codigo_municipio,municipio,grupo,variable,mes,total-H,total-M,TOTAL-H1,TOTAL-M1,TOTAL
51302,ACACIO,estado nutricional en menores de 5 anos,clasificacion f,2002-01-01,0,29,0,29,29
20201,ACHACACHI,estado nutricional en menores de 5 anos,clasificacion f,2002-01-01,0,2,0,2,2
20104,ACHOCALLA,estado nutricional en menores de 5 anos,clasificacion f,2002-01-01,0,1,0,1,1
30201,AIQUILE,estado nutricional en menores de 5 anos,clasificacion f,2002-01-01,0,2,0,2,2
31303,ALALAY,estado nutricional en menores de 5 anos,clasificacion f,2002-01-01,1,0,1,0,1
10404,ALCALA,estado nutricional en menores de 5 anos,clasificacion f,2002-01-01,0,5,0,5,5
20202,ANCORAIMES,estado nutricional en menores de 5 anos,clasificacion f,2002-01-01,0,3,0,3,3
30402,ANZALDO,estado nutricional en menores de 5 anos,clasificacion f,2002-01-01,0,4,0,4,4
51301,ARAMPAMPA,estado nutricional en menores de 5 anos,clasificacion f,2002-01-01,0,3,0,3,3
30501,ARANI,estado nutricional en menores de 5 anos,clasificacion f,2002-01-01,0,4,0,4,4
30601,ARQUE,estado nutricional en menores de 5 anos,clasificacion f,2002-01-01,5,0,5,0,5
20502,AYATA,estado nutricional en menores de 5 anos,clasificacion f,2002-01-01,1,0,1,0,1
21303,AYO AYO,estado nutricional en menores de 5 anos,clasificacion f,2002-01-01,0,1,0,1,1
30301,AYOPAYA (V. DE INDEPENDENCIA),estado nutricional en menores de 5 anos,clasificacion f,2002-01-01,5,2,5,2,7
10201,AZURDUY,estado nutricional en menores de 5 anos,clasificacion f,2002-01-01,1,7,1,7,8
21203,BATALLAS,estado nutricional en menores de 5 anos,clasificacion f,2002-01-01,0,1,0,1,1
80802,BAURES,estado nutricional en menores de 5 anos,clasificacion f,2002-01-01,0,3,0,3,3
50301,BETANZOS,estado nutricional en menores de 5 anos,clasificacion f,2002-01-01,0,27,0,27,27
31501,BOLIVAR,estado nutricional en menores de 5 anos,clasificacion f,2002-01-01,8,5,8,5,13
70707,BOYUIBE,estado nutricional en menores de 5 anos,clasificacion f,2002-01-01,0,4,0,4,4
70401,BUENA VISTA,estado nutricional en menores de 5 anos,clasificacion f,2002-01-01,3,1,3,1,4
70703,CABEZAS,estado nutricional en menores de 5 anos,clasificacion f,2002-01-01,0,5,0,5,5
20905,CAIROMA,estado nutricional en menores de 5 anos,clasificacion f,2002-01-01,0,6,0,6,6
51102,"CAIZA ""D""",estado nutricional en menores de 5 anos,clasificacion f,2002-01-01,2,3,2,3,5
21003,CAJUATA,estado nutricional en menores de 5 anos,clasificacion f,2002-01-01,1,1,1,1,2
21304,CALAMARCA,estado nutricional en menores de 5 anos,clasificacion f,2002-01-01,0,1,0,1,1
10701,CAMARGO,estado nutricional en menores de 5 anos,clasificacion f,2002-01-01,0,6,0,6,6
70706,CAMIRI,estado nutricional en menores de 5 anos,clasificacion f,2002-01-01,12,11,12,11,23
30701,CAPINOTA,estado nutricional en menores de 5 anos,clasificacion f,2002-01-01,7,1,7,1,8
20302,CAQUIAVIRI,estado nutricional en menores de 5 anos,clasificacion f,2002-01-01,2,1,2,1,3
22001,CARANAVI,estado nutricional en menores de 5 anos,clasificacion f,2002-01-01,0,25,0,25,25
50702,CARIPUYO,estado nutricional en menores de 5 anos,clasificacion f,2002-01-01,1,9,1,9,10
40201,CHALLAPATA,estado nutricional en menores de 5 anos,clasificacion f,2002-01-01,10,7,10,7,17
50302,CHAQUI,estado nutricional en menores de 5 anos,clasificacion f,2002-01-01,0,3,0,3,3
70702,CHARAGUA,estado nutricional en menores de 5 anos,clasificacion f,2002-01-01,1,14,1,14,15
31204,CHIMORE,estado nutricional en menores de 5 anos,clasificacion f,2002-01-01,2,2,2,2,4
30801,CLIZA,estado nutricional en menores de 5 anos,clasificacion f,2002-01-01,1,0,1,0,1
90101,COBIJA,estado nutricional en menores de 5 anos,clasificacion f,2002-01-01,6,1,6,1,7
30101,COCHABAMBA,estado nutricional en menores de 5 anos,clasificacion f,2002-01-01,7,11,7,11,18
30905,COLCAPIRHUA,estado nutricional en menores de 5 anos,clasificacion f,2002-01-01,2,1,2,1,3
50901,"COLCHA ""K""",estado nutricional en menores de 5 anos,clasificacion f,2002-01-01,0,2,0,2,2
50401,COLQUECHACA,estado nutricional en menores de 5 anos,clasificacion f,2002-01-01,4,8,4,8,12
21004,COLQUIRI,estado nutricional en menores de 5 anos,clasificacion f,2002-01-01,5,6,5,6,11
20304,COMANCHE,estado nutricional en menores de 5 anos,clasificacion f,2002-01-01,0,1,0,1,1
71301,COMARAPA,estado nutricional en menores de 5 anos,clasificacion f,2002-01-01,0,1,0,1,1
20605,COMBAYA,estado nutricional en menores de 5 anos,clasificacion f,2002-01-01,0,2,0,2,2
21401,COROICO,estado nutricional en menores de 5 anos,clasificacion f,2002-01-01,1,1,1,1,2
40301,CORQUE,estado nutricional en menores de 5 anos,clasificacion f,2002-01-01,0,1,0,1,1
50601,COTAGAITA,estado nutricional en menores de 5 anos,clasificacion f,2002-01-01,0,3,0,3,3
70102,COTOCA,estado nutricional en menores de 5 anos,clasificacion f,2002-01-01,2,2,2,2,4
70704,CUEVO,estado nutricional en menores de 5 anos,clasificacion f,2002-01-01,2,2,2,2,4
10902,CULPINA,estado nutricional en menores de 5 anos,clasificacion f,2002-01-01,0,7,0,7,7
40401,CURAHUARA DE CARANGAS,estado nutricional en menores de 5 anos,clasificacion f,2002-01-01,1,0,1,0,1
20105,EL ALTO,estado nutricional en menores de 5 anos,clasificacion f,2002-01-01,39,47,39,47,86
71503,EL PUENTE(STC),estado nutricional en menores de 5 anos,clasificacion f,2002-01-01,0,6,0,6,6
70105,EL TORNO,estado nutricional en menores de 5 anos,clasificacion f,2002-01-01,3,4,3,4,7
10405,EL VILLAR,estado nutricional en menores de 5 anos,clasificacion f,2002-01-01,0,6,0,6,6
60601,ENTRE RIOS,estado nutricional en menores de 5 anos,clasificacion f,2002-01-01,2,2,2,2,4
41101,EUCALIPTUS,estado nutricional en menores de 5 anos,clasificacion f,2002-01-01,0,1,0,1,1
90203,FILADELFIA,estado nutricional en menores de 5 anos,clasificacion f,2002-01-01,0,2,0,2,2
71002,GENERAL SAAVEDRA,estado nutricional en menores de 5 anos,clasificacion f,2002-01-01,3,6,3,6,9
20602,GUANAY,estado nutricional en menores de 5 anos,clasificacion f,2002-01-01,0,14,0,14,14
80202,GUAYARAMERIN,estado nutricional en menores de 5 anos,clasificacion f,2002-01-01,5,2,5,2,7
70705,GUTIERREZ,estado nutricional en menores de 5 anos,clasificacion f,2002-01-01,4,20,4,20,24
10502,HUACARETA,estado nutricional en menores de 5 anos,clasificacion f,2002-01-01,0,4,0,4,4
11002,HUACAYA (VILLA DE HUACAYA),estado nutricional en menores de 5 anos,clasificacion f,2002-01-01,0,1,0,1,1
40501,HUACHACALLA,estado nutricional en menores de 5 anos,clasificacion f,2002-01-01,0,1,0,1,1
40701,HUANUNI,estado nutricional en menores de 5 anos,clasificacion f,2002-01-01,0,1,0,1,1
10304,ICLA,estado nutricional en menores de 5 anos,clasificacion f,2002-01-01,10,13,10,13,23
10703,INCAHUASI,estado nutricional en menores de 5 anos,clasificacion f,2002-01-01,1,9,1,9,10
21001,INQUISIVI,estado nutricional en menores de 5 anos,clasificacion f,2002-01-01,1,1,1,1,2
21102,IRUPANA (VILLA DE LANZA),estado nutricional en menores de 5 anos,clasificacion f,2002-01-01,0,1,0,1,1
21501,IXIAMAS,estado nutricional en menores de 5 anos,clasificacion f,2002-01-01,0,1,0,1,1
21105,LA ASUNTA,estado nutricional en menores de 5 anos,clasificacion f,2002-01-01,4,5,4,5,9
70104,LA GUARDIA,estado nutricional en menores de 5 anos,clasificacion f,2002-01-01,1,4,1,4,5
20101,LA PAZ,estado nutricional en menores de 5 anos,clasificacion f,2002-01-01,30,36,30,36,66
70701,LAGUNILLAS,estado nutricional en menores de 5 anos,clasificacion f,2002-01-01,3,1,3,1,4
10903,LAS CARRERAS,estado nutricional en menores de 5 anos,clasificacion f,2002-01-01,0,1,0,1,1
20901,LURIBAY,estado nutricional en menores de 5 anos,clasificacion f,2002-01-01,0,3,0,3,3
40702,MACHACAMARCA,estado nutricional en menores de 5 anos,clasificacion f,2002-01-01,3,1,3,1,4
11003,MACHARETI,estado nutricional en menores de 5 anos,clasificacion f,2002-01-01,0,8,0,8,8
70903,MAIRANA,estado nutricional en menores de 5 anos,clasificacion f,2002-01-01,0,1,0,1,1
20103,MECAPACA,estado nutricional en menores de 5 anos,clasificacion f,2002-01-01,0,2,0,2,2
71003,MINEROS,estado nutricional en menores de 5 anos,clasificacion f,2002-01-01,0,10,0,10,10
31301,MIZQUE,estado nutricional en menores de 5 anos,clasificacion f,2002-01-01,0,3,0,3,3
20402,MOCOMOCO,estado nutricional en menores de 5 anos,clasificacion f,2002-01-01,0,1,0,1,1
10303,MOJOCOYA,estado nutricional en menores de 5 anos,clasificacion f,2002-01-01,2,1,2,1,3
10501,MONTEAGUDO,estado nutricional en menores de 5 anos,clasificacion f,2002-01-01,1,11,1,11,12
71001,MONTERO,estado nutricional en menores de 5 anos,clasificacion f,2002-01-01,6,25,6,25,31
30302,MOROCHATA,estado nutricional en menores de 5 anos,clasificacion f,2002-01-01,0,3,0,3,3
50404,OCURI,estado nutricional en menores de 5 anos,clasificacion f,2002-01-01,2,2,2,2,4
40101,ORURO,estado nutricional en menores de 5 anos,clasificacion f,2002-01-01,4,11,4,11,15
60201,PADCAYA,estado nutricional en menores de 5 anos,clasificacion f,2002-01-01,2,3,2,3,5
10401,PADILLA,estado nutricional en menores de 5 anos,clasificacion f,2002-01-01,1,15,1,15,16
70502,PAILON,estado nutricional en menores de 5 anos,clasificacion f,2002-01-01,0,7,0,7,7
20102,PALCA,estado nutricional en menores de 5 anos,clasificacion f,2002-01-01,1,0,1,0,1
21104,PALOS BLANCOS,estado nutricional en menores de 5 anos,clasificacion f,2002-01-01,3,5,3,5,8
70902,PAMPA GRANDE,estado nutricional en menores de 5 anos,clasificacion f,2002-01-01,3,1,3,1,4
21802,PAPEL PAMPA,estado nutricional en menores de 5 anos,clasificacion f,2002-01-01,0,1,0,1,1
30202,PASORAPA,estado nutricional en menores de 5 anos,clasificacion f,2002-01-01,0,2,0,2,2
21305,PATACAMAYA,estado nutricional en menores de 5 anos,clasificacion f,2002-01-01,0,1,0,1,1
40602,PAZÃ‘A,estado nutricional en menores de 5 anos,clasificacion f,2002-01-01,0,3,0,3,3
20702,PELECHUCO,estado nutricional en menores de 5 anos,clasificacion f,2002-01-01,2,0,2,0,2
50403,POCOATA,estado nutricional en menores de 5 anos,clasificacion f,2002-01-01,3,9,3,9,12
31203,POCONA,estado nutricional en menores de 5 anos,clasificacion f,2002-01-01,0,4,0,4,4
31202,POJO (CBBA),estado nutricional en menores de 5 anos,clasificacion f,2002-01-01,3,2,3,2,5
10103,POROMA,estado nutricional en menores de 5 anos,clasificacion f,2002-01-01,0,48,0,48,48
70601,PORTACHUELO,estado nutricional en menores de 5 anos,clasificacion f,2002-01-01,1,1,1,1,2
70804,POSTRER VALLE,estado nutricional en menores de 5 anos,clasificacion f,2002-01-01,0,1,0,1,1
50101,POTOSI,estado nutricional en menores de 5 anos,clasificacion f,2002-01-01,5,16,5,16,21
10302,PRESTO,estado nutricional en menores de 5 anos,clasificacion f,2002-01-01,7,3,7,3,10
21201,PUCARANI,estado nutricional en menores de 5 anos,clasificacion f,2002-01-01,0,2,0,2,2
20401,PUERTO ACOSTA,estado nutricional en menores de 5 anos,clasificacion f,2002-01-01,4,0,4,0,4
20403,PUERTO CARABUCO,estado nutricional en menores de 5 anos,clasificacion f,2002-01-01,5,2,5,2,7
90301,PUERTO GONZALO MORENO,estado nutricional en menores de 5 anos,clasificacion f,2002-01-01,0,2,0,2,2
71402,PUERTO QUIJARRO,estado nutricional en menores de 5 anos,clasificacion f,2002-01-01,2,0,2,0,2
71401,PUERTO SUAREZ,estado nutricional en menores de 5 anos,clasificacion f,2002-01-01,12,4,12,4,16
31205,PUERTO VILLARROEL,estado nutricional en menores de 5 anos,clasificacion f,2002-01-01,17,10,17,10,27
51101,PUNA,estado nutricional en menores de 5 anos,clasificacion f,2002-01-01,0,7,0,7,7
31401,PUNATA,estado nutricional en menores de 5 anos,clasificacion f,2002-01-01,0,2,0,2,2
20604,QUIABAYA,estado nutricional en menores de 5 anos,clasificacion f,2002-01-01,0,3,0,3,3
30901,QUILLACOLLO,estado nutricional en menores de 5 anos,clasificacion f,2002-01-01,4,0,4,0,4
21002,QUIME,estado nutricional en menores de 5 anos,clasificacion f,2002-01-01,1,1,1,1,2
50402,RAVELO,estado nutricional en menores de 5 anos,clasificacion f,2002-01-01,3,20,3,20,23
80301,REYES,estado nutricional en menores de 5 anos,clasificacion f,2002-01-01,0,3,0,3,3
80201,RIBERALTA,estado nutricional en menores de 5 anos,clasificacion f,2002-01-01,25,22,25,22,47
70503,ROBORE,estado nutricional en menores de 5 anos,clasificacion f,2002-01-01,0,6,0,6,6
80304,RURRENABAQUE,estado nutricional en menores de 5 anos,clasificacion f,2002-01-01,6,3,6,3,9
31001,SACABA,estado nutricional en menores de 5 anos,clasificacion f,2002-01-01,0,4,0,4,4
30404,SACABAMBA,estado nutricional en menores de 5 anos,clasificacion f,2002-01-01,0,5,0,5,5
50701,SACACA,estado nutricional en menores de 5 anos,clasificacion f,2002-01-01,13,15,13,15,28
71302,SAIPINA,estado nutricional en menores de 5 anos,clasificacion f,2002-01-01,1,0,1,0,1
40801,SALINAS DE GARCI MENDOZA,estado nutricional en menores de 5 anos,clasificacion f,2002-01-01,0,1,0,1,1
70901,SAMAIPATA,estado nutricional en menores de 5 anos,clasificacion f,2002-01-01,1,0,1,0,1
71105,SAN ANTONIO DE LOMERIO,estado nutricional en menores de 5 anos,clasificacion f,2002-01-01,18,8,18,8,26
31403,SAN BENITO,estado nutricional en menores de 5 anos,clasificacion f,2002-01-01,0,1,0,1,1
80302,SAN BORJA,estado nutricional en menores de 5 anos,clasificacion f,2002-01-01,0,4,0,4,4
21502,SAN BUENA VENTURA,estado nutricional en menores de 5 anos,clasificacion f,2002-01-01,2,0,2,0,2
80501,SAN IGNACIO,estado nutricional en menores de 5 anos,clasificacion f,2002-01-01,2,21,2,21,23
70301,SAN IGNACIO DE VELASCO,estado nutricional en menores de 5 anos,clasificacion f,2002-01-01,18,9,18,9,27
71102,SAN JAVIER(STC),estado nutricional en menores de 5 anos,clasificacion f,2002-01-01,0,1,0,1,1
70501,SAN JOSE DE CHIQUITOS,estado nutricional en menores de 5 anos,clasificacion f,2002-01-01,3,2,3,2,5
71104,SAN JULIAN,estado nutricional en menores de 5 anos,clasificacion f,2002-01-01,7,12,7,12,19
10702,SAN LUCAS,estado nutricional en menores de 5 anos,clasificacion f,2002-01-01,0,36,0,36,36
71201,SAN MATIAS,estado nutricional en menores de 5 anos,clasificacion f,2002-01-01,4,3,4,3,7
70302,SAN MIGUEL DE VELASCO,estado nutricional en menores de 5 anos,clasificacion f,2002-01-01,1,3,1,3,4
51001,SAN PABLO DE LIPEZ,estado nutricional en menores de 5 anos,clasificacion f,2002-01-01,0,1,0,1,1
50501,SAN PEDRO DE BUENA VISTA,estado nutricional en menores de 5 anos,clasificacion f,2002-01-01,0,11,0,11,11
70303,SAN RAFAEL,estado nutricional en menores de 5 anos,clasificacion f,2002-01-01,0,1,0,1,1
80401,SANTA ANA,estado nutricional en menores de 5 anos,clasificacion f,2002-01-01,0,3,0,3,3
70101,SANTA CRUZ DE LA SIERRA,estado nutricional en menores de 5 anos,clasificacion f,2002-01-01,11,18,11,18,29
80303,SANTA ROSA,estado nutricional en menores de 5 anos,clasificacion f,2002-01-01,0,1,0,1,1
70602,SANTA ROSA DEL SARA,estado nutricional en menores de 5 anos,clasificacion f,2002-01-01,2,2,2,2,4
30702,SANTIVAÃ‘ES,estado nutricional en menores de 5 anos,clasificacion f,2002-01-01,1,0,1,0,1
40202,SANTUARIO DE QUILLACAS,estado nutricional en menores de 5 anos,clasificacion f,2002-01-01,0,1,0,1,1
20902,SAPAHAQUI,estado nutricional en menores de 5 anos,clasificacion f,2002-01-01,0,1,0,1,1
90303,SENA,estado nutricional en menores de 5 anos,clasificacion f,2002-01-01,0,2,0,2,2
21301,SICA SICA (VILLA AROMA),estado nutricional en menores de 5 anos,clasificacion f,2002-01-01,0,1,0,1,1
30703,SICAYA,estado nutricional en menores de 5 anos,clasificacion f,2002-01-01,0,1,0,1,1
30902,SIPE SIPE,estado nutricional en menores de 5 anos,clasificacion f,2002-01-01,13,5,13,5,18
10403,SOPACHUY,estado nutricional en menores de 5 anos,clasificacion f,2002-01-01,0,17,0,17,17
10101,SUCRE,estado nutricional en menores de 5 anos,clasificacion f,2002-01-01,5,19,5,19,24
50303,TACOBAMBA,estado nutricional en menores de 5 anos,clasificacion f,2002-01-01,1,8,1,8,9
30602,TACOPAYA,estado nutricional en menores de 5 anos,clasificacion f,2002-01-01,5,6,5,6,11
31101,TAPACARI,estado nutricional en menores de 5 anos,clasificacion f,2002-01-01,0,2,0,2,2
10601,TARABUCO,estado nutricional en menores de 5 anos,clasificacion f,2002-01-01,0,35,0,35,35
30401,TARATA,estado nutricional en menores de 5 anos,clasificacion f,2002-01-01,0,3,0,3,3
60101,TARIJA,estado nutricional en menores de 5 anos,clasificacion f,2002-01-01,1,4,1,4,5
10202,TARVITA,estado nutricional en menores de 5 anos,clasificacion f,2002-01-01,4,3,4,3,7
20803,TIAWANACU,estado nutricional en menores de 5 anos,clasificacion f,2002-01-01,3,0,3,0,3
50102,TINGUIPAYA,estado nutricional en menores de 5 anos,clasificacion f,2002-01-01,2,3,2,3,5
30903,TIQUIPAYA,estado nutricional en menores de 5 anos,clasificacion f,2002-01-01,0,3,0,3,3
31601,TIRAQUE (CBBA),estado nutricional en menores de 5 anos,clasificacion f,2002-01-01,4,10,4,10,14
21703,TITO YUPANQUI (PARQUIPUJIO),estado nutricional en menores de 5 anos,clasificacion f,2002-01-01,0,1,0,1,1
51202,TOMAVE,estado nutricional en menores de 5 anos,clasificacion f,2002-01-01,0,8,0,8,8
10402,TOMINA,estado nutricional en menores de 5 anos,clasificacion f,2002-01-01,0,18,0,18,18
50502,TORO TORO,estado nutricional en menores de 5 anos,clasificacion f,2002-01-01,0,2,0,2,2
31201,TOTORA(CBBA),estado nutricional en menores de 5 anos,clasificacion f,2002-01-01,1,6,1,6,7
80101,TRINIDAD,estado nutricional en menores de 5 anos,clasificacion f,2002-01-01,3,9,3,9,12
50801,TUPIZA,estado nutricional en menores de 5 anos,clasificacion f,2002-01-01,0,17,0,17,17
50201,UNCIA,estado nutricional en menores de 5 anos,clasificacion f,2002-01-01,1,1,1,1,2
60401,URIONDO (A. CONCEPCION),estado nutricional en menores de 5 anos,clasificacion f,2002-01-01,2,1,2,1,3
51201,UYUNI,estado nutricional en menores de 5 anos,clasificacion f,2002-01-01,0,1,0,1,1
30502,VACAS,estado nutricional en menores de 5 anos,clasificacion f,2002-01-01,0,3,0,3,3
70801,VALLEGRANDE,estado nutricional en menores de 5 anos,clasificacion f,2002-01-01,1,2,1,2,3
20801,VIACHA,estado nutricional en menores de 5 anos,clasificacion f,2002-01-01,0,1,0,1,1
60303,VILLA MONTES,estado nutricional en menores de 5 anos,clasificacion f,2002-01-01,2,1,2,1,3
10801,VILLA SERRANO,estado nutricional en menores de 5 anos,clasificacion f,2002-01-01,0,23,0,23,23
31003,VILLA TUNARI,estado nutricional en menores de 5 anos,clasificacion f,2002-01-01,10,10,10,10,20
11001,VILLA VACA GUZMAN (MUYUPAMPA),estado nutricional en menores de 5 anos,clasificacion f,2002-01-01,1,6,1,6,7
51501,VILLAZON,estado nutricional en menores de 5 anos,clasificacion f,2002-01-01,0,10,0,10,10
30904,VINTO,estado nutricional en menores de 5 anos,clasificacion f,2002-01-01,8,8,8,8,16
50602,VITICHI,estado nutricional en menores de 5 anos,clasificacion f,2002-01-01,3,9,3,9,12
70201,WARNES,estado nutricional en menores de 5 anos,clasificacion f,2002-01-01,4,8,4,8,12
20903,YACO,estado nutricional en menores de 5 anos,clasificacion f,2002-01-01,0,1,0,1,1
60301,YACUIBA,estado nutricional en menores de 5 anos,clasificacion f,2002-01-01,1,1,1,1,2
10602,YAMPARAEZ,estado nutricional en menores de 5 anos,clasificacion f,2002-01-01,10,4,10,4,14
70403,YAPACANI,estado nutricional en menores de 5 anos,clasificacion f,2002-01-01,4,1,4,1,5
50103,YOCALLA,estado nutricional en menores de 5 anos,clasificacion f,2002-01-01,0,1,0,1,1
10102,YOTALA,estado nutricional en menores de 5 anos,clasificacion f,2002-01-01,7,4,7,4,11
60402,YUNCHARA,estado nutricional en menores de 5 anos,clasificacion f,2002-01-01,1,2,1,2,3
10301,ZUDAÃ‘EZ,estado nutricional en menores de 5 anos,clasificacion f,2002-01-01,5,4,5,4,9
51302,ACACIO,estado nutricional en menores de 5 anos,clasificacion f,2002-02-01,0,10,0,10,10
20201,ACHACACHI,estado nutricional en menores de 5 anos,clasificacion f,2002-02-01,0,2,0,2,2
30201,AIQUILE,estado nutricional en menores de 5 anos,clasificacion f,2002-02-01,0,1,0,1,1
10404,ALCALA,estado nutricional en menores de 5 anos,clasificacion f,2002-02-01,2,2,2,2,4
20202,ANCORAIMES,estado nutricional en menores de 5 anos,clasificacion f,2002-02-01,3,3,3,3,6
30402,ANZALDO,estado nutricional en menores de 5 anos,clasificacion f,2002-02-01,0,1,0,1,1
20701,APOLO,estado nutricional en menores de 5 anos,clasificacion f,2002-02-01,0,1,0,1,1
51301,ARAMPAMPA,estado nutricional en menores de 5 anos,clasificacion f,2002-02-01,6,1,6,1,7
30601,ARQUE,estado nutricional en menores de 5 anos,clasificacion f,2002-02-01,0,2,0,2,2
71501,ASCENCION DE GUARAYOS,estado nutricional en menores de 5 anos,clasificacion f,2002-02-01,5,2,5,2,7
50802,ATOCHA,estado nutricional en menores de 5 anos,clasificacion f,2002-02-01,0,4,0,4,4
20503,AUCAPATA,estado nutricional en menores de 5 anos,clasificacion f,2002-02-01,0,1,0,1,1
21303,AYO AYO,estado nutricional en menores de 5 anos,clasificacion f,2002-02-01,2,0,2,0,2
30301,AYOPAYA (V. DE INDEPENDENCIA),estado nutricional en menores de 5 anos,clasificacion f,2002-02-01,6,4,6,4,10
10201,AZURDUY,estado nutricional en menores de 5 anos,clasificacion f,2002-02-01,2,3,2,3,5
80802,BAURES,estado nutricional en menores de 5 anos,clasificacion f,2002-02-01,0,1,0,1,1
60202,BERMEJO,estado nutricional en menores de 5 anos,clasificacion f,2002-02-01,3,1,3,1,4
50301,BETANZOS,estado nutricional en menores de 5 anos,clasificacion f,2002-02-01,0,14,0,14,14
31501,BOLIVAR,estado nutricional en menores de 5 anos,clasificacion f,2002-02-01,2,4,2,4,6
70707,BOYUIBE,estado nutricional en menores de 5 anos,clasificacion f,2002-02-01,0,1,0,1,1
70401,BUENA VISTA,estado nutricional en menores de 5 anos,clasificacion f,2002-02-01,1,0,1,0,1
70703,CABEZAS,estado nutricional en menores de 5 anos,clasificacion f,2002-02-01,0,9,0,9,9
51102,"CAIZA ""D""",estado nutricional en menores de 5 anos,clasificacion f,2002-02-01,1,9,1,9,10
21304,CALAMARCA,estado nutricional en menores de 5 anos,clasificacion f,2002-02-01,2,2,2,2,4
10701,CAMARGO,estado nutricional en menores de 5 anos,clasificacion f,2002-02-01,0,3,0,3,3
70706,CAMIRI,estado nutricional en menores de 5 anos,clasificacion f,2002-02-01,8,11,8,11,19
30701,CAPINOTA,estado nutricional en menores de 5 anos,clasificacion f,2002-02-01,5,0,5,0,5
22001,CARANAVI,estado nutricional en menores de 5 anos,clasificacion f,2002-02-01,2,8,2,8,10
60302,CARAPARI,estado nutricional en menores de 5 anos,clasificacion f,2002-02-01,1,2,1,2,3
50702,CARIPUYO,estado nutricional en menores de 5 anos,clasificacion f,2002-02-01,1,6,1,6,7
40201,CHALLAPATA,estado nutricional en menores de 5 anos,clasificacion f,2002-02-01,3,1,3,1,4
50302,CHAQUI,estado nutricional en menores de 5 anos,clasificacion f,2002-02-01,2,2,2,2,4
70702,CHARAGUA,estado nutricional en menores de 5 anos,clasificacion f,2002-02-01,1,18,1,18,19
90101,COBIJA,estado nutricional en menores de 5 anos,clasificacion f,2002-02-01,3,3,3,3,6
30101,COCHABAMBA,estado nutricional en menores de 5 anos,clasificacion f,2002-02-01,6,10,6,10,16
30905,COLCAPIRHUA,estado nutricional en menores de 5 anos,clasificacion f,2002-02-01,3,2,3,2,5
50901,"COLCHA ""K""",estado nutricional en menores de 5 anos,clasificacion f,2002-02-01,0,1,0,1,1
31002,COLOMI,estado nutricional en menores de 5 anos,clasificacion f,2002-02-01,4,0,4,0,4
50401,COLQUECHACA,estado nutricional en menores de 5 anos,clasificacion f,2002-02-01,1,4,1,4,5
21306,COLQUENCHA,estado nutricional en menores de 5 anos,clasificacion f,2002-02-01,2,0,2,0,2
21004,COLQUIRI,estado nutricional en menores de 5 anos,clasificacion f,2002-02-01,4,2,4,2,6
20304,COMANCHE,estado nutricional en menores de 5 anos,clasificacion f,2002-02-01,0,1,0,1,1
20605,COMBAYA,estado nutricional en menores de 5 anos,clasificacion f,2002-02-01,0,1,0,1,1
21401,COROICO,estado nutricional en menores de 5 anos,clasificacion f,2002-02-01,5,0,5,0,5
40301,CORQUE,estado nutricional en menores de 5 anos,clasificacion f,2002-02-01,0,1,0,1,1
50601,COTAGAITA,estado nutricional en menores de 5 anos,clasificacion f,2002-02-01,0,3,0,3,3
70102,COTOCA,estado nutricional en menores de 5 anos,clasificacion f,2002-02-01,0,2,0,2,2
10902,CULPINA,estado nutricional en menores de 5 anos,clasificacion f,2002-02-01,0,8,0,8,8
40401,CURAHUARA DE CARANGAS,estado nutricional en menores de 5 anos,clasificacion f,2002-02-01,0,1,0,1,1
20804,DESAGUADERO,estado nutricional en menores de 5 anos,clasificacion f,2002-02-01,0,1,0,1,1
20105,EL ALTO,estado nutricional en menores de 5 anos,clasificacion f,2002-02-01,32,26,32,26,58
40103,EL CHORO,estado nutricional en menores de 5 anos,clasificacion f,2002-02-01,0,1,0,1,1
71503,EL PUENTE(STC),estado nutricional en menores de 5 anos,clasificacion f,2002-02-01,0,1,0,1,1
70105,EL TORNO,estado nutricional en menores de 5 anos,clasificacion f,2002-02-01,2,1,2,1,3
10405,EL VILLAR,estado nutricional en menores de 5 anos,clasificacion f,2002-02-01,5,2,5,2,7
60601,ENTRE RIOS,estado nutricional en menores de 5 anos,clasificacion f,2002-02-01,1,2,1,2,3
41101,EUCALIPTUS,estado nutricional en menores de 5 anos,clasificacion f,2002-02-01,0,2,0,2,2
90203,FILADELFIA,estado nutricional en menores de 5 anos,clasificacion f,2002-02-01,0,1,0,1,1
71002,GENERAL SAAVEDRA,estado nutricional en menores de 5 anos,clasificacion f,2002-02-01,1,3,1,3,4
20602,GUANAY,estado nutricional en menores de 5 anos,clasificacion f,2002-02-01,1,3,1,3,4
80202,GUAYARAMERIN,estado nutricional en menores de 5 anos,clasificacion f,2002-02-01,1,0,1,0,1
70705,GUTIERREZ,estado nutricional en menores de 5 anos,clasificacion f,2002-02-01,1,10,1,10,11
10502,HUACARETA,estado nutricional en menores de 5 anos,clasificacion f,2002-02-01,1,5,1,5,6
11002,HUACAYA (VILLA DE HUACAYA),estado nutricional en menores de 5 anos,clasificacion f,2002-02-01,1,0,1,0,1
40501,HUACHACALLA,estado nutricional en menores de 5 anos,clasificacion f,2002-02-01,0,1,0,1,1
21005,ICHOCA,estado nutricional en menores de 5 anos,clasificacion f,2002-02-01,1,0,1,0,1
10304,ICLA,estado nutricional en menores de 5 anos,clasificacion f,2002-02-01,4,4,4,4,8
10703,INCAHUASI,estado nutricional en menores de 5 anos,clasificacion f,2002-02-01,0,11,0,11,11
21001,INQUISIVI,estado nutricional en menores de 5 anos,clasificacion f,2002-02-01,1,2,1,2,3
21105,LA ASUNTA,estado nutricional en menores de 5 anos,clasificacion f,2002-02-01,2,8,2,8,10
70104,LA GUARDIA,estado nutricional en menores de 5 anos,clasificacion f,2002-02-01,2,1,2,1,3
20101,LA PAZ,estado nutricional en menores de 5 anos,clasificacion f,2002-02-01,23,19,23,19,42
21202,LAJA,estado nutricional en menores de 5 anos,clasificacion f,2002-02-01,0,2,0,2,2
10903,LAS CARRERAS,estado nutricional en menores de 5 anos,clasificacion f,2002-02-01,0,1,0,1,1
20901,LURIBAY,estado nutricional en menores de 5 anos,clasificacion f,2002-02-01,0,3,0,3,3
40702,MACHACAMARCA,estado nutricional en menores de 5 anos,clasificacion f,2002-02-01,1,0,1,0,1
11003,MACHARETI,estado nutricional en menores de 5 anos,clasificacion f,2002-02-01,3,2,3,2,5
71003,MINEROS,estado nutricional en menores de 5 anos,clasificacion f,2002-02-01,4,6,4,6,10
31301,MIZQUE,estado nutricional en menores de 5 anos,clasificacion f,2002-02-01,2,4,2,4,6
20402,MOCOMOCO,estado nutricional en menores de 5 anos,clasificacion f,2002-02-01,1,0,1,0,1
10303,MOJOCOYA,estado nutricional en menores de 5 anos,clasificacion f,2002-02-01,0,3,0,3,3
10501,MONTEAGUDO,estado nutricional en menores de 5 anos,clasificacion f,2002-02-01,3,3,3,3,6
71001,MONTERO,estado nutricional en menores de 5 anos,clasificacion f,2002-02-01,0,16,0,16,16
30302,MOROCHATA,estado nutricional en menores de 5 anos,clasificacion f,2002-02-01,2,0,2,0,2
50404,OCURI,estado nutricional en menores de 5 anos,clasificacion f,2002-02-01,8,5,8,5,13
40101,ORURO,estado nutricional en menores de 5 anos,clasificacion f,2002-02-01,4,12,4,12,16
10401,PADILLA,estado nutricional en menores de 5 anos,clasificacion f,2002-02-01,9,5,9,5,14
70502,PAILON,estado nutricional en menores de 5 anos,clasificacion f,2002-02-01,1,4,1,4,5
20102,PALCA,estado nutricional en menores de 5 anos,clasificacion f,2002-02-01,2,3,2,3,5
21104,PALOS BLANCOS,estado nutricional en menores de 5 anos,clasificacion f,2002-02-01,4,1,4,1,5
70902,PAMPA GRANDE,estado nutricional en menores de 5 anos,clasificacion f,2002-02-01,0,1,0,1,1
21305,PATACAMAYA,estado nutricional en menores de 5 anos,clasificacion f,2002-02-01,4,0,4,0,4
20702,PELECHUCO,estado nutricional en menores de 5 anos,clasificacion f,2002-02-01,1,0,1,0,1
50403,POCOATA,estado nutricional en menores de 5 anos,clasificacion f,2002-02-01,4,4,4,4,8
31203,POCONA,estado nutricional en menores de 5 anos,clasificacion f,2002-02-01,0,1,0,1,1
31202,POJO (CBBA),estado nutricional en menores de 5 anos,clasificacion f,2002-02-01,3,4,3,4,7
51203,PORCO,estado nutricional en menores de 5 anos,clasificacion f,2002-02-01,1,1,1,1,2
10103,POROMA,estado nutricional en menores de 5 anos,clasificacion f,2002-02-01,11,20,11,20,31
70103,PORONGO,estado nutricional en menores de 5 anos,clasificacion f,2002-02-01,0,1,0,1,1
70601,PORTACHUELO,estado nutricional en menores de 5 anos,clasificacion f,2002-02-01,3,0,3,0,3
50101,POTOSI,estado nutricional en menores de 5 anos,clasificacion f,2002-02-01,8,7,8,7,15
10302,PRESTO,estado nutricional en menores de 5 anos,clasificacion f,2002-02-01,5,1,5,1,6
70805,PUCARA,estado nutricional en menores de 5 anos,clasificacion f,2002-02-01,3,4,3,4,7
21201,PUCARANI,estado nutricional en menores de 5 anos,clasificacion f,2002-02-01,0,1,0,1,1
20401,PUERTO ACOSTA,estado nutricional en menores de 5 anos,clasificacion f,2002-02-01,0,1,0,1,1
20403,PUERTO CARABUCO,estado nutricional en menores de 5 anos,clasificacion f,2002-02-01,2,2,2,2,4
71402,PUERTO QUIJARRO,estado nutricional en menores de 5 anos,clasificacion f,2002-02-01,4,0,4,0,4
71401,PUERTO SUAREZ,estado nutricional en menores de 5 anos,clasificacion f,2002-02-01,1,2,1,2,3
31205,PUERTO VILLARROEL,estado nutricional en menores de 5 anos,clasificacion f,2002-02-01,8,7,8,7,15
51101,PUNA,estado nutricional en menores de 5 anos,clasificacion f,2002-02-01,0,9,0,9,9
31401,PUNATA,estado nutricional en menores de 5 anos,clasificacion f,2002-02-01,0,1,0,1,1
21002,QUIME,estado nutricional en menores de 5 anos,clasificacion f,2002-02-01,0,9,0,9,9
50402,RAVELO,estado nutricional en menores de 5 anos,clasificacion f,2002-02-01,12,13,12,13,25
80301,REYES,estado nutricional en menores de 5 anos,clasificacion f,2002-02-01,3,0,3,0,3
80201,RIBERALTA,estado nutricional en menores de 5 anos,clasificacion f,2002-02-01,13,11,13,11,24
70503,ROBORE,estado nutricional en menores de 5 anos,clasificacion f,2002-02-01,0,3,0,3,3
80304,RURRENABAQUE,estado nutricional en menores de 5 anos,clasificacion f,2002-02-01,0,1,0,1,1
30404,SACABAMBA,estado nutricional en menores de 5 anos,clasificacion f,2002-02-01,0,2,0,2,2
50701,SACACA,estado nutricional en menores de 5 anos,clasificacion f,2002-02-01,7,24,7,24,31
71302,SAIPINA,estado nutricional en menores de 5 anos,clasificacion f,2002-02-01,1,0,1,0,1
40801,SALINAS DE GARCI MENDOZA,estado nutricional en menores de 5 anos,clasificacion f,2002-02-01,1,0,1,0,1
51003,SAN ANTONIO DE ESMORUCO,estado nutricional en menores de 5 anos,clasificacion f,2002-02-01,0,1,0,1,1
71105,SAN ANTONIO DE LOMERIO,estado nutricional en menores de 5 anos,clasificacion f,2002-02-01,10,3,10,3,13
31403,SAN BENITO,estado nutricional en menores de 5 anos,clasificacion f,2002-02-01,0,2,0,2,2
80302,SAN BORJA,estado nutricional en menores de 5 anos,clasificacion f,2002-02-01,7,1,7,1,8
21502,SAN BUENA VENTURA,estado nutricional en menores de 5 anos,clasificacion f,2002-02-01,4,3,4,3,7
80501,SAN IGNACIO,estado nutricional en menores de 5 anos,clasificacion f,2002-02-01,2,13,2,13,15
70301,SAN IGNACIO DE VELASCO,estado nutricional en menores de 5 anos,clasificacion f,2002-02-01,14,9,14,9,23
80102,SAN JAVIER(BNI),estado nutricional en menores de 5 anos,clasificacion f,2002-02-01,1,0,1,0,1
71102,SAN JAVIER(STC),estado nutricional en menores de 5 anos,clasificacion f,2002-02-01,0,3,0,3,3
70501,SAN JOSE DE CHIQUITOS,estado nutricional en menores de 5 anos,clasificacion f,2002-02-01,4,0,4,0,4
71104,SAN JULIAN,estado nutricional en menores de 5 anos,clasificacion f,2002-02-01,7,9,7,9,16
10702,SAN LUCAS,estado nutricional en menores de 5 anos,clasificacion f,2002-02-01,0,16,0,16,16
71201,SAN MATIAS,estado nutricional en menores de 5 anos,clasificacion f,2002-02-01,6,6,6,6,12
70302,SAN MIGUEL DE VELASCO,estado nutricional en menores de 5 anos,clasificacion f,2002-02-01,3,3,3,3,6
50501,SAN PEDRO DE BUENA VISTA,estado nutricional en menores de 5 anos,clasificacion f,2002-02-01,0,6,0,6,6
70303,SAN RAFAEL,estado nutricional en menores de 5 anos,clasificacion f,2002-02-01,4,0,4,0,4
80401,SANTA ANA,estado nutricional en menores de 5 anos,clasificacion f,2002-02-01,0,1,0,1,1
70101,SANTA CRUZ DE LA SIERRA,estado nutricional en menores de 5 anos,clasificacion f,2002-02-01,6,19,6,19,25
70602,SANTA ROSA DEL SARA,estado nutricional en menores de 5 anos,clasificacion f,2002-02-01,0,1,0,1,1
30702,SANTIVAÃ‘ES,estado nutricional en menores de 5 anos,clasificacion f,2002-02-01,3,7,3,7,10
40202,SANTUARIO DE QUILLACAS,estado nutricional en menores de 5 anos,clasificacion f,2002-02-01,3,0,3,0,3
20902,SAPAHAQUI,estado nutricional en menores de 5 anos,clasificacion f,2002-02-01,0,1,0,1,1
21301,SICA SICA (VILLA AROMA),estado nutricional en menores de 5 anos,clasificacion f,2002-02-01,1,0,1,0,1
30902,SIPE SIPE,estado nutricional en menores de 5 anos,clasificacion f,2002-02-01,10,6,10,6,16
10403,SOPACHUY,estado nutricional en menores de 5 anos,clasificacion f,2002-02-01,9,7,9,7,16
10101,SUCRE,estado nutricional en menores de 5 anos,clasificacion f,2002-02-01,2,37,2,37,39
31404,TACACHI,estado nutricional en menores de 5 anos,clasificacion f,2002-02-01,0,1,0,1,1
50303,TACOBAMBA,estado nutricional en menores de 5 anos,clasificacion f,2002-02-01,1,10,1,10,11
30602,TACOPAYA,estado nutricional en menores de 5 anos,clasificacion f,2002-02-01,0,1,0,1,1
31101,TAPACARI,estado nutricional en menores de 5 anos,clasificacion f,2002-02-01,0,4,0,4,4
10601,TARABUCO,estado nutricional en menores de 5 anos,clasificacion f,2002-02-01,0,33,0,33,33
30401,TARATA,estado nutricional en menores de 5 anos,clasificacion f,2002-02-01,0,1,0,1,1
60101,TARIJA,estado nutricional en menores de 5 anos,clasificacion f,2002-02-01,0,1,0,1,1
10202,TARVITA,estado nutricional en menores de 5 anos,clasificacion f,2002-02-01,12,1,12,1,13
20803,TIAWANACU,estado nutricional en menores de 5 anos,clasificacion f,2002-02-01,0,2,0,2,2
50102,TINGUIPAYA,estado nutricional en menores de 5 anos,clasificacion f,2002-02-01,0,2,0,2,2
30903,TIQUIPAYA,estado nutricional en menores de 5 anos,clasificacion f,2002-02-01,0,3,0,3,3
31601,TIRAQUE (CBBA),estado nutricional en menores de 5 anos,clasificacion f,2002-02-01,4,10,4,10,14
21703,TITO YUPANQUI (PARQUIPUJIO),estado nutricional en menores de 5 anos,clasificacion f,2002-02-01,1,0,1,0,1
30802,TOCO,estado nutricional en menores de 5 anos,clasificacion f,2002-02-01,0,1,0,1,1
51202,TOMAVE,estado nutricional en menores de 5 anos,clasificacion f,2002-02-01,0,2,0,2,2
10402,TOMINA,estado nutricional en menores de 5 anos,clasificacion f,2002-02-01,7,7,7,7,14
50502,TORO TORO,estado nutricional en menores de 5 anos,clasificacion f,2002-02-01,1,0,1,0,1
31201,TOTORA(CBBA),estado nutricional en menores de 5 anos,clasificacion f,2002-02-01,4,2,4,2,6
50801,TUPIZA,estado nutricional en menores de 5 anos,clasificacion f,2002-02-01,3,5,3,5,8
71502,URUBICHA,estado nutricional en menores de 5 anos,clasificacion f,2002-02-01,1,5,1,5,6
51201,UYUNI,estado nutricional en menores de 5 anos,clasificacion f,2002-02-01,0,3,0,3,3
30502,VACAS,estado nutricional en menores de 5 anos,clasificacion f,2002-02-01,0,5,0,5,5
70801,VALLEGRANDE,estado nutricional en menores de 5 anos,clasificacion f,2002-02-01,1,3,1,3,4
20801,VIACHA,estado nutricional en menores de 5 anos,clasificacion f,2002-02-01,1,2,1,2,3
31302,VILA VILA,estado nutricional en menores de 5 anos,clasificacion f,2002-02-01,1,1,1,1,2
60303,VILLA MONTES,estado nutricional en menores de 5 anos,clasificacion f,2002-02-01,2,2,2,2,4
10801,VILLA SERRANO,estado nutricional en menores de 5 anos,clasificacion f,2002-02-01,1,8,1,8,9
31003,VILLA TUNARI,estado nutricional en menores de 5 anos,clasificacion f,2002-02-01,6,6,6,6,12
11001,VILLA VACA GUZMAN (MUYUPAMPA),estado nutricional en menores de 5 anos,clasificacion f,2002-02-01,6,5,6,5,11
51501,VILLAZON,estado nutricional en menores de 5 anos,clasificacion f,2002-02-01,0,6,0,6,6
30904,VINTO,estado nutricional en menores de 5 anos,clasificacion f,2002-02-01,7,9,7,9,16
50602,VITICHI,estado nutricional en menores de 5 anos,clasificacion f,2002-02-01,6,2,6,2,8
20306,WALDO BALLIVIAN,estado nutricional en menores de 5 anos,clasificacion f,2002-02-01,0,1,0,1,1
70201,WARNES,estado nutricional en menores de 5 anos,clasificacion f,2002-02-01,5,1,5,1,6
20903,YACO,estado nutricional en menores de 5 anos,clasificacion f,2002-02-01,0,2,0,2,2
10602,YAMPARAEZ,estado nutricional en menores de 5 anos,clasificacion f,2002-02-01,15,3,15,3,18
21103,YANACACHI,estado nutricional en menores de 5 anos,clasificacion f,2002-02-01,1,0,1,0,1
70403,YAPACANI,estado nutricional en menores de 5 anos,clasificacion f,2002-02-01,4,3,4,3,7
50103,YOCALLA,estado nutricional en menores de 5 anos,clasificacion f,2002-02-01,0,3,0,3,3
10102,YOTALA,estado nutricional en menores de 5 anos,clasificacion f,2002-02-01,4,0,4,0,4
10301,ZUDAÃ‘EZ,estado nutricional en menores de 5 anos,clasificacion f,2002-02-01,11,3,11,3,14
51302,ACACIO,estado nutricional en menores de 5 anos,clasificacion f,2002-03-01,4,8,4,8,12
20201,ACHACACHI,estado nutricional en menores de 5 anos,clasificacion f,2002-03-01,1,0,1,0,1
30201,AIQUILE,estado nutricional en menores de 5 anos,clasificacion f,2002-03-01,2,0,2,0,2
10404,ALCALA,estado nutricional en menores de 5 anos,clasificacion f,2002-03-01,2,2,2,2,4
20202,ANCORAIMES,estado nutricional en menores de 5 anos,clasificacion f,2002-03-01,3,3,3,3,6
30402,ANZALDO,estado nutricional en menores de 5 anos,clasificacion f,2002-03-01,0,3,0,3,3
51301,ARAMPAMPA,estado nutricional en menores de 5 anos,clasificacion f,2002-03-01,0,2,0,2,2
30501,ARANI,estado nutricional en menores de 5 anos,clasificacion f,2002-03-01,1,3,1,3,4
30403,ARBIETO,estado nutricional en menores de 5 anos,clasificacion f,2002-03-01,0,1,0,1,1
30601,ARQUE,estado nutricional en menores de 5 anos,clasificacion f,2002-03-01,16,9,16,9,25
21303,AYO AYO,estado nutricional en menores de 5 anos,clasificacion f,2002-03-01,1,0,1,0,1
30301,AYOPAYA (V. DE INDEPENDENCIA),estado nutricional en menores de 5 anos,clasificacion f,2002-03-01,6,5,6,5,11
10201,AZURDUY,estado nutricional en menores de 5 anos,clasificacion f,2002-03-01,12,9,12,9,21
21203,BATALLAS,estado nutricional en menores de 5 anos,clasificacion f,2002-03-01,0,1,0,1,1
60202,BERMEJO,estado nutricional en menores de 5 anos,clasificacion f,2002-03-01,0,3,0,3,3
50301,BETANZOS,estado nutricional en menores de 5 anos,clasificacion f,2002-03-01,10,21,10,21,31
31501,BOLIVAR,estado nutricional en menores de 5 anos,clasificacion f,2002-03-01,4,2,4,2,6
70707,BOYUIBE,estado nutricional en menores de 5 anos,clasificacion f,2002-03-01,0,2,0,2,2
70401,BUENA VISTA,estado nutricional en menores de 5 anos,clasificacion f,2002-03-01,1,2,1,2,3
70703,CABEZAS,estado nutricional en menores de 5 anos,clasificacion f,2002-03-01,0,7,0,7,7
20905,CAIROMA,estado nutricional en menores de 5 anos,clasificacion f,2002-03-01,0,1,0,1,1
51102,"CAIZA ""D""",estado nutricional en menores de 5 anos,clasificacion f,2002-03-01,8,19,8,19,27
21003,CAJUATA,estado nutricional en menores de 5 anos,clasificacion f,2002-03-01,1,0,1,0,1
21304,CALAMARCA,estado nutricional en menores de 5 anos,clasificacion f,2002-03-01,0,1,0,1,1
10701,CAMARGO,estado nutricional en menores de 5 anos,clasificacion f,2002-03-01,0,3,0,3,3
70706,CAMIRI,estado nutricional en menores de 5 anos,clasificacion f,2002-03-01,6,14,6,14,20
30701,CAPINOTA,estado nutricional en menores de 5 anos,clasificacion f,2002-03-01,9,2,9,2,11
20302,CAQUIAVIRI,estado nutricional en menores de 5 anos,clasificacion f,2002-03-01,1,0,1,0,1
40102,CARACOLLO,estado nutricional en menores de 5 anos,clasificacion f,2002-03-01,1,2,1,2,3
22001,CARANAVI,estado nutricional en menores de 5 anos,clasificacion f,2002-03-01,2,9,2,9,11
60302,CARAPARI,estado nutricional en menores de 5 anos,clasificacion f,2002-03-01,1,3,1,3,4
50702,CARIPUYO,estado nutricional en menores de 5 anos,clasificacion f,2002-03-01,0,3,0,3,3
40201,CHALLAPATA,estado nutricional en menores de 5 anos,clasificacion f,2002-03-01,5,1,5,1,6
50302,CHAQUI,estado nutricional en menores de 5 anos,clasificacion f,2002-03-01,0,1,0,1,1
70702,CHARAGUA,estado nutricional en menores de 5 anos,clasificacion f,2002-03-01,1,17,1,17,18
31204,CHIMORE,estado nutricional en menores de 5 anos,clasificacion f,2002-03-01,1,0,1,0,1
20501,CHUMA,estado nutricional en menores de 5 anos,clasificacion f,2002-03-01,2,1,2,1,3
30801,CLIZA,estado nutricional en menores de 5 anos,clasificacion f,2002-03-01,3,21,3,21,24
90101,COBIJA,estado nutricional en menores de 5 anos,clasificacion f,2002-03-01,2,1,2,1,3
30101,COCHABAMBA,estado nutricional en menores de 5 anos,clasificacion f,2002-03-01,7,12,7,12,19
30905,COLCAPIRHUA,estado nutricional en menores de 5 anos,clasificacion f,2002-03-01,3,1,3,1,4
50901,"COLCHA ""K""",estado nutricional en menores de 5 anos,clasificacion f,2002-03-01,0,2,0,2,2
31002,COLOMI,estado nutricional en menores de 5 anos,clasificacion f,2002-03-01,3,1,3,1,4
50401,COLQUECHACA,estado nutricional en menores de 5 anos,clasificacion f,2002-03-01,4,2,4,2,6
21306,COLQUENCHA,estado nutricional en menores de 5 anos,clasificacion f,2002-03-01,0,1,0,1,1
21004,COLQUIRI,estado nutricional en menores de 5 anos,clasificacion f,2002-03-01,2,2,2,2,4
71301,COMARAPA,estado nutricional en menores de 5 anos,clasificacion f,2002-03-01,3,1,3,1,4
20605,COMBAYA,estado nutricional en menores de 5 anos,clasificacion f,2002-03-01,1,0,1,0,1
21701,COPACABANA,estado nutricional en menores de 5 anos,clasificacion f,2002-03-01,0,1,0,1,1
20301,CORO CORO,estado nutricional en menores de 5 anos,clasificacion f,2002-03-01,1,1,1,1,2
21401,COROICO,estado nutricional en menores de 5 anos,clasificacion f,2002-03-01,0,1,0,1,1
40301,CORQUE,estado nutricional en menores de 5 anos,clasificacion f,2002-03-01,0,1,0,1,1
50601,COTAGAITA,estado nutricional en menores de 5 anos,clasificacion f,2002-03-01,8,5,8,5,13
70102,COTOCA,estado nutricional en menores de 5 anos,clasificacion f,2002-03-01,6,5,6,5,11
70704,CUEVO,estado nutricional en menores de 5 anos,clasificacion f,2002-03-01,3,1,3,1,4
10902,CULPINA,estado nutricional en menores de 5 anos,clasificacion f,2002-03-01,1,7,1,7,8
40401,CURAHUARA DE CARANGAS,estado nutricional en menores de 5 anos,clasificacion f,2002-03-01,1,0,1,0,1
20105,EL ALTO,estado nutricional en menores de 5 anos,clasificacion f,2002-03-01,89,27,89,27,116
71503,EL PUENTE(STC),estado nutricional en menores de 5 anos,clasificacion f,2002-03-01,0,8,0,8,8
60502,EL PUENTE(TJA),estado nutricional en menores de 5 anos,clasificacion f,2002-03-01,0,1,0,1,1
70105,EL TORNO,estado nutricional en menores de 5 anos,clasificacion f,2002-03-01,4,5,4,5,9
10405,EL VILLAR,estado nutricional en menores de 5 anos,clasificacion f,2002-03-01,2,4,2,4,6
60601,ENTRE RIOS,estado nutricional en menores de 5 anos,clasificacion f,2002-03-01,2,0,2,0,2
90203,FILADELFIA,estado nutricional en menores de 5 anos,clasificacion f,2002-03-01,0,9,0,9,9
71002,GENERAL SAAVEDRA,estado nutricional en menores de 5 anos,clasificacion f,2002-03-01,7,6,7,6,13
20602,GUANAY,estado nutricional en menores de 5 anos,clasificacion f,2002-03-01,1,8,1,8,9
20802,GUAQUI,estado nutricional en menores de 5 anos,clasificacion f,2002-03-01,0,2,0,2,2
80202,GUAYARAMERIN,estado nutricional en menores de 5 anos,clasificacion f,2002-03-01,6,1,6,1,7
70705,GUTIERREZ,estado nutricional en menores de 5 anos,clasificacion f,2002-03-01,3,22,3,22,25
10502,HUACARETA,estado nutricional en menores de 5 anos,clasificacion f,2002-03-01,5,17,5,17,22
11002,HUACAYA (VILLA DE HUACAYA),estado nutricional en menores de 5 anos,clasificacion f,2002-03-01,0,1,0,1,1
21005,ICHOCA,estado nutricional en menores de 5 anos,clasificacion f,2002-03-01,0,2,0,2,2
10304,ICLA,estado nutricional en menores de 5 anos,clasificacion f,2002-03-01,11,13,11,13,24
10703,INCAHUASI,estado nutricional en menores de 5 anos,clasificacion f,2002-03-01,0,15,0,15,15
21001,INQUISIVI,estado nutricional en menores de 5 anos,clasificacion f,2002-03-01,1,1,1,1,2
21501,IXIAMAS,estado nutricional en menores de 5 anos,clasificacion f,2002-03-01,2,2,2,2,4
21105,LA ASUNTA,estado nutricional en menores de 5 anos,clasificacion f,2002-03-01,1,8,1,8,9
70104,LA GUARDIA,estado nutricional en menores de 5 anos,clasificacion f,2002-03-01,2,2,2,2,4
20101,LA PAZ,estado nutricional en menores de 5 anos,clasificacion f,2002-03-01,28,22,28,22,50
70701,LAGUNILLAS,estado nutricional en menores de 5 anos,clasificacion f,2002-03-01,0,8,0,8,8
10903,LAS CARRERAS,estado nutricional en menores de 5 anos,clasificacion f,2002-03-01,0,3,0,3,3
20901,LURIBAY,estado nutricional en menores de 5 anos,clasificacion f,2002-03-01,0,1,0,1,1
11003,MACHARETI,estado nutricional en menores de 5 anos,clasificacion f,2002-03-01,2,3,2,3,5
80801,MAGDALENA,estado nutricional en menores de 5 anos,clasificacion f,2002-03-01,1,2,1,2,3
70903,MAIRANA,estado nutricional en menores de 5 anos,clasificacion f,2002-03-01,1,0,1,0,1
71003,MINEROS,estado nutricional en menores de 5 anos,clasificacion f,2002-03-01,8,6,8,6,14
31301,MIZQUE,estado nutricional en menores de 5 anos,clasificacion f,2002-03-01,0,4,0,4,4
20402,MOCOMOCO,estado nutricional en menores de 5 anos,clasificacion f,2002-03-01,1,1,1,1,2
51002,MOJINETE,estado nutricional en menores de 5 anos,clasificacion f,2002-03-01,0,1,0,1,1
10303,MOJOCOYA,estado nutricional en menores de 5 anos,clasificacion f,2002-03-01,2,3,2,3,5
10501,MONTEAGUDO,estado nutricional en menores de 5 anos,clasificacion f,2002-03-01,6,4,6,4,10
71001,MONTERO,estado nutricional en menores de 5 anos,clasificacion f,2002-03-01,2,25,2,25,27
70803,MORO MORO,estado nutricional en menores de 5 anos,clasificacion f,2002-03-01,0,1,0,1,1
30302,MOROCHATA,estado nutricional en menores de 5 anos,clasificacion f,2002-03-01,6,6,6,6,12
90401,NACEBE (SANTA ROSA DEL ABUNA),estado nutricional en menores de 5 anos,clasificacion f,2002-03-01,0,4,0,4,4
50404,OCURI,estado nutricional en menores de 5 anos,clasificacion f,2002-03-01,9,7,9,7,16
70202,OKINAWA,estado nutricional en menores de 5 anos,clasificacion f,2002-03-01,1,0,1,0,1
40101,ORURO,estado nutricional en menores de 5 anos,clasificacion f,2002-03-01,6,12,6,12,18
60201,PADCAYA,estado nutricional en menores de 5 anos,clasificacion f,2002-03-01,0,1,0,1,1
10401,PADILLA,estado nutricional en menores de 5 anos,clasificacion f,2002-03-01,5,2,5,2,7
70502,PAILON,estado nutricional en menores de 5 anos,clasificacion f,2002-03-01,0,8,0,8,8
20102,PALCA,estado nutricional en menores de 5 anos,clasificacion f,2002-03-01,1,2,1,2,3
21104,PALOS BLANCOS,estado nutricional en menores de 5 anos,clasificacion f,2002-03-01,4,5,4,5,9
70902,PAMPA GRANDE,estado nutricional en menores de 5 anos,clasificacion f,2002-03-01,1,0,1,0,1
21802,PAPEL PAMPA,estado nutricional en menores de 5 anos,clasificacion f,2002-03-01,0,1,0,1,1
21305,PATACAMAYA,estado nutricional en menores de 5 anos,clasificacion f,2002-03-01,3,0,3,0,3
40602,PAZÃ‘A,estado nutricional en menores de 5 anos,clasificacion f,2002-03-01,0,1,0,1,1
20702,PELECHUCO,estado nutricional en menores de 5 anos,clasificacion f,2002-03-01,0,3,0,3,3
50403,POCOATA,estado nutricional en menores de 5 anos,clasificacion f,2002-03-01,2,11,2,11,13
31203,POCONA,estado nutricional en menores de 5 anos,clasificacion f,2002-03-01,2,9,2,9,11
31202,POJO (CBBA),estado nutricional en menores de 5 anos,clasificacion f,2002-03-01,1,10,1,10,11
10103,POROMA,estado nutricional en menores de 5 anos,clasificacion f,2002-03-01,14,9,14,9,23
70601,PORTACHUELO,estado nutricional en menores de 5 anos,clasificacion f,2002-03-01,1,3,1,3,4
90102,PORVENIR,estado nutricional en menores de 5 anos,clasificacion f,2002-03-01,0,1,0,1,1
70804,POSTRER VALLE,estado nutricional en menores de 5 anos,clasificacion f,2002-03-01,1,1,1,1,2
50101,POTOSI,estado nutricional en menores de 5 anos,clasificacion f,2002-03-01,6,14,6,14,20
10302,PRESTO,estado nutricional en menores de 5 anos,clasificacion f,2002-03-01,5,3,5,3,8
21201,PUCARANI,estado nutricional en menores de 5 anos,clasificacion f,2002-03-01,0,1,0,1,1
20401,PUERTO ACOSTA,estado nutricional en menores de 5 anos,clasificacion f,2002-03-01,2,0,2,0,2
20403,PUERTO CARABUCO,estado nutricional en menores de 5 anos,clasificacion f,2002-03-01,1,2,1,2,3
90301,PUERTO GONZALO MORENO,estado nutricional en menores de 5 anos,clasificacion f,2002-03-01,2,0,2,0,2
71402,PUERTO QUIJARRO,estado nutricional en menores de 5 anos,clasificacion f,2002-03-01,0,1,0,1,1
71401,PUERTO SUAREZ,estado nutricional en menores de 5 anos,clasificacion f,2002-03-01,2,1,2,1,3
31205,PUERTO VILLARROEL,estado nutricional en menores de 5 anos,clasificacion f,2002-03-01,10,4,10,4,14
51101,PUNA,estado nutricional en menores de 5 anos,clasificacion f,2002-03-01,3,16,3,16,19
31401,PUNATA,estado nutricional en menores de 5 anos,clasificacion f,2002-03-01,4,5,4,5,9
30901,QUILLACOLLO,estado nutricional en menores de 5 anos,clasificacion f,2002-03-01,0,1,0,1,1
21002,QUIME,estado nutricional en menores de 5 anos,clasificacion f,2002-03-01,1,10,1,10,11
50402,RAVELO,estado nutricional en menores de 5 anos,clasificacion f,2002-03-01,21,16,21,16,37
80301,REYES,estado nutricional en menores de 5 anos,clasificacion f,2002-03-01,1,3,1,3,4
80201,RIBERALTA,estado nutricional en menores de 5 anos,clasificacion f,2002-03-01,33,18,33,18,51
70503,ROBORE,estado nutricional en menores de 5 anos,clasificacion f,2002-03-01,0,4,0,4,4
80304,RURRENABAQUE,estado nutricional en menores de 5 anos,clasificacion f,2002-03-01,4,5,4,5,9
31001,SACABA,estado nutricional en menores de 5 anos,clasificacion f,2002-03-01,4,1,4,1,5
30404,SACABAMBA,estado nutricional en menores de 5 anos,clasificacion f,2002-03-01,0,3,0,3,3
50701,SACACA,estado nutricional en menores de 5 anos,clasificacion f,2002-03-01,17,11,17,11,28
51601,SAN AGUSTIN,estado nutricional en menores de 5 anos,clasificacion f,2002-03-01,0,1,0,1,1
80602,SAN ANDRES,estado nutricional en menores de 5 anos,clasificacion f,2002-03-01,1,1,1,1,2
71105,SAN ANTONIO DE LOMERIO,estado nutricional en menores de 5 anos,clasificacion f,2002-03-01,12,11,12,11,23
31403,SAN BENITO,estado nutricional en menores de 5 anos,clasificacion f,2002-03-01,0,2,0,2,2
80302,SAN BORJA,estado nutricional en menores de 5 anos,clasificacion f,2002-03-01,6,3,6,3,9
21502,SAN BUENA VENTURA,estado nutricional en menores de 5 anos,clasificacion f,2002-03-01,12,10,12,10,22
80501,SAN IGNACIO,estado nutricional en menores de 5 anos,clasificacion f,2002-03-01,3,14,3,14,17
70301,SAN IGNACIO DE VELASCO,estado nutricional en menores de 5 anos,clasificacion f,2002-03-01,15,19,15,19,34
80102,SAN JAVIER(BNI),estado nutricional en menores de 5 anos,clasificacion f,2002-03-01,0,1,0,1,1
71102,SAN JAVIER(STC),estado nutricional en menores de 5 anos,clasificacion f,2002-03-01,0,1,0,1,1
70501,SAN JOSE DE CHIQUITOS,estado nutricional en menores de 5 anos,clasificacion f,2002-03-01,7,4,7,4,11
71104,SAN JULIAN,estado nutricional en menores de 5 anos,clasificacion f,2002-03-01,7,7,7,7,14
60501,SAN LORENZO(TJA),estado nutricional en menores de 5 anos,clasificacion f,2002-03-01,0,1,0,1,1
10702,SAN LUCAS,estado nutricional en menores de 5 anos,clasificacion f,2002-03-01,3,31,3,31,34
71201,SAN MATIAS,estado nutricional en menores de 5 anos,clasificacion f,2002-03-01,3,1,3,1,4
70302,SAN MIGUEL DE VELASCO,estado nutricional en menores de 5 anos,clasificacion f,2002-03-01,3,0,3,0,3
51001,SAN PABLO DE LIPEZ,estado nutricional en menores de 5 anos,clasificacion f,2002-03-01,0,1,0,1,1
50501,SAN PEDRO DE BUENA VISTA,estado nutricional en menores de 5 anos,clasificacion f,2002-03-01,0,22,0,22,22
21801,SAN PEDRO DE CURAHUARA,estado nutricional en menores de 5 anos,clasificacion f,2002-03-01,1,0,1,0,1
70303,SAN RAFAEL,estado nutricional en menores de 5 anos,clasificacion f,2002-03-01,1,0,1,0,1
70101,SANTA CRUZ DE LA SIERRA,estado nutricional en menores de 5 anos,clasificacion f,2002-03-01,18,15,18,15,33
41401,SANTIAGO DE HUARI,estado nutricional en menores de 5 anos,clasificacion f,2002-03-01,1,0,1,0,1
30702,SANTIVAÃ‘ES,estado nutricional en menores de 5 anos,clasificacion f,2002-03-01,1,1,1,1,2
21301,SICA SICA (VILLA AROMA),estado nutricional en menores de 5 anos,clasificacion f,2002-03-01,0,1,0,1,1
30703,SICAYA,estado nutricional en menores de 5 anos,clasificacion f,2002-03-01,0,1,0,1,1
30902,SIPE SIPE,estado nutricional en menores de 5 anos,clasificacion f,2002-03-01,11,4,11,4,15
10403,SOPACHUY,estado nutricional en menores de 5 anos,clasificacion f,2002-03-01,12,4,12,4,16
20601,SORATA,estado nutricional en menores de 5 anos,clasificacion f,2002-03-01,0,2,0,2,2
10101,SUCRE,estado nutricional en menores de 5 anos,clasificacion f,2002-03-01,11,29,11,29,40
31404,TACACHI,estado nutricional en menores de 5 anos,clasificacion f,2002-03-01,0,1,0,1,1
20603,TACACOMA,estado nutricional en menores de 5 anos,clasificacion f,2002-03-01,1,1,1,1,2
50303,TACOBAMBA,estado nutricional en menores de 5 anos,clasificacion f,2002-03-01,0,1,0,1,1
30602,TACOPAYA,estado nutricional en menores de 5 anos,clasificacion f,2002-03-01,0,2,0,2,2
31101,TAPACARI,estado nutricional en menores de 5 anos,clasificacion f,2002-03-01,0,12,0,12,12
10601,TARABUCO,estado nutricional en menores de 5 anos,clasificacion f,2002-03-01,4,32,4,32,36
30401,TARATA,estado nutricional en menores de 5 anos,clasificacion f,2002-03-01,0,1,0,1,1
60101,TARIJA,estado nutricional en menores de 5 anos,clasificacion f,2002-03-01,2,5,2,5,7
10202,TARVITA,estado nutricional en menores de 5 anos,clasificacion f,2002-03-01,3,0,3,0,3
20803,TIAWANACU,estado nutricional en menores de 5 anos,clasificacion f,2002-03-01,1,0,1,0,1
50102,TINGUIPAYA,estado nutricional en menores de 5 anos,clasificacion f,2002-03-01,4,8,4,8,12
20606,TIPUANI,estado nutricional en menores de 5 anos,clasificacion f,2002-03-01,1,0,1,0,1
30903,TIQUIPAYA,estado nutricional en menores de 5 anos,clasificacion f,2002-03-01,0,3,0,3,3
31601,TIRAQUE (CBBA),estado nutricional en menores de 5 anos,clasificacion f,2002-03-01,5,6,5,6,11
21703,TITO YUPANQUI (PARQUIPUJIO),estado nutricional en menores de 5 anos,clasificacion f,2002-03-01,0,6,0,6,6
30802,TOCO,estado nutricional en menores de 5 anos,clasificacion f,2002-03-01,0,1,0,1,1
51202,TOMAVE,estado nutricional en menores de 5 anos,clasificacion f,2002-03-01,0,7,0,7,7
10402,TOMINA,estado nutricional en menores de 5 anos,clasificacion f,2002-03-01,8,8,8,8,16
50502,TORO TORO,estado nutricional en menores de 5 anos,clasificacion f,2002-03-01,1,2,1,2,3
31201,TOTORA(CBBA),estado nutricional en menores de 5 anos,clasificacion f,2002-03-01,10,2,10,2,12
41301,TOTORA(ORR),estado nutricional en menores de 5 anos,clasificacion f,2002-03-01,0,3,0,3,3
80101,TRINIDAD,estado nutricional en menores de 5 anos,clasificacion f,2002-03-01,5,11,5,11,16
50801,TUPIZA,estado nutricional en menores de 5 anos,clasificacion f,2002-03-01,0,8,0,8,8
60401,URIONDO (A. CONCEPCION),estado nutricional en menores de 5 anos,clasificacion f,2002-03-01,1,1,1,1,2
51201,UYUNI,estado nutricional en menores de 5 anos,clasificacion f,2002-03-01,0,5,0,5,5
30502,VACAS,estado nutricional en menores de 5 anos,clasificacion f,2002-03-01,0,1,0,1,1
70801,VALLEGRANDE,estado nutricional en menores de 5 anos,clasificacion f,2002-03-01,3,1,3,1,4
20801,VIACHA,estado nutricional en menores de 5 anos,clasificacion f,2002-03-01,0,3,0,3,3
31302,VILA VILA,estado nutricional en menores de 5 anos,clasificacion f,2002-03-01,0,11,0,11,11
60303,VILLA MONTES,estado nutricional en menores de 5 anos,clasificacion f,2002-03-01,4,4,4,4,8
31402,VILLA RIVERO,estado nutricional en menores de 5 anos,clasificacion f,2002-03-01,0,3,0,3,3
10801,VILLA SERRANO,estado nutricional en menores de 5 anos,clasificacion f,2002-03-01,6,12,6,12,18
31003,VILLA TUNARI,estado nutricional en menores de 5 anos,clasificacion f,2002-03-01,6,7,6,7,13
11001,VILLA VACA GUZMAN (MUYUPAMPA),estado nutricional en menores de 5 anos,clasificacion f,2002-03-01,3,1,3,1,4
51501,VILLAZON,estado nutricional en menores de 5 anos,clasificacion f,2002-03-01,0,4,0,4,4
30904,VINTO,estado nutricional en menores de 5 anos,clasificacion f,2002-03-01,10,3,10,3,13
50602,VITICHI,estado nutricional en menores de 5 anos,clasificacion f,2002-03-01,1,6,1,6,7
70201,WARNES,estado nutricional en menores de 5 anos,clasificacion f,2002-03-01,4,1,4,1,5
20903,YACO,estado nutricional en menores de 5 anos,clasificacion f,2002-03-01,0,2,0,2,2
60301,YACUIBA,estado nutricional en menores de 5 anos,clasificacion f,2002-03-01,0,2,0,2,2
10602,YAMPARAEZ,estado nutricional en menores de 5 anos,clasificacion f,2002-03-01,14,4,14,4,18
70403,YAPACANI,estado nutricional en menores de 5 anos,clasificacion f,2002-03-01,3,2,3,2,5
50103,YOCALLA,estado nutricional en menores de 5 anos,clasificacion f,2002-03-01,1,1,1,1,2
10102,YOTALA,estado nutricional en menores de 5 anos,clasificacion f,2002-03-01,4,0,4,0,4
60402,YUNCHARA,estado nutricional en menores de 5 anos,clasificacion f,2002-03-01,3,7,3,7,10
10301,ZUDAÃ‘EZ,estado nutricional en menores de 5 anos,clasificacion f,2002-03-01,7,6,7,6,13
51302,ACACIO,estado nutricional en menores de 5 anos,clasificacion f,2002-04-01,0,9,0,9,9
20201,ACHACACHI,estado nutricional en menores de 5 anos,clasificacion f,2002-04-01,2,0,2,0,2
20104,ACHOCALLA,estado nutricional en menores de 5 anos,clasificacion f,2002-04-01,0,1,0,1,1
30201,AIQUILE,estado nutricional en menores de 5 anos,clasificacion f,2002-04-01,8,4,8,4,12
10404,ALCALA,estado nutricional en menores de 5 anos,clasificacion f,2002-04-01,5,2,5,2,7
20202,ANCORAIMES,estado nutricional en menores de 5 anos,clasificacion f,2002-04-01,2,4,2,4,6
30402,ANZALDO,estado nutricional en menores de 5 anos,clasificacion f,2002-04-01,0,7,0,7,7
20701,APOLO,estado nutricional en menores de 5 anos,clasificacion f,2002-04-01,2,2,2,2,4
51301,ARAMPAMPA,estado nutricional en menores de 5 anos,clasificacion f,2002-04-01,0,10,0,10,10
30501,ARANI,estado nutricional en menores de 5 anos,clasificacion f,2002-04-01,1,2,1,2,3
30403,ARBIETO,estado nutricional en menores de 5 anos,clasificacion f,2002-04-01,2,0,2,0,2
30601,ARQUE,estado nutricional en menores de 5 anos,clasificacion f,2002-04-01,0,1,0,1,1
71501,ASCENCION DE GUARAYOS,estado nutricional en menores de 5 anos,clasificacion f,2002-04-01,5,4,5,4,9
50802,ATOCHA,estado nutricional en menores de 5 anos,clasificacion f,2002-04-01,0,8,0,8,8
20503,AUCAPATA,estado nutricional en menores de 5 anos,clasificacion f,2002-04-01,1,0,1,0,1
21303,AYO AYO,estado nutricional en menores de 5 anos,clasificacion f,2002-04-01,2,0,2,0,2
30301,AYOPAYA (V. DE INDEPENDENCIA),estado nutricional en menores de 5 anos,clasificacion f,2002-04-01,8,6,8,6,14
10201,AZURDUY,estado nutricional en menores de 5 anos,clasificacion f,2002-04-01,14,3,14,3,17
80802,BAURES,estado nutricional en menores de 5 anos,clasificacion f,2002-04-01,0,1,0,1,1
60202,BERMEJO,estado nutricional en menores de 5 anos,clasificacion f,2002-04-01,1,0,1,0,1
50301,BETANZOS,estado nutricional en menores de 5 anos,clasificacion f,2002-04-01,4,14,4,14,18
31501,BOLIVAR,estado nutricional en menores de 5 anos,clasificacion f,2002-04-01,6,0,6,0,6
70707,BOYUIBE,estado nutricional en menores de 5 anos,clasificacion f,2002-04-01,0,1,0,1,1
70401,BUENA VISTA,estado nutricional en menores de 5 anos,clasificacion f,2002-04-01,1,0,1,0,1
70703,CABEZAS,estado nutricional en menores de 5 anos,clasificacion f,2002-04-01,0,2,0,2,2
20905,CAIROMA,estado nutricional en menores de 5 anos,clasificacion f,2002-04-01,0,3,0,3,3
51102,"CAIZA ""D""",estado nutricional en menores de 5 anos,clasificacion f,2002-04-01,2,1,2,1,3
10701,CAMARGO,estado nutricional en menores de 5 anos,clasificacion f,2002-04-01,0,2,0,2,2
10901,CAMATAQUI (C. VILLA ABECIA),estado nutricional en menores de 5 anos,clasificacion f,2002-04-01,0,1,0,1,1
70706,CAMIRI,estado nutricional en menores de 5 anos,clasificacion f,2002-04-01,16,12,16,12,28
30701,CAPINOTA,estado nutricional en menores de 5 anos,clasificacion f,2002-04-01,3,0,3,0,3
20302,CAQUIAVIRI,estado nutricional en menores de 5 anos,clasificacion f,2002-04-01,1,0,1,0,1
40102,CARACOLLO,estado nutricional en menores de 5 anos,clasificacion f,2002-04-01,1,2,1,2,3
22001,CARANAVI,estado nutricional en menores de 5 anos,clasificacion f,2002-04-01,9,6,9,6,15
60302,CARAPARI,estado nutricional en menores de 5 anos,clasificacion f,2002-04-01,1,3,1,3,4
50702,CARIPUYO,estado nutricional en menores de 5 anos,clasificacion f,2002-04-01,2,3,2,3,5
40201,CHALLAPATA,estado nutricional en menores de 5 anos,clasificacion f,2002-04-01,2,3,2,3,5
50302,CHAQUI,estado nutricional en menores de 5 anos,clasificacion f,2002-04-01,0,2,0,2,2
70702,CHARAGUA,estado nutricional en menores de 5 anos,clasificacion f,2002-04-01,0,12,0,12,12
20305,CHARAÃ‘A,estado nutricional en menores de 5 anos,clasificacion f,2002-04-01,0,2,0,2,2
31204,CHIMORE,estado nutricional en menores de 5 anos,clasificacion f,2002-04-01,2,0,2,0,2
20501,CHUMA,estado nutricional en menores de 5 anos,clasificacion f,2002-04-01,1,0,1,0,1
30801,CLIZA,estado nutricional en menores de 5 anos,clasificacion f,2002-04-01,1,9,1,9,10
90101,COBIJA,estado nutricional en menores de 5 anos,clasificacion f,2002-04-01,9,1,9,1,10
30101,COCHABAMBA,estado nutricional en menores de 5 anos,clasificacion f,2002-04-01,9,11,9,11,20
30905,COLCAPIRHUA,estado nutricional en menores de 5 anos,clasificacion f,2002-04-01,1,1,1,1,2
50901,"COLCHA ""K""",estado nutricional en menores de 5 anos,clasificacion f,2002-04-01,0,1,0,1,1
31002,COLOMI,estado nutricional en menores de 5 anos,clasificacion f,2002-04-01,3,7,3,7,10
50401,COLQUECHACA,estado nutricional en menores de 5 anos,clasificacion f,2002-04-01,1,5,1,5,6
21004,COLQUIRI,estado nutricional en menores de 5 anos,clasificacion f,2002-04-01,1,1,1,1,2
71301,COMARAPA,estado nutricional en menores de 5 anos,clasificacion f,2002-04-01,0,3,0,3,3
20605,COMBAYA,estado nutricional en menores de 5 anos,clasificacion f,2002-04-01,1,1,1,1,2
20301,CORO CORO,estado nutricional en menores de 5 anos,clasificacion f,2002-04-01,2,0,2,0,2
50601,COTAGAITA,estado nutricional en menores de 5 anos,clasificacion f,2002-04-01,1,4,1,4,5
70102,COTOCA,estado nutricional en menores de 5 anos,clasificacion f,2002-04-01,1,2,1,2,3
31405,CUCHUMUELA (V. G. VILLARROEL),estado nutricional en menores de 5 anos,clasificacion f,2002-04-01,0,5,0,5,5
70704,CUEVO,estado nutricional en menores de 5 anos,clasificacion f,2002-04-01,0,1,0,1,1
10902,CULPINA,estado nutricional en menores de 5 anos,clasificacion f,2002-04-01,3,0,3,0,3
20105,EL ALTO,estado nutricional en menores de 5 anos,clasificacion f,2002-04-01,72,56,72,56,128
71503,EL PUENTE(STC),estado nutricional en menores de 5 anos,clasificacion f,2002-04-01,7,2,7,2,9
60502,EL PUENTE(TJA),estado nutricional en menores de 5 anos,clasificacion f,2002-04-01,1,1,1,1,2
70105,EL TORNO,estado nutricional en menores de 5 anos,clasificacion f,2002-04-01,1,0,1,0,1
10405,EL VILLAR,estado nutricional en menores de 5 anos,clasificacion f,2002-04-01,5,3,5,3,8
60601,ENTRE RIOS,estado nutricional en menores de 5 anos,clasificacion f,2002-04-01,1,1,1,1,2
41101,EUCALIPTUS,estado nutricional en menores de 5 anos,clasificacion f,2002-04-01,0,1,0,1,1
80402,EXALTACION,estado nutricional en menores de 5 anos,clasificacion f,2002-04-01,0,3,0,3,3
90203,FILADELFIA,estado nutricional en menores de 5 anos,clasificacion f,2002-04-01,0,11,0,11,11
21601,GRAL. J.J. PEREZ (CHARAZANI),estado nutricional en menores de 5 anos,clasificacion f,2002-04-01,1,1,1,1,2
20602,GUANAY,estado nutricional en menores de 5 anos,clasificacion f,2002-04-01,1,12,1,12,13
80202,GUAYARAMERIN,estado nutricional en menores de 5 anos,clasificacion f,2002-04-01,3,1,3,1,4
70705,GUTIERREZ,estado nutricional en menores de 5 anos,clasificacion f,2002-04-01,1,15,1,15,16
10502,HUACARETA,estado nutricional en menores de 5 anos,clasificacion f,2002-04-01,5,2,5,2,7
11002,HUACAYA (VILLA DE HUACAYA),estado nutricional en menores de 5 anos,clasificacion f,2002-04-01,1,0,1,0,1
80803,HUARACAJE,estado nutricional en menores de 5 anos,clasificacion f,2002-04-01,2,0,2,0,2
10304,ICLA,estado nutricional en menores de 5 anos,clasificacion f,2002-04-01,10,2,10,2,12
10703,INCAHUASI,estado nutricional en menores de 5 anos,clasificacion f,2002-04-01,1,14,1,14,15
21001,INQUISIVI,estado nutricional en menores de 5 anos,clasificacion f,2002-04-01,0,1,0,1,1
21501,IXIAMAS,estado nutricional en menores de 5 anos,clasificacion f,2002-04-01,4,1,4,1,5
21105,LA ASUNTA,estado nutricional en menores de 5 anos,clasificacion f,2002-04-01,3,2,3,2,5
70104,LA GUARDIA,estado nutricional en menores de 5 anos,clasificacion f,2002-04-01,5,0,5,0,5
20101,LA PAZ,estado nutricional en menores de 5 anos,clasificacion f,2002-04-01,46,18,46,18,64
70701,LAGUNILLAS,estado nutricional en menores de 5 anos,clasificacion f,2002-04-01,2,3,2,3,5
11003,MACHARETI,estado nutricional en menores de 5 anos,clasificacion f,2002-04-01,3,4,3,4,7
70903,MAIRANA,estado nutricional en menores de 5 anos,clasificacion f,2002-04-01,2,0,2,0,2
20904,MALLA,estado nutricional en menores de 5 anos,clasificacion f,2002-04-01,0,2,0,2,2
71003,MINEROS,estado nutricional en menores de 5 anos,clasificacion f,2002-04-01,3,2,3,2,5
31301,MIZQUE,estado nutricional en menores de 5 anos,clasificacion f,2002-04-01,1,3,1,3,4
20402,MOCOMOCO,estado nutricional en menores de 5 anos,clasificacion f,2002-04-01,1,0,1,0,1
10303,MOJOCOYA,estado nutricional en menores de 5 anos,clasificacion f,2002-04-01,5,3,5,3,8
10501,MONTEAGUDO,estado nutricional en menores de 5 anos,clasificacion f,2002-04-01,4,2,4,2,6
70803,MORO MORO,estado nutricional en menores de 5 anos,clasificacion f,2002-04-01,2,1,2,1,3
30302,MOROCHATA,estado nutricional en menores de 5 anos,clasificacion f,2002-04-01,0,4,0,4,4
90401,NACEBE (SANTA ROSA DEL ABUNA),estado nutricional en menores de 5 anos,clasificacion f,2002-04-01,0,5,0,5,5
50404,OCURI,estado nutricional en menores de 5 anos,clasificacion f,2002-04-01,4,4,4,4,8
70202,OKINAWA,estado nutricional en menores de 5 anos,clasificacion f,2002-04-01,1,0,1,0,1
40101,ORURO,estado nutricional en menores de 5 anos,clasificacion f,2002-04-01,18,8,18,8,26
60201,PADCAYA,estado nutricional en menores de 5 anos,clasificacion f,2002-04-01,3,3,3,3,6
10401,PADILLA,estado nutricional en menores de 5 anos,clasificacion f,2002-04-01,8,2,8,2,10
70502,PAILON,estado nutricional en menores de 5 anos,clasificacion f,2002-04-01,0,2,0,2,2
21104,PALOS BLANCOS,estado nutricional en menores de 5 anos,clasificacion f,2002-04-01,1,4,1,4,5
70902,PAMPA GRANDE,estado nutricional en menores de 5 anos,clasificacion f,2002-04-01,0,2,0,2,2
30202,PASORAPA,estado nutricional en menores de 5 anos,clasificacion f,2002-04-01,0,2,0,2,2
40602,PAZÃ‘A,estado nutricional en menores de 5 anos,clasificacion f,2002-04-01,1,1,1,1,2
20702,PELECHUCO,estado nutricional en menores de 5 anos,clasificacion f,2002-04-01,1,1,1,1,2
50403,POCOATA,estado nutricional en menores de 5 anos,clasificacion f,2002-04-01,1,2,1,2,3
31203,POCONA,estado nutricional en menores de 5 anos,clasificacion f,2002-04-01,4,11,4,11,15
31202,POJO (CBBA),estado nutricional en menores de 5 anos,clasificacion f,2002-04-01,0,6,0,6,6
40601,POOPO,estado nutricional en menores de 5 anos,clasificacion f,2002-04-01,0,1,0,1,1
10103,POROMA,estado nutricional en menores de 5 anos,clasificacion f,2002-04-01,4,0,4,0,4
70103,PORONGO,estado nutricional en menores de 5 anos,clasificacion f,2002-04-01,1,0,1,0,1
70601,PORTACHUELO,estado nutricional en menores de 5 anos,clasificacion f,2002-04-01,2,2,2,2,4
90102,PORVENIR,estado nutricional en menores de 5 anos,clasificacion f,2002-04-01,2,0,2,0,2
50101,POTOSI,estado nutricional en menores de 5 anos,clasificacion f,2002-04-01,13,20,13,20,33
10302,PRESTO,estado nutricional en menores de 5 anos,clasificacion f,2002-04-01,15,4,15,4,19
21201,PUCARANI,estado nutricional en menores de 5 anos,clasificacion f,2002-04-01,0,2,0,2,2
20401,PUERTO ACOSTA,estado nutricional en menores de 5 anos,clasificacion f,2002-04-01,1,0,1,0,1
20403,PUERTO CARABUCO,estado nutricional en menores de 5 anos,clasificacion f,2002-04-01,5,0,5,0,5
71402,PUERTO QUIJARRO,estado nutricional en menores de 5 anos,clasificacion f,2002-04-01,7,2,7,2,9
71401,PUERTO SUAREZ,estado nutricional en menores de 5 anos,clasificacion f,2002-04-01,5,2,5,2,7
31205,PUERTO VILLARROEL,estado nutricional en menores de 5 anos,clasificacion f,2002-04-01,10,7,10,7,17
51101,PUNA,estado nutricional en menores de 5 anos,clasificacion f,2002-04-01,6,8,6,8,14
31401,PUNATA,estado nutricional en menores de 5 anos,clasificacion f,2002-04-01,1,15,1,15,16
20604,QUIABAYA,estado nutricional en menores de 5 anos,clasificacion f,2002-04-01,6,1,6,1,7
30901,QUILLACOLLO,estado nutricional en menores de 5 anos,clasificacion f,2002-04-01,1,0,1,0,1
21002,QUIME,estado nutricional en menores de 5 anos,clasificacion f,2002-04-01,1,12,1,12,13
50402,RAVELO,estado nutricional en menores de 5 anos,clasificacion f,2002-04-01,8,12,8,12,20
80301,REYES,estado nutricional en menores de 5 anos,clasificacion f,2002-04-01,1,0,1,0,1
80201,RIBERALTA,estado nutricional en menores de 5 anos,clasificacion f,2002-04-01,46,27,46,27,73
70503,ROBORE,estado nutricional en menores de 5 anos,clasificacion f,2002-04-01,0,4,0,4,4
80304,RURRENABAQUE,estado nutricional en menores de 5 anos,clasificacion f,2002-04-01,5,3,5,3,8
40901,SABAYA,estado nutricional en menores de 5 anos,clasificacion f,2002-04-01,0,1,0,1,1
31001,SACABA,estado nutricional en menores de 5 anos,clasificacion f,2002-04-01,2,7,2,7,9
50701,SACACA,estado nutricional en menores de 5 anos,clasificacion f,2002-04-01,22,13,22,13,35
71302,SAIPINA,estado nutricional en menores de 5 anos,clasificacion f,2002-04-01,1,0,1,0,1
40801,SALINAS DE GARCI MENDOZA,estado nutricional en menores de 5 anos,clasificacion f,2002-04-01,0,2,0,2,2
80602,SAN ANDRES,estado nutricional en menores de 5 anos,clasificacion f,2002-04-01,2,0,2,0,2
71105,SAN ANTONIO DE LOMERIO,estado nutricional en menores de 5 anos,clasificacion f,2002-04-01,6,8,6,8,14
80302,SAN BORJA,estado nutricional en menores de 5 anos,clasificacion f,2002-04-01,9,3,9,3,12
21502,SAN BUENA VENTURA,estado nutricional en menores de 5 anos,clasificacion f,2002-04-01,6,2,6,2,8
80501,SAN IGNACIO,estado nutricional en menores de 5 anos,clasificacion f,2002-04-01,0,11,0,11,11
70301,SAN IGNACIO DE VELASCO,estado nutricional en menores de 5 anos,clasificacion f,2002-04-01,16,9,16,9,25
80102,SAN JAVIER(BNI),estado nutricional en menores de 5 anos,clasificacion f,2002-04-01,0,1,0,1,1
70501,SAN JOSE DE CHIQUITOS,estado nutricional en menores de 5 anos,clasificacion f,2002-04-01,6,1,6,1,7
71104,SAN JULIAN,estado nutricional en menores de 5 anos,clasificacion f,2002-04-01,11,16,11,16,27
60501,SAN LORENZO(TJA),estado nutricional en menores de 5 anos,clasificacion f,2002-04-01,1,0,1,0,1
10702,SAN LUCAS,estado nutricional en menores de 5 anos,clasificacion f,2002-04-01,29,9,29,9,38
71201,SAN MATIAS,estado nutricional en menores de 5 anos,clasificacion f,2002-04-01,7,2,7,2,9
70302,SAN MIGUEL DE VELASCO,estado nutricional en menores de 5 anos,clasificacion f,2002-04-01,7,2,7,2,9
50501,SAN PEDRO DE BUENA VISTA,estado nutricional en menores de 5 anos,clasificacion f,2002-04-01,0,22,0,22,22
80401,SANTA ANA,estado nutricional en menores de 5 anos,clasificacion f,2002-04-01,1,1,1,1,2
70101,SANTA CRUZ DE LA SIERRA,estado nutricional en menores de 5 anos,clasificacion f,2002-04-01,15,20,15,20,35
80303,SANTA ROSA,estado nutricional en menores de 5 anos,clasificacion f,2002-04-01,1,0,1,0,1
70602,SANTA ROSA DEL SARA,estado nutricional en menores de 5 anos,clasificacion f,2002-04-01,0,1,0,1,1
41401,SANTIAGO DE HUARI,estado nutricional en menores de 5 anos,clasificacion f,2002-04-01,3,1,3,1,4
30702,SANTIVAÃ‘ES,estado nutricional en menores de 5 anos,clasificacion f,2002-04-01,3,2,3,2,5
40202,SANTUARIO DE QUILLACAS,estado nutricional en menores de 5 anos,clasificacion f,2002-04-01,1,0,1,0,1
30703,SICAYA,estado nutricional en menores de 5 anos,clasificacion f,2002-04-01,0,1,0,1,1
30902,SIPE SIPE,estado nutricional en menores de 5 anos,clasificacion f,2002-04-01,4,20,4,20,24
10403,SOPACHUY,estado nutricional en menores de 5 anos,clasificacion f,2002-04-01,19,4,19,4,23
10101,SUCRE,estado nutricional en menores de 5 anos,clasificacion f,2002-04-01,23,20,23,20,43
50303,TACOBAMBA,estado nutricional en menores de 5 anos,clasificacion f,2002-04-01,4,3,4,3,7
30602,TACOPAYA,estado nutricional en menores de 5 anos,clasificacion f,2002-04-01,1,3,1,3,4
31101,TAPACARI,estado nutricional en menores de 5 anos,clasificacion f,2002-04-01,0,7,0,7,7
10601,TARABUCO,estado nutricional en menores de 5 anos,clasificacion f,2002-04-01,13,31,13,31,44
30401,TARATA,estado nutricional en menores de 5 anos,clasificacion f,2002-04-01,0,3,0,3,3
60101,TARIJA,estado nutricional en menores de 5 anos,clasificacion f,2002-04-01,5,7,5,7,12
10202,TARVITA,estado nutricional en menores de 5 anos,clasificacion f,2002-04-01,7,4,7,4,11
50102,TINGUIPAYA,estado nutricional en menores de 5 anos,clasificacion f,2002-04-01,0,6,0,6,6
30903,TIQUIPAYA,estado nutricional en menores de 5 anos,clasificacion f,2002-04-01,0,2,0,2,2
31601,TIRAQUE (CBBA),estado nutricional en menores de 5 anos,clasificacion f,2002-04-01,10,10,10,10,20
21703,TITO YUPANQUI (PARQUIPUJIO),estado nutricional en menores de 5 anos,clasificacion f,2002-04-01,0,1,0,1,1
51202,TOMAVE,estado nutricional en menores de 5 anos,clasificacion f,2002-04-01,0,8,0,8,8
10402,TOMINA,estado nutricional en menores de 5 anos,clasificacion f,2002-04-01,6,6,6,6,12
50502,TORO TORO,estado nutricional en menores de 5 anos,clasificacion f,2002-04-01,0,3,0,3,3
31201,TOTORA(CBBA),estado nutricional en menores de 5 anos,clasificacion f,2002-04-01,1,8,1,8,9
41301,TOTORA(ORR),estado nutricional en menores de 5 anos,clasificacion f,2002-04-01,0,1,0,1,1
80101,TRINIDAD,estado nutricional en menores de 5 anos,clasificacion f,2002-04-01,10,12,10,12,22
50801,TUPIZA,estado nutricional en menores de 5 anos,clasificacion f,2002-04-01,1,9,1,9,10
60401,URIONDO (A. CONCEPCION),estado nutricional en menores de 5 anos,clasificacion f,2002-04-01,0,1,0,1,1
71502,URUBICHA,estado nutricional en menores de 5 anos,clasificacion f,2002-04-01,7,5,7,5,12
51201,UYUNI,estado nutricional en menores de 5 anos,clasificacion f,2002-04-01,0,4,0,4,4
30502,VACAS,estado nutricional en menores de 5 anos,clasificacion f,2002-04-01,0,3,0,3,3
70801,VALLEGRANDE,estado nutricional en menores de 5 anos,clasificacion f,2002-04-01,1,0,1,0,1
20801,VIACHA,estado nutricional en menores de 5 anos,clasificacion f,2002-04-01,1,1,1,1,2
31302,VILA VILA,estado nutricional en menores de 5 anos,clasificacion f,2002-04-01,0,4,0,4,4
60303,VILLA MONTES,estado nutricional en menores de 5 anos,clasificacion f,2002-04-01,1,3,1,3,4
31402,VILLA RIVERO,estado nutricional en menores de 5 anos,clasificacion f,2002-04-01,0,2,0,2,2
10801,VILLA SERRANO,estado nutricional en menores de 5 anos,clasificacion f,2002-04-01,7,29,7,29,36
31003,VILLA TUNARI,estado nutricional en menores de 5 anos,clasificacion f,2002-04-01,23,4,23,4,27
11001,VILLA VACA GUZMAN (MUYUPAMPA),estado nutricional en menores de 5 anos,clasificacion f,2002-04-01,1,2,1,2,3
51501,VILLAZON,estado nutricional en menores de 5 anos,clasificacion f,2002-04-01,2,6,2,6,8
30904,VINTO,estado nutricional en menores de 5 anos,clasificacion f,2002-04-01,8,1,8,1,9
50602,VITICHI,estado nutricional en menores de 5 anos,clasificacion f,2002-04-01,0,3,0,3,3
70201,WARNES,estado nutricional en menores de 5 anos,clasificacion f,2002-04-01,6,5,6,5,11
20903,YACO,estado nutricional en menores de 5 anos,clasificacion f,2002-04-01,0,2,0,2,2
60301,YACUIBA,estado nutricional en menores de 5 anos,clasificacion f,2002-04-01,4,2,4,2,6
10602,YAMPARAEZ,estado nutricional en menores de 5 anos,clasificacion f,2002-04-01,12,2,12,2,14
21103,YANACACHI,estado nutricional en menores de 5 anos,clasificacion f,2002-04-01,0,1,0,1,1
70403,YAPACANI,estado nutricional en menores de 5 anos,clasificacion f,2002-04-01,0,9,0,9,9
10102,YOTALA,estado nutricional en menores de 5 anos,clasificacion f,2002-04-01,11,1,11,1,12
60402,YUNCHARA,estado nutricional en menores de 5 anos,clasificacion f,2002-04-01,0,1,0,1,1
10301,ZUDAÃ‘EZ,estado nutricional en menores de 5 anos,clasificacion f,2002-04-01,9,4,9,4,13
51302,ACACIO,estado nutricional en menores de 5 anos,clasificacion f,2002-05-01,1,6,1,6,7
20201,ACHACACHI,estado nutricional en menores de 5 anos,clasificacion f,2002-05-01,9,3,9,3,12
20104,ACHOCALLA,estado nutricional en menores de 5 anos,clasificacion f,2002-05-01,1,0,1,0,1
30201,AIQUILE,estado nutricional en menores de 5 anos,clasificacion f,2002-05-01,6,7,6,7,13
10404,ALCALA,estado nutricional en menores de 5 anos,clasificacion f,2002-05-01,2,1,2,1,3
20202,ANCORAIMES,estado nutricional en menores de 5 anos,clasificacion f,2002-05-01,1,4,1,4,5
30402,ANZALDO,estado nutricional en menores de 5 anos,clasificacion f,2002-05-01,0,6,0,6,6
20701,APOLO,estado nutricional en menores de 5 anos,clasificacion f,2002-05-01,2,1,2,1,3
51301,ARAMPAMPA,estado nutricional en menores de 5 anos,clasificacion f,2002-05-01,4,4,4,4,8
30501,ARANI,estado nutricional en menores de 5 anos,clasificacion f,2002-05-01,1,1,1,1,2
30403,ARBIETO,estado nutricional en menores de 5 anos,clasificacion f,2002-05-01,0,1,0,1,1
30601,ARQUE,estado nutricional en menores de 5 anos,clasificacion f,2002-05-01,11,1,11,1,12
50802,ATOCHA,estado nutricional en menores de 5 anos,clasificacion f,2002-05-01,0,2,0,2,2
20502,AYATA,estado nutricional en menores de 5 anos,clasificacion f,2002-05-01,1,12,1,12,13
21303,AYO AYO,estado nutricional en menores de 5 anos,clasificacion f,2002-05-01,1,0,1,0,1
30301,AYOPAYA (V. DE INDEPENDENCIA),estado nutricional en menores de 5 anos,clasificacion f,2002-05-01,10,1,10,1,11
10201,AZURDUY,estado nutricional en menores de 5 anos,clasificacion f,2002-05-01,11,2,11,2,13
21203,BATALLAS,estado nutricional en menores de 5 anos,clasificacion f,2002-05-01,1,2,1,2,3
80802,BAURES,estado nutricional en menores de 5 anos,clasificacion f,2002-05-01,0,1,0,1,1
50301,BETANZOS,estado nutricional en menores de 5 anos,clasificacion f,2002-05-01,14,15,14,15,29
31501,BOLIVAR,estado nutricional en menores de 5 anos,clasificacion f,2002-05-01,1,3,1,3,4
70707,BOYUIBE,estado nutricional en menores de 5 anos,clasificacion f,2002-05-01,6,4,6,4,10
70401,BUENA VISTA,estado nutricional en menores de 5 anos,clasificacion f,2002-05-01,2,0,2,0,2
70703,CABEZAS,estado nutricional en menores de 5 anos,clasificacion f,2002-05-01,0,1,0,1,1
20905,CAIROMA,estado nutricional en menores de 5 anos,clasificacion f,2002-05-01,0,1,0,1,1
51102,"CAIZA ""D""",estado nutricional en menores de 5 anos,clasificacion f,2002-05-01,5,5,5,5,10
21003,CAJUATA,estado nutricional en menores de 5 anos,clasificacion f,2002-05-01,1,1,1,1,2
21304,CALAMARCA,estado nutricional en menores de 5 anos,clasificacion f,2002-05-01,2,2,2,2,4
10701,CAMARGO,estado nutricional en menores de 5 anos,clasificacion f,2002-05-01,1,2,1,2,3
70706,CAMIRI,estado nutricional en menores de 5 anos,clasificacion f,2002-05-01,2,5,2,5,7
30701,CAPINOTA,estado nutricional en menores de 5 anos,clasificacion f,2002-05-01,7,1,7,1,8
20302,CAQUIAVIRI,estado nutricional en menores de 5 anos,clasificacion f,2002-05-01,1,1,1,1,2
40102,CARACOLLO,estado nutricional en menores de 5 anos,clasificacion f,2002-05-01,0,2,0,2,2
22001,CARANAVI,estado nutricional en menores de 5 anos,clasificacion f,2002-05-01,7,8,7,8,15
60302,CARAPARI,estado nutricional en menores de 5 anos,clasificacion f,2002-05-01,0,2,0,2,2
50702,CARIPUYO,estado nutricional en menores de 5 anos,clasificacion f,2002-05-01,5,5,5,5,10
40201,CHALLAPATA,estado nutricional en menores de 5 anos,clasificacion f,2002-05-01,3,2,3,2,5
50302,CHAQUI,estado nutricional en menores de 5 anos,clasificacion f,2002-05-01,3,3,3,3,6
70702,CHARAGUA,estado nutricional en menores de 5 anos,clasificacion f,2002-05-01,0,14,0,14,14
20305,CHARAÃ‘A,estado nutricional en menores de 5 anos,clasificacion f,2002-05-01,0,1,0,1,1
31204,CHIMORE,estado nutricional en menores de 5 anos,clasificacion f,2002-05-01,2,1,2,1,3
30801,CLIZA,estado nutricional en menores de 5 anos,clasificacion f,2002-05-01,0,2,0,2,2
90101,COBIJA,estado nutricional en menores de 5 anos,clasificacion f,2002-05-01,5,1,5,1,6
30101,COCHABAMBA,estado nutricional en menores de 5 anos,clasificacion f,2002-05-01,10,9,10,9,19
30905,COLCAPIRHUA,estado nutricional en menores de 5 anos,clasificacion f,2002-05-01,1,2,1,2,3
31002,COLOMI,estado nutricional en menores de 5 anos,clasificacion f,2002-05-01,4,2,4,2,6
50401,COLQUECHACA,estado nutricional en menores de 5 anos,clasificacion f,2002-05-01,5,5,5,5,10
21004,COLQUIRI,estado nutricional en menores de 5 anos,clasificacion f,2002-05-01,1,3,1,3,4
71301,COMARAPA,estado nutricional en menores de 5 anos,clasificacion f,2002-05-01,1,10,1,10,11
20605,COMBAYA,estado nutricional en menores de 5 anos,clasificacion f,2002-05-01,1,0,1,0,1
20301,CORO CORO,estado nutricional en menores de 5 anos,clasificacion f,2002-05-01,3,0,3,0,3
21401,COROICO,estado nutricional en menores de 5 anos,clasificacion f,2002-05-01,3,1,3,1,4
40301,CORQUE,estado nutricional en menores de 5 anos,clasificacion f,2002-05-01,1,1,1,1,2
50601,COTAGAITA,estado nutricional en menores de 5 anos,clasificacion f,2002-05-01,0,7,0,7,7
31405,CUCHUMUELA (V. G. VILLARROEL),estado nutricional en menores de 5 anos,clasificacion f,2002-05-01,0,3,0,3,3
70704,CUEVO,estado nutricional en menores de 5 anos,clasificacion f,2002-05-01,2,3,2,3,5
10902,CULPINA,estado nutricional en menores de 5 anos,clasificacion f,2002-05-01,19,4,19,4,23
40401,CURAHUARA DE CARANGAS,estado nutricional en menores de 5 anos,clasificacion f,2002-05-01,3,0,3,0,3
21602,CURVA,estado nutricional en menores de 5 anos,clasificacion f,2002-05-01,1,0,1,0,1
20804,DESAGUADERO,estado nutricional en menores de 5 anos,clasificacion f,2002-05-01,0,3,0,3,3
20105,EL ALTO,estado nutricional en menores de 5 anos,clasificacion f,2002-05-01,50,48,50,48,98
71503,EL PUENTE(STC),estado nutricional en menores de 5 anos,clasificacion f,2002-05-01,5,5,5,5,10
60502,EL PUENTE(TJA),estado nutricional en menores de 5 anos,clasificacion f,2002-05-01,1,0,1,0,1
70105,EL TORNO,estado nutricional en menores de 5 anos,clasificacion f,2002-05-01,6,2,6,2,8
10405,EL VILLAR,estado nutricional en menores de 5 anos,clasificacion f,2002-05-01,6,5,6,5,11
60601,ENTRE RIOS,estado nutricional en menores de 5 anos,clasificacion f,2002-05-01,1,1,1,1,2
71002,GENERAL SAAVEDRA,estado nutricional en menores de 5 anos,clasificacion f,2002-05-01,0,3,0,3,3
20602,GUANAY,estado nutricional en menores de 5 anos,clasificacion f,2002-05-01,8,6,8,6,14
20802,GUAQUI,estado nutricional en menores de 5 anos,clasificacion f,2002-05-01,0,2,0,2,2
80202,GUAYARAMERIN,estado nutricional en menores de 5 anos,clasificacion f,2002-05-01,0,2,0,2,2
70705,GUTIERREZ,estado nutricional en menores de 5 anos,clasificacion f,2002-05-01,0,12,0,12,12
10502,HUACARETA,estado nutricional en menores de 5 anos,clasificacion f,2002-05-01,5,4,5,4,9
11002,HUACAYA (VILLA DE HUACAYA),estado nutricional en menores de 5 anos,clasificacion f,2002-05-01,0,3,0,3,3
40501,HUACHACALLA,estado nutricional en menores de 5 anos,clasificacion f,2002-05-01,0,1,0,1,1
80803,HUARACAJE,estado nutricional en menores de 5 anos,clasificacion f,2002-05-01,1,0,1,0,1
21005,ICHOCA,estado nutricional en menores de 5 anos,clasificacion f,2002-05-01,0,1,0,1,1
10304,ICLA,estado nutricional en menores de 5 anos,clasificacion f,2002-05-01,11,3,11,3,14
10703,INCAHUASI,estado nutricional en menores de 5 anos,clasificacion f,2002-05-01,3,5,3,5,8
21001,INQUISIVI,estado nutricional en menores de 5 anos,clasificacion f,2002-05-01,2,3,2,3,5
21501,IXIAMAS,estado nutricional en menores de 5 anos,clasificacion f,2002-05-01,5,2,5,2,7
21105,LA ASUNTA,estado nutricional en menores de 5 anos,clasificacion f,2002-05-01,4,3,4,3,7
70104,LA GUARDIA,estado nutricional en menores de 5 anos,clasificacion f,2002-05-01,4,2,4,2,6
20101,LA PAZ,estado nutricional en menores de 5 anos,clasificacion f,2002-05-01,36,14,36,14,50
70701,LAGUNILLAS,estado nutricional en menores de 5 anos,clasificacion f,2002-05-01,2,1,2,1,3
10903,LAS CARRERAS,estado nutricional en menores de 5 anos,clasificacion f,2002-05-01,0,1,0,1,1
51401,LLICA,estado nutricional en menores de 5 anos,clasificacion f,2002-05-01,1,1,1,1,2
80601,LORETO,estado nutricional en menores de 5 anos,clasificacion f,2002-05-01,3,0,3,0,3
20901,LURIBAY,estado nutricional en menores de 5 anos,clasificacion f,2002-05-01,0,1,0,1,1
11003,MACHARETI,estado nutricional en menores de 5 anos,clasificacion f,2002-05-01,1,3,1,3,4
80801,MAGDALENA,estado nutricional en menores de 5 anos,clasificacion f,2002-05-01,2,1,2,1,3
70903,MAIRANA,estado nutricional en menores de 5 anos,clasificacion f,2002-05-01,1,2,1,2,3
20103,MECAPACA,estado nutricional en menores de 5 anos,clasificacion f,2002-05-01,1,0,1,0,1
71003,MINEROS,estado nutricional en menores de 5 anos,clasificacion f,2002-05-01,12,4,12,4,16
31301,MIZQUE,estado nutricional en menores de 5 anos,clasificacion f,2002-05-01,7,8,7,8,15
10303,MOJOCOYA,estado nutricional en menores de 5 anos,clasificacion f,2002-05-01,1,1,1,1,2
10501,MONTEAGUDO,estado nutricional en menores de 5 anos,clasificacion f,2002-05-01,7,4,7,4,11
71001,MONTERO,estado nutricional en menores de 5 anos,clasificacion f,2002-05-01,7,17,7,17,24
70803,MORO MORO,estado nutricional en menores de 5 anos,clasificacion f,2002-05-01,1,1,1,1,2
30302,MOROCHATA,estado nutricional en menores de 5 anos,clasificacion f,2002-05-01,0,2,0,2,2
50404,OCURI,estado nutricional en menores de 5 anos,clasificacion f,2002-05-01,5,5,5,5,10
70202,OKINAWA,estado nutricional en menores de 5 anos,clasificacion f,2002-05-01,2,0,2,0,2
30203,OMEREQUE,estado nutricional en menores de 5 anos,clasificacion f,2002-05-01,0,4,0,4,4
40101,ORURO,estado nutricional en menores de 5 anos,clasificacion f,2002-05-01,17,6,17,6,23
60201,PADCAYA,estado nutricional en menores de 5 anos,clasificacion f,2002-05-01,4,2,4,2,6
10401,PADILLA,estado nutricional en menores de 5 anos,clasificacion f,2002-05-01,7,4,7,4,11
70502,PAILON,estado nutricional en menores de 5 anos,clasificacion f,2002-05-01,0,4,0,4,4
20102,PALCA,estado nutricional en menores de 5 anos,clasificacion f,2002-05-01,3,2,3,2,5
21104,PALOS BLANCOS,estado nutricional en menores de 5 anos,clasificacion f,2002-05-01,1,3,1,3,4
70902,PAMPA GRANDE,estado nutricional en menores de 5 anos,clasificacion f,2002-05-01,0,1,0,1,1
30202,PASORAPA,estado nutricional en menores de 5 anos,clasificacion f,2002-05-01,2,0,2,0,2
21305,PATACAMAYA,estado nutricional en menores de 5 anos,clasificacion f,2002-05-01,1,2,1,2,3
20702,PELECHUCO,estado nutricional en menores de 5 anos,clasificacion f,2002-05-01,2,1,2,1,3
50403,POCOATA,estado nutricional en menores de 5 anos,clasificacion f,2002-05-01,1,9,1,9,10
31203,POCONA,estado nutricional en menores de 5 anos,clasificacion f,2002-05-01,4,5,4,5,9
31202,POJO (CBBA),estado nutricional en menores de 5 anos,clasificacion f,2002-05-01,8,7,8,7,15
51203,PORCO,estado nutricional en menores de 5 anos,clasificacion f,2002-05-01,3,0,3,0,3
10103,POROMA,estado nutricional en menores de 5 anos,clasificacion f,2002-05-01,8,12,8,12,20
70601,PORTACHUELO,estado nutricional en menores de 5 anos,clasificacion f,2002-05-01,4,0,4,0,4
50101,POTOSI,estado nutricional en menores de 5 anos,clasificacion f,2002-05-01,27,15,27,15,42
10302,PRESTO,estado nutricional en menores de 5 anos,clasificacion f,2002-05-01,6,2,6,2,8
21201,PUCARANI,estado nutricional en menores de 5 anos,clasificacion f,2002-05-01,1,1,1,1,2
20401,PUERTO ACOSTA,estado nutricional en menores de 5 anos,clasificacion f,2002-05-01,2,0,2,0,2
20403,PUERTO CARABUCO,estado nutricional en menores de 5 anos,clasificacion f,2002-05-01,1,2,1,2,3
90301,PUERTO GONZALO MORENO,estado nutricional en menores de 5 anos,clasificacion f,2002-05-01,1,0,1,0,1
21204,PUERTO PEREZ,estado nutricional en menores de 5 anos,clasificacion f,2002-05-01,0,1,0,1,1
71402,PUERTO QUIJARRO,estado nutricional en menores de 5 anos,clasificacion f,2002-05-01,2,1,2,1,3
71401,PUERTO SUAREZ,estado nutricional en menores de 5 anos,clasificacion f,2002-05-01,5,2,5,2,7
31205,PUERTO VILLARROEL,estado nutricional en menores de 5 anos,clasificacion f,2002-05-01,19,15,19,15,34
51101,PUNA,estado nutricional en menores de 5 anos,clasificacion f,2002-05-01,4,15,4,15,19
31401,PUNATA,estado nutricional en menores de 5 anos,clasificacion f,2002-05-01,0,2,0,2,2
20604,QUIABAYA,estado nutricional en menores de 5 anos,clasificacion f,2002-05-01,4,2,4,2,6
30901,QUILLACOLLO,estado nutricional en menores de 5 anos,clasificacion f,2002-05-01,2,0,2,0,2
50402,RAVELO,estado nutricional en menores de 5 anos,clasificacion f,2002-05-01,17,25,17,25,42
80201,RIBERALTA,estado nutricional en menores de 5 anos,clasificacion f,2002-05-01,48,38,48,38,86
70503,ROBORE,estado nutricional en menores de 5 anos,clasificacion f,2002-05-01,1,1,1,1,2
80304,RURRENABAQUE,estado nutricional en menores de 5 anos,clasificacion f,2002-05-01,2,1,2,1,3
31001,SACABA,estado nutricional en menores de 5 anos,clasificacion f,2002-05-01,0,17,0,17,17
30404,SACABAMBA,estado nutricional en menores de 5 anos,clasificacion f,2002-05-01,0,11,0,11,11
50701,SACACA,estado nutricional en menores de 5 anos,clasificacion f,2002-05-01,21,11,21,11,32
71302,SAIPINA,estado nutricional en menores de 5 anos,clasificacion f,2002-05-01,2,0,2,0,2
70901,SAMAIPATA,estado nutricional en menores de 5 anos,clasificacion f,2002-05-01,1,0,1,0,1
71105,SAN ANTONIO DE LOMERIO,estado nutricional en menores de 5 anos,clasificacion f,2002-05-01,2,5,2,5,7
80302,SAN BORJA,estado nutricional en menores de 5 anos,clasificacion f,2002-05-01,2,5,2,5,7
70402,SAN CARLOS,estado nutricional en menores de 5 anos,clasificacion f,2002-05-01,0,2,0,2,2
80501,SAN IGNACIO,estado nutricional en menores de 5 anos,clasificacion f,2002-05-01,7,27,7,27,34
70301,SAN IGNACIO DE VELASCO,estado nutricional en menores de 5 anos,clasificacion f,2002-05-01,10,7,10,7,17
80102,SAN JAVIER(BNI),estado nutricional en menores de 5 anos,clasificacion f,2002-05-01,3,0,3,0,3
71102,SAN JAVIER(STC),estado nutricional en menores de 5 anos,clasificacion f,2002-05-01,1,1,1,1,2
70501,SAN JOSE DE CHIQUITOS,estado nutricional en menores de 5 anos,clasificacion f,2002-05-01,6,3,6,3,9
71104,SAN JULIAN,estado nutricional en menores de 5 anos,clasificacion f,2002-05-01,12,17,12,17,29
90302,SAN LORENZO(PND),estado nutricional en menores de 5 anos,clasificacion f,2002-05-01,0,2,0,2,2
60501,SAN LORENZO(TJA),estado nutricional en menores de 5 anos,clasificacion f,2002-05-01,1,1,1,1,2
10702,SAN LUCAS,estado nutricional en menores de 5 anos,clasificacion f,2002-05-01,30,4,30,4,34
71201,SAN MATIAS,estado nutricional en menores de 5 anos,clasificacion f,2002-05-01,5,0,5,0,5
70302,SAN MIGUEL DE VELASCO,estado nutricional en menores de 5 anos,clasificacion f,2002-05-01,5,1,5,1,6
50501,SAN PEDRO DE BUENA VISTA,estado nutricional en menores de 5 anos,clasificacion f,2002-05-01,1,28,1,28,29
90202,SAN PEDRO(PND),estado nutricional en menores de 5 anos,clasificacion f,2002-05-01,1,0,1,0,1
70303,SAN RAFAEL,estado nutricional en menores de 5 anos,clasificacion f,2002-05-01,4,0,4,0,4
80401,SANTA ANA,estado nutricional en menores de 5 anos,clasificacion f,2002-05-01,2,1,2,1,3
70101,SANTA CRUZ DE LA SIERRA,estado nutricional en menores de 5 anos,clasificacion f,2002-05-01,17,10,17,10,27
80303,SANTA ROSA,estado nutricional en menores de 5 anos,clasificacion f,2002-05-01,1,0,1,0,1
70602,SANTA ROSA DEL SARA,estado nutricional en menores de 5 anos,clasificacion f,2002-05-01,0,1,0,1,1
20308,SANTIAGO DE CALLAPA,estado nutricional en menores de 5 anos,clasificacion f,2002-05-01,0,1,0,1,1
20902,SAPAHAQUI,estado nutricional en menores de 5 anos,clasificacion f,2002-05-01,0,3,0,3,3
30703,SICAYA,estado nutricional en menores de 5 anos,clasificacion f,2002-05-01,1,0,1,0,1
30902,SIPE SIPE,estado nutricional en menores de 5 anos,clasificacion f,2002-05-01,18,9,18,9,27
10403,SOPACHUY,estado nutricional en menores de 5 anos,clasificacion f,2002-05-01,22,6,22,6,28
20601,SORATA,estado nutricional en menores de 5 anos,clasificacion f,2002-05-01,6,2,6,2,8
10101,SUCRE,estado nutricional en menores de 5 anos,clasificacion f,2002-05-01,30,10,30,10,40
50303,TACOBAMBA,estado nutricional en menores de 5 anos,clasificacion f,2002-05-01,13,2,13,2,15
30602,TACOPAYA,estado nutricional en menores de 5 anos,clasificacion f,2002-05-01,5,1,5,1,6
51402,TAHUA,estado nutricional en menores de 5 anos,clasificacion f,2002-05-01,0,2,0,2,2
31101,TAPACARI,estado nutricional en menores de 5 anos,clasificacion f,2002-05-01,3,19,3,19,22
10601,TARABUCO,estado nutricional en menores de 5 anos,clasificacion f,2002-05-01,8,35,8,35,43
30401,TARATA,estado nutricional en menores de 5 anos,clasificacion f,2002-05-01,4,3,4,3,7
60101,TARIJA,estado nutricional en menores de 5 anos,clasificacion f,2002-05-01,5,2,5,2,7
10202,TARVITA,estado nutricional en menores de 5 anos,clasificacion f,2002-05-01,13,10,13,10,23
20803,TIAWANACU,estado nutricional en menores de 5 anos,clasificacion f,2002-05-01,4,0,4,0,4
50102,TINGUIPAYA,estado nutricional en menores de 5 anos,clasificacion f,2002-05-01,1,4,1,4,5
30903,TIQUIPAYA,estado nutricional en menores de 5 anos,clasificacion f,2002-05-01,0,9,0,9,9
31601,TIRAQUE (CBBA),estado nutricional en menores de 5 anos,clasificacion f,2002-05-01,4,11,4,11,15
21703,TITO YUPANQUI (PARQUIPUJIO),estado nutricional en menores de 5 anos,clasificacion f,2002-05-01,0,2,0,2,2
51202,TOMAVE,estado nutricional en menores de 5 anos,clasificacion f,2002-05-01,0,10,0,10,10
10402,TOMINA,estado nutricional en menores de 5 anos,clasificacion f,2002-05-01,7,7,7,7,14
50502,TORO TORO,estado nutricional en menores de 5 anos,clasificacion f,2002-05-01,0,4,0,4,4
31201,TOTORA(CBBA),estado nutricional en menores de 5 anos,clasificacion f,2002-05-01,17,11,17,11,28
41301,TOTORA(ORR),estado nutricional en menores de 5 anos,clasificacion f,2002-05-01,0,1,0,1,1
80101,TRINIDAD,estado nutricional en menores de 5 anos,clasificacion f,2002-05-01,16,10,16,10,26
50801,TUPIZA,estado nutricional en menores de 5 anos,clasificacion f,2002-05-01,1,6,1,6,7
60401,URIONDO (A. CONCEPCION),estado nutricional en menores de 5 anos,clasificacion f,2002-05-01,2,0,2,0,2
71502,URUBICHA,estado nutricional en menores de 5 anos,clasificacion f,2002-05-01,0,1,0,1,1
51201,UYUNI,estado nutricional en menores de 5 anos,clasificacion f,2002-05-01,0,14,0,14,14
70801,VALLEGRANDE,estado nutricional en menores de 5 anos,clasificacion f,2002-05-01,3,5,3,5,8
20801,VIACHA,estado nutricional en menores de 5 anos,clasificacion f,2002-05-01,0,1,0,1,1
31302,VILA VILA,estado nutricional en menores de 5 anos,clasificacion f,2002-05-01,2,7,2,7,9
60303,VILLA MONTES,estado nutricional en menores de 5 anos,clasificacion f,2002-05-01,4,5,4,5,9
31402,VILLA RIVERO,estado nutricional en menores de 5 anos,clasificacion f,2002-05-01,0,2,0,2,2
10801,VILLA SERRANO,estado nutricional en menores de 5 anos,clasificacion f,2002-05-01,11,26,11,26,37
31003,VILLA TUNARI,estado nutricional en menores de 5 anos,clasificacion f,2002-05-01,9,7,9,7,16
11001,VILLA VACA GUZMAN (MUYUPAMPA),estado nutricional en menores de 5 anos,clasificacion f,2002-05-01,4,1,4,1,5
51501,VILLAZON,estado nutricional en menores de 5 anos,clasificacion f,2002-05-01,1,3,1,3,4
30904,VINTO,estado nutricional en menores de 5 anos,clasificacion f,2002-05-01,16,8,16,8,24
50602,VITICHI,estado nutricional en menores de 5 anos,clasificacion f,2002-05-01,0,3,0,3,3
70201,WARNES,estado nutricional en menores de 5 anos,clasificacion f,2002-05-01,4,5,4,5,9
20903,YACO,estado nutricional en menores de 5 anos,clasificacion f,2002-05-01,0,1,0,1,1
60301,YACUIBA,estado nutricional en menores de 5 anos,clasificacion f,2002-05-01,3,4,3,4,7
10602,YAMPARAEZ,estado nutricional en menores de 5 anos,clasificacion f,2002-05-01,16,3,16,3,19
70403,YAPACANI,estado nutricional en menores de 5 anos,clasificacion f,2002-05-01,0,7,0,7,7
50103,YOCALLA,estado nutricional en menores de 5 anos,clasificacion f,2002-05-01,0,4,0,4,4
10102,YOTALA,estado nutricional en menores de 5 anos,clasificacion f,2002-05-01,12,0,12,0,12
60402,YUNCHARA,estado nutricional en menores de 5 anos,clasificacion f,2002-05-01,1,2,1,2,3
10301,ZUDAÃ‘EZ,estado nutricional en menores de 5 anos,clasificacion f,2002-05-01,2,11,2,11,13
51302,ACACIO,estado nutricional en menores de 5 anos,clasificacion f,2002-06-01,6,10,6,10,16
20201,ACHACACHI,estado nutricional en menores de 5 anos,clasificacion f,2002-06-01,7,3,7,3,10
20104,ACHOCALLA,estado nutricional en menores de 5 anos,clasificacion f,2002-06-01,6,0,6,0,6
30201,AIQUILE,estado nutricional en menores de 5 anos,clasificacion f,2002-06-01,1,0,1,0,1
10404,ALCALA,estado nutricional en menores de 5 anos,clasificacion f,2002-06-01,6,1,6,1,7
20202,ANCORAIMES,estado nutricional en menores de 5 anos,clasificacion f,2002-06-01,2,5,2,5,7
30402,ANZALDO,estado nutricional en menores de 5 anos,clasificacion f,2002-06-01,0,1,0,1,1
20701,APOLO,estado nutricional en menores de 5 anos,clasificacion f,2002-06-01,0,2,0,2,2
51301,ARAMPAMPA,estado nutricional en menores de 5 anos,clasificacion f,2002-06-01,0,2,0,2,2
30501,ARANI,estado nutricional en menores de 5 anos,clasificacion f,2002-06-01,0,1,0,1,1
30403,ARBIETO,estado nutricional en menores de 5 anos,clasificacion f,2002-06-01,0,2,0,2,2
30601,ARQUE,estado nutricional en menores de 5 anos,clasificacion f,2002-06-01,8,4,8,4,12
71501,ASCENCION DE GUARAYOS,estado nutricional en menores de 5 anos,clasificacion f,2002-06-01,8,7,8,7,15
50802,ATOCHA,estado nutricional en menores de 5 anos,clasificacion f,2002-06-01,0,5,0,5,5
20503,AUCAPATA,estado nutricional en menores de 5 anos,clasificacion f,2002-06-01,2,0,2,0,2
20502,AYATA,estado nutricional en menores de 5 anos,clasificacion f,2002-06-01,2,5,2,5,7
30301,AYOPAYA (V. DE INDEPENDENCIA),estado nutricional en menores de 5 anos,clasificacion f,2002-06-01,9,7,9,7,16
10201,AZURDUY,estado nutricional en menores de 5 anos,clasificacion f,2002-06-01,16,6,16,6,22
21203,BATALLAS,estado nutricional en menores de 5 anos,clasificacion f,2002-06-01,0,1,0,1,1
80802,BAURES,estado nutricional en menores de 5 anos,clasificacion f,2002-06-01,0,1,0,1,1
60202,BERMEJO,estado nutricional en menores de 5 anos,clasificacion f,2002-06-01,0,1,0,1,1
50301,BETANZOS,estado nutricional en menores de 5 anos,clasificacion f,2002-06-01,7,8,7,8,15
31501,BOLIVAR,estado nutricional en menores de 5 anos,clasificacion f,2002-06-01,4,2,4,2,6
70703,CABEZAS,estado nutricional en menores de 5 anos,clasificacion f,2002-06-01,0,2,0,2,2
20905,CAIROMA,estado nutricional en menores de 5 anos,clasificacion f,2002-06-01,2,6,2,6,8
51102,"CAIZA ""D""",estado nutricional en menores de 5 anos,clasificacion f,2002-06-01,1,3,1,3,4
21003,CAJUATA,estado nutricional en menores de 5 anos,clasificacion f,2002-06-01,2,3,2,3,5
20303,CALACOTO,estado nutricional en menores de 5 anos,clasificacion f,2002-06-01,0,1,0,1,1
21304,CALAMARCA,estado nutricional en menores de 5 anos,clasificacion f,2002-06-01,2,2,2,2,4
10701,CAMARGO,estado nutricional en menores de 5 anos,clasificacion f,2002-06-01,0,2,0,2,2
70706,CAMIRI,estado nutricional en menores de 5 anos,clasificacion f,2002-06-01,1,3,1,3,4
30701,CAPINOTA,estado nutricional en menores de 5 anos,clasificacion f,2002-06-01,4,10,4,10,14
22001,CARANAVI,estado nutricional en menores de 5 anos,clasificacion f,2002-06-01,14,2,14,2,16
60302,CARAPARI,estado nutricional en menores de 5 anos,clasificacion f,2002-06-01,1,3,1,3,4
50702,CARIPUYO,estado nutricional en menores de 5 anos,clasificacion f,2002-06-01,1,3,1,3,4
21902,CATACORA,estado nutricional en menores de 5 anos,clasificacion f,2002-06-01,1,0,1,0,1
40201,CHALLAPATA,estado nutricional en menores de 5 anos,clasificacion f,2002-06-01,4,3,4,3,7
50302,CHAQUI,estado nutricional en menores de 5 anos,clasificacion f,2002-06-01,5,1,5,1,6
70702,CHARAGUA,estado nutricional en menores de 5 anos,clasificacion f,2002-06-01,0,18,0,18,18
20305,CHARAÃ‘A,estado nutricional en menores de 5 anos,clasificacion f,2002-06-01,2,0,2,0,2
50202,CHAYANTA,estado nutricional en menores de 5 anos,clasificacion f,2002-06-01,1,5,1,5,6
40302,CHOQUE COTA,estado nutricional en menores de 5 anos,clasificacion f,2002-06-01,0,1,0,1,1
20501,CHUMA,estado nutricional en menores de 5 anos,clasificacion f,2002-06-01,0,1,0,1,1
30801,CLIZA,estado nutricional en menores de 5 anos,clasificacion f,2002-06-01,1,14,1,14,15
90101,COBIJA,estado nutricional en menores de 5 anos,clasificacion f,2002-06-01,1,1,1,1,2
30101,COCHABAMBA,estado nutricional en menores de 5 anos,clasificacion f,2002-06-01,9,5,9,5,14
40902,COIPASA,estado nutricional en menores de 5 anos,clasificacion f,2002-06-01,2,0,2,0,2
30905,COLCAPIRHUA,estado nutricional en menores de 5 anos,clasificacion f,2002-06-01,2,2,2,2,4
31002,COLOMI,estado nutricional en menores de 5 anos,clasificacion f,2002-06-01,4,1,4,1,5
50401,COLQUECHACA,estado nutricional en menores de 5 anos,clasificacion f,2002-06-01,21,8,21,8,29
21306,COLQUENCHA,estado nutricional en menores de 5 anos,clasificacion f,2002-06-01,1,1,1,1,2
21004,COLQUIRI,estado nutricional en menores de 5 anos,clasificacion f,2002-06-01,4,1,4,1,5
20304,COMANCHE,estado nutricional en menores de 5 anos,clasificacion f,2002-06-01,2,0,2,0,2
71301,COMARAPA,estado nutricional en menores de 5 anos,clasificacion f,2002-06-01,3,8,3,8,11
20605,COMBAYA,estado nutricional en menores de 5 anos,clasificacion f,2002-06-01,0,1,0,1,1
20301,CORO CORO,estado nutricional en menores de 5 anos,clasificacion f,2002-06-01,1,0,1,0,1
21401,COROICO,estado nutricional en menores de 5 anos,clasificacion f,2002-06-01,3,0,3,0,3
40301,CORQUE,estado nutricional en menores de 5 anos,clasificacion f,2002-06-01,1,2,1,2,3
50601,COTAGAITA,estado nutricional en menores de 5 anos,clasificacion f,2002-06-01,2,8,2,8,10
70102,COTOCA,estado nutricional en menores de 5 anos,clasificacion f,2002-06-01,1,0,1,0,1
31405,CUCHUMUELA (V. G. VILLARROEL),estado nutricional en menores de 5 anos,clasificacion f,2002-06-01,0,4,0,4,4
10902,CULPINA,estado nutricional en menores de 5 anos,clasificacion f,2002-06-01,14,9,14,9,23
21602,CURVA,estado nutricional en menores de 5 anos,clasificacion f,2002-06-01,1,0,1,0,1
20804,DESAGUADERO,estado nutricional en menores de 5 anos,clasificacion f,2002-06-01,0,2,0,2,2
20105,EL ALTO,estado nutricional en menores de 5 anos,clasificacion f,2002-06-01,62,33,62,33,95
71503,EL PUENTE(STC),estado nutricional en menores de 5 anos,clasificacion f,2002-06-01,1,9,1,9,10
60502,EL PUENTE(TJA),estado nutricional en menores de 5 anos,clasificacion f,2002-06-01,1,1,1,1,2
70105,EL TORNO,estado nutricional en menores de 5 anos,clasificacion f,2002-06-01,1,1,1,1,2
10405,EL VILLAR,estado nutricional en menores de 5 anos,clasificacion f,2002-06-01,4,2,4,2,6
90203,FILADELFIA,estado nutricional en menores de 5 anos,clasificacion f,2002-06-01,0,4,0,4,4
71002,GENERAL SAAVEDRA,estado nutricional en menores de 5 anos,clasificacion f,2002-06-01,3,7,3,7,10
20602,GUANAY,estado nutricional en menores de 5 anos,clasificacion f,2002-06-01,12,4,12,4,16
70705,GUTIERREZ,estado nutricional en menores de 5 anos,clasificacion f,2002-06-01,1,12,1,12,13
10502,HUACARETA,estado nutricional en menores de 5 anos,clasificacion f,2002-06-01,3,3,3,3,6
11002,HUACAYA (VILLA DE HUACAYA),estado nutricional en menores de 5 anos,clasificacion f,2002-06-01,1,1,1,1,2
40701,HUANUNI,estado nutricional en menores de 5 anos,clasificacion f,2002-06-01,1,0,1,0,1
41601,HUAYLLAMARCA,estado nutricional en menores de 5 anos,clasificacion f,2002-06-01,1,1,1,1,2
21005,ICHOCA,estado nutricional en menores de 5 anos,clasificacion f,2002-06-01,1,1,1,1,2
10304,ICLA,estado nutricional en menores de 5 anos,clasificacion f,2002-06-01,7,2,7,2,9
10703,INCAHUASI,estado nutricional en menores de 5 anos,clasificacion f,2002-06-01,110,43,110,43,153
21001,INQUISIVI,estado nutricional en menores de 5 anos,clasificacion f,2002-06-01,3,2,3,2,5
21501,IXIAMAS,estado nutricional en menores de 5 anos,clasificacion f,2002-06-01,1,1,1,1,2
21105,LA ASUNTA,estado nutricional en menores de 5 anos,clasificacion f,2002-06-01,2,2,2,2,4
70104,LA GUARDIA,estado nutricional en menores de 5 anos,clasificacion f,2002-06-01,2,0,2,0,2
20101,LA PAZ,estado nutricional en menores de 5 anos,clasificacion f,2002-06-01,35,18,35,18,53
70701,LAGUNILLAS,estado nutricional en menores de 5 anos,clasificacion f,2002-06-01,6,1,6,1,7
10903,LAS CARRERAS,estado nutricional en menores de 5 anos,clasificacion f,2002-06-01,1,0,1,0,1
50203,LLALLAGUA,estado nutricional en menores de 5 anos,clasificacion f,2002-06-01,0,4,0,4,4
20901,LURIBAY,estado nutricional en menores de 5 anos,clasificacion f,2002-06-01,0,2,0,2,2
11003,MACHARETI,estado nutricional en menores de 5 anos,clasificacion f,2002-06-01,1,2,1,2,3
80801,MAGDALENA,estado nutricional en menores de 5 anos,clasificacion f,2002-06-01,2,1,2,1,3
70903,MAIRANA,estado nutricional en menores de 5 anos,clasificacion f,2002-06-01,1,0,1,0,1
71003,MINEROS,estado nutricional en menores de 5 anos,clasificacion f,2002-06-01,7,1,7,1,8
31301,MIZQUE,estado nutricional en menores de 5 anos,clasificacion f,2002-06-01,0,1,0,1,1
20402,MOCOMOCO,estado nutricional en menores de 5 anos,clasificacion f,2002-06-01,3,2,3,2,5
10303,MOJOCOYA,estado nutricional en menores de 5 anos,clasificacion f,2002-06-01,2,5,2,5,7
10501,MONTEAGUDO,estado nutricional en menores de 5 anos,clasificacion f,2002-06-01,6,3,6,3,9
71001,MONTERO,estado nutricional en menores de 5 anos,clasificacion f,2002-06-01,3,17,3,17,20
70803,MORO MORO,estado nutricional en menores de 5 anos,clasificacion f,2002-06-01,1,0,1,0,1
90501,NUEVO MANOA (NUEVA ESPERANZA),estado nutricional en menores de 5 anos,clasificacion f,2002-06-01,0,1,0,1,1
50404,OCURI,estado nutricional en menores de 5 anos,clasificacion f,2002-06-01,8,29,8,29,37
70202,OKINAWA,estado nutricional en menores de 5 anos,clasificacion f,2002-06-01,0,1,0,1,1
40101,ORURO,estado nutricional en menores de 5 anos,clasificacion f,2002-06-01,15,3,15,3,18
60201,PADCAYA,estado nutricional en menores de 5 anos,clasificacion f,2002-06-01,1,1,1,1,2
10401,PADILLA,estado nutricional en menores de 5 anos,clasificacion f,2002-06-01,12,5,12,5,17
20102,PALCA,estado nutricional en menores de 5 anos,clasificacion f,2002-06-01,0,3,0,3,3
21104,PALOS BLANCOS,estado nutricional en menores de 5 anos,clasificacion f,2002-06-01,6,2,6,2,8
21802,PAPEL PAMPA,estado nutricional en menores de 5 anos,clasificacion f,2002-06-01,0,2,0,2,2
30202,PASORAPA,estado nutricional en menores de 5 anos,clasificacion f,2002-06-01,0,2,0,2,2
21305,PATACAMAYA,estado nutricional en menores de 5 anos,clasificacion f,2002-06-01,2,0,2,0,2
40602,PAZÃ‘A,estado nutricional en menores de 5 anos,clasificacion f,2002-06-01,0,1,0,1,1
20702,PELECHUCO,estado nutricional en menores de 5 anos,clasificacion f,2002-06-01,2,0,2,0,2
50403,POCOATA,estado nutricional en menores de 5 anos,clasificacion f,2002-06-01,2,1,2,1,3
31203,POCONA,estado nutricional en menores de 5 anos,clasificacion f,2002-06-01,4,3,4,3,7
31202,POJO (CBBA),estado nutricional en menores de 5 anos,clasificacion f,2002-06-01,5,3,5,3,8
51203,PORCO,estado nutricional en menores de 5 anos,clasificacion f,2002-06-01,1,0,1,0,1
10103,POROMA,estado nutricional en menores de 5 anos,clasificacion f,2002-06-01,21,8,21,8,29
70601,PORTACHUELO,estado nutricional en menores de 5 anos,clasificacion f,2002-06-01,5,3,5,3,8
50101,POTOSI,estado nutricional en menores de 5 anos,clasificacion f,2002-06-01,23,6,23,6,29
10302,PRESTO,estado nutricional en menores de 5 anos,clasificacion f,2002-06-01,6,3,6,3,9
21201,PUCARANI,estado nutricional en menores de 5 anos,clasificacion f,2002-06-01,0,3,0,3,3
20401,PUERTO ACOSTA,estado nutricional en menores de 5 anos,clasificacion f,2002-06-01,2,1,2,1,3
20403,PUERTO CARABUCO,estado nutricional en menores de 5 anos,clasificacion f,2002-06-01,5,3,5,3,8
21204,PUERTO PEREZ,estado nutricional en menores de 5 anos,clasificacion f,2002-06-01,0,1,0,1,1
71402,PUERTO QUIJARRO,estado nutricional en menores de 5 anos,clasificacion f,2002-06-01,1,0,1,0,1
90201,PUERTO RICO,estado nutricional en menores de 5 anos,clasificacion f,2002-06-01,2,0,2,0,2
71401,PUERTO SUAREZ,estado nutricional en menores de 5 anos,clasificacion f,2002-06-01,2,0,2,0,2
31205,PUERTO VILLARROEL,estado nutricional en menores de 5 anos,clasificacion f,2002-06-01,14,12,14,12,26
51101,PUNA,estado nutricional en menores de 5 anos,clasificacion f,2002-06-01,2,10,2,10,12
31401,PUNATA,estado nutricional en menores de 5 anos,clasificacion f,2002-06-01,0,2,0,2,2
20604,QUIABAYA,estado nutricional en menores de 5 anos,clasificacion f,2002-06-01,3,1,3,1,4
30901,QUILLACOLLO,estado nutricional en menores de 5 anos,clasificacion f,2002-06-01,8,4,8,4,12
21002,QUIME,estado nutricional en menores de 5 anos,clasificacion f,2002-06-01,1,9,1,9,10
50402,RAVELO,estado nutricional en menores de 5 anos,clasificacion f,2002-06-01,14,20,14,20,34
80201,RIBERALTA,estado nutricional en menores de 5 anos,clasificacion f,2002-06-01,42,19,42,19,61
70503,ROBORE,estado nutricional en menores de 5 anos,clasificacion f,2002-06-01,3,2,3,2,5
31001,SACABA,estado nutricional en menores de 5 anos,clasificacion f,2002-06-01,2,1,2,1,3
30404,SACABAMBA,estado nutricional en menores de 5 anos,clasificacion f,2002-06-01,0,6,0,6,6
50701,SACACA,estado nutricional en menores de 5 anos,clasificacion f,2002-06-01,20,14,20,14,34
71302,SAIPINA,estado nutricional en menores de 5 anos,clasificacion f,2002-06-01,1,0,1,0,1
40801,SALINAS DE GARCI MENDOZA,estado nutricional en menores de 5 anos,clasificacion f,2002-06-01,1,0,1,0,1
80602,SAN ANDRES,estado nutricional en menores de 5 anos,clasificacion f,2002-06-01,1,0,1,0,1
71105,SAN ANTONIO DE LOMERIO,estado nutricional en menores de 5 anos,clasificacion f,2002-06-01,4,4,4,4,8
31403,SAN BENITO,estado nutricional en menores de 5 anos,clasificacion f,2002-06-01,0,3,0,3,3
80302,SAN BORJA,estado nutricional en menores de 5 anos,clasificacion f,2002-06-01,4,5,4,5,9
80501,SAN IGNACIO,estado nutricional en menores de 5 anos,clasificacion f,2002-06-01,3,9,3,9,12
70301,SAN IGNACIO DE VELASCO,estado nutricional en menores de 5 anos,clasificacion f,2002-06-01,19,8,19,8,27
80102,SAN JAVIER(BNI),estado nutricional en menores de 5 anos,clasificacion f,2002-06-01,1,0,1,0,1
71102,SAN JAVIER(STC),estado nutricional en menores de 5 anos,clasificacion f,2002-06-01,1,0,1,0,1
80701,SAN JOAQUIN,estado nutricional en menores de 5 anos,clasificacion f,2002-06-01,0,1,0,1,1
70501,SAN JOSE DE CHIQUITOS,estado nutricional en menores de 5 anos,clasificacion f,2002-06-01,4,0,4,0,4
71104,SAN JULIAN,estado nutricional en menores de 5 anos,clasificacion f,2002-06-01,10,4,10,4,14
60501,SAN LORENZO(TJA),estado nutricional en menores de 5 anos,clasificacion f,2002-06-01,2,1,2,1,3
10702,SAN LUCAS,estado nutricional en menores de 5 anos,clasificacion f,2002-06-01,35,13,35,13,48
70302,SAN MIGUEL DE VELASCO,estado nutricional en menores de 5 anos,clasificacion f,2002-06-01,4,0,4,0,4
51001,SAN PABLO DE LIPEZ,estado nutricional en menores de 5 anos,clasificacion f,2002-06-01,0,1,0,1,1
50501,SAN PEDRO DE BUENA VISTA,estado nutricional en menores de 5 anos,clasificacion f,2002-06-01,0,32,0,32,32
90202,SAN PEDRO(PND),estado nutricional en menores de 5 anos,clasificacion f,2002-06-01,3,0,3,0,3
70303,SAN RAFAEL,estado nutricional en menores de 5 anos,clasificacion f,2002-06-01,1,0,1,0,1
80702,SAN RAMON,estado nutricional en menores de 5 anos,clasificacion f,2002-06-01,3,2,3,2,5
70101,SANTA CRUZ DE LA SIERRA,estado nutricional en menores de 5 anos,clasificacion f,2002-06-01,9,5,9,5,14
80303,SANTA ROSA,estado nutricional en menores de 5 anos,clasificacion f,2002-06-01,1,0,1,0,1
70602,SANTA ROSA DEL SARA,estado nutricional en menores de 5 anos,clasificacion f,2002-06-01,1,2,1,2,3
41401,SANTIAGO DE HUARI,estado nutricional en menores de 5 anos,clasificacion f,2002-06-01,1,0,1,0,1
30702,SANTIVAÃ‘ES,estado nutricional en menores de 5 anos,clasificacion f,2002-06-01,1,0,1,0,1
21301,SICA SICA (VILLA AROMA),estado nutricional en menores de 5 anos,clasificacion f,2002-06-01,0,1,0,1,1
30703,SICAYA,estado nutricional en menores de 5 anos,clasificacion f,2002-06-01,0,2,0,2,2
30902,SIPE SIPE,estado nutricional en menores de 5 anos,clasificacion f,2002-06-01,11,5,11,5,16
10403,SOPACHUY,estado nutricional en menores de 5 anos,clasificacion f,2002-06-01,15,5,15,5,20
20601,SORATA,estado nutricional en menores de 5 anos,clasificacion f,2002-06-01,1,1,1,1,2
10101,SUCRE,estado nutricional en menores de 5 anos,clasificacion f,2002-06-01,28,6,28,6,34
20603,TACACOMA,estado nutricional en menores de 5 anos,clasificacion f,2002-06-01,1,0,1,0,1
50303,TACOBAMBA,estado nutricional en menores de 5 anos,clasificacion f,2002-06-01,3,1,3,1,4
30602,TACOPAYA,estado nutricional en menores de 5 anos,clasificacion f,2002-06-01,1,3,1,3,4
31101,TAPACARI,estado nutricional en menores de 5 anos,clasificacion f,2002-06-01,0,19,0,19,19
10601,TARABUCO,estado nutricional en menores de 5 anos,clasificacion f,2002-06-01,23,26,23,26,49
30401,TARATA,estado nutricional en menores de 5 anos,clasificacion f,2002-06-01,1,0,1,0,1
60101,TARIJA,estado nutricional en menores de 5 anos,clasificacion f,2002-06-01,6,2,6,2,8
10202,TARVITA,estado nutricional en menores de 5 anos,clasificacion f,2002-06-01,15,6,15,6,21
20803,TIAWANACU,estado nutricional en menores de 5 anos,clasificacion f,2002-06-01,2,1,2,1,3
50102,TINGUIPAYA,estado nutricional en menores de 5 anos,clasificacion f,2002-06-01,0,15,0,15,15
20606,TIPUANI,estado nutricional en menores de 5 anos,clasificacion f,2002-06-01,1,0,1,0,1
30903,TIQUIPAYA,estado nutricional en menores de 5 anos,clasificacion f,2002-06-01,3,6,3,6,9
31601,TIRAQUE (CBBA),estado nutricional en menores de 5 anos,clasificacion f,2002-06-01,8,8,8,8,16
30802,TOCO,estado nutricional en menores de 5 anos,clasificacion f,2002-06-01,0,1,0,1,1
51202,TOMAVE,estado nutricional en menores de 5 anos,clasificacion f,2002-06-01,0,5,0,5,5
10402,TOMINA,estado nutricional en menores de 5 anos,clasificacion f,2002-06-01,7,0,7,0,7
50502,TORO TORO,estado nutricional en menores de 5 anos,clasificacion f,2002-06-01,0,1,0,1,1
31201,TOTORA(CBBA),estado nutricional en menores de 5 anos,clasificacion f,2002-06-01,2,2,2,2,4
41301,TOTORA(ORR),estado nutricional en menores de 5 anos,clasificacion f,2002-06-01,0,1,0,1,1
80101,TRINIDAD,estado nutricional en menores de 5 anos,clasificacion f,2002-06-01,4,11,4,11,15
50801,TUPIZA,estado nutricional en menores de 5 anos,clasificacion f,2002-06-01,0,1,0,1,1
21302,UMALA,estado nutricional en menores de 5 anos,clasificacion f,2002-06-01,1,0,1,0,1
50201,UNCIA,estado nutricional en menores de 5 anos,clasificacion f,2002-06-01,6,19,6,19,25
60401,URIONDO (A. CONCEPCION),estado nutricional en menores de 5 anos,clasificacion f,2002-06-01,1,2,1,2,3
71502,URUBICHA,estado nutricional en menores de 5 anos,clasificacion f,2002-06-01,4,6,4,6,10
51201,UYUNI,estado nutricional en menores de 5 anos,clasificacion f,2002-06-01,7,4,7,4,11
30502,VACAS,estado nutricional en menores de 5 anos,clasificacion f,2002-06-01,0,3,0,3,3
70801,VALLEGRANDE,estado nutricional en menores de 5 anos,clasificacion f,2002-06-01,1,5,1,5,6
20801,VIACHA,estado nutricional en menores de 5 anos,clasificacion f,2002-06-01,0,3,0,3,3
31302,VILA VILA,estado nutricional en menores de 5 anos,clasificacion f,2002-06-01,3,2,3,2,5
60303,VILLA MONTES,estado nutricional en menores de 5 anos,clasificacion f,2002-06-01,4,0,4,0,4
31402,VILLA RIVERO,estado nutricional en menores de 5 anos,clasificacion f,2002-06-01,0,1,0,1,1
10801,VILLA SERRANO,estado nutricional en menores de 5 anos,clasificacion f,2002-06-01,14,25,14,25,39
31003,VILLA TUNARI,estado nutricional en menores de 5 anos,clasificacion f,2002-06-01,13,7,13,7,20
11001,VILLA VACA GUZMAN (MUYUPAMPA),estado nutricional en menores de 5 anos,clasificacion f,2002-06-01,3,3,3,3,6
51501,VILLAZON,estado nutricional en menores de 5 anos,clasificacion f,2002-06-01,0,6,0,6,6
30904,VINTO,estado nutricional en menores de 5 anos,clasificacion f,2002-06-01,7,4,7,4,11
50602,VITICHI,estado nutricional en menores de 5 anos,clasificacion f,2002-06-01,0,4,0,4,4
70201,WARNES,estado nutricional en menores de 5 anos,clasificacion f,2002-06-01,5,6,5,6,11
20903,YACO,estado nutricional en menores de 5 anos,clasificacion f,2002-06-01,0,2,0,2,2
60301,YACUIBA,estado nutricional en menores de 5 anos,clasificacion f,2002-06-01,3,3,3,3,6
10602,YAMPARAEZ,estado nutricional en menores de 5 anos,clasificacion f,2002-06-01,15,4,15,4,19
50103,YOCALLA,estado nutricional en menores de 5 anos,clasificacion f,2002-06-01,0,2,0,2,2
10102,YOTALA,estado nutricional en menores de 5 anos,clasificacion f,2002-06-01,13,0,13,0,13
60402,YUNCHARA,estado nutricional en menores de 5 anos,clasificacion f,2002-06-01,0,5,0,5,5
10301,ZUDAÃ‘EZ,estado nutricional en menores de 5 anos,clasificacion f,2002-06-01,2,0,2,0,2
51302,ACACIO,estado nutricional en menores de 5 anos,clasificacion f,2002-07-01,5,7,5,7,12
20201,ACHACACHI,estado nutricional en menores de 5 anos,clasificacion f,2002-07-01,1,3,1,3,4
20104,ACHOCALLA,estado nutricional en menores de 5 anos,clasificacion f,2002-07-01,1,0,1,0,1
30201,AIQUILE,estado nutricional en menores de 5 anos,clasificacion f,2002-07-01,5,3,5,3,8
31303,ALALAY,estado nutricional en menores de 5 anos,clasificacion f,2002-07-01,0,1,0,1,1
10404,ALCALA,estado nutricional en menores de 5 anos,clasificacion f,2002-07-01,6,4,6,4,10
20202,ANCORAIMES,estado nutricional en menores de 5 anos,clasificacion f,2002-07-01,1,0,1,0,1
40603,ANTEQUERA,estado nutricional en menores de 5 anos,clasificacion f,2002-07-01,0,1,0,1,1
30402,ANZALDO,estado nutricional en menores de 5 anos,clasificacion f,2002-07-01,0,5,0,5,5
20701,APOLO,estado nutricional en menores de 5 anos,clasificacion f,2002-07-01,3,4,3,4,7
51301,ARAMPAMPA,estado nutricional en menores de 5 anos,clasificacion f,2002-07-01,9,2,9,2,11
30501,ARANI,estado nutricional en menores de 5 anos,clasificacion f,2002-07-01,0,4,0,4,4
30601,ARQUE,estado nutricional en menores de 5 anos,clasificacion f,2002-07-01,6,6,6,6,12
50802,ATOCHA,estado nutricional en menores de 5 anos,clasificacion f,2002-07-01,0,3,0,3,3
20502,AYATA,estado nutricional en menores de 5 anos,clasificacion f,2002-07-01,9,5,9,5,14
30301,AYOPAYA (V. DE INDEPENDENCIA),estado nutricional en menores de 5 anos,clasificacion f,2002-07-01,3,3,3,3,6
10201,AZURDUY,estado nutricional en menores de 5 anos,clasificacion f,2002-07-01,4,0,4,0,4
50104,BELEN DE URMIRI,estado nutricional en menores de 5 anos,clasificacion f,2002-07-01,1,0,1,0,1
60202,BERMEJO,estado nutricional en menores de 5 anos,clasificacion f,2002-07-01,0,3,0,3,3
50301,BETANZOS,estado nutricional en menores de 5 anos,clasificacion f,2002-07-01,9,11,9,11,20
31501,BOLIVAR,estado nutricional en menores de 5 anos,clasificacion f,2002-07-01,1,1,1,1,2
70707,BOYUIBE,estado nutricional en menores de 5 anos,clasificacion f,2002-07-01,0,2,0,2,2
70703,CABEZAS,estado nutricional en menores de 5 anos,clasificacion f,2002-07-01,0,1,0,1,1
20905,CAIROMA,estado nutricional en menores de 5 anos,clasificacion f,2002-07-01,2,3,2,3,5
51102,"CAIZA ""D""",estado nutricional en menores de 5 anos,clasificacion f,2002-07-01,3,3,3,3,6
21003,CAJUATA,estado nutricional en menores de 5 anos,clasificacion f,2002-07-01,0,2,0,2,2
20303,CALACOTO,estado nutricional en menores de 5 anos,clasificacion f,2002-07-01,1,0,1,0,1
21304,CALAMARCA,estado nutricional en menores de 5 anos,clasificacion f,2002-07-01,1,0,1,0,1
10701,CAMARGO,estado nutricional en menores de 5 anos,clasificacion f,2002-07-01,9,21,9,21,30
70706,CAMIRI,estado nutricional en menores de 5 anos,clasificacion f,2002-07-01,0,1,0,1,1
30701,CAPINOTA,estado nutricional en menores de 5 anos,clasificacion f,2002-07-01,3,10,3,10,13
40102,CARACOLLO,estado nutricional en menores de 5 anos,clasificacion f,2002-07-01,1,0,1,0,1
22001,CARANAVI,estado nutricional en menores de 5 anos,clasificacion f,2002-07-01,4,7,4,7,11
60302,CARAPARI,estado nutricional en menores de 5 anos,clasificacion f,2002-07-01,1,0,1,0,1
50702,CARIPUYO,estado nutricional en menores de 5 anos,clasificacion f,2002-07-01,3,2,3,2,5
40201,CHALLAPATA,estado nutricional en menores de 5 anos,clasificacion f,2002-07-01,3,6,3,6,9
50302,CHAQUI,estado nutricional en menores de 5 anos,clasificacion f,2002-07-01,1,3,1,3,4
70702,CHARAGUA,estado nutricional en menores de 5 anos,clasificacion f,2002-07-01,3,5,3,5,8
20305,CHARAÃ‘A,estado nutricional en menores de 5 anos,clasificacion f,2002-07-01,0,1,0,1,1
50202,CHAYANTA,estado nutricional en menores de 5 anos,clasificacion f,2002-07-01,11,6,11,6,17
31204,CHIMORE,estado nutricional en menores de 5 anos,clasificacion f,2002-07-01,1,0,1,0,1
20501,CHUMA,estado nutricional en menores de 5 anos,clasificacion f,2002-07-01,0,1,0,1,1
30801,CLIZA,estado nutricional en menores de 5 anos,clasificacion f,2002-07-01,0,2,0,2,2
90101,COBIJA,estado nutricional en menores de 5 anos,clasificacion f,2002-07-01,1,0,1,0,1
30101,COCHABAMBA,estado nutricional en menores de 5 anos,clasificacion f,2002-07-01,10,3,10,3,13
30905,COLCAPIRHUA,estado nutricional en menores de 5 anos,clasificacion f,2002-07-01,1,7,1,7,8
50901,"COLCHA ""K""",estado nutricional en menores de 5 anos,clasificacion f,2002-07-01,1,0,1,0,1
31002,COLOMI,estado nutricional en menores de 5 anos,clasificacion f,2002-07-01,2,0,2,0,2
50401,COLQUECHACA,estado nutricional en menores de 5 anos,clasificacion f,2002-07-01,7,5,7,5,12
21004,COLQUIRI,estado nutricional en menores de 5 anos,clasificacion f,2002-07-01,4,3,4,3,7
71301,COMARAPA,estado nutricional en menores de 5 anos,clasificacion f,2002-07-01,9,4,9,4,13
20301,CORO CORO,estado nutricional en menores de 5 anos,clasificacion f,2002-07-01,2,0,2,0,2
21401,COROICO,estado nutricional en menores de 5 anos,clasificacion f,2002-07-01,1,1,1,1,2
40301,CORQUE,estado nutricional en menores de 5 anos,clasificacion f,2002-07-01,1,0,1,0,1
50601,COTAGAITA,estado nutricional en menores de 5 anos,clasificacion f,2002-07-01,3,4,3,4,7
70102,COTOCA,estado nutricional en menores de 5 anos,clasificacion f,2002-07-01,3,0,3,0,3
70704,CUEVO,estado nutricional en menores de 5 anos,clasificacion f,2002-07-01,1,0,1,0,1
10902,CULPINA,estado nutricional en menores de 5 anos,clasificacion f,2002-07-01,11,8,11,8,19
20105,EL ALTO,estado nutricional en menores de 5 anos,clasificacion f,2002-07-01,64,28,64,28,92
40103,EL CHORO,estado nutricional en menores de 5 anos,clasificacion f,2002-07-01,1,0,1,0,1
71503,EL PUENTE(STC),estado nutricional en menores de 5 anos,clasificacion f,2002-07-01,0,5,0,5,5
60502,EL PUENTE(TJA),estado nutricional en menores de 5 anos,clasificacion f,2002-07-01,2,0,2,0,2
70105,EL TORNO,estado nutricional en menores de 5 anos,clasificacion f,2002-07-01,0,2,0,2,2
10405,EL VILLAR,estado nutricional en menores de 5 anos,clasificacion f,2002-07-01,4,3,4,3,7
60601,ENTRE RIOS,estado nutricional en menores de 5 anos,clasificacion f,2002-07-01,2,1,2,1,3
41101,EUCALIPTUS,estado nutricional en menores de 5 anos,clasificacion f,2002-07-01,0,1,0,1,1
71002,GENERAL SAAVEDRA,estado nutricional en menores de 5 anos,clasificacion f,2002-07-01,5,3,5,3,8
20602,GUANAY,estado nutricional en menores de 5 anos,clasificacion f,2002-07-01,4,3,4,3,7
20802,GUAQUI,estado nutricional en menores de 5 anos,clasificacion f,2002-07-01,4,0,4,0,4
80202,GUAYARAMERIN,estado nutricional en menores de 5 anos,clasificacion f,2002-07-01,9,3,9,3,12
70705,GUTIERREZ,estado nutricional en menores de 5 anos,clasificacion f,2002-07-01,11,12,11,12,23
10502,HUACARETA,estado nutricional en menores de 5 anos,clasificacion f,2002-07-01,1,6,1,6,7
11002,HUACAYA (VILLA DE HUACAYA),estado nutricional en menores de 5 anos,clasificacion f,2002-07-01,0,2,0,2,2
40701,HUANUNI,estado nutricional en menores de 5 anos,clasificacion f,2002-07-01,5,0,5,0,5
10304,ICLA,estado nutricional en menores de 5 anos,clasificacion f,2002-07-01,9,1,9,1,10
10703,INCAHUASI,estado nutricional en menores de 5 anos,clasificacion f,2002-07-01,18,14,18,14,32
21001,INQUISIVI,estado nutricional en menores de 5 anos,clasificacion f,2002-07-01,7,3,7,3,10
21102,IRUPANA (VILLA DE LANZA),estado nutricional en menores de 5 anos,clasificacion f,2002-07-01,0,1,0,1,1
21501,IXIAMAS,estado nutricional en menores de 5 anos,clasificacion f,2002-07-01,2,1,2,1,3
21105,LA ASUNTA,estado nutricional en menores de 5 anos,clasificacion f,2002-07-01,2,1,2,1,3
70104,LA GUARDIA,estado nutricional en menores de 5 anos,clasificacion f,2002-07-01,2,2,2,2,4
20101,LA PAZ,estado nutricional en menores de 5 anos,clasificacion f,2002-07-01,28,15,28,15,43
70701,LAGUNILLAS,estado nutricional en menores de 5 anos,clasificacion f,2002-07-01,1,0,1,0,1
50203,LLALLAGUA,estado nutricional en menores de 5 anos,clasificacion f,2002-07-01,2,14,2,14,16
11003,MACHARETI,estado nutricional en menores de 5 anos,clasificacion f,2002-07-01,1,2,1,2,3
80801,MAGDALENA,estado nutricional en menores de 5 anos,clasificacion f,2002-07-01,4,1,4,1,5
70903,MAIRANA,estado nutricional en menores de 5 anos,clasificacion f,2002-07-01,2,0,2,0,2
20103,MECAPACA,estado nutricional en menores de 5 anos,clasificacion f,2002-07-01,1,1,1,1,2
71003,MINEROS,estado nutricional en menores de 5 anos,clasificacion f,2002-07-01,11,4,11,4,15
31301,MIZQUE,estado nutricional en menores de 5 anos,clasificacion f,2002-07-01,2,2,2,2,4
20402,MOCOMOCO,estado nutricional en menores de 5 anos,clasificacion f,2002-07-01,1,1,1,1,2
10303,MOJOCOYA,estado nutricional en menores de 5 anos,clasificacion f,2002-07-01,1,2,1,2,3
10501,MONTEAGUDO,estado nutricional en menores de 5 anos,clasificacion f,2002-07-01,8,3,8,3,11
71001,MONTERO,estado nutricional en menores de 5 anos,clasificacion f,2002-07-01,11,12,11,12,23
30302,MOROCHATA,estado nutricional en menores de 5 anos,clasificacion f,2002-07-01,3,3,3,3,6
50404,OCURI,estado nutricional en menores de 5 anos,clasificacion f,2002-07-01,10,8,10,8,18
70202,OKINAWA,estado nutricional en menores de 5 anos,clasificacion f,2002-07-01,1,0,1,0,1
40101,ORURO,estado nutricional en menores de 5 anos,clasificacion f,2002-07-01,14,7,14,7,21
60201,PADCAYA,estado nutricional en menores de 5 anos,clasificacion f,2002-07-01,3,0,3,0,3
10401,PADILLA,estado nutricional en menores de 5 anos,clasificacion f,2002-07-01,4,1,4,1,5
70502,PAILON,estado nutricional en menores de 5 anos,clasificacion f,2002-07-01,0,3,0,3,3
20102,PALCA,estado nutricional en menores de 5 anos,clasificacion f,2002-07-01,1,4,1,4,5
21104,PALOS BLANCOS,estado nutricional en menores de 5 anos,clasificacion f,2002-07-01,1,1,1,1,2
40802,PAMPA AULLAGAS,estado nutricional en menores de 5 anos,clasificacion f,2002-07-01,1,0,1,0,1
70902,PAMPA GRANDE,estado nutricional en menores de 5 anos,clasificacion f,2002-07-01,1,0,1,0,1
21802,PAPEL PAMPA,estado nutricional en menores de 5 anos,clasificacion f,2002-07-01,0,1,0,1,1
30202,PASORAPA,estado nutricional en menores de 5 anos,clasificacion f,2002-07-01,2,0,2,0,2
21305,PATACAMAYA,estado nutricional en menores de 5 anos,clasificacion f,2002-07-01,5,1,5,1,6
20702,PELECHUCO,estado nutricional en menores de 5 anos,clasificacion f,2002-07-01,0,2,0,2,2
50403,POCOATA,estado nutricional en menores de 5 anos,clasificacion f,2002-07-01,3,4,3,4,7
31203,POCONA,estado nutricional en menores de 5 anos,clasificacion f,2002-07-01,2,2,2,2,4
31202,POJO (CBBA),estado nutricional en menores de 5 anos,clasificacion f,2002-07-01,5,4,5,4,9
40601,POOPO,estado nutricional en menores de 5 anos,clasificacion f,2002-07-01,0,1,0,1,1
51203,PORCO,estado nutricional en menores de 5 anos,clasificacion f,2002-07-01,1,1,1,1,2
10103,POROMA,estado nutricional en menores de 5 anos,clasificacion f,2002-07-01,11,6,11,6,17
70601,PORTACHUELO,estado nutricional en menores de 5 anos,clasificacion f,2002-07-01,4,0,4,0,4
50101,POTOSI,estado nutricional en menores de 5 anos,clasificacion f,2002-07-01,26,14,26,14,40
10302,PRESTO,estado nutricional en menores de 5 anos,clasificacion f,2002-07-01,12,9,12,9,21
21201,PUCARANI,estado nutricional en menores de 5 anos,clasificacion f,2002-07-01,0,3,0,3,3
20401,PUERTO ACOSTA,estado nutricional en menores de 5 anos,clasificacion f,2002-07-01,5,0,5,0,5
20403,PUERTO CARABUCO,estado nutricional en menores de 5 anos,clasificacion f,2002-07-01,3,5,3,5,8
90301,PUERTO GONZALO MORENO,estado nutricional en menores de 5 anos,clasificacion f,2002-07-01,2,0,2,0,2
71402,PUERTO QUIJARRO,estado nutricional en menores de 5 anos,clasificacion f,2002-07-01,0,2,0,2,2
71401,PUERTO SUAREZ,estado nutricional en menores de 5 anos,clasificacion f,2002-07-01,2,0,2,0,2
31205,PUERTO VILLARROEL,estado nutricional en menores de 5 anos,clasificacion f,2002-07-01,13,8,13,8,21
51101,PUNA,estado nutricional en menores de 5 anos,clasificacion f,2002-07-01,10,14,10,14,24
31401,PUNATA,estado nutricional en menores de 5 anos,clasificacion f,2002-07-01,1,1,1,1,2
20604,QUIABAYA,estado nutricional en menores de 5 anos,clasificacion f,2002-07-01,4,1,4,1,5
30901,QUILLACOLLO,estado nutricional en menores de 5 anos,clasificacion f,2002-07-01,2,1,2,1,3
50402,RAVELO,estado nutricional en menores de 5 anos,clasificacion f,2002-07-01,23,5,23,5,28
80201,RIBERALTA,estado nutricional en menores de 5 anos,clasificacion f,2002-07-01,31,23,31,23,54
70503,ROBORE,estado nutricional en menores de 5 anos,clasificacion f,2002-07-01,2,1,2,1,3
31001,SACABA,estado nutricional en menores de 5 anos,clasificacion f,2002-07-01,1,6,1,6,7
30404,SACABAMBA,estado nutricional en menores de 5 anos,clasificacion f,2002-07-01,0,4,0,4,4
50701,SACACA,estado nutricional en menores de 5 anos,clasificacion f,2002-07-01,11,4,11,4,15
70901,SAMAIPATA,estado nutricional en menores de 5 anos,clasificacion f,2002-07-01,1,0,1,0,1
71105,SAN ANTONIO DE LOMERIO,estado nutricional en menores de 5 anos,clasificacion f,2002-07-01,3,5,3,5,8
31403,SAN BENITO,estado nutricional en menores de 5 anos,clasificacion f,2002-07-01,7,0,7,0,7
80302,SAN BORJA,estado nutricional en menores de 5 anos,clasificacion f,2002-07-01,6,5,6,5,11
21502,SAN BUENA VENTURA,estado nutricional en menores de 5 anos,clasificacion f,2002-07-01,1,10,1,10,11
80501,SAN IGNACIO,estado nutricional en menores de 5 anos,clasificacion f,2002-07-01,1,12,1,12,13
70301,SAN IGNACIO DE VELASCO,estado nutricional en menores de 5 anos,clasificacion f,2002-07-01,13,1,13,1,14
71102,SAN JAVIER(STC),estado nutricional en menores de 5 anos,clasificacion f,2002-07-01,3,0,3,0,3
70501,SAN JOSE DE CHIQUITOS,estado nutricional en menores de 5 anos,clasificacion f,2002-07-01,4,0,4,0,4
71104,SAN JULIAN,estado nutricional en menores de 5 anos,clasificacion f,2002-07-01,5,3,5,3,8
90302,SAN LORENZO(PND),estado nutricional en menores de 5 anos,clasificacion f,2002-07-01,0,1,0,1,1
60501,SAN LORENZO(TJA),estado nutricional en menores de 5 anos,clasificacion f,2002-07-01,0,2,0,2,2
10702,SAN LUCAS,estado nutricional en menores de 5 anos,clasificacion f,2002-07-01,22,6,22,6,28
70302,SAN MIGUEL DE VELASCO,estado nutricional en menores de 5 anos,clasificacion f,2002-07-01,4,0,4,0,4
50501,SAN PEDRO DE BUENA VISTA,estado nutricional en menores de 5 anos,clasificacion f,2002-07-01,4,19,4,19,23
70303,SAN RAFAEL,estado nutricional en menores de 5 anos,clasificacion f,2002-07-01,1,0,1,0,1
70101,SANTA CRUZ DE LA SIERRA,estado nutricional en menores de 5 anos,clasificacion f,2002-07-01,15,8,15,8,23
70602,SANTA ROSA DEL SARA,estado nutricional en menores de 5 anos,clasificacion f,2002-07-01,1,0,1,0,1
20902,SAPAHAQUI,estado nutricional en menores de 5 anos,clasificacion f,2002-07-01,0,1,0,1,1
21301,SICA SICA (VILLA AROMA),estado nutricional en menores de 5 anos,clasificacion f,2002-07-01,1,1,1,1,2
30703,SICAYA,estado nutricional en menores de 5 anos,clasificacion f,2002-07-01,2,2,2,2,4
30902,SIPE SIPE,estado nutricional en menores de 5 anos,clasificacion f,2002-07-01,9,1,9,1,10
10403,SOPACHUY,estado nutricional en menores de 5 anos,clasificacion f,2002-07-01,17,9,17,9,26
20601,SORATA,estado nutricional en menores de 5 anos,clasificacion f,2002-07-01,0,2,0,2,2
10101,SUCRE,estado nutricional en menores de 5 anos,clasificacion f,2002-07-01,38,9,38,9,47
20603,TACACOMA,estado nutricional en menores de 5 anos,clasificacion f,2002-07-01,0,2,0,2,2
50303,TACOBAMBA,estado nutricional en menores de 5 anos,clasificacion f,2002-07-01,2,2,2,2,4
30602,TACOPAYA,estado nutricional en menores de 5 anos,clasificacion f,2002-07-01,0,1,0,1,1
31101,TAPACARI,estado nutricional en menores de 5 anos,clasificacion f,2002-07-01,0,4,0,4,4
10601,TARABUCO,estado nutricional en menores de 5 anos,clasificacion f,2002-07-01,28,15,28,15,43
30401,TARATA,estado nutricional en menores de 5 anos,clasificacion f,2002-07-01,1,0,1,0,1
60101,TARIJA,estado nutricional en menores de 5 anos,clasificacion f,2002-07-01,2,1,2,1,3
10202,TARVITA,estado nutricional en menores de 5 anos,clasificacion f,2002-07-01,14,4,14,4,18
20803,TIAWANACU,estado nutricional en menores de 5 anos,clasificacion f,2002-07-01,1,1,1,1,2
50102,TINGUIPAYA,estado nutricional en menores de 5 anos,clasificacion f,2002-07-01,0,4,0,4,4
20606,TIPUANI,estado nutricional en menores de 5 anos,clasificacion f,2002-07-01,0,1,0,1,1
30903,TIQUIPAYA,estado nutricional en menores de 5 anos,clasificacion f,2002-07-01,0,1,0,1,1
31601,TIRAQUE (CBBA),estado nutricional en menores de 5 anos,clasificacion f,2002-07-01,3,12,3,12,15
51202,TOMAVE,estado nutricional en menores de 5 anos,clasificacion f,2002-07-01,3,3,3,3,6
10402,TOMINA,estado nutricional en menores de 5 anos,clasificacion f,2002-07-01,12,4,12,4,16
50502,TORO TORO,estado nutricional en menores de 5 anos,clasificacion f,2002-07-01,2,2,2,2,4
31201,TOTORA(CBBA),estado nutricional en menores de 5 anos,clasificacion f,2002-07-01,2,1,2,1,3
80101,TRINIDAD,estado nutricional en menores de 5 anos,clasificacion f,2002-07-01,9,17,9,17,26
50801,TUPIZA,estado nutricional en menores de 5 anos,clasificacion f,2002-07-01,0,5,0,5,5
21302,UMALA,estado nutricional en menores de 5 anos,clasificacion f,2002-07-01,0,1,0,1,1
50201,UNCIA,estado nutricional en menores de 5 anos,clasificacion f,2002-07-01,3,1,3,1,4
60401,URIONDO (A. CONCEPCION),estado nutricional en menores de 5 anos,clasificacion f,2002-07-01,2,1,2,1,3
51201,UYUNI,estado nutricional en menores de 5 anos,clasificacion f,2002-07-01,5,2,5,2,7
30502,VACAS,estado nutricional en menores de 5 anos,clasificacion f,2002-07-01,0,1,0,1,1
70801,VALLEGRANDE,estado nutricional en menores de 5 anos,clasificacion f,2002-07-01,1,3,1,3,4
20801,VIACHA,estado nutricional en menores de 5 anos,clasificacion f,2002-07-01,0,3,0,3,3
31302,VILA VILA,estado nutricional en menores de 5 anos,clasificacion f,2002-07-01,1,7,1,7,8
60303,VILLA MONTES,estado nutricional en menores de 5 anos,clasificacion f,2002-07-01,3,1,3,1,4
31402,VILLA RIVERO,estado nutricional en menores de 5 anos,clasificacion f,2002-07-01,2,0,2,0,2
10801,VILLA SERRANO,estado nutricional en menores de 5 anos,clasificacion f,2002-07-01,12,8,12,8,20
31003,VILLA TUNARI,estado nutricional en menores de 5 anos,clasificacion f,2002-07-01,15,5,15,5,20
11001,VILLA VACA GUZMAN (MUYUPAMPA),estado nutricional en menores de 5 anos,clasificacion f,2002-07-01,2,2,2,2,4
51501,VILLAZON,estado nutricional en menores de 5 anos,clasificacion f,2002-07-01,0,4,0,4,4
30904,VINTO,estado nutricional en menores de 5 anos,clasificacion f,2002-07-01,6,3,6,3,9
50602,VITICHI,estado nutricional en menores de 5 anos,clasificacion f,2002-07-01,0,1,0,1,1
70201,WARNES,estado nutricional en menores de 5 anos,clasificacion f,2002-07-01,8,2,8,2,10
60301,YACUIBA,estado nutricional en menores de 5 anos,clasificacion f,2002-07-01,3,1,3,1,4
10602,YAMPARAEZ,estado nutricional en menores de 5 anos,clasificacion f,2002-07-01,11,6,11,6,17
10102,YOTALA,estado nutricional en menores de 5 anos,clasificacion f,2002-07-01,13,1,13,1,14
60402,YUNCHARA,estado nutricional en menores de 5 anos,clasificacion f,2002-07-01,1,0,1,0,1
10301,ZUDAÃ‘EZ,estado nutricional en menores de 5 anos,clasificacion f,2002-07-01,13,2,13,2,15
51302,ACACIO,estado nutricional en menores de 5 anos,clasificacion f,2002-08-01,5,5,5,5,10
20201,ACHACACHI,estado nutricional en menores de 5 anos,clasificacion f,2002-08-01,2,2,2,2,4
20104,ACHOCALLA,estado nutricional en menores de 5 anos,clasificacion f,2002-08-01,2,1,2,1,3
30201,AIQUILE,estado nutricional en menores de 5 anos,clasificacion f,2002-08-01,1,3,1,3,4
31303,ALALAY,estado nutricional en menores de 5 anos,clasificacion f,2002-08-01,0,1,0,1,1
10404,ALCALA,estado nutricional en menores de 5 anos,clasificacion f,2002-08-01,6,2,6,2,8
20202,ANCORAIMES,estado nutricional en menores de 5 anos,clasificacion f,2002-08-01,2,1,2,1,3
41201,ANDAMARCA,estado nutricional en menores de 5 anos,clasificacion f,2002-08-01,1,0,1,0,1
30402,ANZALDO,estado nutricional en menores de 5 anos,clasificacion f,2002-08-01,0,8,0,8,8
20701,APOLO,estado nutricional en menores de 5 anos,clasificacion f,2002-08-01,1,3,1,3,4
51301,ARAMPAMPA,estado nutricional en menores de 5 anos,clasificacion f,2002-08-01,1,1,1,1,2
30601,ARQUE,estado nutricional en menores de 5 anos,clasificacion f,2002-08-01,3,3,3,3,6
71501,ASCENCION DE GUARAYOS,estado nutricional en menores de 5 anos,clasificacion f,2002-08-01,10,7,10,7,17
20503,AUCAPATA,estado nutricional en menores de 5 anos,clasificacion f,2002-08-01,5,0,5,0,5
20502,AYATA,estado nutricional en menores de 5 anos,clasificacion f,2002-08-01,1,0,1,0,1
30301,AYOPAYA (V. DE INDEPENDENCIA),estado nutricional en menores de 5 anos,clasificacion f,2002-08-01,5,1,5,1,6
10201,AZURDUY,estado nutricional en menores de 5 anos,clasificacion f,2002-08-01,11,5,11,5,16
21203,BATALLAS,estado nutricional en menores de 5 anos,clasificacion f,2002-08-01,0,1,0,1,1
80802,BAURES,estado nutricional en menores de 5 anos,clasificacion f,2002-08-01,1,1,1,1,2
60202,BERMEJO,estado nutricional en menores de 5 anos,clasificacion f,2002-08-01,0,1,0,1,1
50301,BETANZOS,estado nutricional en menores de 5 anos,clasificacion f,2002-08-01,13,15,13,15,28
31501,BOLIVAR,estado nutricional en menores de 5 anos,clasificacion f,2002-08-01,1,0,1,0,1
70707,BOYUIBE,estado nutricional en menores de 5 anos,clasificacion f,2002-08-01,0,1,0,1,1
70703,CABEZAS,estado nutricional en menores de 5 anos,clasificacion f,2002-08-01,0,2,0,2,2
20905,CAIROMA,estado nutricional en menores de 5 anos,clasificacion f,2002-08-01,3,0,3,0,3
51102,"CAIZA ""D""",estado nutricional en menores de 5 anos,clasificacion f,2002-08-01,7,3,7,3,10
21003,CAJUATA,estado nutricional en menores de 5 anos,clasificacion f,2002-08-01,1,3,1,3,4
20303,CALACOTO,estado nutricional en menores de 5 anos,clasificacion f,2002-08-01,0,1,0,1,1
10701,CAMARGO,estado nutricional en menores de 5 anos,clasificacion f,2002-08-01,5,9,5,9,14
70706,CAMIRI,estado nutricional en menores de 5 anos,clasificacion f,2002-08-01,16,12,16,12,28
30701,CAPINOTA,estado nutricional en menores de 5 anos,clasificacion f,2002-08-01,6,7,6,7,13
20302,CAQUIAVIRI,estado nutricional en menores de 5 anos,clasificacion f,2002-08-01,4,2,4,2,6
22001,CARANAVI,estado nutricional en menores de 5 anos,clasificacion f,2002-08-01,7,11,7,11,18
60302,CARAPARI,estado nutricional en menores de 5 anos,clasificacion f,2002-08-01,1,1,1,1,2
50702,CARIPUYO,estado nutricional en menores de 5 anos,clasificacion f,2002-08-01,9,6,9,6,15
40201,CHALLAPATA,estado nutricional en menores de 5 anos,clasificacion f,2002-08-01,3,5,3,5,8
50302,CHAQUI,estado nutricional en menores de 5 anos,clasificacion f,2002-08-01,1,0,1,0,1
70702,CHARAGUA,estado nutricional en menores de 5 anos,clasificacion f,2002-08-01,4,3,4,3,7
20305,CHARAÃ‘A,estado nutricional en menores de 5 anos,clasificacion f,2002-08-01,1,0,1,0,1
31204,CHIMORE,estado nutricional en menores de 5 anos,clasificacion f,2002-08-01,1,0,1,0,1
20501,CHUMA,estado nutricional en menores de 5 anos,clasificacion f,2002-08-01,3,1,3,1,4
30801,CLIZA,estado nutricional en menores de 5 anos,clasificacion f,2002-08-01,1,0,1,0,1
90101,COBIJA,estado nutricional en menores de 5 anos,clasificacion f,2002-08-01,6,3,6,3,9
30101,COCHABAMBA,estado nutricional en menores de 5 anos,clasificacion f,2002-08-01,7,7,7,7,14
30905,COLCAPIRHUA,estado nutricional en menores de 5 anos,clasificacion f,2002-08-01,1,0,1,0,1
50901,"COLCHA ""K""",estado nutricional en menores de 5 anos,clasificacion f,2002-08-01,1,1,1,1,2
31002,COLOMI,estado nutricional en menores de 5 anos,clasificacion f,2002-08-01,2,3,2,3,5
50401,COLQUECHACA,estado nutricional en menores de 5 anos,clasificacion f,2002-08-01,32,4,32,4,36
21306,COLQUENCHA,estado nutricional en menores de 5 anos,clasificacion f,2002-08-01,3,0,3,0,3
21004,COLQUIRI,estado nutricional en menores de 5 anos,clasificacion f,2002-08-01,2,4,2,4,6
71301,COMARAPA,estado nutricional en menores de 5 anos,clasificacion f,2002-08-01,8,1,8,1,9
21701,COPACABANA,estado nutricional en menores de 5 anos,clasificacion f,2002-08-01,1,0,1,0,1
21402,CORIPATA,estado nutricional en menores de 5 anos,clasificacion f,2002-08-01,0,1,0,1,1
21401,COROICO,estado nutricional en menores de 5 anos,clasificacion f,2002-08-01,1,0,1,0,1
40301,CORQUE,estado nutricional en menores de 5 anos,clasificacion f,2002-08-01,1,1,1,1,2
50601,COTAGAITA,estado nutricional en menores de 5 anos,clasificacion f,2002-08-01,7,13,7,13,20
70704,CUEVO,estado nutricional en menores de 5 anos,clasificacion f,2002-08-01,0,2,0,2,2
10902,CULPINA,estado nutricional en menores de 5 anos,clasificacion f,2002-08-01,17,10,17,10,27
20105,EL ALTO,estado nutricional en menores de 5 anos,clasificacion f,2002-08-01,50,31,50,31,81
40103,EL CHORO,estado nutricional en menores de 5 anos,clasificacion f,2002-08-01,1,0,1,0,1
71503,EL PUENTE(STC),estado nutricional en menores de 5 anos,clasificacion f,2002-08-01,1,2,1,2,3
60502,EL PUENTE(TJA),estado nutricional en menores de 5 anos,clasificacion f,2002-08-01,1,0,1,0,1
70105,EL TORNO,estado nutricional en menores de 5 anos,clasificacion f,2002-08-01,2,1,2,1,3
10405,EL VILLAR,estado nutricional en menores de 5 anos,clasificacion f,2002-08-01,4,3,4,3,7
60601,ENTRE RIOS,estado nutricional en menores de 5 anos,clasificacion f,2002-08-01,1,0,1,0,1
41101,EUCALIPTUS,estado nutricional en menores de 5 anos,clasificacion f,2002-08-01,1,0,1,0,1
90203,FILADELFIA,estado nutricional en menores de 5 anos,clasificacion f,2002-08-01,1,0,1,0,1
71002,GENERAL SAAVEDRA,estado nutricional en menores de 5 anos,clasificacion f,2002-08-01,4,0,4,0,4
21601,GRAL. J.J. PEREZ (CHARAZANI),estado nutricional en menores de 5 anos,clasificacion f,2002-08-01,2,3,2,3,5
20602,GUANAY,estado nutricional en menores de 5 anos,clasificacion f,2002-08-01,4,11,4,11,15
20802,GUAQUI,estado nutricional en menores de 5 anos,clasificacion f,2002-08-01,1,0,1,0,1
80202,GUAYARAMERIN,estado nutricional en menores de 5 anos,clasificacion f,2002-08-01,9,6,9,6,15
70705,GUTIERREZ,estado nutricional en menores de 5 anos,clasificacion f,2002-08-01,5,6,5,6,11
10502,HUACARETA,estado nutricional en menores de 5 anos,clasificacion f,2002-08-01,0,1,0,1,1
11002,HUACAYA (VILLA DE HUACAYA),estado nutricional en menores de 5 anos,clasificacion f,2002-08-01,2,0,2,0,2
40701,HUANUNI,estado nutricional en menores de 5 anos,clasificacion f,2002-08-01,7,1,7,1,8
21005,ICHOCA,estado nutricional en menores de 5 anos,clasificacion f,2002-08-01,3,3,3,3,6
10304,ICLA,estado nutricional en menores de 5 anos,clasificacion f,2002-08-01,21,11,21,11,32
10703,INCAHUASI,estado nutricional en menores de 5 anos,clasificacion f,2002-08-01,5,5,5,5,10
21001,INQUISIVI,estado nutricional en menores de 5 anos,clasificacion f,2002-08-01,9,2,9,2,11
21501,IXIAMAS,estado nutricional en menores de 5 anos,clasificacion f,2002-08-01,1,0,1,0,1
21105,LA ASUNTA,estado nutricional en menores de 5 anos,clasificacion f,2002-08-01,1,3,1,3,4
70104,LA GUARDIA,estado nutricional en menores de 5 anos,clasificacion f,2002-08-01,1,0,1,0,1
20101,LA PAZ,estado nutricional en menores de 5 anos,clasificacion f,2002-08-01,31,19,31,19,50
10903,LAS CARRERAS,estado nutricional en menores de 5 anos,clasificacion f,2002-08-01,0,2,0,2,2
50203,LLALLAGUA,estado nutricional en menores de 5 anos,clasificacion f,2002-08-01,0,1,0,1,1
11003,MACHARETI,estado nutricional en menores de 5 anos,clasificacion f,2002-08-01,1,4,1,4,5
80801,MAGDALENA,estado nutricional en menores de 5 anos,clasificacion f,2002-08-01,2,1,2,1,3
20103,MECAPACA,estado nutricional en menores de 5 anos,clasificacion f,2002-08-01,1,0,1,0,1
71003,MINEROS,estado nutricional en menores de 5 anos,clasificacion f,2002-08-01,6,4,6,4,10
31301,MIZQUE,estado nutricional en menores de 5 anos,clasificacion f,2002-08-01,4,0,4,0,4
20402,MOCOMOCO,estado nutricional en menores de 5 anos,clasificacion f,2002-08-01,4,1,4,1,5
10303,MOJOCOYA,estado nutricional en menores de 5 anos,clasificacion f,2002-08-01,1,2,1,2,3
10501,MONTEAGUDO,estado nutricional en menores de 5 anos,clasificacion f,2002-08-01,7,5,7,5,12
71001,MONTERO,estado nutricional en menores de 5 anos,clasificacion f,2002-08-01,4,2,4,2,6
30302,MOROCHATA,estado nutricional en menores de 5 anos,clasificacion f,2002-08-01,2,6,2,6,8
50404,OCURI,estado nutricional en menores de 5 anos,clasificacion f,2002-08-01,7,10,7,10,17
30203,OMEREQUE,estado nutricional en menores de 5 anos,clasificacion f,2002-08-01,0,1,0,1,1
40101,ORURO,estado nutricional en menores de 5 anos,clasificacion f,2002-08-01,8,4,8,4,12
10401,PADILLA,estado nutricional en menores de 5 anos,clasificacion f,2002-08-01,4,4,4,4,8
70502,PAILON,estado nutricional en menores de 5 anos,clasificacion f,2002-08-01,2,2,2,2,4
20102,PALCA,estado nutricional en menores de 5 anos,clasificacion f,2002-08-01,0,1,0,1,1
21104,PALOS BLANCOS,estado nutricional en menores de 5 anos,clasificacion f,2002-08-01,1,2,1,2,3
40802,PAMPA AULLAGAS,estado nutricional en menores de 5 anos,clasificacion f,2002-08-01,1,0,1,0,1
21305,PATACAMAYA,estado nutricional en menores de 5 anos,clasificacion f,2002-08-01,3,0,3,0,3
20702,PELECHUCO,estado nutricional en menores de 5 anos,clasificacion f,2002-08-01,3,0,3,0,3
50403,POCOATA,estado nutricional en menores de 5 anos,clasificacion f,2002-08-01,2,5,2,5,7
31203,POCONA,estado nutricional en menores de 5 anos,clasificacion f,2002-08-01,3,2,3,2,5
31202,POJO (CBBA),estado nutricional en menores de 5 anos,clasificacion f,2002-08-01,7,4,7,4,11
51203,PORCO,estado nutricional en menores de 5 anos,clasificacion f,2002-08-01,1,1,1,1,2
10103,POROMA,estado nutricional en menores de 5 anos,clasificacion f,2002-08-01,19,10,19,10,29
70601,PORTACHUELO,estado nutricional en menores de 5 anos,clasificacion f,2002-08-01,2,1,2,1,3
50101,POTOSI,estado nutricional en menores de 5 anos,clasificacion f,2002-08-01,16,5,16,5,21
10302,PRESTO,estado nutricional en menores de 5 anos,clasificacion f,2002-08-01,6,7,6,7,13
21201,PUCARANI,estado nutricional en menores de 5 anos,clasificacion f,2002-08-01,0,1,0,1,1
20403,PUERTO CARABUCO,estado nutricional en menores de 5 anos,clasificacion f,2002-08-01,2,0,2,0,2
71402,PUERTO QUIJARRO,estado nutricional en menores de 5 anos,clasificacion f,2002-08-01,2,1,2,1,3
90201,PUERTO RICO,estado nutricional en menores de 5 anos,clasificacion f,2002-08-01,2,0,2,0,2
71401,PUERTO SUAREZ,estado nutricional en menores de 5 anos,clasificacion f,2002-08-01,4,1,4,1,5
31205,PUERTO VILLARROEL,estado nutricional en menores de 5 anos,clasificacion f,2002-08-01,23,13,23,13,36
51101,PUNA,estado nutricional en menores de 5 anos,clasificacion f,2002-08-01,6,7,6,7,13
20604,QUIABAYA,estado nutricional en menores de 5 anos,clasificacion f,2002-08-01,2,3,2,3,5
30901,QUILLACOLLO,estado nutricional en menores de 5 anos,clasificacion f,2002-08-01,4,0,4,0,4
21002,QUIME,estado nutricional en menores de 5 anos,clasificacion f,2002-08-01,1,0,1,0,1
50402,RAVELO,estado nutricional en menores de 5 anos,clasificacion f,2002-08-01,22,5,22,5,27
80301,REYES,estado nutricional en menores de 5 anos,clasificacion f,2002-08-01,0,3,0,3,3
80201,RIBERALTA,estado nutricional en menores de 5 anos,clasificacion f,2002-08-01,31,12,31,12,43
70503,ROBORE,estado nutricional en menores de 5 anos,clasificacion f,2002-08-01,2,0,2,0,2
31001,SACABA,estado nutricional en menores de 5 anos,clasificacion f,2002-08-01,5,0,5,0,5
30404,SACABAMBA,estado nutricional en menores de 5 anos,clasificacion f,2002-08-01,0,9,0,9,9
50701,SACACA,estado nutricional en menores de 5 anos,clasificacion f,2002-08-01,16,8,16,8,24
70901,SAMAIPATA,estado nutricional en menores de 5 anos,clasificacion f,2002-08-01,1,0,1,0,1
80602,SAN ANDRES,estado nutricional en menores de 5 anos,clasificacion f,2002-08-01,3,0,3,0,3
71105,SAN ANTONIO DE LOMERIO,estado nutricional en menores de 5 anos,clasificacion f,2002-08-01,2,5,2,5,7
31403,SAN BENITO,estado nutricional en menores de 5 anos,clasificacion f,2002-08-01,0,1,0,1,1
80302,SAN BORJA,estado nutricional en menores de 5 anos,clasificacion f,2002-08-01,7,7,7,7,14
80501,SAN IGNACIO,estado nutricional en menores de 5 anos,clasificacion f,2002-08-01,7,4,7,4,11
70301,SAN IGNACIO DE VELASCO,estado nutricional en menores de 5 anos,clasificacion f,2002-08-01,6,3,6,3,9
71102,SAN JAVIER(STC),estado nutricional en menores de 5 anos,clasificacion f,2002-08-01,1,1,1,1,2
70501,SAN JOSE DE CHIQUITOS,estado nutricional en menores de 5 anos,clasificacion f,2002-08-01,1,1,1,1,2
71104,SAN JULIAN,estado nutricional en menores de 5 anos,clasificacion f,2002-08-01,5,5,5,5,10
60501,SAN LORENZO(TJA),estado nutricional en menores de 5 anos,clasificacion f,2002-08-01,0,9,0,9,9
10702,SAN LUCAS,estado nutricional en menores de 5 anos,clasificacion f,2002-08-01,25,10,25,10,35
71201,SAN MATIAS,estado nutricional en menores de 5 anos,clasificacion f,2002-08-01,4,3,4,3,7
70302,SAN MIGUEL DE VELASCO,estado nutricional en menores de 5 anos,clasificacion f,2002-08-01,1,1,1,1,2
50501,SAN PEDRO DE BUENA VISTA,estado nutricional en menores de 5 anos,clasificacion f,2002-08-01,9,18,9,18,27
70303,SAN RAFAEL,estado nutricional en menores de 5 anos,clasificacion f,2002-08-01,3,1,3,1,4
80401,SANTA ANA,estado nutricional en menores de 5 anos,clasificacion f,2002-08-01,2,0,2,0,2
70101,SANTA CRUZ DE LA SIERRA,estado nutricional en menores de 5 anos,clasificacion f,2002-08-01,15,15,15,15,30
70602,SANTA ROSA DEL SARA,estado nutricional en menores de 5 anos,clasificacion f,2002-08-01,1,2,1,2,3
41401,SANTIAGO DE HUARI,estado nutricional en menores de 5 anos,clasificacion f,2002-08-01,2,1,2,1,3
21901,SANTIAGO DE MACHACA,estado nutricional en menores de 5 anos,clasificacion f,2002-08-01,1,0,1,0,1
40202,SANTUARIO DE QUILLACAS,estado nutricional en menores de 5 anos,clasificacion f,2002-08-01,0,1,0,1,1
21301,SICA SICA (VILLA AROMA),estado nutricional en menores de 5 anos,clasificacion f,2002-08-01,2,0,2,0,2
30703,SICAYA,estado nutricional en menores de 5 anos,clasificacion f,2002-08-01,3,0,3,0,3
30902,SIPE SIPE,estado nutricional en menores de 5 anos,clasificacion f,2002-08-01,6,2,6,2,8
10403,SOPACHUY,estado nutricional en menores de 5 anos,clasificacion f,2002-08-01,8,5,8,5,13
20601,SORATA,estado nutricional en menores de 5 anos,clasificacion f,2002-08-01,0,1,0,1,1
10101,SUCRE,estado nutricional en menores de 5 anos,clasificacion f,2002-08-01,20,14,20,14,34
50303,TACOBAMBA,estado nutricional en menores de 5 anos,clasificacion f,2002-08-01,6,3,6,3,9
30602,TACOPAYA,estado nutricional en menores de 5 anos,clasificacion f,2002-08-01,6,0,6,0,6
31101,TAPACARI,estado nutricional en menores de 5 anos,clasificacion f,2002-08-01,4,10,4,10,14
10601,TARABUCO,estado nutricional en menores de 5 anos,clasificacion f,2002-08-01,31,8,31,8,39
30401,TARATA,estado nutricional en menores de 5 anos,clasificacion f,2002-08-01,2,0,2,0,2
60101,TARIJA,estado nutricional en menores de 5 anos,clasificacion f,2002-08-01,1,2,1,2,3
10202,TARVITA,estado nutricional en menores de 5 anos,clasificacion f,2002-08-01,8,4,8,4,12
50102,TINGUIPAYA,estado nutricional en menores de 5 anos,clasificacion f,2002-08-01,0,11,0,11,11
20606,TIPUANI,estado nutricional en menores de 5 anos,clasificacion f,2002-08-01,0,2,0,2,2
30903,TIQUIPAYA,estado nutricional en menores de 5 anos,clasificacion f,2002-08-01,0,3,0,3,3
31601,TIRAQUE (CBBA),estado nutricional en menores de 5 anos,clasificacion f,2002-08-01,6,3,6,3,9
51202,TOMAVE,estado nutricional en menores de 5 anos,clasificacion f,2002-08-01,1,3,1,3,4
10402,TOMINA,estado nutricional en menores de 5 anos,clasificacion f,2002-08-01,10,2,10,2,12
50502,TORO TORO,estado nutricional en menores de 5 anos,clasificacion f,2002-08-01,8,5,8,5,13
41301,TOTORA(ORR),estado nutricional en menores de 5 anos,clasificacion f,2002-08-01,2,1,2,1,3
80101,TRINIDAD,estado nutricional en menores de 5 anos,clasificacion f,2002-08-01,8,12,8,12,20
40402,TURCO,estado nutricional en menores de 5 anos,clasificacion f,2002-08-01,1,0,1,0,1
51201,UYUNI,estado nutricional en menores de 5 anos,clasificacion f,2002-08-01,0,6,0,6,6
20801,VIACHA,estado nutricional en menores de 5 anos,clasificacion f,2002-08-01,0,2,0,2,2
31302,VILA VILA,estado nutricional en menores de 5 anos,clasificacion f,2002-08-01,1,5,1,5,6
60303,VILLA MONTES,estado nutricional en menores de 5 anos,clasificacion f,2002-08-01,5,4,5,4,9
10801,VILLA SERRANO,estado nutricional en menores de 5 anos,clasificacion f,2002-08-01,14,15,14,15,29
31003,VILLA TUNARI,estado nutricional en menores de 5 anos,clasificacion f,2002-08-01,4,6,4,6,10
11001,VILLA VACA GUZMAN (MUYUPAMPA),estado nutricional en menores de 5 anos,clasificacion f,2002-08-01,3,0,3,0,3
51501,VILLAZON,estado nutricional en menores de 5 anos,clasificacion f,2002-08-01,34,8,34,8,42
50602,VITICHI,estado nutricional en menores de 5 anos,clasificacion f,2002-08-01,0,7,0,7,7
70201,WARNES,estado nutricional en menores de 5 anos,clasificacion f,2002-08-01,5,3,5,3,8
20903,YACO,estado nutricional en menores de 5 anos,clasificacion f,2002-08-01,1,2,1,2,3
60301,YACUIBA,estado nutricional en menores de 5 anos,clasificacion f,2002-08-01,2,1,2,1,3
10602,YAMPARAEZ,estado nutricional en menores de 5 anos,clasificacion f,2002-08-01,14,5,14,5,19
10102,YOTALA,estado nutricional en menores de 5 anos,clasificacion f,2002-08-01,8,2,8,2,10
10301,ZUDAÃ‘EZ,estado nutricional en menores de 5 anos,clasificacion f,2002-08-01,7,4,7,4,11
51302,ACACIO,estado nutricional en menores de 5 anos,clasificacion f,2002-09-01,7,5,7,5,12
20201,ACHACACHI,estado nutricional en menores de 5 anos,clasificacion f,2002-09-01,8,4,8,4,12
20104,ACHOCALLA,estado nutricional en menores de 5 anos,clasificacion f,2002-09-01,1,0,1,0,1
30201,AIQUILE,estado nutricional en menores de 5 anos,clasificacion f,2002-09-01,6,0,6,0,6
10404,ALCALA,estado nutricional en menores de 5 anos,clasificacion f,2002-09-01,2,1,2,1,3
20202,ANCORAIMES,estado nutricional en menores de 5 anos,clasificacion f,2002-09-01,23,34,23,34,57
30402,ANZALDO,estado nutricional en menores de 5 anos,clasificacion f,2002-09-01,0,3,0,3,3
20701,APOLO,estado nutricional en menores de 5 anos,clasificacion f,2002-09-01,3,1,3,1,4
30501,ARANI,estado nutricional en menores de 5 anos,clasificacion f,2002-09-01,2,1,2,1,3
30601,ARQUE,estado nutricional en menores de 5 anos,clasificacion f,2002-09-01,3,1,3,1,4
50802,ATOCHA,estado nutricional en menores de 5 anos,clasificacion f,2002-09-01,0,6,0,6,6
20503,AUCAPATA,estado nutricional en menores de 5 anos,clasificacion f,2002-09-01,0,1,0,1,1
20502,AYATA,estado nutricional en menores de 5 anos,clasificacion f,2002-09-01,9,1,9,1,10
30301,AYOPAYA (V. DE INDEPENDENCIA),estado nutricional en menores de 5 anos,clasificacion f,2002-09-01,1,3,1,3,4
10201,AZURDUY,estado nutricional en menores de 5 anos,clasificacion f,2002-09-01,13,3,13,3,16
21203,BATALLAS,estado nutricional en menores de 5 anos,clasificacion f,2002-09-01,1,0,1,0,1
50104,BELEN DE URMIRI,estado nutricional en menores de 5 anos,clasificacion f,2002-09-01,0,2,0,2,2
60202,BERMEJO,estado nutricional en menores de 5 anos,clasificacion f,2002-09-01,1,1,1,1,2
50301,BETANZOS,estado nutricional en menores de 5 anos,clasificacion f,2002-09-01,21,13,21,13,34
31501,BOLIVAR,estado nutricional en menores de 5 anos,clasificacion f,2002-09-01,5,2,5,2,7
70401,BUENA VISTA,estado nutricional en menores de 5 anos,clasificacion f,2002-09-01,1,1,1,1,2
70703,CABEZAS,estado nutricional en menores de 5 anos,clasificacion f,2002-09-01,5,3,5,3,8
20905,CAIROMA,estado nutricional en menores de 5 anos,clasificacion f,2002-09-01,5,4,5,4,9
51102,"CAIZA ""D""",estado nutricional en menores de 5 anos,clasificacion f,2002-09-01,6,3,6,3,9
21003,CAJUATA,estado nutricional en menores de 5 anos,clasificacion f,2002-09-01,1,2,1,2,3
21304,CALAMARCA,estado nutricional en menores de 5 anos,clasificacion f,2002-09-01,1,1,1,1,2
10701,CAMARGO,estado nutricional en menores de 5 anos,clasificacion f,2002-09-01,1,2,1,2,3
10901,CAMATAQUI (C. VILLA ABECIA),estado nutricional en menores de 5 anos,clasificacion f,2002-09-01,1,0,1,0,1
70706,CAMIRI,estado nutricional en menores de 5 anos,clasificacion f,2002-09-01,4,8,4,8,12
30701,CAPINOTA,estado nutricional en menores de 5 anos,clasificacion f,2002-09-01,4,5,4,5,9
20302,CAQUIAVIRI,estado nutricional en menores de 5 anos,clasificacion f,2002-09-01,0,2,0,2,2
40102,CARACOLLO,estado nutricional en menores de 5 anos,clasificacion f,2002-09-01,1,0,1,0,1
22001,CARANAVI,estado nutricional en menores de 5 anos,clasificacion f,2002-09-01,1,2,1,2,3
60302,CARAPARI,estado nutricional en menores de 5 anos,clasificacion f,2002-09-01,3,0,3,0,3
50702,CARIPUYO,estado nutricional en menores de 5 anos,clasificacion f,2002-09-01,5,5,5,5,10
40201,CHALLAPATA,estado nutricional en menores de 5 anos,clasificacion f,2002-09-01,4,1,4,1,5
50302,CHAQUI,estado nutricional en menores de 5 anos,clasificacion f,2002-09-01,2,0,2,0,2
70702,CHARAGUA,estado nutricional en menores de 5 anos,clasificacion f,2002-09-01,6,8,6,8,14
20305,CHARAÃ‘A,estado nutricional en menores de 5 anos,clasificacion f,2002-09-01,3,0,3,0,3
50202,CHAYANTA,estado nutricional en menores de 5 anos,clasificacion f,2002-09-01,5,2,5,2,7
40302,CHOQUE COTA,estado nutricional en menores de 5 anos,clasificacion f,2002-09-01,1,0,1,0,1
21101,CHULUMANI (V. DE LA LIBERTAD),estado nutricional en menores de 5 anos,clasificacion f,2002-09-01,0,1,0,1,1
20501,CHUMA,estado nutricional en menores de 5 anos,clasificacion f,2002-09-01,1,1,1,1,2
90101,COBIJA,estado nutricional en menores de 5 anos,clasificacion f,2002-09-01,1,0,1,0,1
30101,COCHABAMBA,estado nutricional en menores de 5 anos,clasificacion f,2002-09-01,14,5,14,5,19
30905,COLCAPIRHUA,estado nutricional en menores de 5 anos,clasificacion f,2002-09-01,0,2,0,2,2
50901,"COLCHA ""K""",estado nutricional en menores de 5 anos,clasificacion f,2002-09-01,1,0,1,0,1
31002,COLOMI,estado nutricional en menores de 5 anos,clasificacion f,2002-09-01,1,6,1,6,7
50401,COLQUECHACA,estado nutricional en menores de 5 anos,clasificacion f,2002-09-01,20,4,20,4,24
21004,COLQUIRI,estado nutricional en menores de 5 anos,clasificacion f,2002-09-01,0,2,0,2,2
71301,COMARAPA,estado nutricional en menores de 5 anos,clasificacion f,2002-09-01,4,5,4,5,9
20605,COMBAYA,estado nutricional en menores de 5 anos,clasificacion f,2002-09-01,1,0,1,0,1
20301,CORO CORO,estado nutricional en menores de 5 anos,clasificacion f,2002-09-01,0,1,0,1,1
21401,COROICO,estado nutricional en menores de 5 anos,clasificacion f,2002-09-01,4,0,4,0,4
50601,COTAGAITA,estado nutricional en menores de 5 anos,clasificacion f,2002-09-01,1,1,1,1,2
70102,COTOCA,estado nutricional en menores de 5 anos,clasificacion f,2002-09-01,3,0,3,0,3
70704,CUEVO,estado nutricional en menores de 5 anos,clasificacion f,2002-09-01,1,3,1,3,4
10902,CULPINA,estado nutricional en menores de 5 anos,clasificacion f,2002-09-01,20,12,20,12,32
40401,CURAHUARA DE CARANGAS,estado nutricional en menores de 5 anos,clasificacion f,2002-09-01,0,1,0,1,1
20105,EL ALTO,estado nutricional en menores de 5 anos,clasificacion f,2002-09-01,74,23,74,23,97
40103,EL CHORO,estado nutricional en menores de 5 anos,clasificacion f,2002-09-01,1,0,1,0,1
71503,EL PUENTE(STC),estado nutricional en menores de 5 anos,clasificacion f,2002-09-01,0,8,0,8,8
60502,EL PUENTE(TJA),estado nutricional en menores de 5 anos,clasificacion f,2002-09-01,1,1,1,1,2
70105,EL TORNO,estado nutricional en menores de 5 anos,clasificacion f,2002-09-01,1,0,1,0,1
10405,EL VILLAR,estado nutricional en menores de 5 anos,clasificacion f,2002-09-01,3,4,3,4,7
60601,ENTRE RIOS,estado nutricional en menores de 5 anos,clasificacion f,2002-09-01,3,0,3,0,3
21601,GRAL. J.J. PEREZ (CHARAZANI),estado nutricional en menores de 5 anos,clasificacion f,2002-09-01,1,2,1,2,3
20602,GUANAY,estado nutricional en menores de 5 anos,clasificacion f,2002-09-01,1,6,1,6,7
20802,GUAQUI,estado nutricional en menores de 5 anos,clasificacion f,2002-09-01,3,0,3,0,3
80202,GUAYARAMERIN,estado nutricional en menores de 5 anos,clasificacion f,2002-09-01,7,2,7,2,9
70705,GUTIERREZ,estado nutricional en menores de 5 anos,clasificacion f,2002-09-01,4,9,4,9,13
10502,HUACARETA,estado nutricional en menores de 5 anos,clasificacion f,2002-09-01,1,1,1,1,2
11002,HUACAYA (VILLA DE HUACAYA),estado nutricional en menores de 5 anos,clasificacion f,2002-09-01,1,1,1,1,2
40701,HUANUNI,estado nutricional en menores de 5 anos,clasificacion f,2002-09-01,0,1,0,1,1
21005,ICHOCA,estado nutricional en menores de 5 anos,clasificacion f,2002-09-01,1,0,1,0,1
10304,ICLA,estado nutricional en menores de 5 anos,clasificacion f,2002-09-01,10,9,10,9,19
10703,INCAHUASI,estado nutricional en menores de 5 anos,clasificacion f,2002-09-01,3,8,3,8,11
21001,INQUISIVI,estado nutricional en menores de 5 anos,clasificacion f,2002-09-01,4,5,4,5,9
21102,IRUPANA (VILLA DE LANZA),estado nutricional en menores de 5 anos,clasificacion f,2002-09-01,2,0,2,0,2
21501,IXIAMAS,estado nutricional en menores de 5 anos,clasificacion f,2002-09-01,1,0,1,0,1
21105,LA ASUNTA,estado nutricional en menores de 5 anos,clasificacion f,2002-09-01,4,1,4,1,5
70104,LA GUARDIA,estado nutricional en menores de 5 anos,clasificacion f,2002-09-01,1,2,1,2,3
20101,LA PAZ,estado nutricional en menores de 5 anos,clasificacion f,2002-09-01,33,18,33,18,51
70701,LAGUNILLAS,estado nutricional en menores de 5 anos,clasificacion f,2002-09-01,3,1,3,1,4
50203,LLALLAGUA,estado nutricional en menores de 5 anos,clasificacion f,2002-09-01,1,19,1,19,20
20901,LURIBAY,estado nutricional en menores de 5 anos,clasificacion f,2002-09-01,2,3,2,3,5
40702,MACHACAMARCA,estado nutricional en menores de 5 anos,clasificacion f,2002-09-01,1,0,1,0,1
11003,MACHARETI,estado nutricional en menores de 5 anos,clasificacion f,2002-09-01,2,3,2,3,5
80801,MAGDALENA,estado nutricional en menores de 5 anos,clasificacion f,2002-09-01,2,0,2,0,2
20904,MALLA,estado nutricional en menores de 5 anos,clasificacion f,2002-09-01,0,1,0,1,1
31301,MIZQUE,estado nutricional en menores de 5 anos,clasificacion f,2002-09-01,2,7,2,7,9
20402,MOCOMOCO,estado nutricional en menores de 5 anos,clasificacion f,2002-09-01,0,1,0,1,1
10303,MOJOCOYA,estado nutricional en menores de 5 anos,clasificacion f,2002-09-01,1,1,1,1,2
10501,MONTEAGUDO,estado nutricional en menores de 5 anos,clasificacion f,2002-09-01,10,5,10,5,15
71001,MONTERO,estado nutricional en menores de 5 anos,clasificacion f,2002-09-01,7,3,7,3,10
70803,MORO MORO,estado nutricional en menores de 5 anos,clasificacion f,2002-09-01,3,1,3,1,4
30302,MOROCHATA,estado nutricional en menores de 5 anos,clasificacion f,2002-09-01,4,2,4,2,6
50404,OCURI,estado nutricional en menores de 5 anos,clasificacion f,2002-09-01,10,9,10,9,19
30203,OMEREQUE,estado nutricional en menores de 5 anos,clasificacion f,2002-09-01,0,5,0,5,5
40101,ORURO,estado nutricional en menores de 5 anos,clasificacion f,2002-09-01,8,6,8,6,14
10401,PADILLA,estado nutricional en menores de 5 anos,clasificacion f,2002-09-01,3,5,3,5,8
70502,PAILON,estado nutricional en menores de 5 anos,clasificacion f,2002-09-01,2,0,2,0,2
20102,PALCA,estado nutricional en menores de 5 anos,clasificacion f,2002-09-01,4,5,4,5,9
21104,PALOS BLANCOS,estado nutricional en menores de 5 anos,clasificacion f,2002-09-01,1,3,1,3,4
70902,PAMPA GRANDE,estado nutricional en menores de 5 anos,clasificacion f,2002-09-01,1,2,1,2,3
21305,PATACAMAYA,estado nutricional en menores de 5 anos,clasificacion f,2002-09-01,1,0,1,0,1
40602,PAZÃ‘A,estado nutricional en menores de 5 anos,clasificacion f,2002-09-01,0,1,0,1,1
20702,PELECHUCO,estado nutricional en menores de 5 anos,clasificacion f,2002-09-01,3,0,3,0,3
50403,POCOATA,estado nutricional en menores de 5 anos,clasificacion f,2002-09-01,7,10,7,10,17
31203,POCONA,estado nutricional en menores de 5 anos,clasificacion f,2002-09-01,2,5,2,5,7
31202,POJO (CBBA),estado nutricional en menores de 5 anos,clasificacion f,2002-09-01,3,4,3,4,7
51203,PORCO,estado nutricional en menores de 5 anos,clasificacion f,2002-09-01,0,2,0,2,2
10103,POROMA,estado nutricional en menores de 5 anos,clasificacion f,2002-09-01,10,6,10,6,16
70601,PORTACHUELO,estado nutricional en menores de 5 anos,clasificacion f,2002-09-01,5,0,5,0,5
90102,PORVENIR,estado nutricional en menores de 5 anos,clasificacion f,2002-09-01,1,0,1,0,1
50101,POTOSI,estado nutricional en menores de 5 anos,clasificacion f,2002-09-01,31,15,31,15,46
10302,PRESTO,estado nutricional en menores de 5 anos,clasificacion f,2002-09-01,10,6,10,6,16
20401,PUERTO ACOSTA,estado nutricional en menores de 5 anos,clasificacion f,2002-09-01,1,0,1,0,1
20403,PUERTO CARABUCO,estado nutricional en menores de 5 anos,clasificacion f,2002-09-01,2,0,2,0,2
21204,PUERTO PEREZ,estado nutricional en menores de 5 anos,clasificacion f,2002-09-01,1,0,1,0,1
71402,PUERTO QUIJARRO,estado nutricional en menores de 5 anos,clasificacion f,2002-09-01,1,2,1,2,3
71401,PUERTO SUAREZ,estado nutricional en menores de 5 anos,clasificacion f,2002-09-01,4,0,4,0,4
31205,PUERTO VILLARROEL,estado nutricional en menores de 5 anos,clasificacion f,2002-09-01,16,5,16,5,21
51101,PUNA,estado nutricional en menores de 5 anos,clasificacion f,2002-09-01,29,8,29,8,37
31401,PUNATA,estado nutricional en menores de 5 anos,clasificacion f,2002-09-01,1,2,1,2,3
20604,QUIABAYA,estado nutricional en menores de 5 anos,clasificacion f,2002-09-01,2,5,2,5,7
30901,QUILLACOLLO,estado nutricional en menores de 5 anos,clasificacion f,2002-09-01,2,2,2,2,4
50402,RAVELO,estado nutricional en menores de 5 anos,clasificacion f,2002-09-01,27,9,27,9,36
80201,RIBERALTA,estado nutricional en menores de 5 anos,clasificacion f,2002-09-01,25,22,25,22,47
70503,ROBORE,estado nutricional en menores de 5 anos,clasificacion f,2002-09-01,1,0,1,0,1
31001,SACABA,estado nutricional en menores de 5 anos,clasificacion f,2002-09-01,10,5,10,5,15
30404,SACABAMBA,estado nutricional en menores de 5 anos,clasificacion f,2002-09-01,0,9,0,9,9
50701,SACACA,estado nutricional en menores de 5 anos,clasificacion f,2002-09-01,15,10,15,10,25
71302,SAIPINA,estado nutricional en menores de 5 anos,clasificacion f,2002-09-01,1,0,1,0,1
40801,SALINAS DE GARCI MENDOZA,estado nutricional en menores de 5 anos,clasificacion f,2002-09-01,1,0,1,0,1
71105,SAN ANTONIO DE LOMERIO,estado nutricional en menores de 5 anos,clasificacion f,2002-09-01,4,5,4,5,9
31403,SAN BENITO,estado nutricional en menores de 5 anos,clasificacion f,2002-09-01,1,0,1,0,1
80302,SAN BORJA,estado nutricional en menores de 5 anos,clasificacion f,2002-09-01,8,4,8,4,12
21502,SAN BUENA VENTURA,estado nutricional en menores de 5 anos,clasificacion f,2002-09-01,4,2,4,2,6
70402,SAN CARLOS,estado nutricional en menores de 5 anos,clasificacion f,2002-09-01,3,1,3,1,4
80501,SAN IGNACIO,estado nutricional en menores de 5 anos,clasificacion f,2002-09-01,8,10,8,10,18
70301,SAN IGNACIO DE VELASCO,estado nutricional en menores de 5 anos,clasificacion f,2002-09-01,11,3,11,3,14
71102,SAN JAVIER(STC),estado nutricional en menores de 5 anos,clasificacion f,2002-09-01,0,1,0,1,1
70501,SAN JOSE DE CHIQUITOS,estado nutricional en menores de 5 anos,clasificacion f,2002-09-01,1,0,1,0,1
71104,SAN JULIAN,estado nutricional en menores de 5 anos,clasificacion f,2002-09-01,9,6,9,6,15
60501,SAN LORENZO(TJA),estado nutricional en menores de 5 anos,clasificacion f,2002-09-01,1,1,1,1,2
10702,SAN LUCAS,estado nutricional en menores de 5 anos,clasificacion f,2002-09-01,27,6,27,6,33
71201,SAN MATIAS,estado nutricional en menores de 5 anos,clasificacion f,2002-09-01,3,3,3,3,6
70302,SAN MIGUEL DE VELASCO,estado nutricional en menores de 5 anos,clasificacion f,2002-09-01,1,0,1,0,1
51001,SAN PABLO DE LIPEZ,estado nutricional en menores de 5 anos,clasificacion f,2002-09-01,1,0,1,0,1
50501,SAN PEDRO DE BUENA VISTA,estado nutricional en menores de 5 anos,clasificacion f,2002-09-01,15,23,15,23,38
21801,SAN PEDRO DE CURAHUARA,estado nutricional en menores de 5 anos,clasificacion f,2002-09-01,0,1,0,1,1
70303,SAN RAFAEL,estado nutricional en menores de 5 anos,clasificacion f,2002-09-01,1,1,1,1,2
80401,SANTA ANA,estado nutricional en menores de 5 anos,clasificacion f,2002-09-01,2,1,2,1,3
70101,SANTA CRUZ DE LA SIERRA,estado nutricional en menores de 5 anos,clasificacion f,2002-09-01,42,12,42,12,54
70602,SANTA ROSA DEL SARA,estado nutricional en menores de 5 anos,clasificacion f,2002-09-01,2,0,2,0,2
20308,SANTIAGO DE CALLAPA,estado nutricional en menores de 5 anos,clasificacion f,2002-09-01,1,0,1,0,1
21901,SANTIAGO DE MACHACA,estado nutricional en menores de 5 anos,clasificacion f,2002-09-01,1,0,1,0,1
30702,SANTIVAÃ‘ES,estado nutricional en menores de 5 anos,clasificacion f,2002-09-01,2,0,2,0,2
20902,SAPAHAQUI,estado nutricional en menores de 5 anos,clasificacion f,2002-09-01,1,0,1,0,1
21301,SICA SICA (VILLA AROMA),estado nutricional en menores de 5 anos,clasificacion f,2002-09-01,0,1,0,1,1
30703,SICAYA,estado nutricional en menores de 5 anos,clasificacion f,2002-09-01,4,1,4,1,5
30902,SIPE SIPE,estado nutricional en menores de 5 anos,clasificacion f,2002-09-01,20,6,20,6,26
10403,SOPACHUY,estado nutricional en menores de 5 anos,clasificacion f,2002-09-01,10,18,10,18,28
20601,SORATA,estado nutricional en menores de 5 anos,clasificacion f,2002-09-01,3,1,3,1,4
10101,SUCRE,estado nutricional en menores de 5 anos,clasificacion f,2002-09-01,33,7,33,7,40
50303,TACOBAMBA,estado nutricional en menores de 5 anos,clasificacion f,2002-09-01,13,0,13,0,13
30602,TACOPAYA,estado nutricional en menores de 5 anos,clasificacion f,2002-09-01,12,4,12,4,16
31101,TAPACARI,estado nutricional en menores de 5 anos,clasificacion f,2002-09-01,4,8,4,8,12
10601,TARABUCO,estado nutricional en menores de 5 anos,clasificacion f,2002-09-01,28,10,28,10,38
30401,TARATA,estado nutricional en menores de 5 anos,clasificacion f,2002-09-01,3,0,3,0,3
60101,TARIJA,estado nutricional en menores de 5 anos,clasificacion f,2002-09-01,2,1,2,1,3
10202,TARVITA,estado nutricional en menores de 5 anos,clasificacion f,2002-09-01,17,5,17,5,22
50102,TINGUIPAYA,estado nutricional en menores de 5 anos,clasificacion f,2002-09-01,4,10,4,10,14
30903,TIQUIPAYA,estado nutricional en menores de 5 anos,clasificacion f,2002-09-01,0,1,0,1,1
31601,TIRAQUE (CBBA),estado nutricional en menores de 5 anos,clasificacion f,2002-09-01,7,12,7,12,19
30802,TOCO,estado nutricional en menores de 5 anos,clasificacion f,2002-09-01,0,1,0,1,1
41001,TOLEDO,estado nutricional en menores de 5 anos,clasificacion f,2002-09-01,2,0,2,0,2
51202,TOMAVE,estado nutricional en menores de 5 anos,clasificacion f,2002-09-01,1,1,1,1,2
10402,TOMINA,estado nutricional en menores de 5 anos,clasificacion f,2002-09-01,5,4,5,4,9
50502,TORO TORO,estado nutricional en menores de 5 anos,clasificacion f,2002-09-01,3,2,3,2,5
31201,TOTORA(CBBA),estado nutricional en menores de 5 anos,clasificacion f,2002-09-01,3,1,3,1,4
70802,TRIGAL,estado nutricional en menores de 5 anos,clasificacion f,2002-09-01,0,1,0,1,1
80101,TRINIDAD,estado nutricional en menores de 5 anos,clasificacion f,2002-09-01,1,35,1,35,36
50801,TUPIZA,estado nutricional en menores de 5 anos,clasificacion f,2002-09-01,1,7,1,7,8
50201,UNCIA,estado nutricional en menores de 5 anos,clasificacion f,2002-09-01,1,0,1,0,1
71502,URUBICHA,estado nutricional en menores de 5 anos,clasificacion f,2002-09-01,0,1,0,1,1
51201,UYUNI,estado nutricional en menores de 5 anos,clasificacion f,2002-09-01,2,1,2,1,3
30502,VACAS,estado nutricional en menores de 5 anos,clasificacion f,2002-09-01,4,0,4,0,4
70801,VALLEGRANDE,estado nutricional en menores de 5 anos,clasificacion f,2002-09-01,4,0,4,0,4
20801,VIACHA,estado nutricional en menores de 5 anos,clasificacion f,2002-09-01,1,2,1,2,3
31302,VILA VILA,estado nutricional en menores de 5 anos,clasificacion f,2002-09-01,1,3,1,3,4
60303,VILLA MONTES,estado nutricional en menores de 5 anos,clasificacion f,2002-09-01,6,1,6,1,7
31402,VILLA RIVERO,estado nutricional en menores de 5 anos,clasificacion f,2002-09-01,1,0,1,0,1
10801,VILLA SERRANO,estado nutricional en menores de 5 anos,clasificacion f,2002-09-01,16,10,16,10,26
31003,VILLA TUNARI,estado nutricional en menores de 5 anos,clasificacion f,2002-09-01,9,11,9,11,20
11001,VILLA VACA GUZMAN (MUYUPAMPA),estado nutricional en menores de 5 anos,clasificacion f,2002-09-01,3,1,3,1,4
51501,VILLAZON,estado nutricional en menores de 5 anos,clasificacion f,2002-09-01,6,1,6,1,7
30904,VINTO,estado nutricional en menores de 5 anos,clasificacion f,2002-09-01,1,1,1,1,2
50602,VITICHI,estado nutricional en menores de 5 anos,clasificacion f,2002-09-01,0,1,0,1,1
70201,WARNES,estado nutricional en menores de 5 anos,clasificacion f,2002-09-01,2,3,2,3,5
20903,YACO,estado nutricional en menores de 5 anos,clasificacion f,2002-09-01,1,0,1,0,1
60301,YACUIBA,estado nutricional en menores de 5 anos,clasificacion f,2002-09-01,2,2,2,2,4
10602,YAMPARAEZ,estado nutricional en menores de 5 anos,clasificacion f,2002-09-01,16,1,16,1,17
70403,YAPACANI,estado nutricional en menores de 5 anos,clasificacion f,2002-09-01,2,5,2,5,7
50103,YOCALLA,estado nutricional en menores de 5 anos,clasificacion f,2002-09-01,4,1,4,1,5
10102,YOTALA,estado nutricional en menores de 5 anos,clasificacion f,2002-09-01,6,4,6,4,10
10301,ZUDAÃ‘EZ,estado nutricional en menores de 5 anos,clasificacion f,2002-09-01,4,4,4,4,8
51302,ACACIO,estado nutricional en menores de 5 anos,clasificacion f,2002-10-01,9,7,9,7,16
20201,ACHACACHI,estado nutricional en menores de 5 anos,clasificacion f,2002-10-01,9,4,9,4,13
20104,ACHOCALLA,estado nutricional en menores de 5 anos,clasificacion f,2002-10-01,1,1,1,1,2
30201,AIQUILE,estado nutricional en menores de 5 anos,clasificacion f,2002-10-01,2,4,2,4,6
31303,ALALAY,estado nutricional en menores de 5 anos,clasificacion f,2002-10-01,0,6,0,6,6
10404,ALCALA,estado nutricional en menores de 5 anos,clasificacion f,2002-10-01,3,2,3,2,5
20202,ANCORAIMES,estado nutricional en menores de 5 anos,clasificacion f,2002-10-01,2,1,2,1,3
30402,ANZALDO,estado nutricional en menores de 5 anos,clasificacion f,2002-10-01,2,3,2,3,5
20701,APOLO,estado nutricional en menores de 5 anos,clasificacion f,2002-10-01,8,2,8,2,10
51301,ARAMPAMPA,estado nutricional en menores de 5 anos,clasificacion f,2002-10-01,3,4,3,4,7
30501,ARANI,estado nutricional en menores de 5 anos,clasificacion f,2002-10-01,0,1,0,1,1
30601,ARQUE,estado nutricional en menores de 5 anos,clasificacion f,2002-10-01,7,0,7,0,7
71501,ASCENCION DE GUARAYOS,estado nutricional en menores de 5 anos,clasificacion f,2002-10-01,23,16,23,16,39
50802,ATOCHA,estado nutricional en menores de 5 anos,clasificacion f,2002-10-01,1,6,1,6,7
20503,AUCAPATA,estado nutricional en menores de 5 anos,clasificacion f,2002-10-01,2,2,2,2,4
20502,AYATA,estado nutricional en menores de 5 anos,clasificacion f,2002-10-01,7,2,7,2,9
30301,AYOPAYA (V. DE INDEPENDENCIA),estado nutricional en menores de 5 anos,clasificacion f,2002-10-01,9,2,9,2,11
10201,AZURDUY,estado nutricional en menores de 5 anos,clasificacion f,2002-10-01,15,9,15,9,24
80802,BAURES,estado nutricional en menores de 5 anos,clasificacion f,2002-10-01,0,1,0,1,1
50104,BELEN DE URMIRI,estado nutricional en menores de 5 anos,clasificacion f,2002-10-01,0,1,0,1,1
50301,BETANZOS,estado nutricional en menores de 5 anos,clasificacion f,2002-10-01,25,7,25,7,32
31501,BOLIVAR,estado nutricional en menores de 5 anos,clasificacion f,2002-10-01,2,2,2,2,4
70703,CABEZAS,estado nutricional en menores de 5 anos,clasificacion f,2002-10-01,2,3,2,3,5
20905,CAIROMA,estado nutricional en menores de 5 anos,clasificacion f,2002-10-01,5,2,5,2,7
51102,"CAIZA ""D""",estado nutricional en menores de 5 anos,clasificacion f,2002-10-01,6,0,6,0,6
21003,CAJUATA,estado nutricional en menores de 5 anos,clasificacion f,2002-10-01,8,7,8,7,15
20303,CALACOTO,estado nutricional en menores de 5 anos,clasificacion f,2002-10-01,0,1,0,1,1
21304,CALAMARCA,estado nutricional en menores de 5 anos,clasificacion f,2002-10-01,3,1,3,1,4
10701,CAMARGO,estado nutricional en menores de 5 anos,clasificacion f,2002-10-01,1,5,1,5,6
10901,CAMATAQUI (C. VILLA ABECIA),estado nutricional en menores de 5 anos,clasificacion f,2002-10-01,1,0,1,0,1
70706,CAMIRI,estado nutricional en menores de 5 anos,clasificacion f,2002-10-01,4,1,4,1,5
30701,CAPINOTA,estado nutricional en menores de 5 anos,clasificacion f,2002-10-01,8,2,8,2,10
20302,CAQUIAVIRI,estado nutricional en menores de 5 anos,clasificacion f,2002-10-01,0,2,0,2,2
22001,CARANAVI,estado nutricional en menores de 5 anos,clasificacion f,2002-10-01,8,11,8,11,19
60302,CARAPARI,estado nutricional en menores de 5 anos,clasificacion f,2002-10-01,2,1,2,1,3
50702,CARIPUYO,estado nutricional en menores de 5 anos,clasificacion f,2002-10-01,3,9,3,9,12
40201,CHALLAPATA,estado nutricional en menores de 5 anos,clasificacion f,2002-10-01,0,1,0,1,1
50302,CHAQUI,estado nutricional en menores de 5 anos,clasificacion f,2002-10-01,0,1,0,1,1
70702,CHARAGUA,estado nutricional en menores de 5 anos,clasificacion f,2002-10-01,1,3,1,3,4
20305,CHARAÃ‘A,estado nutricional en menores de 5 anos,clasificacion f,2002-10-01,1,0,1,0,1
50202,CHAYANTA,estado nutricional en menores de 5 anos,clasificacion f,2002-10-01,1,0,1,0,1
31204,CHIMORE,estado nutricional en menores de 5 anos,clasificacion f,2002-10-01,1,0,1,0,1
40302,CHOQUE COTA,estado nutricional en menores de 5 anos,clasificacion f,2002-10-01,1,0,1,0,1
21101,CHULUMANI (V. DE LA LIBERTAD),estado nutricional en menores de 5 anos,clasificacion f,2002-10-01,0,1,0,1,1
20501,CHUMA,estado nutricional en menores de 5 anos,clasificacion f,2002-10-01,2,1,2,1,3
30801,CLIZA,estado nutricional en menores de 5 anos,clasificacion f,2002-10-01,0,1,0,1,1
90101,COBIJA,estado nutricional en menores de 5 anos,clasificacion f,2002-10-01,8,2,8,2,10
30101,COCHABAMBA,estado nutricional en menores de 5 anos,clasificacion f,2002-10-01,16,11,16,11,27
40902,COIPASA,estado nutricional en menores de 5 anos,clasificacion f,2002-10-01,1,0,1,0,1
30905,COLCAPIRHUA,estado nutricional en menores de 5 anos,clasificacion f,2002-10-01,1,0,1,0,1
50901,"COLCHA ""K""",estado nutricional en menores de 5 anos,clasificacion f,2002-10-01,1,0,1,0,1
31002,COLOMI,estado nutricional en menores de 5 anos,clasificacion f,2002-10-01,1,1,1,1,2
50401,COLQUECHACA,estado nutricional en menores de 5 anos,clasificacion f,2002-10-01,36,18,36,18,54
21306,COLQUENCHA,estado nutricional en menores de 5 anos,clasificacion f,2002-10-01,4,0,4,0,4
21004,COLQUIRI,estado nutricional en menores de 5 anos,clasificacion f,2002-10-01,4,2,4,2,6
71301,COMARAPA,estado nutricional en menores de 5 anos,clasificacion f,2002-10-01,8,5,8,5,13
20301,CORO CORO,estado nutricional en menores de 5 anos,clasificacion f,2002-10-01,1,0,1,0,1
40301,CORQUE,estado nutricional en menores de 5 anos,clasificacion f,2002-10-01,1,0,1,0,1
50601,COTAGAITA,estado nutricional en menores de 5 anos,clasificacion f,2002-10-01,14,11,14,11,25
70102,COTOCA,estado nutricional en menores de 5 anos,clasificacion f,2002-10-01,8,0,8,0,8
70704,CUEVO,estado nutricional en menores de 5 anos,clasificacion f,2002-10-01,1,2,1,2,3
10902,CULPINA,estado nutricional en menores de 5 anos,clasificacion f,2002-10-01,9,4,9,4,13
21602,CURVA,estado nutricional en menores de 5 anos,clasificacion f,2002-10-01,1,0,1,0,1
20804,DESAGUADERO,estado nutricional en menores de 5 anos,clasificacion f,2002-10-01,1,0,1,0,1
20105,EL ALTO,estado nutricional en menores de 5 anos,clasificacion f,2002-10-01,76,41,76,41,117
40103,EL CHORO,estado nutricional en menores de 5 anos,clasificacion f,2002-10-01,0,1,0,1,1
71503,EL PUENTE(STC),estado nutricional en menores de 5 anos,clasificacion f,2002-10-01,2,3,2,3,5
60502,EL PUENTE(TJA),estado nutricional en menores de 5 anos,clasificacion f,2002-10-01,1,2,1,2,3
70105,EL TORNO,estado nutricional en menores de 5 anos,clasificacion f,2002-10-01,9,2,9,2,11
10405,EL VILLAR,estado nutricional en menores de 5 anos,clasificacion f,2002-10-01,1,2,1,2,3
60601,ENTRE RIOS,estado nutricional en menores de 5 anos,clasificacion f,2002-10-01,1,0,1,0,1
90203,FILADELFIA,estado nutricional en menores de 5 anos,clasificacion f,2002-10-01,0,3,0,3,3
71002,GENERAL SAAVEDRA,estado nutricional en menores de 5 anos,clasificacion f,2002-10-01,6,6,6,6,12
21601,GRAL. J.J. PEREZ (CHARAZANI),estado nutricional en menores de 5 anos,clasificacion f,2002-10-01,6,2,6,2,8
20602,GUANAY,estado nutricional en menores de 5 anos,clasificacion f,2002-10-01,9,1,9,1,10
80202,GUAYARAMERIN,estado nutricional en menores de 5 anos,clasificacion f,2002-10-01,5,2,5,2,7
70705,GUTIERREZ,estado nutricional en menores de 5 anos,clasificacion f,2002-10-01,14,4,14,4,18
10502,HUACARETA,estado nutricional en menores de 5 anos,clasificacion f,2002-10-01,5,1,5,1,6
11002,HUACAYA (VILLA DE HUACAYA),estado nutricional en menores de 5 anos,clasificacion f,2002-10-01,1,0,1,0,1
40701,HUANUNI,estado nutricional en menores de 5 anos,clasificacion f,2002-10-01,1,1,1,1,2
21005,ICHOCA,estado nutricional en menores de 5 anos,clasificacion f,2002-10-01,3,3,3,3,6
10304,ICLA,estado nutricional en menores de 5 anos,clasificacion f,2002-10-01,9,5,9,5,14
10703,INCAHUASI,estado nutricional en menores de 5 anos,clasificacion f,2002-10-01,7,6,7,6,13
21001,INQUISIVI,estado nutricional en menores de 5 anos,clasificacion f,2002-10-01,4,2,4,2,6
21501,IXIAMAS,estado nutricional en menores de 5 anos,clasificacion f,2002-10-01,3,0,3,0,3
21105,LA ASUNTA,estado nutricional en menores de 5 anos,clasificacion f,2002-10-01,6,4,6,4,10
70104,LA GUARDIA,estado nutricional en menores de 5 anos,clasificacion f,2002-10-01,1,0,1,0,1
20101,LA PAZ,estado nutricional en menores de 5 anos,clasificacion f,2002-10-01,31,17,31,17,48
70701,LAGUNILLAS,estado nutricional en menores de 5 anos,clasificacion f,2002-10-01,2,1,2,1,3
10903,LAS CARRERAS,estado nutricional en menores de 5 anos,clasificacion f,2002-10-01,0,2,0,2,2
50203,LLALLAGUA,estado nutricional en menores de 5 anos,clasificacion f,2002-10-01,2,35,2,35,37
11003,MACHARETI,estado nutricional en menores de 5 anos,clasificacion f,2002-10-01,2,4,2,4,6
80801,MAGDALENA,estado nutricional en menores de 5 anos,clasificacion f,2002-10-01,0,2,0,2,2
20103,MECAPACA,estado nutricional en menores de 5 anos,clasificacion f,2002-10-01,1,1,1,1,2
71003,MINEROS,estado nutricional en menores de 5 anos,clasificacion f,2002-10-01,19,4,19,4,23
31301,MIZQUE,estado nutricional en menores de 5 anos,clasificacion f,2002-10-01,4,5,4,5,9
20402,MOCOMOCO,estado nutricional en menores de 5 anos,clasificacion f,2002-10-01,3,0,3,0,3
10303,MOJOCOYA,estado nutricional en menores de 5 anos,clasificacion f,2002-10-01,4,4,4,4,8
10501,MONTEAGUDO,estado nutricional en menores de 5 anos,clasificacion f,2002-10-01,7,6,7,6,13
71001,MONTERO,estado nutricional en menores de 5 anos,clasificacion f,2002-10-01,19,2,19,2,21
70803,MORO MORO,estado nutricional en menores de 5 anos,clasificacion f,2002-10-01,2,1,2,1,3
30302,MOROCHATA,estado nutricional en menores de 5 anos,clasificacion f,2002-10-01,5,7,5,7,12
50404,OCURI,estado nutricional en menores de 5 anos,clasificacion f,2002-10-01,11,6,11,6,17
40101,ORURO,estado nutricional en menores de 5 anos,clasificacion f,2002-10-01,20,3,20,3,23
60201,PADCAYA,estado nutricional en menores de 5 anos,clasificacion f,2002-10-01,2,0,2,0,2
10401,PADILLA,estado nutricional en menores de 5 anos,clasificacion f,2002-10-01,4,2,4,2,6
70502,PAILON,estado nutricional en menores de 5 anos,clasificacion f,2002-10-01,2,1,2,1,3
20102,PALCA,estado nutricional en menores de 5 anos,clasificacion f,2002-10-01,1,1,1,1,2
21104,PALOS BLANCOS,estado nutricional en menores de 5 anos,clasificacion f,2002-10-01,3,1,3,1,4
70902,PAMPA GRANDE,estado nutricional en menores de 5 anos,clasificacion f,2002-10-01,1,0,1,0,1
21802,PAPEL PAMPA,estado nutricional en menores de 5 anos,clasificacion f,2002-10-01,0,1,0,1,1
30202,PASORAPA,estado nutricional en menores de 5 anos,clasificacion f,2002-10-01,1,1,1,1,2
21305,PATACAMAYA,estado nutricional en menores de 5 anos,clasificacion f,2002-10-01,2,1,2,1,3
20702,PELECHUCO,estado nutricional en menores de 5 anos,clasificacion f,2002-10-01,1,0,1,0,1
50403,POCOATA,estado nutricional en menores de 5 anos,clasificacion f,2002-10-01,7,9,7,9,16
31203,POCONA,estado nutricional en menores de 5 anos,clasificacion f,2002-10-01,3,3,3,3,6
31202,POJO (CBBA),estado nutricional en menores de 5 anos,clasificacion f,2002-10-01,9,2,9,2,11
51203,PORCO,estado nutricional en menores de 5 anos,clasificacion f,2002-10-01,2,2,2,2,4
10103,POROMA,estado nutricional en menores de 5 anos,clasificacion f,2002-10-01,10,9,10,9,19
70601,PORTACHUELO,estado nutricional en menores de 5 anos,clasificacion f,2002-10-01,1,0,1,0,1
90102,PORVENIR,estado nutricional en menores de 5 anos,clasificacion f,2002-10-01,1,0,1,0,1
70804,POSTRER VALLE,estado nutricional en menores de 5 anos,clasificacion f,2002-10-01,0,1,0,1,1
50101,POTOSI,estado nutricional en menores de 5 anos,clasificacion f,2002-10-01,24,14,24,14,38
10302,PRESTO,estado nutricional en menores de 5 anos,clasificacion f,2002-10-01,4,6,4,6,10
21201,PUCARANI,estado nutricional en menores de 5 anos,clasificacion f,2002-10-01,3,1,3,1,4
20403,PUERTO CARABUCO,estado nutricional en menores de 5 anos,clasificacion f,2002-10-01,5,0,5,0,5
90301,PUERTO GONZALO MORENO,estado nutricional en menores de 5 anos,clasificacion f,2002-10-01,2,0,2,0,2
21204,PUERTO PEREZ,estado nutricional en menores de 5 anos,clasificacion f,2002-10-01,1,0,1,0,1
71402,PUERTO QUIJARRO,estado nutricional en menores de 5 anos,clasificacion f,2002-10-01,3,0,3,0,3
90201,PUERTO RICO,estado nutricional en menores de 5 anos,clasificacion f,2002-10-01,2,0,2,0,2
80703,PUERTO SILES,estado nutricional en menores de 5 anos,clasificacion f,2002-10-01,1,0,1,0,1
71401,PUERTO SUAREZ,estado nutricional en menores de 5 anos,clasificacion f,2002-10-01,2,1,2,1,3
31205,PUERTO VILLARROEL,estado nutricional en menores de 5 anos,clasificacion f,2002-10-01,15,8,15,8,23
51101,PUNA,estado nutricional en menores de 5 anos,clasificacion f,2002-10-01,1,5,1,5,6
31401,PUNATA,estado nutricional en menores de 5 anos,clasificacion f,2002-10-01,4,2,4,2,6
20604,QUIABAYA,estado nutricional en menores de 5 anos,clasificacion f,2002-10-01,3,1,3,1,4
30901,QUILLACOLLO,estado nutricional en menores de 5 anos,clasificacion f,2002-10-01,16,12,16,12,28
21002,QUIME,estado nutricional en menores de 5 anos,clasificacion f,2002-10-01,6,4,6,4,10
50402,RAVELO,estado nutricional en menores de 5 anos,clasificacion f,2002-10-01,27,4,27,4,31
80201,RIBERALTA,estado nutricional en menores de 5 anos,clasificacion f,2002-10-01,54,34,54,34,88
70503,ROBORE,estado nutricional en menores de 5 anos,clasificacion f,2002-10-01,0,2,0,2,2
80304,RURRENABAQUE,estado nutricional en menores de 5 anos,clasificacion f,2002-10-01,2,0,2,0,2
40901,SABAYA,estado nutricional en menores de 5 anos,clasificacion f,2002-10-01,0,1,0,1,1
31001,SACABA,estado nutricional en menores de 5 anos,clasificacion f,2002-10-01,9,1,9,1,10
30404,SACABAMBA,estado nutricional en menores de 5 anos,clasificacion f,2002-10-01,2,5,2,5,7
50701,SACACA,estado nutricional en menores de 5 anos,clasificacion f,2002-10-01,14,4,14,4,18
71302,SAIPINA,estado nutricional en menores de 5 anos,clasificacion f,2002-10-01,1,0,1,0,1
70901,SAMAIPATA,estado nutricional en menores de 5 anos,clasificacion f,2002-10-01,1,0,1,0,1
80602,SAN ANDRES,estado nutricional en menores de 5 anos,clasificacion f,2002-10-01,3,0,3,0,3
71105,SAN ANTONIO DE LOMERIO,estado nutricional en menores de 5 anos,clasificacion f,2002-10-01,4,3,4,3,7
31403,SAN BENITO,estado nutricional en menores de 5 anos,clasificacion f,2002-10-01,3,0,3,0,3
80302,SAN BORJA,estado nutricional en menores de 5 anos,clasificacion f,2002-10-01,13,8,13,8,21
21502,SAN BUENA VENTURA,estado nutricional en menores de 5 anos,clasificacion f,2002-10-01,3,2,3,2,5
80501,SAN IGNACIO,estado nutricional en menores de 5 anos,clasificacion f,2002-10-01,6,6,6,6,12
70301,SAN IGNACIO DE VELASCO,estado nutricional en menores de 5 anos,clasificacion f,2002-10-01,10,11,10,11,21
80102,SAN JAVIER(BNI),estado nutricional en menores de 5 anos,clasificacion f,2002-10-01,0,1,0,1,1
71102,SAN JAVIER(STC),estado nutricional en menores de 5 anos,clasificacion f,2002-10-01,4,0,4,0,4
70501,SAN JOSE DE CHIQUITOS,estado nutricional en menores de 5 anos,clasificacion f,2002-10-01,2,1,2,1,3
71104,SAN JULIAN,estado nutricional en menores de 5 anos,clasificacion f,2002-10-01,14,7,14,7,21
60501,SAN LORENZO(TJA),estado nutricional en menores de 5 anos,clasificacion f,2002-10-01,2,1,2,1,3
10702,SAN LUCAS,estado nutricional en menores de 5 anos,clasificacion f,2002-10-01,35,20,35,20,55
71201,SAN MATIAS,estado nutricional en menores de 5 anos,clasificacion f,2002-10-01,2,0,2,0,2
70302,SAN MIGUEL DE VELASCO,estado nutricional en menores de 5 anos,clasificacion f,2002-10-01,6,5,6,5,11
51001,SAN PABLO DE LIPEZ,estado nutricional en menores de 5 anos,clasificacion f,2002-10-01,0,1,0,1,1
50501,SAN PEDRO DE BUENA VISTA,estado nutricional en menores de 5 anos,clasificacion f,2002-10-01,10,29,10,29,39
70303,SAN RAFAEL,estado nutricional en menores de 5 anos,clasificacion f,2002-10-01,3,1,3,1,4
80702,SAN RAMON,estado nutricional en menores de 5 anos,clasificacion f,2002-10-01,0,4,0,4,4
70101,SANTA CRUZ DE LA SIERRA,estado nutricional en menores de 5 anos,clasificacion f,2002-10-01,37,17,37,17,54
20308,SANTIAGO DE CALLAPA,estado nutricional en menores de 5 anos,clasificacion f,2002-10-01,1,2,1,2,3
41401,SANTIAGO DE HUARI,estado nutricional en menores de 5 anos,clasificacion f,2002-10-01,1,0,1,0,1
21901,SANTIAGO DE MACHACA,estado nutricional en menores de 5 anos,clasificacion f,2002-10-01,1,0,1,0,1
30702,SANTIVAÃ‘ES,estado nutricional en menores de 5 anos,clasificacion f,2002-10-01,1,0,1,0,1
20902,SAPAHAQUI,estado nutricional en menores de 5 anos,clasificacion f,2002-10-01,1,1,1,1,2
90303,SENA,estado nutricional en menores de 5 anos,clasificacion f,2002-10-01,0,2,0,2,2
21301,SICA SICA (VILLA AROMA),estado nutricional en menores de 5 anos,clasificacion f,2002-10-01,5,1,5,1,6
30703,SICAYA,estado nutricional en menores de 5 anos,clasificacion f,2002-10-01,2,1,2,1,3
30902,SIPE SIPE,estado nutricional en menores de 5 anos,clasificacion f,2002-10-01,5,0,5,0,5
10403,SOPACHUY,estado nutricional en menores de 5 anos,clasificacion f,2002-10-01,10,5,10,5,15
20601,SORATA,estado nutricional en menores de 5 anos,clasificacion f,2002-10-01,1,0,1,0,1
10101,SUCRE,estado nutricional en menores de 5 anos,clasificacion f,2002-10-01,25,13,25,13,38
20603,TACACOMA,estado nutricional en menores de 5 anos,clasificacion f,2002-10-01,0,3,0,3,3
50303,TACOBAMBA,estado nutricional en menores de 5 anos,clasificacion f,2002-10-01,5,5,5,5,10
30602,TACOPAYA,estado nutricional en menores de 5 anos,clasificacion f,2002-10-01,3,3,3,3,6
31101,TAPACARI,estado nutricional en menores de 5 anos,clasificacion f,2002-10-01,14,7,14,7,21
10601,TARABUCO,estado nutricional en menores de 5 anos,clasificacion f,2002-10-01,31,5,31,5,36
30401,TARATA,estado nutricional en menores de 5 anos,clasificacion f,2002-10-01,4,2,4,2,6
60101,TARIJA,estado nutricional en menores de 5 anos,clasificacion f,2002-10-01,4,1,4,1,5
10202,TARVITA,estado nutricional en menores de 5 anos,clasificacion f,2002-10-01,8,3,8,3,11
50102,TINGUIPAYA,estado nutricional en menores de 5 anos,clasificacion f,2002-10-01,11,13,11,13,24
30903,TIQUIPAYA,estado nutricional en menores de 5 anos,clasificacion f,2002-10-01,7,0,7,0,7
31601,TIRAQUE (CBBA),estado nutricional en menores de 5 anos,clasificacion f,2002-10-01,9,4,9,4,13
30803,TOLATA,estado nutricional en menores de 5 anos,clasificacion f,2002-10-01,3,0,3,0,3
51202,TOMAVE,estado nutricional en menores de 5 anos,clasificacion f,2002-10-01,5,1,5,1,6
10402,TOMINA,estado nutricional en menores de 5 anos,clasificacion f,2002-10-01,7,4,7,4,11
50502,TORO TORO,estado nutricional en menores de 5 anos,clasificacion f,2002-10-01,6,5,6,5,11
31201,TOTORA(CBBA),estado nutricional en menores de 5 anos,clasificacion f,2002-10-01,1,2,1,2,3
80101,TRINIDAD,estado nutricional en menores de 5 anos,clasificacion f,2002-10-01,5,24,5,24,29
50801,TUPIZA,estado nutricional en menores de 5 anos,clasificacion f,2002-10-01,1,3,1,3,4
71502,URUBICHA,estado nutricional en menores de 5 anos,clasificacion f,2002-10-01,2,2,2,2,4
51201,UYUNI,estado nutricional en menores de 5 anos,clasificacion f,2002-10-01,4,1,4,1,5
30502,VACAS,estado nutricional en menores de 5 anos,clasificacion f,2002-10-01,1,2,1,2,3
70801,VALLEGRANDE,estado nutricional en menores de 5 anos,clasificacion f,2002-10-01,3,2,3,2,5
20801,VIACHA,estado nutricional en menores de 5 anos,clasificacion f,2002-10-01,1,0,1,0,1
31302,VILA VILA,estado nutricional en menores de 5 anos,clasificacion f,2002-10-01,3,3,3,3,6
60303,VILLA MONTES,estado nutricional en menores de 5 anos,clasificacion f,2002-10-01,6,3,6,3,9
31402,VILLA RIVERO,estado nutricional en menores de 5 anos,clasificacion f,2002-10-01,2,0,2,0,2
10801,VILLA SERRANO,estado nutricional en menores de 5 anos,clasificacion f,2002-10-01,8,3,8,3,11
31003,VILLA TUNARI,estado nutricional en menores de 5 anos,clasificacion f,2002-10-01,28,6,28,6,34
11001,VILLA VACA GUZMAN (MUYUPAMPA),estado nutricional en menores de 5 anos,clasificacion f,2002-10-01,0,1,0,1,1
51501,VILLAZON,estado nutricional en menores de 5 anos,clasificacion f,2002-10-01,4,5,4,5,9
30904,VINTO,estado nutricional en menores de 5 anos,clasificacion f,2002-10-01,2,1,2,1,3
50602,VITICHI,estado nutricional en menores de 5 anos,clasificacion f,2002-10-01,5,5,5,5,10
70201,WARNES,estado nutricional en menores de 5 anos,clasificacion f,2002-10-01,9,0,9,0,9
20903,YACO,estado nutricional en menores de 5 anos,clasificacion f,2002-10-01,1,8,1,8,9
60301,YACUIBA,estado nutricional en menores de 5 anos,clasificacion f,2002-10-01,1,0,1,0,1
10602,YAMPARAEZ,estado nutricional en menores de 5 anos,clasificacion f,2002-10-01,12,3,12,3,15
21103,YANACACHI,estado nutricional en menores de 5 anos,clasificacion f,2002-10-01,0,1,0,1,1
50103,YOCALLA,estado nutricional en menores de 5 anos,clasificacion f,2002-10-01,3,0,3,0,3
10102,YOTALA,estado nutricional en menores de 5 anos,clasificacion f,2002-10-01,7,1,7,1,8
60402,YUNCHARA,estado nutricional en menores de 5 anos,clasificacion f,2002-10-01,1,0,1,0,1
10301,ZUDAÃ‘EZ,estado nutricional en menores de 5 anos,clasificacion f,2002-10-01,7,3,7,3,10
51302,ACACIO,estado nutricional en menores de 5 anos,clasificacion f,2002-11-01,4,4,4,4,8
20201,ACHACACHI,estado nutricional en menores de 5 anos,clasificacion f,2002-11-01,14,4,14,4,18
20104,ACHOCALLA,estado nutricional en menores de 5 anos,clasificacion f,2002-11-01,3,0,3,0,3
30201,AIQUILE,estado nutricional en menores de 5 anos,clasificacion f,2002-11-01,3,2,3,2,5
31303,ALALAY,estado nutricional en menores de 5 anos,clasificacion f,2002-11-01,0,4,0,4,4
10404,ALCALA,estado nutricional en menores de 5 anos,clasificacion f,2002-11-01,4,5,4,5,9
20202,ANCORAIMES,estado nutricional en menores de 5 anos,clasificacion f,2002-11-01,3,0,3,0,3
30402,ANZALDO,estado nutricional en menores de 5 anos,clasificacion f,2002-11-01,0,2,0,2,2
20701,APOLO,estado nutricional en menores de 5 anos,clasificacion f,2002-11-01,1,3,1,3,4
51301,ARAMPAMPA,estado nutricional en menores de 5 anos,clasificacion f,2002-11-01,4,1,4,1,5
30501,ARANI,estado nutricional en menores de 5 anos,clasificacion f,2002-11-01,3,0,3,0,3
30601,ARQUE,estado nutricional en menores de 5 anos,clasificacion f,2002-11-01,7,3,7,3,10
50802,ATOCHA,estado nutricional en menores de 5 anos,clasificacion f,2002-11-01,0,5,0,5,5
20502,AYATA,estado nutricional en menores de 5 anos,clasificacion f,2002-11-01,8,7,8,7,15
30301,AYOPAYA (V. DE INDEPENDENCIA),estado nutricional en menores de 5 anos,clasificacion f,2002-11-01,7,2,7,2,9
10201,AZURDUY,estado nutricional en menores de 5 anos,clasificacion f,2002-11-01,17,7,17,7,24
21203,BATALLAS,estado nutricional en menores de 5 anos,clasificacion f,2002-11-01,1,1,1,1,2
50104,BELEN DE URMIRI,estado nutricional en menores de 5 anos,clasificacion f,2002-11-01,0,1,0,1,1
50301,BETANZOS,estado nutricional en menores de 5 anos,clasificacion f,2002-11-01,28,10,28,10,38
31501,BOLIVAR,estado nutricional en menores de 5 anos,clasificacion f,2002-11-01,5,13,5,13,18
70707,BOYUIBE,estado nutricional en menores de 5 anos,clasificacion f,2002-11-01,0,1,0,1,1
70401,BUENA VISTA,estado nutricional en menores de 5 anos,clasificacion f,2002-11-01,1,0,1,0,1
20905,CAIROMA,estado nutricional en menores de 5 anos,clasificacion f,2002-11-01,1,2,1,2,3
51102,"CAIZA ""D""",estado nutricional en menores de 5 anos,clasificacion f,2002-11-01,9,1,9,1,10
21003,CAJUATA,estado nutricional en menores de 5 anos,clasificacion f,2002-11-01,4,1,4,1,5
10701,CAMARGO,estado nutricional en menores de 5 anos,clasificacion f,2002-11-01,2,2,2,2,4
10901,CAMATAQUI (C. VILLA ABECIA),estado nutricional en menores de 5 anos,clasificacion f,2002-11-01,1,1,1,1,2
70706,CAMIRI,estado nutricional en menores de 5 anos,clasificacion f,2002-11-01,8,0,8,0,8
30701,CAPINOTA,estado nutricional en menores de 5 anos,clasificacion f,2002-11-01,9,4,9,4,13
20302,CAQUIAVIRI,estado nutricional en menores de 5 anos,clasificacion f,2002-11-01,1,1,1,1,2
22001,CARANAVI,estado nutricional en menores de 5 anos,clasificacion f,2002-11-01,6,6,6,6,12
60302,CARAPARI,estado nutricional en menores de 5 anos,clasificacion f,2002-11-01,4,2,4,2,6
50702,CARIPUYO,estado nutricional en menores de 5 anos,clasificacion f,2002-11-01,5,2,5,2,7
40201,CHALLAPATA,estado nutricional en menores de 5 anos,clasificacion f,2002-11-01,6,0,6,0,6
50302,CHAQUI,estado nutricional en menores de 5 anos,clasificacion f,2002-11-01,3,4,3,4,7
70702,CHARAGUA,estado nutricional en menores de 5 anos,clasificacion f,2002-11-01,1,4,1,4,5
20305,CHARAÃ‘A,estado nutricional en menores de 5 anos,clasificacion f,2002-11-01,0,1,0,1,1
50202,CHAYANTA,estado nutricional en menores de 5 anos,clasificacion f,2002-11-01,7,6,7,6,13
21101,CHULUMANI (V. DE LA LIBERTAD),estado nutricional en menores de 5 anos,clasificacion f,2002-11-01,0,1,0,1,1
20501,CHUMA,estado nutricional en menores de 5 anos,clasificacion f,2002-11-01,1,6,1,6,7
30801,CLIZA,estado nutricional en menores de 5 anos,clasificacion f,2002-11-01,1,0,1,0,1
90101,COBIJA,estado nutricional en menores de 5 anos,clasificacion f,2002-11-01,10,2,10,2,12
30101,COCHABAMBA,estado nutricional en menores de 5 anos,clasificacion f,2002-11-01,10,3,10,3,13
30905,COLCAPIRHUA,estado nutricional en menores de 5 anos,clasificacion f,2002-11-01,1,1,1,1,2
50901,"COLCHA ""K""",estado nutricional en menores de 5 anos,clasificacion f,2002-11-01,1,1,1,1,2
31002,COLOMI,estado nutricional en menores de 5 anos,clasificacion f,2002-11-01,1,0,1,0,1
50401,COLQUECHACA,estado nutricional en menores de 5 anos,clasificacion f,2002-11-01,34,10,34,10,44
21004,COLQUIRI,estado nutricional en menores de 5 anos,clasificacion f,2002-11-01,5,2,5,2,7
71301,COMARAPA,estado nutricional en menores de 5 anos,clasificacion f,2002-11-01,7,3,7,3,10
71101,CONCEPCION,estado nutricional en menores de 5 anos,clasificacion f,2002-11-01,4,9,4,9,13
21402,CORIPATA,estado nutricional en menores de 5 anos,clasificacion f,2002-11-01,1,1,1,1,2
21401,COROICO,estado nutricional en menores de 5 anos,clasificacion f,2002-11-01,1,2,1,2,3
40301,CORQUE,estado nutricional en menores de 5 anos,clasificacion f,2002-11-01,0,1,0,1,1
50601,COTAGAITA,estado nutricional en menores de 5 anos,clasificacion f,2002-11-01,5,13,5,13,18
70102,COTOCA,estado nutricional en menores de 5 anos,clasificacion f,2002-11-01,1,0,1,0,1
70704,CUEVO,estado nutricional en menores de 5 anos,clasificacion f,2002-11-01,2,1,2,1,3
10902,CULPINA,estado nutricional en menores de 5 anos,clasificacion f,2002-11-01,8,4,8,4,12
40401,CURAHUARA DE CARANGAS,estado nutricional en menores de 5 anos,clasificacion f,2002-11-01,1,0,1,0,1
20105,EL ALTO,estado nutricional en menores de 5 anos,clasificacion f,2002-11-01,70,29,70,29,99
71503,EL PUENTE(STC),estado nutricional en menores de 5 anos,clasificacion f,2002-11-01,4,1,4,1,5
60502,EL PUENTE(TJA),estado nutricional en menores de 5 anos,clasificacion f,2002-11-01,0,1,0,1,1
70105,EL TORNO,estado nutricional en menores de 5 anos,clasificacion f,2002-11-01,0,2,0,2,2
10405,EL VILLAR,estado nutricional en menores de 5 anos,clasificacion f,2002-11-01,3,5,3,5,8
60601,ENTRE RIOS,estado nutricional en menores de 5 anos,clasificacion f,2002-11-01,2,6,2,6,8
41101,EUCALIPTUS,estado nutricional en menores de 5 anos,clasificacion f,2002-11-01,1,1,1,1,2
80402,EXALTACION,estado nutricional en menores de 5 anos,clasificacion f,2002-11-01,1,0,1,0,1
71002,GENERAL SAAVEDRA,estado nutricional en menores de 5 anos,clasificacion f,2002-11-01,6,2,6,2,8
21601,GRAL. J.J. PEREZ (CHARAZANI),estado nutricional en menores de 5 anos,clasificacion f,2002-11-01,1,1,1,1,2
20602,GUANAY,estado nutricional en menores de 5 anos,clasificacion f,2002-11-01,7,5,7,5,12
20802,GUAQUI,estado nutricional en menores de 5 anos,clasificacion f,2002-11-01,1,0,1,0,1
80202,GUAYARAMERIN,estado nutricional en menores de 5 anos,clasificacion f,2002-11-01,4,5,4,5,9
70705,GUTIERREZ,estado nutricional en menores de 5 anos,clasificacion f,2002-11-01,10,4,10,4,14
10502,HUACARETA,estado nutricional en menores de 5 anos,clasificacion f,2002-11-01,2,0,2,0,2
40701,HUANUNI,estado nutricional en menores de 5 anos,clasificacion f,2002-11-01,2,0,2,0,2
21005,ICHOCA,estado nutricional en menores de 5 anos,clasificacion f,2002-11-01,4,0,4,0,4
10304,ICLA,estado nutricional en menores de 5 anos,clasificacion f,2002-11-01,10,8,10,8,18
10703,INCAHUASI,estado nutricional en menores de 5 anos,clasificacion f,2002-11-01,38,35,38,35,73
21001,INQUISIVI,estado nutricional en menores de 5 anos,clasificacion f,2002-11-01,8,9,8,9,17
21501,IXIAMAS,estado nutricional en menores de 5 anos,clasificacion f,2002-11-01,5,1,5,1,6
70104,LA GUARDIA,estado nutricional en menores de 5 anos,clasificacion f,2002-11-01,1,2,1,2,3
20101,LA PAZ,estado nutricional en menores de 5 anos,clasificacion f,2002-11-01,26,16,26,16,42
70701,LAGUNILLAS,estado nutricional en menores de 5 anos,clasificacion f,2002-11-01,1,3,1,3,4
10903,LAS CARRERAS,estado nutricional en menores de 5 anos,clasificacion f,2002-11-01,2,0,2,0,2
50203,LLALLAGUA,estado nutricional en menores de 5 anos,clasificacion f,2002-11-01,2,23,2,23,25
20901,LURIBAY,estado nutricional en menores de 5 anos,clasificacion f,2002-11-01,2,0,2,0,2
11003,MACHARETI,estado nutricional en menores de 5 anos,clasificacion f,2002-11-01,4,3,4,3,7
80801,MAGDALENA,estado nutricional en menores de 5 anos,clasificacion f,2002-11-01,3,0,3,0,3
20103,MECAPACA,estado nutricional en menores de 5 anos,clasificacion f,2002-11-01,1,0,1,0,1
71003,MINEROS,estado nutricional en menores de 5 anos,clasificacion f,2002-11-01,8,0,8,0,8
31301,MIZQUE,estado nutricional en menores de 5 anos,clasificacion f,2002-11-01,1,1,1,1,2
20402,MOCOMOCO,estado nutricional en menores de 5 anos,clasificacion f,2002-11-01,2,0,2,0,2
10303,MOJOCOYA,estado nutricional en menores de 5 anos,clasificacion f,2002-11-01,2,2,2,2,4
10501,MONTEAGUDO,estado nutricional en menores de 5 anos,clasificacion f,2002-11-01,11,5,11,5,16
71001,MONTERO,estado nutricional en menores de 5 anos,clasificacion f,2002-11-01,13,8,13,8,21
70803,MORO MORO,estado nutricional en menores de 5 anos,clasificacion f,2002-11-01,0,1,0,1,1
30302,MOROCHATA,estado nutricional en menores de 5 anos,clasificacion f,2002-11-01,10,9,10,9,19
50404,OCURI,estado nutricional en menores de 5 anos,clasificacion f,2002-11-01,7,9,7,9,16
70202,OKINAWA,estado nutricional en menores de 5 anos,clasificacion f,2002-11-01,0,1,0,1,1
30203,OMEREQUE,estado nutricional en menores de 5 anos,clasificacion f,2002-11-01,0,1,0,1,1
40101,ORURO,estado nutricional en menores de 5 anos,clasificacion f,2002-11-01,74,3,74,3,77
10401,PADILLA,estado nutricional en menores de 5 anos,clasificacion f,2002-11-01,4,2,4,2,6
70502,PAILON,estado nutricional en menores de 5 anos,clasificacion f,2002-11-01,2,3,2,3,5
20102,PALCA,estado nutricional en menores de 5 anos,clasificacion f,2002-11-01,1,4,1,4,5
21104,PALOS BLANCOS,estado nutricional en menores de 5 anos,clasificacion f,2002-11-01,1,1,1,1,2
70902,PAMPA GRANDE,estado nutricional en menores de 5 anos,clasificacion f,2002-11-01,1,0,1,0,1
21802,PAPEL PAMPA,estado nutricional en menores de 5 anos,clasificacion f,2002-11-01,1,0,1,0,1
30202,PASORAPA,estado nutricional en menores de 5 anos,clasificacion f,2002-11-01,1,2,1,2,3
21305,PATACAMAYA,estado nutricional en menores de 5 anos,clasificacion f,2002-11-01,2,0,2,0,2
40602,PAZÃ‘A,estado nutricional en menores de 5 anos,clasificacion f,2002-11-01,2,0,2,0,2
20702,PELECHUCO,estado nutricional en menores de 5 anos,clasificacion f,2002-11-01,0,2,0,2,2
50403,POCOATA,estado nutricional en menores de 5 anos,clasificacion f,2002-11-01,8,9,8,9,17
31203,POCONA,estado nutricional en menores de 5 anos,clasificacion f,2002-11-01,8,2,8,2,10
31202,POJO (CBBA),estado nutricional en menores de 5 anos,clasificacion f,2002-11-01,0,6,0,6,6
10103,POROMA,estado nutricional en menores de 5 anos,clasificacion f,2002-11-01,9,7,9,7,16
70601,PORTACHUELO,estado nutricional en menores de 5 anos,clasificacion f,2002-11-01,3,2,3,2,5
90102,PORVENIR,estado nutricional en menores de 5 anos,clasificacion f,2002-11-01,2,0,2,0,2
70804,POSTRER VALLE,estado nutricional en menores de 5 anos,clasificacion f,2002-11-01,0,1,0,1,1
50101,POTOSI,estado nutricional en menores de 5 anos,clasificacion f,2002-11-01,18,14,18,14,32
10302,PRESTO,estado nutricional en menores de 5 anos,clasificacion f,2002-11-01,4,4,4,4,8
21201,PUCARANI,estado nutricional en menores de 5 anos,clasificacion f,2002-11-01,0,1,0,1,1
20401,PUERTO ACOSTA,estado nutricional en menores de 5 anos,clasificacion f,2002-11-01,1,1,1,1,2
20403,PUERTO CARABUCO,estado nutricional en menores de 5 anos,clasificacion f,2002-11-01,3,1,3,1,4
90301,PUERTO GONZALO MORENO,estado nutricional en menores de 5 anos,clasificacion f,2002-11-01,1,0,1,0,1
71402,PUERTO QUIJARRO,estado nutricional en menores de 5 anos,clasificacion f,2002-11-01,2,0,2,0,2
90201,PUERTO RICO,estado nutricional en menores de 5 anos,clasificacion f,2002-11-01,0,3,0,3,3
71401,PUERTO SUAREZ,estado nutricional en menores de 5 anos,clasificacion f,2002-11-01,2,6,2,6,8
31205,PUERTO VILLARROEL,estado nutricional en menores de 5 anos,clasificacion f,2002-11-01,20,13,20,13,33
51101,PUNA,estado nutricional en menores de 5 anos,clasificacion f,2002-11-01,24,19,24,19,43
31401,PUNATA,estado nutricional en menores de 5 anos,clasificacion f,2002-11-01,5,0,5,0,5
30901,QUILLACOLLO,estado nutricional en menores de 5 anos,clasificacion f,2002-11-01,13,15,13,15,28
21002,QUIME,estado nutricional en menores de 5 anos,clasificacion f,2002-11-01,7,1,7,1,8
50402,RAVELO,estado nutricional en menores de 5 anos,clasificacion f,2002-11-01,25,9,25,9,34
80301,REYES,estado nutricional en menores de 5 anos,clasificacion f,2002-11-01,3,0,3,0,3
80201,RIBERALTA,estado nutricional en menores de 5 anos,clasificacion f,2002-11-01,18,20,18,20,38
70503,ROBORE,estado nutricional en menores de 5 anos,clasificacion f,2002-11-01,1,0,1,0,1
31001,SACABA,estado nutricional en menores de 5 anos,clasificacion f,2002-11-01,10,3,10,3,13
30404,SACABAMBA,estado nutricional en menores de 5 anos,clasificacion f,2002-11-01,1,18,1,18,19
50701,SACACA,estado nutricional en menores de 5 anos,clasificacion f,2002-11-01,11,14,11,14,25
71302,SAIPINA,estado nutricional en menores de 5 anos,clasificacion f,2002-11-01,0,1,0,1,1
70901,SAMAIPATA,estado nutricional en menores de 5 anos,clasificacion f,2002-11-01,1,1,1,1,2
80602,SAN ANDRES,estado nutricional en menores de 5 anos,clasificacion f,2002-11-01,0,3,0,3,3
71105,SAN ANTONIO DE LOMERIO,estado nutricional en menores de 5 anos,clasificacion f,2002-11-01,5,0,5,0,5
31403,SAN BENITO,estado nutricional en menores de 5 anos,clasificacion f,2002-11-01,2,0,2,0,2
80302,SAN BORJA,estado nutricional en menores de 5 anos,clasificacion f,2002-11-01,8,2,8,2,10
21502,SAN BUENA VENTURA,estado nutricional en menores de 5 anos,clasificacion f,2002-11-01,2,2,2,2,4
70402,SAN CARLOS,estado nutricional en menores de 5 anos,clasificacion f,2002-11-01,4,0,4,0,4
80501,SAN IGNACIO,estado nutricional en menores de 5 anos,clasificacion f,2002-11-01,2,7,2,7,9
70301,SAN IGNACIO DE VELASCO,estado nutricional en menores de 5 anos,clasificacion f,2002-11-01,15,16,15,16,31
71102,SAN JAVIER(STC),estado nutricional en menores de 5 anos,clasificacion f,2002-11-01,3,0,3,0,3
70501,SAN JOSE DE CHIQUITOS,estado nutricional en menores de 5 anos,clasificacion f,2002-11-01,8,2,8,2,10
71104,SAN JULIAN,estado nutricional en menores de 5 anos,clasificacion f,2002-11-01,18,2,18,2,20
10702,SAN LUCAS,estado nutricional en menores de 5 anos,clasificacion f,2002-11-01,27,6,27,6,33
70302,SAN MIGUEL DE VELASCO,estado nutricional en menores de 5 anos,clasificacion f,2002-11-01,1,3,1,3,4
51001,SAN PABLO DE LIPEZ,estado nutricional en menores de 5 anos,clasificacion f,2002-11-01,1,0,1,0,1
50501,SAN PEDRO DE BUENA VISTA,estado nutricional en menores de 5 anos,clasificacion f,2002-11-01,11,16,11,16,27
21801,SAN PEDRO DE CURAHUARA,estado nutricional en menores de 5 anos,clasificacion f,2002-11-01,0,1,0,1,1
70303,SAN RAFAEL,estado nutricional en menores de 5 anos,clasificacion f,2002-11-01,2,0,2,0,2
80702,SAN RAMON,estado nutricional en menores de 5 anos,clasificacion f,2002-11-01,0,2,0,2,2
70101,SANTA CRUZ DE LA SIERRA,estado nutricional en menores de 5 anos,clasificacion f,2002-11-01,41,15,41,15,56
80303,SANTA ROSA,estado nutricional en menores de 5 anos,clasificacion f,2002-11-01,1,0,1,0,1
20308,SANTIAGO DE CALLAPA,estado nutricional en menores de 5 anos,clasificacion f,2002-11-01,3,1,3,1,4
20902,SAPAHAQUI,estado nutricional en menores de 5 anos,clasificacion f,2002-11-01,1,2,1,2,3
90303,SENA,estado nutricional en menores de 5 anos,clasificacion f,2002-11-01,1,0,1,0,1
21301,SICA SICA (VILLA AROMA),estado nutricional en menores de 5 anos,clasificacion f,2002-11-01,2,2,2,2,4
30902,SIPE SIPE,estado nutricional en menores de 5 anos,clasificacion f,2002-11-01,10,5,10,5,15
10403,SOPACHUY,estado nutricional en menores de 5 anos,clasificacion f,2002-11-01,4,5,4,5,9
10101,SUCRE,estado nutricional en menores de 5 anos,clasificacion f,2002-11-01,20,7,20,7,27
20603,TACACOMA,estado nutricional en menores de 5 anos,clasificacion f,2002-11-01,1,0,1,0,1
50303,TACOBAMBA,estado nutricional en menores de 5 anos,clasificacion f,2002-11-01,2,2,2,2,4
30602,TACOPAYA,estado nutricional en menores de 5 anos,clasificacion f,2002-11-01,5,3,5,3,8
31101,TAPACARI,estado nutricional en menores de 5 anos,clasificacion f,2002-11-01,6,0,6,0,6
10601,TARABUCO,estado nutricional en menores de 5 anos,clasificacion f,2002-11-01,38,21,38,21,59
30401,TARATA,estado nutricional en menores de 5 anos,clasificacion f,2002-11-01,1,0,1,0,1
60101,TARIJA,estado nutricional en menores de 5 anos,clasificacion f,2002-11-01,3,0,3,0,3
10202,TARVITA,estado nutricional en menores de 5 anos,clasificacion f,2002-11-01,3,5,3,5,8
50102,TINGUIPAYA,estado nutricional en menores de 5 anos,clasificacion f,2002-11-01,3,10,3,10,13
20606,TIPUANI,estado nutricional en menores de 5 anos,clasificacion f,2002-11-01,1,1,1,1,2
30903,TIQUIPAYA,estado nutricional en menores de 5 anos,clasificacion f,2002-11-01,8,0,8,0,8
31601,TIRAQUE (CBBA),estado nutricional en menores de 5 anos,clasificacion f,2002-11-01,2,4,2,4,6
41001,TOLEDO,estado nutricional en menores de 5 anos,clasificacion f,2002-11-01,1,0,1,0,1
51202,TOMAVE,estado nutricional en menores de 5 anos,clasificacion f,2002-11-01,7,1,7,1,8
10402,TOMINA,estado nutricional en menores de 5 anos,clasificacion f,2002-11-01,5,2,5,2,7
50502,TORO TORO,estado nutricional en menores de 5 anos,clasificacion f,2002-11-01,0,3,0,3,3
31201,TOTORA(CBBA),estado nutricional en menores de 5 anos,clasificacion f,2002-11-01,3,3,3,3,6
80101,TRINIDAD,estado nutricional en menores de 5 anos,clasificacion f,2002-11-01,3,9,3,9,12
50801,TUPIZA,estado nutricional en menores de 5 anos,clasificacion f,2002-11-01,1,5,1,5,6
21302,UMALA,estado nutricional en menores de 5 anos,clasificacion f,2002-11-01,0,1,0,1,1
50201,UNCIA,estado nutricional en menores de 5 anos,clasificacion f,2002-11-01,5,5,5,5,10
71502,URUBICHA,estado nutricional en menores de 5 anos,clasificacion f,2002-11-01,1,1,1,1,2
51201,UYUNI,estado nutricional en menores de 5 anos,clasificacion f,2002-11-01,5,1,5,1,6
30502,VACAS,estado nutricional en menores de 5 anos,clasificacion f,2002-11-01,5,11,5,11,16
70801,VALLEGRANDE,estado nutricional en menores de 5 anos,clasificacion f,2002-11-01,8,3,8,3,11
20801,VIACHA,estado nutricional en menores de 5 anos,clasificacion f,2002-11-01,6,0,6,0,6
31302,VILA VILA,estado nutricional en menores de 5 anos,clasificacion f,2002-11-01,1,3,1,3,4
60303,VILLA MONTES,estado nutricional en menores de 5 anos,clasificacion f,2002-11-01,6,1,6,1,7
31402,VILLA RIVERO,estado nutricional en menores de 5 anos,clasificacion f,2002-11-01,2,0,2,0,2
10801,VILLA SERRANO,estado nutricional en menores de 5 anos,clasificacion f,2002-11-01,8,27,8,27,35
31003,VILLA TUNARI,estado nutricional en menores de 5 anos,clasificacion f,2002-11-01,10,5,10,5,15
11001,VILLA VACA GUZMAN (MUYUPAMPA),estado nutricional en menores de 5 anos,clasificacion f,2002-11-01,0,2,0,2,2
51501,VILLAZON,estado nutricional en menores de 5 anos,clasificacion f,2002-11-01,4,1,4,1,5
30904,VINTO,estado nutricional en menores de 5 anos,clasificacion f,2002-11-01,3,1,3,1,4
50602,VITICHI,estado nutricional en menores de 5 anos,clasificacion f,2002-11-01,1,1,1,1,2
70201,WARNES,estado nutricional en menores de 5 anos,clasificacion f,2002-11-01,11,0,11,0,11
20903,YACO,estado nutricional en menores de 5 anos,clasificacion f,2002-11-01,4,2,4,2,6
60301,YACUIBA,estado nutricional en menores de 5 anos,clasificacion f,2002-11-01,3,3,3,3,6
10602,YAMPARAEZ,estado nutricional en menores de 5 anos,clasificacion f,2002-11-01,13,5,13,5,18
70403,YAPACANI,estado nutricional en menores de 5 anos,clasificacion f,2002-11-01,0,1,0,1,1
50103,YOCALLA,estado nutricional en menores de 5 anos,clasificacion f,2002-11-01,10,2,10,2,12
10102,YOTALA,estado nutricional en menores de 5 anos,clasificacion f,2002-11-01,9,2,9,2,11
10301,ZUDAÃ‘EZ,estado nutricional en menores de 5 anos,clasificacion f,2002-11-01,9,2,9,2,11
51302,ACACIO,estado nutricional en menores de 5 anos,clasificacion f,2002-12-01,6,11,6,11,17
20201,ACHACACHI,estado nutricional en menores de 5 anos,clasificacion f,2002-12-01,10,2,10,2,12
20104,ACHOCALLA,estado nutricional en menores de 5 anos,clasificacion f,2002-12-01,2,1,2,1,3
30201,AIQUILE,estado nutricional en menores de 5 anos,clasificacion f,2002-12-01,3,2,3,2,5
10404,ALCALA,estado nutricional en menores de 5 anos,clasificacion f,2002-12-01,4,3,4,3,7
20202,ANCORAIMES,estado nutricional en menores de 5 anos,clasificacion f,2002-12-01,3,0,3,0,3
41201,ANDAMARCA,estado nutricional en menores de 5 anos,clasificacion f,2002-12-01,1,0,1,0,1
30402,ANZALDO,estado nutricional en menores de 5 anos,clasificacion f,2002-12-01,2,1,2,1,3
20701,APOLO,estado nutricional en menores de 5 anos,clasificacion f,2002-12-01,1,2,1,2,3
51301,ARAMPAMPA,estado nutricional en menores de 5 anos,clasificacion f,2002-12-01,1,2,1,2,3
30501,ARANI,estado nutricional en menores de 5 anos,clasificacion f,2002-12-01,0,1,0,1,1
30403,ARBIETO,estado nutricional en menores de 5 anos,clasificacion f,2002-12-01,1,0,1,0,1
30601,ARQUE,estado nutricional en menores de 5 anos,clasificacion f,2002-12-01,2,1,2,1,3
50802,ATOCHA,estado nutricional en menores de 5 anos,clasificacion f,2002-12-01,0,4,0,4,4
20502,AYATA,estado nutricional en menores de 5 anos,clasificacion f,2002-12-01,4,8,4,8,12
21303,AYO AYO,estado nutricional en menores de 5 anos,clasificacion f,2002-12-01,4,0,4,0,4
30301,AYOPAYA (V. DE INDEPENDENCIA),estado nutricional en menores de 5 anos,clasificacion f,2002-12-01,2,2,2,2,4
10201,AZURDUY,estado nutricional en menores de 5 anos,clasificacion f,2002-12-01,10,0,10,0,10
21203,BATALLAS,estado nutricional en menores de 5 anos,clasificacion f,2002-12-01,1,0,1,0,1
80802,BAURES,estado nutricional en menores de 5 anos,clasificacion f,2002-12-01,1,0,1,0,1
50104,BELEN DE URMIRI,estado nutricional en menores de 5 anos,clasificacion f,2002-12-01,0,1,0,1,1
60202,BERMEJO,estado nutricional en menores de 5 anos,clasificacion f,2002-12-01,3,0,3,0,3
50301,BETANZOS,estado nutricional en menores de 5 anos,clasificacion f,2002-12-01,30,10,30,10,40
31501,BOLIVAR,estado nutricional en menores de 5 anos,clasificacion f,2002-12-01,2,1,2,1,3
70703,CABEZAS,estado nutricional en menores de 5 anos,clasificacion f,2002-12-01,0,1,0,1,1
20905,CAIROMA,estado nutricional en menores de 5 anos,clasificacion f,2002-12-01,4,2,4,2,6
51102,"CAIZA ""D""",estado nutricional en menores de 5 anos,clasificacion f,2002-12-01,6,2,6,2,8
21304,CALAMARCA,estado nutricional en menores de 5 anos,clasificacion f,2002-12-01,3,0,3,0,3
10701,CAMARGO,estado nutricional en menores de 5 anos,clasificacion f,2002-12-01,2,3,2,3,5
10901,CAMATAQUI (C. VILLA ABECIA),estado nutricional en menores de 5 anos,clasificacion f,2002-12-01,2,0,2,0,2
70706,CAMIRI,estado nutricional en menores de 5 anos,clasificacion f,2002-12-01,2,0,2,0,2
30701,CAPINOTA,estado nutricional en menores de 5 anos,clasificacion f,2002-12-01,11,5,11,5,16
22001,CARANAVI,estado nutricional en menores de 5 anos,clasificacion f,2002-12-01,12,7,12,7,19
60302,CARAPARI,estado nutricional en menores de 5 anos,clasificacion f,2002-12-01,2,4,2,4,6
50702,CARIPUYO,estado nutricional en menores de 5 anos,clasificacion f,2002-12-01,6,6,6,6,12
40201,CHALLAPATA,estado nutricional en menores de 5 anos,clasificacion f,2002-12-01,6,4,6,4,10
50302,CHAQUI,estado nutricional en menores de 5 anos,clasificacion f,2002-12-01,2,0,2,0,2
70702,CHARAGUA,estado nutricional en menores de 5 anos,clasificacion f,2002-12-01,7,8,7,8,15
20305,CHARAÃ‘A,estado nutricional en menores de 5 anos,clasificacion f,2002-12-01,1,1,1,1,2
50202,CHAYANTA,estado nutricional en menores de 5 anos,clasificacion f,2002-12-01,3,2,3,2,5
31204,CHIMORE,estado nutricional en menores de 5 anos,clasificacion f,2002-12-01,1,0,1,0,1
20501,CHUMA,estado nutricional en menores de 5 anos,clasificacion f,2002-12-01,2,2,2,2,4
90101,COBIJA,estado nutricional en menores de 5 anos,clasificacion f,2002-12-01,2,6,2,6,8
30101,COCHABAMBA,estado nutricional en menores de 5 anos,clasificacion f,2002-12-01,8,6,8,6,14
31002,COLOMI,estado nutricional en menores de 5 anos,clasificacion f,2002-12-01,1,0,1,0,1
50401,COLQUECHACA,estado nutricional en menores de 5 anos,clasificacion f,2002-12-01,12,4,12,4,16
21306,COLQUENCHA,estado nutricional en menores de 5 anos,clasificacion f,2002-12-01,1,1,1,1,2
21004,COLQUIRI,estado nutricional en menores de 5 anos,clasificacion f,2002-12-01,3,2,3,2,5
20304,COMANCHE,estado nutricional en menores de 5 anos,clasificacion f,2002-12-01,2,0,2,0,2
71301,COMARAPA,estado nutricional en menores de 5 anos,clasificacion f,2002-12-01,10,2,10,2,12
20301,CORO CORO,estado nutricional en menores de 5 anos,clasificacion f,2002-12-01,1,0,1,0,1
21401,COROICO,estado nutricional en menores de 5 anos,clasificacion f,2002-12-01,2,1,2,1,3
40301,CORQUE,estado nutricional en menores de 5 anos,clasificacion f,2002-12-01,2,2,2,2,4
50601,COTAGAITA,estado nutricional en menores de 5 anos,clasificacion f,2002-12-01,5,2,5,2,7
70704,CUEVO,estado nutricional en menores de 5 anos,clasificacion f,2002-12-01,0,2,0,2,2
10902,CULPINA,estado nutricional en menores de 5 anos,clasificacion f,2002-12-01,5,4,5,4,9
21602,CURVA,estado nutricional en menores de 5 anos,clasificacion f,2002-12-01,1,0,1,0,1
20105,EL ALTO,estado nutricional en menores de 5 anos,clasificacion f,2002-12-01,52,17,52,17,69
71503,EL PUENTE(STC),estado nutricional en menores de 5 anos,clasificacion f,2002-12-01,4,4,4,4,8
60502,EL PUENTE(TJA),estado nutricional en menores de 5 anos,clasificacion f,2002-12-01,0,1,0,1,1
70105,EL TORNO,estado nutricional en menores de 5 anos,clasificacion f,2002-12-01,0,1,0,1,1
10405,EL VILLAR,estado nutricional en menores de 5 anos,clasificacion f,2002-12-01,0,6,0,6,6
60601,ENTRE RIOS,estado nutricional en menores de 5 anos,clasificacion f,2002-12-01,1,1,1,1,2
41101,EUCALIPTUS,estado nutricional en menores de 5 anos,clasificacion f,2002-12-01,1,1,1,1,2
71002,GENERAL SAAVEDRA,estado nutricional en menores de 5 anos,clasificacion f,2002-12-01,5,4,5,4,9
21601,GRAL. J.J. PEREZ (CHARAZANI),estado nutricional en menores de 5 anos,clasificacion f,2002-12-01,2,0,2,0,2
20602,GUANAY,estado nutricional en menores de 5 anos,clasificacion f,2002-12-01,0,3,0,3,3
20802,GUAQUI,estado nutricional en menores de 5 anos,clasificacion f,2002-12-01,1,0,1,0,1
80202,GUAYARAMERIN,estado nutricional en menores de 5 anos,clasificacion f,2002-12-01,5,1,5,1,6
70705,GUTIERREZ,estado nutricional en menores de 5 anos,clasificacion f,2002-12-01,13,5,13,5,18
10502,HUACARETA,estado nutricional en menores de 5 anos,clasificacion f,2002-12-01,3,2,3,2,5
11002,HUACAYA (VILLA DE HUACAYA),estado nutricional en menores de 5 anos,clasificacion f,2002-12-01,0,1,0,1,1
40701,HUANUNI,estado nutricional en menores de 5 anos,clasificacion f,2002-12-01,2,2,2,2,4
10304,ICLA,estado nutricional en menores de 5 anos,clasificacion f,2002-12-01,5,8,5,8,13
10703,INCAHUASI,estado nutricional en menores de 5 anos,clasificacion f,2002-12-01,6,2,6,2,8
21001,INQUISIVI,estado nutricional en menores de 5 anos,clasificacion f,2002-12-01,2,4,2,4,6
21501,IXIAMAS,estado nutricional en menores de 5 anos,clasificacion f,2002-12-01,6,5,6,5,11
21105,LA ASUNTA,estado nutricional en menores de 5 anos,clasificacion f,2002-12-01,0,2,0,2,2
70104,LA GUARDIA,estado nutricional en menores de 5 anos,clasificacion f,2002-12-01,1,3,1,3,4
20101,LA PAZ,estado nutricional en menores de 5 anos,clasificacion f,2002-12-01,19,7,19,7,26
70701,LAGUNILLAS,estado nutricional en menores de 5 anos,clasificacion f,2002-12-01,2,4,2,4,6
50203,LLALLAGUA,estado nutricional en menores de 5 anos,clasificacion f,2002-12-01,0,9,0,9,9
11003,MACHARETI,estado nutricional en menores de 5 anos,clasificacion f,2002-12-01,3,1,3,1,4
80801,MAGDALENA,estado nutricional en menores de 5 anos,clasificacion f,2002-12-01,3,0,3,0,3
70903,MAIRANA,estado nutricional en menores de 5 anos,clasificacion f,2002-12-01,2,2,2,2,4
71003,MINEROS,estado nutricional en menores de 5 anos,clasificacion f,2002-12-01,12,3,12,3,15
31301,MIZQUE,estado nutricional en menores de 5 anos,clasificacion f,2002-12-01,7,4,7,4,11
10303,MOJOCOYA,estado nutricional en menores de 5 anos,clasificacion f,2002-12-01,2,1,2,1,3
10501,MONTEAGUDO,estado nutricional en menores de 5 anos,clasificacion f,2002-12-01,7,3,7,3,10
71001,MONTERO,estado nutricional en menores de 5 anos,clasificacion f,2002-12-01,9,6,9,6,15
30302,MOROCHATA,estado nutricional en menores de 5 anos,clasificacion f,2002-12-01,4,6,4,6,10
20307,NAZACARA DE PACAJES,estado nutricional en menores de 5 anos,clasificacion f,2002-12-01,1,0,1,0,1
50404,OCURI,estado nutricional en menores de 5 anos,clasificacion f,2002-12-01,7,9,7,9,16
30203,OMEREQUE,estado nutricional en menores de 5 anos,clasificacion f,2002-12-01,0,1,0,1,1
40101,ORURO,estado nutricional en menores de 5 anos,clasificacion f,2002-12-01,14,7,14,7,21
10401,PADILLA,estado nutricional en menores de 5 anos,clasificacion f,2002-12-01,4,3,4,3,7
70502,PAILON,estado nutricional en menores de 5 anos,clasificacion f,2002-12-01,1,0,1,0,1
20102,PALCA,estado nutricional en menores de 5 anos,clasificacion f,2002-12-01,1,2,1,2,3
21104,PALOS BLANCOS,estado nutricional en menores de 5 anos,clasificacion f,2002-12-01,1,0,1,0,1
21305,PATACAMAYA,estado nutricional en menores de 5 anos,clasificacion f,2002-12-01,1,1,1,1,2
40602,PAZÃ‘A,estado nutricional en menores de 5 anos,clasificacion f,2002-12-01,3,0,3,0,3
50403,POCOATA,estado nutricional en menores de 5 anos,clasificacion f,2002-12-01,4,6,4,6,10
31203,POCONA,estado nutricional en menores de 5 anos,clasificacion f,2002-12-01,3,3,3,3,6
31202,POJO (CBBA),estado nutricional en menores de 5 anos,clasificacion f,2002-12-01,3,2,3,2,5
51203,PORCO,estado nutricional en menores de 5 anos,clasificacion f,2002-12-01,1,1,1,1,2
10103,POROMA,estado nutricional en menores de 5 anos,clasificacion f,2002-12-01,2,1,2,1,3
70601,PORTACHUELO,estado nutricional en menores de 5 anos,clasificacion f,2002-12-01,1,0,1,0,1
50101,POTOSI,estado nutricional en menores de 5 anos,clasificacion f,2002-12-01,25,1,25,1,26
10302,PRESTO,estado nutricional en menores de 5 anos,clasificacion f,2002-12-01,2,4,2,4,6
21201,PUCARANI,estado nutricional en menores de 5 anos,clasificacion f,2002-12-01,0,1,0,1,1
20401,PUERTO ACOSTA,estado nutricional en menores de 5 anos,clasificacion f,2002-12-01,2,1,2,1,3
20403,PUERTO CARABUCO,estado nutricional en menores de 5 anos,clasificacion f,2002-12-01,1,0,1,0,1
71402,PUERTO QUIJARRO,estado nutricional en menores de 5 anos,clasificacion f,2002-12-01,2,1,2,1,3
71401,PUERTO SUAREZ,estado nutricional en menores de 5 anos,clasificacion f,2002-12-01,8,0,8,0,8
31205,PUERTO VILLARROEL,estado nutricional en menores de 5 anos,clasificacion f,2002-12-01,13,9,13,9,22
51101,PUNA,estado nutricional en menores de 5 anos,clasificacion f,2002-12-01,2,1,2,1,3
31401,PUNATA,estado nutricional en menores de 5 anos,clasificacion f,2002-12-01,19,1,19,1,20
30901,QUILLACOLLO,estado nutricional en menores de 5 anos,clasificacion f,2002-12-01,7,4,7,4,11
21002,QUIME,estado nutricional en menores de 5 anos,clasificacion f,2002-12-01,1,0,1,0,1
50402,RAVELO,estado nutricional en menores de 5 anos,clasificacion f,2002-12-01,38,18,38,18,56
80201,RIBERALTA,estado nutricional en menores de 5 anos,clasificacion f,2002-12-01,19,23,19,23,42
70503,ROBORE,estado nutricional en menores de 5 anos,clasificacion f,2002-12-01,8,1,8,1,9
80304,RURRENABAQUE,estado nutricional en menores de 5 anos,clasificacion f,2002-12-01,1,1,1,1,2
31001,SACABA,estado nutricional en menores de 5 anos,clasificacion f,2002-12-01,4,1,4,1,5
30404,SACABAMBA,estado nutricional en menores de 5 anos,clasificacion f,2002-12-01,0,1,0,1,1
50701,SACACA,estado nutricional en menores de 5 anos,clasificacion f,2002-12-01,10,13,10,13,23
71302,SAIPINA,estado nutricional en menores de 5 anos,clasificacion f,2002-12-01,1,0,1,0,1
70901,SAMAIPATA,estado nutricional en menores de 5 anos,clasificacion f,2002-12-01,1,0,1,0,1
80602,SAN ANDRES,estado nutricional en menores de 5 anos,clasificacion f,2002-12-01,2,1,2,1,3
71105,SAN ANTONIO DE LOMERIO,estado nutricional en menores de 5 anos,clasificacion f,2002-12-01,1,1,1,1,2
31403,SAN BENITO,estado nutricional en menores de 5 anos,clasificacion f,2002-12-01,3,0,3,0,3
80302,SAN BORJA,estado nutricional en menores de 5 anos,clasificacion f,2002-12-01,5,5,5,5,10
21502,SAN BUENA VENTURA,estado nutricional en menores de 5 anos,clasificacion f,2002-12-01,0,1,0,1,1
80501,SAN IGNACIO,estado nutricional en menores de 5 anos,clasificacion f,2002-12-01,5,2,5,2,7
70301,SAN IGNACIO DE VELASCO,estado nutricional en menores de 5 anos,clasificacion f,2002-12-01,11,7,11,7,18
71102,SAN JAVIER(STC),estado nutricional en menores de 5 anos,clasificacion f,2002-12-01,2,1,2,1,3
70501,SAN JOSE DE CHIQUITOS,estado nutricional en menores de 5 anos,clasificacion f,2002-12-01,4,1,4,1,5
71104,SAN JULIAN,estado nutricional en menores de 5 anos,clasificacion f,2002-12-01,10,2,10,2,12
60501,SAN LORENZO(TJA),estado nutricional en menores de 5 anos,clasificacion f,2002-12-01,3,2,3,2,5
10702,SAN LUCAS,estado nutricional en menores de 5 anos,clasificacion f,2002-12-01,16,17,16,17,33
70302,SAN MIGUEL DE VELASCO,estado nutricional en menores de 5 anos,clasificacion f,2002-12-01,1,2,1,2,3
50501,SAN PEDRO DE BUENA VISTA,estado nutricional en menores de 5 anos,clasificacion f,2002-12-01,7,6,7,6,13
70303,SAN RAFAEL,estado nutricional en menores de 5 anos,clasificacion f,2002-12-01,2,1,2,1,3
80702,SAN RAMON,estado nutricional en menores de 5 anos,clasificacion f,2002-12-01,2,0,2,0,2
80401,SANTA ANA,estado nutricional en menores de 5 anos,clasificacion f,2002-12-01,1,0,1,0,1
70101,SANTA CRUZ DE LA SIERRA,estado nutricional en menores de 5 anos,clasificacion f,2002-12-01,10,4,10,4,14
20308,SANTIAGO DE CALLAPA,estado nutricional en menores de 5 anos,clasificacion f,2002-12-01,1,1,1,1,2
30702,SANTIVAÃ‘ES,estado nutricional en menores de 5 anos,clasificacion f,2002-12-01,0,1,0,1,1
20902,SAPAHAQUI,estado nutricional en menores de 5 anos,clasificacion f,2002-12-01,4,2,4,2,6
90303,SENA,estado nutricional en menores de 5 anos,clasificacion f,2002-12-01,1,0,1,0,1
21301,SICA SICA (VILLA AROMA),estado nutricional en menores de 5 anos,clasificacion f,2002-12-01,8,2,8,2,10
30703,SICAYA,estado nutricional en menores de 5 anos,clasificacion f,2002-12-01,0,2,0,2,2
30902,SIPE SIPE,estado nutricional en menores de 5 anos,clasificacion f,2002-12-01,11,2,11,2,13
10403,SOPACHUY,estado nutricional en menores de 5 anos,clasificacion f,2002-12-01,7,4,7,4,11
20601,SORATA,estado nutricional en menores de 5 anos,clasificacion f,2002-12-01,0,2,0,2,2
10101,SUCRE,estado nutricional en menores de 5 anos,clasificacion f,2002-12-01,9,9,9,9,18
50303,TACOBAMBA,estado nutricional en menores de 5 anos,clasificacion f,2002-12-01,6,3,6,3,9
31101,TAPACARI,estado nutricional en menores de 5 anos,clasificacion f,2002-12-01,8,5,8,5,13
10601,TARABUCO,estado nutricional en menores de 5 anos,clasificacion f,2002-12-01,34,17,34,17,51
30401,TARATA,estado nutricional en menores de 5 anos,clasificacion f,2002-12-01,4,2,4,2,6
60101,TARIJA,estado nutricional en menores de 5 anos,clasificacion f,2002-12-01,5,1,5,1,6
10202,TARVITA,estado nutricional en menores de 5 anos,clasificacion f,2002-12-01,6,3,6,3,9
50102,TINGUIPAYA,estado nutricional en menores de 5 anos,clasificacion f,2002-12-01,1,3,1,3,4
30903,TIQUIPAYA,estado nutricional en menores de 5 anos,clasificacion f,2002-12-01,1,0,1,0,1
31601,TIRAQUE (CBBA),estado nutricional en menores de 5 anos,clasificacion f,2002-12-01,10,15,10,15,25
41001,TOLEDO,estado nutricional en menores de 5 anos,clasificacion f,2002-12-01,1,0,1,0,1
51202,TOMAVE,estado nutricional en menores de 5 anos,clasificacion f,2002-12-01,2,1,2,1,3
10402,TOMINA,estado nutricional en menores de 5 anos,clasificacion f,2002-12-01,4,3,4,3,7
50502,TORO TORO,estado nutricional en menores de 5 anos,clasificacion f,2002-12-01,5,2,5,2,7
31201,TOTORA(CBBA),estado nutricional en menores de 5 anos,clasificacion f,2002-12-01,4,0,4,0,4
80101,TRINIDAD,estado nutricional en menores de 5 anos,clasificacion f,2002-12-01,6,12,6,12,18
50801,TUPIZA,estado nutricional en menores de 5 anos,clasificacion f,2002-12-01,1,10,1,10,11
50201,UNCIA,estado nutricional en menores de 5 anos,clasificacion f,2002-12-01,2,2,2,2,4
60401,URIONDO (A. CONCEPCION),estado nutricional en menores de 5 anos,clasificacion f,2002-12-01,0,1,0,1,1
71502,URUBICHA,estado nutricional en menores de 5 anos,clasificacion f,2002-12-01,1,2,1,2,3
51201,UYUNI,estado nutricional en menores de 5 anos,clasificacion f,2002-12-01,1,4,1,4,5
30502,VACAS,estado nutricional en menores de 5 anos,clasificacion f,2002-12-01,0,9,0,9,9
20801,VIACHA,estado nutricional en menores de 5 anos,clasificacion f,2002-12-01,3,4,3,4,7
31302,VILA VILA,estado nutricional en menores de 5 anos,clasificacion f,2002-12-01,0,12,0,12,12
60303,VILLA MONTES,estado nutricional en menores de 5 anos,clasificacion f,2002-12-01,10,2,10,2,12
31402,VILLA RIVERO,estado nutricional en menores de 5 anos,clasificacion f,2002-12-01,1,0,1,0,1
10801,VILLA SERRANO,estado nutricional en menores de 5 anos,clasificacion f,2002-12-01,6,7,6,7,13
31003,VILLA TUNARI,estado nutricional en menores de 5 anos,clasificacion f,2002-12-01,6,10,6,10,16
11001,VILLA VACA GUZMAN (MUYUPAMPA),estado nutricional en menores de 5 anos,clasificacion f,2002-12-01,3,1,3,1,4
51501,VILLAZON,estado nutricional en menores de 5 anos,clasificacion f,2002-12-01,3,1,3,1,4
30904,VINTO,estado nutricional en menores de 5 anos,clasificacion f,2002-12-01,2,0,2,0,2
50602,VITICHI,estado nutricional en menores de 5 anos,clasificacion f,2002-12-01,2,1,2,1,3
70201,WARNES,estado nutricional en menores de 5 anos,clasificacion f,2002-12-01,5,1,5,1,6
20903,YACO,estado nutricional en menores de 5 anos,clasificacion f,2002-12-01,1,8,1,8,9
60301,YACUIBA,estado nutricional en menores de 5 anos,clasificacion f,2002-12-01,3,2,3,2,5
10602,YAMPARAEZ,estado nutricional en menores de 5 anos,clasificacion f,2002-12-01,16,5,16,5,21
50103,YOCALLA,estado nutricional en menores de 5 anos,clasificacion f,2002-12-01,1,1,1,1,2
10102,YOTALA,estado nutricional en menores de 5 anos,clasificacion f,2002-12-01,6,1,6,1,7
60402,YUNCHARA,estado nutricional en menores de 5 anos,clasificacion f,2002-12-01,0,1,0,1,1
10301,ZUDAÃ‘EZ,estado nutricional en menores de 5 anos,clasificacion f,2002-12-01,2,1,2,1,3
