codigo_municipio,municipio,grupo,variable,mes,total-H,total-M,TOTAL-H1,TOTAL-M1,TOTAL
51302,ACACIO,estado nutricional en menores de 5 anos,clasificacion e,2002-01-01,0,51,0,51,51
20201,ACHACACHI,estado nutricional en menores de 5 anos,clasificacion e,2002-01-01,3,22,3,22,25
20104,ACHOCALLA,estado nutricional en menores de 5 anos,clasificacion e,2002-01-01,3,1,3,1,4
30201,AIQUILE,estado nutricional en menores de 5 anos,clasificacion e,2002-01-01,1,4,1,4,5
31303,ALALAY,estado nutricional en menores de 5 anos,clasificacion e,2002-01-01,1,1,1,1,2
10404,ALCALA,estado nutricional en menores de 5 anos,clasificacion e,2002-01-01,0,22,0,22,22
20202,ANCORAIMES,estado nutricional en menores de 5 anos,clasificacion e,2002-01-01,0,36,0,36,36
41201,ANDAMARCA,estado nutricional en menores de 5 anos,clasificacion e,2002-01-01,1,0,1,0,1
40603,ANTEQUERA,estado nutricional en menores de 5 anos,clasificacion e,2002-01-01,1,0,1,0,1
30402,ANZALDO,estado nutricional en menores de 5 anos,clasificacion e,2002-01-01,0,5,0,5,5
20701,APOLO,estado nutricional en menores de 5 anos,clasificacion e,2002-01-01,3,2,3,2,5
51301,ARAMPAMPA,estado nutricional en menores de 5 anos,clasificacion e,2002-01-01,0,48,0,48,48
30501,ARANI,estado nutricional en menores de 5 anos,clasificacion e,2002-01-01,0,8,0,8,8
30403,ARBIETO,estado nutricional en menores de 5 anos,clasificacion e,2002-01-01,0,4,0,4,4
30601,ARQUE,estado nutricional en menores de 5 anos,clasificacion e,2002-01-01,4,2,4,2,6
50802,ATOCHA,estado nutricional en menores de 5 anos,clasificacion e,2002-01-01,1,7,1,7,8
20503,AUCAPATA,estado nutricional en menores de 5 anos,clasificacion e,2002-01-01,0,10,0,10,10
20502,AYATA,estado nutricional en menores de 5 anos,clasificacion e,2002-01-01,5,0,5,0,5
21303,AYO AYO,estado nutricional en menores de 5 anos,clasificacion e,2002-01-01,7,4,7,4,11
30301,AYOPAYA (V. DE INDEPENDENCIA),estado nutricional en menores de 5 anos,clasificacion e,2002-01-01,23,30,23,30,53
10201,AZURDUY,estado nutricional en menores de 5 anos,clasificacion e,2002-01-01,1,33,1,33,34
21203,BATALLAS,estado nutricional en menores de 5 anos,clasificacion e,2002-01-01,0,13,0,13,13
80802,BAURES,estado nutricional en menores de 5 anos,clasificacion e,2002-01-01,5,9,5,9,14
50104,BELEN DE URMIRI,estado nutricional en menores de 5 anos,clasificacion e,2002-01-01,0,2,0,2,2
60202,BERMEJO,estado nutricional en menores de 5 anos,clasificacion e,2002-01-01,0,5,0,5,5
50301,BETANZOS,estado nutricional en menores de 5 anos,clasificacion e,2002-01-01,9,160,9,160,169
31501,BOLIVAR,estado nutricional en menores de 5 anos,clasificacion e,2002-01-01,40,37,40,37,77
90103,BOLPEBRA,estado nutricional en menores de 5 anos,clasificacion e,2002-01-01,0,2,0,2,2
70707,BOYUIBE,estado nutricional en menores de 5 anos,clasificacion e,2002-01-01,0,16,0,16,16
70401,BUENA VISTA,estado nutricional en menores de 5 anos,clasificacion e,2002-01-01,10,13,10,13,23
70703,CABEZAS,estado nutricional en menores de 5 anos,clasificacion e,2002-01-01,0,11,0,11,11
20905,CAIROMA,estado nutricional en menores de 5 anos,clasificacion e,2002-01-01,0,14,0,14,14
51102,"CAIZA ""D""",estado nutricional en menores de 5 anos,clasificacion e,2002-01-01,2,29,2,29,31
21003,CAJUATA,estado nutricional en menores de 5 anos,clasificacion e,2002-01-01,3,3,3,3,6
21304,CALAMARCA,estado nutricional en menores de 5 anos,clasificacion e,2002-01-01,1,4,1,4,5
10701,CAMARGO,estado nutricional en menores de 5 anos,clasificacion e,2002-01-01,0,41,0,41,41
10901,CAMATAQUI (C. VILLA ABECIA),estado nutricional en menores de 5 anos,clasificacion e,2002-01-01,0,10,0,10,10
70706,CAMIRI,estado nutricional en menores de 5 anos,clasificacion e,2002-01-01,42,46,42,46,88
30701,CAPINOTA,estado nutricional en menores de 5 anos,clasificacion e,2002-01-01,20,10,20,10,30
20302,CAQUIAVIRI,estado nutricional en menores de 5 anos,clasificacion e,2002-01-01,2,15,2,15,17
40102,CARACOLLO,estado nutricional en menores de 5 anos,clasificacion e,2002-01-01,1,4,1,4,5
22001,CARANAVI,estado nutricional en menores de 5 anos,clasificacion e,2002-01-01,17,27,17,27,44
60302,CARAPARI,estado nutricional en menores de 5 anos,clasificacion e,2002-01-01,6,4,6,4,10
50702,CARIPUYO,estado nutricional en menores de 5 anos,clasificacion e,2002-01-01,0,44,0,44,44
21902,CATACORA,estado nutricional en menores de 5 anos,clasificacion e,2002-01-01,0,3,0,3,3
40201,CHALLAPATA,estado nutricional en menores de 5 anos,clasificacion e,2002-01-01,16,17,16,17,33
50302,CHAQUI,estado nutricional en menores de 5 anos,clasificacion e,2002-01-01,0,32,0,32,32
70702,CHARAGUA,estado nutricional en menores de 5 anos,clasificacion e,2002-01-01,0,81,0,81,81
31204,CHIMORE,estado nutricional en menores de 5 anos,clasificacion e,2002-01-01,7,9,7,9,16
21101,CHULUMANI (V. DE LA LIBERTAD),estado nutricional en menores de 5 anos,clasificacion e,2002-01-01,2,4,2,4,6
30801,CLIZA,estado nutricional en menores de 5 anos,clasificacion e,2002-01-01,1,8,1,8,9
90101,COBIJA,estado nutricional en menores de 5 anos,clasificacion e,2002-01-01,25,12,25,12,37
30101,COCHABAMBA,estado nutricional en menores de 5 anos,clasificacion e,2002-01-01,70,62,70,62,132
30905,COLCAPIRHUA,estado nutricional en menores de 5 anos,clasificacion e,2002-01-01,20,20,20,20,40
50901,"COLCHA ""K""",estado nutricional en menores de 5 anos,clasificacion e,2002-01-01,0,17,0,17,17
31002,COLOMI,estado nutricional en menores de 5 anos,clasificacion e,2002-01-01,5,6,5,6,11
50401,COLQUECHACA,estado nutricional en menores de 5 anos,clasificacion e,2002-01-01,10,22,10,22,32
21306,COLQUENCHA,estado nutricional en menores de 5 anos,clasificacion e,2002-01-01,3,1,3,1,4
21004,COLQUIRI,estado nutricional en menores de 5 anos,clasificacion e,2002-01-01,16,11,16,11,27
20304,COMANCHE,estado nutricional en menores de 5 anos,clasificacion e,2002-01-01,2,3,2,3,5
71301,COMARAPA,estado nutricional en menores de 5 anos,clasificacion e,2002-01-01,4,10,4,10,14
20605,COMBAYA,estado nutricional en menores de 5 anos,clasificacion e,2002-01-01,0,13,0,13,13
71101,CONCEPCION,estado nutricional en menores de 5 anos,clasificacion e,2002-01-01,0,12,0,12,12
21701,COPACABANA,estado nutricional en menores de 5 anos,clasificacion e,2002-01-01,0,1,0,1,1
21402,CORIPATA,estado nutricional en menores de 5 anos,clasificacion e,2002-01-01,0,2,0,2,2
20301,CORO CORO,estado nutricional en menores de 5 anos,clasificacion e,2002-01-01,6,10,6,10,16
21401,COROICO,estado nutricional en menores de 5 anos,clasificacion e,2002-01-01,6,2,6,2,8
40301,CORQUE,estado nutricional en menores de 5 anos,clasificacion e,2002-01-01,5,6,5,6,11
50601,COTAGAITA,estado nutricional en menores de 5 anos,clasificacion e,2002-01-01,3,43,3,43,46
70102,COTOCA,estado nutricional en menores de 5 anos,clasificacion e,2002-01-01,8,10,8,10,18
31405,CUCHUMUELA (V. G. VILLARROEL),estado nutricional en menores de 5 anos,clasificacion e,2002-01-01,0,3,0,3,3
70704,CUEVO,estado nutricional en menores de 5 anos,clasificacion e,2002-01-01,9,4,9,4,13
10902,CULPINA,estado nutricional en menores de 5 anos,clasificacion e,2002-01-01,2,61,2,61,63
40401,CURAHUARA DE CARANGAS,estado nutricional en menores de 5 anos,clasificacion e,2002-01-01,3,1,3,1,4
21602,CURVA,estado nutricional en menores de 5 anos,clasificacion e,2002-01-01,2,1,2,1,3
20804,DESAGUADERO,estado nutricional en menores de 5 anos,clasificacion e,2002-01-01,0,5,0,5,5
20105,EL ALTO,estado nutricional en menores de 5 anos,clasificacion e,2002-01-01,359,325,359,325,684
40103,EL CHORO,estado nutricional en menores de 5 anos,clasificacion e,2002-01-01,1,0,1,0,1
71503,EL PUENTE(STC),estado nutricional en menores de 5 anos,clasificacion e,2002-01-01,1,25,1,25,26
60502,EL PUENTE(TJA),estado nutricional en menores de 5 anos,clasificacion e,2002-01-01,0,2,0,2,2
70105,EL TORNO,estado nutricional en menores de 5 anos,clasificacion e,2002-01-01,14,21,14,21,35
10405,EL VILLAR,estado nutricional en menores de 5 anos,clasificacion e,2002-01-01,0,48,0,48,48
60601,ENTRE RIOS,estado nutricional en menores de 5 anos,clasificacion e,2002-01-01,9,10,9,10,19
41101,EUCALIPTUS,estado nutricional en menores de 5 anos,clasificacion e,2002-01-01,0,2,0,2,2
80402,EXALTACION,estado nutricional en menores de 5 anos,clasificacion e,2002-01-01,3,10,3,10,13
90203,FILADELFIA,estado nutricional en menores de 5 anos,clasificacion e,2002-01-01,0,2,0,2,2
71002,GENERAL SAAVEDRA,estado nutricional en menores de 5 anos,clasificacion e,2002-01-01,19,56,19,56,75
21601,GRAL. J.J. PEREZ (CHARAZANI),estado nutricional en menores de 5 anos,clasificacion e,2002-01-01,1,2,1,2,3
20602,GUANAY,estado nutricional en menores de 5 anos,clasificacion e,2002-01-01,0,35,0,35,35
20802,GUAQUI,estado nutricional en menores de 5 anos,clasificacion e,2002-01-01,0,2,0,2,2
80202,GUAYARAMERIN,estado nutricional en menores de 5 anos,clasificacion e,2002-01-01,18,10,18,10,28
70705,GUTIERREZ,estado nutricional en menores de 5 anos,clasificacion e,2002-01-01,9,90,9,90,99
10502,HUACARETA,estado nutricional en menores de 5 anos,clasificacion e,2002-01-01,2,56,2,56,58
11002,HUACAYA (VILLA DE HUACAYA),estado nutricional en menores de 5 anos,clasificacion e,2002-01-01,0,6,0,6,6
40501,HUACHACALLA,estado nutricional en menores de 5 anos,clasificacion e,2002-01-01,0,1,0,1,1
40701,HUANUNI,estado nutricional en menores de 5 anos,clasificacion e,2002-01-01,2,3,2,3,5
21005,ICHOCA,estado nutricional en menores de 5 anos,clasificacion e,2002-01-01,1,3,1,3,4
10304,ICLA,estado nutricional en menores de 5 anos,clasificacion e,2002-01-01,97,114,97,114,211
10703,INCAHUASI,estado nutricional en menores de 5 anos,clasificacion e,2002-01-01,1,32,1,32,33
21001,INQUISIVI,estado nutricional en menores de 5 anos,clasificacion e,2002-01-01,1,23,1,23,24
21102,IRUPANA (VILLA DE LANZA),estado nutricional en menores de 5 anos,clasificacion e,2002-01-01,0,8,0,8,8
21501,IXIAMAS,estado nutricional en menores de 5 anos,clasificacion e,2002-01-01,3,5,3,5,8
21105,LA ASUNTA,estado nutricional en menores de 5 anos,clasificacion e,2002-01-01,10,12,10,12,22
70104,LA GUARDIA,estado nutricional en menores de 5 anos,clasificacion e,2002-01-01,9,21,9,21,30
20101,LA PAZ,estado nutricional en menores de 5 anos,clasificacion e,2002-01-01,172,161,172,161,333
70701,LAGUNILLAS,estado nutricional en menores de 5 anos,clasificacion e,2002-01-01,17,17,17,17,34
21202,LAJA,estado nutricional en menores de 5 anos,clasificacion e,2002-01-01,0,5,0,5,5
10903,LAS CARRERAS,estado nutricional en menores de 5 anos,clasificacion e,2002-01-01,0,8,0,8,8
51401,LLICA,estado nutricional en menores de 5 anos,clasificacion e,2002-01-01,1,7,1,7,8
80601,LORETO,estado nutricional en menores de 5 anos,clasificacion e,2002-01-01,0,1,0,1,1
20901,LURIBAY,estado nutricional en menores de 5 anos,clasificacion e,2002-01-01,0,6,0,6,6
40702,MACHACAMARCA,estado nutricional en menores de 5 anos,clasificacion e,2002-01-01,10,1,10,1,11
11003,MACHARETI,estado nutricional en menores de 5 anos,clasificacion e,2002-01-01,3,40,3,40,43
80801,MAGDALENA,estado nutricional en menores de 5 anos,clasificacion e,2002-01-01,3,6,3,6,9
70903,MAIRANA,estado nutricional en menores de 5 anos,clasificacion e,2002-01-01,6,8,6,8,14
20103,MECAPACA,estado nutricional en menores de 5 anos,clasificacion e,2002-01-01,0,6,0,6,6
71003,MINEROS,estado nutricional en menores de 5 anos,clasificacion e,2002-01-01,7,72,7,72,79
31301,MIZQUE,estado nutricional en menores de 5 anos,clasificacion e,2002-01-01,2,11,2,11,13
20402,MOCOMOCO,estado nutricional en menores de 5 anos,clasificacion e,2002-01-01,0,3,0,3,3
51002,MOJINETE,estado nutricional en menores de 5 anos,clasificacion e,2002-01-01,0,1,0,1,1
10303,MOJOCOYA,estado nutricional en menores de 5 anos,clasificacion e,2002-01-01,25,14,25,14,39
10501,MONTEAGUDO,estado nutricional en menores de 5 anos,clasificacion e,2002-01-01,7,47,7,47,54
71001,MONTERO,estado nutricional en menores de 5 anos,clasificacion e,2002-01-01,3,142,3,142,145
70803,MORO MORO,estado nutricional en menores de 5 anos,clasificacion e,2002-01-01,6,1,6,1,7
30302,MOROCHATA,estado nutricional en menores de 5 anos,clasificacion e,2002-01-01,4,9,4,9,13
50404,OCURI,estado nutricional en menores de 5 anos,clasificacion e,2002-01-01,15,23,15,23,38
70202,OKINAWA,estado nutricional en menores de 5 anos,clasificacion e,2002-01-01,0,2,0,2,2
40101,ORURO,estado nutricional en menores de 5 anos,clasificacion e,2002-01-01,10,198,10,198,208
60201,PADCAYA,estado nutricional en menores de 5 anos,clasificacion e,2002-01-01,3,5,3,5,8
10401,PADILLA,estado nutricional en menores de 5 anos,clasificacion e,2002-01-01,1,104,1,104,105
70502,PAILON,estado nutricional en menores de 5 anos,clasificacion e,2002-01-01,2,19,2,19,21
20102,PALCA,estado nutricional en menores de 5 anos,clasificacion e,2002-01-01,10,8,10,8,18
21104,PALOS BLANCOS,estado nutricional en menores de 5 anos,clasificacion e,2002-01-01,15,22,15,22,37
40802,PAMPA AULLAGAS,estado nutricional en menores de 5 anos,clasificacion e,2002-01-01,4,5,4,5,9
70902,PAMPA GRANDE,estado nutricional en menores de 5 anos,clasificacion e,2002-01-01,2,5,2,5,7
21802,PAPEL PAMPA,estado nutricional en menores de 5 anos,clasificacion e,2002-01-01,3,1,3,1,4
30202,PASORAPA,estado nutricional en menores de 5 anos,clasificacion e,2002-01-01,1,0,1,0,1
21305,PATACAMAYA,estado nutricional en menores de 5 anos,clasificacion e,2002-01-01,10,3,10,3,13
40602,PAZÑA,estado nutricional en menores de 5 anos,clasificacion e,2002-01-01,0,11,0,11,11
20702,PELECHUCO,estado nutricional en menores de 5 anos,clasificacion e,2002-01-01,6,4,6,4,10
50403,POCOATA,estado nutricional en menores de 5 anos,clasificacion e,2002-01-01,19,47,19,47,66
31203,POCONA,estado nutricional en menores de 5 anos,clasificacion e,2002-01-01,1,16,1,16,17
31202,POJO (CBBA),estado nutricional en menores de 5 anos,clasificacion e,2002-01-01,7,28,7,28,35
40601,POOPO,estado nutricional en menores de 5 anos,clasificacion e,2002-01-01,0,12,0,12,12
51203,PORCO,estado nutricional en menores de 5 anos,clasificacion e,2002-01-01,5,1,5,1,6
10103,POROMA,estado nutricional en menores de 5 anos,clasificacion e,2002-01-01,11,52,11,52,63
70103,PORONGO,estado nutricional en menores de 5 anos,clasificacion e,2002-01-01,0,2,0,2,2
70601,PORTACHUELO,estado nutricional en menores de 5 anos,clasificacion e,2002-01-01,12,4,12,4,16
90102,PORVENIR,estado nutricional en menores de 5 anos,clasificacion e,2002-01-01,0,2,0,2,2
70804,POSTRER VALLE,estado nutricional en menores de 5 anos,clasificacion e,2002-01-01,0,1,0,1,1
50101,POTOSI,estado nutricional en menores de 5 anos,clasificacion e,2002-01-01,28,160,28,160,188
10302,PRESTO,estado nutricional en menores de 5 anos,clasificacion e,2002-01-01,26,17,26,17,43
21201,PUCARANI,estado nutricional en menores de 5 anos,clasificacion e,2002-01-01,1,0,1,0,1
20401,PUERTO ACOSTA,estado nutricional en menores de 5 anos,clasificacion e,2002-01-01,16,8,16,8,24
20403,PUERTO CARABUCO,estado nutricional en menores de 5 anos,clasificacion e,2002-01-01,8,10,8,10,18
90301,PUERTO GONZALO MORENO,estado nutricional en menores de 5 anos,clasificacion e,2002-01-01,0,3,0,3,3
21204,PUERTO PEREZ,estado nutricional en menores de 5 anos,clasificacion e,2002-01-01,0,3,0,3,3
71402,PUERTO QUIJARRO,estado nutricional en menores de 5 anos,clasificacion e,2002-01-01,18,3,18,3,21
90201,PUERTO RICO,estado nutricional en menores de 5 anos,clasificacion e,2002-01-01,0,3,0,3,3
71401,PUERTO SUAREZ,estado nutricional en menores de 5 anos,clasificacion e,2002-01-01,33,5,33,5,38
31205,PUERTO VILLARROEL,estado nutricional en menores de 5 anos,clasificacion e,2002-01-01,35,41,35,41,76
51101,PUNA,estado nutricional en menores de 5 anos,clasificacion e,2002-01-01,0,64,0,64,64
31401,PUNATA,estado nutricional en menores de 5 anos,clasificacion e,2002-01-01,0,4,0,4,4
20604,QUIABAYA,estado nutricional en menores de 5 anos,clasificacion e,2002-01-01,0,4,0,4,4
30901,QUILLACOLLO,estado nutricional en menores de 5 anos,clasificacion e,2002-01-01,8,5,8,5,13
21002,QUIME,estado nutricional en menores de 5 anos,clasificacion e,2002-01-01,7,8,7,8,15
50402,RAVELO,estado nutricional en menores de 5 anos,clasificacion e,2002-01-01,3,88,3,88,91
80301,REYES,estado nutricional en menores de 5 anos,clasificacion e,2002-01-01,5,9,5,9,14
80201,RIBERALTA,estado nutricional en menores de 5 anos,clasificacion e,2002-01-01,111,85,111,85,196
70503,ROBORE,estado nutricional en menores de 5 anos,clasificacion e,2002-01-01,0,15,0,15,15
80304,RURRENABAQUE,estado nutricional en menores de 5 anos,clasificacion e,2002-01-01,10,8,10,8,18
31001,SACABA,estado nutricional en menores de 5 anos,clasificacion e,2002-01-01,8,22,8,22,30
30404,SACABAMBA,estado nutricional en menores de 5 anos,clasificacion e,2002-01-01,0,8,0,8,8
50701,SACACA,estado nutricional en menores de 5 anos,clasificacion e,2002-01-01,27,73,27,73,100
71302,SAIPINA,estado nutricional en menores de 5 anos,clasificacion e,2002-01-01,5,1,5,1,6
40801,SALINAS DE GARCI MENDOZA,estado nutricional en menores de 5 anos,clasificacion e,2002-01-01,4,2,4,2,6
70901,SAMAIPATA,estado nutricional en menores de 5 anos,clasificacion e,2002-01-01,2,3,2,3,5
51601,SAN AGUSTIN,estado nutricional en menores de 5 anos,clasificacion e,2002-01-01,0,2,0,2,2
51003,SAN ANTONIO DE ESMORUCO,estado nutricional en menores de 5 anos,clasificacion e,2002-01-01,0,1,0,1,1
71105,SAN ANTONIO DE LOMERIO,estado nutricional en menores de 5 anos,clasificacion e,2002-01-01,57,70,57,70,127
31403,SAN BENITO,estado nutricional en menores de 5 anos,clasificacion e,2002-01-01,0,5,0,5,5
80302,SAN BORJA,estado nutricional en menores de 5 anos,clasificacion e,2002-01-01,19,13,19,13,32
21502,SAN BUENA VENTURA,estado nutricional en menores de 5 anos,clasificacion e,2002-01-01,11,6,11,6,17
70402,SAN CARLOS,estado nutricional en menores de 5 anos,clasificacion e,2002-01-01,1,1,1,1,2
80501,SAN IGNACIO,estado nutricional en menores de 5 anos,clasificacion e,2002-01-01,1,42,1,42,43
70301,SAN IGNACIO DE VELASCO,estado nutricional en menores de 5 anos,clasificacion e,2002-01-01,68,41,68,41,109
80102,SAN JAVIER(BNI),estado nutricional en menores de 5 anos,clasificacion e,2002-01-01,0,2,0,2,2
71102,SAN JAVIER(STC),estado nutricional en menores de 5 anos,clasificacion e,2002-01-01,5,3,5,3,8
80701,SAN JOAQUIN,estado nutricional en menores de 5 anos,clasificacion e,2002-01-01,0,2,0,2,2
70501,SAN JOSE DE CHIQUITOS,estado nutricional en menores de 5 anos,clasificacion e,2002-01-01,23,6,23,6,29
71104,SAN JULIAN,estado nutricional en menores de 5 anos,clasificacion e,2002-01-01,31,48,31,48,79
60501,SAN LORENZO(TJA),estado nutricional en menores de 5 anos,clasificacion e,2002-01-01,0,5,0,5,5
10702,SAN LUCAS,estado nutricional en menores de 5 anos,clasificacion e,2002-01-01,1,177,1,177,178
71201,SAN MATIAS,estado nutricional en menores de 5 anos,clasificacion e,2002-01-01,35,17,35,17,52
70302,SAN MIGUEL DE VELASCO,estado nutricional en menores de 5 anos,clasificacion e,2002-01-01,17,29,17,29,46
51001,SAN PABLO DE LIPEZ,estado nutricional en menores de 5 anos,clasificacion e,2002-01-01,0,5,0,5,5
50501,SAN PEDRO DE BUENA VISTA,estado nutricional en menores de 5 anos,clasificacion e,2002-01-01,1,20,1,20,21
21801,SAN PEDRO DE CURAHUARA,estado nutricional en menores de 5 anos,clasificacion e,2002-01-01,0,2,0,2,2
21702,SAN PEDRO DE TIQUINA,estado nutricional en menores de 5 anos,clasificacion e,2002-01-01,0,4,0,4,4
90202,SAN PEDRO(PND),estado nutricional en menores de 5 anos,clasificacion e,2002-01-01,1,0,1,0,1
70303,SAN RAFAEL,estado nutricional en menores de 5 anos,clasificacion e,2002-01-01,6,9,6,9,15
80702,SAN RAMON,estado nutricional en menores de 5 anos,clasificacion e,2002-01-01,3,1,3,1,4
80401,SANTA ANA,estado nutricional en menores de 5 anos,clasificacion e,2002-01-01,2,9,2,9,11
70101,SANTA CRUZ DE LA SIERRA,estado nutricional en menores de 5 anos,clasificacion e,2002-01-01,61,88,61,88,149
80303,SANTA ROSA,estado nutricional en menores de 5 anos,clasificacion e,2002-01-01,3,2,3,2,5
70602,SANTA ROSA DEL SARA,estado nutricional en menores de 5 anos,clasificacion e,2002-01-01,2,6,2,6,8
41401,SANTIAGO DE HUARI,estado nutricional en menores de 5 anos,clasificacion e,2002-01-01,9,3,9,3,12
30702,SANTIVAÑES,estado nutricional en menores de 5 anos,clasificacion e,2002-01-01,4,7,4,7,11
40202,SANTUARIO DE QUILLACAS,estado nutricional en menores de 5 anos,clasificacion e,2002-01-01,1,1,1,1,2
20902,SAPAHAQUI,estado nutricional en menores de 5 anos,clasificacion e,2002-01-01,1,6,1,6,7
90303,SENA,estado nutricional en menores de 5 anos,clasificacion e,2002-01-01,0,4,0,4,4
21301,SICA SICA (VILLA AROMA),estado nutricional en menores de 5 anos,clasificacion e,2002-01-01,7,3,7,3,10
30703,SICAYA,estado nutricional en menores de 5 anos,clasificacion e,2002-01-01,0,7,0,7,7
30902,SIPE SIPE,estado nutricional en menores de 5 anos,clasificacion e,2002-01-01,36,31,36,31,67
10403,SOPACHUY,estado nutricional en menores de 5 anos,clasificacion e,2002-01-01,1,42,1,42,43
20601,SORATA,estado nutricional en menores de 5 anos,clasificacion e,2002-01-01,0,2,0,2,2
10101,SUCRE,estado nutricional en menores de 5 anos,clasificacion e,2002-01-01,12,219,12,219,231
31404,TACACHI,estado nutricional en menores de 5 anos,clasificacion e,2002-01-01,0,3,0,3,3
50303,TACOBAMBA,estado nutricional en menores de 5 anos,clasificacion e,2002-01-01,4,25,4,25,29
30602,TACOPAYA,estado nutricional en menores de 5 anos,clasificacion e,2002-01-01,16,21,16,21,37
51402,TAHUA,estado nutricional en menores de 5 anos,clasificacion e,2002-01-01,0,2,0,2,2
31101,TAPACARI,estado nutricional en menores de 5 anos,clasificacion e,2002-01-01,0,20,0,20,20
10601,TARABUCO,estado nutricional en menores de 5 anos,clasificacion e,2002-01-01,3,285,3,285,288
30401,TARATA,estado nutricional en menores de 5 anos,clasificacion e,2002-01-01,0,15,0,15,15
60101,TARIJA,estado nutricional en menores de 5 anos,clasificacion e,2002-01-01,10,43,10,43,53
10202,TARVITA,estado nutricional en menores de 5 anos,clasificacion e,2002-01-01,15,28,15,28,43
20803,TIAWANACU,estado nutricional en menores de 5 anos,clasificacion e,2002-01-01,1,0,1,0,1
50102,TINGUIPAYA,estado nutricional en menores de 5 anos,clasificacion e,2002-01-01,4,22,4,22,26
20606,TIPUANI,estado nutricional en menores de 5 anos,clasificacion e,2002-01-01,1,2,1,2,3
30903,TIQUIPAYA,estado nutricional en menores de 5 anos,clasificacion e,2002-01-01,0,12,0,12,12
31601,TIRAQUE (CBBA),estado nutricional en menores de 5 anos,clasificacion e,2002-01-01,33,63,33,63,96
21703,TITO YUPANQUI (PARQUIPUJIO),estado nutricional en menores de 5 anos,clasificacion e,2002-01-01,0,13,0,13,13
30802,TOCO,estado nutricional en menores de 5 anos,clasificacion e,2002-01-01,0,2,0,2,2
41001,TOLEDO,estado nutricional en menores de 5 anos,clasificacion e,2002-01-01,4,0,4,0,4
51202,TOMAVE,estado nutricional en menores de 5 anos,clasificacion e,2002-01-01,0,36,0,36,36
10402,TOMINA,estado nutricional en menores de 5 anos,clasificacion e,2002-01-01,7,76,7,76,83
50502,TORO TORO,estado nutricional en menores de 5 anos,clasificacion e,2002-01-01,0,4,0,4,4
31201,TOTORA(CBBA),estado nutricional en menores de 5 anos,clasificacion e,2002-01-01,9,9,9,9,18
70802,TRIGAL,estado nutricional en menores de 5 anos,clasificacion e,2002-01-01,1,1,1,1,2
80101,TRINIDAD,estado nutricional en menores de 5 anos,clasificacion e,2002-01-01,10,64,10,64,74
50801,TUPIZA,estado nutricional en menores de 5 anos,clasificacion e,2002-01-01,2,104,2,104,106
40402,TURCO,estado nutricional en menores de 5 anos,clasificacion e,2002-01-01,1,3,1,3,4
21302,UMALA,estado nutricional en menores de 5 anos,clasificacion e,2002-01-01,0,1,0,1,1
50201,UNCIA,estado nutricional en menores de 5 anos,clasificacion e,2002-01-01,0,4,0,4,4
60401,URIONDO (A. CONCEPCION),estado nutricional en menores de 5 anos,clasificacion e,2002-01-01,3,3,3,3,6
71502,URUBICHA,estado nutricional en menores de 5 anos,clasificacion e,2002-01-01,0,5,0,5,5
51201,UYUNI,estado nutricional en menores de 5 anos,clasificacion e,2002-01-01,0,9,0,9,9
30502,VACAS,estado nutricional en menores de 5 anos,clasificacion e,2002-01-01,0,12,0,12,12
70801,VALLEGRANDE,estado nutricional en menores de 5 anos,clasificacion e,2002-01-01,2,22,2,22,24
20801,VIACHA,estado nutricional en menores de 5 anos,clasificacion e,2002-01-01,2,30,2,30,32
31302,VILA VILA,estado nutricional en menores de 5 anos,clasificacion e,2002-01-01,3,5,3,5,8
60303,VILLA MONTES,estado nutricional en menores de 5 anos,clasificacion e,2002-01-01,17,18,17,18,35
10801,VILLA SERRANO,estado nutricional en menores de 5 anos,clasificacion e,2002-01-01,0,72,0,72,72
31003,VILLA TUNARI,estado nutricional en menores de 5 anos,clasificacion e,2002-01-01,39,27,39,27,66
11001,VILLA VACA GUZMAN (MUYUPAMPA),estado nutricional en menores de 5 anos,clasificacion e,2002-01-01,0,38,0,38,38
51501,VILLAZON,estado nutricional en menores de 5 anos,clasificacion e,2002-01-01,1,43,1,43,44
30904,VINTO,estado nutricional en menores de 5 anos,clasificacion e,2002-01-01,10,17,10,17,27
50602,VITICHI,estado nutricional en menores de 5 anos,clasificacion e,2002-01-01,8,18,8,18,26
20306,WALDO BALLIVIAN,estado nutricional en menores de 5 anos,clasificacion e,2002-01-01,0,3,0,3,3
70201,WARNES,estado nutricional en menores de 5 anos,clasificacion e,2002-01-01,20,31,20,31,51
20903,YACO,estado nutricional en menores de 5 anos,clasificacion e,2002-01-01,0,9,0,9,9
60301,YACUIBA,estado nutricional en menores de 5 anos,clasificacion e,2002-01-01,14,8,14,8,22
10602,YAMPARAEZ,estado nutricional en menores de 5 anos,clasificacion e,2002-01-01,63,52,63,52,115
21103,YANACACHI,estado nutricional en menores de 5 anos,clasificacion e,2002-01-01,3,0,3,0,3
70403,YAPACANI,estado nutricional en menores de 5 anos,clasificacion e,2002-01-01,33,22,33,22,55
50103,YOCALLA,estado nutricional en menores de 5 anos,clasificacion e,2002-01-01,0,5,0,5,5
10102,YOTALA,estado nutricional en menores de 5 anos,clasificacion e,2002-01-01,15,34,15,34,49
60402,YUNCHARA,estado nutricional en menores de 5 anos,clasificacion e,2002-01-01,4,11,4,11,15
10301,ZUDAÑEZ,estado nutricional en menores de 5 anos,clasificacion e,2002-01-01,50,39,50,39,89
51302,ACACIO,estado nutricional en menores de 5 anos,clasificacion e,2002-02-01,3,36,3,36,39
20201,ACHACACHI,estado nutricional en menores de 5 anos,clasificacion e,2002-02-01,9,10,9,10,19
30201,AIQUILE,estado nutricional en menores de 5 anos,clasificacion e,2002-02-01,2,3,2,3,5
31303,ALALAY,estado nutricional en menores de 5 anos,clasificacion e,2002-02-01,0,2,0,2,2
10404,ALCALA,estado nutricional en menores de 5 anos,clasificacion e,2002-02-01,10,10,10,10,20
20202,ANCORAIMES,estado nutricional en menores de 5 anos,clasificacion e,2002-02-01,5,12,5,12,17
41201,ANDAMARCA,estado nutricional en menores de 5 anos,clasificacion e,2002-02-01,2,0,2,0,2
30402,ANZALDO,estado nutricional en menores de 5 anos,clasificacion e,2002-02-01,1,9,1,9,10
20701,APOLO,estado nutricional en menores de 5 anos,clasificacion e,2002-02-01,13,3,13,3,16
51301,ARAMPAMPA,estado nutricional en menores de 5 anos,clasificacion e,2002-02-01,6,38,6,38,44
30403,ARBIETO,estado nutricional en menores de 5 anos,clasificacion e,2002-02-01,0,1,0,1,1
30601,ARQUE,estado nutricional en menores de 5 anos,clasificacion e,2002-02-01,1,7,1,7,8
71501,ASCENCION DE GUARAYOS,estado nutricional en menores de 5 anos,clasificacion e,2002-02-01,38,38,38,38,76
50802,ATOCHA,estado nutricional en menores de 5 anos,clasificacion e,2002-02-01,2,14,2,14,16
20503,AUCAPATA,estado nutricional en menores de 5 anos,clasificacion e,2002-02-01,0,9,0,9,9
20502,AYATA,estado nutricional en menores de 5 anos,clasificacion e,2002-02-01,1,0,1,0,1
21303,AYO AYO,estado nutricional en menores de 5 anos,clasificacion e,2002-02-01,6,1,6,1,7
30301,AYOPAYA (V. DE INDEPENDENCIA),estado nutricional en menores de 5 anos,clasificacion e,2002-02-01,22,23,22,23,45
10201,AZURDUY,estado nutricional en menores de 5 anos,clasificacion e,2002-02-01,10,27,10,27,37
21203,BATALLAS,estado nutricional en menores de 5 anos,clasificacion e,2002-02-01,1,6,1,6,7
80802,BAURES,estado nutricional en menores de 5 anos,clasificacion e,2002-02-01,3,3,3,3,6
50104,BELEN DE URMIRI,estado nutricional en menores de 5 anos,clasificacion e,2002-02-01,0,3,0,3,3
90104,BELLA FLOR,estado nutricional en menores de 5 anos,clasificacion e,2002-02-01,0,3,0,3,3
60202,BERMEJO,estado nutricional en menores de 5 anos,clasificacion e,2002-02-01,1,4,1,4,5
50301,BETANZOS,estado nutricional en menores de 5 anos,clasificacion e,2002-02-01,6,72,6,72,78
31501,BOLIVAR,estado nutricional en menores de 5 anos,clasificacion e,2002-02-01,9,12,9,12,21
70707,BOYUIBE,estado nutricional en menores de 5 anos,clasificacion e,2002-02-01,0,1,0,1,1
70401,BUENA VISTA,estado nutricional en menores de 5 anos,clasificacion e,2002-02-01,7,7,7,7,14
70703,CABEZAS,estado nutricional en menores de 5 anos,clasificacion e,2002-02-01,0,16,0,16,16
20905,CAIROMA,estado nutricional en menores de 5 anos,clasificacion e,2002-02-01,0,2,0,2,2
51102,"CAIZA ""D""",estado nutricional en menores de 5 anos,clasificacion e,2002-02-01,5,40,5,40,45
21003,CAJUATA,estado nutricional en menores de 5 anos,clasificacion e,2002-02-01,9,2,9,2,11
20303,CALACOTO,estado nutricional en menores de 5 anos,clasificacion e,2002-02-01,0,2,0,2,2
21304,CALAMARCA,estado nutricional en menores de 5 anos,clasificacion e,2002-02-01,5,3,5,3,8
10701,CAMARGO,estado nutricional en menores de 5 anos,clasificacion e,2002-02-01,1,34,1,34,35
10901,CAMATAQUI (C. VILLA ABECIA),estado nutricional en menores de 5 anos,clasificacion e,2002-02-01,1,4,1,4,5
70706,CAMIRI,estado nutricional en menores de 5 anos,clasificacion e,2002-02-01,19,32,19,32,51
30701,CAPINOTA,estado nutricional en menores de 5 anos,clasificacion e,2002-02-01,15,3,15,3,18
20302,CAQUIAVIRI,estado nutricional en menores de 5 anos,clasificacion e,2002-02-01,2,7,2,7,9
40102,CARACOLLO,estado nutricional en menores de 5 anos,clasificacion e,2002-02-01,6,18,6,18,24
22001,CARANAVI,estado nutricional en menores de 5 anos,clasificacion e,2002-02-01,15,17,15,17,32
60302,CARAPARI,estado nutricional en menores de 5 anos,clasificacion e,2002-02-01,5,3,5,3,8
50702,CARIPUYO,estado nutricional en menores de 5 anos,clasificacion e,2002-02-01,0,20,0,20,20
21902,CATACORA,estado nutricional en menores de 5 anos,clasificacion e,2002-02-01,2,2,2,2,4
40201,CHALLAPATA,estado nutricional en menores de 5 anos,clasificacion e,2002-02-01,8,3,8,3,11
50302,CHAQUI,estado nutricional en menores de 5 anos,clasificacion e,2002-02-01,10,23,10,23,33
70702,CHARAGUA,estado nutricional en menores de 5 anos,clasificacion e,2002-02-01,2,69,2,69,71
31204,CHIMORE,estado nutricional en menores de 5 anos,clasificacion e,2002-02-01,5,3,5,3,8
40903,CHIPAYA,estado nutricional en menores de 5 anos,clasificacion e,2002-02-01,0,1,0,1,1
40302,CHOQUE COTA,estado nutricional en menores de 5 anos,clasificacion e,2002-02-01,0,1,0,1,1
20501,CHUMA,estado nutricional en menores de 5 anos,clasificacion e,2002-02-01,2,0,2,0,2
30801,CLIZA,estado nutricional en menores de 5 anos,clasificacion e,2002-02-01,0,12,0,12,12
90101,COBIJA,estado nutricional en menores de 5 anos,clasificacion e,2002-02-01,6,5,6,5,11
30101,COCHABAMBA,estado nutricional en menores de 5 anos,clasificacion e,2002-02-01,36,67,36,67,103
40902,COIPASA,estado nutricional en menores de 5 anos,clasificacion e,2002-02-01,0,1,0,1,1
30905,COLCAPIRHUA,estado nutricional en menores de 5 anos,clasificacion e,2002-02-01,7,6,7,6,13
50901,"COLCHA ""K""",estado nutricional en menores de 5 anos,clasificacion e,2002-02-01,0,3,0,3,3
31002,COLOMI,estado nutricional en menores de 5 anos,clasificacion e,2002-02-01,16,9,16,9,25
50401,COLQUECHACA,estado nutricional en menores de 5 anos,clasificacion e,2002-02-01,10,24,10,24,34
21306,COLQUENCHA,estado nutricional en menores de 5 anos,clasificacion e,2002-02-01,4,1,4,1,5
21004,COLQUIRI,estado nutricional en menores de 5 anos,clasificacion e,2002-02-01,17,7,17,7,24
20304,COMANCHE,estado nutricional en menores de 5 anos,clasificacion e,2002-02-01,2,4,2,4,6
71301,COMARAPA,estado nutricional en menores de 5 anos,clasificacion e,2002-02-01,1,6,1,6,7
20605,COMBAYA,estado nutricional en menores de 5 anos,clasificacion e,2002-02-01,0,3,0,3,3
71101,CONCEPCION,estado nutricional en menores de 5 anos,clasificacion e,2002-02-01,0,8,0,8,8
21701,COPACABANA,estado nutricional en menores de 5 anos,clasificacion e,2002-02-01,0,5,0,5,5
20301,CORO CORO,estado nutricional en menores de 5 anos,clasificacion e,2002-02-01,3,2,3,2,5
21401,COROICO,estado nutricional en menores de 5 anos,clasificacion e,2002-02-01,7,4,7,4,11
40301,CORQUE,estado nutricional en menores de 5 anos,clasificacion e,2002-02-01,4,7,4,7,11
50601,COTAGAITA,estado nutricional en menores de 5 anos,clasificacion e,2002-02-01,2,24,2,24,26
70102,COTOCA,estado nutricional en menores de 5 anos,clasificacion e,2002-02-01,7,17,7,17,24
31405,CUCHUMUELA (V. G. VILLARROEL),estado nutricional en menores de 5 anos,clasificacion e,2002-02-01,0,1,0,1,1
70704,CUEVO,estado nutricional en menores de 5 anos,clasificacion e,2002-02-01,9,7,9,7,16
10902,CULPINA,estado nutricional en menores de 5 anos,clasificacion e,2002-02-01,2,50,2,50,52
40401,CURAHUARA DE CARANGAS,estado nutricional en menores de 5 anos,clasificacion e,2002-02-01,2,3,2,3,5
21602,CURVA,estado nutricional en menores de 5 anos,clasificacion e,2002-02-01,2,3,2,3,5
20804,DESAGUADERO,estado nutricional en menores de 5 anos,clasificacion e,2002-02-01,0,2,0,2,2
20105,EL ALTO,estado nutricional en menores de 5 anos,clasificacion e,2002-02-01,257,217,257,217,474
71503,EL PUENTE(STC),estado nutricional en menores de 5 anos,clasificacion e,2002-02-01,4,42,4,42,46
60502,EL PUENTE(TJA),estado nutricional en menores de 5 anos,clasificacion e,2002-02-01,3,8,3,8,11
70105,EL TORNO,estado nutricional en menores de 5 anos,clasificacion e,2002-02-01,21,7,21,7,28
10405,EL VILLAR,estado nutricional en menores de 5 anos,clasificacion e,2002-02-01,16,29,16,29,45
60601,ENTRE RIOS,estado nutricional en menores de 5 anos,clasificacion e,2002-02-01,2,8,2,8,10
41101,EUCALIPTUS,estado nutricional en menores de 5 anos,clasificacion e,2002-02-01,0,8,0,8,8
80402,EXALTACION,estado nutricional en menores de 5 anos,clasificacion e,2002-02-01,2,12,2,12,14
90203,FILADELFIA,estado nutricional en menores de 5 anos,clasificacion e,2002-02-01,0,1,0,1,1
71002,GENERAL SAAVEDRA,estado nutricional en menores de 5 anos,clasificacion e,2002-02-01,13,36,13,36,49
20602,GUANAY,estado nutricional en menores de 5 anos,clasificacion e,2002-02-01,11,22,11,22,33
20802,GUAQUI,estado nutricional en menores de 5 anos,clasificacion e,2002-02-01,0,2,0,2,2
80202,GUAYARAMERIN,estado nutricional en menores de 5 anos,clasificacion e,2002-02-01,8,12,8,12,20
70705,GUTIERREZ,estado nutricional en menores de 5 anos,clasificacion e,2002-02-01,5,42,5,42,47
10502,HUACARETA,estado nutricional en menores de 5 anos,clasificacion e,2002-02-01,27,26,27,26,53
11002,HUACAYA (VILLA DE HUACAYA),estado nutricional en menores de 5 anos,clasificacion e,2002-02-01,3,1,3,1,4
80803,HUARACAJE,estado nutricional en menores de 5 anos,clasificacion e,2002-02-01,3,0,3,0,3
21005,ICHOCA,estado nutricional en menores de 5 anos,clasificacion e,2002-02-01,4,8,4,8,12
10304,ICLA,estado nutricional en menores de 5 anos,clasificacion e,2002-02-01,18,29,18,29,47
10703,INCAHUASI,estado nutricional en menores de 5 anos,clasificacion e,2002-02-01,0,44,0,44,44
21001,INQUISIVI,estado nutricional en menores de 5 anos,clasificacion e,2002-02-01,5,18,5,18,23
21102,IRUPANA (VILLA DE LANZA),estado nutricional en menores de 5 anos,clasificacion e,2002-02-01,0,3,0,3,3
21501,IXIAMAS,estado nutricional en menores de 5 anos,clasificacion e,2002-02-01,3,6,3,6,9
21105,LA ASUNTA,estado nutricional en menores de 5 anos,clasificacion e,2002-02-01,7,13,7,13,20
70104,LA GUARDIA,estado nutricional en menores de 5 anos,clasificacion e,2002-02-01,16,6,16,6,22
20101,LA PAZ,estado nutricional en menores de 5 anos,clasificacion e,2002-02-01,148,128,148,128,276
70701,LAGUNILLAS,estado nutricional en menores de 5 anos,clasificacion e,2002-02-01,1,3,1,3,4
21202,LAJA,estado nutricional en menores de 5 anos,clasificacion e,2002-02-01,0,7,0,7,7
10903,LAS CARRERAS,estado nutricional en menores de 5 anos,clasificacion e,2002-02-01,0,7,0,7,7
51401,LLICA,estado nutricional en menores de 5 anos,clasificacion e,2002-02-01,0,5,0,5,5
20901,LURIBAY,estado nutricional en menores de 5 anos,clasificacion e,2002-02-01,0,8,0,8,8
40702,MACHACAMARCA,estado nutricional en menores de 5 anos,clasificacion e,2002-02-01,4,1,4,1,5
11003,MACHARETI,estado nutricional en menores de 5 anos,clasificacion e,2002-02-01,16,19,16,19,35
80801,MAGDALENA,estado nutricional en menores de 5 anos,clasificacion e,2002-02-01,5,0,5,0,5
70903,MAIRANA,estado nutricional en menores de 5 anos,clasificacion e,2002-02-01,1,1,1,1,2
20103,MECAPACA,estado nutricional en menores de 5 anos,clasificacion e,2002-02-01,1,1,1,1,2
71003,MINEROS,estado nutricional en menores de 5 anos,clasificacion e,2002-02-01,10,32,10,32,42
31301,MIZQUE,estado nutricional en menores de 5 anos,clasificacion e,2002-02-01,19,26,19,26,45
20402,MOCOMOCO,estado nutricional en menores de 5 anos,clasificacion e,2002-02-01,3,9,3,9,12
51002,MOJINETE,estado nutricional en menores de 5 anos,clasificacion e,2002-02-01,0,2,0,2,2
10303,MOJOCOYA,estado nutricional en menores de 5 anos,clasificacion e,2002-02-01,32,19,32,19,51
10501,MONTEAGUDO,estado nutricional en menores de 5 anos,clasificacion e,2002-02-01,39,46,39,46,85
71001,MONTERO,estado nutricional en menores de 5 anos,clasificacion e,2002-02-01,0,81,0,81,81
70803,MORO MORO,estado nutricional en menores de 5 anos,clasificacion e,2002-02-01,3,7,3,7,10
30302,MOROCHATA,estado nutricional en menores de 5 anos,clasificacion e,2002-02-01,5,7,5,7,12
90401,NACEBE (SANTA ROSA DEL ABUNA),estado nutricional en menores de 5 anos,clasificacion e,2002-02-01,0,3,0,3,3
20307,NAZACARA DE PACAJES,estado nutricional en menores de 5 anos,clasificacion e,2002-02-01,1,0,1,0,1
50404,OCURI,estado nutricional en menores de 5 anos,clasificacion e,2002-02-01,19,17,19,17,36
70202,OKINAWA,estado nutricional en menores de 5 anos,clasificacion e,2002-02-01,1,5,1,5,6
30203,OMEREQUE,estado nutricional en menores de 5 anos,clasificacion e,2002-02-01,1,1,1,1,2
40101,ORURO,estado nutricional en menores de 5 anos,clasificacion e,2002-02-01,11,102,11,102,113
60201,PADCAYA,estado nutricional en menores de 5 anos,clasificacion e,2002-02-01,0,5,0,5,5
10401,PADILLA,estado nutricional en menores de 5 anos,clasificacion e,2002-02-01,41,71,41,71,112
70502,PAILON,estado nutricional en menores de 5 anos,clasificacion e,2002-02-01,1,12,1,12,13
20102,PALCA,estado nutricional en menores de 5 anos,clasificacion e,2002-02-01,13,19,13,19,32
21104,PALOS BLANCOS,estado nutricional en menores de 5 anos,clasificacion e,2002-02-01,6,7,6,7,13
40802,PAMPA AULLAGAS,estado nutricional en menores de 5 anos,clasificacion e,2002-02-01,6,2,6,2,8
70902,PAMPA GRANDE,estado nutricional en menores de 5 anos,clasificacion e,2002-02-01,1,4,1,4,5
30202,PASORAPA,estado nutricional en menores de 5 anos,clasificacion e,2002-02-01,3,14,3,14,17
21305,PATACAMAYA,estado nutricional en menores de 5 anos,clasificacion e,2002-02-01,6,1,6,1,7
40602,PAZÑA,estado nutricional en menores de 5 anos,clasificacion e,2002-02-01,1,14,1,14,15
20702,PELECHUCO,estado nutricional en menores de 5 anos,clasificacion e,2002-02-01,6,1,6,1,7
50403,POCOATA,estado nutricional en menores de 5 anos,clasificacion e,2002-02-01,32,50,32,50,82
31203,POCONA,estado nutricional en menores de 5 anos,clasificacion e,2002-02-01,1,13,1,13,14
31202,POJO (CBBA),estado nutricional en menores de 5 anos,clasificacion e,2002-02-01,10,24,10,24,34
40601,POOPO,estado nutricional en menores de 5 anos,clasificacion e,2002-02-01,0,3,0,3,3
51203,PORCO,estado nutricional en menores de 5 anos,clasificacion e,2002-02-01,14,9,14,9,23
10103,POROMA,estado nutricional en menores de 5 anos,clasificacion e,2002-02-01,30,63,30,63,93
70103,PORONGO,estado nutricional en menores de 5 anos,clasificacion e,2002-02-01,3,0,3,0,3
70601,PORTACHUELO,estado nutricional en menores de 5 anos,clasificacion e,2002-02-01,5,2,5,2,7
50101,POTOSI,estado nutricional en menores de 5 anos,clasificacion e,2002-02-01,36,68,36,68,104
10302,PRESTO,estado nutricional en menores de 5 anos,clasificacion e,2002-02-01,25,12,25,12,37
70805,PUCARA,estado nutricional en menores de 5 anos,clasificacion e,2002-02-01,0,1,0,1,1
21201,PUCARANI,estado nutricional en menores de 5 anos,clasificacion e,2002-02-01,2,12,2,12,14
20401,PUERTO ACOSTA,estado nutricional en menores de 5 anos,clasificacion e,2002-02-01,7,5,7,5,12
20403,PUERTO CARABUCO,estado nutricional en menores de 5 anos,clasificacion e,2002-02-01,14,13,14,13,27
90301,PUERTO GONZALO MORENO,estado nutricional en menores de 5 anos,clasificacion e,2002-02-01,0,2,0,2,2
21204,PUERTO PEREZ,estado nutricional en menores de 5 anos,clasificacion e,2002-02-01,2,0,2,0,2
71402,PUERTO QUIJARRO,estado nutricional en menores de 5 anos,clasificacion e,2002-02-01,9,3,9,3,12
90201,PUERTO RICO,estado nutricional en menores de 5 anos,clasificacion e,2002-02-01,0,3,0,3,3
80703,PUERTO SILES,estado nutricional en menores de 5 anos,clasificacion e,2002-02-01,0,3,0,3,3
71401,PUERTO SUAREZ,estado nutricional en menores de 5 anos,clasificacion e,2002-02-01,8,6,8,6,14
31205,PUERTO VILLARROEL,estado nutricional en menores de 5 anos,clasificacion e,2002-02-01,22,10,22,10,32
51101,PUNA,estado nutricional en menores de 5 anos,clasificacion e,2002-02-01,0,57,0,57,57
31401,PUNATA,estado nutricional en menores de 5 anos,clasificacion e,2002-02-01,0,2,0,2,2
20604,QUIABAYA,estado nutricional en menores de 5 anos,clasificacion e,2002-02-01,0,15,0,15,15
21002,QUIME,estado nutricional en menores de 5 anos,clasificacion e,2002-02-01,2,12,2,12,14
50402,RAVELO,estado nutricional en menores de 5 anos,clasificacion e,2002-02-01,22,58,22,58,80
80301,REYES,estado nutricional en menores de 5 anos,clasificacion e,2002-02-01,8,0,8,0,8
80201,RIBERALTA,estado nutricional en menores de 5 anos,clasificacion e,2002-02-01,51,36,51,36,87
70503,ROBORE,estado nutricional en menores de 5 anos,clasificacion e,2002-02-01,0,17,0,17,17
80304,RURRENABAQUE,estado nutricional en menores de 5 anos,clasificacion e,2002-02-01,3,0,3,0,3
31001,SACABA,estado nutricional en menores de 5 anos,clasificacion e,2002-02-01,3,15,3,15,18
30404,SACABAMBA,estado nutricional en menores de 5 anos,clasificacion e,2002-02-01,0,22,0,22,22
50701,SACACA,estado nutricional en menores de 5 anos,clasificacion e,2002-02-01,34,71,34,71,105
71302,SAIPINA,estado nutricional en menores de 5 anos,clasificacion e,2002-02-01,4,4,4,4,8
40801,SALINAS DE GARCI MENDOZA,estado nutricional en menores de 5 anos,clasificacion e,2002-02-01,2,3,2,3,5
70901,SAMAIPATA,estado nutricional en menores de 5 anos,clasificacion e,2002-02-01,1,3,1,3,4
51003,SAN ANTONIO DE ESMORUCO,estado nutricional en menores de 5 anos,clasificacion e,2002-02-01,0,3,0,3,3
71105,SAN ANTONIO DE LOMERIO,estado nutricional en menores de 5 anos,clasificacion e,2002-02-01,24,60,24,60,84
31403,SAN BENITO,estado nutricional en menores de 5 anos,clasificacion e,2002-02-01,0,13,0,13,13
80302,SAN BORJA,estado nutricional en menores de 5 anos,clasificacion e,2002-02-01,17,7,17,7,24
21502,SAN BUENA VENTURA,estado nutricional en menores de 5 anos,clasificacion e,2002-02-01,11,14,11,14,25
70402,SAN CARLOS,estado nutricional en menores de 5 anos,clasificacion e,2002-02-01,0,4,0,4,4
80501,SAN IGNACIO,estado nutricional en menores de 5 anos,clasificacion e,2002-02-01,7,33,7,33,40
70301,SAN IGNACIO DE VELASCO,estado nutricional en menores de 5 anos,clasificacion e,2002-02-01,68,75,68,75,143
80102,SAN JAVIER(BNI),estado nutricional en menores de 5 anos,clasificacion e,2002-02-01,3,1,3,1,4
71102,SAN JAVIER(STC),estado nutricional en menores de 5 anos,clasificacion e,2002-02-01,0,23,0,23,23
80701,SAN JOAQUIN,estado nutricional en menores de 5 anos,clasificacion e,2002-02-01,1,3,1,3,4
70501,SAN JOSE DE CHIQUITOS,estado nutricional en menores de 5 anos,clasificacion e,2002-02-01,9,10,9,10,19
71104,SAN JULIAN,estado nutricional en menores de 5 anos,clasificacion e,2002-02-01,24,42,24,42,66
90302,SAN LORENZO(PND),estado nutricional en menores de 5 anos,clasificacion e,2002-02-01,0,2,0,2,2
60501,SAN LORENZO(TJA),estado nutricional en menores de 5 anos,clasificacion e,2002-02-01,0,5,0,5,5
10702,SAN LUCAS,estado nutricional en menores de 5 anos,clasificacion e,2002-02-01,0,120,0,120,120
71201,SAN MATIAS,estado nutricional en menores de 5 anos,clasificacion e,2002-02-01,26,23,26,23,49
70302,SAN MIGUEL DE VELASCO,estado nutricional en menores de 5 anos,clasificacion e,2002-02-01,11,33,11,33,44
51001,SAN PABLO DE LIPEZ,estado nutricional en menores de 5 anos,clasificacion e,2002-02-01,0,5,0,5,5
50501,SAN PEDRO DE BUENA VISTA,estado nutricional en menores de 5 anos,clasificacion e,2002-02-01,5,56,5,56,61
21801,SAN PEDRO DE CURAHUARA,estado nutricional en menores de 5 anos,clasificacion e,2002-02-01,1,0,1,0,1
21702,SAN PEDRO DE TIQUINA,estado nutricional en menores de 5 anos,clasificacion e,2002-02-01,0,1,0,1,1
90202,SAN PEDRO(PND),estado nutricional en menores de 5 anos,clasificacion e,2002-02-01,0,1,0,1,1
70303,SAN RAFAEL,estado nutricional en menores de 5 anos,clasificacion e,2002-02-01,13,9,13,9,22
80702,SAN RAMON,estado nutricional en menores de 5 anos,clasificacion e,2002-02-01,1,2,1,2,3
80401,SANTA ANA,estado nutricional en menores de 5 anos,clasificacion e,2002-02-01,4,2,4,2,6
70101,SANTA CRUZ DE LA SIERRA,estado nutricional en menores de 5 anos,clasificacion e,2002-02-01,44,64,44,64,108
80303,SANTA ROSA,estado nutricional en menores de 5 anos,clasificacion e,2002-02-01,1,2,1,2,3
70602,SANTA ROSA DEL SARA,estado nutricional en menores de 5 anos,clasificacion e,2002-02-01,1,0,1,0,1
41401,SANTIAGO DE HUARI,estado nutricional en menores de 5 anos,clasificacion e,2002-02-01,0,2,0,2,2
30702,SANTIVAÑES,estado nutricional en menores de 5 anos,clasificacion e,2002-02-01,4,28,4,28,32
40202,SANTUARIO DE QUILLACAS,estado nutricional en menores de 5 anos,clasificacion e,2002-02-01,1,1,1,1,2
20902,SAPAHAQUI,estado nutricional en menores de 5 anos,clasificacion e,2002-02-01,0,5,0,5,5
21301,SICA SICA (VILLA AROMA),estado nutricional en menores de 5 anos,clasificacion e,2002-02-01,9,0,9,0,9
30703,SICAYA,estado nutricional en menores de 5 anos,clasificacion e,2002-02-01,0,1,0,1,1
30902,SIPE SIPE,estado nutricional en menores de 5 anos,clasificacion e,2002-02-01,22,18,22,18,40
10403,SOPACHUY,estado nutricional en menores de 5 anos,clasificacion e,2002-02-01,22,10,22,10,32
20601,SORATA,estado nutricional en menores de 5 anos,clasificacion e,2002-02-01,1,6,1,6,7
10101,SUCRE,estado nutricional en menores de 5 anos,clasificacion e,2002-02-01,7,162,7,162,169
31404,TACACHI,estado nutricional en menores de 5 anos,clasificacion e,2002-02-01,0,3,0,3,3
20603,TACACOMA,estado nutricional en menores de 5 anos,clasificacion e,2002-02-01,4,3,4,3,7
50303,TACOBAMBA,estado nutricional en menores de 5 anos,clasificacion e,2002-02-01,8,20,8,20,28
30602,TACOPAYA,estado nutricional en menores de 5 anos,clasificacion e,2002-02-01,2,2,2,2,4
31101,TAPACARI,estado nutricional en menores de 5 anos,clasificacion e,2002-02-01,0,21,0,21,21
10601,TARABUCO,estado nutricional en menores de 5 anos,clasificacion e,2002-02-01,0,226,0,226,226
30401,TARATA,estado nutricional en menores de 5 anos,clasificacion e,2002-02-01,1,7,1,7,8
60101,TARIJA,estado nutricional en menores de 5 anos,clasificacion e,2002-02-01,6,18,6,18,24
10202,TARVITA,estado nutricional en menores de 5 anos,clasificacion e,2002-02-01,21,20,21,20,41
20803,TIAWANACU,estado nutricional en menores de 5 anos,clasificacion e,2002-02-01,6,2,6,2,8
50102,TINGUIPAYA,estado nutricional en menores de 5 anos,clasificacion e,2002-02-01,0,27,0,27,27
20606,TIPUANI,estado nutricional en menores de 5 anos,clasificacion e,2002-02-01,1,0,1,0,1
30903,TIQUIPAYA,estado nutricional en menores de 5 anos,clasificacion e,2002-02-01,0,3,0,3,3
31601,TIRAQUE (CBBA),estado nutricional en menores de 5 anos,clasificacion e,2002-02-01,13,21,13,21,34
21703,TITO YUPANQUI (PARQUIPUJIO),estado nutricional en menores de 5 anos,clasificacion e,2002-02-01,0,5,0,5,5
30802,TOCO,estado nutricional en menores de 5 anos,clasificacion e,2002-02-01,0,4,0,4,4
41001,TOLEDO,estado nutricional en menores de 5 anos,clasificacion e,2002-02-01,1,1,1,1,2
51202,TOMAVE,estado nutricional en menores de 5 anos,clasificacion e,2002-02-01,0,35,0,35,35
10402,TOMINA,estado nutricional en menores de 5 anos,clasificacion e,2002-02-01,34,30,34,30,64
50502,TORO TORO,estado nutricional en menores de 5 anos,clasificacion e,2002-02-01,2,4,2,4,6
31201,TOTORA(CBBA),estado nutricional en menores de 5 anos,clasificacion e,2002-02-01,14,10,14,10,24
41301,TOTORA(ORR),estado nutricional en menores de 5 anos,clasificacion e,2002-02-01,1,2,1,2,3
80101,TRINIDAD,estado nutricional en menores de 5 anos,clasificacion e,2002-02-01,1,0,1,0,1
50801,TUPIZA,estado nutricional en menores de 5 anos,clasificacion e,2002-02-01,10,33,10,33,43
40402,TURCO,estado nutricional en menores de 5 anos,clasificacion e,2002-02-01,0,2,0,2,2
21302,UMALA,estado nutricional en menores de 5 anos,clasificacion e,2002-02-01,4,0,4,0,4
60401,URIONDO (A. CONCEPCION),estado nutricional en menores de 5 anos,clasificacion e,2002-02-01,1,9,1,9,10
71502,URUBICHA,estado nutricional en menores de 5 anos,clasificacion e,2002-02-01,9,78,9,78,87
51201,UYUNI,estado nutricional en menores de 5 anos,clasificacion e,2002-02-01,0,13,0,13,13
30502,VACAS,estado nutricional en menores de 5 anos,clasificacion e,2002-02-01,0,14,0,14,14
70801,VALLEGRANDE,estado nutricional en menores de 5 anos,clasificacion e,2002-02-01,4,9,4,9,13
20801,VIACHA,estado nutricional en menores de 5 anos,clasificacion e,2002-02-01,4,22,4,22,26
31302,VILA VILA,estado nutricional en menores de 5 anos,clasificacion e,2002-02-01,2,8,2,8,10
60303,VILLA MONTES,estado nutricional en menores de 5 anos,clasificacion e,2002-02-01,7,15,7,15,22
31402,VILLA RIVERO,estado nutricional en menores de 5 anos,clasificacion e,2002-02-01,0,2,0,2,2
10801,VILLA SERRANO,estado nutricional en menores de 5 anos,clasificacion e,2002-02-01,31,49,31,49,80
31003,VILLA TUNARI,estado nutricional en menores de 5 anos,clasificacion e,2002-02-01,25,21,25,21,46
11001,VILLA VACA GUZMAN (MUYUPAMPA),estado nutricional en menores de 5 anos,clasificacion e,2002-02-01,15,33,15,33,48
51501,VILLAZON,estado nutricional en menores de 5 anos,clasificacion e,2002-02-01,0,22,0,22,22
30904,VINTO,estado nutricional en menores de 5 anos,clasificacion e,2002-02-01,12,11,12,11,23
50602,VITICHI,estado nutricional en menores de 5 anos,clasificacion e,2002-02-01,10,25,10,25,35
20306,WALDO BALLIVIAN,estado nutricional en menores de 5 anos,clasificacion e,2002-02-01,1,1,1,1,2
70201,WARNES,estado nutricional en menores de 5 anos,clasificacion e,2002-02-01,20,11,20,11,31
20903,YACO,estado nutricional en menores de 5 anos,clasificacion e,2002-02-01,0,6,0,6,6
60301,YACUIBA,estado nutricional en menores de 5 anos,clasificacion e,2002-02-01,12,7,12,7,19
10602,YAMPARAEZ,estado nutricional en menores de 5 anos,clasificacion e,2002-02-01,54,48,54,48,102
70403,YAPACANI,estado nutricional en menores de 5 anos,clasificacion e,2002-02-01,13,27,13,27,40
50103,YOCALLA,estado nutricional en menores de 5 anos,clasificacion e,2002-02-01,0,22,0,22,22
10102,YOTALA,estado nutricional en menores de 5 anos,clasificacion e,2002-02-01,19,25,19,25,44
60402,YUNCHARA,estado nutricional en menores de 5 anos,clasificacion e,2002-02-01,2,4,2,4,6
10301,ZUDAÑEZ,estado nutricional en menores de 5 anos,clasificacion e,2002-02-01,33,34,33,34,67
51302,ACACIO,estado nutricional en menores de 5 anos,clasificacion e,2002-03-01,19,17,19,17,36
20201,ACHACACHI,estado nutricional en menores de 5 anos,clasificacion e,2002-03-01,11,29,11,29,40
20104,ACHOCALLA,estado nutricional en menores de 5 anos,clasificacion e,2002-03-01,3,0,3,0,3
30201,AIQUILE,estado nutricional en menores de 5 anos,clasificacion e,2002-03-01,6,13,6,13,19
31303,ALALAY,estado nutricional en menores de 5 anos,clasificacion e,2002-03-01,1,1,1,1,2
10404,ALCALA,estado nutricional en menores de 5 anos,clasificacion e,2002-03-01,11,12,11,12,23
20202,ANCORAIMES,estado nutricional en menores de 5 anos,clasificacion e,2002-03-01,26,17,26,17,43
41201,ANDAMARCA,estado nutricional en menores de 5 anos,clasificacion e,2002-03-01,6,3,6,3,9
40603,ANTEQUERA,estado nutricional en menores de 5 anos,clasificacion e,2002-03-01,0,1,0,1,1
30402,ANZALDO,estado nutricional en menores de 5 anos,clasificacion e,2002-03-01,0,21,0,21,21
20701,APOLO,estado nutricional en menores de 5 anos,clasificacion e,2002-03-01,8,6,8,6,14
51301,ARAMPAMPA,estado nutricional en menores de 5 anos,clasificacion e,2002-03-01,4,11,4,11,15
30501,ARANI,estado nutricional en menores de 5 anos,clasificacion e,2002-03-01,3,23,3,23,26
30403,ARBIETO,estado nutricional en menores de 5 anos,clasificacion e,2002-03-01,0,5,0,5,5
30601,ARQUE,estado nutricional en menores de 5 anos,clasificacion e,2002-03-01,40,40,40,40,80
71501,ASCENCION DE GUARAYOS,estado nutricional en menores de 5 anos,clasificacion e,2002-03-01,0,1,0,1,1
50802,ATOCHA,estado nutricional en menores de 5 anos,clasificacion e,2002-03-01,0,11,0,11,11
20502,AYATA,estado nutricional en menores de 5 anos,clasificacion e,2002-03-01,0,2,0,2,2
21303,AYO AYO,estado nutricional en menores de 5 anos,clasificacion e,2002-03-01,1,2,1,2,3
30301,AYOPAYA (V. DE INDEPENDENCIA),estado nutricional en menores de 5 anos,clasificacion e,2002-03-01,25,27,25,27,52
10201,AZURDUY,estado nutricional en menores de 5 anos,clasificacion e,2002-03-01,48,49,48,49,97
21203,BATALLAS,estado nutricional en menores de 5 anos,clasificacion e,2002-03-01,0,3,0,3,3
80802,BAURES,estado nutricional en menores de 5 anos,clasificacion e,2002-03-01,3,2,3,2,5
41202,BELEN DE ANDAMARCA,estado nutricional en menores de 5 anos,clasificacion e,2002-03-01,0,3,0,3,3
50104,BELEN DE URMIRI,estado nutricional en menores de 5 anos,clasificacion e,2002-03-01,0,4,0,4,4
60202,BERMEJO,estado nutricional en menores de 5 anos,clasificacion e,2002-03-01,1,8,1,8,9
50301,BETANZOS,estado nutricional en menores de 5 anos,clasificacion e,2002-03-01,49,181,49,181,230
31501,BOLIVAR,estado nutricional en menores de 5 anos,clasificacion e,2002-03-01,30,27,30,27,57
90103,BOLPEBRA,estado nutricional en menores de 5 anos,clasificacion e,2002-03-01,0,6,0,6,6
70707,BOYUIBE,estado nutricional en menores de 5 anos,clasificacion e,2002-03-01,1,3,1,3,4
70401,BUENA VISTA,estado nutricional en menores de 5 anos,clasificacion e,2002-03-01,12,10,12,10,22
70703,CABEZAS,estado nutricional en menores de 5 anos,clasificacion e,2002-03-01,0,10,0,10,10
20905,CAIROMA,estado nutricional en menores de 5 anos,clasificacion e,2002-03-01,0,19,0,19,19
51102,"CAIZA ""D""",estado nutricional en menores de 5 anos,clasificacion e,2002-03-01,17,42,17,42,59
21003,CAJUATA,estado nutricional en menores de 5 anos,clasificacion e,2002-03-01,4,1,4,1,5
20303,CALACOTO,estado nutricional en menores de 5 anos,clasificacion e,2002-03-01,1,2,1,2,3
21304,CALAMARCA,estado nutricional en menores de 5 anos,clasificacion e,2002-03-01,3,0,3,0,3
10701,CAMARGO,estado nutricional en menores de 5 anos,clasificacion e,2002-03-01,0,32,0,32,32
10901,CAMATAQUI (C. VILLA ABECIA),estado nutricional en menores de 5 anos,clasificacion e,2002-03-01,0,14,0,14,14
70706,CAMIRI,estado nutricional en menores de 5 anos,clasificacion e,2002-03-01,16,24,16,24,40
30701,CAPINOTA,estado nutricional en menores de 5 anos,clasificacion e,2002-03-01,25,49,25,49,74
20302,CAQUIAVIRI,estado nutricional en menores de 5 anos,clasificacion e,2002-03-01,10,7,10,7,17
40102,CARACOLLO,estado nutricional en menores de 5 anos,clasificacion e,2002-03-01,3,6,3,6,9
22001,CARANAVI,estado nutricional en menores de 5 anos,clasificacion e,2002-03-01,29,41,29,41,70
60302,CARAPARI,estado nutricional en menores de 5 anos,clasificacion e,2002-03-01,10,13,10,13,23
50702,CARIPUYO,estado nutricional en menores de 5 anos,clasificacion e,2002-03-01,5,38,5,38,43
21902,CATACORA,estado nutricional en menores de 5 anos,clasificacion e,2002-03-01,2,0,2,0,2
40201,CHALLAPATA,estado nutricional en menores de 5 anos,clasificacion e,2002-03-01,16,11,16,11,27
50302,CHAQUI,estado nutricional en menores de 5 anos,clasificacion e,2002-03-01,1,29,1,29,30
70702,CHARAGUA,estado nutricional en menores de 5 anos,clasificacion e,2002-03-01,1,62,1,62,63
20305,CHARAÑA,estado nutricional en menores de 5 anos,clasificacion e,2002-03-01,0,3,0,3,3
31204,CHIMORE,estado nutricional en menores de 5 anos,clasificacion e,2002-03-01,2,2,2,2,4
40903,CHIPAYA,estado nutricional en menores de 5 anos,clasificacion e,2002-03-01,0,1,0,1,1
20501,CHUMA,estado nutricional en menores de 5 anos,clasificacion e,2002-03-01,6,2,6,2,8
30801,CLIZA,estado nutricional en menores de 5 anos,clasificacion e,2002-03-01,4,9,4,9,13
90101,COBIJA,estado nutricional en menores de 5 anos,clasificacion e,2002-03-01,14,11,14,11,25
30101,COCHABAMBA,estado nutricional en menores de 5 anos,clasificacion e,2002-03-01,43,94,43,94,137
40902,COIPASA,estado nutricional en menores de 5 anos,clasificacion e,2002-03-01,0,1,0,1,1
30905,COLCAPIRHUA,estado nutricional en menores de 5 anos,clasificacion e,2002-03-01,8,3,8,3,11
50901,"COLCHA ""K""",estado nutricional en menores de 5 anos,clasificacion e,2002-03-01,1,15,1,15,16
31002,COLOMI,estado nutricional en menores de 5 anos,clasificacion e,2002-03-01,21,10,21,10,31
50401,COLQUECHACA,estado nutricional en menores de 5 anos,clasificacion e,2002-03-01,32,27,32,27,59
21306,COLQUENCHA,estado nutricional en menores de 5 anos,clasificacion e,2002-03-01,9,0,9,0,9
21004,COLQUIRI,estado nutricional en menores de 5 anos,clasificacion e,2002-03-01,18,11,18,11,29
20304,COMANCHE,estado nutricional en menores de 5 anos,clasificacion e,2002-03-01,1,1,1,1,2
71301,COMARAPA,estado nutricional en menores de 5 anos,clasificacion e,2002-03-01,5,12,5,12,17
20605,COMBAYA,estado nutricional en menores de 5 anos,clasificacion e,2002-03-01,3,11,3,11,14
21701,COPACABANA,estado nutricional en menores de 5 anos,clasificacion e,2002-03-01,2,3,2,3,5
21402,CORIPATA,estado nutricional en menores de 5 anos,clasificacion e,2002-03-01,2,1,2,1,3
20301,CORO CORO,estado nutricional en menores de 5 anos,clasificacion e,2002-03-01,4,8,4,8,12
21401,COROICO,estado nutricional en menores de 5 anos,clasificacion e,2002-03-01,7,3,7,3,10
40301,CORQUE,estado nutricional en menores de 5 anos,clasificacion e,2002-03-01,4,11,4,11,15
50601,COTAGAITA,estado nutricional en menores de 5 anos,clasificacion e,2002-03-01,18,52,18,52,70
70102,COTOCA,estado nutricional en menores de 5 anos,clasificacion e,2002-03-01,15,9,15,9,24
31405,CUCHUMUELA (V. G. VILLARROEL),estado nutricional en menores de 5 anos,clasificacion e,2002-03-01,0,2,0,2,2
70704,CUEVO,estado nutricional en menores de 5 anos,clasificacion e,2002-03-01,9,2,9,2,11
10902,CULPINA,estado nutricional en menores de 5 anos,clasificacion e,2002-03-01,17,73,17,73,90
40401,CURAHUARA DE CARANGAS,estado nutricional en menores de 5 anos,clasificacion e,2002-03-01,3,0,3,0,3
20804,DESAGUADERO,estado nutricional en menores de 5 anos,clasificacion e,2002-03-01,0,9,0,9,9
20105,EL ALTO,estado nutricional en menores de 5 anos,clasificacion e,2002-03-01,355,241,355,241,596
40103,EL CHORO,estado nutricional en menores de 5 anos,clasificacion e,2002-03-01,0,1,0,1,1
71503,EL PUENTE(STC),estado nutricional en menores de 5 anos,clasificacion e,2002-03-01,1,24,1,24,25
60502,EL PUENTE(TJA),estado nutricional en menores de 5 anos,clasificacion e,2002-03-01,0,7,0,7,7
70105,EL TORNO,estado nutricional en menores de 5 anos,clasificacion e,2002-03-01,25,13,25,13,38
10405,EL VILLAR,estado nutricional en menores de 5 anos,clasificacion e,2002-03-01,19,28,19,28,47
60601,ENTRE RIOS,estado nutricional en menores de 5 anos,clasificacion e,2002-03-01,8,7,8,7,15
41101,EUCALIPTUS,estado nutricional en menores de 5 anos,clasificacion e,2002-03-01,0,3,0,3,3
80402,EXALTACION,estado nutricional en menores de 5 anos,clasificacion e,2002-03-01,0,14,0,14,14
90203,FILADELFIA,estado nutricional en menores de 5 anos,clasificacion e,2002-03-01,0,8,0,8,8
71002,GENERAL SAAVEDRA,estado nutricional en menores de 5 anos,clasificacion e,2002-03-01,17,27,17,27,44
21601,GRAL. J.J. PEREZ (CHARAZANI),estado nutricional en menores de 5 anos,clasificacion e,2002-03-01,5,0,5,0,5
20602,GUANAY,estado nutricional en menores de 5 anos,clasificacion e,2002-03-01,1,22,1,22,23
20802,GUAQUI,estado nutricional en menores de 5 anos,clasificacion e,2002-03-01,0,1,0,1,1
80202,GUAYARAMERIN,estado nutricional en menores de 5 anos,clasificacion e,2002-03-01,24,11,24,11,35
70705,GUTIERREZ,estado nutricional en menores de 5 anos,clasificacion e,2002-03-01,17,72,17,72,89
10502,HUACARETA,estado nutricional en menores de 5 anos,clasificacion e,2002-03-01,32,21,32,21,53
11002,HUACAYA (VILLA DE HUACAYA),estado nutricional en menores de 5 anos,clasificacion e,2002-03-01,4,9,4,9,13
40501,HUACHACALLA,estado nutricional en menores de 5 anos,clasificacion e,2002-03-01,0,1,0,1,1
80803,HUARACAJE,estado nutricional en menores de 5 anos,clasificacion e,2002-03-01,4,0,4,0,4
41601,HUAYLLAMARCA,estado nutricional en menores de 5 anos,clasificacion e,2002-03-01,0,1,0,1,1
21005,ICHOCA,estado nutricional en menores de 5 anos,clasificacion e,2002-03-01,3,2,3,2,5
10304,ICLA,estado nutricional en menores de 5 anos,clasificacion e,2002-03-01,43,76,43,76,119
10703,INCAHUASI,estado nutricional en menores de 5 anos,clasificacion e,2002-03-01,2,90,2,90,92
21001,INQUISIVI,estado nutricional en menores de 5 anos,clasificacion e,2002-03-01,1,24,1,24,25
21102,IRUPANA (VILLA DE LANZA),estado nutricional en menores de 5 anos,clasificacion e,2002-03-01,0,4,0,4,4
21501,IXIAMAS,estado nutricional en menores de 5 anos,clasificacion e,2002-03-01,13,6,13,6,19
21105,LA ASUNTA,estado nutricional en menores de 5 anos,clasificacion e,2002-03-01,11,12,11,12,23
70104,LA GUARDIA,estado nutricional en menores de 5 anos,clasificacion e,2002-03-01,27,10,27,10,37
20101,LA PAZ,estado nutricional en menores de 5 anos,clasificacion e,2002-03-01,199,172,199,172,371
70701,LAGUNILLAS,estado nutricional en menores de 5 anos,clasificacion e,2002-03-01,1,28,1,28,29
21202,LAJA,estado nutricional en menores de 5 anos,clasificacion e,2002-03-01,0,8,0,8,8
10903,LAS CARRERAS,estado nutricional en menores de 5 anos,clasificacion e,2002-03-01,5,10,5,10,15
21006,LICOMA PAMPA,estado nutricional en menores de 5 anos,clasificacion e,2002-03-01,0,2,0,2,2
51401,LLICA,estado nutricional en menores de 5 anos,clasificacion e,2002-03-01,0,6,0,6,6
80601,LORETO,estado nutricional en menores de 5 anos,clasificacion e,2002-03-01,0,2,0,2,2
20901,LURIBAY,estado nutricional en menores de 5 anos,clasificacion e,2002-03-01,0,9,0,9,9
40702,MACHACAMARCA,estado nutricional en menores de 5 anos,clasificacion e,2002-03-01,4,2,4,2,6
11003,MACHARETI,estado nutricional en menores de 5 anos,clasificacion e,2002-03-01,20,21,20,21,41
80801,MAGDALENA,estado nutricional en menores de 5 anos,clasificacion e,2002-03-01,1,2,1,2,3
70903,MAIRANA,estado nutricional en menores de 5 anos,clasificacion e,2002-03-01,1,3,1,3,4
20103,MECAPACA,estado nutricional en menores de 5 anos,clasificacion e,2002-03-01,3,3,3,3,6
71003,MINEROS,estado nutricional en menores de 5 anos,clasificacion e,2002-03-01,22,34,22,34,56
31301,MIZQUE,estado nutricional en menores de 5 anos,clasificacion e,2002-03-01,0,15,0,15,15
20402,MOCOMOCO,estado nutricional en menores de 5 anos,clasificacion e,2002-03-01,7,10,7,10,17
51002,MOJINETE,estado nutricional en menores de 5 anos,clasificacion e,2002-03-01,0,3,0,3,3
10303,MOJOCOYA,estado nutricional en menores de 5 anos,clasificacion e,2002-03-01,28,16,28,16,44
10501,MONTEAGUDO,estado nutricional en menores de 5 anos,clasificacion e,2002-03-01,44,49,44,49,93
71001,MONTERO,estado nutricional en menores de 5 anos,clasificacion e,2002-03-01,6,124,6,124,130
70803,MORO MORO,estado nutricional en menores de 5 anos,clasificacion e,2002-03-01,4,2,4,2,6
30302,MOROCHATA,estado nutricional en menores de 5 anos,clasificacion e,2002-03-01,18,32,18,32,50
90401,NACEBE (SANTA ROSA DEL ABUNA),estado nutricional en menores de 5 anos,clasificacion e,2002-03-01,0,7,0,7,7
50404,OCURI,estado nutricional en menores de 5 anos,clasificacion e,2002-03-01,28,23,28,23,51
70202,OKINAWA,estado nutricional en menores de 5 anos,clasificacion e,2002-03-01,1,4,1,4,5
30203,OMEREQUE,estado nutricional en menores de 5 anos,clasificacion e,2002-03-01,0,1,0,1,1
40101,ORURO,estado nutricional en menores de 5 anos,clasificacion e,2002-03-01,60,74,60,74,134
60201,PADCAYA,estado nutricional en menores de 5 anos,clasificacion e,2002-03-01,11,13,11,13,24
10401,PADILLA,estado nutricional en menores de 5 anos,clasificacion e,2002-03-01,43,63,43,63,106
70502,PAILON,estado nutricional en menores de 5 anos,clasificacion e,2002-03-01,1,14,1,14,15
20102,PALCA,estado nutricional en menores de 5 anos,clasificacion e,2002-03-01,11,16,11,16,27
21104,PALOS BLANCOS,estado nutricional en menores de 5 anos,clasificacion e,2002-03-01,18,21,18,21,39
40802,PAMPA AULLAGAS,estado nutricional en menores de 5 anos,clasificacion e,2002-03-01,3,3,3,3,6
70902,PAMPA GRANDE,estado nutricional en menores de 5 anos,clasificacion e,2002-03-01,6,3,6,3,9
21802,PAPEL PAMPA,estado nutricional en menores de 5 anos,clasificacion e,2002-03-01,1,5,1,5,6
30202,PASORAPA,estado nutricional en menores de 5 anos,clasificacion e,2002-03-01,6,14,6,14,20
21305,PATACAMAYA,estado nutricional en menores de 5 anos,clasificacion e,2002-03-01,7,3,7,3,10
40602,PAZÑA,estado nutricional en menores de 5 anos,clasificacion e,2002-03-01,1,5,1,5,6
20702,PELECHUCO,estado nutricional en menores de 5 anos,clasificacion e,2002-03-01,4,0,4,0,4
50403,POCOATA,estado nutricional en menores de 5 anos,clasificacion e,2002-03-01,35,45,35,45,80
31203,POCONA,estado nutricional en menores de 5 anos,clasificacion e,2002-03-01,12,24,12,24,36
31202,POJO (CBBA),estado nutricional en menores de 5 anos,clasificacion e,2002-03-01,3,24,3,24,27
40601,POOPO,estado nutricional en menores de 5 anos,clasificacion e,2002-03-01,0,37,0,37,37
51203,PORCO,estado nutricional en menores de 5 anos,clasificacion e,2002-03-01,13,6,13,6,19
10103,POROMA,estado nutricional en menores de 5 anos,clasificacion e,2002-03-01,42,34,42,34,76
70103,PORONGO,estado nutricional en menores de 5 anos,clasificacion e,2002-03-01,3,1,3,1,4
70601,PORTACHUELO,estado nutricional en menores de 5 anos,clasificacion e,2002-03-01,14,6,14,6,20
90102,PORVENIR,estado nutricional en menores de 5 anos,clasificacion e,2002-03-01,0,1,0,1,1
70804,POSTRER VALLE,estado nutricional en menores de 5 anos,clasificacion e,2002-03-01,1,2,1,2,3
50101,POTOSI,estado nutricional en menores de 5 anos,clasificacion e,2002-03-01,55,89,55,89,144
10302,PRESTO,estado nutricional en menores de 5 anos,clasificacion e,2002-03-01,25,25,25,25,50
70805,PUCARA,estado nutricional en menores de 5 anos,clasificacion e,2002-03-01,0,1,0,1,1
21201,PUCARANI,estado nutricional en menores de 5 anos,clasificacion e,2002-03-01,0,15,0,15,15
20401,PUERTO ACOSTA,estado nutricional en menores de 5 anos,clasificacion e,2002-03-01,5,7,5,7,12
20403,PUERTO CARABUCO,estado nutricional en menores de 5 anos,clasificacion e,2002-03-01,7,15,7,15,22
90301,PUERTO GONZALO MORENO,estado nutricional en menores de 5 anos,clasificacion e,2002-03-01,7,1,7,1,8
21204,PUERTO PEREZ,estado nutricional en menores de 5 anos,clasificacion e,2002-03-01,0,3,0,3,3
71402,PUERTO QUIJARRO,estado nutricional en menores de 5 anos,clasificacion e,2002-03-01,16,1,16,1,17
90201,PUERTO RICO,estado nutricional en menores de 5 anos,clasificacion e,2002-03-01,1,3,1,3,4
80703,PUERTO SILES,estado nutricional en menores de 5 anos,clasificacion e,2002-03-01,0,1,0,1,1
71401,PUERTO SUAREZ,estado nutricional en menores de 5 anos,clasificacion e,2002-03-01,19,10,19,10,29
31205,PUERTO VILLARROEL,estado nutricional en menores de 5 anos,clasificacion e,2002-03-01,40,19,40,19,59
51101,PUNA,estado nutricional en menores de 5 anos,clasificacion e,2002-03-01,6,113,6,113,119
31401,PUNATA,estado nutricional en menores de 5 anos,clasificacion e,2002-03-01,8,13,8,13,21
20604,QUIABAYA,estado nutricional en menores de 5 anos,clasificacion e,2002-03-01,0,11,0,11,11
30901,QUILLACOLLO,estado nutricional en menores de 5 anos,clasificacion e,2002-03-01,15,3,15,3,18
21002,QUIME,estado nutricional en menores de 5 anos,clasificacion e,2002-03-01,2,13,2,13,15
50402,RAVELO,estado nutricional en menores de 5 anos,clasificacion e,2002-03-01,57,87,57,87,144
80301,REYES,estado nutricional en menores de 5 anos,clasificacion e,2002-03-01,5,10,5,10,15
80201,RIBERALTA,estado nutricional en menores de 5 anos,clasificacion e,2002-03-01,113,75,113,75,188
70503,ROBORE,estado nutricional en menores de 5 anos,clasificacion e,2002-03-01,0,22,0,22,22
80304,RURRENABAQUE,estado nutricional en menores de 5 anos,clasificacion e,2002-03-01,6,4,6,4,10
31001,SACABA,estado nutricional en menores de 5 anos,clasificacion e,2002-03-01,24,59,24,59,83
30404,SACABAMBA,estado nutricional en menores de 5 anos,clasificacion e,2002-03-01,0,12,0,12,12
50701,SACACA,estado nutricional en menores de 5 anos,clasificacion e,2002-03-01,59,114,59,114,173
71302,SAIPINA,estado nutricional en menores de 5 anos,clasificacion e,2002-03-01,8,6,8,6,14
40801,SALINAS DE GARCI MENDOZA,estado nutricional en menores de 5 anos,clasificacion e,2002-03-01,4,2,4,2,6
70901,SAMAIPATA,estado nutricional en menores de 5 anos,clasificacion e,2002-03-01,0,3,0,3,3
51601,SAN AGUSTIN,estado nutricional en menores de 5 anos,clasificacion e,2002-03-01,0,2,0,2,2
80602,SAN ANDRES,estado nutricional en menores de 5 anos,clasificacion e,2002-03-01,4,3,4,3,7
51003,SAN ANTONIO DE ESMORUCO,estado nutricional en menores de 5 anos,clasificacion e,2002-03-01,0,4,0,4,4
71105,SAN ANTONIO DE LOMERIO,estado nutricional en menores de 5 anos,clasificacion e,2002-03-01,50,58,50,58,108
31403,SAN BENITO,estado nutricional en menores de 5 anos,clasificacion e,2002-03-01,0,7,0,7,7
80302,SAN BORJA,estado nutricional en menores de 5 anos,clasificacion e,2002-03-01,19,20,19,20,39
21502,SAN BUENA VENTURA,estado nutricional en menores de 5 anos,clasificacion e,2002-03-01,20,4,20,4,24
70402,SAN CARLOS,estado nutricional en menores de 5 anos,clasificacion e,2002-03-01,0,11,0,11,11
80501,SAN IGNACIO,estado nutricional en menores de 5 anos,clasificacion e,2002-03-01,14,27,14,27,41
70301,SAN IGNACIO DE VELASCO,estado nutricional en menores de 5 anos,clasificacion e,2002-03-01,51,46,51,46,97
80102,SAN JAVIER(BNI),estado nutricional en menores de 5 anos,clasificacion e,2002-03-01,6,1,6,1,7
71102,SAN JAVIER(STC),estado nutricional en menores de 5 anos,clasificacion e,2002-03-01,0,11,0,11,11
80701,SAN JOAQUIN,estado nutricional en menores de 5 anos,clasificacion e,2002-03-01,0,3,0,3,3
70501,SAN JOSE DE CHIQUITOS,estado nutricional en menores de 5 anos,clasificacion e,2002-03-01,24,5,24,5,29
71104,SAN JULIAN,estado nutricional en menores de 5 anos,clasificacion e,2002-03-01,29,44,29,44,73
60501,SAN LORENZO(TJA),estado nutricional en menores de 5 anos,clasificacion e,2002-03-01,8,6,8,6,14
10702,SAN LUCAS,estado nutricional en menores de 5 anos,clasificacion e,2002-03-01,11,218,11,218,229
71201,SAN MATIAS,estado nutricional en menores de 5 anos,clasificacion e,2002-03-01,29,22,29,22,51
70302,SAN MIGUEL DE VELASCO,estado nutricional en menores de 5 anos,clasificacion e,2002-03-01,26,27,26,27,53
51001,SAN PABLO DE LIPEZ,estado nutricional en menores de 5 anos,clasificacion e,2002-03-01,1,10,1,10,11
50501,SAN PEDRO DE BUENA VISTA,estado nutricional en menores de 5 anos,clasificacion e,2002-03-01,1,85,1,85,86
21801,SAN PEDRO DE CURAHUARA,estado nutricional en menores de 5 anos,clasificacion e,2002-03-01,0,5,0,5,5
70303,SAN RAFAEL,estado nutricional en menores de 5 anos,clasificacion e,2002-03-01,9,8,9,8,17
80702,SAN RAMON,estado nutricional en menores de 5 anos,clasificacion e,2002-03-01,0,7,0,7,7
80702,SAN RAMON,estado nutricional en menores de 5 anos,clasificacion e,2002-03-01,2,0,2,0,2
80401,SANTA ANA,estado nutricional en menores de 5 anos,clasificacion e,2002-03-01,1,7,1,7,8
70101,SANTA CRUZ DE LA SIERRA,estado nutricional en menores de 5 anos,clasificacion e,2002-03-01,55,95,55,95,150
80303,SANTA ROSA,estado nutricional en menores de 5 anos,clasificacion e,2002-03-01,4,1,4,1,5
70602,SANTA ROSA DEL SARA,estado nutricional en menores de 5 anos,clasificacion e,2002-03-01,3,2,3,2,5
20308,SANTIAGO DE CALLAPA,estado nutricional en menores de 5 anos,clasificacion e,2002-03-01,0,2,0,2,2
41401,SANTIAGO DE HUARI,estado nutricional en menores de 5 anos,clasificacion e,2002-03-01,4,10,4,10,14
21901,SANTIAGO DE MACHACA,estado nutricional en menores de 5 anos,clasificacion e,2002-03-01,0,1,0,1,1
30702,SANTIVAÑES,estado nutricional en menores de 5 anos,clasificacion e,2002-03-01,9,12,9,12,21
40202,SANTUARIO DE QUILLACAS,estado nutricional en menores de 5 anos,clasificacion e,2002-03-01,2,5,2,5,7
20902,SAPAHAQUI,estado nutricional en menores de 5 anos,clasificacion e,2002-03-01,0,7,0,7,7
21301,SICA SICA (VILLA AROMA),estado nutricional en menores de 5 anos,clasificacion e,2002-03-01,9,5,9,5,14
30703,SICAYA,estado nutricional en menores de 5 anos,clasificacion e,2002-03-01,0,8,0,8,8
30902,SIPE SIPE,estado nutricional en menores de 5 anos,clasificacion e,2002-03-01,27,27,27,27,54
10403,SOPACHUY,estado nutricional en menores de 5 anos,clasificacion e,2002-03-01,28,26,28,26,54
20601,SORATA,estado nutricional en menores de 5 anos,clasificacion e,2002-03-01,2,4,2,4,6
10101,SUCRE,estado nutricional en menores de 5 anos,clasificacion e,2002-03-01,57,248,57,248,305
31404,TACACHI,estado nutricional en menores de 5 anos,clasificacion e,2002-03-01,1,5,1,5,6
20603,TACACOMA,estado nutricional en menores de 5 anos,clasificacion e,2002-03-01,3,7,3,7,10
50303,TACOBAMBA,estado nutricional en menores de 5 anos,clasificacion e,2002-03-01,14,16,14,16,30
30602,TACOPAYA,estado nutricional en menores de 5 anos,clasificacion e,2002-03-01,0,23,0,23,23
51402,TAHUA,estado nutricional en menores de 5 anos,clasificacion e,2002-03-01,0,2,0,2,2
31101,TAPACARI,estado nutricional en menores de 5 anos,clasificacion e,2002-03-01,1,43,1,43,44
10601,TARABUCO,estado nutricional en menores de 5 anos,clasificacion e,2002-03-01,33,233,33,233,266
30401,TARATA,estado nutricional en menores de 5 anos,clasificacion e,2002-03-01,1,11,1,11,12
60101,TARIJA,estado nutricional en menores de 5 anos,clasificacion e,2002-03-01,15,45,15,45,60
10202,TARVITA,estado nutricional en menores de 5 anos,clasificacion e,2002-03-01,24,13,24,13,37
20803,TIAWANACU,estado nutricional en menores de 5 anos,clasificacion e,2002-03-01,1,2,1,2,3
50102,TINGUIPAYA,estado nutricional en menores de 5 anos,clasificacion e,2002-03-01,2,35,2,35,37
20606,TIPUANI,estado nutricional en menores de 5 anos,clasificacion e,2002-03-01,4,1,4,1,5
30903,TIQUIPAYA,estado nutricional en menores de 5 anos,clasificacion e,2002-03-01,0,13,0,13,13
31601,TIRAQUE (CBBA),estado nutricional en menores de 5 anos,clasificacion e,2002-03-01,12,46,12,46,58
21703,TITO YUPANQUI (PARQUIPUJIO),estado nutricional en menores de 5 anos,clasificacion e,2002-03-01,0,7,0,7,7
30802,TOCO,estado nutricional en menores de 5 anos,clasificacion e,2002-03-01,0,7,0,7,7
41001,TOLEDO,estado nutricional en menores de 5 anos,clasificacion e,2002-03-01,0,2,0,2,2
51202,TOMAVE,estado nutricional en menores de 5 anos,clasificacion e,2002-03-01,0,46,0,46,46
10402,TOMINA,estado nutricional en menores de 5 anos,clasificacion e,2002-03-01,46,46,46,46,92
50502,TORO TORO,estado nutricional en menores de 5 anos,clasificacion e,2002-03-01,3,12,3,12,15
31201,TOTORA(CBBA),estado nutricional en menores de 5 anos,clasificacion e,2002-03-01,29,16,29,16,45
41301,TOTORA(ORR),estado nutricional en menores de 5 anos,clasificacion e,2002-03-01,0,7,0,7,7
70802,TRIGAL,estado nutricional en menores de 5 anos,clasificacion e,2002-03-01,0,2,0,2,2
80101,TRINIDAD,estado nutricional en menores de 5 anos,clasificacion e,2002-03-01,13,56,13,56,69
50801,TUPIZA,estado nutricional en menores de 5 anos,clasificacion e,2002-03-01,7,94,7,94,101
40402,TURCO,estado nutricional en menores de 5 anos,clasificacion e,2002-03-01,2,0,2,0,2
21302,UMALA,estado nutricional en menores de 5 anos,clasificacion e,2002-03-01,0,3,0,3,3
60401,URIONDO (A. CONCEPCION),estado nutricional en menores de 5 anos,clasificacion e,2002-03-01,1,5,1,5,6
71502,URUBICHA,estado nutricional en menores de 5 anos,clasificacion e,2002-03-01,0,8,0,8,8
51201,UYUNI,estado nutricional en menores de 5 anos,clasificacion e,2002-03-01,1,34,1,34,35
30502,VACAS,estado nutricional en menores de 5 anos,clasificacion e,2002-03-01,0,4,0,4,4
70801,VALLEGRANDE,estado nutricional en menores de 5 anos,clasificacion e,2002-03-01,12,3,12,3,15
20801,VIACHA,estado nutricional en menores de 5 anos,clasificacion e,2002-03-01,2,27,2,27,29
31302,VILA VILA,estado nutricional en menores de 5 anos,clasificacion e,2002-03-01,2,9,2,9,11
60303,VILLA MONTES,estado nutricional en menores de 5 anos,clasificacion e,2002-03-01,10,18,10,18,28
31402,VILLA RIVERO,estado nutricional en menores de 5 anos,clasificacion e,2002-03-01,0,4,0,4,4
10801,VILLA SERRANO,estado nutricional en menores de 5 anos,clasificacion e,2002-03-01,31,42,31,42,73
31003,VILLA TUNARI,estado nutricional en menores de 5 anos,clasificacion e,2002-03-01,28,31,28,31,59
11001,VILLA VACA GUZMAN (MUYUPAMPA),estado nutricional en menores de 5 anos,clasificacion e,2002-03-01,21,4,21,4,25
51501,VILLAZON,estado nutricional en menores de 5 anos,clasificacion e,2002-03-01,2,49,2,49,51
30904,VINTO,estado nutricional en menores de 5 anos,clasificacion e,2002-03-01,11,5,11,5,16
50602,VITICHI,estado nutricional en menores de 5 anos,clasificacion e,2002-03-01,8,25,8,25,33
70201,WARNES,estado nutricional en menores de 5 anos,clasificacion e,2002-03-01,22,26,22,26,48
20903,YACO,estado nutricional en menores de 5 anos,clasificacion e,2002-03-01,0,14,0,14,14
60301,YACUIBA,estado nutricional en menores de 5 anos,clasificacion e,2002-03-01,10,18,10,18,28
10602,YAMPARAEZ,estado nutricional en menores de 5 anos,clasificacion e,2002-03-01,42,49,42,49,91
70403,YAPACANI,estado nutricional en menores de 5 anos,clasificacion e,2002-03-01,20,21,20,21,41
50103,YOCALLA,estado nutricional en menores de 5 anos,clasificacion e,2002-03-01,0,12,0,12,12
10102,YOTALA,estado nutricional en menores de 5 anos,clasificacion e,2002-03-01,34,38,34,38,72
60402,YUNCHARA,estado nutricional en menores de 5 anos,clasificacion e,2002-03-01,2,11,2,11,13
10301,ZUDAÑEZ,estado nutricional en menores de 5 anos,clasificacion e,2002-03-01,54,52,54,52,106
51302,ACACIO,estado nutricional en menores de 5 anos,clasificacion e,2002-04-01,9,35,9,35,44
20201,ACHACACHI,estado nutricional en menores de 5 anos,clasificacion e,2002-04-01,26,27,26,27,53
20104,ACHOCALLA,estado nutricional en menores de 5 anos,clasificacion e,2002-04-01,6,1,6,1,7
30201,AIQUILE,estado nutricional en menores de 5 anos,clasificacion e,2002-04-01,6,8,6,8,14
31303,ALALAY,estado nutricional en menores de 5 anos,clasificacion e,2002-04-01,1,1,1,1,2
10404,ALCALA,estado nutricional en menores de 5 anos,clasificacion e,2002-04-01,14,15,14,15,29
20202,ANCORAIMES,estado nutricional en menores de 5 anos,clasificacion e,2002-04-01,19,17,19,17,36
41201,ANDAMARCA,estado nutricional en menores de 5 anos,clasificacion e,2002-04-01,1,0,1,0,1
30402,ANZALDO,estado nutricional en menores de 5 anos,clasificacion e,2002-04-01,1,41,1,41,42
20701,APOLO,estado nutricional en menores de 5 anos,clasificacion e,2002-04-01,9,5,9,5,14
51301,ARAMPAMPA,estado nutricional en menores de 5 anos,clasificacion e,2002-04-01,12,32,12,32,44
30501,ARANI,estado nutricional en menores de 5 anos,clasificacion e,2002-04-01,6,10,6,10,16
30403,ARBIETO,estado nutricional en menores de 5 anos,clasificacion e,2002-04-01,1,16,1,16,17
30601,ARQUE,estado nutricional en menores de 5 anos,clasificacion e,2002-04-01,4,9,4,9,13
71501,ASCENCION DE GUARAYOS,estado nutricional en menores de 5 anos,clasificacion e,2002-04-01,44,48,44,48,92
50802,ATOCHA,estado nutricional en menores de 5 anos,clasificacion e,2002-04-01,0,14,0,14,14
20503,AUCAPATA,estado nutricional en menores de 5 anos,clasificacion e,2002-04-01,6,0,6,0,6
20502,AYATA,estado nutricional en menores de 5 anos,clasificacion e,2002-04-01,11,12,11,12,23
21303,AYO AYO,estado nutricional en menores de 5 anos,clasificacion e,2002-04-01,4,0,4,0,4
30301,AYOPAYA (V. DE INDEPENDENCIA),estado nutricional en menores de 5 anos,clasificacion e,2002-04-01,35,13,35,13,48
10201,AZURDUY,estado nutricional en menores de 5 anos,clasificacion e,2002-04-01,46,36,46,36,82
21203,BATALLAS,estado nutricional en menores de 5 anos,clasificacion e,2002-04-01,1,4,1,4,5
80802,BAURES,estado nutricional en menores de 5 anos,clasificacion e,2002-04-01,4,5,4,5,9
41202,BELEN DE ANDAMARCA,estado nutricional en menores de 5 anos,clasificacion e,2002-04-01,0,2,0,2,2
50104,BELEN DE URMIRI,estado nutricional en menores de 5 anos,clasificacion e,2002-04-01,0,2,0,2,2
60202,BERMEJO,estado nutricional en menores de 5 anos,clasificacion e,2002-04-01,5,2,5,2,7
50301,BETANZOS,estado nutricional en menores de 5 anos,clasificacion e,2002-04-01,46,98,46,98,144
31501,BOLIVAR,estado nutricional en menores de 5 anos,clasificacion e,2002-04-01,16,25,16,25,41
90103,BOLPEBRA,estado nutricional en menores de 5 anos,clasificacion e,2002-04-01,1,0,1,0,1
70707,BOYUIBE,estado nutricional en menores de 5 anos,clasificacion e,2002-04-01,0,1,0,1,1
70401,BUENA VISTA,estado nutricional en menores de 5 anos,clasificacion e,2002-04-01,9,8,9,8,17
70703,CABEZAS,estado nutricional en menores de 5 anos,clasificacion e,2002-04-01,0,6,0,6,6
20905,CAIROMA,estado nutricional en menores de 5 anos,clasificacion e,2002-04-01,0,6,0,6,6
51102,"CAIZA ""D""",estado nutricional en menores de 5 anos,clasificacion e,2002-04-01,15,22,15,22,37
21003,CAJUATA,estado nutricional en menores de 5 anos,clasificacion e,2002-04-01,6,3,6,3,9
20303,CALACOTO,estado nutricional en menores de 5 anos,clasificacion e,2002-04-01,0,1,0,1,1
21304,CALAMARCA,estado nutricional en menores de 5 anos,clasificacion e,2002-04-01,3,3,3,3,6
10701,CAMARGO,estado nutricional en menores de 5 anos,clasificacion e,2002-04-01,0,23,0,23,23
10901,CAMATAQUI (C. VILLA ABECIA),estado nutricional en menores de 5 anos,clasificacion e,2002-04-01,0,16,0,16,16
70706,CAMIRI,estado nutricional en menores de 5 anos,clasificacion e,2002-04-01,39,42,39,42,81
30701,CAPINOTA,estado nutricional en menores de 5 anos,clasificacion e,2002-04-01,11,10,11,10,21
20302,CAQUIAVIRI,estado nutricional en menores de 5 anos,clasificacion e,2002-04-01,4,16,4,16,20
40102,CARACOLLO,estado nutricional en menores de 5 anos,clasificacion e,2002-04-01,3,12,3,12,15
22001,CARANAVI,estado nutricional en menores de 5 anos,clasificacion e,2002-04-01,28,52,28,52,80
60302,CARAPARI,estado nutricional en menores de 5 anos,clasificacion e,2002-04-01,13,9,13,9,22
50702,CARIPUYO,estado nutricional en menores de 5 anos,clasificacion e,2002-04-01,0,41,0,41,41
21902,CATACORA,estado nutricional en menores de 5 anos,clasificacion e,2002-04-01,3,2,3,2,5
40201,CHALLAPATA,estado nutricional en menores de 5 anos,clasificacion e,2002-04-01,17,23,17,23,40
50302,CHAQUI,estado nutricional en menores de 5 anos,clasificacion e,2002-04-01,0,28,0,28,28
70702,CHARAGUA,estado nutricional en menores de 5 anos,clasificacion e,2002-04-01,4,67,4,67,71
20305,CHARAÑA,estado nutricional en menores de 5 anos,clasificacion e,2002-04-01,0,10,0,10,10
31204,CHIMORE,estado nutricional en menores de 5 anos,clasificacion e,2002-04-01,8,8,8,8,16
40302,CHOQUE COTA,estado nutricional en menores de 5 anos,clasificacion e,2002-04-01,0,2,0,2,2
21101,CHULUMANI (V. DE LA LIBERTAD),estado nutricional en menores de 5 anos,clasificacion e,2002-04-01,3,2,3,2,5
20501,CHUMA,estado nutricional en menores de 5 anos,clasificacion e,2002-04-01,2,4,2,4,6
30801,CLIZA,estado nutricional en menores de 5 anos,clasificacion e,2002-04-01,5,8,5,8,13
90101,COBIJA,estado nutricional en menores de 5 anos,clasificacion e,2002-04-01,34,24,34,24,58
30101,COCHABAMBA,estado nutricional en menores de 5 anos,clasificacion e,2002-04-01,67,89,67,89,156
30905,COLCAPIRHUA,estado nutricional en menores de 5 anos,clasificacion e,2002-04-01,12,7,12,7,19
50901,"COLCHA ""K""",estado nutricional en menores de 5 anos,clasificacion e,2002-04-01,0,8,0,8,8
31002,COLOMI,estado nutricional en menores de 5 anos,clasificacion e,2002-04-01,14,25,14,25,39
50401,COLQUECHACA,estado nutricional en menores de 5 anos,clasificacion e,2002-04-01,34,36,34,36,70
21306,COLQUENCHA,estado nutricional en menores de 5 anos,clasificacion e,2002-04-01,0,1,0,1,1
21004,COLQUIRI,estado nutricional en menores de 5 anos,clasificacion e,2002-04-01,23,8,23,8,31
20304,COMANCHE,estado nutricional en menores de 5 anos,clasificacion e,2002-04-01,5,3,5,3,8
71301,COMARAPA,estado nutricional en menores de 5 anos,clasificacion e,2002-04-01,2,10,2,10,12
20605,COMBAYA,estado nutricional en menores de 5 anos,clasificacion e,2002-04-01,2,6,2,6,8
71101,CONCEPCION,estado nutricional en menores de 5 anos,clasificacion e,2002-04-01,2,0,2,0,2
21701,COPACABANA,estado nutricional en menores de 5 anos,clasificacion e,2002-04-01,1,3,1,3,4
21402,CORIPATA,estado nutricional en menores de 5 anos,clasificacion e,2002-04-01,1,5,1,5,6
20301,CORO CORO,estado nutricional en menores de 5 anos,clasificacion e,2002-04-01,8,16,8,16,24
21401,COROICO,estado nutricional en menores de 5 anos,clasificacion e,2002-04-01,2,3,2,3,5
40301,CORQUE,estado nutricional en menores de 5 anos,clasificacion e,2002-04-01,1,2,1,2,3
50601,COTAGAITA,estado nutricional en menores de 5 anos,clasificacion e,2002-04-01,6,41,6,41,47
70102,COTOCA,estado nutricional en menores de 5 anos,clasificacion e,2002-04-01,12,5,12,5,17
31405,CUCHUMUELA (V. G. VILLARROEL),estado nutricional en menores de 5 anos,clasificacion e,2002-04-01,0,5,0,5,5
70704,CUEVO,estado nutricional en menores de 5 anos,clasificacion e,2002-04-01,6,2,6,2,8
10902,CULPINA,estado nutricional en menores de 5 anos,clasificacion e,2002-04-01,29,31,29,31,60
40401,CURAHUARA DE CARANGAS,estado nutricional en menores de 5 anos,clasificacion e,2002-04-01,5,3,5,3,8
20804,DESAGUADERO,estado nutricional en menores de 5 anos,clasificacion e,2002-04-01,0,4,0,4,4
20105,EL ALTO,estado nutricional en menores de 5 anos,clasificacion e,2002-04-01,344,330,344,330,674
40103,EL CHORO,estado nutricional en menores de 5 anos,clasificacion e,2002-04-01,1,0,1,0,1
71503,EL PUENTE(STC),estado nutricional en menores de 5 anos,clasificacion e,2002-04-01,6,34,6,34,40
60502,EL PUENTE(TJA),estado nutricional en menores de 5 anos,clasificacion e,2002-04-01,3,3,3,3,6
70105,EL TORNO,estado nutricional en menores de 5 anos,clasificacion e,2002-04-01,13,7,13,7,20
10405,EL VILLAR,estado nutricional en menores de 5 anos,clasificacion e,2002-04-01,20,37,20,37,57
60601,ENTRE RIOS,estado nutricional en menores de 5 anos,clasificacion e,2002-04-01,3,10,3,10,13
41101,EUCALIPTUS,estado nutricional en menores de 5 anos,clasificacion e,2002-04-01,0,5,0,5,5
80402,EXALTACION,estado nutricional en menores de 5 anos,clasificacion e,2002-04-01,3,6,3,6,9
90203,FILADELFIA,estado nutricional en menores de 5 anos,clasificacion e,2002-04-01,0,12,0,12,12
21601,GRAL. J.J. PEREZ (CHARAZANI),estado nutricional en menores de 5 anos,clasificacion e,2002-04-01,1,3,1,3,4
20602,GUANAY,estado nutricional en menores de 5 anos,clasificacion e,2002-04-01,5,29,5,29,34
20802,GUAQUI,estado nutricional en menores de 5 anos,clasificacion e,2002-04-01,0,3,0,3,3
80202,GUAYARAMERIN,estado nutricional en menores de 5 anos,clasificacion e,2002-04-01,24,18,24,18,42
70705,GUTIERREZ,estado nutricional en menores de 5 anos,clasificacion e,2002-04-01,9,58,9,58,67
10502,HUACARETA,estado nutricional en menores de 5 anos,clasificacion e,2002-04-01,22,18,22,18,40
11002,HUACAYA (VILLA DE HUACAYA),estado nutricional en menores de 5 anos,clasificacion e,2002-04-01,3,3,3,3,6
40501,HUACHACALLA,estado nutricional en menores de 5 anos,clasificacion e,2002-04-01,0,1,0,1,1
40701,HUANUNI,estado nutricional en menores de 5 anos,clasificacion e,2002-04-01,0,1,0,1,1
80803,HUARACAJE,estado nutricional en menores de 5 anos,clasificacion e,2002-04-01,3,0,3,0,3
41601,HUAYLLAMARCA,estado nutricional en menores de 5 anos,clasificacion e,2002-04-01,1,0,1,0,1
21005,ICHOCA,estado nutricional en menores de 5 anos,clasificacion e,2002-04-01,5,4,5,4,9
10304,ICLA,estado nutricional en menores de 5 anos,clasificacion e,2002-04-01,62,61,62,61,123
10703,INCAHUASI,estado nutricional en menores de 5 anos,clasificacion e,2002-04-01,5,75,5,75,80
21001,INQUISIVI,estado nutricional en menores de 5 anos,clasificacion e,2002-04-01,3,14,3,14,17
21102,IRUPANA (VILLA DE LANZA),estado nutricional en menores de 5 anos,clasificacion e,2002-04-01,0,7,0,7,7
21501,IXIAMAS,estado nutricional en menores de 5 anos,clasificacion e,2002-04-01,6,8,6,8,14
21105,LA ASUNTA,estado nutricional en menores de 5 anos,clasificacion e,2002-04-01,14,16,14,16,30
70104,LA GUARDIA,estado nutricional en menores de 5 anos,clasificacion e,2002-04-01,16,9,16,9,25
20101,LA PAZ,estado nutricional en menores de 5 anos,clasificacion e,2002-04-01,211,195,211,195,406
70701,LAGUNILLAS,estado nutricional en menores de 5 anos,clasificacion e,2002-04-01,11,13,11,13,24
21202,LAJA,estado nutricional en menores de 5 anos,clasificacion e,2002-04-01,0,8,0,8,8
10903,LAS CARRERAS,estado nutricional en menores de 5 anos,clasificacion e,2002-04-01,3,3,3,3,6
51401,LLICA,estado nutricional en menores de 5 anos,clasificacion e,2002-04-01,0,2,0,2,2
20901,LURIBAY,estado nutricional en menores de 5 anos,clasificacion e,2002-04-01,7,5,7,5,12
40702,MACHACAMARCA,estado nutricional en menores de 5 anos,clasificacion e,2002-04-01,2,2,2,2,4
11003,MACHARETI,estado nutricional en menores de 5 anos,clasificacion e,2002-04-01,11,26,11,26,37
80801,MAGDALENA,estado nutricional en menores de 5 anos,clasificacion e,2002-04-01,6,2,6,2,8
70903,MAIRANA,estado nutricional en menores de 5 anos,clasificacion e,2002-04-01,3,3,3,3,6
20904,MALLA,estado nutricional en menores de 5 anos,clasificacion e,2002-04-01,0,2,0,2,2
20103,MECAPACA,estado nutricional en menores de 5 anos,clasificacion e,2002-04-01,0,2,0,2,2
71003,MINEROS,estado nutricional en menores de 5 anos,clasificacion e,2002-04-01,13,0,13,0,13
31301,MIZQUE,estado nutricional en menores de 5 anos,clasificacion e,2002-04-01,5,7,5,7,12
20402,MOCOMOCO,estado nutricional en menores de 5 anos,clasificacion e,2002-04-01,6,4,6,4,10
51002,MOJINETE,estado nutricional en menores de 5 anos,clasificacion e,2002-04-01,0,1,0,1,1
10303,MOJOCOYA,estado nutricional en menores de 5 anos,clasificacion e,2002-04-01,30,20,30,20,50
10501,MONTEAGUDO,estado nutricional en menores de 5 anos,clasificacion e,2002-04-01,19,42,19,42,61
71001,MONTERO,estado nutricional en menores de 5 anos,clasificacion e,2002-04-01,0,5,0,5,5
70803,MORO MORO,estado nutricional en menores de 5 anos,clasificacion e,2002-04-01,3,6,3,6,9
30302,MOROCHATA,estado nutricional en menores de 5 anos,clasificacion e,2002-04-01,12,14,12,14,26
90401,NACEBE (SANTA ROSA DEL ABUNA),estado nutricional en menores de 5 anos,clasificacion e,2002-04-01,0,3,0,3,3
50404,OCURI,estado nutricional en menores de 5 anos,clasificacion e,2002-04-01,20,20,20,20,40
70202,OKINAWA,estado nutricional en menores de 5 anos,clasificacion e,2002-04-01,2,7,2,7,9
30203,OMEREQUE,estado nutricional en menores de 5 anos,clasificacion e,2002-04-01,0,6,0,6,6
40101,ORURO,estado nutricional en menores de 5 anos,clasificacion e,2002-04-01,87,68,87,68,155
60201,PADCAYA,estado nutricional en menores de 5 anos,clasificacion e,2002-04-01,3,15,3,15,18
10401,PADILLA,estado nutricional en menores de 5 anos,clasificacion e,2002-04-01,43,63,43,63,106
70502,PAILON,estado nutricional en menores de 5 anos,clasificacion e,2002-04-01,0,26,0,26,26
20102,PALCA,estado nutricional en menores de 5 anos,clasificacion e,2002-04-01,13,19,13,19,32
21104,PALOS BLANCOS,estado nutricional en menores de 5 anos,clasificacion e,2002-04-01,20,34,20,34,54
40802,PAMPA AULLAGAS,estado nutricional en menores de 5 anos,clasificacion e,2002-04-01,0,11,0,11,11
70902,PAMPA GRANDE,estado nutricional en menores de 5 anos,clasificacion e,2002-04-01,3,6,3,6,9
21802,PAPEL PAMPA,estado nutricional en menores de 5 anos,clasificacion e,2002-04-01,0,1,0,1,1
30202,PASORAPA,estado nutricional en menores de 5 anos,clasificacion e,2002-04-01,3,7,3,7,10
21305,PATACAMAYA,estado nutricional en menores de 5 anos,clasificacion e,2002-04-01,4,3,4,3,7
40602,PAZÑA,estado nutricional en menores de 5 anos,clasificacion e,2002-04-01,0,1,0,1,1
20702,PELECHUCO,estado nutricional en menores de 5 anos,clasificacion e,2002-04-01,5,5,5,5,10
50403,POCOATA,estado nutricional en menores de 5 anos,clasificacion e,2002-04-01,29,40,29,40,69
31203,POCONA,estado nutricional en menores de 5 anos,clasificacion e,2002-04-01,14,18,14,18,32
31202,POJO (CBBA),estado nutricional en menores de 5 anos,clasificacion e,2002-04-01,27,18,27,18,45
40601,POOPO,estado nutricional en menores de 5 anos,clasificacion e,2002-04-01,0,10,0,10,10
51203,PORCO,estado nutricional en menores de 5 anos,clasificacion e,2002-04-01,5,4,5,4,9
10103,POROMA,estado nutricional en menores de 5 anos,clasificacion e,2002-04-01,23,25,23,25,48
70103,PORONGO,estado nutricional en menores de 5 anos,clasificacion e,2002-04-01,2,2,2,2,4
70601,PORTACHUELO,estado nutricional en menores de 5 anos,clasificacion e,2002-04-01,14,14,14,14,28
90102,PORVENIR,estado nutricional en menores de 5 anos,clasificacion e,2002-04-01,1,0,1,0,1
50101,POTOSI,estado nutricional en menores de 5 anos,clasificacion e,2002-04-01,110,94,110,94,204
10302,PRESTO,estado nutricional en menores de 5 anos,clasificacion e,2002-04-01,40,24,40,24,64
70805,PUCARA,estado nutricional en menores de 5 anos,clasificacion e,2002-04-01,0,6,0,6,6
21201,PUCARANI,estado nutricional en menores de 5 anos,clasificacion e,2002-04-01,0,13,0,13,13
20401,PUERTO ACOSTA,estado nutricional en menores de 5 anos,clasificacion e,2002-04-01,21,9,21,9,30
20403,PUERTO CARABUCO,estado nutricional en menores de 5 anos,clasificacion e,2002-04-01,12,11,12,11,23
90301,PUERTO GONZALO MORENO,estado nutricional en menores de 5 anos,clasificacion e,2002-04-01,3,0,3,0,3
21204,PUERTO PEREZ,estado nutricional en menores de 5 anos,clasificacion e,2002-04-01,0,2,0,2,2
71402,PUERTO QUIJARRO,estado nutricional en menores de 5 anos,clasificacion e,2002-04-01,14,10,14,10,24
90201,PUERTO RICO,estado nutricional en menores de 5 anos,clasificacion e,2002-04-01,0,2,0,2,2
80703,PUERTO SILES,estado nutricional en menores de 5 anos,clasificacion e,2002-04-01,0,2,0,2,2
71401,PUERTO SUAREZ,estado nutricional en menores de 5 anos,clasificacion e,2002-04-01,7,3,7,3,10
31205,PUERTO VILLARROEL,estado nutricional en menores de 5 anos,clasificacion e,2002-04-01,44,25,44,25,69
51101,PUNA,estado nutricional en menores de 5 anos,clasificacion e,2002-04-01,16,69,16,69,85
31401,PUNATA,estado nutricional en menores de 5 anos,clasificacion e,2002-04-01,16,73,16,73,89
20604,QUIABAYA,estado nutricional en menores de 5 anos,clasificacion e,2002-04-01,7,5,7,5,12
30901,QUILLACOLLO,estado nutricional en menores de 5 anos,clasificacion e,2002-04-01,13,9,13,9,22
21002,QUIME,estado nutricional en menores de 5 anos,clasificacion e,2002-04-01,4,15,4,15,19
50402,RAVELO,estado nutricional en menores de 5 anos,clasificacion e,2002-04-01,21,60,21,60,81
80301,REYES,estado nutricional en menores de 5 anos,clasificacion e,2002-04-01,4,8,4,8,12
80201,RIBERALTA,estado nutricional en menores de 5 anos,clasificacion e,2002-04-01,149,102,149,102,251
70503,ROBORE,estado nutricional en menores de 5 anos,clasificacion e,2002-04-01,0,20,0,20,20
80304,RURRENABAQUE,estado nutricional en menores de 5 anos,clasificacion e,2002-04-01,7,7,7,7,14
40901,SABAYA,estado nutricional en menores de 5 anos,clasificacion e,2002-04-01,0,1,0,1,1
31001,SACABA,estado nutricional en menores de 5 anos,clasificacion e,2002-04-01,8,31,8,31,39
30404,SACABAMBA,estado nutricional en menores de 5 anos,clasificacion e,2002-04-01,0,9,0,9,9
50701,SACACA,estado nutricional en menores de 5 anos,clasificacion e,2002-04-01,46,63,46,63,109
71302,SAIPINA,estado nutricional en menores de 5 anos,clasificacion e,2002-04-01,5,4,5,4,9
40801,SALINAS DE GARCI MENDOZA,estado nutricional en menores de 5 anos,clasificacion e,2002-04-01,5,4,5,4,9
70901,SAMAIPATA,estado nutricional en menores de 5 anos,clasificacion e,2002-04-01,1,1,1,1,2
51601,SAN AGUSTIN,estado nutricional en menores de 5 anos,clasificacion e,2002-04-01,0,3,0,3,3
80602,SAN ANDRES,estado nutricional en menores de 5 anos,clasificacion e,2002-04-01,3,5,3,5,8
51003,SAN ANTONIO DE ESMORUCO,estado nutricional en menores de 5 anos,clasificacion e,2002-04-01,0,1,0,1,1
71105,SAN ANTONIO DE LOMERIO,estado nutricional en menores de 5 anos,clasificacion e,2002-04-01,45,37,45,37,82
31403,SAN BENITO,estado nutricional en menores de 5 anos,clasificacion e,2002-04-01,0,6,0,6,6
80302,SAN BORJA,estado nutricional en menores de 5 anos,clasificacion e,2002-04-01,30,31,30,31,61
21502,SAN BUENA VENTURA,estado nutricional en menores de 5 anos,clasificacion e,2002-04-01,13,24,13,24,37
70402,SAN CARLOS,estado nutricional en menores de 5 anos,clasificacion e,2002-04-01,0,6,0,6,6
80501,SAN IGNACIO,estado nutricional en menores de 5 anos,clasificacion e,2002-04-01,12,35,12,35,47
70301,SAN IGNACIO DE VELASCO,estado nutricional en menores de 5 anos,clasificacion e,2002-04-01,74,45,74,45,119
80102,SAN JAVIER(BNI),estado nutricional en menores de 5 anos,clasificacion e,2002-04-01,4,5,4,5,9
71102,SAN JAVIER(STC),estado nutricional en menores de 5 anos,clasificacion e,2002-04-01,13,3,13,3,16
80701,SAN JOAQUIN,estado nutricional en menores de 5 anos,clasificacion e,2002-04-01,0,9,0,9,9
70501,SAN JOSE DE CHIQUITOS,estado nutricional en menores de 5 anos,clasificacion e,2002-04-01,21,9,21,9,30
71104,SAN JULIAN,estado nutricional en menores de 5 anos,clasificacion e,2002-04-01,30,84,30,84,114
60501,SAN LORENZO(TJA),estado nutricional en menores de 5 anos,clasificacion e,2002-04-01,4,5,4,5,9
10702,SAN LUCAS,estado nutricional en menores de 5 anos,clasificacion e,2002-04-01,111,111,111,111,222
71201,SAN MATIAS,estado nutricional en menores de 5 anos,clasificacion e,2002-04-01,26,17,26,17,43
70302,SAN MIGUEL DE VELASCO,estado nutricional en menores de 5 anos,clasificacion e,2002-04-01,38,26,38,26,64
51001,SAN PABLO DE LIPEZ,estado nutricional en menores de 5 anos,clasificacion e,2002-04-01,0,3,0,3,3
50501,SAN PEDRO DE BUENA VISTA,estado nutricional en menores de 5 anos,clasificacion e,2002-04-01,0,68,0,68,68
50902,SAN PEDRO DE QUEMES,estado nutricional en menores de 5 anos,clasificacion e,2002-04-01,0,4,0,4,4
90202,SAN PEDRO(PND),estado nutricional en menores de 5 anos,clasificacion e,2002-04-01,0,1,0,1,1
70303,SAN RAFAEL,estado nutricional en menores de 5 anos,clasificacion e,2002-04-01,8,3,8,3,11
80702,SAN RAMON,estado nutricional en menores de 5 anos,clasificacion e,2002-04-01,2,0,2,0,2
80702,SAN RAMON,estado nutricional en menores de 5 anos,clasificacion e,2002-04-01,3,1,3,1,4
80401,SANTA ANA,estado nutricional en menores de 5 anos,clasificacion e,2002-04-01,2,2,2,2,4
70101,SANTA CRUZ DE LA SIERRA,estado nutricional en menores de 5 anos,clasificacion e,2002-04-01,65,77,65,77,142
80303,SANTA ROSA,estado nutricional en menores de 5 anos,clasificacion e,2002-04-01,3,0,3,0,3
70602,SANTA ROSA DEL SARA,estado nutricional en menores de 5 anos,clasificacion e,2002-04-01,2,4,2,4,6
20308,SANTIAGO DE CALLAPA,estado nutricional en menores de 5 anos,clasificacion e,2002-04-01,1,4,1,4,5
41401,SANTIAGO DE HUARI,estado nutricional en menores de 5 anos,clasificacion e,2002-04-01,4,6,4,6,10
21901,SANTIAGO DE MACHACA,estado nutricional en menores de 5 anos,clasificacion e,2002-04-01,0,2,0,2,2
30702,SANTIVAÑES,estado nutricional en menores de 5 anos,clasificacion e,2002-04-01,14,8,14,8,22
40202,SANTUARIO DE QUILLACAS,estado nutricional en menores de 5 anos,clasificacion e,2002-04-01,0,1,0,1,1
20902,SAPAHAQUI,estado nutricional en menores de 5 anos,clasificacion e,2002-04-01,0,3,0,3,3
21301,SICA SICA (VILLA AROMA),estado nutricional en menores de 5 anos,clasificacion e,2002-04-01,4,1,4,1,5
30703,SICAYA,estado nutricional en menores de 5 anos,clasificacion e,2002-04-01,0,5,0,5,5
30902,SIPE SIPE,estado nutricional en menores de 5 anos,clasificacion e,2002-04-01,44,41,44,41,85
10403,SOPACHUY,estado nutricional en menores de 5 anos,clasificacion e,2002-04-01,39,27,39,27,66
20601,SORATA,estado nutricional en menores de 5 anos,clasificacion e,2002-04-01,0,3,0,3,3
10101,SUCRE,estado nutricional en menores de 5 anos,clasificacion e,2002-04-01,108,158,108,158,266
31404,TACACHI,estado nutricional en menores de 5 anos,clasificacion e,2002-04-01,0,1,0,1,1
20603,TACACOMA,estado nutricional en menores de 5 anos,clasificacion e,2002-04-01,1,1,1,1,2
50303,TACOBAMBA,estado nutricional en menores de 5 anos,clasificacion e,2002-04-01,32,11,32,11,43
30602,TACOPAYA,estado nutricional en menores de 5 anos,clasificacion e,2002-04-01,12,19,12,19,31
51402,TAHUA,estado nutricional en menores de 5 anos,clasificacion e,2002-04-01,0,1,0,1,1
31101,TAPACARI,estado nutricional en menores de 5 anos,clasificacion e,2002-04-01,1,34,1,34,35
10601,TARABUCO,estado nutricional en menores de 5 anos,clasificacion e,2002-04-01,71,204,71,204,275
30401,TARATA,estado nutricional en menores de 5 anos,clasificacion e,2002-04-01,1,14,1,14,15
60101,TARIJA,estado nutricional en menores de 5 anos,clasificacion e,2002-04-01,31,47,31,47,78
10202,TARVITA,estado nutricional en menores de 5 anos,clasificacion e,2002-04-01,33,21,33,21,54
20803,TIAWANACU,estado nutricional en menores de 5 anos,clasificacion e,2002-04-01,3,4,3,4,7
50102,TINGUIPAYA,estado nutricional en menores de 5 anos,clasificacion e,2002-04-01,0,46,0,46,46
20606,TIPUANI,estado nutricional en menores de 5 anos,clasificacion e,2002-04-01,3,3,3,3,6
30903,TIQUIPAYA,estado nutricional en menores de 5 anos,clasificacion e,2002-04-01,0,13,0,13,13
31601,TIRAQUE (CBBA),estado nutricional en menores de 5 anos,clasificacion e,2002-04-01,25,100,25,100,125
21703,TITO YUPANQUI (PARQUIPUJIO),estado nutricional en menores de 5 anos,clasificacion e,2002-04-01,0,3,0,3,3
41001,TOLEDO,estado nutricional en menores de 5 anos,clasificacion e,2002-04-01,0,1,0,1,1
51202,TOMAVE,estado nutricional en menores de 5 anos,clasificacion e,2002-04-01,0,38,0,38,38
10402,TOMINA,estado nutricional en menores de 5 anos,clasificacion e,2002-04-01,63,53,63,53,116
50502,TORO TORO,estado nutricional en menores de 5 anos,clasificacion e,2002-04-01,0,11,0,11,11
31201,TOTORA(CBBA),estado nutricional en menores de 5 anos,clasificacion e,2002-04-01,7,38,7,38,45
41301,TOTORA(ORR),estado nutricional en menores de 5 anos,clasificacion e,2002-04-01,0,5,0,5,5
70802,TRIGAL,estado nutricional en menores de 5 anos,clasificacion e,2002-04-01,0,2,0,2,2
80101,TRINIDAD,estado nutricional en menores de 5 anos,clasificacion e,2002-04-01,38,57,38,57,95
50801,TUPIZA,estado nutricional en menores de 5 anos,clasificacion e,2002-04-01,1,73,1,73,74
40402,TURCO,estado nutricional en menores de 5 anos,clasificacion e,2002-04-01,1,1,1,1,2
21302,UMALA,estado nutricional en menores de 5 anos,clasificacion e,2002-04-01,1,1,1,1,2
60401,URIONDO (A. CONCEPCION),estado nutricional en menores de 5 anos,clasificacion e,2002-04-01,6,10,6,10,16
71502,URUBICHA,estado nutricional en menores de 5 anos,clasificacion e,2002-04-01,23,64,23,64,87
51201,UYUNI,estado nutricional en menores de 5 anos,clasificacion e,2002-04-01,0,40,0,40,40
30502,VACAS,estado nutricional en menores de 5 anos,clasificacion e,2002-04-01,5,11,5,11,16
70801,VALLEGRANDE,estado nutricional en menores de 5 anos,clasificacion e,2002-04-01,10,10,10,10,20
20801,VIACHA,estado nutricional en menores de 5 anos,clasificacion e,2002-04-01,4,22,4,22,26
31302,VILA VILA,estado nutricional en menores de 5 anos,clasificacion e,2002-04-01,4,12,4,12,16
60303,VILLA MONTES,estado nutricional en menores de 5 anos,clasificacion e,2002-04-01,11,17,11,17,28
90502,VILLA NUEVA (LOMA ALTA),estado nutricional en menores de 5 anos,clasificacion e,2002-04-01,0,1,0,1,1
31402,VILLA RIVERO,estado nutricional en menores de 5 anos,clasificacion e,2002-04-01,0,24,0,24,24
10801,VILLA SERRANO,estado nutricional en menores de 5 anos,clasificacion e,2002-04-01,44,78,44,78,122
31003,VILLA TUNARI,estado nutricional en menores de 5 anos,clasificacion e,2002-04-01,51,29,51,29,80
11001,VILLA VACA GUZMAN (MUYUPAMPA),estado nutricional en menores de 5 anos,clasificacion e,2002-04-01,12,15,12,15,27
51501,VILLAZON,estado nutricional en menores de 5 anos,clasificacion e,2002-04-01,1,51,1,51,52
30904,VINTO,estado nutricional en menores de 5 anos,clasificacion e,2002-04-01,13,16,13,16,29
50602,VITICHI,estado nutricional en menores de 5 anos,clasificacion e,2002-04-01,14,30,14,30,44
20306,WALDO BALLIVIAN,estado nutricional en menores de 5 anos,clasificacion e,2002-04-01,3,0,3,0,3
70201,WARNES,estado nutricional en menores de 5 anos,clasificacion e,2002-04-01,24,22,24,22,46
20903,YACO,estado nutricional en menores de 5 anos,clasificacion e,2002-04-01,0,10,0,10,10
60301,YACUIBA,estado nutricional en menores de 5 anos,clasificacion e,2002-04-01,18,21,18,21,39
10602,YAMPARAEZ,estado nutricional en menores de 5 anos,clasificacion e,2002-04-01,72,46,72,46,118
21103,YANACACHI,estado nutricional en menores de 5 anos,clasificacion e,2002-04-01,1,3,1,3,4
70403,YAPACANI,estado nutricional en menores de 5 anos,clasificacion e,2002-04-01,25,44,25,44,69
50103,YOCALLA,estado nutricional en menores de 5 anos,clasificacion e,2002-04-01,0,14,0,14,14
10102,YOTALA,estado nutricional en menores de 5 anos,clasificacion e,2002-04-01,25,33,25,33,58
60402,YUNCHARA,estado nutricional en menores de 5 anos,clasificacion e,2002-04-01,0,14,0,14,14
10301,ZUDAÑEZ,estado nutricional en menores de 5 anos,clasificacion e,2002-04-01,43,29,43,29,72
51302,ACACIO,estado nutricional en menores de 5 anos,clasificacion e,2002-05-01,13,34,13,34,47
20201,ACHACACHI,estado nutricional en menores de 5 anos,clasificacion e,2002-05-01,16,16,16,16,32
20104,ACHOCALLA,estado nutricional en menores de 5 anos,clasificacion e,2002-05-01,3,0,3,0,3
30201,AIQUILE,estado nutricional en menores de 5 anos,clasificacion e,2002-05-01,8,2,8,2,10
31303,ALALAY,estado nutricional en menores de 5 anos,clasificacion e,2002-05-01,3,1,3,1,4
10404,ALCALA,estado nutricional en menores de 5 anos,clasificacion e,2002-05-01,18,8,18,8,26
20202,ANCORAIMES,estado nutricional en menores de 5 anos,clasificacion e,2002-05-01,21,21,21,21,42
30402,ANZALDO,estado nutricional en menores de 5 anos,clasificacion e,2002-05-01,0,18,0,18,18
20701,APOLO,estado nutricional en menores de 5 anos,clasificacion e,2002-05-01,19,7,19,7,26
51301,ARAMPAMPA,estado nutricional en menores de 5 anos,clasificacion e,2002-05-01,24,19,24,19,43
30501,ARANI,estado nutricional en menores de 5 anos,clasificacion e,2002-05-01,4,4,4,4,8
30403,ARBIETO,estado nutricional en menores de 5 anos,clasificacion e,2002-05-01,0,15,0,15,15
30601,ARQUE,estado nutricional en menores de 5 anos,clasificacion e,2002-05-01,21,13,21,13,34
71501,ASCENCION DE GUARAYOS,estado nutricional en menores de 5 anos,clasificacion e,2002-05-01,0,1,0,1,1
50802,ATOCHA,estado nutricional en menores de 5 anos,clasificacion e,2002-05-01,3,27,3,27,30
20502,AYATA,estado nutricional en menores de 5 anos,clasificacion e,2002-05-01,12,14,12,14,26
21303,AYO AYO,estado nutricional en menores de 5 anos,clasificacion e,2002-05-01,8,3,8,3,11
30301,AYOPAYA (V. DE INDEPENDENCIA),estado nutricional en menores de 5 anos,clasificacion e,2002-05-01,33,16,33,16,49
10201,AZURDUY,estado nutricional en menores de 5 anos,clasificacion e,2002-05-01,43,40,43,40,83
21203,BATALLAS,estado nutricional en menores de 5 anos,clasificacion e,2002-05-01,1,5,1,5,6
80802,BAURES,estado nutricional en menores de 5 anos,clasificacion e,2002-05-01,2,0,2,0,2
50104,BELEN DE URMIRI,estado nutricional en menores de 5 anos,clasificacion e,2002-05-01,0,7,0,7,7
90104,BELLA FLOR,estado nutricional en menores de 5 anos,clasificacion e,2002-05-01,0,1,0,1,1
60202,BERMEJO,estado nutricional en menores de 5 anos,clasificacion e,2002-05-01,2,6,2,6,8
50301,BETANZOS,estado nutricional en menores de 5 anos,clasificacion e,2002-05-01,81,143,81,143,224
31501,BOLIVAR,estado nutricional en menores de 5 anos,clasificacion e,2002-05-01,5,13,5,13,18
70707,BOYUIBE,estado nutricional en menores de 5 anos,clasificacion e,2002-05-01,1,7,1,7,8
70401,BUENA VISTA,estado nutricional en menores de 5 anos,clasificacion e,2002-05-01,8,6,8,6,14
70703,CABEZAS,estado nutricional en menores de 5 anos,clasificacion e,2002-05-01,0,4,0,4,4
20905,CAIROMA,estado nutricional en menores de 5 anos,clasificacion e,2002-05-01,0,10,0,10,10
51102,"CAIZA ""D""",estado nutricional en menores de 5 anos,clasificacion e,2002-05-01,12,34,12,34,46
21003,CAJUATA,estado nutricional en menores de 5 anos,clasificacion e,2002-05-01,2,4,2,4,6
20303,CALACOTO,estado nutricional en menores de 5 anos,clasificacion e,2002-05-01,3,0,3,0,3
21304,CALAMARCA,estado nutricional en menores de 5 anos,clasificacion e,2002-05-01,5,4,5,4,9
10701,CAMARGO,estado nutricional en menores de 5 anos,clasificacion e,2002-05-01,8,23,8,23,31
10901,CAMATAQUI (C. VILLA ABECIA),estado nutricional en menores de 5 anos,clasificacion e,2002-05-01,7,5,7,5,12
70706,CAMIRI,estado nutricional en menores de 5 anos,clasificacion e,2002-05-01,4,16,4,16,20
30701,CAPINOTA,estado nutricional en menores de 5 anos,clasificacion e,2002-05-01,2,5,2,5,7
20302,CAQUIAVIRI,estado nutricional en menores de 5 anos,clasificacion e,2002-05-01,2,3,2,3,5
40102,CARACOLLO,estado nutricional en menores de 5 anos,clasificacion e,2002-05-01,3,12,3,12,15
22001,CARANAVI,estado nutricional en menores de 5 anos,clasificacion e,2002-05-01,26,15,26,15,41
60302,CARAPARI,estado nutricional en menores de 5 anos,clasificacion e,2002-05-01,7,8,7,8,15
50702,CARIPUYO,estado nutricional en menores de 5 anos,clasificacion e,2002-05-01,11,60,11,60,71
21803,CHACARILLA,estado nutricional en menores de 5 anos,clasificacion e,2002-05-01,2,2,2,2,4
40201,CHALLAPATA,estado nutricional en menores de 5 anos,clasificacion e,2002-05-01,30,29,30,29,59
50302,CHAQUI,estado nutricional en menores de 5 anos,clasificacion e,2002-05-01,22,27,22,27,49
70702,CHARAGUA,estado nutricional en menores de 5 anos,clasificacion e,2002-05-01,7,61,7,61,68
20305,CHARAÑA,estado nutricional en menores de 5 anos,clasificacion e,2002-05-01,0,4,0,4,4
31204,CHIMORE,estado nutricional en menores de 5 anos,clasificacion e,2002-05-01,4,3,4,3,7
40302,CHOQUE COTA,estado nutricional en menores de 5 anos,clasificacion e,2002-05-01,0,1,0,1,1
21101,CHULUMANI (V. DE LA LIBERTAD),estado nutricional en menores de 5 anos,clasificacion e,2002-05-01,0,3,0,3,3
20501,CHUMA,estado nutricional en menores de 5 anos,clasificacion e,2002-05-01,1,3,1,3,4
30801,CLIZA,estado nutricional en menores de 5 anos,clasificacion e,2002-05-01,2,7,2,7,9
90101,COBIJA,estado nutricional en menores de 5 anos,clasificacion e,2002-05-01,21,18,21,18,39
30101,COCHABAMBA,estado nutricional en menores de 5 anos,clasificacion e,2002-05-01,103,95,103,95,198
30905,COLCAPIRHUA,estado nutricional en menores de 5 anos,clasificacion e,2002-05-01,33,12,33,12,45
50901,"COLCHA ""K""",estado nutricional en menores de 5 anos,clasificacion e,2002-05-01,0,19,0,19,19
31002,COLOMI,estado nutricional en menores de 5 anos,clasificacion e,2002-05-01,15,15,15,15,30
50401,COLQUECHACA,estado nutricional en menores de 5 anos,clasificacion e,2002-05-01,41,31,41,31,72
21306,COLQUENCHA,estado nutricional en menores de 5 anos,clasificacion e,2002-05-01,14,5,14,5,19
21004,COLQUIRI,estado nutricional en menores de 5 anos,clasificacion e,2002-05-01,8,8,8,8,16
20304,COMANCHE,estado nutricional en menores de 5 anos,clasificacion e,2002-05-01,1,2,1,2,3
71301,COMARAPA,estado nutricional en menores de 5 anos,clasificacion e,2002-05-01,9,13,9,13,22
20605,COMBAYA,estado nutricional en menores de 5 anos,clasificacion e,2002-05-01,1,3,1,3,4
71101,CONCEPCION,estado nutricional en menores de 5 anos,clasificacion e,2002-05-01,1,0,1,0,1
21701,COPACABANA,estado nutricional en menores de 5 anos,clasificacion e,2002-05-01,4,2,4,2,6
20301,CORO CORO,estado nutricional en menores de 5 anos,clasificacion e,2002-05-01,17,1,17,1,18
21401,COROICO,estado nutricional en menores de 5 anos,clasificacion e,2002-05-01,17,10,17,10,27
40301,CORQUE,estado nutricional en menores de 5 anos,clasificacion e,2002-05-01,2,3,2,3,5
50601,COTAGAITA,estado nutricional en menores de 5 anos,clasificacion e,2002-05-01,9,40,9,40,49
70102,COTOCA,estado nutricional en menores de 5 anos,clasificacion e,2002-05-01,6,6,6,6,12
31405,CUCHUMUELA (V. G. VILLARROEL),estado nutricional en menores de 5 anos,clasificacion e,2002-05-01,0,11,0,11,11
70704,CUEVO,estado nutricional en menores de 5 anos,clasificacion e,2002-05-01,8,6,8,6,14
10902,CULPINA,estado nutricional en menores de 5 anos,clasificacion e,2002-05-01,52,41,52,41,93
40401,CURAHUARA DE CARANGAS,estado nutricional en menores de 5 anos,clasificacion e,2002-05-01,6,3,6,3,9
21602,CURVA,estado nutricional en menores de 5 anos,clasificacion e,2002-05-01,3,0,3,0,3
20804,DESAGUADERO,estado nutricional en menores de 5 anos,clasificacion e,2002-05-01,0,7,0,7,7
20105,EL ALTO,estado nutricional en menores de 5 anos,clasificacion e,2002-05-01,441,378,441,378,819
40103,EL CHORO,estado nutricional en menores de 5 anos,clasificacion e,2002-05-01,0,1,0,1,1
71503,EL PUENTE(STC),estado nutricional en menores de 5 anos,clasificacion e,2002-05-01,1,27,1,27,28
60502,EL PUENTE(TJA),estado nutricional en menores de 5 anos,clasificacion e,2002-05-01,2,17,2,17,19
70105,EL TORNO,estado nutricional en menores de 5 anos,clasificacion e,2002-05-01,21,15,21,15,36
10405,EL VILLAR,estado nutricional en menores de 5 anos,clasificacion e,2002-05-01,37,37,37,37,74
60601,ENTRE RIOS,estado nutricional en menores de 5 anos,clasificacion e,2002-05-01,6,12,6,12,18
41101,EUCALIPTUS,estado nutricional en menores de 5 anos,clasificacion e,2002-05-01,0,5,0,5,5
80402,EXALTACION,estado nutricional en menores de 5 anos,clasificacion e,2002-05-01,7,16,7,16,23
90203,FILADELFIA,estado nutricional en menores de 5 anos,clasificacion e,2002-05-01,0,4,0,4,4
71002,GENERAL SAAVEDRA,estado nutricional en menores de 5 anos,clasificacion e,2002-05-01,13,18,13,18,31
21601,GRAL. J.J. PEREZ (CHARAZANI),estado nutricional en menores de 5 anos,clasificacion e,2002-05-01,1,0,1,0,1
20602,GUANAY,estado nutricional en menores de 5 anos,clasificacion e,2002-05-01,16,29,16,29,45
20802,GUAQUI,estado nutricional en menores de 5 anos,clasificacion e,2002-05-01,0,7,0,7,7
80202,GUAYARAMERIN,estado nutricional en menores de 5 anos,clasificacion e,2002-05-01,27,19,27,19,46
70705,GUTIERREZ,estado nutricional en menores de 5 anos,clasificacion e,2002-05-01,1,55,1,55,56
10502,HUACARETA,estado nutricional en menores de 5 anos,clasificacion e,2002-05-01,27,21,27,21,48
11002,HUACAYA (VILLA DE HUACAYA),estado nutricional en menores de 5 anos,clasificacion e,2002-05-01,0,5,0,5,5
40501,HUACHACALLA,estado nutricional en menores de 5 anos,clasificacion e,2002-05-01,0,2,0,2,2
80803,HUARACAJE,estado nutricional en menores de 5 anos,clasificacion e,2002-05-01,6,0,6,0,6
41601,HUAYLLAMARCA,estado nutricional en menores de 5 anos,clasificacion e,2002-05-01,3,0,3,0,3
21005,ICHOCA,estado nutricional en menores de 5 anos,clasificacion e,2002-05-01,1,1,1,1,2
10304,ICLA,estado nutricional en menores de 5 anos,clasificacion e,2002-05-01,65,65,65,65,130
10703,INCAHUASI,estado nutricional en menores de 5 anos,clasificacion e,2002-05-01,35,45,35,45,80
21001,INQUISIVI,estado nutricional en menores de 5 anos,clasificacion e,2002-05-01,10,28,10,28,38
21102,IRUPANA (VILLA DE LANZA),estado nutricional en menores de 5 anos,clasificacion e,2002-05-01,0,4,0,4,4
21501,IXIAMAS,estado nutricional en menores de 5 anos,clasificacion e,2002-05-01,4,15,4,15,19
21105,LA ASUNTA,estado nutricional en menores de 5 anos,clasificacion e,2002-05-01,9,10,9,10,19
70104,LA GUARDIA,estado nutricional en menores de 5 anos,clasificacion e,2002-05-01,14,7,14,7,21
20101,LA PAZ,estado nutricional en menores de 5 anos,clasificacion e,2002-05-01,298,141,298,141,439
70701,LAGUNILLAS,estado nutricional en menores de 5 anos,clasificacion e,2002-05-01,5,9,5,9,14
21202,LAJA,estado nutricional en menores de 5 anos,clasificacion e,2002-05-01,0,13,0,13,13
10903,LAS CARRERAS,estado nutricional en menores de 5 anos,clasificacion e,2002-05-01,9,10,9,10,19
51401,LLICA,estado nutricional en menores de 5 anos,clasificacion e,2002-05-01,0,2,0,2,2
80601,LORETO,estado nutricional en menores de 5 anos,clasificacion e,2002-05-01,2,2,2,2,4
20901,LURIBAY,estado nutricional en menores de 5 anos,clasificacion e,2002-05-01,6,3,6,3,9
40702,MACHACAMARCA,estado nutricional en menores de 5 anos,clasificacion e,2002-05-01,3,0,3,0,3
11003,MACHARETI,estado nutricional en menores de 5 anos,clasificacion e,2002-05-01,9,21,9,21,30
80801,MAGDALENA,estado nutricional en menores de 5 anos,clasificacion e,2002-05-01,7,5,7,5,12
70903,MAIRANA,estado nutricional en menores de 5 anos,clasificacion e,2002-05-01,5,1,5,1,6
20904,MALLA,estado nutricional en menores de 5 anos,clasificacion e,2002-05-01,1,0,1,0,1
20103,MECAPACA,estado nutricional en menores de 5 anos,clasificacion e,2002-05-01,1,4,1,4,5
71003,MINEROS,estado nutricional en menores de 5 anos,clasificacion e,2002-05-01,39,23,39,23,62
31301,MIZQUE,estado nutricional en menores de 5 anos,clasificacion e,2002-05-01,13,17,13,17,30
20402,MOCOMOCO,estado nutricional en menores de 5 anos,clasificacion e,2002-05-01,4,6,4,6,10
51002,MOJINETE,estado nutricional en menores de 5 anos,clasificacion e,2002-05-01,0,1,0,1,1
10303,MOJOCOYA,estado nutricional en menores de 5 anos,clasificacion e,2002-05-01,33,21,33,21,54
10501,MONTEAGUDO,estado nutricional en menores de 5 anos,clasificacion e,2002-05-01,50,48,50,48,98
71001,MONTERO,estado nutricional en menores de 5 anos,clasificacion e,2002-05-01,18,122,18,122,140
70803,MORO MORO,estado nutricional en menores de 5 anos,clasificacion e,2002-05-01,4,3,4,3,7
30302,MOROCHATA,estado nutricional en menores de 5 anos,clasificacion e,2002-05-01,7,15,7,15,22
90501,NUEVO MANOA (NUEVA ESPERANZA),estado nutricional en menores de 5 anos,clasificacion e,2002-05-01,1,1,1,1,2
50404,OCURI,estado nutricional en menores de 5 anos,clasificacion e,2002-05-01,28,19,28,19,47
70202,OKINAWA,estado nutricional en menores de 5 anos,clasificacion e,2002-05-01,2,3,2,3,5
40101,ORURO,estado nutricional en menores de 5 anos,clasificacion e,2002-05-01,99,70,99,70,169
60201,PADCAYA,estado nutricional en menores de 5 anos,clasificacion e,2002-05-01,11,19,11,19,30
10401,PADILLA,estado nutricional en menores de 5 anos,clasificacion e,2002-05-01,61,53,61,53,114
70502,PAILON,estado nutricional en menores de 5 anos,clasificacion e,2002-05-01,0,10,0,10,10
20102,PALCA,estado nutricional en menores de 5 anos,clasificacion e,2002-05-01,9,13,9,13,22
21104,PALOS BLANCOS,estado nutricional en menores de 5 anos,clasificacion e,2002-05-01,18,20,18,20,38
40802,PAMPA AULLAGAS,estado nutricional en menores de 5 anos,clasificacion e,2002-05-01,7,4,7,4,11
70902,PAMPA GRANDE,estado nutricional en menores de 5 anos,clasificacion e,2002-05-01,5,2,5,2,7
21802,PAPEL PAMPA,estado nutricional en menores de 5 anos,clasificacion e,2002-05-01,1,0,1,0,1
30202,PASORAPA,estado nutricional en menores de 5 anos,clasificacion e,2002-05-01,15,11,15,11,26
21305,PATACAMAYA,estado nutricional en menores de 5 anos,clasificacion e,2002-05-01,9,8,9,8,17
40602,PAZÑA,estado nutricional en menores de 5 anos,clasificacion e,2002-05-01,0,7,0,7,7
20702,PELECHUCO,estado nutricional en menores de 5 anos,clasificacion e,2002-05-01,4,12,4,12,16
50403,POCOATA,estado nutricional en menores de 5 anos,clasificacion e,2002-05-01,37,61,37,61,98
31203,POCONA,estado nutricional en menores de 5 anos,clasificacion e,2002-05-01,35,31,35,31,66
31202,POJO (CBBA),estado nutricional en menores de 5 anos,clasificacion e,2002-05-01,24,21,24,21,45
40601,POOPO,estado nutricional en menores de 5 anos,clasificacion e,2002-05-01,2,12,2,12,14
51203,PORCO,estado nutricional en menores de 5 anos,clasificacion e,2002-05-01,3,4,3,4,7
10103,POROMA,estado nutricional en menores de 5 anos,clasificacion e,2002-05-01,34,80,34,80,114
70103,PORONGO,estado nutricional en menores de 5 anos,clasificacion e,2002-05-01,7,2,7,2,9
70601,PORTACHUELO,estado nutricional en menores de 5 anos,clasificacion e,2002-05-01,10,4,10,4,14
50101,POTOSI,estado nutricional en menores de 5 anos,clasificacion e,2002-05-01,129,115,129,115,244
10302,PRESTO,estado nutricional en menores de 5 anos,clasificacion e,2002-05-01,35,34,35,34,69
70805,PUCARA,estado nutricional en menores de 5 anos,clasificacion e,2002-05-01,0,6,0,6,6
21201,PUCARANI,estado nutricional en menores de 5 anos,clasificacion e,2002-05-01,0,20,0,20,20
20401,PUERTO ACOSTA,estado nutricional en menores de 5 anos,clasificacion e,2002-05-01,17,10,17,10,27
20403,PUERTO CARABUCO,estado nutricional en menores de 5 anos,clasificacion e,2002-05-01,9,16,9,16,25
90301,PUERTO GONZALO MORENO,estado nutricional en menores de 5 anos,clasificacion e,2002-05-01,6,3,6,3,9
71402,PUERTO QUIJARRO,estado nutricional en menores de 5 anos,clasificacion e,2002-05-01,11,0,11,0,11
90201,PUERTO RICO,estado nutricional en menores de 5 anos,clasificacion e,2002-05-01,0,7,0,7,7
71401,PUERTO SUAREZ,estado nutricional en menores de 5 anos,clasificacion e,2002-05-01,22,3,22,3,25
31205,PUERTO VILLARROEL,estado nutricional en menores de 5 anos,clasificacion e,2002-05-01,61,43,61,43,104
51101,PUNA,estado nutricional en menores de 5 anos,clasificacion e,2002-05-01,48,81,48,81,129
31401,PUNATA,estado nutricional en menores de 5 anos,clasificacion e,2002-05-01,0,5,0,5,5
20604,QUIABAYA,estado nutricional en menores de 5 anos,clasificacion e,2002-05-01,11,4,11,4,15
30901,QUILLACOLLO,estado nutricional en menores de 5 anos,clasificacion e,2002-05-01,20,10,20,10,30
21002,QUIME,estado nutricional en menores de 5 anos,clasificacion e,2002-05-01,5,1,5,1,6
50402,RAVELO,estado nutricional en menores de 5 anos,clasificacion e,2002-05-01,60,90,60,90,150
80301,REYES,estado nutricional en menores de 5 anos,clasificacion e,2002-05-01,3,4,3,4,7
80201,RIBERALTA,estado nutricional en menores de 5 anos,clasificacion e,2002-05-01,160,117,160,117,277
70503,ROBORE,estado nutricional en menores de 5 anos,clasificacion e,2002-05-01,2,7,2,7,9
80304,RURRENABAQUE,estado nutricional en menores de 5 anos,clasificacion e,2002-05-01,5,5,5,5,10
31001,SACABA,estado nutricional en menores de 5 anos,clasificacion e,2002-05-01,7,119,7,119,126
30404,SACABAMBA,estado nutricional en menores de 5 anos,clasificacion e,2002-05-01,0,29,0,29,29
50701,SACACA,estado nutricional en menores de 5 anos,clasificacion e,2002-05-01,69,90,69,90,159
71302,SAIPINA,estado nutricional en menores de 5 anos,clasificacion e,2002-05-01,1,1,1,1,2
40801,SALINAS DE GARCI MENDOZA,estado nutricional en menores de 5 anos,clasificacion e,2002-05-01,2,3,2,3,5
70901,SAMAIPATA,estado nutricional en menores de 5 anos,clasificacion e,2002-05-01,8,0,8,0,8
51601,SAN AGUSTIN,estado nutricional en menores de 5 anos,clasificacion e,2002-05-01,0,1,0,1,1
80602,SAN ANDRES,estado nutricional en menores de 5 anos,clasificacion e,2002-05-01,0,2,0,2,2
51003,SAN ANTONIO DE ESMORUCO,estado nutricional en menores de 5 anos,clasificacion e,2002-05-01,0,5,0,5,5
71105,SAN ANTONIO DE LOMERIO,estado nutricional en menores de 5 anos,clasificacion e,2002-05-01,39,32,39,32,71
31403,SAN BENITO,estado nutricional en menores de 5 anos,clasificacion e,2002-05-01,1,1,1,1,2
80302,SAN BORJA,estado nutricional en menores de 5 anos,clasificacion e,2002-05-01,11,12,11,12,23
21502,SAN BUENA VENTURA,estado nutricional en menores de 5 anos,clasificacion e,2002-05-01,3,5,3,5,8
70402,SAN CARLOS,estado nutricional en menores de 5 anos,clasificacion e,2002-05-01,0,1,0,1,1
80501,SAN IGNACIO,estado nutricional en menores de 5 anos,clasificacion e,2002-05-01,26,39,26,39,65
70301,SAN IGNACIO DE VELASCO,estado nutricional en menores de 5 anos,clasificacion e,2002-05-01,46,26,46,26,72
80102,SAN JAVIER(BNI),estado nutricional en menores de 5 anos,clasificacion e,2002-05-01,5,1,5,1,6
71102,SAN JAVIER(STC),estado nutricional en menores de 5 anos,clasificacion e,2002-05-01,18,0,18,0,18
80701,SAN JOAQUIN,estado nutricional en menores de 5 anos,clasificacion e,2002-05-01,0,8,0,8,8
70501,SAN JOSE DE CHIQUITOS,estado nutricional en menores de 5 anos,clasificacion e,2002-05-01,14,6,14,6,20
71104,SAN JULIAN,estado nutricional en menores de 5 anos,clasificacion e,2002-05-01,35,85,35,85,120
90302,SAN LORENZO(PND),estado nutricional en menores de 5 anos,clasificacion e,2002-05-01,0,1,0,1,1
60501,SAN LORENZO(TJA),estado nutricional en menores de 5 anos,clasificacion e,2002-05-01,4,5,4,5,9
10702,SAN LUCAS,estado nutricional en menores de 5 anos,clasificacion e,2002-05-01,152,112,152,112,264
71201,SAN MATIAS,estado nutricional en menores de 5 anos,clasificacion e,2002-05-01,13,13,13,13,26
70302,SAN MIGUEL DE VELASCO,estado nutricional en menores de 5 anos,clasificacion e,2002-05-01,19,18,19,18,37
51001,SAN PABLO DE LIPEZ,estado nutricional en menores de 5 anos,clasificacion e,2002-05-01,0,18,0,18,18
50501,SAN PEDRO DE BUENA VISTA,estado nutricional en menores de 5 anos,clasificacion e,2002-05-01,1,109,1,109,110
21801,SAN PEDRO DE CURAHUARA,estado nutricional en menores de 5 anos,clasificacion e,2002-05-01,1,6,1,6,7
90202,SAN PEDRO(PND),estado nutricional en menores de 5 anos,clasificacion e,2002-05-01,1,1,1,1,2
70303,SAN RAFAEL,estado nutricional en menores de 5 anos,clasificacion e,2002-05-01,8,5,8,5,13
80401,SANTA ANA,estado nutricional en menores de 5 anos,clasificacion e,2002-05-01,7,0,7,0,7
70101,SANTA CRUZ DE LA SIERRA,estado nutricional en menores de 5 anos,clasificacion e,2002-05-01,83,39,83,39,122
80303,SANTA ROSA,estado nutricional en menores de 5 anos,clasificacion e,2002-05-01,19,5,19,5,24
70602,SANTA ROSA DEL SARA,estado nutricional en menores de 5 anos,clasificacion e,2002-05-01,2,5,2,5,7
20308,SANTIAGO DE CALLAPA,estado nutricional en menores de 5 anos,clasificacion e,2002-05-01,0,4,0,4,4
41401,SANTIAGO DE HUARI,estado nutricional en menores de 5 anos,clasificacion e,2002-05-01,4,7,4,7,11
21901,SANTIAGO DE MACHACA,estado nutricional en menores de 5 anos,clasificacion e,2002-05-01,1,1,1,1,2
30702,SANTIVAÑES,estado nutricional en menores de 5 anos,clasificacion e,2002-05-01,4,2,4,2,6
40202,SANTUARIO DE QUILLACAS,estado nutricional en menores de 5 anos,clasificacion e,2002-05-01,0,2,0,2,2
20902,SAPAHAQUI,estado nutricional en menores de 5 anos,clasificacion e,2002-05-01,0,3,0,3,3
21301,SICA SICA (VILLA AROMA),estado nutricional en menores de 5 anos,clasificacion e,2002-05-01,6,5,6,5,11
30703,SICAYA,estado nutricional en menores de 5 anos,clasificacion e,2002-05-01,0,12,0,12,12
30902,SIPE SIPE,estado nutricional en menores de 5 anos,clasificacion e,2002-05-01,61,47,61,47,108
10403,SOPACHUY,estado nutricional en menores de 5 anos,clasificacion e,2002-05-01,41,28,41,28,69
20601,SORATA,estado nutricional en menores de 5 anos,clasificacion e,2002-05-01,11,12,11,12,23
10101,SUCRE,estado nutricional en menores de 5 anos,clasificacion e,2002-05-01,195,140,195,140,335
31404,TACACHI,estado nutricional en menores de 5 anos,clasificacion e,2002-05-01,0,1,0,1,1
20603,TACACOMA,estado nutricional en menores de 5 anos,clasificacion e,2002-05-01,2,3,2,3,5
50303,TACOBAMBA,estado nutricional en menores de 5 anos,clasificacion e,2002-05-01,16,12,16,12,28
30602,TACOPAYA,estado nutricional en menores de 5 anos,clasificacion e,2002-05-01,17,14,17,14,31
51402,TAHUA,estado nutricional en menores de 5 anos,clasificacion e,2002-05-01,0,2,0,2,2
31101,TAPACARI,estado nutricional en menores de 5 anos,clasificacion e,2002-05-01,3,75,3,75,78
10601,TARABUCO,estado nutricional en menores de 5 anos,clasificacion e,2002-05-01,76,222,76,222,298
30401,TARATA,estado nutricional en menores de 5 anos,clasificacion e,2002-05-01,13,15,13,15,28
60101,TARIJA,estado nutricional en menores de 5 anos,clasificacion e,2002-05-01,45,32,45,32,77
10202,TARVITA,estado nutricional en menores de 5 anos,clasificacion e,2002-05-01,37,20,37,20,57
20803,TIAWANACU,estado nutricional en menores de 5 anos,clasificacion e,2002-05-01,5,3,5,3,8
50102,TINGUIPAYA,estado nutricional en menores de 5 anos,clasificacion e,2002-05-01,7,56,7,56,63
20606,TIPUANI,estado nutricional en menores de 5 anos,clasificacion e,2002-05-01,0,2,0,2,2
30903,TIQUIPAYA,estado nutricional en menores de 5 anos,clasificacion e,2002-05-01,0,23,0,23,23
31601,TIRAQUE (CBBA),estado nutricional en menores de 5 anos,clasificacion e,2002-05-01,19,41,19,41,60
21703,TITO YUPANQUI (PARQUIPUJIO),estado nutricional en menores de 5 anos,clasificacion e,2002-05-01,0,24,0,24,24
30802,TOCO,estado nutricional en menores de 5 anos,clasificacion e,2002-05-01,6,2,6,2,8
41001,TOLEDO,estado nutricional en menores de 5 anos,clasificacion e,2002-05-01,1,2,1,2,3
51202,TOMAVE,estado nutricional en menores de 5 anos,clasificacion e,2002-05-01,1,44,1,44,45
10402,TOMINA,estado nutricional en menores de 5 anos,clasificacion e,2002-05-01,44,41,44,41,85
50502,TORO TORO,estado nutricional en menores de 5 anos,clasificacion e,2002-05-01,0,23,0,23,23
31201,TOTORA(CBBA),estado nutricional en menores de 5 anos,clasificacion e,2002-05-01,30,28,30,28,58
41301,TOTORA(ORR),estado nutricional en menores de 5 anos,clasificacion e,2002-05-01,4,1,4,1,5
80101,TRINIDAD,estado nutricional en menores de 5 anos,clasificacion e,2002-05-01,52,50,52,50,102
50801,TUPIZA,estado nutricional en menores de 5 anos,clasificacion e,2002-05-01,1,88,1,88,89
21302,UMALA,estado nutricional en menores de 5 anos,clasificacion e,2002-05-01,0,2,0,2,2
60401,URIONDO (A. CONCEPCION),estado nutricional en menores de 5 anos,clasificacion e,2002-05-01,8,17,8,17,25
71502,URUBICHA,estado nutricional en menores de 5 anos,clasificacion e,2002-05-01,0,8,0,8,8
51201,UYUNI,estado nutricional en menores de 5 anos,clasificacion e,2002-05-01,0,53,0,53,53
30502,VACAS,estado nutricional en menores de 5 anos,clasificacion e,2002-05-01,3,16,3,16,19
70801,VALLEGRANDE,estado nutricional en menores de 5 anos,clasificacion e,2002-05-01,12,12,12,12,24
20801,VIACHA,estado nutricional en menores de 5 anos,clasificacion e,2002-05-01,3,39,3,39,42
31302,VILA VILA,estado nutricional en menores de 5 anos,clasificacion e,2002-05-01,8,12,8,12,20
60303,VILLA MONTES,estado nutricional en menores de 5 anos,clasificacion e,2002-05-01,5,15,5,15,20
31402,VILLA RIVERO,estado nutricional en menores de 5 anos,clasificacion e,2002-05-01,0,6,0,6,6
10801,VILLA SERRANO,estado nutricional en menores de 5 anos,clasificacion e,2002-05-01,34,52,34,52,86
31003,VILLA TUNARI,estado nutricional en menores de 5 anos,clasificacion e,2002-05-01,52,35,52,35,87
11001,VILLA VACA GUZMAN (MUYUPAMPA),estado nutricional en menores de 5 anos,clasificacion e,2002-05-01,29,18,29,18,47
51501,VILLAZON,estado nutricional en menores de 5 anos,clasificacion e,2002-05-01,7,58,7,58,65
30904,VINTO,estado nutricional en menores de 5 anos,clasificacion e,2002-05-01,84,33,84,33,117
50602,VITICHI,estado nutricional en menores de 5 anos,clasificacion e,2002-05-01,3,40,3,40,43
20306,WALDO BALLIVIAN,estado nutricional en menores de 5 anos,clasificacion e,2002-05-01,0,1,0,1,1
70201,WARNES,estado nutricional en menores de 5 anos,clasificacion e,2002-05-01,25,14,25,14,39
20903,YACO,estado nutricional en menores de 5 anos,clasificacion e,2002-05-01,0,6,0,6,6
60301,YACUIBA,estado nutricional en menores de 5 anos,clasificacion e,2002-05-01,22,10,22,10,32
10602,YAMPARAEZ,estado nutricional en menores de 5 anos,clasificacion e,2002-05-01,64,44,64,44,108
21103,YANACACHI,estado nutricional en menores de 5 anos,clasificacion e,2002-05-01,1,5,1,5,6
70403,YAPACANI,estado nutricional en menores de 5 anos,clasificacion e,2002-05-01,1,33,1,33,34
50103,YOCALLA,estado nutricional en menores de 5 anos,clasificacion e,2002-05-01,0,21,0,21,21
10102,YOTALA,estado nutricional en menores de 5 anos,clasificacion e,2002-05-01,26,32,26,32,58
60402,YUNCHARA,estado nutricional en menores de 5 anos,clasificacion e,2002-05-01,4,11,4,11,15
10301,ZUDAÑEZ,estado nutricional en menores de 5 anos,clasificacion e,2002-05-01,35,50,35,50,85
51302,ACACIO,estado nutricional en menores de 5 anos,clasificacion e,2002-06-01,11,46,11,46,57
20201,ACHACACHI,estado nutricional en menores de 5 anos,clasificacion e,2002-06-01,26,15,26,15,41
20104,ACHOCALLA,estado nutricional en menores de 5 anos,clasificacion e,2002-06-01,4,0,4,0,4
30201,AIQUILE,estado nutricional en menores de 5 anos,clasificacion e,2002-06-01,5,5,5,5,10
31303,ALALAY,estado nutricional en menores de 5 anos,clasificacion e,2002-06-01,1,4,1,4,5
10404,ALCALA,estado nutricional en menores de 5 anos,clasificacion e,2002-06-01,14,9,14,9,23
20202,ANCORAIMES,estado nutricional en menores de 5 anos,clasificacion e,2002-06-01,11,23,11,23,34
41201,ANDAMARCA,estado nutricional en menores de 5 anos,clasificacion e,2002-06-01,6,1,6,1,7
40603,ANTEQUERA,estado nutricional en menores de 5 anos,clasificacion e,2002-06-01,0,1,0,1,1
30402,ANZALDO,estado nutricional en menores de 5 anos,clasificacion e,2002-06-01,2,33,2,33,35
20701,APOLO,estado nutricional en menores de 5 anos,clasificacion e,2002-06-01,18,7,18,7,25
51301,ARAMPAMPA,estado nutricional en menores de 5 anos,clasificacion e,2002-06-01,13,6,13,6,19
30501,ARANI,estado nutricional en menores de 5 anos,clasificacion e,2002-06-01,1,9,1,9,10
30403,ARBIETO,estado nutricional en menores de 5 anos,clasificacion e,2002-06-01,0,1,0,1,1
30601,ARQUE,estado nutricional en menores de 5 anos,clasificacion e,2002-06-01,23,6,23,6,29
71501,ASCENCION DE GUARAYOS,estado nutricional en menores de 5 anos,clasificacion e,2002-06-01,56,62,56,62,118
50802,ATOCHA,estado nutricional en menores de 5 anos,clasificacion e,2002-06-01,1,13,1,13,14
20503,AUCAPATA,estado nutricional en menores de 5 anos,clasificacion e,2002-06-01,5,1,5,1,6
20502,AYATA,estado nutricional en menores de 5 anos,clasificacion e,2002-06-01,4,5,4,5,9
21303,AYO AYO,estado nutricional en menores de 5 anos,clasificacion e,2002-06-01,9,1,9,1,10
30301,AYOPAYA (V. DE INDEPENDENCIA),estado nutricional en menores de 5 anos,clasificacion e,2002-06-01,33,26,33,26,59
10201,AZURDUY,estado nutricional en menores de 5 anos,clasificacion e,2002-06-01,73,49,73,49,122
21203,BATALLAS,estado nutricional en menores de 5 anos,clasificacion e,2002-06-01,0,15,0,15,15
80802,BAURES,estado nutricional en menores de 5 anos,clasificacion e,2002-06-01,7,6,7,6,13
50104,BELEN DE URMIRI,estado nutricional en menores de 5 anos,clasificacion e,2002-06-01,1,5,1,5,6
90104,BELLA FLOR,estado nutricional en menores de 5 anos,clasificacion e,2002-06-01,0,1,0,1,1
60202,BERMEJO,estado nutricional en menores de 5 anos,clasificacion e,2002-06-01,1,4,1,4,5
50301,BETANZOS,estado nutricional en menores de 5 anos,clasificacion e,2002-06-01,54,70,54,70,124
31501,BOLIVAR,estado nutricional en menores de 5 anos,clasificacion e,2002-06-01,14,16,14,16,30
70703,CABEZAS,estado nutricional en menores de 5 anos,clasificacion e,2002-06-01,0,20,0,20,20
20905,CAIROMA,estado nutricional en menores de 5 anos,clasificacion e,2002-06-01,9,18,9,18,27
51102,"CAIZA ""D""",estado nutricional en menores de 5 anos,clasificacion e,2002-06-01,13,15,13,15,28
21003,CAJUATA,estado nutricional en menores de 5 anos,clasificacion e,2002-06-01,8,5,8,5,13
20303,CALACOTO,estado nutricional en menores de 5 anos,clasificacion e,2002-06-01,1,3,1,3,4
21304,CALAMARCA,estado nutricional en menores de 5 anos,clasificacion e,2002-06-01,10,3,10,3,13
10701,CAMARGO,estado nutricional en menores de 5 anos,clasificacion e,2002-06-01,4,25,4,25,29
10901,CAMATAQUI (C. VILLA ABECIA),estado nutricional en menores de 5 anos,clasificacion e,2002-06-01,9,9,9,9,18
70706,CAMIRI,estado nutricional en menores de 5 anos,clasificacion e,2002-06-01,5,18,5,18,23
30701,CAPINOTA,estado nutricional en menores de 5 anos,clasificacion e,2002-06-01,9,26,9,26,35
20302,CAQUIAVIRI,estado nutricional en menores de 5 anos,clasificacion e,2002-06-01,6,4,6,4,10
40102,CARACOLLO,estado nutricional en menores de 5 anos,clasificacion e,2002-06-01,4,10,4,10,14
22001,CARANAVI,estado nutricional en menores de 5 anos,clasificacion e,2002-06-01,33,28,33,28,61
60302,CARAPARI,estado nutricional en menores de 5 anos,clasificacion e,2002-06-01,4,9,4,9,13
50702,CARIPUYO,estado nutricional en menores de 5 anos,clasificacion e,2002-06-01,1,55,1,55,56
21902,CATACORA,estado nutricional en menores de 5 anos,clasificacion e,2002-06-01,3,1,3,1,4
40201,CHALLAPATA,estado nutricional en menores de 5 anos,clasificacion e,2002-06-01,12,20,12,20,32
50302,CHAQUI,estado nutricional en menores de 5 anos,clasificacion e,2002-06-01,23,14,23,14,37
70702,CHARAGUA,estado nutricional en menores de 5 anos,clasificacion e,2002-06-01,1,48,1,48,49
20305,CHARAÑA,estado nutricional en menores de 5 anos,clasificacion e,2002-06-01,1,0,1,0,1
50202,CHAYANTA,estado nutricional en menores de 5 anos,clasificacion e,2002-06-01,9,43,9,43,52
31204,CHIMORE,estado nutricional en menores de 5 anos,clasificacion e,2002-06-01,8,1,8,1,9
40903,CHIPAYA,estado nutricional en menores de 5 anos,clasificacion e,2002-06-01,0,3,0,3,3
40302,CHOQUE COTA,estado nutricional en menores de 5 anos,clasificacion e,2002-06-01,1,0,1,0,1
21101,CHULUMANI (V. DE LA LIBERTAD),estado nutricional en menores de 5 anos,clasificacion e,2002-06-01,0,6,0,6,6
20501,CHUMA,estado nutricional en menores de 5 anos,clasificacion e,2002-06-01,2,8,2,8,10
30801,CLIZA,estado nutricional en menores de 5 anos,clasificacion e,2002-06-01,2,10,2,10,12
90101,COBIJA,estado nutricional en menores de 5 anos,clasificacion e,2002-06-01,11,6,11,6,17
30101,COCHABAMBA,estado nutricional en menores de 5 anos,clasificacion e,2002-06-01,43,45,43,45,88
30905,COLCAPIRHUA,estado nutricional en menores de 5 anos,clasificacion e,2002-06-01,19,13,19,13,32
50901,"COLCHA ""K""",estado nutricional en menores de 5 anos,clasificacion e,2002-06-01,1,23,1,23,24
21307,COLLANA,estado nutricional en menores de 5 anos,clasificacion e,2002-06-01,1,0,1,0,1
31002,COLOMI,estado nutricional en menores de 5 anos,clasificacion e,2002-06-01,9,7,9,7,16
50401,COLQUECHACA,estado nutricional en menores de 5 anos,clasificacion e,2002-06-01,60,6,60,6,66
21306,COLQUENCHA,estado nutricional en menores de 5 anos,clasificacion e,2002-06-01,8,3,8,3,11
21004,COLQUIRI,estado nutricional en menores de 5 anos,clasificacion e,2002-06-01,14,10,14,10,24
20304,COMANCHE,estado nutricional en menores de 5 anos,clasificacion e,2002-06-01,3,2,3,2,5
71301,COMARAPA,estado nutricional en menores de 5 anos,clasificacion e,2002-06-01,7,13,7,13,20
20605,COMBAYA,estado nutricional en menores de 5 anos,clasificacion e,2002-06-01,1,3,1,3,4
71101,CONCEPCION,estado nutricional en menores de 5 anos,clasificacion e,2002-06-01,0,1,0,1,1
21701,COPACABANA,estado nutricional en menores de 5 anos,clasificacion e,2002-06-01,0,4,0,4,4
20301,CORO CORO,estado nutricional en menores de 5 anos,clasificacion e,2002-06-01,5,2,5,2,7
21401,COROICO,estado nutricional en menores de 5 anos,clasificacion e,2002-06-01,2,4,2,4,6
40301,CORQUE,estado nutricional en menores de 5 anos,clasificacion e,2002-06-01,4,10,4,10,14
50601,COTAGAITA,estado nutricional en menores de 5 anos,clasificacion e,2002-06-01,28,79,28,79,107
70102,COTOCA,estado nutricional en menores de 5 anos,clasificacion e,2002-06-01,12,11,12,11,23
31405,CUCHUMUELA (V. G. VILLARROEL),estado nutricional en menores de 5 anos,clasificacion e,2002-06-01,1,9,1,9,10
70704,CUEVO,estado nutricional en menores de 5 anos,clasificacion e,2002-06-01,2,1,2,1,3
10902,CULPINA,estado nutricional en menores de 5 anos,clasificacion e,2002-06-01,61,38,61,38,99
40401,CURAHUARA DE CARANGAS,estado nutricional en menores de 5 anos,clasificacion e,2002-06-01,2,1,2,1,3
21602,CURVA,estado nutricional en menores de 5 anos,clasificacion e,2002-06-01,1,4,1,4,5
20804,DESAGUADERO,estado nutricional en menores de 5 anos,clasificacion e,2002-06-01,0,8,0,8,8
20105,EL ALTO,estado nutricional en menores de 5 anos,clasificacion e,2002-06-01,426,278,426,278,704
40103,EL CHORO,estado nutricional en menores de 5 anos,clasificacion e,2002-06-01,1,0,1,0,1
71503,EL PUENTE(STC),estado nutricional en menores de 5 anos,clasificacion e,2002-06-01,1,25,1,25,26
60502,EL PUENTE(TJA),estado nutricional en menores de 5 anos,clasificacion e,2002-06-01,12,18,12,18,30
70105,EL TORNO,estado nutricional en menores de 5 anos,clasificacion e,2002-06-01,11,11,11,11,22
10405,EL VILLAR,estado nutricional en menores de 5 anos,clasificacion e,2002-06-01,28,31,28,31,59
60601,ENTRE RIOS,estado nutricional en menores de 5 anos,clasificacion e,2002-06-01,5,5,5,5,10
41101,EUCALIPTUS,estado nutricional en menores de 5 anos,clasificacion e,2002-06-01,1,4,1,4,5
80402,EXALTACION,estado nutricional en menores de 5 anos,clasificacion e,2002-06-01,4,4,4,4,8
90203,FILADELFIA,estado nutricional en menores de 5 anos,clasificacion e,2002-06-01,0,6,0,6,6
71002,GENERAL SAAVEDRA,estado nutricional en menores de 5 anos,clasificacion e,2002-06-01,8,12,8,12,20
20602,GUANAY,estado nutricional en menores de 5 anos,clasificacion e,2002-06-01,46,42,46,42,88
20802,GUAQUI,estado nutricional en menores de 5 anos,clasificacion e,2002-06-01,4,4,4,4,8
80202,GUAYARAMERIN,estado nutricional en menores de 5 anos,clasificacion e,2002-06-01,17,11,17,11,28
70705,GUTIERREZ,estado nutricional en menores de 5 anos,clasificacion e,2002-06-01,10,60,10,60,70
10502,HUACARETA,estado nutricional en menores de 5 anos,clasificacion e,2002-06-01,25,21,25,21,46
11002,HUACAYA (VILLA DE HUACAYA),estado nutricional en menores de 5 anos,clasificacion e,2002-06-01,3,5,3,5,8
40501,HUACHACALLA,estado nutricional en menores de 5 anos,clasificacion e,2002-06-01,1,0,1,0,1
80803,HUARACAJE,estado nutricional en menores de 5 anos,clasificacion e,2002-06-01,2,3,2,3,5
41601,HUAYLLAMARCA,estado nutricional en menores de 5 anos,clasificacion e,2002-06-01,1,1,1,1,2
21005,ICHOCA,estado nutricional en menores de 5 anos,clasificacion e,2002-06-01,4,2,4,2,6
10304,ICLA,estado nutricional en menores de 5 anos,clasificacion e,2002-06-01,65,71,65,71,136
10703,INCAHUASI,estado nutricional en menores de 5 anos,clasificacion e,2002-06-01,52,61,52,61,113
21001,INQUISIVI,estado nutricional en menores de 5 anos,clasificacion e,2002-06-01,12,42,12,42,54
21102,IRUPANA (VILLA DE LANZA),estado nutricional en menores de 5 anos,clasificacion e,2002-06-01,0,1,0,1,1
21501,IXIAMAS,estado nutricional en menores de 5 anos,clasificacion e,2002-06-01,5,4,5,4,9
21105,LA ASUNTA,estado nutricional en menores de 5 anos,clasificacion e,2002-06-01,10,15,10,15,25
70104,LA GUARDIA,estado nutricional en menores de 5 anos,clasificacion e,2002-06-01,10,8,10,8,18
20101,LA PAZ,estado nutricional en menores de 5 anos,clasificacion e,2002-06-01,300,167,300,167,467
70701,LAGUNILLAS,estado nutricional en menores de 5 anos,clasificacion e,2002-06-01,4,2,4,2,6
21202,LAJA,estado nutricional en menores de 5 anos,clasificacion e,2002-06-01,0,3,0,3,3
10903,LAS CARRERAS,estado nutricional en menores de 5 anos,clasificacion e,2002-06-01,9,3,9,3,12
50203,LLALLAGUA,estado nutricional en menores de 5 anos,clasificacion e,2002-06-01,0,18,0,18,18
51401,LLICA,estado nutricional en menores de 5 anos,clasificacion e,2002-06-01,1,0,1,0,1
80601,LORETO,estado nutricional en menores de 5 anos,clasificacion e,2002-06-01,1,1,1,1,2
20901,LURIBAY,estado nutricional en menores de 5 anos,clasificacion e,2002-06-01,3,5,3,5,8
11003,MACHARETI,estado nutricional en menores de 5 anos,clasificacion e,2002-06-01,12,27,12,27,39
80801,MAGDALENA,estado nutricional en menores de 5 anos,clasificacion e,2002-06-01,5,7,5,7,12
70903,MAIRANA,estado nutricional en menores de 5 anos,clasificacion e,2002-06-01,4,3,4,3,7
20103,MECAPACA,estado nutricional en menores de 5 anos,clasificacion e,2002-06-01,1,9,1,9,10
71003,MINEROS,estado nutricional en menores de 5 anos,clasificacion e,2002-06-01,17,7,17,7,24
31301,MIZQUE,estado nutricional en menores de 5 anos,clasificacion e,2002-06-01,1,12,1,12,13
20402,MOCOMOCO,estado nutricional en menores de 5 anos,clasificacion e,2002-06-01,15,3,15,3,18
51002,MOJINETE,estado nutricional en menores de 5 anos,clasificacion e,2002-06-01,0,1,0,1,1
10303,MOJOCOYA,estado nutricional en menores de 5 anos,clasificacion e,2002-06-01,23,29,23,29,52
10501,MONTEAGUDO,estado nutricional en menores de 5 anos,clasificacion e,2002-06-01,36,39,36,39,75
71001,MONTERO,estado nutricional en menores de 5 anos,clasificacion e,2002-06-01,24,65,24,65,89
70803,MORO MORO,estado nutricional en menores de 5 anos,clasificacion e,2002-06-01,4,9,4,9,13
30302,MOROCHATA,estado nutricional en menores de 5 anos,clasificacion e,2002-06-01,9,27,9,27,36
90401,NACEBE (SANTA ROSA DEL ABUNA),estado nutricional en menores de 5 anos,clasificacion e,2002-06-01,0,1,0,1,1
90501,NUEVO MANOA (NUEVA ESPERANZA),estado nutricional en menores de 5 anos,clasificacion e,2002-06-01,0,3,0,3,3
50404,OCURI,estado nutricional en menores de 5 anos,clasificacion e,2002-06-01,32,55,32,55,87
70202,OKINAWA,estado nutricional en menores de 5 anos,clasificacion e,2002-06-01,3,3,3,3,6
40101,ORURO,estado nutricional en menores de 5 anos,clasificacion e,2002-06-01,101,55,101,55,156
60201,PADCAYA,estado nutricional en menores de 5 anos,clasificacion e,2002-06-01,8,13,8,13,21
10401,PADILLA,estado nutricional en menores de 5 anos,clasificacion e,2002-06-01,47,47,47,47,94
70502,PAILON,estado nutricional en menores de 5 anos,clasificacion e,2002-06-01,5,3,5,3,8
20102,PALCA,estado nutricional en menores de 5 anos,clasificacion e,2002-06-01,2,5,2,5,7
21104,PALOS BLANCOS,estado nutricional en menores de 5 anos,clasificacion e,2002-06-01,17,14,17,14,31
40802,PAMPA AULLAGAS,estado nutricional en menores de 5 anos,clasificacion e,2002-06-01,5,1,5,1,6
70902,PAMPA GRANDE,estado nutricional en menores de 5 anos,clasificacion e,2002-06-01,1,2,1,2,3
21802,PAPEL PAMPA,estado nutricional en menores de 5 anos,clasificacion e,2002-06-01,0,1,0,1,1
30202,PASORAPA,estado nutricional en menores de 5 anos,clasificacion e,2002-06-01,5,5,5,5,10
21305,PATACAMAYA,estado nutricional en menores de 5 anos,clasificacion e,2002-06-01,7,8,7,8,15
40602,PAZÑA,estado nutricional en menores de 5 anos,clasificacion e,2002-06-01,3,6,3,6,9
20702,PELECHUCO,estado nutricional en menores de 5 anos,clasificacion e,2002-06-01,7,13,7,13,20
50403,POCOATA,estado nutricional en menores de 5 anos,clasificacion e,2002-06-01,55,60,55,60,115
31203,POCONA,estado nutricional en menores de 5 anos,clasificacion e,2002-06-01,17,12,17,12,29
31202,POJO (CBBA),estado nutricional en menores de 5 anos,clasificacion e,2002-06-01,23,14,23,14,37
40601,POOPO,estado nutricional en menores de 5 anos,clasificacion e,2002-06-01,0,6,0,6,6
51203,PORCO,estado nutricional en menores de 5 anos,clasificacion e,2002-06-01,6,12,6,12,18
10103,POROMA,estado nutricional en menores de 5 anos,clasificacion e,2002-06-01,49,75,49,75,124
70103,PORONGO,estado nutricional en menores de 5 anos,clasificacion e,2002-06-01,1,0,1,0,1
70601,PORTACHUELO,estado nutricional en menores de 5 anos,clasificacion e,2002-06-01,8,7,8,7,15
70804,POSTRER VALLE,estado nutricional en menores de 5 anos,clasificacion e,2002-06-01,1,3,1,3,4
50101,POTOSI,estado nutricional en menores de 5 anos,clasificacion e,2002-06-01,150,107,150,107,257
10302,PRESTO,estado nutricional en menores de 5 anos,clasificacion e,2002-06-01,30,31,30,31,61
21201,PUCARANI,estado nutricional en menores de 5 anos,clasificacion e,2002-06-01,2,18,2,18,20
20401,PUERTO ACOSTA,estado nutricional en menores de 5 anos,clasificacion e,2002-06-01,14,6,14,6,20
20403,PUERTO CARABUCO,estado nutricional en menores de 5 anos,clasificacion e,2002-06-01,10,21,10,21,31
90301,PUERTO GONZALO MORENO,estado nutricional en menores de 5 anos,clasificacion e,2002-06-01,2,0,2,0,2
21204,PUERTO PEREZ,estado nutricional en menores de 5 anos,clasificacion e,2002-06-01,0,1,0,1,1
71402,PUERTO QUIJARRO,estado nutricional en menores de 5 anos,clasificacion e,2002-06-01,15,1,15,1,16
90201,PUERTO RICO,estado nutricional en menores de 5 anos,clasificacion e,2002-06-01,4,2,4,2,6
71401,PUERTO SUAREZ,estado nutricional en menores de 5 anos,clasificacion e,2002-06-01,4,4,4,4,8
31205,PUERTO VILLARROEL,estado nutricional en menores de 5 anos,clasificacion e,2002-06-01,42,29,42,29,71
51101,PUNA,estado nutricional en menores de 5 anos,clasificacion e,2002-06-01,7,62,7,62,69
31401,PUNATA,estado nutricional en menores de 5 anos,clasificacion e,2002-06-01,7,14,7,14,21
20604,QUIABAYA,estado nutricional en menores de 5 anos,clasificacion e,2002-06-01,8,4,8,4,12
30901,QUILLACOLLO,estado nutricional en menores de 5 anos,clasificacion e,2002-06-01,13,13,13,13,26
21002,QUIME,estado nutricional en menores de 5 anos,clasificacion e,2002-06-01,12,14,12,14,26
50402,RAVELO,estado nutricional en menores de 5 anos,clasificacion e,2002-06-01,80,151,80,151,231
80301,REYES,estado nutricional en menores de 5 anos,clasificacion e,2002-06-01,4,4,4,4,8
80201,RIBERALTA,estado nutricional en menores de 5 anos,clasificacion e,2002-06-01,109,56,109,56,165
70503,ROBORE,estado nutricional en menores de 5 anos,clasificacion e,2002-06-01,2,6,2,6,8
80304,RURRENABAQUE,estado nutricional en menores de 5 anos,clasificacion e,2002-06-01,4,3,4,3,7
31001,SACABA,estado nutricional en menores de 5 anos,clasificacion e,2002-06-01,14,33,14,33,47
30404,SACABAMBA,estado nutricional en menores de 5 anos,clasificacion e,2002-06-01,0,21,0,21,21
50701,SACACA,estado nutricional en menores de 5 anos,clasificacion e,2002-06-01,100,117,100,117,217
71302,SAIPINA,estado nutricional en menores de 5 anos,clasificacion e,2002-06-01,1,1,1,1,2
40801,SALINAS DE GARCI MENDOZA,estado nutricional en menores de 5 anos,clasificacion e,2002-06-01,3,1,3,1,4
51601,SAN AGUSTIN,estado nutricional en menores de 5 anos,clasificacion e,2002-06-01,0,1,0,1,1
80602,SAN ANDRES,estado nutricional en menores de 5 anos,clasificacion e,2002-06-01,4,8,4,8,12
51003,SAN ANTONIO DE ESMORUCO,estado nutricional en menores de 5 anos,clasificacion e,2002-06-01,0,1,0,1,1
71105,SAN ANTONIO DE LOMERIO,estado nutricional en menores de 5 anos,clasificacion e,2002-06-01,33,25,33,25,58
31403,SAN BENITO,estado nutricional en menores de 5 anos,clasificacion e,2002-06-01,2,5,2,5,7
80302,SAN BORJA,estado nutricional en menores de 5 anos,clasificacion e,2002-06-01,36,21,36,21,57
21502,SAN BUENA VENTURA,estado nutricional en menores de 5 anos,clasificacion e,2002-06-01,6,5,6,5,11
80501,SAN IGNACIO,estado nutricional en menores de 5 anos,clasificacion e,2002-06-01,6,28,6,28,34
70301,SAN IGNACIO DE VELASCO,estado nutricional en menores de 5 anos,clasificacion e,2002-06-01,70,46,70,46,116
80102,SAN JAVIER(BNI),estado nutricional en menores de 5 anos,clasificacion e,2002-06-01,9,6,9,6,15
71102,SAN JAVIER(STC),estado nutricional en menores de 5 anos,clasificacion e,2002-06-01,15,5,15,5,20
70501,SAN JOSE DE CHIQUITOS,estado nutricional en menores de 5 anos,clasificacion e,2002-06-01,16,1,16,1,17
71104,SAN JULIAN,estado nutricional en menores de 5 anos,clasificacion e,2002-06-01,20,20,20,20,40
90302,SAN LORENZO(PND),estado nutricional en menores de 5 anos,clasificacion e,2002-06-01,0,1,0,1,1
60501,SAN LORENZO(TJA),estado nutricional en menores de 5 anos,clasificacion e,2002-06-01,11,8,11,8,19
10702,SAN LUCAS,estado nutricional en menores de 5 anos,clasificacion e,2002-06-01,156,119,156,119,275
70302,SAN MIGUEL DE VELASCO,estado nutricional en menores de 5 anos,clasificacion e,2002-06-01,13,11,13,11,24
51001,SAN PABLO DE LIPEZ,estado nutricional en menores de 5 anos,clasificacion e,2002-06-01,0,6,0,6,6
50501,SAN PEDRO DE BUENA VISTA,estado nutricional en menores de 5 anos,clasificacion e,2002-06-01,1,95,1,95,96
21801,SAN PEDRO DE CURAHUARA,estado nutricional en menores de 5 anos,clasificacion e,2002-06-01,2,4,2,4,6
90202,SAN PEDRO(PND),estado nutricional en menores de 5 anos,clasificacion e,2002-06-01,5,4,5,4,9
70303,SAN RAFAEL,estado nutricional en menores de 5 anos,clasificacion e,2002-06-01,13,8,13,8,21
80702,SAN RAMON,estado nutricional en menores de 5 anos,clasificacion e,2002-06-01,5,4,5,4,9
80401,SANTA ANA,estado nutricional en menores de 5 anos,clasificacion e,2002-06-01,0,1,0,1,1
70101,SANTA CRUZ DE LA SIERRA,estado nutricional en menores de 5 anos,clasificacion e,2002-06-01,51,39,51,39,90
80303,SANTA ROSA,estado nutricional en menores de 5 anos,clasificacion e,2002-06-01,5,1,5,1,6
70602,SANTA ROSA DEL SARA,estado nutricional en menores de 5 anos,clasificacion e,2002-06-01,5,6,5,6,11
20308,SANTIAGO DE CALLAPA,estado nutricional en menores de 5 anos,clasificacion e,2002-06-01,1,0,1,0,1
41401,SANTIAGO DE HUARI,estado nutricional en menores de 5 anos,clasificacion e,2002-06-01,3,4,3,4,7
21901,SANTIAGO DE MACHACA,estado nutricional en menores de 5 anos,clasificacion e,2002-06-01,1,0,1,0,1
30702,SANTIVAÑES,estado nutricional en menores de 5 anos,clasificacion e,2002-06-01,7,5,7,5,12
40202,SANTUARIO DE QUILLACAS,estado nutricional en menores de 5 anos,clasificacion e,2002-06-01,0,1,0,1,1
20902,SAPAHAQUI,estado nutricional en menores de 5 anos,clasificacion e,2002-06-01,0,1,0,1,1
90303,SENA,estado nutricional en menores de 5 anos,clasificacion e,2002-06-01,9,4,9,4,13
21301,SICA SICA (VILLA AROMA),estado nutricional en menores de 5 anos,clasificacion e,2002-06-01,11,10,11,10,21
30703,SICAYA,estado nutricional en menores de 5 anos,clasificacion e,2002-06-01,1,12,1,12,13
30902,SIPE SIPE,estado nutricional en menores de 5 anos,clasificacion e,2002-06-01,42,26,42,26,68
10403,SOPACHUY,estado nutricional en menores de 5 anos,clasificacion e,2002-06-01,26,36,26,36,62
20601,SORATA,estado nutricional en menores de 5 anos,clasificacion e,2002-06-01,6,7,6,7,13
10101,SUCRE,estado nutricional en menores de 5 anos,clasificacion e,2002-06-01,157,107,157,107,264
31404,TACACHI,estado nutricional en menores de 5 anos,clasificacion e,2002-06-01,0,1,0,1,1
20603,TACACOMA,estado nutricional en menores de 5 anos,clasificacion e,2002-06-01,6,14,6,14,20
50303,TACOBAMBA,estado nutricional en menores de 5 anos,clasificacion e,2002-06-01,18,9,18,9,27
30602,TACOPAYA,estado nutricional en menores de 5 anos,clasificacion e,2002-06-01,10,20,10,20,30
31101,TAPACARI,estado nutricional en menores de 5 anos,clasificacion e,2002-06-01,3,58,3,58,61
10601,TARABUCO,estado nutricional en menores de 5 anos,clasificacion e,2002-06-01,140,156,140,156,296
30401,TARATA,estado nutricional en menores de 5 anos,clasificacion e,2002-06-01,13,9,13,9,22
60101,TARIJA,estado nutricional en menores de 5 anos,clasificacion e,2002-06-01,41,21,41,21,62
10202,TARVITA,estado nutricional en menores de 5 anos,clasificacion e,2002-06-01,39,38,39,38,77
20803,TIAWANACU,estado nutricional en menores de 5 anos,clasificacion e,2002-06-01,11,12,11,12,23
50102,TINGUIPAYA,estado nutricional en menores de 5 anos,clasificacion e,2002-06-01,7,50,7,50,57
30903,TIQUIPAYA,estado nutricional en menores de 5 anos,clasificacion e,2002-06-01,16,22,16,22,38
31601,TIRAQUE (CBBA),estado nutricional en menores de 5 anos,clasificacion e,2002-06-01,23,30,23,30,53
21703,TITO YUPANQUI (PARQUIPUJIO),estado nutricional en menores de 5 anos,clasificacion e,2002-06-01,3,1,3,1,4
30802,TOCO,estado nutricional en menores de 5 anos,clasificacion e,2002-06-01,1,5,1,5,6
30803,TOLATA,estado nutricional en menores de 5 anos,clasificacion e,2002-06-01,1,0,1,0,1
41001,TOLEDO,estado nutricional en menores de 5 anos,clasificacion e,2002-06-01,1,0,1,0,1
51202,TOMAVE,estado nutricional en menores de 5 anos,clasificacion e,2002-06-01,1,58,1,58,59
10402,TOMINA,estado nutricional en menores de 5 anos,clasificacion e,2002-06-01,37,40,37,40,77
50502,TORO TORO,estado nutricional en menores de 5 anos,clasificacion e,2002-06-01,0,5,0,5,5
31201,TOTORA(CBBA),estado nutricional en menores de 5 anos,clasificacion e,2002-06-01,12,11,12,11,23
41301,TOTORA(ORR),estado nutricional en menores de 5 anos,clasificacion e,2002-06-01,6,2,6,2,8
70802,TRIGAL,estado nutricional en menores de 5 anos,clasificacion e,2002-06-01,1,0,1,0,1
80101,TRINIDAD,estado nutricional en menores de 5 anos,clasificacion e,2002-06-01,23,50,23,50,73
50801,TUPIZA,estado nutricional en menores de 5 anos,clasificacion e,2002-06-01,0,43,0,43,43
40402,TURCO,estado nutricional en menores de 5 anos,clasificacion e,2002-06-01,1,1,1,1,2
21302,UMALA,estado nutricional en menores de 5 anos,clasificacion e,2002-06-01,0,2,0,2,2
50201,UNCIA,estado nutricional en menores de 5 anos,clasificacion e,2002-06-01,10,39,10,39,49
60401,URIONDO (A. CONCEPCION),estado nutricional en menores de 5 anos,clasificacion e,2002-06-01,2,5,2,5,7
71502,URUBICHA,estado nutricional en menores de 5 anos,clasificacion e,2002-06-01,18,52,18,52,70
51201,UYUNI,estado nutricional en menores de 5 anos,clasificacion e,2002-06-01,13,32,13,32,45
30502,VACAS,estado nutricional en menores de 5 anos,clasificacion e,2002-06-01,1,9,1,9,10
70801,VALLEGRANDE,estado nutricional en menores de 5 anos,clasificacion e,2002-06-01,4,14,4,14,18
20801,VIACHA,estado nutricional en menores de 5 anos,clasificacion e,2002-06-01,1,24,1,24,25
31302,VILA VILA,estado nutricional en menores de 5 anos,clasificacion e,2002-06-01,6,1,6,1,7
60303,VILLA MONTES,estado nutricional en menores de 5 anos,clasificacion e,2002-06-01,6,2,6,2,8
31402,VILLA RIVERO,estado nutricional en menores de 5 anos,clasificacion e,2002-06-01,0,8,0,8,8
10801,VILLA SERRANO,estado nutricional en menores de 5 anos,clasificacion e,2002-06-01,49,64,49,64,113
31003,VILLA TUNARI,estado nutricional en menores de 5 anos,clasificacion e,2002-06-01,40,35,40,35,75
11001,VILLA VACA GUZMAN (MUYUPAMPA),estado nutricional en menores de 5 anos,clasificacion e,2002-06-01,41,9,41,9,50
51501,VILLAZON,estado nutricional en menores de 5 anos,clasificacion e,2002-06-01,8,38,8,38,46
30904,VINTO,estado nutricional en menores de 5 anos,clasificacion e,2002-06-01,24,8,24,8,32
50602,VITICHI,estado nutricional en menores de 5 anos,clasificacion e,2002-06-01,11,15,11,15,26
20306,WALDO BALLIVIAN,estado nutricional en menores de 5 anos,clasificacion e,2002-06-01,1,0,1,0,1
70201,WARNES,estado nutricional en menores de 5 anos,clasificacion e,2002-06-01,20,6,20,6,26
20903,YACO,estado nutricional en menores de 5 anos,clasificacion e,2002-06-01,0,11,0,11,11
60301,YACUIBA,estado nutricional en menores de 5 anos,clasificacion e,2002-06-01,17,10,17,10,27
10602,YAMPARAEZ,estado nutricional en menores de 5 anos,clasificacion e,2002-06-01,64,42,64,42,106
50103,YOCALLA,estado nutricional en menores de 5 anos,clasificacion e,2002-06-01,0,13,0,13,13
10102,YOTALA,estado nutricional en menores de 5 anos,clasificacion e,2002-06-01,25,37,25,37,62
60402,YUNCHARA,estado nutricional en menores de 5 anos,clasificacion e,2002-06-01,2,7,2,7,9
10301,ZUDAÑEZ,estado nutricional en menores de 5 anos,clasificacion e,2002-06-01,43,25,43,25,68
51302,ACACIO,estado nutricional en menores de 5 anos,clasificacion e,2002-07-01,14,21,14,21,35
20201,ACHACACHI,estado nutricional en menores de 5 anos,clasificacion e,2002-07-01,17,14,17,14,31
20104,ACHOCALLA,estado nutricional en menores de 5 anos,clasificacion e,2002-07-01,3,0,3,0,3
30201,AIQUILE,estado nutricional en menores de 5 anos,clasificacion e,2002-07-01,8,16,8,16,24
31303,ALALAY,estado nutricional en menores de 5 anos,clasificacion e,2002-07-01,2,1,2,1,3
10404,ALCALA,estado nutricional en menores de 5 anos,clasificacion e,2002-07-01,15,18,15,18,33
20202,ANCORAIMES,estado nutricional en menores de 5 anos,clasificacion e,2002-07-01,13,18,13,18,31
40603,ANTEQUERA,estado nutricional en menores de 5 anos,clasificacion e,2002-07-01,0,1,0,1,1
30402,ANZALDO,estado nutricional en menores de 5 anos,clasificacion e,2002-07-01,0,24,0,24,24
20701,APOLO,estado nutricional en menores de 5 anos,clasificacion e,2002-07-01,13,10,13,10,23
51301,ARAMPAMPA,estado nutricional en menores de 5 anos,clasificacion e,2002-07-01,12,27,12,27,39
30501,ARANI,estado nutricional en menores de 5 anos,clasificacion e,2002-07-01,14,9,14,9,23
30403,ARBIETO,estado nutricional en menores de 5 anos,clasificacion e,2002-07-01,1,3,1,3,4
30601,ARQUE,estado nutricional en menores de 5 anos,clasificacion e,2002-07-01,25,17,25,17,42
50802,ATOCHA,estado nutricional en menores de 5 anos,clasificacion e,2002-07-01,0,17,0,17,17
20503,AUCAPATA,estado nutricional en menores de 5 anos,clasificacion e,2002-07-01,2,1,2,1,3
20502,AYATA,estado nutricional en menores de 5 anos,clasificacion e,2002-07-01,9,7,9,7,16
21303,AYO AYO,estado nutricional en menores de 5 anos,clasificacion e,2002-07-01,1,3,1,3,4
30301,AYOPAYA (V. DE INDEPENDENCIA),estado nutricional en menores de 5 anos,clasificacion e,2002-07-01,25,23,25,23,48
10201,AZURDUY,estado nutricional en menores de 5 anos,clasificacion e,2002-07-01,32,31,32,31,63
21203,BATALLAS,estado nutricional en menores de 5 anos,clasificacion e,2002-07-01,1,1,1,1,2
80802,BAURES,estado nutricional en menores de 5 anos,clasificacion e,2002-07-01,5,4,5,4,9
50104,BELEN DE URMIRI,estado nutricional en menores de 5 anos,clasificacion e,2002-07-01,1,4,1,4,5
60202,BERMEJO,estado nutricional en menores de 5 anos,clasificacion e,2002-07-01,1,9,1,9,10
50301,BETANZOS,estado nutricional en menores de 5 anos,clasificacion e,2002-07-01,93,95,93,95,188
31501,BOLIVAR,estado nutricional en menores de 5 anos,clasificacion e,2002-07-01,26,22,26,22,48
70707,BOYUIBE,estado nutricional en menores de 5 anos,clasificacion e,2002-07-01,0,7,0,7,7
70703,CABEZAS,estado nutricional en menores de 5 anos,clasificacion e,2002-07-01,4,4,4,4,8
20905,CAIROMA,estado nutricional en menores de 5 anos,clasificacion e,2002-07-01,10,11,10,11,21
51102,"CAIZA ""D""",estado nutricional en menores de 5 anos,clasificacion e,2002-07-01,24,13,24,13,37
21003,CAJUATA,estado nutricional en menores de 5 anos,clasificacion e,2002-07-01,6,1,6,1,7
20303,CALACOTO,estado nutricional en menores de 5 anos,clasificacion e,2002-07-01,3,1,3,1,4
21304,CALAMARCA,estado nutricional en menores de 5 anos,clasificacion e,2002-07-01,7,5,7,5,12
10701,CAMARGO,estado nutricional en menores de 5 anos,clasificacion e,2002-07-01,9,8,9,8,17
10901,CAMATAQUI (C. VILLA ABECIA),estado nutricional en menores de 5 anos,clasificacion e,2002-07-01,5,3,5,3,8
70706,CAMIRI,estado nutricional en menores de 5 anos,clasificacion e,2002-07-01,5,18,5,18,23
30701,CAPINOTA,estado nutricional en menores de 5 anos,clasificacion e,2002-07-01,11,24,11,24,35
20302,CAQUIAVIRI,estado nutricional en menores de 5 anos,clasificacion e,2002-07-01,2,2,2,2,4
40102,CARACOLLO,estado nutricional en menores de 5 anos,clasificacion e,2002-07-01,4,4,4,4,8
22001,CARANAVI,estado nutricional en menores de 5 anos,clasificacion e,2002-07-01,47,38,47,38,85
60302,CARAPARI,estado nutricional en menores de 5 anos,clasificacion e,2002-07-01,6,10,6,10,16
50702,CARIPUYO,estado nutricional en menores de 5 anos,clasificacion e,2002-07-01,27,19,27,19,46
21902,CATACORA,estado nutricional en menores de 5 anos,clasificacion e,2002-07-01,1,0,1,0,1
21803,CHACARILLA,estado nutricional en menores de 5 anos,clasificacion e,2002-07-01,0,2,0,2,2
40201,CHALLAPATA,estado nutricional en menores de 5 anos,clasificacion e,2002-07-01,15,16,15,16,31
50302,CHAQUI,estado nutricional en menores de 5 anos,clasificacion e,2002-07-01,18,8,18,8,26
70702,CHARAGUA,estado nutricional en menores de 5 anos,clasificacion e,2002-07-01,14,34,14,34,48
20305,CHARAÑA,estado nutricional en menores de 5 anos,clasificacion e,2002-07-01,5,2,5,2,7
50202,CHAYANTA,estado nutricional en menores de 5 anos,clasificacion e,2002-07-01,31,17,31,17,48
31204,CHIMORE,estado nutricional en menores de 5 anos,clasificacion e,2002-07-01,5,1,5,1,6
21101,CHULUMANI (V. DE LA LIBERTAD),estado nutricional en menores de 5 anos,clasificacion e,2002-07-01,2,3,2,3,5
20501,CHUMA,estado nutricional en menores de 5 anos,clasificacion e,2002-07-01,1,15,1,15,16
30801,CLIZA,estado nutricional en menores de 5 anos,clasificacion e,2002-07-01,3,9,3,9,12
90101,COBIJA,estado nutricional en menores de 5 anos,clasificacion e,2002-07-01,11,11,11,11,22
30101,COCHABAMBA,estado nutricional en menores de 5 anos,clasificacion e,2002-07-01,59,51,59,51,110
30905,COLCAPIRHUA,estado nutricional en menores de 5 anos,clasificacion e,2002-07-01,9,25,9,25,34
50901,"COLCHA ""K""",estado nutricional en menores de 5 anos,clasificacion e,2002-07-01,4,6,4,6,10
21307,COLLANA,estado nutricional en menores de 5 anos,clasificacion e,2002-07-01,1,0,1,0,1
31002,COLOMI,estado nutricional en menores de 5 anos,clasificacion e,2002-07-01,14,9,14,9,23
50401,COLQUECHACA,estado nutricional en menores de 5 anos,clasificacion e,2002-07-01,45,25,45,25,70
21306,COLQUENCHA,estado nutricional en menores de 5 anos,clasificacion e,2002-07-01,4,4,4,4,8
21004,COLQUIRI,estado nutricional en menores de 5 anos,clasificacion e,2002-07-01,12,7,12,7,19
20304,COMANCHE,estado nutricional en menores de 5 anos,clasificacion e,2002-07-01,0,1,0,1,1
71301,COMARAPA,estado nutricional en menores de 5 anos,clasificacion e,2002-07-01,20,24,20,24,44
20605,COMBAYA,estado nutricional en menores de 5 anos,clasificacion e,2002-07-01,0,1,0,1,1
71101,CONCEPCION,estado nutricional en menores de 5 anos,clasificacion e,2002-07-01,8,5,8,5,13
21701,COPACABANA,estado nutricional en menores de 5 anos,clasificacion e,2002-07-01,1,7,1,7,8
20301,CORO CORO,estado nutricional en menores de 5 anos,clasificacion e,2002-07-01,15,4,15,4,19
21401,COROICO,estado nutricional en menores de 5 anos,clasificacion e,2002-07-01,5,3,5,3,8
40301,CORQUE,estado nutricional en menores de 5 anos,clasificacion e,2002-07-01,3,2,3,2,5
50601,COTAGAITA,estado nutricional en menores de 5 anos,clasificacion e,2002-07-01,19,25,19,25,44
70102,COTOCA,estado nutricional en menores de 5 anos,clasificacion e,2002-07-01,8,2,8,2,10
31405,CUCHUMUELA (V. G. VILLARROEL),estado nutricional en menores de 5 anos,clasificacion e,2002-07-01,5,1,5,1,6
70704,CUEVO,estado nutricional en menores de 5 anos,clasificacion e,2002-07-01,4,2,4,2,6
10902,CULPINA,estado nutricional en menores de 5 anos,clasificacion e,2002-07-01,43,35,43,35,78
40401,CURAHUARA DE CARANGAS,estado nutricional en menores de 5 anos,clasificacion e,2002-07-01,4,1,4,1,5
21602,CURVA,estado nutricional en menores de 5 anos,clasificacion e,2002-07-01,1,1,1,1,2
20804,DESAGUADERO,estado nutricional en menores de 5 anos,clasificacion e,2002-07-01,8,0,8,0,8
20105,EL ALTO,estado nutricional en menores de 5 anos,clasificacion e,2002-07-01,402,259,402,259,661
71503,EL PUENTE(STC),estado nutricional en menores de 5 anos,clasificacion e,2002-07-01,0,28,0,28,28
60502,EL PUENTE(TJA),estado nutricional en menores de 5 anos,clasificacion e,2002-07-01,8,25,8,25,33
70105,EL TORNO,estado nutricional en menores de 5 anos,clasificacion e,2002-07-01,5,15,5,15,20
10405,EL VILLAR,estado nutricional en menores de 5 anos,clasificacion e,2002-07-01,23,26,23,26,49
60601,ENTRE RIOS,estado nutricional en menores de 5 anos,clasificacion e,2002-07-01,9,7,9,7,16
41101,EUCALIPTUS,estado nutricional en menores de 5 anos,clasificacion e,2002-07-01,1,2,1,2,3
80402,EXALTACION,estado nutricional en menores de 5 anos,clasificacion e,2002-07-01,0,1,0,1,1
90203,FILADELFIA,estado nutricional en menores de 5 anos,clasificacion e,2002-07-01,0,1,0,1,1
71002,GENERAL SAAVEDRA,estado nutricional en menores de 5 anos,clasificacion e,2002-07-01,22,10,22,10,32
21601,GRAL. J.J. PEREZ (CHARAZANI),estado nutricional en menores de 5 anos,clasificacion e,2002-07-01,1,1,1,1,2
20602,GUANAY,estado nutricional en menores de 5 anos,clasificacion e,2002-07-01,38,37,38,37,75
20802,GUAQUI,estado nutricional en menores de 5 anos,clasificacion e,2002-07-01,6,1,6,1,7
80202,GUAYARAMERIN,estado nutricional en menores de 5 anos,clasificacion e,2002-07-01,33,19,33,19,52
70705,GUTIERREZ,estado nutricional en menores de 5 anos,clasificacion e,2002-07-01,22,40,22,40,62
10502,HUACARETA,estado nutricional en menores de 5 anos,clasificacion e,2002-07-01,27,21,27,21,48
11002,HUACAYA (VILLA DE HUACAYA),estado nutricional en menores de 5 anos,clasificacion e,2002-07-01,2,1,2,1,3
40501,HUACHACALLA,estado nutricional en menores de 5 anos,clasificacion e,2002-07-01,0,1,0,1,1
40701,HUANUNI,estado nutricional en menores de 5 anos,clasificacion e,2002-07-01,15,6,15,6,21
80803,HUARACAJE,estado nutricional en menores de 5 anos,clasificacion e,2002-07-01,5,0,5,0,5
41601,HUAYLLAMARCA,estado nutricional en menores de 5 anos,clasificacion e,2002-07-01,7,3,7,3,10
21005,ICHOCA,estado nutricional en menores de 5 anos,clasificacion e,2002-07-01,1,0,1,0,1
10304,ICLA,estado nutricional en menores de 5 anos,clasificacion e,2002-07-01,67,69,67,69,136
10703,INCAHUASI,estado nutricional en menores de 5 anos,clasificacion e,2002-07-01,31,48,31,48,79
21001,INQUISIVI,estado nutricional en menores de 5 anos,clasificacion e,2002-07-01,16,35,16,35,51
21102,IRUPANA (VILLA DE LANZA),estado nutricional en menores de 5 anos,clasificacion e,2002-07-01,0,1,0,1,1
21501,IXIAMAS,estado nutricional en menores de 5 anos,clasificacion e,2002-07-01,5,6,5,6,11
21105,LA ASUNTA,estado nutricional en menores de 5 anos,clasificacion e,2002-07-01,7,11,7,11,18
70104,LA GUARDIA,estado nutricional en menores de 5 anos,clasificacion e,2002-07-01,11,7,11,7,18
20101,LA PAZ,estado nutricional en menores de 5 anos,clasificacion e,2002-07-01,237,140,237,140,377
70701,LAGUNILLAS,estado nutricional en menores de 5 anos,clasificacion e,2002-07-01,7,4,7,4,11
21202,LAJA,estado nutricional en menores de 5 anos,clasificacion e,2002-07-01,2,0,2,0,2
10903,LAS CARRERAS,estado nutricional en menores de 5 anos,clasificacion e,2002-07-01,7,6,7,6,13
21006,LICOMA PAMPA,estado nutricional en menores de 5 anos,clasificacion e,2002-07-01,1,0,1,0,1
50203,LLALLAGUA,estado nutricional en menores de 5 anos,clasificacion e,2002-07-01,4,75,4,75,79
80601,LORETO,estado nutricional en menores de 5 anos,clasificacion e,2002-07-01,0,2,0,2,2
20901,LURIBAY,estado nutricional en menores de 5 anos,clasificacion e,2002-07-01,2,6,2,6,8
40702,MACHACAMARCA,estado nutricional en menores de 5 anos,clasificacion e,2002-07-01,2,3,2,3,5
11003,MACHARETI,estado nutricional en menores de 5 anos,clasificacion e,2002-07-01,5,11,5,11,16
80801,MAGDALENA,estado nutricional en menores de 5 anos,clasificacion e,2002-07-01,8,4,8,4,12
70903,MAIRANA,estado nutricional en menores de 5 anos,clasificacion e,2002-07-01,5,1,5,1,6
20103,MECAPACA,estado nutricional en menores de 5 anos,clasificacion e,2002-07-01,2,3,2,3,5
71003,MINEROS,estado nutricional en menores de 5 anos,clasificacion e,2002-07-01,39,11,39,11,50
31301,MIZQUE,estado nutricional en menores de 5 anos,clasificacion e,2002-07-01,34,16,34,16,50
20402,MOCOMOCO,estado nutricional en menores de 5 anos,clasificacion e,2002-07-01,13,11,13,11,24
51002,MOJINETE,estado nutricional en menores de 5 anos,clasificacion e,2002-07-01,0,1,0,1,1
10303,MOJOCOYA,estado nutricional en menores de 5 anos,clasificacion e,2002-07-01,23,17,23,17,40
10501,MONTEAGUDO,estado nutricional en menores de 5 anos,clasificacion e,2002-07-01,39,45,39,45,84
71001,MONTERO,estado nutricional en menores de 5 anos,clasificacion e,2002-07-01,26,36,26,36,62
70803,MORO MORO,estado nutricional en menores de 5 anos,clasificacion e,2002-07-01,4,5,4,5,9
30302,MOROCHATA,estado nutricional en menores de 5 anos,clasificacion e,2002-07-01,25,19,25,19,44
90501,NUEVO MANOA (NUEVA ESPERANZA),estado nutricional en menores de 5 anos,clasificacion e,2002-07-01,1,3,1,3,4
50404,OCURI,estado nutricional en menores de 5 anos,clasificacion e,2002-07-01,42,24,42,24,66
70202,OKINAWA,estado nutricional en menores de 5 anos,clasificacion e,2002-07-01,3,7,3,7,10
30203,OMEREQUE,estado nutricional en menores de 5 anos,clasificacion e,2002-07-01,0,1,0,1,1
40101,ORURO,estado nutricional en menores de 5 anos,clasificacion e,2002-07-01,93,47,93,47,140
60201,PADCAYA,estado nutricional en menores de 5 anos,clasificacion e,2002-07-01,6,7,6,7,13
10401,PADILLA,estado nutricional en menores de 5 anos,clasificacion e,2002-07-01,28,51,28,51,79
70502,PAILON,estado nutricional en menores de 5 anos,clasificacion e,2002-07-01,10,2,10,2,12
20102,PALCA,estado nutricional en menores de 5 anos,clasificacion e,2002-07-01,6,9,6,9,15
21104,PALOS BLANCOS,estado nutricional en menores de 5 anos,clasificacion e,2002-07-01,11,20,11,20,31
40802,PAMPA AULLAGAS,estado nutricional en menores de 5 anos,clasificacion e,2002-07-01,1,2,1,2,3
70902,PAMPA GRANDE,estado nutricional en menores de 5 anos,clasificacion e,2002-07-01,2,3,2,3,5
21802,PAPEL PAMPA,estado nutricional en menores de 5 anos,clasificacion e,2002-07-01,1,0,1,0,1
30202,PASORAPA,estado nutricional en menores de 5 anos,clasificacion e,2002-07-01,9,7,9,7,16
21305,PATACAMAYA,estado nutricional en menores de 5 anos,clasificacion e,2002-07-01,15,3,15,3,18
40602,PAZÑA,estado nutricional en menores de 5 anos,clasificacion e,2002-07-01,5,2,5,2,7
20702,PELECHUCO,estado nutricional en menores de 5 anos,clasificacion e,2002-07-01,5,13,5,13,18
50403,POCOATA,estado nutricional en menores de 5 anos,clasificacion e,2002-07-01,25,24,25,24,49
31203,POCONA,estado nutricional en menores de 5 anos,clasificacion e,2002-07-01,9,16,9,16,25
31202,POJO (CBBA),estado nutricional en menores de 5 anos,clasificacion e,2002-07-01,32,25,32,25,57
40601,POOPO,estado nutricional en menores de 5 anos,clasificacion e,2002-07-01,0,5,0,5,5
51203,PORCO,estado nutricional en menores de 5 anos,clasificacion e,2002-07-01,3,4,3,4,7
10103,POROMA,estado nutricional en menores de 5 anos,clasificacion e,2002-07-01,39,19,39,19,58
70601,PORTACHUELO,estado nutricional en menores de 5 anos,clasificacion e,2002-07-01,10,3,10,3,13
90102,PORVENIR,estado nutricional en menores de 5 anos,clasificacion e,2002-07-01,0,1,0,1,1
50101,POTOSI,estado nutricional en menores de 5 anos,clasificacion e,2002-07-01,148,100,148,100,248
10302,PRESTO,estado nutricional en menores de 5 anos,clasificacion e,2002-07-01,29,34,29,34,63
21201,PUCARANI,estado nutricional en menores de 5 anos,clasificacion e,2002-07-01,0,8,0,8,8
20401,PUERTO ACOSTA,estado nutricional en menores de 5 anos,clasificacion e,2002-07-01,26,12,26,12,38
20403,PUERTO CARABUCO,estado nutricional en menores de 5 anos,clasificacion e,2002-07-01,14,11,14,11,25
90301,PUERTO GONZALO MORENO,estado nutricional en menores de 5 anos,clasificacion e,2002-07-01,5,1,5,1,6
21204,PUERTO PEREZ,estado nutricional en menores de 5 anos,clasificacion e,2002-07-01,1,0,1,0,1
71402,PUERTO QUIJARRO,estado nutricional en menores de 5 anos,clasificacion e,2002-07-01,6,0,6,0,6
90201,PUERTO RICO,estado nutricional en menores de 5 anos,clasificacion e,2002-07-01,2,5,2,5,7
80703,PUERTO SILES,estado nutricional en menores de 5 anos,clasificacion e,2002-07-01,1,3,1,3,4
71401,PUERTO SUAREZ,estado nutricional en menores de 5 anos,clasificacion e,2002-07-01,9,3,9,3,12
31205,PUERTO VILLARROEL,estado nutricional en menores de 5 anos,clasificacion e,2002-07-01,70,33,70,33,103
51101,PUNA,estado nutricional en menores de 5 anos,clasificacion e,2002-07-01,37,74,37,74,111
31401,PUNATA,estado nutricional en menores de 5 anos,clasificacion e,2002-07-01,6,6,6,6,12
20604,QUIABAYA,estado nutricional en menores de 5 anos,clasificacion e,2002-07-01,5,6,5,6,11
30901,QUILLACOLLO,estado nutricional en menores de 5 anos,clasificacion e,2002-07-01,10,6,10,6,16
21002,QUIME,estado nutricional en menores de 5 anos,clasificacion e,2002-07-01,3,3,3,3,6
50402,RAVELO,estado nutricional en menores de 5 anos,clasificacion e,2002-07-01,54,30,54,30,84
80201,RIBERALTA,estado nutricional en menores de 5 anos,clasificacion e,2002-07-01,98,88,98,88,186
70503,ROBORE,estado nutricional en menores de 5 anos,clasificacion e,2002-07-01,7,3,7,3,10
80304,RURRENABAQUE,estado nutricional en menores de 5 anos,clasificacion e,2002-07-01,4,2,4,2,6
40901,SABAYA,estado nutricional en menores de 5 anos,clasificacion e,2002-07-01,0,1,0,1,1
31001,SACABA,estado nutricional en menores de 5 anos,clasificacion e,2002-07-01,13,58,13,58,71
30404,SACABAMBA,estado nutricional en menores de 5 anos,clasificacion e,2002-07-01,1,26,1,26,27
50701,SACACA,estado nutricional en menores de 5 anos,clasificacion e,2002-07-01,47,60,47,60,107
71302,SAIPINA,estado nutricional en menores de 5 anos,clasificacion e,2002-07-01,0,1,0,1,1
40801,SALINAS DE GARCI MENDOZA,estado nutricional en menores de 5 anos,clasificacion e,2002-07-01,2,1,2,1,3
70901,SAMAIPATA,estado nutricional en menores de 5 anos,clasificacion e,2002-07-01,4,3,4,3,7
80602,SAN ANDRES,estado nutricional en menores de 5 anos,clasificacion e,2002-07-01,5,7,5,7,12
51003,SAN ANTONIO DE ESMORUCO,estado nutricional en menores de 5 anos,clasificacion e,2002-07-01,0,3,0,3,3
71105,SAN ANTONIO DE LOMERIO,estado nutricional en menores de 5 anos,clasificacion e,2002-07-01,37,38,37,38,75
31403,SAN BENITO,estado nutricional en menores de 5 anos,clasificacion e,2002-07-01,10,3,10,3,13
80302,SAN BORJA,estado nutricional en menores de 5 anos,clasificacion e,2002-07-01,21,12,21,12,33
21502,SAN BUENA VENTURA,estado nutricional en menores de 5 anos,clasificacion e,2002-07-01,8,19,8,19,27
80501,SAN IGNACIO,estado nutricional en menores de 5 anos,clasificacion e,2002-07-01,13,29,13,29,42
70301,SAN IGNACIO DE VELASCO,estado nutricional en menores de 5 anos,clasificacion e,2002-07-01,47,22,47,22,69
80102,SAN JAVIER(BNI),estado nutricional en menores de 5 anos,clasificacion e,2002-07-01,8,7,8,7,15
71102,SAN JAVIER(STC),estado nutricional en menores de 5 anos,clasificacion e,2002-07-01,8,11,8,11,19
80701,SAN JOAQUIN,estado nutricional en menores de 5 anos,clasificacion e,2002-07-01,2,5,2,5,7
70501,SAN JOSE DE CHIQUITOS,estado nutricional en menores de 5 anos,clasificacion e,2002-07-01,7,1,7,1,8
71104,SAN JULIAN,estado nutricional en menores de 5 anos,clasificacion e,2002-07-01,29,38,29,38,67
90302,SAN LORENZO(PND),estado nutricional en menores de 5 anos,clasificacion e,2002-07-01,3,6,3,6,9
60501,SAN LORENZO(TJA),estado nutricional en menores de 5 anos,clasificacion e,2002-07-01,14,31,14,31,45
10702,SAN LUCAS,estado nutricional en menores de 5 anos,clasificacion e,2002-07-01,118,65,118,65,183
71201,SAN MATIAS,estado nutricional en menores de 5 anos,clasificacion e,2002-07-01,0,5,0,5,5
70302,SAN MIGUEL DE VELASCO,estado nutricional en menores de 5 anos,clasificacion e,2002-07-01,8,22,8,22,30
51001,SAN PABLO DE LIPEZ,estado nutricional en menores de 5 anos,clasificacion e,2002-07-01,1,0,1,0,1
50501,SAN PEDRO DE BUENA VISTA,estado nutricional en menores de 5 anos,clasificacion e,2002-07-01,4,71,4,71,75
21801,SAN PEDRO DE CURAHUARA,estado nutricional en menores de 5 anos,clasificacion e,2002-07-01,2,2,2,2,4
21702,SAN PEDRO DE TIQUINA,estado nutricional en menores de 5 anos,clasificacion e,2002-07-01,1,0,1,0,1
70303,SAN RAFAEL,estado nutricional en menores de 5 anos,clasificacion e,2002-07-01,10,3,10,3,13
80401,SANTA ANA,estado nutricional en menores de 5 anos,clasificacion e,2002-07-01,1,1,1,1,2
70101,SANTA CRUZ DE LA SIERRA,estado nutricional en menores de 5 anos,clasificacion e,2002-07-01,99,38,99,38,137
70602,SANTA ROSA DEL SARA,estado nutricional en menores de 5 anos,clasificacion e,2002-07-01,3,0,3,0,3
41401,SANTIAGO DE HUARI,estado nutricional en menores de 5 anos,clasificacion e,2002-07-01,0,8,0,8,8
21901,SANTIAGO DE MACHACA,estado nutricional en menores de 5 anos,clasificacion e,2002-07-01,4,1,4,1,5
30702,SANTIVAÑES,estado nutricional en menores de 5 anos,clasificacion e,2002-07-01,4,1,4,1,5
40202,SANTUARIO DE QUILLACAS,estado nutricional en menores de 5 anos,clasificacion e,2002-07-01,3,7,3,7,10
20902,SAPAHAQUI,estado nutricional en menores de 5 anos,clasificacion e,2002-07-01,0,4,0,4,4
21301,SICA SICA (VILLA AROMA),estado nutricional en menores de 5 anos,clasificacion e,2002-07-01,6,4,6,4,10
30703,SICAYA,estado nutricional en menores de 5 anos,clasificacion e,2002-07-01,10,2,10,2,12
30902,SIPE SIPE,estado nutricional en menores de 5 anos,clasificacion e,2002-07-01,35,21,35,21,56
10403,SOPACHUY,estado nutricional en menores de 5 anos,clasificacion e,2002-07-01,33,23,33,23,56
20601,SORATA,estado nutricional en menores de 5 anos,clasificacion e,2002-07-01,10,4,10,4,14
10101,SUCRE,estado nutricional en menores de 5 anos,clasificacion e,2002-07-01,160,83,160,83,243
31404,TACACHI,estado nutricional en menores de 5 anos,clasificacion e,2002-07-01,2,2,2,2,4
20603,TACACOMA,estado nutricional en menores de 5 anos,clasificacion e,2002-07-01,5,9,5,9,14
50303,TACOBAMBA,estado nutricional en menores de 5 anos,clasificacion e,2002-07-01,12,11,12,11,23
30602,TACOPAYA,estado nutricional en menores de 5 anos,clasificacion e,2002-07-01,5,3,5,3,8
31101,TAPACARI,estado nutricional en menores de 5 anos,clasificacion e,2002-07-01,2,36,2,36,38
10601,TARABUCO,estado nutricional en menores de 5 anos,clasificacion e,2002-07-01,161,137,161,137,298
30401,TARATA,estado nutricional en menores de 5 anos,clasificacion e,2002-07-01,2,2,2,2,4
60101,TARIJA,estado nutricional en menores de 5 anos,clasificacion e,2002-07-01,39,20,39,20,59
10202,TARVITA,estado nutricional en menores de 5 anos,clasificacion e,2002-07-01,28,23,28,23,51
20803,TIAWANACU,estado nutricional en menores de 5 anos,clasificacion e,2002-07-01,6,5,6,5,11
50102,TINGUIPAYA,estado nutricional en menores de 5 anos,clasificacion e,2002-07-01,1,53,1,53,54
20606,TIPUANI,estado nutricional en menores de 5 anos,clasificacion e,2002-07-01,2,1,2,1,3
30903,TIQUIPAYA,estado nutricional en menores de 5 anos,clasificacion e,2002-07-01,6,11,6,11,17
31601,TIRAQUE (CBBA),estado nutricional en menores de 5 anos,clasificacion e,2002-07-01,8,49,8,49,57
21703,TITO YUPANQUI (PARQUIPUJIO),estado nutricional en menores de 5 anos,clasificacion e,2002-07-01,0,3,0,3,3
30802,TOCO,estado nutricional en menores de 5 anos,clasificacion e,2002-07-01,1,2,1,2,3
30803,TOLATA,estado nutricional en menores de 5 anos,clasificacion e,2002-07-01,1,0,1,0,1
41001,TOLEDO,estado nutricional en menores de 5 anos,clasificacion e,2002-07-01,1,1,1,1,2
51202,TOMAVE,estado nutricional en menores de 5 anos,clasificacion e,2002-07-01,13,18,13,18,31
10402,TOMINA,estado nutricional en menores de 5 anos,clasificacion e,2002-07-01,31,45,31,45,76
50502,TORO TORO,estado nutricional en menores de 5 anos,clasificacion e,2002-07-01,4,8,4,8,12
31201,TOTORA(CBBA),estado nutricional en menores de 5 anos,clasificacion e,2002-07-01,9,8,9,8,17
41301,TOTORA(ORR),estado nutricional en menores de 5 anos,clasificacion e,2002-07-01,0,2,0,2,2
70802,TRIGAL,estado nutricional en menores de 5 anos,clasificacion e,2002-07-01,1,1,1,1,2
80101,TRINIDAD,estado nutricional en menores de 5 anos,clasificacion e,2002-07-01,52,65,52,65,117
50801,TUPIZA,estado nutricional en menores de 5 anos,clasificacion e,2002-07-01,3,69,3,69,72
21302,UMALA,estado nutricional en menores de 5 anos,clasificacion e,2002-07-01,0,7,0,7,7
50201,UNCIA,estado nutricional en menores de 5 anos,clasificacion e,2002-07-01,6,21,6,21,27
60401,URIONDO (A. CONCEPCION),estado nutricional en menores de 5 anos,clasificacion e,2002-07-01,1,2,1,2,3
51201,UYUNI,estado nutricional en menores de 5 anos,clasificacion e,2002-07-01,11,22,11,22,33
30502,VACAS,estado nutricional en menores de 5 anos,clasificacion e,2002-07-01,0,11,0,11,11
70801,VALLEGRANDE,estado nutricional en menores de 5 anos,clasificacion e,2002-07-01,5,6,5,6,11
20801,VIACHA,estado nutricional en menores de 5 anos,clasificacion e,2002-07-01,7,20,7,20,27
31302,VILA VILA,estado nutricional en menores de 5 anos,clasificacion e,2002-07-01,7,9,7,9,16
60303,VILLA MONTES,estado nutricional en menores de 5 anos,clasificacion e,2002-07-01,8,7,8,7,15
31402,VILLA RIVERO,estado nutricional en menores de 5 anos,clasificacion e,2002-07-01,7,6,7,6,13
10801,VILLA SERRANO,estado nutricional en menores de 5 anos,clasificacion e,2002-07-01,57,79,57,79,136
31003,VILLA TUNARI,estado nutricional en menores de 5 anos,clasificacion e,2002-07-01,46,63,46,63,109
11001,VILLA VACA GUZMAN (MUYUPAMPA),estado nutricional en menores de 5 anos,clasificacion e,2002-07-01,25,15,25,15,40
51501,VILLAZON,estado nutricional en menores de 5 anos,clasificacion e,2002-07-01,7,22,7,22,29
30904,VINTO,estado nutricional en menores de 5 anos,clasificacion e,2002-07-01,18,8,18,8,26
50602,VITICHI,estado nutricional en menores de 5 anos,clasificacion e,2002-07-01,3,6,3,6,9
20306,WALDO BALLIVIAN,estado nutricional en menores de 5 anos,clasificacion e,2002-07-01,4,0,4,0,4
70201,WARNES,estado nutricional en menores de 5 anos,clasificacion e,2002-07-01,35,21,35,21,56
20903,YACO,estado nutricional en menores de 5 anos,clasificacion e,2002-07-01,0,4,0,4,4
60301,YACUIBA,estado nutricional en menores de 5 anos,clasificacion e,2002-07-01,15,4,15,4,19
10602,YAMPARAEZ,estado nutricional en menores de 5 anos,clasificacion e,2002-07-01,65,42,65,42,107
50103,YOCALLA,estado nutricional en menores de 5 anos,clasificacion e,2002-07-01,0,12,0,12,12
10102,YOTALA,estado nutricional en menores de 5 anos,clasificacion e,2002-07-01,33,31,33,31,64
60402,YUNCHARA,estado nutricional en menores de 5 anos,clasificacion e,2002-07-01,2,11,2,11,13
10301,ZUDAÑEZ,estado nutricional en menores de 5 anos,clasificacion e,2002-07-01,39,40,39,40,79
51302,ACACIO,estado nutricional en menores de 5 anos,clasificacion e,2002-08-01,27,40,27,40,67
20201,ACHACACHI,estado nutricional en menores de 5 anos,clasificacion e,2002-08-01,32,24,32,24,56
20104,ACHOCALLA,estado nutricional en menores de 5 anos,clasificacion e,2002-08-01,9,6,9,6,15
30201,AIQUILE,estado nutricional en menores de 5 anos,clasificacion e,2002-08-01,13,17,13,17,30
31303,ALALAY,estado nutricional en menores de 5 anos,clasificacion e,2002-08-01,2,5,2,5,7
10404,ALCALA,estado nutricional en menores de 5 anos,clasificacion e,2002-08-01,21,21,21,21,42
20202,ANCORAIMES,estado nutricional en menores de 5 anos,clasificacion e,2002-08-01,17,20,17,20,37
30402,ANZALDO,estado nutricional en menores de 5 anos,clasificacion e,2002-08-01,2,27,2,27,29
20701,APOLO,estado nutricional en menores de 5 anos,clasificacion e,2002-08-01,8,10,8,10,18
51301,ARAMPAMPA,estado nutricional en menores de 5 anos,clasificacion e,2002-08-01,13,15,13,15,28
30403,ARBIETO,estado nutricional en menores de 5 anos,clasificacion e,2002-08-01,0,7,0,7,7
30601,ARQUE,estado nutricional en menores de 5 anos,clasificacion e,2002-08-01,16,14,16,14,30
71501,ASCENCION DE GUARAYOS,estado nutricional en menores de 5 anos,clasificacion e,2002-08-01,69,71,69,71,140
50802,ATOCHA,estado nutricional en menores de 5 anos,clasificacion e,2002-08-01,1,5,1,5,6
20503,AUCAPATA,estado nutricional en menores de 5 anos,clasificacion e,2002-08-01,12,3,12,3,15
20502,AYATA,estado nutricional en menores de 5 anos,clasificacion e,2002-08-01,12,5,12,5,17
21303,AYO AYO,estado nutricional en menores de 5 anos,clasificacion e,2002-08-01,4,0,4,0,4
30301,AYOPAYA (V. DE INDEPENDENCIA),estado nutricional en menores de 5 anos,clasificacion e,2002-08-01,26,26,26,26,52
10201,AZURDUY,estado nutricional en menores de 5 anos,clasificacion e,2002-08-01,68,54,68,54,122
21203,BATALLAS,estado nutricional en menores de 5 anos,clasificacion e,2002-08-01,2,13,2,13,15
80802,BAURES,estado nutricional en menores de 5 anos,clasificacion e,2002-08-01,6,5,6,5,11
41202,BELEN DE ANDAMARCA,estado nutricional en menores de 5 anos,clasificacion e,2002-08-01,0,1,0,1,1
50104,BELEN DE URMIRI,estado nutricional en menores de 5 anos,clasificacion e,2002-08-01,0,1,0,1,1
60202,BERMEJO,estado nutricional en menores de 5 anos,clasificacion e,2002-08-01,1,3,1,3,4
50301,BETANZOS,estado nutricional en menores de 5 anos,clasificacion e,2002-08-01,62,60,62,60,122
31501,BOLIVAR,estado nutricional en menores de 5 anos,clasificacion e,2002-08-01,8,11,8,11,19
70707,BOYUIBE,estado nutricional en menores de 5 anos,clasificacion e,2002-08-01,0,2,0,2,2
70703,CABEZAS,estado nutricional en menores de 5 anos,clasificacion e,2002-08-01,2,8,2,8,10
20905,CAIROMA,estado nutricional en menores de 5 anos,clasificacion e,2002-08-01,27,9,27,9,36
51102,"CAIZA ""D""",estado nutricional en menores de 5 anos,clasificacion e,2002-08-01,27,21,27,21,48
21003,CAJUATA,estado nutricional en menores de 5 anos,clasificacion e,2002-08-01,12,8,12,8,20
20303,CALACOTO,estado nutricional en menores de 5 anos,clasificacion e,2002-08-01,9,1,9,1,10
21304,CALAMARCA,estado nutricional en menores de 5 anos,clasificacion e,2002-08-01,16,11,16,11,27
10701,CAMARGO,estado nutricional en menores de 5 anos,clasificacion e,2002-08-01,2,14,2,14,16
10901,CAMATAQUI (C. VILLA ABECIA),estado nutricional en menores de 5 anos,clasificacion e,2002-08-01,4,4,4,4,8
70706,CAMIRI,estado nutricional en menores de 5 anos,clasificacion e,2002-08-01,53,37,53,37,90
30701,CAPINOTA,estado nutricional en menores de 5 anos,clasificacion e,2002-08-01,21,35,21,35,56
20302,CAQUIAVIRI,estado nutricional en menores de 5 anos,clasificacion e,2002-08-01,5,4,5,4,9
40102,CARACOLLO,estado nutricional en menores de 5 anos,clasificacion e,2002-08-01,2,7,2,7,9
22001,CARANAVI,estado nutricional en menores de 5 anos,clasificacion e,2002-08-01,37,43,37,43,80
60302,CARAPARI,estado nutricional en menores de 5 anos,clasificacion e,2002-08-01,3,4,3,4,7
50702,CARIPUYO,estado nutricional en menores de 5 anos,clasificacion e,2002-08-01,31,26,31,26,57
21902,CATACORA,estado nutricional en menores de 5 anos,clasificacion e,2002-08-01,2,1,2,1,3
40201,CHALLAPATA,estado nutricional en menores de 5 anos,clasificacion e,2002-08-01,24,21,24,21,45
50302,CHAQUI,estado nutricional en menores de 5 anos,clasificacion e,2002-08-01,11,9,11,9,20
70702,CHARAGUA,estado nutricional en menores de 5 anos,clasificacion e,2002-08-01,11,27,11,27,38
20305,CHARAÑA,estado nutricional en menores de 5 anos,clasificacion e,2002-08-01,5,7,5,7,12
31204,CHIMORE,estado nutricional en menores de 5 anos,clasificacion e,2002-08-01,2,2,2,2,4
40302,CHOQUE COTA,estado nutricional en menores de 5 anos,clasificacion e,2002-08-01,1,0,1,0,1
21101,CHULUMANI (V. DE LA LIBERTAD),estado nutricional en menores de 5 anos,clasificacion e,2002-08-01,3,2,3,2,5
20501,CHUMA,estado nutricional en menores de 5 anos,clasificacion e,2002-08-01,14,8,14,8,22
30801,CLIZA,estado nutricional en menores de 5 anos,clasificacion e,2002-08-01,5,10,5,10,15
90101,COBIJA,estado nutricional en menores de 5 anos,clasificacion e,2002-08-01,22,22,22,22,44
30101,COCHABAMBA,estado nutricional en menores de 5 anos,clasificacion e,2002-08-01,68,58,68,58,126
30905,COLCAPIRHUA,estado nutricional en menores de 5 anos,clasificacion e,2002-08-01,14,3,14,3,17
50901,"COLCHA ""K""",estado nutricional en menores de 5 anos,clasificacion e,2002-08-01,7,8,7,8,15
31002,COLOMI,estado nutricional en menores de 5 anos,clasificacion e,2002-08-01,13,24,13,24,37
50401,COLQUECHACA,estado nutricional en menores de 5 anos,clasificacion e,2002-08-01,73,36,73,36,109
21306,COLQUENCHA,estado nutricional en menores de 5 anos,clasificacion e,2002-08-01,6,13,6,13,19
21004,COLQUIRI,estado nutricional en menores de 5 anos,clasificacion e,2002-08-01,38,11,38,11,49
20304,COMANCHE,estado nutricional en menores de 5 anos,clasificacion e,2002-08-01,1,5,1,5,6
71301,COMARAPA,estado nutricional en menores de 5 anos,clasificacion e,2002-08-01,24,15,24,15,39
20605,COMBAYA,estado nutricional en menores de 5 anos,clasificacion e,2002-08-01,2,4,2,4,6
71101,CONCEPCION,estado nutricional en menores de 5 anos,clasificacion e,2002-08-01,4,0,4,0,4
21701,COPACABANA,estado nutricional en menores de 5 anos,clasificacion e,2002-08-01,4,1,4,1,5
21402,CORIPATA,estado nutricional en menores de 5 anos,clasificacion e,2002-08-01,5,2,5,2,7
20301,CORO CORO,estado nutricional en menores de 5 anos,clasificacion e,2002-08-01,8,10,8,10,18
21401,COROICO,estado nutricional en menores de 5 anos,clasificacion e,2002-08-01,2,3,2,3,5
40301,CORQUE,estado nutricional en menores de 5 anos,clasificacion e,2002-08-01,5,2,5,2,7
50601,COTAGAITA,estado nutricional en menores de 5 anos,clasificacion e,2002-08-01,24,44,24,44,68
70102,COTOCA,estado nutricional en menores de 5 anos,clasificacion e,2002-08-01,18,4,18,4,22
70704,CUEVO,estado nutricional en menores de 5 anos,clasificacion e,2002-08-01,3,1,3,1,4
10902,CULPINA,estado nutricional en menores de 5 anos,clasificacion e,2002-08-01,59,52,59,52,111
40401,CURAHUARA DE CARANGAS,estado nutricional en menores de 5 anos,clasificacion e,2002-08-01,2,1,2,1,3
20804,DESAGUADERO,estado nutricional en menores de 5 anos,clasificacion e,2002-08-01,11,2,11,2,13
20105,EL ALTO,estado nutricional en menores de 5 anos,clasificacion e,2002-08-01,344,241,344,241,585
40103,EL CHORO,estado nutricional en menores de 5 anos,clasificacion e,2002-08-01,0,1,0,1,1
71503,EL PUENTE(STC),estado nutricional en menores de 5 anos,clasificacion e,2002-08-01,2,23,2,23,25
60502,EL PUENTE(TJA),estado nutricional en menores de 5 anos,clasificacion e,2002-08-01,5,5,5,5,10
70105,EL TORNO,estado nutricional en menores de 5 anos,clasificacion e,2002-08-01,7,6,7,6,13
10405,EL VILLAR,estado nutricional en menores de 5 anos,clasificacion e,2002-08-01,22,30,22,30,52
60601,ENTRE RIOS,estado nutricional en menores de 5 anos,clasificacion e,2002-08-01,5,3,5,3,8
41101,EUCALIPTUS,estado nutricional en menores de 5 anos,clasificacion e,2002-08-01,4,16,4,16,20
80402,EXALTACION,estado nutricional en menores de 5 anos,clasificacion e,2002-08-01,1,5,1,5,6
90203,FILADELFIA,estado nutricional en menores de 5 anos,clasificacion e,2002-08-01,1,3,1,3,4
71002,GENERAL SAAVEDRA,estado nutricional en menores de 5 anos,clasificacion e,2002-08-01,12,13,12,13,25
21601,GRAL. J.J. PEREZ (CHARAZANI),estado nutricional en menores de 5 anos,clasificacion e,2002-08-01,2,22,2,22,24
20602,GUANAY,estado nutricional en menores de 5 anos,clasificacion e,2002-08-01,33,20,33,20,53
20802,GUAQUI,estado nutricional en menores de 5 anos,clasificacion e,2002-08-01,2,2,2,2,4
80202,GUAYARAMERIN,estado nutricional en menores de 5 anos,clasificacion e,2002-08-01,30,19,30,19,49
70705,GUTIERREZ,estado nutricional en menores de 5 anos,clasificacion e,2002-08-01,36,33,36,33,69
10502,HUACARETA,estado nutricional en menores de 5 anos,clasificacion e,2002-08-01,15,11,15,11,26
11002,HUACAYA (VILLA DE HUACAYA),estado nutricional en menores de 5 anos,clasificacion e,2002-08-01,2,4,2,4,6
40501,HUACHACALLA,estado nutricional en menores de 5 anos,clasificacion e,2002-08-01,1,0,1,0,1
40701,HUANUNI,estado nutricional en menores de 5 anos,clasificacion e,2002-08-01,13,7,13,7,20
41601,HUAYLLAMARCA,estado nutricional en menores de 5 anos,clasificacion e,2002-08-01,1,2,1,2,3
21005,ICHOCA,estado nutricional en menores de 5 anos,clasificacion e,2002-08-01,9,8,9,8,17
10304,ICLA,estado nutricional en menores de 5 anos,clasificacion e,2002-08-01,64,93,64,93,157
10703,INCAHUASI,estado nutricional en menores de 5 anos,clasificacion e,2002-08-01,28,43,28,43,71
21001,INQUISIVI,estado nutricional en menores de 5 anos,clasificacion e,2002-08-01,13,32,13,32,45
21102,IRUPANA (VILLA DE LANZA),estado nutricional en menores de 5 anos,clasificacion e,2002-08-01,1,1,1,1,2
21501,IXIAMAS,estado nutricional en menores de 5 anos,clasificacion e,2002-08-01,5,8,5,8,13
21105,LA ASUNTA,estado nutricional en menores de 5 anos,clasificacion e,2002-08-01,5,9,5,9,14
70104,LA GUARDIA,estado nutricional en menores de 5 anos,clasificacion e,2002-08-01,11,6,11,6,17
20101,LA PAZ,estado nutricional en menores de 5 anos,clasificacion e,2002-08-01,200,153,200,153,353
70701,LAGUNILLAS,estado nutricional en menores de 5 anos,clasificacion e,2002-08-01,7,11,7,11,18
21202,LAJA,estado nutricional en menores de 5 anos,clasificacion e,2002-08-01,5,2,5,2,7
10903,LAS CARRERAS,estado nutricional en menores de 5 anos,clasificacion e,2002-08-01,6,10,6,10,16
21006,LICOMA PAMPA,estado nutricional en menores de 5 anos,clasificacion e,2002-08-01,2,1,2,1,3
50203,LLALLAGUA,estado nutricional en menores de 5 anos,clasificacion e,2002-08-01,0,6,0,6,6
51401,LLICA,estado nutricional en menores de 5 anos,clasificacion e,2002-08-01,3,1,3,1,4
20901,LURIBAY,estado nutricional en menores de 5 anos,clasificacion e,2002-08-01,2,0,2,0,2
40702,MACHACAMARCA,estado nutricional en menores de 5 anos,clasificacion e,2002-08-01,2,1,2,1,3
11003,MACHARETI,estado nutricional en menores de 5 anos,clasificacion e,2002-08-01,8,15,8,15,23
80801,MAGDALENA,estado nutricional en menores de 5 anos,clasificacion e,2002-08-01,1,3,1,3,4
70903,MAIRANA,estado nutricional en menores de 5 anos,clasificacion e,2002-08-01,3,6,3,6,9
20103,MECAPACA,estado nutricional en menores de 5 anos,clasificacion e,2002-08-01,2,3,2,3,5
71003,MINEROS,estado nutricional en menores de 5 anos,clasificacion e,2002-08-01,26,8,26,8,34
31301,MIZQUE,estado nutricional en menores de 5 anos,clasificacion e,2002-08-01,10,9,10,9,19
20402,MOCOMOCO,estado nutricional en menores de 5 anos,clasificacion e,2002-08-01,18,18,18,18,36
10303,MOJOCOYA,estado nutricional en menores de 5 anos,clasificacion e,2002-08-01,24,19,24,19,43
10501,MONTEAGUDO,estado nutricional en menores de 5 anos,clasificacion e,2002-08-01,33,30,33,30,63
71001,MONTERO,estado nutricional en menores de 5 anos,clasificacion e,2002-08-01,24,16,24,16,40
70803,MORO MORO,estado nutricional en menores de 5 anos,clasificacion e,2002-08-01,1,1,1,1,2
30302,MOROCHATA,estado nutricional en menores de 5 anos,clasificacion e,2002-08-01,13,15,13,15,28
90401,NACEBE (SANTA ROSA DEL ABUNA),estado nutricional en menores de 5 anos,clasificacion e,2002-08-01,0,1,0,1,1
20307,NAZACARA DE PACAJES,estado nutricional en menores de 5 anos,clasificacion e,2002-08-01,1,1,1,1,2
50404,OCURI,estado nutricional en menores de 5 anos,clasificacion e,2002-08-01,43,32,43,32,75
70202,OKINAWA,estado nutricional en menores de 5 anos,clasificacion e,2002-08-01,1,2,1,2,3
30203,OMEREQUE,estado nutricional en menores de 5 anos,clasificacion e,2002-08-01,0,1,0,1,1
40101,ORURO,estado nutricional en menores de 5 anos,clasificacion e,2002-08-01,71,51,71,51,122
60201,PADCAYA,estado nutricional en menores de 5 anos,clasificacion e,2002-08-01,6,3,6,3,9
10401,PADILLA,estado nutricional en menores de 5 anos,clasificacion e,2002-08-01,33,50,33,50,83
70502,PAILON,estado nutricional en menores de 5 anos,clasificacion e,2002-08-01,5,5,5,5,10
20102,PALCA,estado nutricional en menores de 5 anos,clasificacion e,2002-08-01,10,11,10,11,21
21104,PALOS BLANCOS,estado nutricional en menores de 5 anos,clasificacion e,2002-08-01,17,17,17,17,34
40802,PAMPA AULLAGAS,estado nutricional en menores de 5 anos,clasificacion e,2002-08-01,7,1,7,1,8
70902,PAMPA GRANDE,estado nutricional en menores de 5 anos,clasificacion e,2002-08-01,3,2,3,2,5
21802,PAPEL PAMPA,estado nutricional en menores de 5 anos,clasificacion e,2002-08-01,1,3,1,3,4
30202,PASORAPA,estado nutricional en menores de 5 anos,clasificacion e,2002-08-01,2,11,2,11,13
21305,PATACAMAYA,estado nutricional en menores de 5 anos,clasificacion e,2002-08-01,2,4,2,4,6
40602,PAZÑA,estado nutricional en menores de 5 anos,clasificacion e,2002-08-01,1,2,1,2,3
20702,PELECHUCO,estado nutricional en menores de 5 anos,clasificacion e,2002-08-01,11,6,11,6,17
50403,POCOATA,estado nutricional en menores de 5 anos,clasificacion e,2002-08-01,36,29,36,29,65
31203,POCONA,estado nutricional en menores de 5 anos,clasificacion e,2002-08-01,20,15,20,15,35
31202,POJO (CBBA),estado nutricional en menores de 5 anos,clasificacion e,2002-08-01,57,21,57,21,78
40601,POOPO,estado nutricional en menores de 5 anos,clasificacion e,2002-08-01,5,1,5,1,6
51203,PORCO,estado nutricional en menores de 5 anos,clasificacion e,2002-08-01,6,2,6,2,8
10103,POROMA,estado nutricional en menores de 5 anos,clasificacion e,2002-08-01,39,50,39,50,89
70103,PORONGO,estado nutricional en menores de 5 anos,clasificacion e,2002-08-01,5,4,5,4,9
70601,PORTACHUELO,estado nutricional en menores de 5 anos,clasificacion e,2002-08-01,8,2,8,2,10
70804,POSTRER VALLE,estado nutricional en menores de 5 anos,clasificacion e,2002-08-01,1,0,1,0,1
50101,POTOSI,estado nutricional en menores de 5 anos,clasificacion e,2002-08-01,128,69,128,69,197
10302,PRESTO,estado nutricional en menores de 5 anos,clasificacion e,2002-08-01,24,19,24,19,43
70805,PUCARA,estado nutricional en menores de 5 anos,clasificacion e,2002-08-01,0,2,0,2,2
21201,PUCARANI,estado nutricional en menores de 5 anos,clasificacion e,2002-08-01,3,4,3,4,7
20401,PUERTO ACOSTA,estado nutricional en menores de 5 anos,clasificacion e,2002-08-01,22,17,22,17,39
20403,PUERTO CARABUCO,estado nutricional en menores de 5 anos,clasificacion e,2002-08-01,16,15,16,15,31
90301,PUERTO GONZALO MORENO,estado nutricional en menores de 5 anos,clasificacion e,2002-08-01,9,1,9,1,10
21204,PUERTO PEREZ,estado nutricional en menores de 5 anos,clasificacion e,2002-08-01,0,1,0,1,1
71402,PUERTO QUIJARRO,estado nutricional en menores de 5 anos,clasificacion e,2002-08-01,12,4,12,4,16
90201,PUERTO RICO,estado nutricional en menores de 5 anos,clasificacion e,2002-08-01,4,4,4,4,8
80703,PUERTO SILES,estado nutricional en menores de 5 anos,clasificacion e,2002-08-01,0,1,0,1,1
71401,PUERTO SUAREZ,estado nutricional en menores de 5 anos,clasificacion e,2002-08-01,14,8,14,8,22
31205,PUERTO VILLARROEL,estado nutricional en menores de 5 anos,clasificacion e,2002-08-01,36,44,36,44,80
51101,PUNA,estado nutricional en menores de 5 anos,clasificacion e,2002-08-01,18,45,18,45,63
20604,QUIABAYA,estado nutricional en menores de 5 anos,clasificacion e,2002-08-01,7,2,7,2,9
30901,QUILLACOLLO,estado nutricional en menores de 5 anos,clasificacion e,2002-08-01,10,0,10,0,10
21002,QUIME,estado nutricional en menores de 5 anos,clasificacion e,2002-08-01,10,3,10,3,13
70904,QUIRUSILLAS,estado nutricional en menores de 5 anos,clasificacion e,2002-08-01,1,0,1,0,1
50402,RAVELO,estado nutricional en menores de 5 anos,clasificacion e,2002-08-01,71,47,71,47,118
80301,REYES,estado nutricional en menores de 5 anos,clasificacion e,2002-08-01,2,5,2,5,7
80201,RIBERALTA,estado nutricional en menores de 5 anos,clasificacion e,2002-08-01,161,74,161,74,235
70503,ROBORE,estado nutricional en menores de 5 anos,clasificacion e,2002-08-01,6,2,6,2,8
80304,RURRENABAQUE,estado nutricional en menores de 5 anos,clasificacion e,2002-08-01,3,0,3,0,3
40901,SABAYA,estado nutricional en menores de 5 anos,clasificacion e,2002-08-01,0,1,0,1,1
31001,SACABA,estado nutricional en menores de 5 anos,clasificacion e,2002-08-01,35,18,35,18,53
30404,SACABAMBA,estado nutricional en menores de 5 anos,clasificacion e,2002-08-01,0,45,0,45,45
50701,SACACA,estado nutricional en menores de 5 anos,clasificacion e,2002-08-01,70,58,70,58,128
71302,SAIPINA,estado nutricional en menores de 5 anos,clasificacion e,2002-08-01,1,2,1,2,3
40801,SALINAS DE GARCI MENDOZA,estado nutricional en menores de 5 anos,clasificacion e,2002-08-01,3,3,3,3,6
70901,SAMAIPATA,estado nutricional en menores de 5 anos,clasificacion e,2002-08-01,4,3,4,3,7
80602,SAN ANDRES,estado nutricional en menores de 5 anos,clasificacion e,2002-08-01,10,7,10,7,17
71105,SAN ANTONIO DE LOMERIO,estado nutricional en menores de 5 anos,clasificacion e,2002-08-01,31,33,31,33,64
31403,SAN BENITO,estado nutricional en menores de 5 anos,clasificacion e,2002-08-01,0,3,0,3,3
80302,SAN BORJA,estado nutricional en menores de 5 anos,clasificacion e,2002-08-01,34,22,34,22,56
21502,SAN BUENA VENTURA,estado nutricional en menores de 5 anos,clasificacion e,2002-08-01,6,9,6,9,15
80501,SAN IGNACIO,estado nutricional en menores de 5 anos,clasificacion e,2002-08-01,27,31,27,31,58
70301,SAN IGNACIO DE VELASCO,estado nutricional en menores de 5 anos,clasificacion e,2002-08-01,66,36,66,36,102
80102,SAN JAVIER(BNI),estado nutricional en menores de 5 anos,clasificacion e,2002-08-01,8,2,8,2,10
71102,SAN JAVIER(STC),estado nutricional en menores de 5 anos,clasificacion e,2002-08-01,15,7,15,7,22
80701,SAN JOAQUIN,estado nutricional en menores de 5 anos,clasificacion e,2002-08-01,0,6,0,6,6
70501,SAN JOSE DE CHIQUITOS,estado nutricional en menores de 5 anos,clasificacion e,2002-08-01,6,1,6,1,7
71104,SAN JULIAN,estado nutricional en menores de 5 anos,clasificacion e,2002-08-01,50,32,50,32,82
60501,SAN LORENZO(TJA),estado nutricional en menores de 5 anos,clasificacion e,2002-08-01,9,9,9,9,18
10702,SAN LUCAS,estado nutricional en menores de 5 anos,clasificacion e,2002-08-01,131,80,131,80,211
71201,SAN MATIAS,estado nutricional en menores de 5 anos,clasificacion e,2002-08-01,19,20,19,20,39
70302,SAN MIGUEL DE VELASCO,estado nutricional en menores de 5 anos,clasificacion e,2002-08-01,9,8,9,8,17
50501,SAN PEDRO DE BUENA VISTA,estado nutricional en menores de 5 anos,clasificacion e,2002-08-01,33,107,33,107,140
21801,SAN PEDRO DE CURAHUARA,estado nutricional en menores de 5 anos,clasificacion e,2002-08-01,0,3,0,3,3
21702,SAN PEDRO DE TIQUINA,estado nutricional en menores de 5 anos,clasificacion e,2002-08-01,0,1,0,1,1
70303,SAN RAFAEL,estado nutricional en menores de 5 anos,clasificacion e,2002-08-01,9,5,9,5,14
80702,SAN RAMON,estado nutricional en menores de 5 anos,clasificacion e,2002-08-01,0,4,0,4,4
80401,SANTA ANA,estado nutricional en menores de 5 anos,clasificacion e,2002-08-01,6,1,6,1,7
70101,SANTA CRUZ DE LA SIERRA,estado nutricional en menores de 5 anos,clasificacion e,2002-08-01,81,55,81,55,136
80303,SANTA ROSA,estado nutricional en menores de 5 anos,clasificacion e,2002-08-01,4,1,4,1,5
70602,SANTA ROSA DEL SARA,estado nutricional en menores de 5 anos,clasificacion e,2002-08-01,3,0,3,0,3
20308,SANTIAGO DE CALLAPA,estado nutricional en menores de 5 anos,clasificacion e,2002-08-01,1,0,1,0,1
41401,SANTIAGO DE HUARI,estado nutricional en menores de 5 anos,clasificacion e,2002-08-01,2,8,2,8,10
21901,SANTIAGO DE MACHACA,estado nutricional en menores de 5 anos,clasificacion e,2002-08-01,4,2,4,2,6
30702,SANTIVAÑES,estado nutricional en menores de 5 anos,clasificacion e,2002-08-01,5,0,5,0,5
40202,SANTUARIO DE QUILLACAS,estado nutricional en menores de 5 anos,clasificacion e,2002-08-01,2,0,2,0,2
20902,SAPAHAQUI,estado nutricional en menores de 5 anos,clasificacion e,2002-08-01,3,1,3,1,4
21301,SICA SICA (VILLA AROMA),estado nutricional en menores de 5 anos,clasificacion e,2002-08-01,12,5,12,5,17
30703,SICAYA,estado nutricional en menores de 5 anos,clasificacion e,2002-08-01,4,3,4,3,7
30902,SIPE SIPE,estado nutricional en menores de 5 anos,clasificacion e,2002-08-01,23,6,23,6,29
10403,SOPACHUY,estado nutricional en menores de 5 anos,clasificacion e,2002-08-01,32,17,32,17,49
20601,SORATA,estado nutricional en menores de 5 anos,clasificacion e,2002-08-01,4,9,4,9,13
10101,SUCRE,estado nutricional en menores de 5 anos,clasificacion e,2002-08-01,180,146,180,146,326
20603,TACACOMA,estado nutricional en menores de 5 anos,clasificacion e,2002-08-01,5,9,5,9,14
50303,TACOBAMBA,estado nutricional en menores de 5 anos,clasificacion e,2002-08-01,17,21,17,21,38
30602,TACOPAYA,estado nutricional en menores de 5 anos,clasificacion e,2002-08-01,5,6,5,6,11
31101,TAPACARI,estado nutricional en menores de 5 anos,clasificacion e,2002-08-01,22,44,22,44,66
10601,TARABUCO,estado nutricional en menores de 5 anos,clasificacion e,2002-08-01,173,123,173,123,296
30401,TARATA,estado nutricional en menores de 5 anos,clasificacion e,2002-08-01,7,10,7,10,17
60101,TARIJA,estado nutricional en menores de 5 anos,clasificacion e,2002-08-01,31,20,31,20,51
10202,TARVITA,estado nutricional en menores de 5 anos,clasificacion e,2002-08-01,34,58,34,58,92
20803,TIAWANACU,estado nutricional en menores de 5 anos,clasificacion e,2002-08-01,5,6,5,6,11
50102,TINGUIPAYA,estado nutricional en menores de 5 anos,clasificacion e,2002-08-01,9,54,9,54,63
20606,TIPUANI,estado nutricional en menores de 5 anos,clasificacion e,2002-08-01,2,1,2,1,3
30903,TIQUIPAYA,estado nutricional en menores de 5 anos,clasificacion e,2002-08-01,10,23,10,23,33
31601,TIRAQUE (CBBA),estado nutricional en menores de 5 anos,clasificacion e,2002-08-01,15,11,15,11,26
21703,TITO YUPANQUI (PARQUIPUJIO),estado nutricional en menores de 5 anos,clasificacion e,2002-08-01,0,3,0,3,3
30802,TOCO,estado nutricional en menores de 5 anos,clasificacion e,2002-08-01,3,4,3,4,7
41001,TOLEDO,estado nutricional en menores de 5 anos,clasificacion e,2002-08-01,2,3,2,3,5
51202,TOMAVE,estado nutricional en menores de 5 anos,clasificacion e,2002-08-01,16,18,16,18,34
10402,TOMINA,estado nutricional en menores de 5 anos,clasificacion e,2002-08-01,21,36,21,36,57
50502,TORO TORO,estado nutricional en menores de 5 anos,clasificacion e,2002-08-01,23,23,23,23,46
31201,TOTORA(CBBA),estado nutricional en menores de 5 anos,clasificacion e,2002-08-01,15,17,15,17,32
41301,TOTORA(ORR),estado nutricional en menores de 5 anos,clasificacion e,2002-08-01,6,6,6,6,12
70802,TRIGAL,estado nutricional en menores de 5 anos,clasificacion e,2002-08-01,1,1,1,1,2
80101,TRINIDAD,estado nutricional en menores de 5 anos,clasificacion e,2002-08-01,46,55,46,55,101
40402,TURCO,estado nutricional en menores de 5 anos,clasificacion e,2002-08-01,0,2,0,2,2
21302,UMALA,estado nutricional en menores de 5 anos,clasificacion e,2002-08-01,2,2,2,2,4
60401,URIONDO (A. CONCEPCION),estado nutricional en menores de 5 anos,clasificacion e,2002-08-01,0,3,0,3,3
71502,URUBICHA,estado nutricional en menores de 5 anos,clasificacion e,2002-08-01,6,30,6,30,36
51201,UYUNI,estado nutricional en menores de 5 anos,clasificacion e,2002-08-01,10,17,10,17,27
70801,VALLEGRANDE,estado nutricional en menores de 5 anos,clasificacion e,2002-08-01,18,11,18,11,29
20801,VIACHA,estado nutricional en menores de 5 anos,clasificacion e,2002-08-01,11,19,11,19,30
31302,VILA VILA,estado nutricional en menores de 5 anos,clasificacion e,2002-08-01,2,17,2,17,19
60303,VILLA MONTES,estado nutricional en menores de 5 anos,clasificacion e,2002-08-01,12,6,12,6,18
31402,VILLA RIVERO,estado nutricional en menores de 5 anos,clasificacion e,2002-08-01,1,0,1,0,1
10801,VILLA SERRANO,estado nutricional en menores de 5 anos,clasificacion e,2002-08-01,40,58,40,58,98
31003,VILLA TUNARI,estado nutricional en menores de 5 anos,clasificacion e,2002-08-01,53,43,53,43,96
11001,VILLA VACA GUZMAN (MUYUPAMPA),estado nutricional en menores de 5 anos,clasificacion e,2002-08-01,18,21,18,21,39
51501,VILLAZON,estado nutricional en menores de 5 anos,clasificacion e,2002-08-01,29,27,29,27,56
50602,VITICHI,estado nutricional en menores de 5 anos,clasificacion e,2002-08-01,14,35,14,35,49
70201,WARNES,estado nutricional en menores de 5 anos,clasificacion e,2002-08-01,28,9,28,9,37
20903,YACO,estado nutricional en menores de 5 anos,clasificacion e,2002-08-01,7,17,7,17,24
60301,YACUIBA,estado nutricional en menores de 5 anos,clasificacion e,2002-08-01,10,7,10,7,17
10602,YAMPARAEZ,estado nutricional en menores de 5 anos,clasificacion e,2002-08-01,58,46,58,46,104
21103,YANACACHI,estado nutricional en menores de 5 anos,clasificacion e,2002-08-01,0,4,0,4,4
50103,YOCALLA,estado nutricional en menores de 5 anos,clasificacion e,2002-08-01,0,9,0,9,9
10102,YOTALA,estado nutricional en menores de 5 anos,clasificacion e,2002-08-01,36,35,36,35,71
60402,YUNCHARA,estado nutricional en menores de 5 anos,clasificacion e,2002-08-01,0,6,0,6,6
10301,ZUDAÑEZ,estado nutricional en menores de 5 anos,clasificacion e,2002-08-01,30,25,30,25,55
51302,ACACIO,estado nutricional en menores de 5 anos,clasificacion e,2002-09-01,8,36,8,36,44
20201,ACHACACHI,estado nutricional en menores de 5 anos,clasificacion e,2002-09-01,33,21,33,21,54
20104,ACHOCALLA,estado nutricional en menores de 5 anos,clasificacion e,2002-09-01,4,7,4,7,11
30201,AIQUILE,estado nutricional en menores de 5 anos,clasificacion e,2002-09-01,10,15,10,15,25
31303,ALALAY,estado nutricional en menores de 5 anos,clasificacion e,2002-09-01,1,2,1,2,3
10404,ALCALA,estado nutricional en menores de 5 anos,clasificacion e,2002-09-01,25,22,25,22,47
20202,ANCORAIMES,estado nutricional en menores de 5 anos,clasificacion e,2002-09-01,12,16,12,16,28
41201,ANDAMARCA,estado nutricional en menores de 5 anos,clasificacion e,2002-09-01,3,0,3,0,3
30402,ANZALDO,estado nutricional en menores de 5 anos,clasificacion e,2002-09-01,2,24,2,24,26
20701,APOLO,estado nutricional en menores de 5 anos,clasificacion e,2002-09-01,10,10,10,10,20
51301,ARAMPAMPA,estado nutricional en menores de 5 anos,clasificacion e,2002-09-01,9,12,9,12,21
30501,ARANI,estado nutricional en menores de 5 anos,clasificacion e,2002-09-01,10,13,10,13,23
30403,ARBIETO,estado nutricional en menores de 5 anos,clasificacion e,2002-09-01,0,9,0,9,9
30601,ARQUE,estado nutricional en menores de 5 anos,clasificacion e,2002-09-01,22,7,22,7,29
50802,ATOCHA,estado nutricional en menores de 5 anos,clasificacion e,2002-09-01,0,19,0,19,19
20503,AUCAPATA,estado nutricional en menores de 5 anos,clasificacion e,2002-09-01,1,1,1,1,2
20502,AYATA,estado nutricional en menores de 5 anos,clasificacion e,2002-09-01,24,19,24,19,43
21303,AYO AYO,estado nutricional en menores de 5 anos,clasificacion e,2002-09-01,1,1,1,1,2
30301,AYOPAYA (V. DE INDEPENDENCIA),estado nutricional en menores de 5 anos,clasificacion e,2002-09-01,35,25,35,25,60
10201,AZURDUY,estado nutricional en menores de 5 anos,clasificacion e,2002-09-01,58,69,58,69,127
21203,BATALLAS,estado nutricional en menores de 5 anos,clasificacion e,2002-09-01,4,9,4,9,13
80802,BAURES,estado nutricional en menores de 5 anos,clasificacion e,2002-09-01,8,6,8,6,14
41202,BELEN DE ANDAMARCA,estado nutricional en menores de 5 anos,clasificacion e,2002-09-01,1,0,1,0,1
50104,BELEN DE URMIRI,estado nutricional en menores de 5 anos,clasificacion e,2002-09-01,4,8,4,8,12
60202,BERMEJO,estado nutricional en menores de 5 anos,clasificacion e,2002-09-01,3,5,3,5,8
50301,BETANZOS,estado nutricional en menores de 5 anos,clasificacion e,2002-09-01,121,127,121,127,248
31501,BOLIVAR,estado nutricional en menores de 5 anos,clasificacion e,2002-09-01,17,11,17,11,28
70707,BOYUIBE,estado nutricional en menores de 5 anos,clasificacion e,2002-09-01,0,5,0,5,5
70401,BUENA VISTA,estado nutricional en menores de 5 anos,clasificacion e,2002-09-01,9,5,9,5,14
70703,CABEZAS,estado nutricional en menores de 5 anos,clasificacion e,2002-09-01,7,3,7,3,10
20905,CAIROMA,estado nutricional en menores de 5 anos,clasificacion e,2002-09-01,14,8,14,8,22
51102,"CAIZA ""D""",estado nutricional en menores de 5 anos,clasificacion e,2002-09-01,30,16,30,16,46
21003,CAJUATA,estado nutricional en menores de 5 anos,clasificacion e,2002-09-01,1,4,1,4,5
20303,CALACOTO,estado nutricional en menores de 5 anos,clasificacion e,2002-09-01,0,4,0,4,4
21304,CALAMARCA,estado nutricional en menores de 5 anos,clasificacion e,2002-09-01,13,11,13,11,24
10701,CAMARGO,estado nutricional en menores de 5 anos,clasificacion e,2002-09-01,17,37,17,37,54
10901,CAMATAQUI (C. VILLA ABECIA),estado nutricional en menores de 5 anos,clasificacion e,2002-09-01,6,5,6,5,11
70706,CAMIRI,estado nutricional en menores de 5 anos,clasificacion e,2002-09-01,16,24,16,24,40
30701,CAPINOTA,estado nutricional en menores de 5 anos,clasificacion e,2002-09-01,17,24,17,24,41
20302,CAQUIAVIRI,estado nutricional en menores de 5 anos,clasificacion e,2002-09-01,3,4,3,4,7
40102,CARACOLLO,estado nutricional en menores de 5 anos,clasificacion e,2002-09-01,5,8,5,8,13
22001,CARANAVI,estado nutricional en menores de 5 anos,clasificacion e,2002-09-01,30,25,30,25,55
60302,CARAPARI,estado nutricional en menores de 5 anos,clasificacion e,2002-09-01,5,2,5,2,7
50702,CARIPUYO,estado nutricional en menores de 5 anos,clasificacion e,2002-09-01,35,14,35,14,49
21902,CATACORA,estado nutricional en menores de 5 anos,clasificacion e,2002-09-01,2,0,2,0,2
40201,CHALLAPATA,estado nutricional en menores de 5 anos,clasificacion e,2002-09-01,10,22,10,22,32
50302,CHAQUI,estado nutricional en menores de 5 anos,clasificacion e,2002-09-01,24,11,24,11,35
70702,CHARAGUA,estado nutricional en menores de 5 anos,clasificacion e,2002-09-01,20,27,20,27,47
20305,CHARAÑA,estado nutricional en menores de 5 anos,clasificacion e,2002-09-01,7,9,7,9,16
50202,CHAYANTA,estado nutricional en menores de 5 anos,clasificacion e,2002-09-01,23,15,23,15,38
40302,CHOQUE COTA,estado nutricional en menores de 5 anos,clasificacion e,2002-09-01,2,0,2,0,2
21101,CHULUMANI (V. DE LA LIBERTAD),estado nutricional en menores de 5 anos,clasificacion e,2002-09-01,5,2,5,2,7
20501,CHUMA,estado nutricional en menores de 5 anos,clasificacion e,2002-09-01,16,19,16,19,35
30801,CLIZA,estado nutricional en menores de 5 anos,clasificacion e,2002-09-01,2,9,2,9,11
90101,COBIJA,estado nutricional en menores de 5 anos,clasificacion e,2002-09-01,11,11,11,11,22
30101,COCHABAMBA,estado nutricional en menores de 5 anos,clasificacion e,2002-09-01,84,54,84,54,138
30905,COLCAPIRHUA,estado nutricional en menores de 5 anos,clasificacion e,2002-09-01,16,5,16,5,21
50901,"COLCHA ""K""",estado nutricional en menores de 5 anos,clasificacion e,2002-09-01,8,6,8,6,14
21307,COLLANA,estado nutricional en menores de 5 anos,clasificacion e,2002-09-01,3,1,3,1,4
31002,COLOMI,estado nutricional en menores de 5 anos,clasificacion e,2002-09-01,12,15,12,15,27
50401,COLQUECHACA,estado nutricional en menores de 5 anos,clasificacion e,2002-09-01,82,46,82,46,128
21306,COLQUENCHA,estado nutricional en menores de 5 anos,clasificacion e,2002-09-01,1,4,1,4,5
21004,COLQUIRI,estado nutricional en menores de 5 anos,clasificacion e,2002-09-01,22,9,22,9,31
20304,COMANCHE,estado nutricional en menores de 5 anos,clasificacion e,2002-09-01,3,2,3,2,5
71301,COMARAPA,estado nutricional en menores de 5 anos,clasificacion e,2002-09-01,20,18,20,18,38
20605,COMBAYA,estado nutricional en menores de 5 anos,clasificacion e,2002-09-01,1,7,1,7,8
71101,CONCEPCION,estado nutricional en menores de 5 anos,clasificacion e,2002-09-01,1,3,1,3,4
21701,COPACABANA,estado nutricional en menores de 5 anos,clasificacion e,2002-09-01,0,2,0,2,2
21402,CORIPATA,estado nutricional en menores de 5 anos,clasificacion e,2002-09-01,0,6,0,6,6
20301,CORO CORO,estado nutricional en menores de 5 anos,clasificacion e,2002-09-01,14,10,14,10,24
21401,COROICO,estado nutricional en menores de 5 anos,clasificacion e,2002-09-01,13,5,13,5,18
40301,CORQUE,estado nutricional en menores de 5 anos,clasificacion e,2002-09-01,6,7,6,7,13
50601,COTAGAITA,estado nutricional en menores de 5 anos,clasificacion e,2002-09-01,16,19,16,19,35
70102,COTOCA,estado nutricional en menores de 5 anos,clasificacion e,2002-09-01,11,10,11,10,21
31405,CUCHUMUELA (V. G. VILLARROEL),estado nutricional en menores de 5 anos,clasificacion e,2002-09-01,0,2,0,2,2
70704,CUEVO,estado nutricional en menores de 5 anos,clasificacion e,2002-09-01,3,2,3,2,5
10902,CULPINA,estado nutricional en menores de 5 anos,clasificacion e,2002-09-01,79,73,79,73,152
40401,CURAHUARA DE CARANGAS,estado nutricional en menores de 5 anos,clasificacion e,2002-09-01,4,0,4,0,4
20804,DESAGUADERO,estado nutricional en menores de 5 anos,clasificacion e,2002-09-01,3,3,3,3,6
20105,EL ALTO,estado nutricional en menores de 5 anos,clasificacion e,2002-09-01,365,226,365,226,591
40103,EL CHORO,estado nutricional en menores de 5 anos,clasificacion e,2002-09-01,1,1,1,1,2
71503,EL PUENTE(STC),estado nutricional en menores de 5 anos,clasificacion e,2002-09-01,0,25,0,25,25
60502,EL PUENTE(TJA),estado nutricional en menores de 5 anos,clasificacion e,2002-09-01,12,25,12,25,37
70105,EL TORNO,estado nutricional en menores de 5 anos,clasificacion e,2002-09-01,11,13,11,13,24
10405,EL VILLAR,estado nutricional en menores de 5 anos,clasificacion e,2002-09-01,24,24,24,24,48
60601,ENTRE RIOS,estado nutricional en menores de 5 anos,clasificacion e,2002-09-01,4,4,4,4,8
41101,EUCALIPTUS,estado nutricional en menores de 5 anos,clasificacion e,2002-09-01,2,2,2,2,4
80402,EXALTACION,estado nutricional en menores de 5 anos,clasificacion e,2002-09-01,0,1,0,1,1
90203,FILADELFIA,estado nutricional en menores de 5 anos,clasificacion e,2002-09-01,1,0,1,0,1
71002,GENERAL SAAVEDRA,estado nutricional en menores de 5 anos,clasificacion e,2002-09-01,2,0,2,0,2
21601,GRAL. J.J. PEREZ (CHARAZANI),estado nutricional en menores de 5 anos,clasificacion e,2002-09-01,25,5,25,5,30
20602,GUANAY,estado nutricional en menores de 5 anos,clasificacion e,2002-09-01,12,24,12,24,36
20802,GUAQUI,estado nutricional en menores de 5 anos,clasificacion e,2002-09-01,0,3,0,3,3
80202,GUAYARAMERIN,estado nutricional en menores de 5 anos,clasificacion e,2002-09-01,25,18,25,18,43
70705,GUTIERREZ,estado nutricional en menores de 5 anos,clasificacion e,2002-09-01,24,24,24,24,48
10502,HUACARETA,estado nutricional en menores de 5 anos,clasificacion e,2002-09-01,13,4,13,4,17
11002,HUACAYA (VILLA DE HUACAYA),estado nutricional en menores de 5 anos,clasificacion e,2002-09-01,2,2,2,2,4
40701,HUANUNI,estado nutricional en menores de 5 anos,clasificacion e,2002-09-01,16,9,16,9,25
80803,HUARACAJE,estado nutricional en menores de 5 anos,clasificacion e,2002-09-01,1,0,1,0,1
41601,HUAYLLAMARCA,estado nutricional en menores de 5 anos,clasificacion e,2002-09-01,2,1,2,1,3
21005,ICHOCA,estado nutricional en menores de 5 anos,clasificacion e,2002-09-01,1,4,1,4,5
10304,ICLA,estado nutricional en menores de 5 anos,clasificacion e,2002-09-01,50,72,50,72,122
10703,INCAHUASI,estado nutricional en menores de 5 anos,clasificacion e,2002-09-01,31,47,31,47,78
21001,INQUISIVI,estado nutricional en menores de 5 anos,clasificacion e,2002-09-01,14,30,14,30,44
21102,IRUPANA (VILLA DE LANZA),estado nutricional en menores de 5 anos,clasificacion e,2002-09-01,4,3,4,3,7
21501,IXIAMAS,estado nutricional en menores de 5 anos,clasificacion e,2002-09-01,1,6,1,6,7
21105,LA ASUNTA,estado nutricional en menores de 5 anos,clasificacion e,2002-09-01,8,6,8,6,14
70104,LA GUARDIA,estado nutricional en menores de 5 anos,clasificacion e,2002-09-01,11,6,11,6,17
20101,LA PAZ,estado nutricional en menores de 5 anos,clasificacion e,2002-09-01,215,169,215,169,384
70701,LAGUNILLAS,estado nutricional en menores de 5 anos,clasificacion e,2002-09-01,10,6,10,6,16
21202,LAJA,estado nutricional en menores de 5 anos,clasificacion e,2002-09-01,7,8,7,8,15
10903,LAS CARRERAS,estado nutricional en menores de 5 anos,clasificacion e,2002-09-01,6,8,6,8,14
21006,LICOMA PAMPA,estado nutricional en menores de 5 anos,clasificacion e,2002-09-01,2,2,2,2,4
50203,LLALLAGUA,estado nutricional en menores de 5 anos,clasificacion e,2002-09-01,0,51,0,51,51
80601,LORETO,estado nutricional en menores de 5 anos,clasificacion e,2002-09-01,0,3,0,3,3
20901,LURIBAY,estado nutricional en menores de 5 anos,clasificacion e,2002-09-01,4,1,4,1,5
40702,MACHACAMARCA,estado nutricional en menores de 5 anos,clasificacion e,2002-09-01,1,0,1,0,1
11003,MACHARETI,estado nutricional en menores de 5 anos,clasificacion e,2002-09-01,13,32,13,32,45
80801,MAGDALENA,estado nutricional en menores de 5 anos,clasificacion e,2002-09-01,1,1,1,1,2
70903,MAIRANA,estado nutricional en menores de 5 anos,clasificacion e,2002-09-01,3,1,3,1,4
20904,MALLA,estado nutricional en menores de 5 anos,clasificacion e,2002-09-01,0,2,0,2,2
20103,MECAPACA,estado nutricional en menores de 5 anos,clasificacion e,2002-09-01,2,2,2,2,4
31301,MIZQUE,estado nutricional en menores de 5 anos,clasificacion e,2002-09-01,3,15,3,15,18
20402,MOCOMOCO,estado nutricional en menores de 5 anos,clasificacion e,2002-09-01,5,2,5,2,7
51002,MOJINETE,estado nutricional en menores de 5 anos,clasificacion e,2002-09-01,0,1,0,1,1
10303,MOJOCOYA,estado nutricional en menores de 5 anos,clasificacion e,2002-09-01,21,16,21,16,37
10501,MONTEAGUDO,estado nutricional en menores de 5 anos,clasificacion e,2002-09-01,36,49,36,49,85
71001,MONTERO,estado nutricional en menores de 5 anos,clasificacion e,2002-09-01,52,29,52,29,81
70803,MORO MORO,estado nutricional en menores de 5 anos,clasificacion e,2002-09-01,6,10,6,10,16
30302,MOROCHATA,estado nutricional en menores de 5 anos,clasificacion e,2002-09-01,30,31,30,31,61
20307,NAZACARA DE PACAJES,estado nutricional en menores de 5 anos,clasificacion e,2002-09-01,1,0,1,0,1
50404,OCURI,estado nutricional en menores de 5 anos,clasificacion e,2002-09-01,29,40,29,40,69
70202,OKINAWA,estado nutricional en menores de 5 anos,clasificacion e,2002-09-01,2,1,2,1,3
30203,OMEREQUE,estado nutricional en menores de 5 anos,clasificacion e,2002-09-01,0,8,0,8,8
40101,ORURO,estado nutricional en menores de 5 anos,clasificacion e,2002-09-01,117,78,117,78,195
60201,PADCAYA,estado nutricional en menores de 5 anos,clasificacion e,2002-09-01,9,6,9,6,15
10401,PADILLA,estado nutricional en menores de 5 anos,clasificacion e,2002-09-01,33,58,33,58,91
70502,PAILON,estado nutricional en menores de 5 anos,clasificacion e,2002-09-01,2,8,2,8,10
20102,PALCA,estado nutricional en menores de 5 anos,clasificacion e,2002-09-01,11,38,11,38,49
21104,PALOS BLANCOS,estado nutricional en menores de 5 anos,clasificacion e,2002-09-01,17,12,17,12,29
40802,PAMPA AULLAGAS,estado nutricional en menores de 5 anos,clasificacion e,2002-09-01,4,0,4,0,4
70902,PAMPA GRANDE,estado nutricional en menores de 5 anos,clasificacion e,2002-09-01,5,8,5,8,13
21802,PAPEL PAMPA,estado nutricional en menores de 5 anos,clasificacion e,2002-09-01,4,1,4,1,5
30202,PASORAPA,estado nutricional en menores de 5 anos,clasificacion e,2002-09-01,9,5,9,5,14
21305,PATACAMAYA,estado nutricional en menores de 5 anos,clasificacion e,2002-09-01,19,8,19,8,27
40602,PAZÑA,estado nutricional en menores de 5 anos,clasificacion e,2002-09-01,4,1,4,1,5
20702,PELECHUCO,estado nutricional en menores de 5 anos,clasificacion e,2002-09-01,12,17,12,17,29
50403,POCOATA,estado nutricional en menores de 5 anos,clasificacion e,2002-09-01,43,42,43,42,85
31203,POCONA,estado nutricional en menores de 5 anos,clasificacion e,2002-09-01,19,11,19,11,30
31202,POJO (CBBA),estado nutricional en menores de 5 anos,clasificacion e,2002-09-01,27,25,27,25,52
40601,POOPO,estado nutricional en menores de 5 anos,clasificacion e,2002-09-01,1,4,1,4,5
51203,PORCO,estado nutricional en menores de 5 anos,clasificacion e,2002-09-01,9,4,9,4,13
10103,POROMA,estado nutricional en menores de 5 anos,clasificacion e,2002-09-01,43,49,43,49,92
70103,PORONGO,estado nutricional en menores de 5 anos,clasificacion e,2002-09-01,2,2,2,2,4
70601,PORTACHUELO,estado nutricional en menores de 5 anos,clasificacion e,2002-09-01,10,7,10,7,17
90102,PORVENIR,estado nutricional en menores de 5 anos,clasificacion e,2002-09-01,3,1,3,1,4
70804,POSTRER VALLE,estado nutricional en menores de 5 anos,clasificacion e,2002-09-01,1,1,1,1,2
50101,POTOSI,estado nutricional en menores de 5 anos,clasificacion e,2002-09-01,143,85,143,85,228
10302,PRESTO,estado nutricional en menores de 5 anos,clasificacion e,2002-09-01,38,36,38,36,74
21201,PUCARANI,estado nutricional en menores de 5 anos,clasificacion e,2002-09-01,5,14,5,14,19
20401,PUERTO ACOSTA,estado nutricional en menores de 5 anos,clasificacion e,2002-09-01,23,11,23,11,34
20403,PUERTO CARABUCO,estado nutricional en menores de 5 anos,clasificacion e,2002-09-01,7,10,7,10,17
90301,PUERTO GONZALO MORENO,estado nutricional en menores de 5 anos,clasificacion e,2002-09-01,0,1,0,1,1
21204,PUERTO PEREZ,estado nutricional en menores de 5 anos,clasificacion e,2002-09-01,0,1,0,1,1
71402,PUERTO QUIJARRO,estado nutricional en menores de 5 anos,clasificacion e,2002-09-01,10,2,10,2,12
90201,PUERTO RICO,estado nutricional en menores de 5 anos,clasificacion e,2002-09-01,7,2,7,2,9
71401,PUERTO SUAREZ,estado nutricional en menores de 5 anos,clasificacion e,2002-09-01,7,4,7,4,11
31205,PUERTO VILLARROEL,estado nutricional en menores de 5 anos,clasificacion e,2002-09-01,60,30,60,30,90
51101,PUNA,estado nutricional en menores de 5 anos,clasificacion e,2002-09-01,98,106,98,106,204
31401,PUNATA,estado nutricional en menores de 5 anos,clasificacion e,2002-09-01,7,5,7,5,12
20604,QUIABAYA,estado nutricional en menores de 5 anos,clasificacion e,2002-09-01,3,6,3,6,9
30901,QUILLACOLLO,estado nutricional en menores de 5 anos,clasificacion e,2002-09-01,29,22,29,22,51
21002,QUIME,estado nutricional en menores de 5 anos,clasificacion e,2002-09-01,9,7,9,7,16
70904,QUIRUSILLAS,estado nutricional en menores de 5 anos,clasificacion e,2002-09-01,0,2,0,2,2
50402,RAVELO,estado nutricional en menores de 5 anos,clasificacion e,2002-09-01,88,78,88,78,166
80301,REYES,estado nutricional en menores de 5 anos,clasificacion e,2002-09-01,2,2,2,2,4
80201,RIBERALTA,estado nutricional en menores de 5 anos,clasificacion e,2002-09-01,144,100,144,100,244
70503,ROBORE,estado nutricional en menores de 5 anos,clasificacion e,2002-09-01,6,6,6,6,12
80304,RURRENABAQUE,estado nutricional en menores de 5 anos,clasificacion e,2002-09-01,4,0,4,0,4
31001,SACABA,estado nutricional en menores de 5 anos,clasificacion e,2002-09-01,64,43,64,43,107
30404,SACABAMBA,estado nutricional en menores de 5 anos,clasificacion e,2002-09-01,0,26,0,26,26
50701,SACACA,estado nutricional en menores de 5 anos,clasificacion e,2002-09-01,73,75,73,75,148
71302,SAIPINA,estado nutricional en menores de 5 anos,clasificacion e,2002-09-01,2,5,2,5,7
40801,SALINAS DE GARCI MENDOZA,estado nutricional en menores de 5 anos,clasificacion e,2002-09-01,6,5,6,5,11
70901,SAMAIPATA,estado nutricional en menores de 5 anos,clasificacion e,2002-09-01,5,2,5,2,7
80602,SAN ANDRES,estado nutricional en menores de 5 anos,clasificacion e,2002-09-01,2,1,2,1,3
51003,SAN ANTONIO DE ESMORUCO,estado nutricional en menores de 5 anos,clasificacion e,2002-09-01,2,3,2,3,5
71105,SAN ANTONIO DE LOMERIO,estado nutricional en menores de 5 anos,clasificacion e,2002-09-01,24,29,24,29,53
31403,SAN BENITO,estado nutricional en menores de 5 anos,clasificacion e,2002-09-01,7,1,7,1,8
80302,SAN BORJA,estado nutricional en menores de 5 anos,clasificacion e,2002-09-01,31,31,31,31,62
21502,SAN BUENA VENTURA,estado nutricional en menores de 5 anos,clasificacion e,2002-09-01,11,11,11,11,22
70402,SAN CARLOS,estado nutricional en menores de 5 anos,clasificacion e,2002-09-01,13,5,13,5,18
80501,SAN IGNACIO,estado nutricional en menores de 5 anos,clasificacion e,2002-09-01,42,42,42,42,84
70301,SAN IGNACIO DE VELASCO,estado nutricional en menores de 5 anos,clasificacion e,2002-09-01,76,44,76,44,120
80102,SAN JAVIER(BNI),estado nutricional en menores de 5 anos,clasificacion e,2002-09-01,0,2,0,2,2
71102,SAN JAVIER(STC),estado nutricional en menores de 5 anos,clasificacion e,2002-09-01,0,1,0,1,1
80701,SAN JOAQUIN,estado nutricional en menores de 5 anos,clasificacion e,2002-09-01,0,6,0,6,6
70501,SAN JOSE DE CHIQUITOS,estado nutricional en menores de 5 anos,clasificacion e,2002-09-01,9,2,9,2,11
71104,SAN JULIAN,estado nutricional en menores de 5 anos,clasificacion e,2002-09-01,16,25,16,25,41
90302,SAN LORENZO(PND),estado nutricional en menores de 5 anos,clasificacion e,2002-09-01,2,1,2,1,3
60501,SAN LORENZO(TJA),estado nutricional en menores de 5 anos,clasificacion e,2002-09-01,6,7,6,7,13
10702,SAN LUCAS,estado nutricional en menores de 5 anos,clasificacion e,2002-09-01,130,98,130,98,228
71201,SAN MATIAS,estado nutricional en menores de 5 anos,clasificacion e,2002-09-01,19,11,19,11,30
70302,SAN MIGUEL DE VELASCO,estado nutricional en menores de 5 anos,clasificacion e,2002-09-01,23,16,23,16,39
51001,SAN PABLO DE LIPEZ,estado nutricional en menores de 5 anos,clasificacion e,2002-09-01,3,2,3,2,5
50501,SAN PEDRO DE BUENA VISTA,estado nutricional en menores de 5 anos,clasificacion e,2002-09-01,37,84,37,84,121
21801,SAN PEDRO DE CURAHUARA,estado nutricional en menores de 5 anos,clasificacion e,2002-09-01,1,1,1,1,2
21702,SAN PEDRO DE TIQUINA,estado nutricional en menores de 5 anos,clasificacion e,2002-09-01,0,1,0,1,1
70303,SAN RAFAEL,estado nutricional en menores de 5 anos,clasificacion e,2002-09-01,13,8,13,8,21
80401,SANTA ANA,estado nutricional en menores de 5 anos,clasificacion e,2002-09-01,6,0,6,0,6
70101,SANTA CRUZ DE LA SIERRA,estado nutricional en menores de 5 anos,clasificacion e,2002-09-01,148,90,148,90,238
80303,SANTA ROSA,estado nutricional en menores de 5 anos,clasificacion e,2002-09-01,3,0,3,0,3
70602,SANTA ROSA DEL SARA,estado nutricional en menores de 5 anos,clasificacion e,2002-09-01,0,1,0,1,1
20308,SANTIAGO DE CALLAPA,estado nutricional en menores de 5 anos,clasificacion e,2002-09-01,6,3,6,3,9
41401,SANTIAGO DE HUARI,estado nutricional en menores de 5 anos,clasificacion e,2002-09-01,3,1,3,1,4
21901,SANTIAGO DE MACHACA,estado nutricional en menores de 5 anos,clasificacion e,2002-09-01,1,1,1,1,2
30702,SANTIVAÑES,estado nutricional en menores de 5 anos,clasificacion e,2002-09-01,6,10,6,10,16
40202,SANTUARIO DE QUILLACAS,estado nutricional en menores de 5 anos,clasificacion e,2002-09-01,1,2,1,2,3
20902,SAPAHAQUI,estado nutricional en menores de 5 anos,clasificacion e,2002-09-01,3,1,3,1,4
90303,SENA,estado nutricional en menores de 5 anos,clasificacion e,2002-09-01,6,1,6,1,7
21301,SICA SICA (VILLA AROMA),estado nutricional en menores de 5 anos,clasificacion e,2002-09-01,14,6,14,6,20
30703,SICAYA,estado nutricional en menores de 5 anos,clasificacion e,2002-09-01,6,1,6,1,7
30902,SIPE SIPE,estado nutricional en menores de 5 anos,clasificacion e,2002-09-01,56,38,56,38,94
10403,SOPACHUY,estado nutricional en menores de 5 anos,clasificacion e,2002-09-01,28,26,28,26,54
20601,SORATA,estado nutricional en menores de 5 anos,clasificacion e,2002-09-01,5,7,5,7,12
10101,SUCRE,estado nutricional en menores de 5 anos,clasificacion e,2002-09-01,180,125,180,125,305
31404,TACACHI,estado nutricional en menores de 5 anos,clasificacion e,2002-09-01,0,1,0,1,1
20603,TACACOMA,estado nutricional en menores de 5 anos,clasificacion e,2002-09-01,3,0,3,0,3
50303,TACOBAMBA,estado nutricional en menores de 5 anos,clasificacion e,2002-09-01,18,15,18,15,33
30602,TACOPAYA,estado nutricional en menores de 5 anos,clasificacion e,2002-09-01,24,23,24,23,47
51402,TAHUA,estado nutricional en menores de 5 anos,clasificacion e,2002-09-01,1,1,1,1,2
31101,TAPACARI,estado nutricional en menores de 5 anos,clasificacion e,2002-09-01,30,59,30,59,89
10601,TARABUCO,estado nutricional en menores de 5 anos,clasificacion e,2002-09-01,152,126,152,126,278
30401,TARATA,estado nutricional en menores de 5 anos,clasificacion e,2002-09-01,11,7,11,7,18
60101,TARIJA,estado nutricional en menores de 5 anos,clasificacion e,2002-09-01,36,17,36,17,53
10202,TARVITA,estado nutricional en menores de 5 anos,clasificacion e,2002-09-01,38,70,38,70,108
20803,TIAWANACU,estado nutricional en menores de 5 anos,clasificacion e,2002-09-01,7,3,7,3,10
50102,TINGUIPAYA,estado nutricional en menores de 5 anos,clasificacion e,2002-09-01,14,74,14,74,88
20606,TIPUANI,estado nutricional en menores de 5 anos,clasificacion e,2002-09-01,3,0,3,0,3
30903,TIQUIPAYA,estado nutricional en menores de 5 anos,clasificacion e,2002-09-01,12,15,12,15,27
31601,TIRAQUE (CBBA),estado nutricional en menores de 5 anos,clasificacion e,2002-09-01,40,45,40,45,85
30802,TOCO,estado nutricional en menores de 5 anos,clasificacion e,2002-09-01,0,2,0,2,2
30803,TOLATA,estado nutricional en menores de 5 anos,clasificacion e,2002-09-01,1,5,1,5,6
41001,TOLEDO,estado nutricional en menores de 5 anos,clasificacion e,2002-09-01,1,2,1,2,3
51202,TOMAVE,estado nutricional en menores de 5 anos,clasificacion e,2002-09-01,12,16,12,16,28
10402,TOMINA,estado nutricional en menores de 5 anos,clasificacion e,2002-09-01,26,50,26,50,76
50502,TORO TORO,estado nutricional en menores de 5 anos,clasificacion e,2002-09-01,19,12,19,12,31
31201,TOTORA(CBBA),estado nutricional en menores de 5 anos,clasificacion e,2002-09-01,17,13,17,13,30
41301,TOTORA(ORR),estado nutricional en menores de 5 anos,clasificacion e,2002-09-01,1,2,1,2,3
80101,TRINIDAD,estado nutricional en menores de 5 anos,clasificacion e,2002-09-01,15,87,15,87,102
50801,TUPIZA,estado nutricional en menores de 5 anos,clasificacion e,2002-09-01,8,76,8,76,84
21302,UMALA,estado nutricional en menores de 5 anos,clasificacion e,2002-09-01,1,0,1,0,1
50201,UNCIA,estado nutricional en menores de 5 anos,clasificacion e,2002-09-01,1,5,1,5,6
60401,URIONDO (A. CONCEPCION),estado nutricional en menores de 5 anos,clasificacion e,2002-09-01,1,1,1,1,2
71502,URUBICHA,estado nutricional en menores de 5 anos,clasificacion e,2002-09-01,2,5,2,5,7
51201,UYUNI,estado nutricional en menores de 5 anos,clasificacion e,2002-09-01,10,18,10,18,28
30502,VACAS,estado nutricional en menores de 5 anos,clasificacion e,2002-09-01,17,8,17,8,25
70801,VALLEGRANDE,estado nutricional en menores de 5 anos,clasificacion e,2002-09-01,18,12,18,12,30
20801,VIACHA,estado nutricional en menores de 5 anos,clasificacion e,2002-09-01,19,17,19,17,36
31302,VILA VILA,estado nutricional en menores de 5 anos,clasificacion e,2002-09-01,2,9,2,9,11
60303,VILLA MONTES,estado nutricional en menores de 5 anos,clasificacion e,2002-09-01,10,4,10,4,14
31402,VILLA RIVERO,estado nutricional en menores de 5 anos,clasificacion e,2002-09-01,5,3,5,3,8
10801,VILLA SERRANO,estado nutricional en menores de 5 anos,clasificacion e,2002-09-01,51,85,51,85,136
31003,VILLA TUNARI,estado nutricional en menores de 5 anos,clasificacion e,2002-09-01,25,49,25,49,74
11001,VILLA VACA GUZMAN (MUYUPAMPA),estado nutricional en menores de 5 anos,clasificacion e,2002-09-01,14,12,14,12,26
51501,VILLAZON,estado nutricional en menores de 5 anos,clasificacion e,2002-09-01,28,23,28,23,51
30904,VINTO,estado nutricional en menores de 5 anos,clasificacion e,2002-09-01,15,5,15,5,20
50602,VITICHI,estado nutricional en menores de 5 anos,clasificacion e,2002-09-01,9,11,9,11,20
20306,WALDO BALLIVIAN,estado nutricional en menores de 5 anos,clasificacion e,2002-09-01,3,0,3,0,3
70201,WARNES,estado nutricional en menores de 5 anos,clasificacion e,2002-09-01,32,21,32,21,53
20903,YACO,estado nutricional en menores de 5 anos,clasificacion e,2002-09-01,6,3,6,3,9
60301,YACUIBA,estado nutricional en menores de 5 anos,clasificacion e,2002-09-01,21,21,21,21,42
10602,YAMPARAEZ,estado nutricional en menores de 5 anos,clasificacion e,2002-09-01,72,43,72,43,115
21103,YANACACHI,estado nutricional en menores de 5 anos,clasificacion e,2002-09-01,1,4,1,4,5
70403,YAPACANI,estado nutricional en menores de 5 anos,clasificacion e,2002-09-01,18,18,18,18,36
50103,YOCALLA,estado nutricional en menores de 5 anos,clasificacion e,2002-09-01,6,6,6,6,12
10102,YOTALA,estado nutricional en menores de 5 anos,clasificacion e,2002-09-01,34,39,34,39,73
60402,YUNCHARA,estado nutricional en menores de 5 anos,clasificacion e,2002-09-01,2,4,2,4,6
10301,ZUDAÑEZ,estado nutricional en menores de 5 anos,clasificacion e,2002-09-01,34,43,34,43,77
51302,ACACIO,estado nutricional en menores de 5 anos,clasificacion e,2002-10-01,21,32,21,32,53
20201,ACHACACHI,estado nutricional en menores de 5 anos,clasificacion e,2002-10-01,34,22,34,22,56
20104,ACHOCALLA,estado nutricional en menores de 5 anos,clasificacion e,2002-10-01,6,6,6,6,12
30201,AIQUILE,estado nutricional en menores de 5 anos,clasificacion e,2002-10-01,10,20,10,20,30
31303,ALALAY,estado nutricional en menores de 5 anos,clasificacion e,2002-10-01,1,26,1,26,27
10404,ALCALA,estado nutricional en menores de 5 anos,clasificacion e,2002-10-01,8,17,8,17,25
20202,ANCORAIMES,estado nutricional en menores de 5 anos,clasificacion e,2002-10-01,9,18,9,18,27
30402,ANZALDO,estado nutricional en menores de 5 anos,clasificacion e,2002-10-01,6,18,6,18,24
20701,APOLO,estado nutricional en menores de 5 anos,clasificacion e,2002-10-01,5,14,5,14,19
51301,ARAMPAMPA,estado nutricional en menores de 5 anos,clasificacion e,2002-10-01,11,10,11,10,21
30501,ARANI,estado nutricional en menores de 5 anos,clasificacion e,2002-10-01,8,6,8,6,14
30403,ARBIETO,estado nutricional en menores de 5 anos,clasificacion e,2002-10-01,0,13,0,13,13
30601,ARQUE,estado nutricional en menores de 5 anos,clasificacion e,2002-10-01,17,10,17,10,27
71501,ASCENCION DE GUARAYOS,estado nutricional en menores de 5 anos,clasificacion e,2002-10-01,113,62,113,62,175
50802,ATOCHA,estado nutricional en menores de 5 anos,clasificacion e,2002-10-01,0,32,0,32,32
20503,AUCAPATA,estado nutricional en menores de 5 anos,clasificacion e,2002-10-01,6,0,6,0,6
20502,AYATA,estado nutricional en menores de 5 anos,clasificacion e,2002-10-01,10,2,10,2,12
21303,AYO AYO,estado nutricional en menores de 5 anos,clasificacion e,2002-10-01,1,1,1,1,2
30301,AYOPAYA (V. DE INDEPENDENCIA),estado nutricional en menores de 5 anos,clasificacion e,2002-10-01,39,23,39,23,62
10201,AZURDUY,estado nutricional en menores de 5 anos,clasificacion e,2002-10-01,66,71,66,71,137
21203,BATALLAS,estado nutricional en menores de 5 anos,clasificacion e,2002-10-01,3,6,3,6,9
80802,BAURES,estado nutricional en menores de 5 anos,clasificacion e,2002-10-01,6,3,6,3,9
41202,BELEN DE ANDAMARCA,estado nutricional en menores de 5 anos,clasificacion e,2002-10-01,0,1,0,1,1
50104,BELEN DE URMIRI,estado nutricional en menores de 5 anos,clasificacion e,2002-10-01,0,4,0,4,4
60202,BERMEJO,estado nutricional en menores de 5 anos,clasificacion e,2002-10-01,2,1,2,1,3
50301,BETANZOS,estado nutricional en menores de 5 anos,clasificacion e,2002-10-01,75,79,75,79,154
31501,BOLIVAR,estado nutricional en menores de 5 anos,clasificacion e,2002-10-01,31,20,31,20,51
70707,BOYUIBE,estado nutricional en menores de 5 anos,clasificacion e,2002-10-01,1,13,1,13,14
70703,CABEZAS,estado nutricional en menores de 5 anos,clasificacion e,2002-10-01,5,10,5,10,15
20905,CAIROMA,estado nutricional en menores de 5 anos,clasificacion e,2002-10-01,33,44,33,44,77
51102,"CAIZA ""D""",estado nutricional en menores de 5 anos,clasificacion e,2002-10-01,29,19,29,19,48
21003,CAJUATA,estado nutricional en menores de 5 anos,clasificacion e,2002-10-01,19,12,19,12,31
20303,CALACOTO,estado nutricional en menores de 5 anos,clasificacion e,2002-10-01,2,4,2,4,6
21304,CALAMARCA,estado nutricional en menores de 5 anos,clasificacion e,2002-10-01,37,11,37,11,48
10701,CAMARGO,estado nutricional en menores de 5 anos,clasificacion e,2002-10-01,24,30,24,30,54
10901,CAMATAQUI (C. VILLA ABECIA),estado nutricional en menores de 5 anos,clasificacion e,2002-10-01,4,3,4,3,7
70706,CAMIRI,estado nutricional en menores de 5 anos,clasificacion e,2002-10-01,28,18,28,18,46
30701,CAPINOTA,estado nutricional en menores de 5 anos,clasificacion e,2002-10-01,39,29,39,29,68
20302,CAQUIAVIRI,estado nutricional en menores de 5 anos,clasificacion e,2002-10-01,4,5,4,5,9
40102,CARACOLLO,estado nutricional en menores de 5 anos,clasificacion e,2002-10-01,7,16,7,16,23
22001,CARANAVI,estado nutricional en menores de 5 anos,clasificacion e,2002-10-01,26,22,26,22,48
60302,CARAPARI,estado nutricional en menores de 5 anos,clasificacion e,2002-10-01,7,6,7,6,13
50702,CARIPUYO,estado nutricional en menores de 5 anos,clasificacion e,2002-10-01,16,15,16,15,31
40201,CHALLAPATA,estado nutricional en menores de 5 anos,clasificacion e,2002-10-01,17,21,17,21,38
50302,CHAQUI,estado nutricional en menores de 5 anos,clasificacion e,2002-10-01,17,16,17,16,33
70702,CHARAGUA,estado nutricional en menores de 5 anos,clasificacion e,2002-10-01,5,22,5,22,27
20305,CHARAÑA,estado nutricional en menores de 5 anos,clasificacion e,2002-10-01,4,4,4,4,8
50202,CHAYANTA,estado nutricional en menores de 5 anos,clasificacion e,2002-10-01,20,15,20,15,35
31204,CHIMORE,estado nutricional en menores de 5 anos,clasificacion e,2002-10-01,12,3,12,3,15
40302,CHOQUE COTA,estado nutricional en menores de 5 anos,clasificacion e,2002-10-01,3,0,3,0,3
21101,CHULUMANI (V. DE LA LIBERTAD),estado nutricional en menores de 5 anos,clasificacion e,2002-10-01,1,1,1,1,2
20501,CHUMA,estado nutricional en menores de 5 anos,clasificacion e,2002-10-01,9,1,9,1,10
30801,CLIZA,estado nutricional en menores de 5 anos,clasificacion e,2002-10-01,10,5,10,5,15
90101,COBIJA,estado nutricional en menores de 5 anos,clasificacion e,2002-10-01,32,21,32,21,53
30101,COCHABAMBA,estado nutricional en menores de 5 anos,clasificacion e,2002-10-01,107,130,107,130,237
40902,COIPASA,estado nutricional en menores de 5 anos,clasificacion e,2002-10-01,1,0,1,0,1
30905,COLCAPIRHUA,estado nutricional en menores de 5 anos,clasificacion e,2002-10-01,11,11,11,11,22
50901,"COLCHA ""K""",estado nutricional en menores de 5 anos,clasificacion e,2002-10-01,6,8,6,8,14
21307,COLLANA,estado nutricional en menores de 5 anos,clasificacion e,2002-10-01,0,1,0,1,1
31002,COLOMI,estado nutricional en menores de 5 anos,clasificacion e,2002-10-01,4,16,4,16,20
50401,COLQUECHACA,estado nutricional en menores de 5 anos,clasificacion e,2002-10-01,90,43,90,43,133
21306,COLQUENCHA,estado nutricional en menores de 5 anos,clasificacion e,2002-10-01,2,7,2,7,9
21004,COLQUIRI,estado nutricional en menores de 5 anos,clasificacion e,2002-10-01,28,24,28,24,52
20304,COMANCHE,estado nutricional en menores de 5 anos,clasificacion e,2002-10-01,2,3,2,3,5
71301,COMARAPA,estado nutricional en menores de 5 anos,clasificacion e,2002-10-01,18,22,18,22,40
20605,COMBAYA,estado nutricional en menores de 5 anos,clasificacion e,2002-10-01,2,4,2,4,6
71101,CONCEPCION,estado nutricional en menores de 5 anos,clasificacion e,2002-10-01,5,2,5,2,7
21701,COPACABANA,estado nutricional en menores de 5 anos,clasificacion e,2002-10-01,8,7,8,7,15
21402,CORIPATA,estado nutricional en menores de 5 anos,clasificacion e,2002-10-01,0,4,0,4,4
20301,CORO CORO,estado nutricional en menores de 5 anos,clasificacion e,2002-10-01,5,0,5,0,5
21401,COROICO,estado nutricional en menores de 5 anos,clasificacion e,2002-10-01,6,3,6,3,9
40301,CORQUE,estado nutricional en menores de 5 anos,clasificacion e,2002-10-01,5,4,5,4,9
50601,COTAGAITA,estado nutricional en menores de 5 anos,clasificacion e,2002-10-01,50,65,50,65,115
70102,COTOCA,estado nutricional en menores de 5 anos,clasificacion e,2002-10-01,36,10,36,10,46
31405,CUCHUMUELA (V. G. VILLARROEL),estado nutricional en menores de 5 anos,clasificacion e,2002-10-01,2,4,2,4,6
70704,CUEVO,estado nutricional en menores de 5 anos,clasificacion e,2002-10-01,6,0,6,0,6
10902,CULPINA,estado nutricional en menores de 5 anos,clasificacion e,2002-10-01,53,43,53,43,96
40401,CURAHUARA DE CARANGAS,estado nutricional en menores de 5 anos,clasificacion e,2002-10-01,6,0,6,0,6
21602,CURVA,estado nutricional en menores de 5 anos,clasificacion e,2002-10-01,2,3,2,3,5
20804,DESAGUADERO,estado nutricional en menores de 5 anos,clasificacion e,2002-10-01,1,5,1,5,6
20105,EL ALTO,estado nutricional en menores de 5 anos,clasificacion e,2002-10-01,476,338,476,338,814
40103,EL CHORO,estado nutricional en menores de 5 anos,clasificacion e,2002-10-01,2,4,2,4,6
71503,EL PUENTE(STC),estado nutricional en menores de 5 anos,clasificacion e,2002-10-01,2,17,2,17,19
60502,EL PUENTE(TJA),estado nutricional en menores de 5 anos,clasificacion e,2002-10-01,18,33,18,33,51
70105,EL TORNO,estado nutricional en menores de 5 anos,clasificacion e,2002-10-01,23,12,23,12,35
10405,EL VILLAR,estado nutricional en menores de 5 anos,clasificacion e,2002-10-01,20,40,20,40,60
60601,ENTRE RIOS,estado nutricional en menores de 5 anos,clasificacion e,2002-10-01,2,11,2,11,13
41101,EUCALIPTUS,estado nutricional en menores de 5 anos,clasificacion e,2002-10-01,1,6,1,6,7
90203,FILADELFIA,estado nutricional en menores de 5 anos,clasificacion e,2002-10-01,0,5,0,5,5
71002,GENERAL SAAVEDRA,estado nutricional en menores de 5 anos,clasificacion e,2002-10-01,18,21,18,21,39
21601,GRAL. J.J. PEREZ (CHARAZANI),estado nutricional en menores de 5 anos,clasificacion e,2002-10-01,14,20,14,20,34
20602,GUANAY,estado nutricional en menores de 5 anos,clasificacion e,2002-10-01,16,28,16,28,44
20802,GUAQUI,estado nutricional en menores de 5 anos,clasificacion e,2002-10-01,3,1,3,1,4
80202,GUAYARAMERIN,estado nutricional en menores de 5 anos,clasificacion e,2002-10-01,34,24,34,24,58
70705,GUTIERREZ,estado nutricional en menores de 5 anos,clasificacion e,2002-10-01,23,44,23,44,67
10502,HUACARETA,estado nutricional en menores de 5 anos,clasificacion e,2002-10-01,19,17,19,17,36
11002,HUACAYA (VILLA DE HUACAYA),estado nutricional en menores de 5 anos,clasificacion e,2002-10-01,4,3,4,3,7
40701,HUANUNI,estado nutricional en menores de 5 anos,clasificacion e,2002-10-01,20,12,20,12,32
80803,HUARACAJE,estado nutricional en menores de 5 anos,clasificacion e,2002-10-01,5,4,5,4,9
21005,ICHOCA,estado nutricional en menores de 5 anos,clasificacion e,2002-10-01,22,11,22,11,33
10304,ICLA,estado nutricional en menores de 5 anos,clasificacion e,2002-10-01,40,68,40,68,108
10703,INCAHUASI,estado nutricional en menores de 5 anos,clasificacion e,2002-10-01,34,28,34,28,62
21001,INQUISIVI,estado nutricional en menores de 5 anos,clasificacion e,2002-10-01,33,20,33,20,53
21102,IRUPANA (VILLA DE LANZA),estado nutricional en menores de 5 anos,clasificacion e,2002-10-01,0,1,0,1,1
21501,IXIAMAS,estado nutricional en menores de 5 anos,clasificacion e,2002-10-01,4,13,4,13,17
21105,LA ASUNTA,estado nutricional en menores de 5 anos,clasificacion e,2002-10-01,7,5,7,5,12
70104,LA GUARDIA,estado nutricional en menores de 5 anos,clasificacion e,2002-10-01,16,10,16,10,26
20101,LA PAZ,estado nutricional en menores de 5 anos,clasificacion e,2002-10-01,261,168,261,168,429
70701,LAGUNILLAS,estado nutricional en menores de 5 anos,clasificacion e,2002-10-01,7,8,7,8,15
21202,LAJA,estado nutricional en menores de 5 anos,clasificacion e,2002-10-01,15,6,15,6,21
10903,LAS CARRERAS,estado nutricional en menores de 5 anos,clasificacion e,2002-10-01,6,12,6,12,18
50203,LLALLAGUA,estado nutricional en menores de 5 anos,clasificacion e,2002-10-01,7,78,7,78,85
51401,LLICA,estado nutricional en menores de 5 anos,clasificacion e,2002-10-01,1,1,1,1,2
80601,LORETO,estado nutricional en menores de 5 anos,clasificacion e,2002-10-01,6,3,6,3,9
20901,LURIBAY,estado nutricional en menores de 5 anos,clasificacion e,2002-10-01,8,7,8,7,15
40702,MACHACAMARCA,estado nutricional en menores de 5 anos,clasificacion e,2002-10-01,1,2,1,2,3
11003,MACHARETI,estado nutricional en menores de 5 anos,clasificacion e,2002-10-01,13,24,13,24,37
80801,MAGDALENA,estado nutricional en menores de 5 anos,clasificacion e,2002-10-01,4,0,4,0,4
70903,MAIRANA,estado nutricional en menores de 5 anos,clasificacion e,2002-10-01,10,4,10,4,14
20904,MALLA,estado nutricional en menores de 5 anos,clasificacion e,2002-10-01,1,4,1,4,5
20103,MECAPACA,estado nutricional en menores de 5 anos,clasificacion e,2002-10-01,2,6,2,6,8
71003,MINEROS,estado nutricional en menores de 5 anos,clasificacion e,2002-10-01,43,13,43,13,56
31301,MIZQUE,estado nutricional en menores de 5 anos,clasificacion e,2002-10-01,10,26,10,26,36
20402,MOCOMOCO,estado nutricional en menores de 5 anos,clasificacion e,2002-10-01,17,13,17,13,30
51002,MOJINETE,estado nutricional en menores de 5 anos,clasificacion e,2002-10-01,1,3,1,3,4
10303,MOJOCOYA,estado nutricional en menores de 5 anos,clasificacion e,2002-10-01,25,23,25,23,48
10501,MONTEAGUDO,estado nutricional en menores de 5 anos,clasificacion e,2002-10-01,25,50,25,50,75
71001,MONTERO,estado nutricional en menores de 5 anos,clasificacion e,2002-10-01,81,39,81,39,120
70803,MORO MORO,estado nutricional en menores de 5 anos,clasificacion e,2002-10-01,6,5,6,5,11
30302,MOROCHATA,estado nutricional en menores de 5 anos,clasificacion e,2002-10-01,20,34,20,34,54
90401,NACEBE (SANTA ROSA DEL ABUNA),estado nutricional en menores de 5 anos,clasificacion e,2002-10-01,2,5,2,5,7
20307,NAZACARA DE PACAJES,estado nutricional en menores de 5 anos,clasificacion e,2002-10-01,2,0,2,0,2
90501,NUEVO MANOA (NUEVA ESPERANZA),estado nutricional en menores de 5 anos,clasificacion e,2002-10-01,2,3,2,3,5
50404,OCURI,estado nutricional en menores de 5 anos,clasificacion e,2002-10-01,26,30,26,30,56
70202,OKINAWA,estado nutricional en menores de 5 anos,clasificacion e,2002-10-01,2,0,2,0,2
30203,OMEREQUE,estado nutricional en menores de 5 anos,clasificacion e,2002-10-01,0,1,0,1,1
40101,ORURO,estado nutricional en menores de 5 anos,clasificacion e,2002-10-01,173,97,173,97,270
60201,PADCAYA,estado nutricional en menores de 5 anos,clasificacion e,2002-10-01,7,11,7,11,18
10401,PADILLA,estado nutricional en menores de 5 anos,clasificacion e,2002-10-01,37,46,37,46,83
70502,PAILON,estado nutricional en menores de 5 anos,clasificacion e,2002-10-01,8,12,8,12,20
20102,PALCA,estado nutricional en menores de 5 anos,clasificacion e,2002-10-01,8,16,8,16,24
21104,PALOS BLANCOS,estado nutricional en menores de 5 anos,clasificacion e,2002-10-01,9,10,9,10,19
40802,PAMPA AULLAGAS,estado nutricional en menores de 5 anos,clasificacion e,2002-10-01,8,3,8,3,11
70902,PAMPA GRANDE,estado nutricional en menores de 5 anos,clasificacion e,2002-10-01,2,5,2,5,7
21802,PAPEL PAMPA,estado nutricional en menores de 5 anos,clasificacion e,2002-10-01,1,0,1,0,1
30202,PASORAPA,estado nutricional en menores de 5 anos,clasificacion e,2002-10-01,5,10,5,10,15
21305,PATACAMAYA,estado nutricional en menores de 5 anos,clasificacion e,2002-10-01,14,11,14,11,25
40602,PAZÑA,estado nutricional en menores de 5 anos,clasificacion e,2002-10-01,1,1,1,1,2
20702,PELECHUCO,estado nutricional en menores de 5 anos,clasificacion e,2002-10-01,6,5,6,5,11
50403,POCOATA,estado nutricional en menores de 5 anos,clasificacion e,2002-10-01,53,57,53,57,110
31203,POCONA,estado nutricional en menores de 5 anos,clasificacion e,2002-10-01,21,12,21,12,33
31202,POJO (CBBA),estado nutricional en menores de 5 anos,clasificacion e,2002-10-01,37,22,37,22,59
40601,POOPO,estado nutricional en menores de 5 anos,clasificacion e,2002-10-01,4,4,4,4,8
51203,PORCO,estado nutricional en menores de 5 anos,clasificacion e,2002-10-01,15,9,15,9,24
10103,POROMA,estado nutricional en menores de 5 anos,clasificacion e,2002-10-01,73,87,73,87,160
70103,PORONGO,estado nutricional en menores de 5 anos,clasificacion e,2002-10-01,1,1,1,1,2
70601,PORTACHUELO,estado nutricional en menores de 5 anos,clasificacion e,2002-10-01,12,7,12,7,19
70804,POSTRER VALLE,estado nutricional en menores de 5 anos,clasificacion e,2002-10-01,1,0,1,0,1
50101,POTOSI,estado nutricional en menores de 5 anos,clasificacion e,2002-10-01,173,129,173,129,302
10302,PRESTO,estado nutricional en menores de 5 anos,clasificacion e,2002-10-01,36,27,36,27,63
70805,PUCARA,estado nutricional en menores de 5 anos,clasificacion e,2002-10-01,1,1,1,1,2
21201,PUCARANI,estado nutricional en menores de 5 anos,clasificacion e,2002-10-01,3,8,3,8,11
20401,PUERTO ACOSTA,estado nutricional en menores de 5 anos,clasificacion e,2002-10-01,28,21,28,21,49
20403,PUERTO CARABUCO,estado nutricional en menores de 5 anos,clasificacion e,2002-10-01,12,13,12,13,25
90301,PUERTO GONZALO MORENO,estado nutricional en menores de 5 anos,clasificacion e,2002-10-01,3,1,3,1,4
21204,PUERTO PEREZ,estado nutricional en menores de 5 anos,clasificacion e,2002-10-01,3,1,3,1,4
71402,PUERTO QUIJARRO,estado nutricional en menores de 5 anos,clasificacion e,2002-10-01,2,1,2,1,3
90201,PUERTO RICO,estado nutricional en menores de 5 anos,clasificacion e,2002-10-01,8,7,8,7,15
71401,PUERTO SUAREZ,estado nutricional en menores de 5 anos,clasificacion e,2002-10-01,23,5,23,5,28
31205,PUERTO VILLARROEL,estado nutricional en menores de 5 anos,clasificacion e,2002-10-01,87,34,87,34,121
51101,PUNA,estado nutricional en menores de 5 anos,clasificacion e,2002-10-01,16,27,16,27,43
31401,PUNATA,estado nutricional en menores de 5 anos,clasificacion e,2002-10-01,37,17,37,17,54
20604,QUIABAYA,estado nutricional en menores de 5 anos,clasificacion e,2002-10-01,15,12,15,12,27
30901,QUILLACOLLO,estado nutricional en menores de 5 anos,clasificacion e,2002-10-01,40,31,40,31,71
21002,QUIME,estado nutricional en menores de 5 anos,clasificacion e,2002-10-01,25,13,25,13,38
70904,QUIRUSILLAS,estado nutricional en menores de 5 anos,clasificacion e,2002-10-01,0,1,0,1,1
50402,RAVELO,estado nutricional en menores de 5 anos,clasificacion e,2002-10-01,93,66,93,66,159
80301,REYES,estado nutricional en menores de 5 anos,clasificacion e,2002-10-01,9,4,9,4,13
80201,RIBERALTA,estado nutricional en menores de 5 anos,clasificacion e,2002-10-01,178,111,178,111,289
70503,ROBORE,estado nutricional en menores de 5 anos,clasificacion e,2002-10-01,5,6,5,6,11
80304,RURRENABAQUE,estado nutricional en menores de 5 anos,clasificacion e,2002-10-01,1,2,1,2,3
40901,SABAYA,estado nutricional en menores de 5 anos,clasificacion e,2002-10-01,0,1,0,1,1
31001,SACABA,estado nutricional en menores de 5 anos,clasificacion e,2002-10-01,66,33,66,33,99
30404,SACABAMBA,estado nutricional en menores de 5 anos,clasificacion e,2002-10-01,15,26,15,26,41
50701,SACACA,estado nutricional en menores de 5 anos,clasificacion e,2002-10-01,43,81,43,81,124
71302,SAIPINA,estado nutricional en menores de 5 anos,clasificacion e,2002-10-01,5,4,5,4,9
40801,SALINAS DE GARCI MENDOZA,estado nutricional en menores de 5 anos,clasificacion e,2002-10-01,3,7,3,7,10
70901,SAMAIPATA,estado nutricional en menores de 5 anos,clasificacion e,2002-10-01,5,0,5,0,5
80602,SAN ANDRES,estado nutricional en menores de 5 anos,clasificacion e,2002-10-01,10,7,10,7,17
71105,SAN ANTONIO DE LOMERIO,estado nutricional en menores de 5 anos,clasificacion e,2002-10-01,26,38,26,38,64
31403,SAN BENITO,estado nutricional en menores de 5 anos,clasificacion e,2002-10-01,3,0,3,0,3
80302,SAN BORJA,estado nutricional en menores de 5 anos,clasificacion e,2002-10-01,44,48,44,48,92
21502,SAN BUENA VENTURA,estado nutricional en menores de 5 anos,clasificacion e,2002-10-01,8,1,8,1,9
80501,SAN IGNACIO,estado nutricional en menores de 5 anos,clasificacion e,2002-10-01,31,28,31,28,59
70301,SAN IGNACIO DE VELASCO,estado nutricional en menores de 5 anos,clasificacion e,2002-10-01,50,48,50,48,98
80102,SAN JAVIER(BNI),estado nutricional en menores de 5 anos,clasificacion e,2002-10-01,4,5,4,5,9
71102,SAN JAVIER(STC),estado nutricional en menores de 5 anos,clasificacion e,2002-10-01,22,11,22,11,33
80701,SAN JOAQUIN,estado nutricional en menores de 5 anos,clasificacion e,2002-10-01,0,3,0,3,3
70501,SAN JOSE DE CHIQUITOS,estado nutricional en menores de 5 anos,clasificacion e,2002-10-01,27,2,27,2,29
71104,SAN JULIAN,estado nutricional en menores de 5 anos,clasificacion e,2002-10-01,56,36,56,36,92
90302,SAN LORENZO(PND),estado nutricional en menores de 5 anos,clasificacion e,2002-10-01,3,14,3,14,17
60501,SAN LORENZO(TJA),estado nutricional en menores de 5 anos,clasificacion e,2002-10-01,4,7,4,7,11
10702,SAN LUCAS,estado nutricional en menores de 5 anos,clasificacion e,2002-10-01,177,163,177,163,340
71201,SAN MATIAS,estado nutricional en menores de 5 anos,clasificacion e,2002-10-01,23,4,23,4,27
70302,SAN MIGUEL DE VELASCO,estado nutricional en menores de 5 anos,clasificacion e,2002-10-01,22,35,22,35,57
51001,SAN PABLO DE LIPEZ,estado nutricional en menores de 5 anos,clasificacion e,2002-10-01,1,6,1,6,7
50501,SAN PEDRO DE BUENA VISTA,estado nutricional en menores de 5 anos,clasificacion e,2002-10-01,43,111,43,111,154
21801,SAN PEDRO DE CURAHUARA,estado nutricional en menores de 5 anos,clasificacion e,2002-10-01,4,5,4,5,9
90202,SAN PEDRO(PND),estado nutricional en menores de 5 anos,clasificacion e,2002-10-01,1,2,1,2,3
70303,SAN RAFAEL,estado nutricional en menores de 5 anos,clasificacion e,2002-10-01,14,14,14,14,28
80702,SAN RAMON,estado nutricional en menores de 5 anos,clasificacion e,2002-10-01,1,0,1,0,1
80702,SAN RAMON,estado nutricional en menores de 5 anos,clasificacion e,2002-10-01,2,0,2,0,2
70101,SANTA CRUZ DE LA SIERRA,estado nutricional en menores de 5 anos,clasificacion e,2002-10-01,181,87,181,87,268
80303,SANTA ROSA,estado nutricional en menores de 5 anos,clasificacion e,2002-10-01,0,4,0,4,4
70602,SANTA ROSA DEL SARA,estado nutricional en menores de 5 anos,clasificacion e,2002-10-01,2,3,2,3,5
20308,SANTIAGO DE CALLAPA,estado nutricional en menores de 5 anos,clasificacion e,2002-10-01,5,6,5,6,11
41401,SANTIAGO DE HUARI,estado nutricional en menores de 5 anos,clasificacion e,2002-10-01,4,5,4,5,9
21901,SANTIAGO DE MACHACA,estado nutricional en menores de 5 anos,clasificacion e,2002-10-01,1,2,1,2,3
30702,SANTIVAÑES,estado nutricional en menores de 5 anos,clasificacion e,2002-10-01,7,4,7,4,11
40202,SANTUARIO DE QUILLACAS,estado nutricional en menores de 5 anos,clasificacion e,2002-10-01,3,2,3,2,5
20902,SAPAHAQUI,estado nutricional en menores de 5 anos,clasificacion e,2002-10-01,5,11,5,11,16
90303,SENA,estado nutricional en menores de 5 anos,clasificacion e,2002-10-01,0,9,0,9,9
21301,SICA SICA (VILLA AROMA),estado nutricional en menores de 5 anos,clasificacion e,2002-10-01,23,13,23,13,36
30703,SICAYA,estado nutricional en menores de 5 anos,clasificacion e,2002-10-01,3,5,3,5,8
30902,SIPE SIPE,estado nutricional en menores de 5 anos,clasificacion e,2002-10-01,64,27,64,27,91
10403,SOPACHUY,estado nutricional en menores de 5 anos,clasificacion e,2002-10-01,33,34,33,34,67
20601,SORATA,estado nutricional en menores de 5 anos,clasificacion e,2002-10-01,11,13,11,13,24
10101,SUCRE,estado nutricional en menores de 5 anos,clasificacion e,2002-10-01,197,156,197,156,353
31404,TACACHI,estado nutricional en menores de 5 anos,clasificacion e,2002-10-01,0,2,0,2,2
20603,TACACOMA,estado nutricional en menores de 5 anos,clasificacion e,2002-10-01,4,7,4,7,11
50303,TACOBAMBA,estado nutricional en menores de 5 anos,clasificacion e,2002-10-01,31,24,31,24,55
30602,TACOPAYA,estado nutricional en menores de 5 anos,clasificacion e,2002-10-01,17,43,17,43,60
51402,TAHUA,estado nutricional en menores de 5 anos,clasificacion e,2002-10-01,1,0,1,0,1
31101,TAPACARI,estado nutricional en menores de 5 anos,clasificacion e,2002-10-01,41,25,41,25,66
10601,TARABUCO,estado nutricional en menores de 5 anos,clasificacion e,2002-10-01,136,114,136,114,250
30401,TARATA,estado nutricional en menores de 5 anos,clasificacion e,2002-10-01,8,7,8,7,15
60101,TARIJA,estado nutricional en menores de 5 anos,clasificacion e,2002-10-01,50,39,50,39,89
10202,TARVITA,estado nutricional en menores de 5 anos,clasificacion e,2002-10-01,35,51,35,51,86
20803,TIAWANACU,estado nutricional en menores de 5 anos,clasificacion e,2002-10-01,3,5,3,5,8
50102,TINGUIPAYA,estado nutricional en menores de 5 anos,clasificacion e,2002-10-01,74,61,74,61,135
20606,TIPUANI,estado nutricional en menores de 5 anos,clasificacion e,2002-10-01,1,3,1,3,4
30903,TIQUIPAYA,estado nutricional en menores de 5 anos,clasificacion e,2002-10-01,28,20,28,20,48
31601,TIRAQUE (CBBA),estado nutricional en menores de 5 anos,clasificacion e,2002-10-01,34,49,34,49,83
21703,TITO YUPANQUI (PARQUIPUJIO),estado nutricional en menores de 5 anos,clasificacion e,2002-10-01,0,2,0,2,2
30802,TOCO,estado nutricional en menores de 5 anos,clasificacion e,2002-10-01,0,8,0,8,8
30803,TOLATA,estado nutricional en menores de 5 anos,clasificacion e,2002-10-01,1,0,1,0,1
41001,TOLEDO,estado nutricional en menores de 5 anos,clasificacion e,2002-10-01,2,2,2,2,4
51202,TOMAVE,estado nutricional en menores de 5 anos,clasificacion e,2002-10-01,19,8,19,8,27
10402,TOMINA,estado nutricional en menores de 5 anos,clasificacion e,2002-10-01,28,39,28,39,67
50502,TORO TORO,estado nutricional en menores de 5 anos,clasificacion e,2002-10-01,23,17,23,17,40
31201,TOTORA(CBBA),estado nutricional en menores de 5 anos,clasificacion e,2002-10-01,9,5,9,5,14
41301,TOTORA(ORR),estado nutricional en menores de 5 anos,clasificacion e,2002-10-01,0,1,0,1,1
80101,TRINIDAD,estado nutricional en menores de 5 anos,clasificacion e,2002-10-01,37,51,37,51,88
50801,TUPIZA,estado nutricional en menores de 5 anos,clasificacion e,2002-10-01,17,87,17,87,104
40402,TURCO,estado nutricional en menores de 5 anos,clasificacion e,2002-10-01,0,2,0,2,2
50201,UNCIA,estado nutricional en menores de 5 anos,clasificacion e,2002-10-01,2,0,2,0,2
60401,URIONDO (A. CONCEPCION),estado nutricional en menores de 5 anos,clasificacion e,2002-10-01,2,5,2,5,7
71502,URUBICHA,estado nutricional en menores de 5 anos,clasificacion e,2002-10-01,29,49,29,49,78
51201,UYUNI,estado nutricional en menores de 5 anos,clasificacion e,2002-10-01,10,8,10,8,18
30502,VACAS,estado nutricional en menores de 5 anos,clasificacion e,2002-10-01,7,21,7,21,28
70801,VALLEGRANDE,estado nutricional en menores de 5 anos,clasificacion e,2002-10-01,15,17,15,17,32
20801,VIACHA,estado nutricional en menores de 5 anos,clasificacion e,2002-10-01,22,21,22,21,43
31302,VILA VILA,estado nutricional en menores de 5 anos,clasificacion e,2002-10-01,13,32,13,32,45
60303,VILLA MONTES,estado nutricional en menores de 5 anos,clasificacion e,2002-10-01,20,10,20,10,30
31402,VILLA RIVERO,estado nutricional en menores de 5 anos,clasificacion e,2002-10-01,2,11,2,11,13
10801,VILLA SERRANO,estado nutricional en menores de 5 anos,clasificacion e,2002-10-01,42,61,42,61,103
31003,VILLA TUNARI,estado nutricional en menores de 5 anos,clasificacion e,2002-10-01,39,46,39,46,85
11001,VILLA VACA GUZMAN (MUYUPAMPA),estado nutricional en menores de 5 anos,clasificacion e,2002-10-01,16,10,16,10,26
51501,VILLAZON,estado nutricional en menores de 5 anos,clasificacion e,2002-10-01,30,32,30,32,62
30904,VINTO,estado nutricional en menores de 5 anos,clasificacion e,2002-10-01,25,11,25,11,36
50602,VITICHI,estado nutricional en menores de 5 anos,clasificacion e,2002-10-01,11,17,11,17,28
20306,WALDO BALLIVIAN,estado nutricional en menores de 5 anos,clasificacion e,2002-10-01,2,0,2,0,2
70201,WARNES,estado nutricional en menores de 5 anos,clasificacion e,2002-10-01,20,22,20,22,42
20903,YACO,estado nutricional en menores de 5 anos,clasificacion e,2002-10-01,12,29,12,29,41
60301,YACUIBA,estado nutricional en menores de 5 anos,clasificacion e,2002-10-01,24,12,24,12,36
10602,YAMPARAEZ,estado nutricional en menores de 5 anos,clasificacion e,2002-10-01,56,32,56,32,88
21103,YANACACHI,estado nutricional en menores de 5 anos,clasificacion e,2002-10-01,1,3,1,3,4
50103,YOCALLA,estado nutricional en menores de 5 anos,clasificacion e,2002-10-01,13,19,13,19,32
10102,YOTALA,estado nutricional en menores de 5 anos,clasificacion e,2002-10-01,33,43,33,43,76
60402,YUNCHARA,estado nutricional en menores de 5 anos,clasificacion e,2002-10-01,3,8,3,8,11
10301,ZUDAÑEZ,estado nutricional en menores de 5 anos,clasificacion e,2002-10-01,35,41,35,41,76
51302,ACACIO,estado nutricional en menores de 5 anos,clasificacion e,2002-11-01,15,32,15,32,47
20201,ACHACACHI,estado nutricional en menores de 5 anos,clasificacion e,2002-11-01,51,17,51,17,68
20104,ACHOCALLA,estado nutricional en menores de 5 anos,clasificacion e,2002-11-01,7,1,7,1,8
30201,AIQUILE,estado nutricional en menores de 5 anos,clasificacion e,2002-11-01,30,35,30,35,65
31303,ALALAY,estado nutricional en menores de 5 anos,clasificacion e,2002-11-01,1,12,1,12,13
10404,ALCALA,estado nutricional en menores de 5 anos,clasificacion e,2002-11-01,12,22,12,22,34
20202,ANCORAIMES,estado nutricional en menores de 5 anos,clasificacion e,2002-11-01,21,22,21,22,43
41201,ANDAMARCA,estado nutricional en menores de 5 anos,clasificacion e,2002-11-01,1,0,1,0,1
30402,ANZALDO,estado nutricional en menores de 5 anos,clasificacion e,2002-11-01,5,23,5,23,28
20701,APOLO,estado nutricional en menores de 5 anos,clasificacion e,2002-11-01,17,19,17,19,36
51301,ARAMPAMPA,estado nutricional en menores de 5 anos,clasificacion e,2002-11-01,8,21,8,21,29
30501,ARANI,estado nutricional en menores de 5 anos,clasificacion e,2002-11-01,12,11,12,11,23
30601,ARQUE,estado nutricional en menores de 5 anos,clasificacion e,2002-11-01,19,12,19,12,31
50802,ATOCHA,estado nutricional en menores de 5 anos,clasificacion e,2002-11-01,1,36,1,36,37
20503,AUCAPATA,estado nutricional en menores de 5 anos,clasificacion e,2002-11-01,5,2,5,2,7
20502,AYATA,estado nutricional en menores de 5 anos,clasificacion e,2002-11-01,27,8,27,8,35
21303,AYO AYO,estado nutricional en menores de 5 anos,clasificacion e,2002-11-01,1,1,1,1,2
30301,AYOPAYA (V. DE INDEPENDENCIA),estado nutricional en menores de 5 anos,clasificacion e,2002-11-01,19,18,19,18,37
10201,AZURDUY,estado nutricional en menores de 5 anos,clasificacion e,2002-11-01,53,52,53,52,105
21203,BATALLAS,estado nutricional en menores de 5 anos,clasificacion e,2002-11-01,10,7,10,7,17
80802,BAURES,estado nutricional en menores de 5 anos,clasificacion e,2002-11-01,4,1,4,1,5
41202,BELEN DE ANDAMARCA,estado nutricional en menores de 5 anos,clasificacion e,2002-11-01,1,0,1,0,1
50104,BELEN DE URMIRI,estado nutricional en menores de 5 anos,clasificacion e,2002-11-01,2,4,2,4,6
60202,BERMEJO,estado nutricional en menores de 5 anos,clasificacion e,2002-11-01,2,0,2,0,2
50301,BETANZOS,estado nutricional en menores de 5 anos,clasificacion e,2002-11-01,112,123,112,123,235
31501,BOLIVAR,estado nutricional en menores de 5 anos,clasificacion e,2002-11-01,32,20,32,20,52
90103,BOLPEBRA,estado nutricional en menores de 5 anos,clasificacion e,2002-11-01,1,0,1,0,1
70707,BOYUIBE,estado nutricional en menores de 5 anos,clasificacion e,2002-11-01,0,4,0,4,4
70401,BUENA VISTA,estado nutricional en menores de 5 anos,clasificacion e,2002-11-01,2,8,2,8,10
70703,CABEZAS,estado nutricional en menores de 5 anos,clasificacion e,2002-11-01,11,6,11,6,17
20905,CAIROMA,estado nutricional en menores de 5 anos,clasificacion e,2002-11-01,12,10,12,10,22
51102,"CAIZA ""D""",estado nutricional en menores de 5 anos,clasificacion e,2002-11-01,39,16,39,16,55
21003,CAJUATA,estado nutricional en menores de 5 anos,clasificacion e,2002-11-01,12,18,12,18,30
20303,CALACOTO,estado nutricional en menores de 5 anos,clasificacion e,2002-11-01,9,2,9,2,11
21304,CALAMARCA,estado nutricional en menores de 5 anos,clasificacion e,2002-11-01,18,10,18,10,28
10701,CAMARGO,estado nutricional en menores de 5 anos,clasificacion e,2002-11-01,15,30,15,30,45
10901,CAMATAQUI (C. VILLA ABECIA),estado nutricional en menores de 5 anos,clasificacion e,2002-11-01,2,4,2,4,6
70706,CAMIRI,estado nutricional en menores de 5 anos,clasificacion e,2002-11-01,27,21,27,21,48
30701,CAPINOTA,estado nutricional en menores de 5 anos,clasificacion e,2002-11-01,29,23,29,23,52
20302,CAQUIAVIRI,estado nutricional en menores de 5 anos,clasificacion e,2002-11-01,6,11,6,11,17
40102,CARACOLLO,estado nutricional en menores de 5 anos,clasificacion e,2002-11-01,2,26,2,26,28
22001,CARANAVI,estado nutricional en menores de 5 anos,clasificacion e,2002-11-01,38,28,38,28,66
60302,CARAPARI,estado nutricional en menores de 5 anos,clasificacion e,2002-11-01,3,3,3,3,6
50702,CARIPUYO,estado nutricional en menores de 5 anos,clasificacion e,2002-11-01,49,27,49,27,76
21902,CATACORA,estado nutricional en menores de 5 anos,clasificacion e,2002-11-01,3,0,3,0,3
40201,CHALLAPATA,estado nutricional en menores de 5 anos,clasificacion e,2002-11-01,18,12,18,12,30
50302,CHAQUI,estado nutricional en menores de 5 anos,clasificacion e,2002-11-01,33,17,33,17,50
70702,CHARAGUA,estado nutricional en menores de 5 anos,clasificacion e,2002-11-01,8,28,8,28,36
20305,CHARAÑA,estado nutricional en menores de 5 anos,clasificacion e,2002-11-01,5,2,5,2,7
50202,CHAYANTA,estado nutricional en menores de 5 anos,clasificacion e,2002-11-01,34,38,34,38,72
31204,CHIMORE,estado nutricional en menores de 5 anos,clasificacion e,2002-11-01,7,3,7,3,10
40903,CHIPAYA,estado nutricional en menores de 5 anos,clasificacion e,2002-11-01,0,2,0,2,2
21101,CHULUMANI (V. DE LA LIBERTAD),estado nutricional en menores de 5 anos,clasificacion e,2002-11-01,0,2,0,2,2
20501,CHUMA,estado nutricional en menores de 5 anos,clasificacion e,2002-11-01,10,18,10,18,28
30801,CLIZA,estado nutricional en menores de 5 anos,clasificacion e,2002-11-01,3,0,3,0,3
90101,COBIJA,estado nutricional en menores de 5 anos,clasificacion e,2002-11-01,15,4,15,4,19
30101,COCHABAMBA,estado nutricional en menores de 5 anos,clasificacion e,2002-11-01,84,84,84,84,168
30905,COLCAPIRHUA,estado nutricional en menores de 5 anos,clasificacion e,2002-11-01,4,3,4,3,7
50901,"COLCHA ""K""",estado nutricional en menores de 5 anos,clasificacion e,2002-11-01,10,6,10,6,16
31002,COLOMI,estado nutricional en menores de 5 anos,clasificacion e,2002-11-01,7,9,7,9,16
50401,COLQUECHACA,estado nutricional en menores de 5 anos,clasificacion e,2002-11-01,62,45,62,45,107
21306,COLQUENCHA,estado nutricional en menores de 5 anos,clasificacion e,2002-11-01,3,4,3,4,7
21004,COLQUIRI,estado nutricional en menores de 5 anos,clasificacion e,2002-11-01,34,19,34,19,53
20304,COMANCHE,estado nutricional en menores de 5 anos,clasificacion e,2002-11-01,4,2,4,2,6
71301,COMARAPA,estado nutricional en menores de 5 anos,clasificacion e,2002-11-01,15,15,15,15,30
20605,COMBAYA,estado nutricional en menores de 5 anos,clasificacion e,2002-11-01,2,0,2,0,2
71101,CONCEPCION,estado nutricional en menores de 5 anos,clasificacion e,2002-11-01,5,5,5,5,10
21701,COPACABANA,estado nutricional en menores de 5 anos,clasificacion e,2002-11-01,11,8,11,8,19
21402,CORIPATA,estado nutricional en menores de 5 anos,clasificacion e,2002-11-01,0,1,0,1,1
20301,CORO CORO,estado nutricional en menores de 5 anos,clasificacion e,2002-11-01,5,7,5,7,12
21401,COROICO,estado nutricional en menores de 5 anos,clasificacion e,2002-11-01,5,3,5,3,8
40301,CORQUE,estado nutricional en menores de 5 anos,clasificacion e,2002-11-01,2,0,2,0,2
50601,COTAGAITA,estado nutricional en menores de 5 anos,clasificacion e,2002-11-01,33,23,33,23,56
70102,COTOCA,estado nutricional en menores de 5 anos,clasificacion e,2002-11-01,4,1,4,1,5
31405,CUCHUMUELA (V. G. VILLARROEL),estado nutricional en menores de 5 anos,clasificacion e,2002-11-01,0,1,0,1,1
70704,CUEVO,estado nutricional en menores de 5 anos,clasificacion e,2002-11-01,7,8,7,8,15
10902,CULPINA,estado nutricional en menores de 5 anos,clasificacion e,2002-11-01,61,45,61,45,106
40401,CURAHUARA DE CARANGAS,estado nutricional en menores de 5 anos,clasificacion e,2002-11-01,2,0,2,0,2
21602,CURVA,estado nutricional en menores de 5 anos,clasificacion e,2002-11-01,5,3,5,3,8
20804,DESAGUADERO,estado nutricional en menores de 5 anos,clasificacion e,2002-11-01,0,2,0,2,2
20105,EL ALTO,estado nutricional en menores de 5 anos,clasificacion e,2002-11-01,508,241,508,241,749
40103,EL CHORO,estado nutricional en menores de 5 anos,clasificacion e,2002-11-01,1,0,1,0,1
71503,EL PUENTE(STC),estado nutricional en menores de 5 anos,clasificacion e,2002-11-01,4,24,4,24,28
60502,EL PUENTE(TJA),estado nutricional en menores de 5 anos,clasificacion e,2002-11-01,8,36,8,36,44
70105,EL TORNO,estado nutricional en menores de 5 anos,clasificacion e,2002-11-01,22,11,22,11,33
10405,EL VILLAR,estado nutricional en menores de 5 anos,clasificacion e,2002-11-01,13,27,13,27,40
60601,ENTRE RIOS,estado nutricional en menores de 5 anos,clasificacion e,2002-11-01,8,16,8,16,24
41101,EUCALIPTUS,estado nutricional en menores de 5 anos,clasificacion e,2002-11-01,4,6,4,6,10
80402,EXALTACION,estado nutricional en menores de 5 anos,clasificacion e,2002-11-01,1,8,1,8,9
90203,FILADELFIA,estado nutricional en menores de 5 anos,clasificacion e,2002-11-01,1,0,1,0,1
71002,GENERAL SAAVEDRA,estado nutricional en menores de 5 anos,clasificacion e,2002-11-01,35,16,35,16,51
21601,GRAL. J.J. PEREZ (CHARAZANI),estado nutricional en menores de 5 anos,clasificacion e,2002-11-01,9,21,9,21,30
20602,GUANAY,estado nutricional en menores de 5 anos,clasificacion e,2002-11-01,8,9,8,9,17
20802,GUAQUI,estado nutricional en menores de 5 anos,clasificacion e,2002-11-01,3,2,3,2,5
80202,GUAYARAMERIN,estado nutricional en menores de 5 anos,clasificacion e,2002-11-01,24,20,24,20,44
70705,GUTIERREZ,estado nutricional en menores de 5 anos,clasificacion e,2002-11-01,39,30,39,30,69
10502,HUACARETA,estado nutricional en menores de 5 anos,clasificacion e,2002-11-01,20,16,20,16,36
11002,HUACAYA (VILLA DE HUACAYA),estado nutricional en menores de 5 anos,clasificacion e,2002-11-01,0,4,0,4,4
40701,HUANUNI,estado nutricional en menores de 5 anos,clasificacion e,2002-11-01,8,12,8,12,20
80803,HUARACAJE,estado nutricional en menores de 5 anos,clasificacion e,2002-11-01,1,0,1,0,1
41601,HUAYLLAMARCA,estado nutricional en menores de 5 anos,clasificacion e,2002-11-01,1,0,1,0,1
21005,ICHOCA,estado nutricional en menores de 5 anos,clasificacion e,2002-11-01,7,5,7,5,12
10304,ICLA,estado nutricional en menores de 5 anos,clasificacion e,2002-11-01,63,75,63,75,138
10703,INCAHUASI,estado nutricional en menores de 5 anos,clasificacion e,2002-11-01,156,53,156,53,209
21001,INQUISIVI,estado nutricional en menores de 5 anos,clasificacion e,2002-11-01,30,41,30,41,71
21102,IRUPANA (VILLA DE LANZA),estado nutricional en menores de 5 anos,clasificacion e,2002-11-01,4,7,4,7,11
21501,IXIAMAS,estado nutricional en menores de 5 anos,clasificacion e,2002-11-01,3,5,3,5,8
21105,LA ASUNTA,estado nutricional en menores de 5 anos,clasificacion e,2002-11-01,4,7,4,7,11
70104,LA GUARDIA,estado nutricional en menores de 5 anos,clasificacion e,2002-11-01,9,2,9,2,11
20101,LA PAZ,estado nutricional en menores de 5 anos,clasificacion e,2002-11-01,262,170,262,170,432
70701,LAGUNILLAS,estado nutricional en menores de 5 anos,clasificacion e,2002-11-01,6,16,6,16,22
21202,LAJA,estado nutricional en menores de 5 anos,clasificacion e,2002-11-01,4,2,4,2,6
10903,LAS CARRERAS,estado nutricional en menores de 5 anos,clasificacion e,2002-11-01,9,11,9,11,20
50203,LLALLAGUA,estado nutricional en menores de 5 anos,clasificacion e,2002-11-01,8,53,8,53,61
51401,LLICA,estado nutricional en menores de 5 anos,clasificacion e,2002-11-01,5,1,5,1,6
80601,LORETO,estado nutricional en menores de 5 anos,clasificacion e,2002-11-01,2,3,2,3,5
20901,LURIBAY,estado nutricional en menores de 5 anos,clasificacion e,2002-11-01,12,2,12,2,14
40702,MACHACAMARCA,estado nutricional en menores de 5 anos,clasificacion e,2002-11-01,4,1,4,1,5
11003,MACHARETI,estado nutricional en menores de 5 anos,clasificacion e,2002-11-01,15,24,15,24,39
80801,MAGDALENA,estado nutricional en menores de 5 anos,clasificacion e,2002-11-01,2,3,2,3,5
70903,MAIRANA,estado nutricional en menores de 5 anos,clasificacion e,2002-11-01,8,2,8,2,10
20904,MALLA,estado nutricional en menores de 5 anos,clasificacion e,2002-11-01,4,3,4,3,7
20103,MECAPACA,estado nutricional en menores de 5 anos,clasificacion e,2002-11-01,3,5,3,5,8
71003,MINEROS,estado nutricional en menores de 5 anos,clasificacion e,2002-11-01,34,19,34,19,53
31301,MIZQUE,estado nutricional en menores de 5 anos,clasificacion e,2002-11-01,8,14,8,14,22
20402,MOCOMOCO,estado nutricional en menores de 5 anos,clasificacion e,2002-11-01,5,3,5,3,8
51002,MOJINETE,estado nutricional en menores de 5 anos,clasificacion e,2002-11-01,0,5,0,5,5
10303,MOJOCOYA,estado nutricional en menores de 5 anos,clasificacion e,2002-11-01,22,12,22,12,34
10501,MONTEAGUDO,estado nutricional en menores de 5 anos,clasificacion e,2002-11-01,36,35,36,35,71
71001,MONTERO,estado nutricional en menores de 5 anos,clasificacion e,2002-11-01,78,32,78,32,110
70803,MORO MORO,estado nutricional en menores de 5 anos,clasificacion e,2002-11-01,5,7,5,7,12
30302,MOROCHATA,estado nutricional en menores de 5 anos,clasificacion e,2002-11-01,22,40,22,40,62
90401,NACEBE (SANTA ROSA DEL ABUNA),estado nutricional en menores de 5 anos,clasificacion e,2002-11-01,1,0,1,0,1
50404,OCURI,estado nutricional en menores de 5 anos,clasificacion e,2002-11-01,23,38,23,38,61
70202,OKINAWA,estado nutricional en menores de 5 anos,clasificacion e,2002-11-01,3,0,3,0,3
30203,OMEREQUE,estado nutricional en menores de 5 anos,clasificacion e,2002-11-01,1,1,1,1,2
40101,ORURO,estado nutricional en menores de 5 anos,clasificacion e,2002-11-01,118,70,118,70,188
60201,PADCAYA,estado nutricional en menores de 5 anos,clasificacion e,2002-11-01,8,6,8,6,14
10401,PADILLA,estado nutricional en menores de 5 anos,clasificacion e,2002-11-01,29,48,29,48,77
70502,PAILON,estado nutricional en menores de 5 anos,clasificacion e,2002-11-01,4,3,4,3,7
20102,PALCA,estado nutricional en menores de 5 anos,clasificacion e,2002-11-01,17,31,17,31,48
21104,PALOS BLANCOS,estado nutricional en menores de 5 anos,clasificacion e,2002-11-01,17,14,17,14,31
40802,PAMPA AULLAGAS,estado nutricional en menores de 5 anos,clasificacion e,2002-11-01,8,2,8,2,10
70902,PAMPA GRANDE,estado nutricional en menores de 5 anos,clasificacion e,2002-11-01,2,2,2,2,4
21802,PAPEL PAMPA,estado nutricional en menores de 5 anos,clasificacion e,2002-11-01,1,0,1,0,1
30202,PASORAPA,estado nutricional en menores de 5 anos,clasificacion e,2002-11-01,9,6,9,6,15
21305,PATACAMAYA,estado nutricional en menores de 5 anos,clasificacion e,2002-11-01,17,10,17,10,27
40602,PAZÑA,estado nutricional en menores de 5 anos,clasificacion e,2002-11-01,6,4,6,4,10
20702,PELECHUCO,estado nutricional en menores de 5 anos,clasificacion e,2002-11-01,8,9,8,9,17
50403,POCOATA,estado nutricional en menores de 5 anos,clasificacion e,2002-11-01,33,47,33,47,80
31203,POCONA,estado nutricional en menores de 5 anos,clasificacion e,2002-11-01,16,15,16,15,31
31202,POJO (CBBA),estado nutricional en menores de 5 anos,clasificacion e,2002-11-01,28,15,28,15,43
40601,POOPO,estado nutricional en menores de 5 anos,clasificacion e,2002-11-01,3,3,3,3,6
10103,POROMA,estado nutricional en menores de 5 anos,clasificacion e,2002-11-01,27,48,27,48,75
70103,PORONGO,estado nutricional en menores de 5 anos,clasificacion e,2002-11-01,2,3,2,3,5
70601,PORTACHUELO,estado nutricional en menores de 5 anos,clasificacion e,2002-11-01,7,4,7,4,11
90102,PORVENIR,estado nutricional en menores de 5 anos,clasificacion e,2002-11-01,2,3,2,3,5
70804,POSTRER VALLE,estado nutricional en menores de 5 anos,clasificacion e,2002-11-01,0,2,0,2,2
50101,POTOSI,estado nutricional en menores de 5 anos,clasificacion e,2002-11-01,121,72,121,72,193
10302,PRESTO,estado nutricional en menores de 5 anos,clasificacion e,2002-11-01,22,31,22,31,53
21201,PUCARANI,estado nutricional en menores de 5 anos,clasificacion e,2002-11-01,0,4,0,4,4
20401,PUERTO ACOSTA,estado nutricional en menores de 5 anos,clasificacion e,2002-11-01,12,13,12,13,25
20403,PUERTO CARABUCO,estado nutricional en menores de 5 anos,clasificacion e,2002-11-01,8,15,8,15,23
90301,PUERTO GONZALO MORENO,estado nutricional en menores de 5 anos,clasificacion e,2002-11-01,11,0,11,0,11
71402,PUERTO QUIJARRO,estado nutricional en menores de 5 anos,clasificacion e,2002-11-01,11,1,11,1,12
90201,PUERTO RICO,estado nutricional en menores de 5 anos,clasificacion e,2002-11-01,2,8,2,8,10
80703,PUERTO SILES,estado nutricional en menores de 5 anos,clasificacion e,2002-11-01,1,1,1,1,2
71401,PUERTO SUAREZ,estado nutricional en menores de 5 anos,clasificacion e,2002-11-01,23,11,23,11,34
31205,PUERTO VILLARROEL,estado nutricional en menores de 5 anos,clasificacion e,2002-11-01,59,44,59,44,103
51101,PUNA,estado nutricional en menores de 5 anos,clasificacion e,2002-11-01,90,56,90,56,146
31401,PUNATA,estado nutricional en menores de 5 anos,clasificacion e,2002-11-01,5,10,5,10,15
20604,QUIABAYA,estado nutricional en menores de 5 anos,clasificacion e,2002-11-01,13,3,13,3,16
30901,QUILLACOLLO,estado nutricional en menores de 5 anos,clasificacion e,2002-11-01,19,22,19,22,41
21002,QUIME,estado nutricional en menores de 5 anos,clasificacion e,2002-11-01,21,10,21,10,31
50402,RAVELO,estado nutricional en menores de 5 anos,clasificacion e,2002-11-01,80,50,80,50,130
80301,REYES,estado nutricional en menores de 5 anos,clasificacion e,2002-11-01,23,12,23,12,35
80201,RIBERALTA,estado nutricional en menores de 5 anos,clasificacion e,2002-11-01,121,70,121,70,191
70503,ROBORE,estado nutricional en menores de 5 anos,clasificacion e,2002-11-01,8,5,8,5,13
40901,SABAYA,estado nutricional en menores de 5 anos,clasificacion e,2002-11-01,0,3,0,3,3
31001,SACABA,estado nutricional en menores de 5 anos,clasificacion e,2002-11-01,45,21,45,21,66
30404,SACABAMBA,estado nutricional en menores de 5 anos,clasificacion e,2002-11-01,4,21,4,21,25
50701,SACACA,estado nutricional en menores de 5 anos,clasificacion e,2002-11-01,61,82,61,82,143
71302,SAIPINA,estado nutricional en menores de 5 anos,clasificacion e,2002-11-01,5,7,5,7,12
40801,SALINAS DE GARCI MENDOZA,estado nutricional en menores de 5 anos,clasificacion e,2002-11-01,7,1,7,1,8
70901,SAMAIPATA,estado nutricional en menores de 5 anos,clasificacion e,2002-11-01,6,5,6,5,11
51601,SAN AGUSTIN,estado nutricional en menores de 5 anos,clasificacion e,2002-11-01,1,1,1,1,2
80602,SAN ANDRES,estado nutricional en menores de 5 anos,clasificacion e,2002-11-01,5,8,5,8,13
51003,SAN ANTONIO DE ESMORUCO,estado nutricional en menores de 5 anos,clasificacion e,2002-11-01,0,5,0,5,5
71105,SAN ANTONIO DE LOMERIO,estado nutricional en menores de 5 anos,clasificacion e,2002-11-01,26,33,26,33,59
31403,SAN BENITO,estado nutricional en menores de 5 anos,clasificacion e,2002-11-01,8,9,8,9,17
80302,SAN BORJA,estado nutricional en menores de 5 anos,clasificacion e,2002-11-01,38,35,38,35,73
21502,SAN BUENA VENTURA,estado nutricional en menores de 5 anos,clasificacion e,2002-11-01,17,5,17,5,22
70402,SAN CARLOS,estado nutricional en menores de 5 anos,clasificacion e,2002-11-01,16,9,16,9,25
80501,SAN IGNACIO,estado nutricional en menores de 5 anos,clasificacion e,2002-11-01,19,35,19,35,54
70301,SAN IGNACIO DE VELASCO,estado nutricional en menores de 5 anos,clasificacion e,2002-11-01,53,64,53,64,117
80102,SAN JAVIER(BNI),estado nutricional en menores de 5 anos,clasificacion e,2002-11-01,1,3,1,3,4
71102,SAN JAVIER(STC),estado nutricional en menores de 5 anos,clasificacion e,2002-11-01,7,2,7,2,9
80701,SAN JOAQUIN,estado nutricional en menores de 5 anos,clasificacion e,2002-11-01,0,2,0,2,2
70501,SAN JOSE DE CHIQUITOS,estado nutricional en menores de 5 anos,clasificacion e,2002-11-01,19,10,19,10,29
71104,SAN JULIAN,estado nutricional en menores de 5 anos,clasificacion e,2002-11-01,42,34,42,34,76
90302,SAN LORENZO(PND),estado nutricional en menores de 5 anos,clasificacion e,2002-11-01,4,2,4,2,6
60501,SAN LORENZO(TJA),estado nutricional en menores de 5 anos,clasificacion e,2002-11-01,7,8,7,8,15
10702,SAN LUCAS,estado nutricional en menores de 5 anos,clasificacion e,2002-11-01,122,89,122,89,211
70302,SAN MIGUEL DE VELASCO,estado nutricional en menores de 5 anos,clasificacion e,2002-11-01,3,8,3,8,11
51001,SAN PABLO DE LIPEZ,estado nutricional en menores de 5 anos,clasificacion e,2002-11-01,2,5,2,5,7
50501,SAN PEDRO DE BUENA VISTA,estado nutricional en menores de 5 anos,clasificacion e,2002-11-01,43,86,43,86,129
21801,SAN PEDRO DE CURAHUARA,estado nutricional en menores de 5 anos,clasificacion e,2002-11-01,3,7,3,7,10
21702,SAN PEDRO DE TIQUINA,estado nutricional en menores de 5 anos,clasificacion e,2002-11-01,1,0,1,0,1
90202,SAN PEDRO(PND),estado nutricional en menores de 5 anos,clasificacion e,2002-11-01,2,4,2,4,6
70303,SAN RAFAEL,estado nutricional en menores de 5 anos,clasificacion e,2002-11-01,10,6,10,6,16
80401,SANTA ANA,estado nutricional en menores de 5 anos,clasificacion e,2002-11-01,6,5,6,5,11
70101,SANTA CRUZ DE LA SIERRA,estado nutricional en menores de 5 anos,clasificacion e,2002-11-01,130,46,130,46,176
80303,SANTA ROSA,estado nutricional en menores de 5 anos,clasificacion e,2002-11-01,2,0,2,0,2
20308,SANTIAGO DE CALLAPA,estado nutricional en menores de 5 anos,clasificacion e,2002-11-01,6,9,6,9,15
41401,SANTIAGO DE HUARI,estado nutricional en menores de 5 anos,clasificacion e,2002-11-01,5,2,5,2,7
21901,SANTIAGO DE MACHACA,estado nutricional en menores de 5 anos,clasificacion e,2002-11-01,1,3,1,3,4
30702,SANTIVAÑES,estado nutricional en menores de 5 anos,clasificacion e,2002-11-01,1,3,1,3,4
40202,SANTUARIO DE QUILLACAS,estado nutricional en menores de 5 anos,clasificacion e,2002-11-01,1,2,1,2,3
20902,SAPAHAQUI,estado nutricional en menores de 5 anos,clasificacion e,2002-11-01,14,10,14,10,24
90303,SENA,estado nutricional en menores de 5 anos,clasificacion e,2002-11-01,2,0,2,0,2
21301,SICA SICA (VILLA AROMA),estado nutricional en menores de 5 anos,clasificacion e,2002-11-01,15,8,15,8,23
30703,SICAYA,estado nutricional en menores de 5 anos,clasificacion e,2002-11-01,0,1,0,1,1
30902,SIPE SIPE,estado nutricional en menores de 5 anos,clasificacion e,2002-11-01,75,33,75,33,108
10403,SOPACHUY,estado nutricional en menores de 5 anos,clasificacion e,2002-11-01,25,19,25,19,44
20601,SORATA,estado nutricional en menores de 5 anos,clasificacion e,2002-11-01,2,22,2,22,24
10101,SUCRE,estado nutricional en menores de 5 anos,clasificacion e,2002-11-01,160,98,160,98,258
31404,TACACHI,estado nutricional en menores de 5 anos,clasificacion e,2002-11-01,5,0,5,0,5
20603,TACACOMA,estado nutricional en menores de 5 anos,clasificacion e,2002-11-01,2,1,2,1,3
50303,TACOBAMBA,estado nutricional en menores de 5 anos,clasificacion e,2002-11-01,30,26,30,26,56
30602,TACOPAYA,estado nutricional en menores de 5 anos,clasificacion e,2002-11-01,25,26,25,26,51
51402,TAHUA,estado nutricional en menores de 5 anos,clasificacion e,2002-11-01,0,1,0,1,1
31101,TAPACARI,estado nutricional en menores de 5 anos,clasificacion e,2002-11-01,25,16,25,16,41
10601,TARABUCO,estado nutricional en menores de 5 anos,clasificacion e,2002-11-01,147,109,147,109,256
30401,TARATA,estado nutricional en menores de 5 anos,clasificacion e,2002-11-01,9,1,9,1,10
60101,TARIJA,estado nutricional en menores de 5 anos,clasificacion e,2002-11-01,36,35,36,35,71
10202,TARVITA,estado nutricional en menores de 5 anos,clasificacion e,2002-11-01,19,32,19,32,51
20803,TIAWANACU,estado nutricional en menores de 5 anos,clasificacion e,2002-11-01,4,4,4,4,8
50102,TINGUIPAYA,estado nutricional en menores de 5 anos,clasificacion e,2002-11-01,9,43,9,43,52
20606,TIPUANI,estado nutricional en menores de 5 anos,clasificacion e,2002-11-01,3,6,3,6,9
30903,TIQUIPAYA,estado nutricional en menores de 5 anos,clasificacion e,2002-11-01,33,19,33,19,52
31601,TIRAQUE (CBBA),estado nutricional en menores de 5 anos,clasificacion e,2002-11-01,27,19,27,19,46
21703,TITO YUPANQUI (PARQUIPUJIO),estado nutricional en menores de 5 anos,clasificacion e,2002-11-01,2,2,2,2,4
30802,TOCO,estado nutricional en menores de 5 anos,clasificacion e,2002-11-01,0,3,0,3,3
41001,TOLEDO,estado nutricional en menores de 5 anos,clasificacion e,2002-11-01,3,0,3,0,3
51202,TOMAVE,estado nutricional en menores de 5 anos,clasificacion e,2002-11-01,23,20,23,20,43
10402,TOMINA,estado nutricional en menores de 5 anos,clasificacion e,2002-11-01,23,46,23,46,69
50502,TORO TORO,estado nutricional en menores de 5 anos,clasificacion e,2002-11-01,4,11,4,11,15
31201,TOTORA(CBBA),estado nutricional en menores de 5 anos,clasificacion e,2002-11-01,7,6,7,6,13
41301,TOTORA(ORR),estado nutricional en menores de 5 anos,clasificacion e,2002-11-01,3,2,3,2,5
70802,TRIGAL,estado nutricional en menores de 5 anos,clasificacion e,2002-11-01,2,0,2,0,2
80101,TRINIDAD,estado nutricional en menores de 5 anos,clasificacion e,2002-11-01,27,37,27,37,64
50801,TUPIZA,estado nutricional en menores de 5 anos,clasificacion e,2002-11-01,12,73,12,73,85
40402,TURCO,estado nutricional en menores de 5 anos,clasificacion e,2002-11-01,1,0,1,0,1
21302,UMALA,estado nutricional en menores de 5 anos,clasificacion e,2002-11-01,1,0,1,0,1
50201,UNCIA,estado nutricional en menores de 5 anos,clasificacion e,2002-11-01,6,8,6,8,14
60401,URIONDO (A. CONCEPCION),estado nutricional en menores de 5 anos,clasificacion e,2002-11-01,0,1,0,1,1
71502,URUBICHA,estado nutricional en menores de 5 anos,clasificacion e,2002-11-01,18,16,18,16,34
51201,UYUNI,estado nutricional en menores de 5 anos,clasificacion e,2002-11-01,12,13,12,13,25
30502,VACAS,estado nutricional en menores de 5 anos,clasificacion e,2002-11-01,13,26,13,26,39
70801,VALLEGRANDE,estado nutricional en menores de 5 anos,clasificacion e,2002-11-01,11,15,11,15,26
20801,VIACHA,estado nutricional en menores de 5 anos,clasificacion e,2002-11-01,22,29,22,29,51
31302,VILA VILA,estado nutricional en menores de 5 anos,clasificacion e,2002-11-01,0,9,0,9,9
60303,VILLA MONTES,estado nutricional en menores de 5 anos,clasificacion e,2002-11-01,14,5,14,5,19
31402,VILLA RIVERO,estado nutricional en menores de 5 anos,clasificacion e,2002-11-01,9,1,9,1,10
10801,VILLA SERRANO,estado nutricional en menores de 5 anos,clasificacion e,2002-11-01,51,63,51,63,114
31003,VILLA TUNARI,estado nutricional en menores de 5 anos,clasificacion e,2002-11-01,18,30,18,30,48
11001,VILLA VACA GUZMAN (MUYUPAMPA),estado nutricional en menores de 5 anos,clasificacion e,2002-11-01,10,14,10,14,24
51501,VILLAZON,estado nutricional en menores de 5 anos,clasificacion e,2002-11-01,32,34,32,34,66
30904,VINTO,estado nutricional en menores de 5 anos,clasificacion e,2002-11-01,6,4,6,4,10
50602,VITICHI,estado nutricional en menores de 5 anos,clasificacion e,2002-11-01,10,21,10,21,31
20306,WALDO BALLIVIAN,estado nutricional en menores de 5 anos,clasificacion e,2002-11-01,1,1,1,1,2
70201,WARNES,estado nutricional en menores de 5 anos,clasificacion e,2002-11-01,42,18,42,18,60
20903,YACO,estado nutricional en menores de 5 anos,clasificacion e,2002-11-01,11,10,11,10,21
60301,YACUIBA,estado nutricional en menores de 5 anos,clasificacion e,2002-11-01,21,15,21,15,36
10602,YAMPARAEZ,estado nutricional en menores de 5 anos,clasificacion e,2002-11-01,72,44,72,44,116
21103,YANACACHI,estado nutricional en menores de 5 anos,clasificacion e,2002-11-01,3,2,3,2,5
70403,YAPACANI,estado nutricional en menores de 5 anos,clasificacion e,2002-11-01,14,17,14,17,31
50103,YOCALLA,estado nutricional en menores de 5 anos,clasificacion e,2002-11-01,10,14,10,14,24
10102,YOTALA,estado nutricional en menores de 5 anos,clasificacion e,2002-11-01,26,36,26,36,62
60402,YUNCHARA,estado nutricional en menores de 5 anos,clasificacion e,2002-11-01,8,12,8,12,20
10301,ZUDAÑEZ,estado nutricional en menores de 5 anos,clasificacion e,2002-11-01,33,46,33,46,79
51302,ACACIO,estado nutricional en menores de 5 anos,clasificacion e,2002-12-01,9,39,9,39,48
20201,ACHACACHI,estado nutricional en menores de 5 anos,clasificacion e,2002-12-01,28,24,28,24,52
20104,ACHOCALLA,estado nutricional en menores de 5 anos,clasificacion e,2002-12-01,4,1,4,1,5
30201,AIQUILE,estado nutricional en menores de 5 anos,clasificacion e,2002-12-01,11,6,11,6,17
31303,ALALAY,estado nutricional en menores de 5 anos,clasificacion e,2002-12-01,0,4,0,4,4
10404,ALCALA,estado nutricional en menores de 5 anos,clasificacion e,2002-12-01,17,16,17,16,33
20202,ANCORAIMES,estado nutricional en menores de 5 anos,clasificacion e,2002-12-01,10,14,10,14,24
41201,ANDAMARCA,estado nutricional en menores de 5 anos,clasificacion e,2002-12-01,1,0,1,0,1
30402,ANZALDO,estado nutricional en menores de 5 anos,clasificacion e,2002-12-01,6,10,6,10,16
20701,APOLO,estado nutricional en menores de 5 anos,clasificacion e,2002-12-01,10,11,10,11,21
51301,ARAMPAMPA,estado nutricional en menores de 5 anos,clasificacion e,2002-12-01,21,31,21,31,52
30501,ARANI,estado nutricional en menores de 5 anos,clasificacion e,2002-12-01,5,2,5,2,7
30403,ARBIETO,estado nutricional en menores de 5 anos,clasificacion e,2002-12-01,2,1,2,1,3
30601,ARQUE,estado nutricional en menores de 5 anos,clasificacion e,2002-12-01,2,2,2,2,4
71501,ASCENCION DE GUARAYOS,estado nutricional en menores de 5 anos,clasificacion e,2002-12-01,1,3,1,3,4
50802,ATOCHA,estado nutricional en menores de 5 anos,clasificacion e,2002-12-01,1,25,1,25,26
20502,AYATA,estado nutricional en menores de 5 anos,clasificacion e,2002-12-01,14,14,14,14,28
21303,AYO AYO,estado nutricional en menores de 5 anos,clasificacion e,2002-12-01,16,0,16,0,16
30301,AYOPAYA (V. DE INDEPENDENCIA),estado nutricional en menores de 5 anos,clasificacion e,2002-12-01,19,16,19,16,35
10201,AZURDUY,estado nutricional en menores de 5 anos,clasificacion e,2002-12-01,42,39,42,39,81
21203,BATALLAS,estado nutricional en menores de 5 anos,clasificacion e,2002-12-01,0,1,0,1,1
80802,BAURES,estado nutricional en menores de 5 anos,clasificacion e,2002-12-01,3,2,3,2,5
41202,BELEN DE ANDAMARCA,estado nutricional en menores de 5 anos,clasificacion e,2002-12-01,1,0,1,0,1
50104,BELEN DE URMIRI,estado nutricional en menores de 5 anos,clasificacion e,2002-12-01,2,3,2,3,5
60202,BERMEJO,estado nutricional en menores de 5 anos,clasificacion e,2002-12-01,7,3,7,3,10
50301,BETANZOS,estado nutricional en menores de 5 anos,clasificacion e,2002-12-01,108,80,108,80,188
31501,BOLIVAR,estado nutricional en menores de 5 anos,clasificacion e,2002-12-01,17,14,17,14,31
90103,BOLPEBRA,estado nutricional en menores de 5 anos,clasificacion e,2002-12-01,1,1,1,1,2
70707,BOYUIBE,estado nutricional en menores de 5 anos,clasificacion e,2002-12-01,1,0,1,0,1
70703,CABEZAS,estado nutricional en menores de 5 anos,clasificacion e,2002-12-01,4,12,4,12,16
20905,CAIROMA,estado nutricional en menores de 5 anos,clasificacion e,2002-12-01,20,14,20,14,34
51102,"CAIZA ""D""",estado nutricional en menores de 5 anos,clasificacion e,2002-12-01,19,7,19,7,26
21003,CAJUATA,estado nutricional en menores de 5 anos,clasificacion e,2002-12-01,3,9,3,9,12
20303,CALACOTO,estado nutricional en menores de 5 anos,clasificacion e,2002-12-01,6,0,6,0,6
21304,CALAMARCA,estado nutricional en menores de 5 anos,clasificacion e,2002-12-01,41,20,41,20,61
10701,CAMARGO,estado nutricional en menores de 5 anos,clasificacion e,2002-12-01,21,20,21,20,41
10901,CAMATAQUI (C. VILLA ABECIA),estado nutricional en menores de 5 anos,clasificacion e,2002-12-01,3,3,3,3,6
70706,CAMIRI,estado nutricional en menores de 5 anos,clasificacion e,2002-12-01,29,15,29,15,44
30701,CAPINOTA,estado nutricional en menores de 5 anos,clasificacion e,2002-12-01,26,18,26,18,44
20302,CAQUIAVIRI,estado nutricional en menores de 5 anos,clasificacion e,2002-12-01,6,1,6,1,7
40102,CARACOLLO,estado nutricional en menores de 5 anos,clasificacion e,2002-12-01,0,16,0,16,16
22001,CARANAVI,estado nutricional en menores de 5 anos,clasificacion e,2002-12-01,36,15,36,15,51
60302,CARAPARI,estado nutricional en menores de 5 anos,clasificacion e,2002-12-01,7,5,7,5,12
50702,CARIPUYO,estado nutricional en menores de 5 anos,clasificacion e,2002-12-01,19,17,19,17,36
21902,CATACORA,estado nutricional en menores de 5 anos,clasificacion e,2002-12-01,2,1,2,1,3
40201,CHALLAPATA,estado nutricional en menores de 5 anos,clasificacion e,2002-12-01,9,20,9,20,29
50302,CHAQUI,estado nutricional en menores de 5 anos,clasificacion e,2002-12-01,29,12,29,12,41
70702,CHARAGUA,estado nutricional en menores de 5 anos,clasificacion e,2002-12-01,15,29,15,29,44
50202,CHAYANTA,estado nutricional en menores de 5 anos,clasificacion e,2002-12-01,38,36,38,36,74
31204,CHIMORE,estado nutricional en menores de 5 anos,clasificacion e,2002-12-01,8,0,8,0,8
20501,CHUMA,estado nutricional en menores de 5 anos,clasificacion e,2002-12-01,13,5,13,5,18
30801,CLIZA,estado nutricional en menores de 5 anos,clasificacion e,2002-12-01,2,1,2,1,3
90101,COBIJA,estado nutricional en menores de 5 anos,clasificacion e,2002-12-01,34,18,34,18,52
30101,COCHABAMBA,estado nutricional en menores de 5 anos,clasificacion e,2002-12-01,67,46,67,46,113
40902,COIPASA,estado nutricional en menores de 5 anos,clasificacion e,2002-12-01,0,1,0,1,1
30905,COLCAPIRHUA,estado nutricional en menores de 5 anos,clasificacion e,2002-12-01,9,5,9,5,14
50901,"COLCHA ""K""",estado nutricional en menores de 5 anos,clasificacion e,2002-12-01,9,5,9,5,14
31002,COLOMI,estado nutricional en menores de 5 anos,clasificacion e,2002-12-01,7,3,7,3,10
50401,COLQUECHACA,estado nutricional en menores de 5 anos,clasificacion e,2002-12-01,50,25,50,25,75
21306,COLQUENCHA,estado nutricional en menores de 5 anos,clasificacion e,2002-12-01,5,2,5,2,7
21004,COLQUIRI,estado nutricional en menores de 5 anos,clasificacion e,2002-12-01,7,5,7,5,12
20304,COMANCHE,estado nutricional en menores de 5 anos,clasificacion e,2002-12-01,1,1,1,1,2
71301,COMARAPA,estado nutricional en menores de 5 anos,clasificacion e,2002-12-01,26,19,26,19,45
20605,COMBAYA,estado nutricional en menores de 5 anos,clasificacion e,2002-12-01,3,2,3,2,5
71101,CONCEPCION,estado nutricional en menores de 5 anos,clasificacion e,2002-12-01,5,0,5,0,5
21701,COPACABANA,estado nutricional en menores de 5 anos,clasificacion e,2002-12-01,5,2,5,2,7
21402,CORIPATA,estado nutricional en menores de 5 anos,clasificacion e,2002-12-01,1,3,1,3,4
20301,CORO CORO,estado nutricional en menores de 5 anos,clasificacion e,2002-12-01,6,11,6,11,17
21401,COROICO,estado nutricional en menores de 5 anos,clasificacion e,2002-12-01,7,2,7,2,9
40301,CORQUE,estado nutricional en menores de 5 anos,clasificacion e,2002-12-01,10,7,10,7,17
50601,COTAGAITA,estado nutricional en menores de 5 anos,clasificacion e,2002-12-01,28,27,28,27,55
70102,COTOCA,estado nutricional en menores de 5 anos,clasificacion e,2002-12-01,8,1,8,1,9
70704,CUEVO,estado nutricional en menores de 5 anos,clasificacion e,2002-12-01,3,3,3,3,6
10902,CULPINA,estado nutricional en menores de 5 anos,clasificacion e,2002-12-01,57,56,57,56,113
40401,CURAHUARA DE CARANGAS,estado nutricional en menores de 5 anos,clasificacion e,2002-12-01,2,0,2,0,2
21602,CURVA,estado nutricional en menores de 5 anos,clasificacion e,2002-12-01,2,0,2,0,2
20804,DESAGUADERO,estado nutricional en menores de 5 anos,clasificacion e,2002-12-01,1,0,1,0,1
20105,EL ALTO,estado nutricional en menores de 5 anos,clasificacion e,2002-12-01,404,199,404,199,603
71503,EL PUENTE(STC),estado nutricional en menores de 5 anos,clasificacion e,2002-12-01,3,23,3,23,26
60502,EL PUENTE(TJA),estado nutricional en menores de 5 anos,clasificacion e,2002-12-01,15,22,15,22,37
70105,EL TORNO,estado nutricional en menores de 5 anos,clasificacion e,2002-12-01,13,13,13,13,26
10405,EL VILLAR,estado nutricional en menores de 5 anos,clasificacion e,2002-12-01,12,25,12,25,37
60601,ENTRE RIOS,estado nutricional en menores de 5 anos,clasificacion e,2002-12-01,4,5,4,5,9
41101,EUCALIPTUS,estado nutricional en menores de 5 anos,clasificacion e,2002-12-01,5,1,5,1,6
80402,EXALTACION,estado nutricional en menores de 5 anos,clasificacion e,2002-12-01,0,2,0,2,2
71002,GENERAL SAAVEDRA,estado nutricional en menores de 5 anos,clasificacion e,2002-12-01,16,15,16,15,31
21601,GRAL. J.J. PEREZ (CHARAZANI),estado nutricional en menores de 5 anos,clasificacion e,2002-12-01,1,4,1,4,5
20602,GUANAY,estado nutricional en menores de 5 anos,clasificacion e,2002-12-01,15,9,15,9,24
20802,GUAQUI,estado nutricional en menores de 5 anos,clasificacion e,2002-12-01,4,1,4,1,5
80202,GUAYARAMERIN,estado nutricional en menores de 5 anos,clasificacion e,2002-12-01,30,20,30,20,50
70705,GUTIERREZ,estado nutricional en menores de 5 anos,clasificacion e,2002-12-01,31,21,31,21,52
10502,HUACARETA,estado nutricional en menores de 5 anos,clasificacion e,2002-12-01,17,16,17,16,33
11002,HUACAYA (VILLA DE HUACAYA),estado nutricional en menores de 5 anos,clasificacion e,2002-12-01,2,0,2,0,2
40701,HUANUNI,estado nutricional en menores de 5 anos,clasificacion e,2002-12-01,16,8,16,8,24
80803,HUARACAJE,estado nutricional en menores de 5 anos,clasificacion e,2002-12-01,0,1,0,1,1
21005,ICHOCA,estado nutricional en menores de 5 anos,clasificacion e,2002-12-01,8,0,8,0,8
10304,ICLA,estado nutricional en menores de 5 anos,clasificacion e,2002-12-01,50,69,50,69,119
10703,INCAHUASI,estado nutricional en menores de 5 anos,clasificacion e,2002-12-01,38,26,38,26,64
21001,INQUISIVI,estado nutricional en menores de 5 anos,clasificacion e,2002-12-01,28,19,28,19,47
21501,IXIAMAS,estado nutricional en menores de 5 anos,clasificacion e,2002-12-01,7,22,7,22,29
21105,LA ASUNTA,estado nutricional en menores de 5 anos,clasificacion e,2002-12-01,11,10,11,10,21
70104,LA GUARDIA,estado nutricional en menores de 5 anos,clasificacion e,2002-12-01,8,4,8,4,12
20101,LA PAZ,estado nutricional en menores de 5 anos,clasificacion e,2002-12-01,182,112,182,112,294
70701,LAGUNILLAS,estado nutricional en menores de 5 anos,clasificacion e,2002-12-01,6,8,6,8,14
21202,LAJA,estado nutricional en menores de 5 anos,clasificacion e,2002-12-01,8,3,8,3,11
10903,LAS CARRERAS,estado nutricional en menores de 5 anos,clasificacion e,2002-12-01,1,12,1,12,13
50203,LLALLAGUA,estado nutricional en menores de 5 anos,clasificacion e,2002-12-01,16,64,16,64,80
51401,LLICA,estado nutricional en menores de 5 anos,clasificacion e,2002-12-01,0,1,0,1,1
20901,LURIBAY,estado nutricional en menores de 5 anos,clasificacion e,2002-12-01,4,0,4,0,4
40702,MACHACAMARCA,estado nutricional en menores de 5 anos,clasificacion e,2002-12-01,0,2,0,2,2
11003,MACHARETI,estado nutricional en menores de 5 anos,clasificacion e,2002-12-01,19,30,19,30,49
80801,MAGDALENA,estado nutricional en menores de 5 anos,clasificacion e,2002-12-01,1,1,1,1,2
70903,MAIRANA,estado nutricional en menores de 5 anos,clasificacion e,2002-12-01,3,2,3,2,5
20103,MECAPACA,estado nutricional en menores de 5 anos,clasificacion e,2002-12-01,2,2,2,2,4
71003,MINEROS,estado nutricional en menores de 5 anos,clasificacion e,2002-12-01,26,14,26,14,40
31301,MIZQUE,estado nutricional en menores de 5 anos,clasificacion e,2002-12-01,11,9,11,9,20
20402,MOCOMOCO,estado nutricional en menores de 5 anos,clasificacion e,2002-12-01,9,2,9,2,11
10303,MOJOCOYA,estado nutricional en menores de 5 anos,clasificacion e,2002-12-01,9,9,9,9,18
10501,MONTEAGUDO,estado nutricional en menores de 5 anos,clasificacion e,2002-12-01,26,27,26,27,53
71001,MONTERO,estado nutricional en menores de 5 anos,clasificacion e,2002-12-01,54,23,54,23,77
30302,MOROCHATA,estado nutricional en menores de 5 anos,clasificacion e,2002-12-01,16,23,16,23,39
90401,NACEBE (SANTA ROSA DEL ABUNA),estado nutricional en menores de 5 anos,clasificacion e,2002-12-01,0,3,0,3,3
20307,NAZACARA DE PACAJES,estado nutricional en menores de 5 anos,clasificacion e,2002-12-01,2,0,2,0,2
50404,OCURI,estado nutricional en menores de 5 anos,clasificacion e,2002-12-01,23,43,23,43,66
70202,OKINAWA,estado nutricional en menores de 5 anos,clasificacion e,2002-12-01,3,0,3,0,3
30203,OMEREQUE,estado nutricional en menores de 5 anos,clasificacion e,2002-12-01,0,1,0,1,1
40101,ORURO,estado nutricional en menores de 5 anos,clasificacion e,2002-12-01,97,60,97,60,157
60201,PADCAYA,estado nutricional en menores de 5 anos,clasificacion e,2002-12-01,6,4,6,4,10
10401,PADILLA,estado nutricional en menores de 5 anos,clasificacion e,2002-12-01,33,50,33,50,83
70502,PAILON,estado nutricional en menores de 5 anos,clasificacion e,2002-12-01,4,3,4,3,7
20102,PALCA,estado nutricional en menores de 5 anos,clasificacion e,2002-12-01,10,10,10,10,20
21104,PALOS BLANCOS,estado nutricional en menores de 5 anos,clasificacion e,2002-12-01,11,5,11,5,16
40802,PAMPA AULLAGAS,estado nutricional en menores de 5 anos,clasificacion e,2002-12-01,3,1,3,1,4
70902,PAMPA GRANDE,estado nutricional en menores de 5 anos,clasificacion e,2002-12-01,3,1,3,1,4
21802,PAPEL PAMPA,estado nutricional en menores de 5 anos,clasificacion e,2002-12-01,1,1,1,1,2
30202,PASORAPA,estado nutricional en menores de 5 anos,clasificacion e,2002-12-01,3,3,3,3,6
21305,PATACAMAYA,estado nutricional en menores de 5 anos,clasificacion e,2002-12-01,10,9,10,9,19
40602,PAZÑA,estado nutricional en menores de 5 anos,clasificacion e,2002-12-01,1,4,1,4,5
20702,PELECHUCO,estado nutricional en menores de 5 anos,clasificacion e,2002-12-01,5,0,5,0,5
50403,POCOATA,estado nutricional en menores de 5 anos,clasificacion e,2002-12-01,38,62,38,62,100
31203,POCONA,estado nutricional en menores de 5 anos,clasificacion e,2002-12-01,22,11,22,11,33
31202,POJO (CBBA),estado nutricional en menores de 5 anos,clasificacion e,2002-12-01,23,7,23,7,30
40601,POOPO,estado nutricional en menores de 5 anos,clasificacion e,2002-12-01,3,3,3,3,6
51203,PORCO,estado nutricional en menores de 5 anos,clasificacion e,2002-12-01,1,6,1,6,7
10103,POROMA,estado nutricional en menores de 5 anos,clasificacion e,2002-12-01,29,35,29,35,64
70601,PORTACHUELO,estado nutricional en menores de 5 anos,clasificacion e,2002-12-01,14,15,14,15,29
90102,PORVENIR,estado nutricional en menores de 5 anos,clasificacion e,2002-12-01,5,0,5,0,5
70804,POSTRER VALLE,estado nutricional en menores de 5 anos,clasificacion e,2002-12-01,2,2,2,2,4
50101,POTOSI,estado nutricional en menores de 5 anos,clasificacion e,2002-12-01,129,65,129,65,194
10302,PRESTO,estado nutricional en menores de 5 anos,clasificacion e,2002-12-01,24,22,24,22,46
20401,PUERTO ACOSTA,estado nutricional en menores de 5 anos,clasificacion e,2002-12-01,13,15,13,15,28
20403,PUERTO CARABUCO,estado nutricional en menores de 5 anos,clasificacion e,2002-12-01,11,6,11,6,17
90301,PUERTO GONZALO MORENO,estado nutricional en menores de 5 anos,clasificacion e,2002-12-01,1,0,1,0,1
21204,PUERTO PEREZ,estado nutricional en menores de 5 anos,clasificacion e,2002-12-01,1,1,1,1,2
71402,PUERTO QUIJARRO,estado nutricional en menores de 5 anos,clasificacion e,2002-12-01,11,1,11,1,12
90201,PUERTO RICO,estado nutricional en menores de 5 anos,clasificacion e,2002-12-01,2,3,2,3,5
71401,PUERTO SUAREZ,estado nutricional en menores de 5 anos,clasificacion e,2002-12-01,13,7,13,7,20
31205,PUERTO VILLARROEL,estado nutricional en menores de 5 anos,clasificacion e,2002-12-01,50,28,50,28,78
51101,PUNA,estado nutricional en menores de 5 anos,clasificacion e,2002-12-01,27,15,27,15,42
31401,PUNATA,estado nutricional en menores de 5 anos,clasificacion e,2002-12-01,39,16,39,16,55
30901,QUILLACOLLO,estado nutricional en menores de 5 anos,clasificacion e,2002-12-01,16,25,16,25,41
21002,QUIME,estado nutricional en menores de 5 anos,clasificacion e,2002-12-01,7,8,7,8,15
50402,RAVELO,estado nutricional en menores de 5 anos,clasificacion e,2002-12-01,114,101,114,101,215
80301,REYES,estado nutricional en menores de 5 anos,clasificacion e,2002-12-01,1,2,1,2,3
80201,RIBERALTA,estado nutricional en menores de 5 anos,clasificacion e,2002-12-01,85,92,85,92,177
70503,ROBORE,estado nutricional en menores de 5 anos,clasificacion e,2002-12-01,10,9,10,9,19
80304,RURRENABAQUE,estado nutricional en menores de 5 anos,clasificacion e,2002-12-01,2,1,2,1,3
31001,SACABA,estado nutricional en menores de 5 anos,clasificacion e,2002-12-01,39,14,39,14,53
30404,SACABAMBA,estado nutricional en menores de 5 anos,clasificacion e,2002-12-01,3,7,3,7,10
50701,SACACA,estado nutricional en menores de 5 anos,clasificacion e,2002-12-01,49,75,49,75,124
71302,SAIPINA,estado nutricional en menores de 5 anos,clasificacion e,2002-12-01,7,6,7,6,13
40801,SALINAS DE GARCI MENDOZA,estado nutricional en menores de 5 anos,clasificacion e,2002-12-01,3,6,3,6,9
70901,SAMAIPATA,estado nutricional en menores de 5 anos,clasificacion e,2002-12-01,2,2,2,2,4
80602,SAN ANDRES,estado nutricional en menores de 5 anos,clasificacion e,2002-12-01,6,2,6,2,8
51003,SAN ANTONIO DE ESMORUCO,estado nutricional en menores de 5 anos,clasificacion e,2002-12-01,0,4,0,4,4
71105,SAN ANTONIO DE LOMERIO,estado nutricional en menores de 5 anos,clasificacion e,2002-12-01,32,36,32,36,68
31403,SAN BENITO,estado nutricional en menores de 5 anos,clasificacion e,2002-12-01,5,2,5,2,7
80302,SAN BORJA,estado nutricional en menores de 5 anos,clasificacion e,2002-12-01,42,33,42,33,75
21502,SAN BUENA VENTURA,estado nutricional en menores de 5 anos,clasificacion e,2002-12-01,8,9,8,9,17
70402,SAN CARLOS,estado nutricional en menores de 5 anos,clasificacion e,2002-12-01,5,5,5,5,10
80501,SAN IGNACIO,estado nutricional en menores de 5 anos,clasificacion e,2002-12-01,22,17,22,17,39
70301,SAN IGNACIO DE VELASCO,estado nutricional en menores de 5 anos,clasificacion e,2002-12-01,54,73,54,73,127
71102,SAN JAVIER(STC),estado nutricional en menores de 5 anos,clasificacion e,2002-12-01,15,8,15,8,23
80701,SAN JOAQUIN,estado nutricional en menores de 5 anos,clasificacion e,2002-12-01,2,0,2,0,2
70501,SAN JOSE DE CHIQUITOS,estado nutricional en menores de 5 anos,clasificacion e,2002-12-01,8,3,8,3,11
71104,SAN JULIAN,estado nutricional en menores de 5 anos,clasificacion e,2002-12-01,58,26,58,26,84
90302,SAN LORENZO(PND),estado nutricional en menores de 5 anos,clasificacion e,2002-12-01,0,2,0,2,2
60501,SAN LORENZO(TJA),estado nutricional en menores de 5 anos,clasificacion e,2002-12-01,11,18,11,18,29
10702,SAN LUCAS,estado nutricional en menores de 5 anos,clasificacion e,2002-12-01,114,86,114,86,200
70302,SAN MIGUEL DE VELASCO,estado nutricional en menores de 5 anos,clasificacion e,2002-12-01,8,11,8,11,19
51001,SAN PABLO DE LIPEZ,estado nutricional en menores de 5 anos,clasificacion e,2002-12-01,1,0,1,0,1
50501,SAN PEDRO DE BUENA VISTA,estado nutricional en menores de 5 anos,clasificacion e,2002-12-01,37,46,37,46,83
21801,SAN PEDRO DE CURAHUARA,estado nutricional en menores de 5 anos,clasificacion e,2002-12-01,6,3,6,3,9
70303,SAN RAFAEL,estado nutricional en menores de 5 anos,clasificacion e,2002-12-01,10,4,10,4,14
80702,SAN RAMON,estado nutricional en menores de 5 anos,clasificacion e,2002-12-01,1,1,1,1,2
80401,SANTA ANA,estado nutricional en menores de 5 anos,clasificacion e,2002-12-01,11,13,11,13,24
70101,SANTA CRUZ DE LA SIERRA,estado nutricional en menores de 5 anos,clasificacion e,2002-12-01,108,47,108,47,155
80303,SANTA ROSA,estado nutricional en menores de 5 anos,clasificacion e,2002-12-01,6,2,6,2,8
70602,SANTA ROSA DEL SARA,estado nutricional en menores de 5 anos,clasificacion e,2002-12-01,5,5,5,5,10
20308,SANTIAGO DE CALLAPA,estado nutricional en menores de 5 anos,clasificacion e,2002-12-01,7,4,7,4,11
41401,SANTIAGO DE HUARI,estado nutricional en menores de 5 anos,clasificacion e,2002-12-01,7,6,7,6,13
21901,SANTIAGO DE MACHACA,estado nutricional en menores de 5 anos,clasificacion e,2002-12-01,2,0,2,0,2
30702,SANTIVAÑES,estado nutricional en menores de 5 anos,clasificacion e,2002-12-01,2,1,2,1,3
40202,SANTUARIO DE QUILLACAS,estado nutricional en menores de 5 anos,clasificacion e,2002-12-01,2,1,2,1,3
20902,SAPAHAQUI,estado nutricional en menores de 5 anos,clasificacion e,2002-12-01,16,3,16,3,19
90303,SENA,estado nutricional en menores de 5 anos,clasificacion e,2002-12-01,2,0,2,0,2
21301,SICA SICA (VILLA AROMA),estado nutricional en menores de 5 anos,clasificacion e,2002-12-01,14,11,14,11,25
30703,SICAYA,estado nutricional en menores de 5 anos,clasificacion e,2002-12-01,1,4,1,4,5
30902,SIPE SIPE,estado nutricional en menores de 5 anos,clasificacion e,2002-12-01,39,13,39,13,52
10403,SOPACHUY,estado nutricional en menores de 5 anos,clasificacion e,2002-12-01,38,29,38,29,67
20601,SORATA,estado nutricional en menores de 5 anos,clasificacion e,2002-12-01,7,6,7,6,13
10101,SUCRE,estado nutricional en menores de 5 anos,clasificacion e,2002-12-01,101,77,101,77,178
31404,TACACHI,estado nutricional en menores de 5 anos,clasificacion e,2002-12-01,1,0,1,0,1
20603,TACACOMA,estado nutricional en menores de 5 anos,clasificacion e,2002-12-01,6,8,6,8,14
50303,TACOBAMBA,estado nutricional en menores de 5 anos,clasificacion e,2002-12-01,21,28,21,28,49
30602,TACOPAYA,estado nutricional en menores de 5 anos,clasificacion e,2002-12-01,4,3,4,3,7
31101,TAPACARI,estado nutricional en menores de 5 anos,clasificacion e,2002-12-01,18,21,18,21,39
10601,TARABUCO,estado nutricional en menores de 5 anos,clasificacion e,2002-12-01,127,125,127,125,252
30401,TARATA,estado nutricional en menores de 5 anos,clasificacion e,2002-12-01,6,9,6,9,15
60101,TARIJA,estado nutricional en menores de 5 anos,clasificacion e,2002-12-01,45,31,45,31,76
10202,TARVITA,estado nutricional en menores de 5 anos,clasificacion e,2002-12-01,28,37,28,37,65
20803,TIAWANACU,estado nutricional en menores de 5 anos,clasificacion e,2002-12-01,3,6,3,6,9
50102,TINGUIPAYA,estado nutricional en menores de 5 anos,clasificacion e,2002-12-01,12,13,12,13,25
20606,TIPUANI,estado nutricional en menores de 5 anos,clasificacion e,2002-12-01,2,3,2,3,5
30903,TIQUIPAYA,estado nutricional en menores de 5 anos,clasificacion e,2002-12-01,5,18,5,18,23
31601,TIRAQUE (CBBA),estado nutricional en menores de 5 anos,clasificacion e,2002-12-01,32,45,32,45,77
30802,TOCO,estado nutricional en menores de 5 anos,clasificacion e,2002-12-01,0,4,0,4,4
30803,TOLATA,estado nutricional en menores de 5 anos,clasificacion e,2002-12-01,0,1,0,1,1
41001,TOLEDO,estado nutricional en menores de 5 anos,clasificacion e,2002-12-01,2,2,2,2,4
51202,TOMAVE,estado nutricional en menores de 5 anos,clasificacion e,2002-12-01,15,14,15,14,29
10402,TOMINA,estado nutricional en menores de 5 anos,clasificacion e,2002-12-01,26,42,26,42,68
50502,TORO TORO,estado nutricional en menores de 5 anos,clasificacion e,2002-12-01,12,12,12,12,24
31201,TOTORA(CBBA),estado nutricional en menores de 5 anos,clasificacion e,2002-12-01,13,7,13,7,20
41301,TOTORA(ORR),estado nutricional en menores de 5 anos,clasificacion e,2002-12-01,4,3,4,3,7
70802,TRIGAL,estado nutricional en menores de 5 anos,clasificacion e,2002-12-01,2,0,2,0,2
80101,TRINIDAD,estado nutricional en menores de 5 anos,clasificacion e,2002-12-01,39,57,39,57,96
50801,TUPIZA,estado nutricional en menores de 5 anos,clasificacion e,2002-12-01,13,91,13,91,104
40402,TURCO,estado nutricional en menores de 5 anos,clasificacion e,2002-12-01,1,1,1,1,2
21302,UMALA,estado nutricional en menores de 5 anos,clasificacion e,2002-12-01,1,1,1,1,2
50201,UNCIA,estado nutricional en menores de 5 anos,clasificacion e,2002-12-01,2,5,2,5,7
60401,URIONDO (A. CONCEPCION),estado nutricional en menores de 5 anos,clasificacion e,2002-12-01,4,3,4,3,7
71502,URUBICHA,estado nutricional en menores de 5 anos,clasificacion e,2002-12-01,8,6,8,6,14
51201,UYUNI,estado nutricional en menores de 5 anos,clasificacion e,2002-12-01,9,13,9,13,22
30502,VACAS,estado nutricional en menores de 5 anos,clasificacion e,2002-12-01,4,23,4,23,27
70801,VALLEGRANDE,estado nutricional en menores de 5 anos,clasificacion e,2002-12-01,10,8,10,8,18
20801,VIACHA,estado nutricional en menores de 5 anos,clasificacion e,2002-12-01,13,22,13,22,35
31302,VILA VILA,estado nutricional en menores de 5 anos,clasificacion e,2002-12-01,2,21,2,21,23
60303,VILLA MONTES,estado nutricional en menores de 5 anos,clasificacion e,2002-12-01,21,2,21,2,23
31402,VILLA RIVERO,estado nutricional en menores de 5 anos,clasificacion e,2002-12-01,1,1,1,1,2
10801,VILLA SERRANO,estado nutricional en menores de 5 anos,clasificacion e,2002-12-01,37,46,37,46,83
31003,VILLA TUNARI,estado nutricional en menores de 5 anos,clasificacion e,2002-12-01,11,29,11,29,40
11001,VILLA VACA GUZMAN (MUYUPAMPA),estado nutricional en menores de 5 anos,clasificacion e,2002-12-01,14,21,14,21,35
51501,VILLAZON,estado nutricional en menores de 5 anos,clasificacion e,2002-12-01,27,26,27,26,53
30904,VINTO,estado nutricional en menores de 5 anos,clasificacion e,2002-12-01,13,5,13,5,18
50602,VITICHI,estado nutricional en menores de 5 anos,clasificacion e,2002-12-01,18,26,18,26,44
20306,WALDO BALLIVIAN,estado nutricional en menores de 5 anos,clasificacion e,2002-12-01,1,0,1,0,1
70201,WARNES,estado nutricional en menores de 5 anos,clasificacion e,2002-12-01,22,15,22,15,37
20903,YACO,estado nutricional en menores de 5 anos,clasificacion e,2002-12-01,5,13,5,13,18
60301,YACUIBA,estado nutricional en menores de 5 anos,clasificacion e,2002-12-01,23,11,23,11,34
10602,YAMPARAEZ,estado nutricional en menores de 5 anos,clasificacion e,2002-12-01,76,46,76,46,122
50103,YOCALLA,estado nutricional en menores de 5 anos,clasificacion e,2002-12-01,4,4,4,4,8
10102,YOTALA,estado nutricional en menores de 5 anos,clasificacion e,2002-12-01,28,36,28,36,64
60402,YUNCHARA,estado nutricional en menores de 5 anos,clasificacion e,2002-12-01,4,4,4,4,8
10301,ZUDAÑEZ,estado nutricional en menores de 5 anos,clasificacion e,2002-12-01,25,38,25,38,63
