codigo_municipio,municipio,grupo,variable,mes,total-H,total-M,TOTAL-H1,TOTAL-M1,TOTAL
51302,ACACIO,estado nutricional en menores de 5 anos,clasificacion d,2002-01-01,3,155,3,155,158
20201,ACHACACHI,estado nutricional en menores de 5 anos,clasificacion d,2002-01-01,11,128,11,128,139
20104,ACHOCALLA,estado nutricional en menores de 5 anos,clasificacion d,2002-01-01,7,26,7,26,33
30201,AIQUILE,estado nutricional en menores de 5 anos,clasificacion d,2002-01-01,5,11,5,11,16
31303,ALALAY,estado nutricional en menores de 5 anos,clasificacion d,2002-01-01,8,6,8,6,14
10404,ALCALA,estado nutricional en menores de 5 anos,clasificacion d,2002-01-01,4,114,4,114,118
20202,ANCORAIMES,estado nutricional en menores de 5 anos,clasificacion d,2002-01-01,3,222,3,222,225
41201,ANDAMARCA,estado nutricional en menores de 5 anos,clasificacion d,2002-01-01,3,1,3,1,4
40603,ANTEQUERA,estado nutricional en menores de 5 anos,clasificacion d,2002-01-01,4,11,4,11,15
30402,ANZALDO,estado nutricional en menores de 5 anos,clasificacion d,2002-01-01,2,40,2,40,42
20701,APOLO,estado nutricional en menores de 5 anos,clasificacion d,2002-01-01,16,3,16,3,19
51301,ARAMPAMPA,estado nutricional en menores de 5 anos,clasificacion d,2002-01-01,2,80,2,80,82
30501,ARANI,estado nutricional en menores de 5 anos,clasificacion d,2002-01-01,2,29,2,29,31
30403,ARBIETO,estado nutricional en menores de 5 anos,clasificacion d,2002-01-01,0,17,0,17,17
30601,ARQUE,estado nutricional en menores de 5 anos,clasificacion d,2002-01-01,13,2,13,2,15
50802,ATOCHA,estado nutricional en menores de 5 anos,clasificacion d,2002-01-01,0,44,0,44,44
20503,AUCAPATA,estado nutricional en menores de 5 anos,clasificacion d,2002-01-01,1,9,1,9,10
20502,AYATA,estado nutricional en menores de 5 anos,clasificacion d,2002-01-01,5,0,5,0,5
21303,AYO AYO,estado nutricional en menores de 5 anos,clasificacion d,2002-01-01,20,5,20,5,25
30301,AYOPAYA (V. DE INDEPENDENCIA),estado nutricional en menores de 5 anos,clasificacion d,2002-01-01,83,114,83,114,197
10201,AZURDUY,estado nutricional en menores de 5 anos,clasificacion d,2002-01-01,2,94,2,94,96
21203,BATALLAS,estado nutricional en menores de 5 anos,clasificacion d,2002-01-01,0,23,0,23,23
80802,BAURES,estado nutricional en menores de 5 anos,clasificacion d,2002-01-01,31,27,31,27,58
41202,BELEN DE ANDAMARCA,estado nutricional en menores de 5 anos,clasificacion d,2002-01-01,0,2,0,2,2
50104,BELEN DE URMIRI,estado nutricional en menores de 5 anos,clasificacion d,2002-01-01,0,16,0,16,16
90104,BELLA FLOR,estado nutricional en menores de 5 anos,clasificacion d,2002-01-01,1,0,1,0,1
60202,BERMEJO,estado nutricional en menores de 5 anos,clasificacion d,2002-01-01,0,19,0,19,19
50301,BETANZOS,estado nutricional en menores de 5 anos,clasificacion d,2002-01-01,38,424,38,424,462
31501,BOLIVAR,estado nutricional en menores de 5 anos,clasificacion d,2002-01-01,89,148,89,148,237
90103,BOLPEBRA,estado nutricional en menores de 5 anos,clasificacion d,2002-01-01,0,12,0,12,12
70707,BOYUIBE,estado nutricional en menores de 5 anos,clasificacion d,2002-01-01,1,34,1,34,35
70401,BUENA VISTA,estado nutricional en menores de 5 anos,clasificacion d,2002-01-01,41,54,41,54,95
70703,CABEZAS,estado nutricional en menores de 5 anos,clasificacion d,2002-01-01,3,60,3,60,63
20905,CAIROMA,estado nutricional en menores de 5 anos,clasificacion d,2002-01-01,0,36,0,36,36
51102,"CAIZA ""D""",estado nutricional en menores de 5 anos,clasificacion d,2002-01-01,12,92,12,92,104
21003,CAJUATA,estado nutricional en menores de 5 anos,clasificacion d,2002-01-01,13,23,13,23,36
20303,CALACOTO,estado nutricional en menores de 5 anos,clasificacion d,2002-01-01,4,1,4,1,5
21304,CALAMARCA,estado nutricional en menores de 5 anos,clasificacion d,2002-01-01,22,16,22,16,38
10701,CAMARGO,estado nutricional en menores de 5 anos,clasificacion d,2002-01-01,4,126,4,126,130
10901,CAMATAQUI (C. VILLA ABECIA),estado nutricional en menores de 5 anos,clasificacion d,2002-01-01,1,59,1,59,60
70706,CAMIRI,estado nutricional en menores de 5 anos,clasificacion d,2002-01-01,57,96,57,96,153
30701,CAPINOTA,estado nutricional en menores de 5 anos,clasificacion d,2002-01-01,40,34,40,34,74
20302,CAQUIAVIRI,estado nutricional en menores de 5 anos,clasificacion d,2002-01-01,19,26,19,26,45
40102,CARACOLLO,estado nutricional en menores de 5 anos,clasificacion d,2002-01-01,26,49,26,49,75
22001,CARANAVI,estado nutricional en menores de 5 anos,clasificacion d,2002-01-01,63,90,63,90,153
41503,CARANGAS,estado nutricional en menores de 5 anos,clasificacion d,2002-01-01,0,2,0,2,2
60302,CARAPARI,estado nutricional en menores de 5 anos,clasificacion d,2002-01-01,24,46,24,46,70
50702,CARIPUYO,estado nutricional en menores de 5 anos,clasificacion d,2002-01-01,3,158,3,158,161
21902,CATACORA,estado nutricional en menores de 5 anos,clasificacion d,2002-01-01,1,7,1,7,8
40201,CHALLAPATA,estado nutricional en menores de 5 anos,clasificacion d,2002-01-01,27,68,27,68,95
50302,CHAQUI,estado nutricional en menores de 5 anos,clasificacion d,2002-01-01,0,113,0,113,113
70702,CHARAGUA,estado nutricional en menores de 5 anos,clasificacion d,2002-01-01,4,299,4,299,303
20305,CHARAÃ‘A,estado nutricional en menores de 5 anos,clasificacion d,2002-01-01,0,5,0,5,5
31204,CHIMORE,estado nutricional en menores de 5 anos,clasificacion d,2002-01-01,18,49,18,49,67
21101,CHULUMANI (V. DE LA LIBERTAD),estado nutricional en menores de 5 anos,clasificacion d,2002-01-01,2,22,2,22,24
20501,CHUMA,estado nutricional en menores de 5 anos,clasificacion d,2002-01-01,1,1,1,1,2
30801,CLIZA,estado nutricional en menores de 5 anos,clasificacion d,2002-01-01,4,27,4,27,31
90101,COBIJA,estado nutricional en menores de 5 anos,clasificacion d,2002-01-01,89,46,89,46,135
30101,COCHABAMBA,estado nutricional en menores de 5 anos,clasificacion d,2002-01-01,389,328,389,328,717
30905,COLCAPIRHUA,estado nutricional en menores de 5 anos,clasificacion d,2002-01-01,53,69,53,69,122
50901,"COLCHA ""K""",estado nutricional en menores de 5 anos,clasificacion d,2002-01-01,4,66,4,66,70
21307,COLLANA,estado nutricional en menores de 5 anos,clasificacion d,2002-01-01,1,0,1,0,1
31002,COLOMI,estado nutricional en menores de 5 anos,clasificacion d,2002-01-01,19,35,19,35,54
50401,COLQUECHACA,estado nutricional en menores de 5 anos,clasificacion d,2002-01-01,38,141,38,141,179
21306,COLQUENCHA,estado nutricional en menores de 5 anos,clasificacion d,2002-01-01,18,5,18,5,23
21004,COLQUIRI,estado nutricional en menores de 5 anos,clasificacion d,2002-01-01,36,46,36,46,82
20304,COMANCHE,estado nutricional en menores de 5 anos,clasificacion d,2002-01-01,6,16,6,16,22
71301,COMARAPA,estado nutricional en menores de 5 anos,clasificacion d,2002-01-01,20,39,20,39,59
20605,COMBAYA,estado nutricional en menores de 5 anos,clasificacion d,2002-01-01,0,28,0,28,28
71101,CONCEPCION,estado nutricional en menores de 5 anos,clasificacion d,2002-01-01,3,24,3,24,27
21701,COPACABANA,estado nutricional en menores de 5 anos,clasificacion d,2002-01-01,5,55,5,55,60
21402,CORIPATA,estado nutricional en menores de 5 anos,clasificacion d,2002-01-01,5,6,5,6,11
20301,CORO CORO,estado nutricional en menores de 5 anos,clasificacion d,2002-01-01,22,26,22,26,48
21401,COROICO,estado nutricional en menores de 5 anos,clasificacion d,2002-01-01,16,28,16,28,44
40301,CORQUE,estado nutricional en menores de 5 anos,clasificacion d,2002-01-01,8,14,8,14,22
50601,COTAGAITA,estado nutricional en menores de 5 anos,clasificacion d,2002-01-01,13,154,13,154,167
70102,COTOCA,estado nutricional en menores de 5 anos,clasificacion d,2002-01-01,37,57,37,57,94
31405,CUCHUMUELA (V. G. VILLARROEL),estado nutricional en menores de 5 anos,clasificacion d,2002-01-01,0,4,0,4,4
70704,CUEVO,estado nutricional en menores de 5 anos,clasificacion d,2002-01-01,31,33,31,33,64
10902,CULPINA,estado nutricional en menores de 5 anos,clasificacion d,2002-01-01,6,237,6,237,243
40401,CURAHUARA DE CARANGAS,estado nutricional en menores de 5 anos,clasificacion d,2002-01-01,16,10,16,10,26
21602,CURVA,estado nutricional en menores de 5 anos,clasificacion d,2002-01-01,5,2,5,2,7
20804,DESAGUADERO,estado nutricional en menores de 5 anos,clasificacion d,2002-01-01,1,12,1,12,13
20105,EL ALTO,estado nutricional en menores de 5 anos,clasificacion d,2002-01-01,1290,1245,1290,1245,2535
40103,EL CHORO,estado nutricional en menores de 5 anos,clasificacion d,2002-01-01,0,1,0,1,1
71503,EL PUENTE(STC),estado nutricional en menores de 5 anos,clasificacion d,2002-01-01,7,72,7,72,79
60502,EL PUENTE(TJA),estado nutricional en menores de 5 anos,clasificacion d,2002-01-01,6,32,6,32,38
70105,EL TORNO,estado nutricional en menores de 5 anos,clasificacion d,2002-01-01,52,94,52,94,146
10405,EL VILLAR,estado nutricional en menores de 5 anos,clasificacion d,2002-01-01,1,147,1,147,148
60601,ENTRE RIOS,estado nutricional en menores de 5 anos,clasificacion d,2002-01-01,28,85,28,85,113
41101,EUCALIPTUS,estado nutricional en menores de 5 anos,clasificacion d,2002-01-01,0,6,0,6,6
80402,EXALTACION,estado nutricional en menores de 5 anos,clasificacion d,2002-01-01,12,25,12,25,37
90203,FILADELFIA,estado nutricional en menores de 5 anos,clasificacion d,2002-01-01,6,10,6,10,16
71002,GENERAL SAAVEDRA,estado nutricional en menores de 5 anos,clasificacion d,2002-01-01,40,165,40,165,205
21601,GRAL. J.J. PEREZ (CHARAZANI),estado nutricional en menores de 5 anos,clasificacion d,2002-01-01,8,19,8,19,27
20602,GUANAY,estado nutricional en menores de 5 anos,clasificacion d,2002-01-01,10,153,10,153,163
20802,GUAQUI,estado nutricional en menores de 5 anos,clasificacion d,2002-01-01,2,7,2,7,9
80202,GUAYARAMERIN,estado nutricional en menores de 5 anos,clasificacion d,2002-01-01,62,91,62,91,153
70705,GUTIERREZ,estado nutricional en menores de 5 anos,clasificacion d,2002-01-01,22,250,22,250,272
10502,HUACARETA,estado nutricional en menores de 5 anos,clasificacion d,2002-01-01,7,169,7,169,176
11002,HUACAYA (VILLA DE HUACAYA),estado nutricional en menores de 5 anos,clasificacion d,2002-01-01,0,22,0,22,22
40501,HUACHACALLA,estado nutricional en menores de 5 anos,clasificacion d,2002-01-01,0,12,0,12,12
40701,HUANUNI,estado nutricional en menores de 5 anos,clasificacion d,2002-01-01,3,10,3,10,13
80803,HUARACAJE,estado nutricional en menores de 5 anos,clasificacion d,2002-01-01,5,7,5,7,12
41601,HUAYLLAMARCA,estado nutricional en menores de 5 anos,clasificacion d,2002-01-01,13,38,13,38,51
21005,ICHOCA,estado nutricional en menores de 5 anos,clasificacion d,2002-01-01,5,17,5,17,22
10304,ICLA,estado nutricional en menores de 5 anos,clasificacion d,2002-01-01,167,261,167,261,428
10703,INCAHUASI,estado nutricional en menores de 5 anos,clasificacion d,2002-01-01,2,102,2,102,104
21001,INQUISIVI,estado nutricional en menores de 5 anos,clasificacion d,2002-01-01,10,53,10,53,63
21102,IRUPANA (VILLA DE LANZA),estado nutricional en menores de 5 anos,clasificacion d,2002-01-01,3,43,3,43,46
21501,IXIAMAS,estado nutricional en menores de 5 anos,clasificacion d,2002-01-01,14,17,14,17,31
21105,LA ASUNTA,estado nutricional en menores de 5 anos,clasificacion d,2002-01-01,26,59,26,59,85
70104,LA GUARDIA,estado nutricional en menores de 5 anos,clasificacion d,2002-01-01,66,116,66,116,182
20101,LA PAZ,estado nutricional en menores de 5 anos,clasificacion d,2002-01-01,853,946,853,946,1799
41501,LA RIVERA,estado nutricional en menores de 5 anos,clasificacion d,2002-01-01,1,0,1,0,1
70701,LAGUNILLAS,estado nutricional en menores de 5 anos,clasificacion d,2002-01-01,35,51,35,51,86
21202,LAJA,estado nutricional en menores de 5 anos,clasificacion d,2002-01-01,0,32,0,32,32
10903,LAS CARRERAS,estado nutricional en menores de 5 anos,clasificacion d,2002-01-01,0,37,0,37,37
51401,LLICA,estado nutricional en menores de 5 anos,clasificacion d,2002-01-01,0,20,0,20,20
80601,LORETO,estado nutricional en menores de 5 anos,clasificacion d,2002-01-01,0,12,0,12,12
20901,LURIBAY,estado nutricional en menores de 5 anos,clasificacion d,2002-01-01,0,17,0,17,17
40702,MACHACAMARCA,estado nutricional en menores de 5 anos,clasificacion d,2002-01-01,11,13,11,13,24
11003,MACHARETI,estado nutricional en menores de 5 anos,clasificacion d,2002-01-01,1,142,1,142,143
80801,MAGDALENA,estado nutricional en menores de 5 anos,clasificacion d,2002-01-01,20,57,20,57,77
70903,MAIRANA,estado nutricional en menores de 5 anos,clasificacion d,2002-01-01,28,24,28,24,52
20103,MECAPACA,estado nutricional en menores de 5 anos,clasificacion d,2002-01-01,0,22,0,22,22
71003,MINEROS,estado nutricional en menores de 5 anos,clasificacion d,2002-01-01,14,191,14,191,205
31301,MIZQUE,estado nutricional en menores de 5 anos,clasificacion d,2002-01-01,9,20,9,20,29
20402,MOCOMOCO,estado nutricional en menores de 5 anos,clasificacion d,2002-01-01,13,17,13,17,30
51002,MOJINETE,estado nutricional en menores de 5 anos,clasificacion d,2002-01-01,2,15,2,15,17
10303,MOJOCOYA,estado nutricional en menores de 5 anos,clasificacion d,2002-01-01,73,114,73,114,187
10501,MONTEAGUDO,estado nutricional en menores de 5 anos,clasificacion d,2002-01-01,29,194,29,194,223
71001,MONTERO,estado nutricional en menores de 5 anos,clasificacion d,2002-01-01,13,560,13,560,573
70803,MORO MORO,estado nutricional en menores de 5 anos,clasificacion d,2002-01-01,13,12,13,12,25
30302,MOROCHATA,estado nutricional en menores de 5 anos,clasificacion d,2002-01-01,7,15,7,15,22
90401,NACEBE (SANTA ROSA DEL ABUNA),estado nutricional en menores de 5 anos,clasificacion d,2002-01-01,0,1,0,1,1
20307,NAZACARA DE PACAJES,estado nutricional en menores de 5 anos,clasificacion d,2002-01-01,4,0,4,0,4
50404,OCURI,estado nutricional en menores de 5 anos,clasificacion d,2002-01-01,43,70,43,70,113
70202,OKINAWA,estado nutricional en menores de 5 anos,clasificacion d,2002-01-01,2,7,2,7,9
30203,OMEREQUE,estado nutricional en menores de 5 anos,clasificacion d,2002-01-01,1,0,1,0,1
40101,ORURO,estado nutricional en menores de 5 anos,clasificacion d,2002-01-01,80,789,80,789,869
60201,PADCAYA,estado nutricional en menores de 5 anos,clasificacion d,2002-01-01,11,46,11,46,57
10401,PADILLA,estado nutricional en menores de 5 anos,clasificacion d,2002-01-01,8,414,8,414,422
70502,PAILON,estado nutricional en menores de 5 anos,clasificacion d,2002-01-01,4,71,4,71,75
20102,PALCA,estado nutricional en menores de 5 anos,clasificacion d,2002-01-01,22,22,22,22,44
21104,PALOS BLANCOS,estado nutricional en menores de 5 anos,clasificacion d,2002-01-01,43,84,43,84,127
40802,PAMPA AULLAGAS,estado nutricional en menores de 5 anos,clasificacion d,2002-01-01,12,19,12,19,31
70902,PAMPA GRANDE,estado nutricional en menores de 5 anos,clasificacion d,2002-01-01,10,15,10,15,25
21802,PAPEL PAMPA,estado nutricional en menores de 5 anos,clasificacion d,2002-01-01,3,2,3,2,5
30202,PASORAPA,estado nutricional en menores de 5 anos,clasificacion d,2002-01-01,6,6,6,6,12
21305,PATACAMAYA,estado nutricional en menores de 5 anos,clasificacion d,2002-01-01,21,23,21,23,44
40602,PAZÃ‘A,estado nutricional en menores de 5 anos,clasificacion d,2002-01-01,4,42,4,42,46
20702,PELECHUCO,estado nutricional en menores de 5 anos,clasificacion d,2002-01-01,8,49,8,49,57
50403,POCOATA,estado nutricional en menores de 5 anos,clasificacion d,2002-01-01,68,185,68,185,253
31203,POCONA,estado nutricional en menores de 5 anos,clasificacion d,2002-01-01,1,46,1,46,47
31202,POJO (CBBA),estado nutricional en menores de 5 anos,clasificacion d,2002-01-01,48,128,48,128,176
40601,POOPO,estado nutricional en menores de 5 anos,clasificacion d,2002-01-01,1,45,1,45,46
51203,PORCO,estado nutricional en menores de 5 anos,clasificacion d,2002-01-01,12,14,12,14,26
10103,POROMA,estado nutricional en menores de 5 anos,clasificacion d,2002-01-01,46,142,46,142,188
70103,PORONGO,estado nutricional en menores de 5 anos,clasificacion d,2002-01-01,1,43,1,43,44
70601,PORTACHUELO,estado nutricional en menores de 5 anos,clasificacion d,2002-01-01,55,28,55,28,83
90102,PORVENIR,estado nutricional en menores de 5 anos,clasificacion d,2002-01-01,1,30,1,30,31
70804,POSTRER VALLE,estado nutricional en menores de 5 anos,clasificacion d,2002-01-01,0,4,0,4,4
50101,POTOSI,estado nutricional en menores de 5 anos,clasificacion d,2002-01-01,102,484,102,484,586
10302,PRESTO,estado nutricional en menores de 5 anos,clasificacion d,2002-01-01,66,76,66,76,142
21201,PUCARANI,estado nutricional en menores de 5 anos,clasificacion d,2002-01-01,1,24,1,24,25
20401,PUERTO ACOSTA,estado nutricional en menores de 5 anos,clasificacion d,2002-01-01,42,61,42,61,103
20403,PUERTO CARABUCO,estado nutricional en menores de 5 anos,clasificacion d,2002-01-01,39,60,39,60,99
90301,PUERTO GONZALO MORENO,estado nutricional en menores de 5 anos,clasificacion d,2002-01-01,1,7,1,7,8
21204,PUERTO PEREZ,estado nutricional en menores de 5 anos,clasificacion d,2002-01-01,5,12,5,12,17
71402,PUERTO QUIJARRO,estado nutricional en menores de 5 anos,clasificacion d,2002-01-01,47,13,47,13,60
90201,PUERTO RICO,estado nutricional en menores de 5 anos,clasificacion d,2002-01-01,2,26,2,26,28
80703,PUERTO SILES,estado nutricional en menores de 5 anos,clasificacion d,2002-01-01,0,2,0,2,2
71401,PUERTO SUAREZ,estado nutricional en menores de 5 anos,clasificacion d,2002-01-01,89,30,89,30,119
31205,PUERTO VILLARROEL,estado nutricional en menores de 5 anos,clasificacion d,2002-01-01,168,173,168,173,341
51101,PUNA,estado nutricional en menores de 5 anos,clasificacion d,2002-01-01,4,244,4,244,248
31401,PUNATA,estado nutricional en menores de 5 anos,clasificacion d,2002-01-01,0,13,0,13,13
20604,QUIABAYA,estado nutricional en menores de 5 anos,clasificacion d,2002-01-01,0,17,0,17,17
30901,QUILLACOLLO,estado nutricional en menores de 5 anos,clasificacion d,2002-01-01,17,14,17,14,31
21002,QUIME,estado nutricional en menores de 5 anos,clasificacion d,2002-01-01,15,43,15,43,58
50402,RAVELO,estado nutricional en menores de 5 anos,clasificacion d,2002-01-01,29,245,29,245,274
80301,REYES,estado nutricional en menores de 5 anos,clasificacion d,2002-01-01,21,38,21,38,59
80201,RIBERALTA,estado nutricional en menores de 5 anos,clasificacion d,2002-01-01,301,264,301,264,565
70503,ROBORE,estado nutricional en menores de 5 anos,clasificacion d,2002-01-01,3,60,3,60,63
80304,RURRENABAQUE,estado nutricional en menores de 5 anos,clasificacion d,2002-01-01,27,18,27,18,45
40901,SABAYA,estado nutricional en menores de 5 anos,clasificacion d,2002-01-01,0,6,0,6,6
31001,SACABA,estado nutricional en menores de 5 anos,clasificacion d,2002-01-01,42,85,42,85,127
30404,SACABAMBA,estado nutricional en menores de 5 anos,clasificacion d,2002-01-01,0,31,0,31,31
50701,SACACA,estado nutricional en menores de 5 anos,clasificacion d,2002-01-01,42,249,42,249,291
71302,SAIPINA,estado nutricional en menores de 5 anos,clasificacion d,2002-01-01,29,9,29,9,38
40801,SALINAS DE GARCI MENDOZA,estado nutricional en menores de 5 anos,clasificacion d,2002-01-01,9,5,9,5,14
70901,SAMAIPATA,estado nutricional en menores de 5 anos,clasificacion d,2002-01-01,28,17,28,17,45
51601,SAN AGUSTIN,estado nutricional en menores de 5 anos,clasificacion d,2002-01-01,0,7,0,7,7
71105,SAN ANTONIO DE LOMERIO,estado nutricional en menores de 5 anos,clasificacion d,2002-01-01,59,133,59,133,192
31403,SAN BENITO,estado nutricional en menores de 5 anos,clasificacion d,2002-01-01,1,12,1,12,13
80302,SAN BORJA,estado nutricional en menores de 5 anos,clasificacion d,2002-01-01,66,82,66,82,148
21502,SAN BUENA VENTURA,estado nutricional en menores de 5 anos,clasificacion d,2002-01-01,34,39,34,39,73
70402,SAN CARLOS,estado nutricional en menores de 5 anos,clasificacion d,2002-01-01,0,5,0,5,5
80501,SAN IGNACIO,estado nutricional en menores de 5 anos,clasificacion d,2002-01-01,20,127,20,127,147
70301,SAN IGNACIO DE VELASCO,estado nutricional en menores de 5 anos,clasificacion d,2002-01-01,191,178,191,178,369
80102,SAN JAVIER(BNI),estado nutricional en menores de 5 anos,clasificacion d,2002-01-01,0,14,0,14,14
71102,SAN JAVIER(STC),estado nutricional en menores de 5 anos,clasificacion d,2002-01-01,26,15,26,15,41
80701,SAN JOAQUIN,estado nutricional en menores de 5 anos,clasificacion d,2002-01-01,0,9,0,9,9
70501,SAN JOSE DE CHIQUITOS,estado nutricional en menores de 5 anos,clasificacion d,2002-01-01,57,19,57,19,76
71104,SAN JULIAN,estado nutricional en menores de 5 anos,clasificacion d,2002-01-01,69,192,69,192,261
90302,SAN LORENZO(PND),estado nutricional en menores de 5 anos,clasificacion d,2002-01-01,0,4,0,4,4
60501,SAN LORENZO(TJA),estado nutricional en menores de 5 anos,clasificacion d,2002-01-01,31,25,31,25,56
10702,SAN LUCAS,estado nutricional en menores de 5 anos,clasificacion d,2002-01-01,10,540,10,540,550
71201,SAN MATIAS,estado nutricional en menores de 5 anos,clasificacion d,2002-01-01,61,55,61,55,116
70302,SAN MIGUEL DE VELASCO,estado nutricional en menores de 5 anos,clasificacion d,2002-01-01,46,139,46,139,185
51001,SAN PABLO DE LIPEZ,estado nutricional en menores de 5 anos,clasificacion d,2002-01-01,1,19,1,19,20
50501,SAN PEDRO DE BUENA VISTA,estado nutricional en menores de 5 anos,clasificacion d,2002-01-01,0,76,0,76,76
21801,SAN PEDRO DE CURAHUARA,estado nutricional en menores de 5 anos,clasificacion d,2002-01-01,0,27,0,27,27
50902,SAN PEDRO DE QUEMES,estado nutricional en menores de 5 anos,clasificacion d,2002-01-01,0,5,0,5,5
21702,SAN PEDRO DE TIQUINA,estado nutricional en menores de 5 anos,clasificacion d,2002-01-01,0,13,0,13,13
90202,SAN PEDRO(PND),estado nutricional en menores de 5 anos,clasificacion d,2002-01-01,2,1,2,1,3
70303,SAN RAFAEL,estado nutricional en menores de 5 anos,clasificacion d,2002-01-01,29,17,29,17,46
80702,SAN RAMON,estado nutricional en menores de 5 anos,clasificacion d,2002-01-01,1,2,1,2,3
80702,SAN RAMON,estado nutricional en menores de 5 anos,clasificacion d,2002-01-01,0,16,0,16,16
80401,SANTA ANA,estado nutricional en menores de 5 anos,clasificacion d,2002-01-01,19,13,19,13,32
70101,SANTA CRUZ DE LA SIERRA,estado nutricional en menores de 5 anos,clasificacion d,2002-01-01,291,363,291,363,654
80303,SANTA ROSA,estado nutricional en menores de 5 anos,clasificacion d,2002-01-01,13,4,13,4,17
70602,SANTA ROSA DEL SARA,estado nutricional en menores de 5 anos,clasificacion d,2002-01-01,7,29,7,29,36
20308,SANTIAGO DE CALLAPA,estado nutricional en menores de 5 anos,clasificacion d,2002-01-01,0,4,0,4,4
41401,SANTIAGO DE HUARI,estado nutricional en menores de 5 anos,clasificacion d,2002-01-01,10,26,10,26,36
21901,SANTIAGO DE MACHACA,estado nutricional en menores de 5 anos,clasificacion d,2002-01-01,3,9,3,9,12
30702,SANTIVAÃ‘ES,estado nutricional en menores de 5 anos,clasificacion d,2002-01-01,24,21,24,21,45
40202,SANTUARIO DE QUILLACAS,estado nutricional en menores de 5 anos,clasificacion d,2002-01-01,3,16,3,16,19
20902,SAPAHAQUI,estado nutricional en menores de 5 anos,clasificacion d,2002-01-01,2,21,2,21,23
90303,SENA,estado nutricional en menores de 5 anos,clasificacion d,2002-01-01,0,10,0,10,10
21301,SICA SICA (VILLA AROMA),estado nutricional en menores de 5 anos,clasificacion d,2002-01-01,24,20,24,20,44
30703,SICAYA,estado nutricional en menores de 5 anos,clasificacion d,2002-01-01,1,29,1,29,30
30902,SIPE SIPE,estado nutricional en menores de 5 anos,clasificacion d,2002-01-01,122,128,122,128,250
10403,SOPACHUY,estado nutricional en menores de 5 anos,clasificacion d,2002-01-01,2,114,2,114,116
20601,SORATA,estado nutricional en menores de 5 anos,clasificacion d,2002-01-01,4,55,4,55,59
10101,SUCRE,estado nutricional en menores de 5 anos,clasificacion d,2002-01-01,69,1053,69,1053,1122
31404,TACACHI,estado nutricional en menores de 5 anos,clasificacion d,2002-01-01,1,10,1,10,11
20603,TACACOMA,estado nutricional en menores de 5 anos,clasificacion d,2002-01-01,1,36,1,36,37
50303,TACOBAMBA,estado nutricional en menores de 5 anos,clasificacion d,2002-01-01,8,94,8,94,102
30602,TACOPAYA,estado nutricional en menores de 5 anos,clasificacion d,2002-01-01,41,73,41,73,114
51402,TAHUA,estado nutricional en menores de 5 anos,clasificacion d,2002-01-01,1,5,1,5,6
31101,TAPACARI,estado nutricional en menores de 5 anos,clasificacion d,2002-01-01,2,52,2,52,54
10601,TARABUCO,estado nutricional en menores de 5 anos,clasificacion d,2002-01-01,7,723,7,723,730
30401,TARATA,estado nutricional en menores de 5 anos,clasificacion d,2002-01-01,6,41,6,41,47
60101,TARIJA,estado nutricional en menores de 5 anos,clasificacion d,2002-01-01,58,222,58,222,280
10202,TARVITA,estado nutricional en menores de 5 anos,clasificacion d,2002-01-01,62,72,62,72,134
20803,TIAWANACU,estado nutricional en menores de 5 anos,clasificacion d,2002-01-01,12,11,12,11,23
50102,TINGUIPAYA,estado nutricional en menores de 5 anos,clasificacion d,2002-01-01,14,56,14,56,70
20606,TIPUANI,estado nutricional en menores de 5 anos,clasificacion d,2002-01-01,7,5,7,5,12
30903,TIQUIPAYA,estado nutricional en menores de 5 anos,clasificacion d,2002-01-01,1,40,1,40,41
31601,TIRAQUE (CBBA),estado nutricional en menores de 5 anos,clasificacion d,2002-01-01,63,176,63,176,239
21703,TITO YUPANQUI (PARQUIPUJIO),estado nutricional en menores de 5 anos,clasificacion d,2002-01-01,0,23,0,23,23
30802,TOCO,estado nutricional en menores de 5 anos,clasificacion d,2002-01-01,0,1,0,1,1
30803,TOLATA,estado nutricional en menores de 5 anos,clasificacion d,2002-01-01,0,4,0,4,4
41001,TOLEDO,estado nutricional en menores de 5 anos,clasificacion d,2002-01-01,13,1,13,1,14
51202,TOMAVE,estado nutricional en menores de 5 anos,clasificacion d,2002-01-01,3,143,3,143,146
10402,TOMINA,estado nutricional en menores de 5 anos,clasificacion d,2002-01-01,43,243,43,243,286
50502,TORO TORO,estado nutricional en menores de 5 anos,clasificacion d,2002-01-01,1,24,1,24,25
31201,TOTORA(CBBA),estado nutricional en menores de 5 anos,clasificacion d,2002-01-01,21,30,21,30,51
41301,TOTORA(ORR),estado nutricional en menores de 5 anos,clasificacion d,2002-01-01,0,13,0,13,13
70802,TRIGAL,estado nutricional en menores de 5 anos,clasificacion d,2002-01-01,3,7,3,7,10
80101,TRINIDAD,estado nutricional en menores de 5 anos,clasificacion d,2002-01-01,25,187,25,187,212
50801,TUPIZA,estado nutricional en menores de 5 anos,clasificacion d,2002-01-01,5,389,5,389,394
40402,TURCO,estado nutricional en menores de 5 anos,clasificacion d,2002-01-01,14,11,14,11,25
21302,UMALA,estado nutricional en menores de 5 anos,clasificacion d,2002-01-01,0,8,0,8,8
50201,UNCIA,estado nutricional en menores de 5 anos,clasificacion d,2002-01-01,0,24,0,24,24
60401,URIONDO (A. CONCEPCION),estado nutricional en menores de 5 anos,clasificacion d,2002-01-01,14,19,14,19,33
71502,URUBICHA,estado nutricional en menores de 5 anos,clasificacion d,2002-01-01,0,20,0,20,20
51201,UYUNI,estado nutricional en menores de 5 anos,clasificacion d,2002-01-01,5,74,5,74,79
30502,VACAS,estado nutricional en menores de 5 anos,clasificacion d,2002-01-01,3,22,3,22,25
70801,VALLEGRANDE,estado nutricional en menores de 5 anos,clasificacion d,2002-01-01,37,112,37,112,149
20801,VIACHA,estado nutricional en menores de 5 anos,clasificacion d,2002-01-01,17,135,17,135,152
31302,VILA VILA,estado nutricional en menores de 5 anos,clasificacion d,2002-01-01,3,8,3,8,11
60303,VILLA MONTES,estado nutricional en menores de 5 anos,clasificacion d,2002-01-01,67,62,67,62,129
31402,VILLA RIVERO,estado nutricional en menores de 5 anos,clasificacion d,2002-01-01,1,5,1,5,6
10801,VILLA SERRANO,estado nutricional en menores de 5 anos,clasificacion d,2002-01-01,1,266,1,266,267
31003,VILLA TUNARI,estado nutricional en menores de 5 anos,clasificacion d,2002-01-01,72,112,72,112,184
11001,VILLA VACA GUZMAN (MUYUPAMPA),estado nutricional en menores de 5 anos,clasificacion d,2002-01-01,0,133,0,133,133
51501,VILLAZON,estado nutricional en menores de 5 anos,clasificacion d,2002-01-01,2,209,2,209,211
30904,VINTO,estado nutricional en menores de 5 anos,clasificacion d,2002-01-01,17,98,17,98,115
50602,VITICHI,estado nutricional en menores de 5 anos,clasificacion d,2002-01-01,15,66,15,66,81
20306,WALDO BALLIVIAN,estado nutricional en menores de 5 anos,clasificacion d,2002-01-01,0,4,0,4,4
70201,WARNES,estado nutricional en menores de 5 anos,clasificacion d,2002-01-01,101,157,101,157,258
20903,YACO,estado nutricional en menores de 5 anos,clasificacion d,2002-01-01,1,31,1,31,32
60301,YACUIBA,estado nutricional en menores de 5 anos,clasificacion d,2002-01-01,43,33,43,33,76
10602,YAMPARAEZ,estado nutricional en menores de 5 anos,clasificacion d,2002-01-01,138,293,138,293,431
21103,YANACACHI,estado nutricional en menores de 5 anos,clasificacion d,2002-01-01,14,9,14,9,23
70403,YAPACANI,estado nutricional en menores de 5 anos,clasificacion d,2002-01-01,101,103,101,103,204
50103,YOCALLA,estado nutricional en menores de 5 anos,clasificacion d,2002-01-01,3,50,3,50,53
10102,YOTALA,estado nutricional en menores de 5 anos,clasificacion d,2002-01-01,73,169,73,169,242
60402,YUNCHARA,estado nutricional en menores de 5 anos,clasificacion d,2002-01-01,8,32,8,32,40
10301,ZUDAÃ‘EZ,estado nutricional en menores de 5 anos,clasificacion d,2002-01-01,71,130,71,130,201
51302,ACACIO,estado nutricional en menores de 5 anos,clasificacion d,2002-02-01,2,110,2,110,112
20201,ACHACACHI,estado nutricional en menores de 5 anos,clasificacion d,2002-02-01,65,130,65,130,195
20104,ACHOCALLA,estado nutricional en menores de 5 anos,clasificacion d,2002-02-01,1,9,1,9,10
30201,AIQUILE,estado nutricional en menores de 5 anos,clasificacion d,2002-02-01,8,15,8,15,23
31303,ALALAY,estado nutricional en menores de 5 anos,clasificacion d,2002-02-01,0,9,0,9,9
10404,ALCALA,estado nutricional en menores de 5 anos,clasificacion d,2002-02-01,30,47,30,47,77
20202,ANCORAIMES,estado nutricional en menores de 5 anos,clasificacion d,2002-02-01,44,67,44,67,111
41201,ANDAMARCA,estado nutricional en menores de 5 anos,clasificacion d,2002-02-01,9,4,9,4,13
40603,ANTEQUERA,estado nutricional en menores de 5 anos,clasificacion d,2002-02-01,0,1,0,1,1
30402,ANZALDO,estado nutricional en menores de 5 anos,clasificacion d,2002-02-01,1,28,1,28,29
20701,APOLO,estado nutricional en menores de 5 anos,clasificacion d,2002-02-01,12,4,12,4,16
51301,ARAMPAMPA,estado nutricional en menores de 5 anos,clasificacion d,2002-02-01,14,76,14,76,90
30501,ARANI,estado nutricional en menores de 5 anos,clasificacion d,2002-02-01,0,13,0,13,13
30403,ARBIETO,estado nutricional en menores de 5 anos,clasificacion d,2002-02-01,0,12,0,12,12
30601,ARQUE,estado nutricional en menores de 5 anos,clasificacion d,2002-02-01,3,20,3,20,23
71501,ASCENCION DE GUARAYOS,estado nutricional en menores de 5 anos,clasificacion d,2002-02-01,169,277,169,277,446
50802,ATOCHA,estado nutricional en menores de 5 anos,clasificacion d,2002-02-01,5,67,5,67,72
20503,AUCAPATA,estado nutricional en menores de 5 anos,clasificacion d,2002-02-01,0,1,0,1,1
20502,AYATA,estado nutricional en menores de 5 anos,clasificacion d,2002-02-01,1,1,1,1,2
21303,AYO AYO,estado nutricional en menores de 5 anos,clasificacion d,2002-02-01,18,7,18,7,25
30301,AYOPAYA (V. DE INDEPENDENCIA),estado nutricional en menores de 5 anos,clasificacion d,2002-02-01,68,86,68,86,154
10201,AZURDUY,estado nutricional en menores de 5 anos,clasificacion d,2002-02-01,29,119,29,119,148
21203,BATALLAS,estado nutricional en menores de 5 anos,clasificacion d,2002-02-01,1,39,1,39,40
80802,BAURES,estado nutricional en menores de 5 anos,clasificacion d,2002-02-01,21,24,21,24,45
41202,BELEN DE ANDAMARCA,estado nutricional en menores de 5 anos,clasificacion d,2002-02-01,0,1,0,1,1
50104,BELEN DE URMIRI,estado nutricional en menores de 5 anos,clasificacion d,2002-02-01,1,10,1,10,11
90104,BELLA FLOR,estado nutricional en menores de 5 anos,clasificacion d,2002-02-01,1,0,1,0,1
60202,BERMEJO,estado nutricional en menores de 5 anos,clasificacion d,2002-02-01,0,11,0,11,11
50301,BETANZOS,estado nutricional en menores de 5 anos,clasificacion d,2002-02-01,29,181,29,181,210
31501,BOLIVAR,estado nutricional en menores de 5 anos,clasificacion d,2002-02-01,19,31,19,31,50
90103,BOLPEBRA,estado nutricional en menores de 5 anos,clasificacion d,2002-02-01,0,3,0,3,3
70707,BOYUIBE,estado nutricional en menores de 5 anos,clasificacion d,2002-02-01,0,22,0,22,22
70401,BUENA VISTA,estado nutricional en menores de 5 anos,clasificacion d,2002-02-01,55,75,55,75,130
70703,CABEZAS,estado nutricional en menores de 5 anos,clasificacion d,2002-02-01,2,70,2,70,72
20905,CAIROMA,estado nutricional en menores de 5 anos,clasificacion d,2002-02-01,0,4,0,4,4
51102,"CAIZA ""D""",estado nutricional en menores de 5 anos,clasificacion d,2002-02-01,10,139,10,139,149
21003,CAJUATA,estado nutricional en menores de 5 anos,clasificacion d,2002-02-01,7,21,7,21,28
20303,CALACOTO,estado nutricional en menores de 5 anos,clasificacion d,2002-02-01,1,12,1,12,13
21304,CALAMARCA,estado nutricional en menores de 5 anos,clasificacion d,2002-02-01,12,8,12,8,20
10701,CAMARGO,estado nutricional en menores de 5 anos,clasificacion d,2002-02-01,4,67,4,67,71
10901,CAMATAQUI (C. VILLA ABECIA),estado nutricional en menores de 5 anos,clasificacion d,2002-02-01,1,10,1,10,11
70706,CAMIRI,estado nutricional en menores de 5 anos,clasificacion d,2002-02-01,47,126,47,126,173
30701,CAPINOTA,estado nutricional en menores de 5 anos,clasificacion d,2002-02-01,28,14,28,14,42
20302,CAQUIAVIRI,estado nutricional en menores de 5 anos,clasificacion d,2002-02-01,12,23,12,23,35
40102,CARACOLLO,estado nutricional en menores de 5 anos,clasificacion d,2002-02-01,41,38,41,38,79
22001,CARANAVI,estado nutricional en menores de 5 anos,clasificacion d,2002-02-01,109,80,109,80,189
60302,CARAPARI,estado nutricional en menores de 5 anos,clasificacion d,2002-02-01,15,40,15,40,55
50702,CARIPUYO,estado nutricional en menores de 5 anos,clasificacion d,2002-02-01,1,54,1,54,55
21902,CATACORA,estado nutricional en menores de 5 anos,clasificacion d,2002-02-01,2,3,2,3,5
40201,CHALLAPATA,estado nutricional en menores de 5 anos,clasificacion d,2002-02-01,24,29,24,29,53
50302,CHAQUI,estado nutricional en menores de 5 anos,clasificacion d,2002-02-01,27,82,27,82,109
70702,CHARAGUA,estado nutricional en menores de 5 anos,clasificacion d,2002-02-01,9,264,9,264,273
20305,CHARAÃ‘A,estado nutricional en menores de 5 anos,clasificacion d,2002-02-01,8,7,8,7,15
31204,CHIMORE,estado nutricional en menores de 5 anos,clasificacion d,2002-02-01,10,5,10,5,15
40903,CHIPAYA,estado nutricional en menores de 5 anos,clasificacion d,2002-02-01,1,1,1,1,2
40302,CHOQUE COTA,estado nutricional en menores de 5 anos,clasificacion d,2002-02-01,1,3,1,3,4
21101,CHULUMANI (V. DE LA LIBERTAD),estado nutricional en menores de 5 anos,clasificacion d,2002-02-01,4,6,4,6,10
20501,CHUMA,estado nutricional en menores de 5 anos,clasificacion d,2002-02-01,2,1,2,1,3
30801,CLIZA,estado nutricional en menores de 5 anos,clasificacion d,2002-02-01,1,41,1,41,42
90101,COBIJA,estado nutricional en menores de 5 anos,clasificacion d,2002-02-01,35,30,35,30,65
30101,COCHABAMBA,estado nutricional en menores de 5 anos,clasificacion d,2002-02-01,151,282,151,282,433
40902,COIPASA,estado nutricional en menores de 5 anos,clasificacion d,2002-02-01,0,1,0,1,1
30905,COLCAPIRHUA,estado nutricional en menores de 5 anos,clasificacion d,2002-02-01,25,32,25,32,57
50901,"COLCHA ""K""",estado nutricional en menores de 5 anos,clasificacion d,2002-02-01,0,27,0,27,27
21307,COLLANA,estado nutricional en menores de 5 anos,clasificacion d,2002-02-01,3,0,3,0,3
31002,COLOMI,estado nutricional en menores de 5 anos,clasificacion d,2002-02-01,45,40,45,40,85
50401,COLQUECHACA,estado nutricional en menores de 5 anos,clasificacion d,2002-02-01,26,90,26,90,116
21306,COLQUENCHA,estado nutricional en menores de 5 anos,clasificacion d,2002-02-01,7,8,7,8,15
21004,COLQUIRI,estado nutricional en menores de 5 anos,clasificacion d,2002-02-01,41,27,41,27,68
20304,COMANCHE,estado nutricional en menores de 5 anos,clasificacion d,2002-02-01,8,14,8,14,22
71301,COMARAPA,estado nutricional en menores de 5 anos,clasificacion d,2002-02-01,14,32,14,32,46
20605,COMBAYA,estado nutricional en menores de 5 anos,clasificacion d,2002-02-01,0,28,0,28,28
71101,CONCEPCION,estado nutricional en menores de 5 anos,clasificacion d,2002-02-01,4,41,4,41,45
21701,COPACABANA,estado nutricional en menores de 5 anos,clasificacion d,2002-02-01,4,45,4,45,49
21402,CORIPATA,estado nutricional en menores de 5 anos,clasificacion d,2002-02-01,4,6,4,6,10
20301,CORO CORO,estado nutricional en menores de 5 anos,clasificacion d,2002-02-01,15,20,15,20,35
21401,COROICO,estado nutricional en menores de 5 anos,clasificacion d,2002-02-01,12,9,12,9,21
40301,CORQUE,estado nutricional en menores de 5 anos,clasificacion d,2002-02-01,16,8,16,8,24
50601,COTAGAITA,estado nutricional en menores de 5 anos,clasificacion d,2002-02-01,14,107,14,107,121
70102,COTOCA,estado nutricional en menores de 5 anos,clasificacion d,2002-02-01,32,44,32,44,76
31405,CUCHUMUELA (V. G. VILLARROEL),estado nutricional en menores de 5 anos,clasificacion d,2002-02-01,1,6,1,6,7
70704,CUEVO,estado nutricional en menores de 5 anos,clasificacion d,2002-02-01,19,18,19,18,37
10902,CULPINA,estado nutricional en menores de 5 anos,clasificacion d,2002-02-01,8,242,8,242,250
40401,CURAHUARA DE CARANGAS,estado nutricional en menores de 5 anos,clasificacion d,2002-02-01,17,10,17,10,27
21602,CURVA,estado nutricional en menores de 5 anos,clasificacion d,2002-02-01,12,4,12,4,16
20804,DESAGUADERO,estado nutricional en menores de 5 anos,clasificacion d,2002-02-01,4,23,4,23,27
20105,EL ALTO,estado nutricional en menores de 5 anos,clasificacion d,2002-02-01,896,761,896,761,1657
40103,EL CHORO,estado nutricional en menores de 5 anos,clasificacion d,2002-02-01,1,2,1,2,3
71503,EL PUENTE(STC),estado nutricional en menores de 5 anos,clasificacion d,2002-02-01,12,107,12,107,119
60502,EL PUENTE(TJA),estado nutricional en menores de 5 anos,clasificacion d,2002-02-01,22,52,22,52,74
70105,EL TORNO,estado nutricional en menores de 5 anos,clasificacion d,2002-02-01,61,42,61,42,103
10405,EL VILLAR,estado nutricional en menores de 5 anos,clasificacion d,2002-02-01,38,98,38,98,136
60601,ENTRE RIOS,estado nutricional en menores de 5 anos,clasificacion d,2002-02-01,15,41,15,41,56
41101,EUCALIPTUS,estado nutricional en menores de 5 anos,clasificacion d,2002-02-01,0,32,0,32,32
90503,EUREKA (SANTOS MERCADO),estado nutricional en menores de 5 anos,clasificacion d,2002-02-01,0,2,0,2,2
80402,EXALTACION,estado nutricional en menores de 5 anos,clasificacion d,2002-02-01,6,27,6,27,33
90203,FILADELFIA,estado nutricional en menores de 5 anos,clasificacion d,2002-02-01,4,4,4,4,8
71002,GENERAL SAAVEDRA,estado nutricional en menores de 5 anos,clasificacion d,2002-02-01,33,111,33,111,144
21601,GRAL. J.J. PEREZ (CHARAZANI),estado nutricional en menores de 5 anos,clasificacion d,2002-02-01,12,7,12,7,19
20602,GUANAY,estado nutricional en menores de 5 anos,clasificacion d,2002-02-01,17,104,17,104,121
20802,GUAQUI,estado nutricional en menores de 5 anos,clasificacion d,2002-02-01,0,9,0,9,9
80202,GUAYARAMERIN,estado nutricional en menores de 5 anos,clasificacion d,2002-02-01,33,48,33,48,81
70705,GUTIERREZ,estado nutricional en menores de 5 anos,clasificacion d,2002-02-01,10,192,10,192,202
10502,HUACARETA,estado nutricional en menores de 5 anos,clasificacion d,2002-02-01,67,100,67,100,167
11002,HUACAYA (VILLA DE HUACAYA),estado nutricional en menores de 5 anos,clasificacion d,2002-02-01,9,17,9,17,26
40501,HUACHACALLA,estado nutricional en menores de 5 anos,clasificacion d,2002-02-01,1,1,1,1,2
80803,HUARACAJE,estado nutricional en menores de 5 anos,clasificacion d,2002-02-01,2,9,2,9,11
41601,HUAYLLAMARCA,estado nutricional en menores de 5 anos,clasificacion d,2002-02-01,11,6,11,6,17
21005,ICHOCA,estado nutricional en menores de 5 anos,clasificacion d,2002-02-01,17,27,17,27,44
10304,ICLA,estado nutricional en menores de 5 anos,clasificacion d,2002-02-01,54,124,54,124,178
10703,INCAHUASI,estado nutricional en menores de 5 anos,clasificacion d,2002-02-01,3,186,3,186,189
21001,INQUISIVI,estado nutricional en menores de 5 anos,clasificacion d,2002-02-01,4,49,4,49,53
21102,IRUPANA (VILLA DE LANZA),estado nutricional en menores de 5 anos,clasificacion d,2002-02-01,4,51,4,51,55
21501,IXIAMAS,estado nutricional en menores de 5 anos,clasificacion d,2002-02-01,9,10,9,10,19
21105,LA ASUNTA,estado nutricional en menores de 5 anos,clasificacion d,2002-02-01,19,50,19,50,69
70104,LA GUARDIA,estado nutricional en menores de 5 anos,clasificacion d,2002-02-01,68,46,68,46,114
20101,LA PAZ,estado nutricional en menores de 5 anos,clasificacion d,2002-02-01,776,755,776,755,1531
70701,LAGUNILLAS,estado nutricional en menores de 5 anos,clasificacion d,2002-02-01,6,20,6,20,26
21202,LAJA,estado nutricional en menores de 5 anos,clasificacion d,2002-02-01,0,22,0,22,22
10903,LAS CARRERAS,estado nutricional en menores de 5 anos,clasificacion d,2002-02-01,2,35,2,35,37
51401,LLICA,estado nutricional en menores de 5 anos,clasificacion d,2002-02-01,0,14,0,14,14
80601,LORETO,estado nutricional en menores de 5 anos,clasificacion d,2002-02-01,0,8,0,8,8
20901,LURIBAY,estado nutricional en menores de 5 anos,clasificacion d,2002-02-01,0,23,0,23,23
40702,MACHACAMARCA,estado nutricional en menores de 5 anos,clasificacion d,2002-02-01,7,5,7,5,12
11003,MACHARETI,estado nutricional en menores de 5 anos,clasificacion d,2002-02-01,30,65,30,65,95
80801,MAGDALENA,estado nutricional en menores de 5 anos,clasificacion d,2002-02-01,10,22,10,22,32
70903,MAIRANA,estado nutricional en menores de 5 anos,clasificacion d,2002-02-01,24,21,24,21,45
20103,MECAPACA,estado nutricional en menores de 5 anos,clasificacion d,2002-02-01,5,9,5,9,14
71003,MINEROS,estado nutricional en menores de 5 anos,clasificacion d,2002-02-01,51,109,51,109,160
31301,MIZQUE,estado nutricional en menores de 5 anos,clasificacion d,2002-02-01,39,88,39,88,127
20402,MOCOMOCO,estado nutricional en menores de 5 anos,clasificacion d,2002-02-01,32,36,32,36,68
51002,MOJINETE,estado nutricional en menores de 5 anos,clasificacion d,2002-02-01,0,7,0,7,7
10303,MOJOCOYA,estado nutricional en menores de 5 anos,clasificacion d,2002-02-01,67,122,67,122,189
10501,MONTEAGUDO,estado nutricional en menores de 5 anos,clasificacion d,2002-02-01,112,172,112,172,284
71001,MONTERO,estado nutricional en menores de 5 anos,clasificacion d,2002-02-01,11,341,11,341,352
70803,MORO MORO,estado nutricional en menores de 5 anos,clasificacion d,2002-02-01,4,9,4,9,13
30302,MOROCHATA,estado nutricional en menores de 5 anos,clasificacion d,2002-02-01,22,23,22,23,45
90401,NACEBE (SANTA ROSA DEL ABUNA),estado nutricional en menores de 5 anos,clasificacion d,2002-02-01,0,3,0,3,3
20307,NAZACARA DE PACAJES,estado nutricional en menores de 5 anos,clasificacion d,2002-02-01,4,0,4,0,4
50404,OCURI,estado nutricional en menores de 5 anos,clasificacion d,2002-02-01,42,66,42,66,108
70202,OKINAWA,estado nutricional en menores de 5 anos,clasificacion d,2002-02-01,5,5,5,5,10
30203,OMEREQUE,estado nutricional en menores de 5 anos,clasificacion d,2002-02-01,2,11,2,11,13
40101,ORURO,estado nutricional en menores de 5 anos,clasificacion d,2002-02-01,63,597,63,597,660
60201,PADCAYA,estado nutricional en menores de 5 anos,clasificacion d,2002-02-01,14,38,14,38,52
10401,PADILLA,estado nutricional en menores de 5 anos,clasificacion d,2002-02-01,132,212,132,212,344
70502,PAILON,estado nutricional en menores de 5 anos,clasificacion d,2002-02-01,1,56,1,56,57
20102,PALCA,estado nutricional en menores de 5 anos,clasificacion d,2002-02-01,39,27,39,27,66
21104,PALOS BLANCOS,estado nutricional en menores de 5 anos,clasificacion d,2002-02-01,52,48,52,48,100
40802,PAMPA AULLAGAS,estado nutricional en menores de 5 anos,clasificacion d,2002-02-01,12,12,12,12,24
70902,PAMPA GRANDE,estado nutricional en menores de 5 anos,clasificacion d,2002-02-01,6,9,6,9,15
21802,PAPEL PAMPA,estado nutricional en menores de 5 anos,clasificacion d,2002-02-01,1,2,1,2,3
30202,PASORAPA,estado nutricional en menores de 5 anos,clasificacion d,2002-02-01,5,23,5,23,28
21305,PATACAMAYA,estado nutricional en menores de 5 anos,clasificacion d,2002-02-01,16,14,16,14,30
40602,PAZÃ‘A,estado nutricional en menores de 5 anos,clasificacion d,2002-02-01,2,30,2,30,32
20702,PELECHUCO,estado nutricional en menores de 5 anos,clasificacion d,2002-02-01,17,7,17,7,24
50403,POCOATA,estado nutricional en menores de 5 anos,clasificacion d,2002-02-01,69,164,69,164,233
31203,POCONA,estado nutricional en menores de 5 anos,clasificacion d,2002-02-01,10,35,10,35,45
31202,POJO (CBBA),estado nutricional en menores de 5 anos,clasificacion d,2002-02-01,27,93,27,93,120
40601,POOPO,estado nutricional en menores de 5 anos,clasificacion d,2002-02-01,0,22,0,22,22
51203,PORCO,estado nutricional en menores de 5 anos,clasificacion d,2002-02-01,32,33,32,33,65
10103,POROMA,estado nutricional en menores de 5 anos,clasificacion d,2002-02-01,80,129,80,129,209
70103,PORONGO,estado nutricional en menores de 5 anos,clasificacion d,2002-02-01,14,13,14,13,27
70601,PORTACHUELO,estado nutricional en menores de 5 anos,clasificacion d,2002-02-01,41,30,41,30,71
90102,PORVENIR,estado nutricional en menores de 5 anos,clasificacion d,2002-02-01,0,5,0,5,5
50101,POTOSI,estado nutricional en menores de 5 anos,clasificacion d,2002-02-01,131,257,131,257,388
10302,PRESTO,estado nutricional en menores de 5 anos,clasificacion d,2002-02-01,62,50,62,50,112
21201,PUCARANI,estado nutricional en menores de 5 anos,clasificacion d,2002-02-01,5,45,5,45,50
20401,PUERTO ACOSTA,estado nutricional en menores de 5 anos,clasificacion d,2002-02-01,34,44,34,44,78
20403,PUERTO CARABUCO,estado nutricional en menores de 5 anos,clasificacion d,2002-02-01,34,70,34,70,104
90301,PUERTO GONZALO MORENO,estado nutricional en menores de 5 anos,clasificacion d,2002-02-01,1,15,1,15,16
21204,PUERTO PEREZ,estado nutricional en menores de 5 anos,clasificacion d,2002-02-01,2,3,2,3,5
71402,PUERTO QUIJARRO,estado nutricional en menores de 5 anos,clasificacion d,2002-02-01,40,8,40,8,48
90201,PUERTO RICO,estado nutricional en menores de 5 anos,clasificacion d,2002-02-01,0,6,0,6,6
80703,PUERTO SILES,estado nutricional en menores de 5 anos,clasificacion d,2002-02-01,0,2,0,2,2
71401,PUERTO SUAREZ,estado nutricional en menores de 5 anos,clasificacion d,2002-02-01,27,15,27,15,42
31205,PUERTO VILLARROEL,estado nutricional en menores de 5 anos,clasificacion d,2002-02-01,54,37,54,37,91
51101,PUNA,estado nutricional en menores de 5 anos,clasificacion d,2002-02-01,2,154,2,154,156
31401,PUNATA,estado nutricional en menores de 5 anos,clasificacion d,2002-02-01,0,8,0,8,8
20604,QUIABAYA,estado nutricional en menores de 5 anos,clasificacion d,2002-02-01,0,36,0,36,36
21002,QUIME,estado nutricional en menores de 5 anos,clasificacion d,2002-02-01,17,42,17,42,59
50402,RAVELO,estado nutricional en menores de 5 anos,clasificacion d,2002-02-01,77,150,77,150,227
80301,REYES,estado nutricional en menores de 5 anos,clasificacion d,2002-02-01,15,10,15,10,25
80201,RIBERALTA,estado nutricional en menores de 5 anos,clasificacion d,2002-02-01,107,91,107,91,198
70503,ROBORE,estado nutricional en menores de 5 anos,clasificacion d,2002-02-01,1,51,1,51,52
80304,RURRENABAQUE,estado nutricional en menores de 5 anos,clasificacion d,2002-02-01,19,15,19,15,34
40901,SABAYA,estado nutricional en menores de 5 anos,clasificacion d,2002-02-01,0,7,0,7,7
31001,SACABA,estado nutricional en menores de 5 anos,clasificacion d,2002-02-01,28,5,28,5,33
30404,SACABAMBA,estado nutricional en menores de 5 anos,clasificacion d,2002-02-01,0,36,0,36,36
50701,SACACA,estado nutricional en menores de 5 anos,clasificacion d,2002-02-01,53,289,53,289,342
71302,SAIPINA,estado nutricional en menores de 5 anos,clasificacion d,2002-02-01,11,13,11,13,24
40801,SALINAS DE GARCI MENDOZA,estado nutricional en menores de 5 anos,clasificacion d,2002-02-01,10,13,10,13,23
70901,SAMAIPATA,estado nutricional en menores de 5 anos,clasificacion d,2002-02-01,30,9,30,9,39
51601,SAN AGUSTIN,estado nutricional en menores de 5 anos,clasificacion d,2002-02-01,1,4,1,4,5
51003,SAN ANTONIO DE ESMORUCO,estado nutricional en menores de 5 anos,clasificacion d,2002-02-01,0,21,0,21,21
71105,SAN ANTONIO DE LOMERIO,estado nutricional en menores de 5 anos,clasificacion d,2002-02-01,70,154,70,154,224
31403,SAN BENITO,estado nutricional en menores de 5 anos,clasificacion d,2002-02-01,1,41,1,41,42
80302,SAN BORJA,estado nutricional en menores de 5 anos,clasificacion d,2002-02-01,40,36,40,36,76
21502,SAN BUENA VENTURA,estado nutricional en menores de 5 anos,clasificacion d,2002-02-01,30,50,30,50,80
70402,SAN CARLOS,estado nutricional en menores de 5 anos,clasificacion d,2002-02-01,0,7,0,7,7
80501,SAN IGNACIO,estado nutricional en menores de 5 anos,clasificacion d,2002-02-01,13,104,13,104,117
70301,SAN IGNACIO DE VELASCO,estado nutricional en menores de 5 anos,clasificacion d,2002-02-01,194,247,194,247,441
80102,SAN JAVIER(BNI),estado nutricional en menores de 5 anos,clasificacion d,2002-02-01,14,15,14,15,29
71102,SAN JAVIER(STC),estado nutricional en menores de 5 anos,clasificacion d,2002-02-01,4,106,4,106,110
80701,SAN JOAQUIN,estado nutricional en menores de 5 anos,clasificacion d,2002-02-01,1,7,1,7,8
70501,SAN JOSE DE CHIQUITOS,estado nutricional en menores de 5 anos,clasificacion d,2002-02-01,31,27,31,27,58
71104,SAN JULIAN,estado nutricional en menores de 5 anos,clasificacion d,2002-02-01,139,212,139,212,351
90302,SAN LORENZO(PND),estado nutricional en menores de 5 anos,clasificacion d,2002-02-01,0,2,0,2,2
60501,SAN LORENZO(TJA),estado nutricional en menores de 5 anos,clasificacion d,2002-02-01,5,18,5,18,23
10702,SAN LUCAS,estado nutricional en menores de 5 anos,clasificacion d,2002-02-01,7,458,7,458,465
71201,SAN MATIAS,estado nutricional en menores de 5 anos,clasificacion d,2002-02-01,59,61,59,61,120
70302,SAN MIGUEL DE VELASCO,estado nutricional en menores de 5 anos,clasificacion d,2002-02-01,48,124,48,124,172
51001,SAN PABLO DE LIPEZ,estado nutricional en menores de 5 anos,clasificacion d,2002-02-01,2,17,2,17,19
50501,SAN PEDRO DE BUENA VISTA,estado nutricional en menores de 5 anos,clasificacion d,2002-02-01,7,213,7,213,220
21801,SAN PEDRO DE CURAHUARA,estado nutricional en menores de 5 anos,clasificacion d,2002-02-01,2,10,2,10,12
50902,SAN PEDRO DE QUEMES,estado nutricional en menores de 5 anos,clasificacion d,2002-02-01,0,7,0,7,7
21702,SAN PEDRO DE TIQUINA,estado nutricional en menores de 5 anos,clasificacion d,2002-02-01,0,3,0,3,3
90202,SAN PEDRO(PND),estado nutricional en menores de 5 anos,clasificacion d,2002-02-01,1,7,1,7,8
70303,SAN RAFAEL,estado nutricional en menores de 5 anos,clasificacion d,2002-02-01,36,40,36,40,76
80702,SAN RAMON,estado nutricional en menores de 5 anos,clasificacion d,2002-02-01,4,4,4,4,8
80702,SAN RAMON,estado nutricional en menores de 5 anos,clasificacion d,2002-02-01,14,2,14,2,16
80401,SANTA ANA,estado nutricional en menores de 5 anos,clasificacion d,2002-02-01,27,20,27,20,47
70101,SANTA CRUZ DE LA SIERRA,estado nutricional en menores de 5 anos,clasificacion d,2002-02-01,296,337,296,337,633
80303,SANTA ROSA,estado nutricional en menores de 5 anos,clasificacion d,2002-02-01,8,7,8,7,15
70602,SANTA ROSA DEL SARA,estado nutricional en menores de 5 anos,clasificacion d,2002-02-01,8,26,8,26,34
20308,SANTIAGO DE CALLAPA,estado nutricional en menores de 5 anos,clasificacion d,2002-02-01,0,7,0,7,7
41401,SANTIAGO DE HUARI,estado nutricional en menores de 5 anos,clasificacion d,2002-02-01,16,7,16,7,23
21901,SANTIAGO DE MACHACA,estado nutricional en menores de 5 anos,clasificacion d,2002-02-01,3,6,3,6,9
30702,SANTIVAÃ‘ES,estado nutricional en menores de 5 anos,clasificacion d,2002-02-01,14,50,14,50,64
40202,SANTUARIO DE QUILLACAS,estado nutricional en menores de 5 anos,clasificacion d,2002-02-01,6,22,6,22,28
20902,SAPAHAQUI,estado nutricional en menores de 5 anos,clasificacion d,2002-02-01,1,16,1,16,17
21301,SICA SICA (VILLA AROMA),estado nutricional en menores de 5 anos,clasificacion d,2002-02-01,26,4,26,4,30
30703,SICAYA,estado nutricional en menores de 5 anos,clasificacion d,2002-02-01,0,17,0,17,17
30902,SIPE SIPE,estado nutricional en menores de 5 anos,clasificacion d,2002-02-01,79,70,79,70,149
10403,SOPACHUY,estado nutricional en menores de 5 anos,clasificacion d,2002-02-01,29,30,29,30,59
20601,SORATA,estado nutricional en menores de 5 anos,clasificacion d,2002-02-01,11,39,11,39,50
10101,SUCRE,estado nutricional en menores de 5 anos,clasificacion d,2002-02-01,59,777,59,777,836
31404,TACACHI,estado nutricional en menores de 5 anos,clasificacion d,2002-02-01,1,11,1,11,12
20603,TACACOMA,estado nutricional en menores de 5 anos,clasificacion d,2002-02-01,20,23,20,23,43
50303,TACOBAMBA,estado nutricional en menores de 5 anos,clasificacion d,2002-02-01,17,71,17,71,88
30602,TACOPAYA,estado nutricional en menores de 5 anos,clasificacion d,2002-02-01,2,7,2,7,9
51402,TAHUA,estado nutricional en menores de 5 anos,clasificacion d,2002-02-01,0,6,0,6,6
31101,TAPACARI,estado nutricional en menores de 5 anos,clasificacion d,2002-02-01,5,66,5,66,71
10601,TARABUCO,estado nutricional en menores de 5 anos,clasificacion d,2002-02-01,12,615,12,615,627
30401,TARATA,estado nutricional en menores de 5 anos,clasificacion d,2002-02-01,1,22,1,22,23
60101,TARIJA,estado nutricional en menores de 5 anos,clasificacion d,2002-02-01,37,167,37,167,204
10202,TARVITA,estado nutricional en menores de 5 anos,clasificacion d,2002-02-01,79,97,79,97,176
20803,TIAWANACU,estado nutricional en menores de 5 anos,clasificacion d,2002-02-01,13,9,13,9,22
50102,TINGUIPAYA,estado nutricional en menores de 5 anos,clasificacion d,2002-02-01,2,59,2,59,61
20606,TIPUANI,estado nutricional en menores de 5 anos,clasificacion d,2002-02-01,7,1,7,1,8
30903,TIQUIPAYA,estado nutricional en menores de 5 anos,clasificacion d,2002-02-01,1,15,1,15,16
31601,TIRAQUE (CBBA),estado nutricional en menores de 5 anos,clasificacion d,2002-02-01,55,85,55,85,140
21703,TITO YUPANQUI (PARQUIPUJIO),estado nutricional en menores de 5 anos,clasificacion d,2002-02-01,0,9,0,9,9
30802,TOCO,estado nutricional en menores de 5 anos,clasificacion d,2002-02-01,1,9,1,9,10
30803,TOLATA,estado nutricional en menores de 5 anos,clasificacion d,2002-02-01,0,6,0,6,6
41001,TOLEDO,estado nutricional en menores de 5 anos,clasificacion d,2002-02-01,6,9,6,9,15
51202,TOMAVE,estado nutricional en menores de 5 anos,clasificacion d,2002-02-01,0,104,0,104,104
10402,TOMINA,estado nutricional en menores de 5 anos,clasificacion d,2002-02-01,71,163,71,163,234
50502,TORO TORO,estado nutricional en menores de 5 anos,clasificacion d,2002-02-01,8,20,8,20,28
31201,TOTORA(CBBA),estado nutricional en menores de 5 anos,clasificacion d,2002-02-01,37,28,37,28,65
41301,TOTORA(ORR),estado nutricional en menores de 5 anos,clasificacion d,2002-02-01,0,13,0,13,13
70802,TRIGAL,estado nutricional en menores de 5 anos,clasificacion d,2002-02-01,2,1,2,1,3
80101,TRINIDAD,estado nutricional en menores de 5 anos,clasificacion d,2002-02-01,1,0,1,0,1
50801,TUPIZA,estado nutricional en menores de 5 anos,clasificacion d,2002-02-01,9,165,9,165,174
40402,TURCO,estado nutricional en menores de 5 anos,clasificacion d,2002-02-01,4,5,4,5,9
21302,UMALA,estado nutricional en menores de 5 anos,clasificacion d,2002-02-01,11,3,11,3,14
60401,URIONDO (A. CONCEPCION),estado nutricional en menores de 5 anos,clasificacion d,2002-02-01,4,20,4,20,24
71502,URUBICHA,estado nutricional en menores de 5 anos,clasificacion d,2002-02-01,59,298,59,298,357
51201,UYUNI,estado nutricional en menores de 5 anos,clasificacion d,2002-02-01,1,79,1,79,80
30502,VACAS,estado nutricional en menores de 5 anos,clasificacion d,2002-02-01,3,43,3,43,46
70801,VALLEGRANDE,estado nutricional en menores de 5 anos,clasificacion d,2002-02-01,26,56,26,56,82
20801,VIACHA,estado nutricional en menores de 5 anos,clasificacion d,2002-02-01,7,97,7,97,104
31302,VILA VILA,estado nutricional en menores de 5 anos,clasificacion d,2002-02-01,0,24,0,24,24
60303,VILLA MONTES,estado nutricional en menores de 5 anos,clasificacion d,2002-02-01,37,42,37,42,79
90502,VILLA NUEVA (LOMA ALTA),estado nutricional en menores de 5 anos,clasificacion d,2002-02-01,2,0,2,0,2
31402,VILLA RIVERO,estado nutricional en menores de 5 anos,clasificacion d,2002-02-01,0,5,0,5,5
10801,VILLA SERRANO,estado nutricional en menores de 5 anos,clasificacion d,2002-02-01,78,195,78,195,273
31003,VILLA TUNARI,estado nutricional en menores de 5 anos,clasificacion d,2002-02-01,49,74,49,74,123
11001,VILLA VACA GUZMAN (MUYUPAMPA),estado nutricional en menores de 5 anos,clasificacion d,2002-02-01,52,113,52,113,165
51501,VILLAZON,estado nutricional en menores de 5 anos,clasificacion d,2002-02-01,3,139,3,139,142
30904,VINTO,estado nutricional en menores de 5 anos,clasificacion d,2002-02-01,30,18,30,18,48
50602,VITICHI,estado nutricional en menores de 5 anos,clasificacion d,2002-02-01,36,106,36,106,142
20306,WALDO BALLIVIAN,estado nutricional en menores de 5 anos,clasificacion d,2002-02-01,0,3,0,3,3
70201,WARNES,estado nutricional en menores de 5 anos,clasificacion d,2002-02-01,57,114,57,114,171
20903,YACO,estado nutricional en menores de 5 anos,clasificacion d,2002-02-01,3,18,3,18,21
60301,YACUIBA,estado nutricional en menores de 5 anos,clasificacion d,2002-02-01,37,23,37,23,60
10602,YAMPARAEZ,estado nutricional en menores de 5 anos,clasificacion d,2002-02-01,128,259,128,259,387
21103,YANACACHI,estado nutricional en menores de 5 anos,clasificacion d,2002-02-01,2,4,2,4,6
70403,YAPACANI,estado nutricional en menores de 5 anos,clasificacion d,2002-02-01,67,124,67,124,191
50103,YOCALLA,estado nutricional en menores de 5 anos,clasificacion d,2002-02-01,5,88,5,88,93
10102,YOTALA,estado nutricional en menores de 5 anos,clasificacion d,2002-02-01,77,179,77,179,256
60402,YUNCHARA,estado nutricional en menores de 5 anos,clasificacion d,2002-02-01,8,29,8,29,37
10301,ZUDAÃ‘EZ,estado nutricional en menores de 5 anos,clasificacion d,2002-02-01,68,135,68,135,203
51302,ACACIO,estado nutricional en menores de 5 anos,clasificacion d,2002-03-01,27,127,27,127,154
20201,ACHACACHI,estado nutricional en menores de 5 anos,clasificacion d,2002-03-01,55,170,55,170,225
20104,ACHOCALLA,estado nutricional en menores de 5 anos,clasificacion d,2002-03-01,22,8,22,8,30
30201,AIQUILE,estado nutricional en menores de 5 anos,clasificacion d,2002-03-01,9,27,9,27,36
31303,ALALAY,estado nutricional en menores de 5 anos,clasificacion d,2002-03-01,14,13,14,13,27
10404,ALCALA,estado nutricional en menores de 5 anos,clasificacion d,2002-03-01,40,68,40,68,108
20202,ANCORAIMES,estado nutricional en menores de 5 anos,clasificacion d,2002-03-01,98,108,98,108,206
41201,ANDAMARCA,estado nutricional en menores de 5 anos,clasificacion d,2002-03-01,12,29,12,29,41
40603,ANTEQUERA,estado nutricional en menores de 5 anos,clasificacion d,2002-03-01,0,10,0,10,10
30402,ANZALDO,estado nutricional en menores de 5 anos,clasificacion d,2002-03-01,2,63,2,63,65
20701,APOLO,estado nutricional en menores de 5 anos,clasificacion d,2002-03-01,13,18,13,18,31
51301,ARAMPAMPA,estado nutricional en menores de 5 anos,clasificacion d,2002-03-01,10,43,10,43,53
30501,ARANI,estado nutricional en menores de 5 anos,clasificacion d,2002-03-01,9,65,9,65,74
30403,ARBIETO,estado nutricional en menores de 5 anos,clasificacion d,2002-03-01,3,16,3,16,19
30601,ARQUE,estado nutricional en menores de 5 anos,clasificacion d,2002-03-01,50,111,50,111,161
71501,ASCENCION DE GUARAYOS,estado nutricional en menores de 5 anos,clasificacion d,2002-03-01,0,2,0,2,2
50802,ATOCHA,estado nutricional en menores de 5 anos,clasificacion d,2002-03-01,5,67,5,67,72
20503,AUCAPATA,estado nutricional en menores de 5 anos,clasificacion d,2002-03-01,0,2,0,2,2
21303,AYO AYO,estado nutricional en menores de 5 anos,clasificacion d,2002-03-01,19,2,19,2,21
30301,AYOPAYA (V. DE INDEPENDENCIA),estado nutricional en menores de 5 anos,clasificacion d,2002-03-01,79,97,79,97,176
10201,AZURDUY,estado nutricional en menores de 5 anos,clasificacion d,2002-03-01,102,175,102,175,277
21203,BATALLAS,estado nutricional en menores de 5 anos,clasificacion d,2002-03-01,1,37,1,37,38
80802,BAURES,estado nutricional en menores de 5 anos,clasificacion d,2002-03-01,15,21,15,21,36
41202,BELEN DE ANDAMARCA,estado nutricional en menores de 5 anos,clasificacion d,2002-03-01,0,5,0,5,5
50104,BELEN DE URMIRI,estado nutricional en menores de 5 anos,clasificacion d,2002-03-01,0,15,0,15,15
90104,BELLA FLOR,estado nutricional en menores de 5 anos,clasificacion d,2002-03-01,0,1,0,1,1
60202,BERMEJO,estado nutricional en menores de 5 anos,clasificacion d,2002-03-01,5,12,5,12,17
50301,BETANZOS,estado nutricional en menores de 5 anos,clasificacion d,2002-03-01,124,485,124,485,609
31501,BOLIVAR,estado nutricional en menores de 5 anos,clasificacion d,2002-03-01,50,111,50,111,161
90103,BOLPEBRA,estado nutricional en menores de 5 anos,clasificacion d,2002-03-01,0,12,0,12,12
70707,BOYUIBE,estado nutricional en menores de 5 anos,clasificacion d,2002-03-01,0,29,0,29,29
70401,BUENA VISTA,estado nutricional en menores de 5 anos,clasificacion d,2002-03-01,33,48,33,48,81
70703,CABEZAS,estado nutricional en menores de 5 anos,clasificacion d,2002-03-01,3,58,3,58,61
20905,CAIROMA,estado nutricional en menores de 5 anos,clasificacion d,2002-03-01,0,39,0,39,39
51102,"CAIZA ""D""",estado nutricional en menores de 5 anos,clasificacion d,2002-03-01,37,152,37,152,189
21003,CAJUATA,estado nutricional en menores de 5 anos,clasificacion d,2002-03-01,18,20,18,20,38
20303,CALACOTO,estado nutricional en menores de 5 anos,clasificacion d,2002-03-01,8,7,8,7,15
21304,CALAMARCA,estado nutricional en menores de 5 anos,clasificacion d,2002-03-01,14,16,14,16,30
10701,CAMARGO,estado nutricional en menores de 5 anos,clasificacion d,2002-03-01,4,73,4,73,77
10901,CAMATAQUI (C. VILLA ABECIA),estado nutricional en menores de 5 anos,clasificacion d,2002-03-01,0,64,0,64,64
70706,CAMIRI,estado nutricional en menores de 5 anos,clasificacion d,2002-03-01,52,97,52,97,149
30701,CAPINOTA,estado nutricional en menores de 5 anos,clasificacion d,2002-03-01,58,137,58,137,195
20302,CAQUIAVIRI,estado nutricional en menores de 5 anos,clasificacion d,2002-03-01,21,44,21,44,65
40102,CARACOLLO,estado nutricional en menores de 5 anos,clasificacion d,2002-03-01,22,48,22,48,70
22001,CARANAVI,estado nutricional en menores de 5 anos,clasificacion d,2002-03-01,86,143,86,143,229
41503,CARANGAS,estado nutricional en menores de 5 anos,clasificacion d,2002-03-01,0,2,0,2,2
60302,CARAPARI,estado nutricional en menores de 5 anos,clasificacion d,2002-03-01,19,64,19,64,83
50702,CARIPUYO,estado nutricional en menores de 5 anos,clasificacion d,2002-03-01,18,131,18,131,149
21902,CATACORA,estado nutricional en menores de 5 anos,clasificacion d,2002-03-01,3,1,3,1,4
40201,CHALLAPATA,estado nutricional en menores de 5 anos,clasificacion d,2002-03-01,45,43,45,43,88
50302,CHAQUI,estado nutricional en menores de 5 anos,clasificacion d,2002-03-01,1,98,1,98,99
70702,CHARAGUA,estado nutricional en menores de 5 anos,clasificacion d,2002-03-01,5,197,5,197,202
20305,CHARAÃ‘A,estado nutricional en menores de 5 anos,clasificacion d,2002-03-01,0,13,0,13,13
31204,CHIMORE,estado nutricional en menores de 5 anos,clasificacion d,2002-03-01,12,42,12,42,54
40903,CHIPAYA,estado nutricional en menores de 5 anos,clasificacion d,2002-03-01,0,6,0,6,6
21101,CHULUMANI (V. DE LA LIBERTAD),estado nutricional en menores de 5 anos,clasificacion d,2002-03-01,20,13,20,13,33
20501,CHUMA,estado nutricional en menores de 5 anos,clasificacion d,2002-03-01,8,14,8,14,22
30801,CLIZA,estado nutricional en menores de 5 anos,clasificacion d,2002-03-01,3,28,3,28,31
90101,COBIJA,estado nutricional en menores de 5 anos,clasificacion d,2002-03-01,55,43,55,43,98
30101,COCHABAMBA,estado nutricional en menores de 5 anos,clasificacion d,2002-03-01,185,306,185,306,491
40902,COIPASA,estado nutricional en menores de 5 anos,clasificacion d,2002-03-01,0,3,0,3,3
30905,COLCAPIRHUA,estado nutricional en menores de 5 anos,clasificacion d,2002-03-01,61,41,61,41,102
50901,"COLCHA ""K""",estado nutricional en menores de 5 anos,clasificacion d,2002-03-01,1,88,1,88,89
21307,COLLANA,estado nutricional en menores de 5 anos,clasificacion d,2002-03-01,2,0,2,0,2
31002,COLOMI,estado nutricional en menores de 5 anos,clasificacion d,2002-03-01,39,54,39,54,93
50401,COLQUECHACA,estado nutricional en menores de 5 anos,clasificacion d,2002-03-01,67,120,67,120,187
21306,COLQUENCHA,estado nutricional en menores de 5 anos,clasificacion d,2002-03-01,13,23,13,23,36
21004,COLQUIRI,estado nutricional en menores de 5 anos,clasificacion d,2002-03-01,48,37,48,37,85
20304,COMANCHE,estado nutricional en menores de 5 anos,clasificacion d,2002-03-01,5,14,5,14,19
71301,COMARAPA,estado nutricional en menores de 5 anos,clasificacion d,2002-03-01,26,53,26,53,79
20605,COMBAYA,estado nutricional en menores de 5 anos,clasificacion d,2002-03-01,14,15,14,15,29
71101,CONCEPCION,estado nutricional en menores de 5 anos,clasificacion d,2002-03-01,3,33,3,33,36
21701,COPACABANA,estado nutricional en menores de 5 anos,clasificacion d,2002-03-01,4,67,4,67,71
21402,CORIPATA,estado nutricional en menores de 5 anos,clasificacion d,2002-03-01,9,6,9,6,15
20301,CORO CORO,estado nutricional en menores de 5 anos,clasificacion d,2002-03-01,10,29,10,29,39
21401,COROICO,estado nutricional en menores de 5 anos,clasificacion d,2002-03-01,22,9,22,9,31
40301,CORQUE,estado nutricional en menores de 5 anos,clasificacion d,2002-03-01,21,40,21,40,61
50601,COTAGAITA,estado nutricional en menores de 5 anos,clasificacion d,2002-03-01,56,211,56,211,267
70102,COTOCA,estado nutricional en menores de 5 anos,clasificacion d,2002-03-01,61,26,61,26,87
31405,CUCHUMUELA (V. G. VILLARROEL),estado nutricional en menores de 5 anos,clasificacion d,2002-03-01,0,23,0,23,23
70704,CUEVO,estado nutricional en menores de 5 anos,clasificacion d,2002-03-01,26,13,26,13,39
10902,CULPINA,estado nutricional en menores de 5 anos,clasificacion d,2002-03-01,43,259,43,259,302
40401,CURAHUARA DE CARANGAS,estado nutricional en menores de 5 anos,clasificacion d,2002-03-01,21,6,21,6,27
21602,CURVA,estado nutricional en menores de 5 anos,clasificacion d,2002-03-01,8,9,8,9,17
20804,DESAGUADERO,estado nutricional en menores de 5 anos,clasificacion d,2002-03-01,1,26,1,26,27
20105,EL ALTO,estado nutricional en menores de 5 anos,clasificacion d,2002-03-01,1148,925,1148,925,2073
40103,EL CHORO,estado nutricional en menores de 5 anos,clasificacion d,2002-03-01,1,0,1,0,1
71503,EL PUENTE(STC),estado nutricional en menores de 5 anos,clasificacion d,2002-03-01,10,90,10,90,100
60502,EL PUENTE(TJA),estado nutricional en menores de 5 anos,clasificacion d,2002-03-01,13,27,13,27,40
70105,EL TORNO,estado nutricional en menores de 5 anos,clasificacion d,2002-03-01,84,67,84,67,151
10405,EL VILLAR,estado nutricional en menores de 5 anos,clasificacion d,2002-03-01,47,132,47,132,179
60601,ENTRE RIOS,estado nutricional en menores de 5 anos,clasificacion d,2002-03-01,22,67,22,67,89
40502,ESCARA,estado nutricional en menores de 5 anos,clasificacion d,2002-03-01,0,1,0,1,1
41101,EUCALIPTUS,estado nutricional en menores de 5 anos,clasificacion d,2002-03-01,0,14,0,14,14
80402,EXALTACION,estado nutricional en menores de 5 anos,clasificacion d,2002-03-01,12,15,12,15,27
90203,FILADELFIA,estado nutricional en menores de 5 anos,clasificacion d,2002-03-01,5,10,5,10,15
71002,GENERAL SAAVEDRA,estado nutricional en menores de 5 anos,clasificacion d,2002-03-01,53,163,53,163,216
21601,GRAL. J.J. PEREZ (CHARAZANI),estado nutricional en menores de 5 anos,clasificacion d,2002-03-01,27,24,27,24,51
20602,GUANAY,estado nutricional en menores de 5 anos,clasificacion d,2002-03-01,10,129,10,129,139
20802,GUAQUI,estado nutricional en menores de 5 anos,clasificacion d,2002-03-01,0,9,0,9,9
80202,GUAYARAMERIN,estado nutricional en menores de 5 anos,clasificacion d,2002-03-01,69,52,69,52,121
70705,GUTIERREZ,estado nutricional en menores de 5 anos,clasificacion d,2002-03-01,26,194,26,194,220
10502,HUACARETA,estado nutricional en menores de 5 anos,clasificacion d,2002-03-01,77,122,77,122,199
11002,HUACAYA (VILLA DE HUACAYA),estado nutricional en menores de 5 anos,clasificacion d,2002-03-01,9,33,9,33,42
40501,HUACHACALLA,estado nutricional en menores de 5 anos,clasificacion d,2002-03-01,0,7,0,7,7
40701,HUANUNI,estado nutricional en menores de 5 anos,clasificacion d,2002-03-01,1,3,1,3,4
80803,HUARACAJE,estado nutricional en menores de 5 anos,clasificacion d,2002-03-01,3,4,3,4,7
41601,HUAYLLAMARCA,estado nutricional en menores de 5 anos,clasificacion d,2002-03-01,8,4,8,4,12
21005,ICHOCA,estado nutricional en menores de 5 anos,clasificacion d,2002-03-01,3,8,3,8,11
10304,ICLA,estado nutricional en menores de 5 anos,clasificacion d,2002-03-01,102,274,102,274,376
10703,INCAHUASI,estado nutricional en menores de 5 anos,clasificacion d,2002-03-01,5,284,5,284,289
21001,INQUISIVI,estado nutricional en menores de 5 anos,clasificacion d,2002-03-01,5,46,5,46,51
21102,IRUPANA (VILLA DE LANZA),estado nutricional en menores de 5 anos,clasificacion d,2002-03-01,11,29,11,29,40
21501,IXIAMAS,estado nutricional en menores de 5 anos,clasificacion d,2002-03-01,25,35,25,35,60
21105,LA ASUNTA,estado nutricional en menores de 5 anos,clasificacion d,2002-03-01,29,38,29,38,67
70104,LA GUARDIA,estado nutricional en menores de 5 anos,clasificacion d,2002-03-01,98,40,98,40,138
20101,LA PAZ,estado nutricional en menores de 5 anos,clasificacion d,2002-03-01,846,901,846,901,1747
41501,LA RIVERA,estado nutricional en menores de 5 anos,clasificacion d,2002-03-01,0,2,0,2,2
70701,LAGUNILLAS,estado nutricional en menores de 5 anos,clasificacion d,2002-03-01,5,71,5,71,76
21202,LAJA,estado nutricional en menores de 5 anos,clasificacion d,2002-03-01,0,33,0,33,33
10903,LAS CARRERAS,estado nutricional en menores de 5 anos,clasificacion d,2002-03-01,15,54,15,54,69
21006,LICOMA PAMPA,estado nutricional en menores de 5 anos,clasificacion d,2002-03-01,1,19,1,19,20
51401,LLICA,estado nutricional en menores de 5 anos,clasificacion d,2002-03-01,1,22,1,22,23
80601,LORETO,estado nutricional en menores de 5 anos,clasificacion d,2002-03-01,0,6,0,6,6
20901,LURIBAY,estado nutricional en menores de 5 anos,clasificacion d,2002-03-01,0,44,0,44,44
40702,MACHACAMARCA,estado nutricional en menores de 5 anos,clasificacion d,2002-03-01,9,12,9,12,21
11003,MACHARETI,estado nutricional en menores de 5 anos,clasificacion d,2002-03-01,38,102,38,102,140
80801,MAGDALENA,estado nutricional en menores de 5 anos,clasificacion d,2002-03-01,5,9,5,9,14
70903,MAIRANA,estado nutricional en menores de 5 anos,clasificacion d,2002-03-01,17,17,17,17,34
20103,MECAPACA,estado nutricional en menores de 5 anos,clasificacion d,2002-03-01,10,12,10,12,22
71003,MINEROS,estado nutricional en menores de 5 anos,clasificacion d,2002-03-01,57,114,57,114,171
31301,MIZQUE,estado nutricional en menores de 5 anos,clasificacion d,2002-03-01,0,70,0,70,70
20402,MOCOMOCO,estado nutricional en menores de 5 anos,clasificacion d,2002-03-01,19,28,19,28,47
51002,MOJINETE,estado nutricional en menores de 5 anos,clasificacion d,2002-03-01,0,20,0,20,20
10303,MOJOCOYA,estado nutricional en menores de 5 anos,clasificacion d,2002-03-01,85,131,85,131,216
10501,MONTEAGUDO,estado nutricional en menores de 5 anos,clasificacion d,2002-03-01,137,240,137,240,377
71001,MONTERO,estado nutricional en menores de 5 anos,clasificacion d,2002-03-01,12,476,12,476,488
70803,MORO MORO,estado nutricional en menores de 5 anos,clasificacion d,2002-03-01,9,22,9,22,31
30302,MOROCHATA,estado nutricional en menores de 5 anos,clasificacion d,2002-03-01,38,95,38,95,133
90401,NACEBE (SANTA ROSA DEL ABUNA),estado nutricional en menores de 5 anos,clasificacion d,2002-03-01,0,7,0,7,7
50404,OCURI,estado nutricional en menores de 5 anos,clasificacion d,2002-03-01,75,66,75,66,141
70202,OKINAWA,estado nutricional en menores de 5 anos,clasificacion d,2002-03-01,8,35,8,35,43
30203,OMEREQUE,estado nutricional en menores de 5 anos,clasificacion d,2002-03-01,0,11,0,11,11
40101,ORURO,estado nutricional en menores de 5 anos,clasificacion d,2002-03-01,331,417,331,417,748
60201,PADCAYA,estado nutricional en menores de 5 anos,clasificacion d,2002-03-01,26,56,26,56,82
10401,PADILLA,estado nutricional en menores de 5 anos,clasificacion d,2002-03-01,132,258,132,258,390
70502,PAILON,estado nutricional en menores de 5 anos,clasificacion d,2002-03-01,4,69,4,69,73
20102,PALCA,estado nutricional en menores de 5 anos,clasificacion d,2002-03-01,37,34,37,34,71
21104,PALOS BLANCOS,estado nutricional en menores de 5 anos,clasificacion d,2002-03-01,52,121,52,121,173
40802,PAMPA AULLAGAS,estado nutricional en menores de 5 anos,clasificacion d,2002-03-01,9,24,9,24,33
70902,PAMPA GRANDE,estado nutricional en menores de 5 anos,clasificacion d,2002-03-01,15,18,15,18,33
21802,PAPEL PAMPA,estado nutricional en menores de 5 anos,clasificacion d,2002-03-01,2,12,2,12,14
30202,PASORAPA,estado nutricional en menores de 5 anos,clasificacion d,2002-03-01,10,40,10,40,50
21305,PATACAMAYA,estado nutricional en menores de 5 anos,clasificacion d,2002-03-01,27,7,27,7,34
40602,PAZÃ‘A,estado nutricional en menores de 5 anos,clasificacion d,2002-03-01,1,28,1,28,29
20702,PELECHUCO,estado nutricional en menores de 5 anos,clasificacion d,2002-03-01,9,25,9,25,34
50403,POCOATA,estado nutricional en menores de 5 anos,clasificacion d,2002-03-01,104,208,104,208,312
31203,POCONA,estado nutricional en menores de 5 anos,clasificacion d,2002-03-01,49,51,49,51,100
31202,POJO (CBBA),estado nutricional en menores de 5 anos,clasificacion d,2002-03-01,40,120,40,120,160
40601,POOPO,estado nutricional en menores de 5 anos,clasificacion d,2002-03-01,0,38,0,38,38
51203,PORCO,estado nutricional en menores de 5 anos,clasificacion d,2002-03-01,24,25,24,25,49
10103,POROMA,estado nutricional en menores de 5 anos,clasificacion d,2002-03-01,123,132,123,132,255
70103,PORONGO,estado nutricional en menores de 5 anos,clasificacion d,2002-03-01,23,18,23,18,41
70601,PORTACHUELO,estado nutricional en menores de 5 anos,clasificacion d,2002-03-01,59,33,59,33,92
90102,PORVENIR,estado nutricional en menores de 5 anos,clasificacion d,2002-03-01,0,4,0,4,4
70804,POSTRER VALLE,estado nutricional en menores de 5 anos,clasificacion d,2002-03-01,3,7,3,7,10
50101,POTOSI,estado nutricional en menores de 5 anos,clasificacion d,2002-03-01,213,330,213,330,543
10302,PRESTO,estado nutricional en menores de 5 anos,clasificacion d,2002-03-01,80,73,80,73,153
70805,PUCARA,estado nutricional en menores de 5 anos,clasificacion d,2002-03-01,0,2,0,2,2
21201,PUCARANI,estado nutricional en menores de 5 anos,clasificacion d,2002-03-01,8,84,8,84,92
20401,PUERTO ACOSTA,estado nutricional en menores de 5 anos,clasificacion d,2002-03-01,29,56,29,56,85
20403,PUERTO CARABUCO,estado nutricional en menores de 5 anos,clasificacion d,2002-03-01,33,47,33,47,80
90301,PUERTO GONZALO MORENO,estado nutricional en menores de 5 anos,clasificacion d,2002-03-01,20,18,20,18,38
21204,PUERTO PEREZ,estado nutricional en menores de 5 anos,clasificacion d,2002-03-01,5,14,5,14,19
71402,PUERTO QUIJARRO,estado nutricional en menores de 5 anos,clasificacion d,2002-03-01,18,5,18,5,23
90201,PUERTO RICO,estado nutricional en menores de 5 anos,clasificacion d,2002-03-01,1,12,1,12,13
80703,PUERTO SILES,estado nutricional en menores de 5 anos,clasificacion d,2002-03-01,0,4,0,4,4
71401,PUERTO SUAREZ,estado nutricional en menores de 5 anos,clasificacion d,2002-03-01,66,27,66,27,93
31205,PUERTO VILLARROEL,estado nutricional en menores de 5 anos,clasificacion d,2002-03-01,94,104,94,104,198
51101,PUNA,estado nutricional en menores de 5 anos,clasificacion d,2002-03-01,44,363,44,363,407
31401,PUNATA,estado nutricional en menores de 5 anos,clasificacion d,2002-03-01,73,164,73,164,237
20604,QUIABAYA,estado nutricional en menores de 5 anos,clasificacion d,2002-03-01,1,34,1,34,35
30901,QUILLACOLLO,estado nutricional en menores de 5 anos,clasificacion d,2002-03-01,20,3,20,3,23
21002,QUIME,estado nutricional en menores de 5 anos,clasificacion d,2002-03-01,16,24,16,24,40
70904,QUIRUSILLAS,estado nutricional en menores de 5 anos,clasificacion d,2002-03-01,2,2,2,2,4
50402,RAVELO,estado nutricional en menores de 5 anos,clasificacion d,2002-03-01,121,223,121,223,344
80301,REYES,estado nutricional en menores de 5 anos,clasificacion d,2002-03-01,32,26,32,26,58
80201,RIBERALTA,estado nutricional en menores de 5 anos,clasificacion d,2002-03-01,285,215,285,215,500
70503,ROBORE,estado nutricional en menores de 5 anos,clasificacion d,2002-03-01,0,70,0,70,70
80304,RURRENABAQUE,estado nutricional en menores de 5 anos,clasificacion d,2002-03-01,25,32,25,32,57
40901,SABAYA,estado nutricional en menores de 5 anos,clasificacion d,2002-03-01,0,7,0,7,7
31001,SACABA,estado nutricional en menores de 5 anos,clasificacion d,2002-03-01,90,123,90,123,213
30404,SACABAMBA,estado nutricional en menores de 5 anos,clasificacion d,2002-03-01,1,62,1,62,63
50701,SACACA,estado nutricional en menores de 5 anos,clasificacion d,2002-03-01,95,341,95,341,436
71302,SAIPINA,estado nutricional en menores de 5 anos,clasificacion d,2002-03-01,16,17,16,17,33
40801,SALINAS DE GARCI MENDOZA,estado nutricional en menores de 5 anos,clasificacion d,2002-03-01,9,9,9,9,18
70901,SAMAIPATA,estado nutricional en menores de 5 anos,clasificacion d,2002-03-01,19,9,19,9,28
51601,SAN AGUSTIN,estado nutricional en menores de 5 anos,clasificacion d,2002-03-01,0,11,0,11,11
80602,SAN ANDRES,estado nutricional en menores de 5 anos,clasificacion d,2002-03-01,6,9,6,9,15
51003,SAN ANTONIO DE ESMORUCO,estado nutricional en menores de 5 anos,clasificacion d,2002-03-01,0,22,0,22,22
71105,SAN ANTONIO DE LOMERIO,estado nutricional en menores de 5 anos,clasificacion d,2002-03-01,67,148,67,148,215
31403,SAN BENITO,estado nutricional en menores de 5 anos,clasificacion d,2002-03-01,3,31,3,31,34
80302,SAN BORJA,estado nutricional en menores de 5 anos,clasificacion d,2002-03-01,104,81,104,81,185
21502,SAN BUENA VENTURA,estado nutricional en menores de 5 anos,clasificacion d,2002-03-01,44,76,44,76,120
70402,SAN CARLOS,estado nutricional en menores de 5 anos,clasificacion d,2002-03-01,0,7,0,7,7
80501,SAN IGNACIO,estado nutricional en menores de 5 anos,clasificacion d,2002-03-01,36,79,36,79,115
70301,SAN IGNACIO DE VELASCO,estado nutricional en menores de 5 anos,clasificacion d,2002-03-01,147,257,147,257,404
80102,SAN JAVIER(BNI),estado nutricional en menores de 5 anos,clasificacion d,2002-03-01,6,9,6,9,15
71102,SAN JAVIER(STC),estado nutricional en menores de 5 anos,clasificacion d,2002-03-01,2,46,2,46,48
80701,SAN JOAQUIN,estado nutricional en menores de 5 anos,clasificacion d,2002-03-01,3,15,3,15,18
70501,SAN JOSE DE CHIQUITOS,estado nutricional en menores de 5 anos,clasificacion d,2002-03-01,64,29,64,29,93
71104,SAN JULIAN,estado nutricional en menores de 5 anos,clasificacion d,2002-03-01,103,198,103,198,301
60501,SAN LORENZO(TJA),estado nutricional en menores de 5 anos,clasificacion d,2002-03-01,34,72,34,72,106
10702,SAN LUCAS,estado nutricional en menores de 5 anos,clasificacion d,2002-03-01,37,683,37,683,720
71201,SAN MATIAS,estado nutricional en menores de 5 anos,clasificacion d,2002-03-01,70,38,70,38,108
70302,SAN MIGUEL DE VELASCO,estado nutricional en menores de 5 anos,clasificacion d,2002-03-01,65,92,65,92,157
51001,SAN PABLO DE LIPEZ,estado nutricional en menores de 5 anos,clasificacion d,2002-03-01,7,75,7,75,82
50501,SAN PEDRO DE BUENA VISTA,estado nutricional en menores de 5 anos,clasificacion d,2002-03-01,0,258,0,258,258
21801,SAN PEDRO DE CURAHUARA,estado nutricional en menores de 5 anos,clasificacion d,2002-03-01,16,29,16,29,45
50902,SAN PEDRO DE QUEMES,estado nutricional en menores de 5 anos,clasificacion d,2002-03-01,0,3,0,3,3
21702,SAN PEDRO DE TIQUINA,estado nutricional en menores de 5 anos,clasificacion d,2002-03-01,3,9,3,9,12
90202,SAN PEDRO(PND),estado nutricional en menores de 5 anos,clasificacion d,2002-03-01,2,2,2,2,4
70303,SAN RAFAEL,estado nutricional en menores de 5 anos,clasificacion d,2002-03-01,38,47,38,47,85
80702,SAN RAMON,estado nutricional en menores de 5 anos,clasificacion d,2002-03-01,0,37,0,37,37
80702,SAN RAMON,estado nutricional en menores de 5 anos,clasificacion d,2002-03-01,2,34,2,34,36
80401,SANTA ANA,estado nutricional en menores de 5 anos,clasificacion d,2002-03-01,20,16,20,16,36
70101,SANTA CRUZ DE LA SIERRA,estado nutricional en menores de 5 anos,clasificacion d,2002-03-01,315,385,315,385,700
80303,SANTA ROSA,estado nutricional en menores de 5 anos,clasificacion d,2002-03-01,12,15,12,15,27
70602,SANTA ROSA DEL SARA,estado nutricional en menores de 5 anos,clasificacion d,2002-03-01,11,11,11,11,22
20308,SANTIAGO DE CALLAPA,estado nutricional en menores de 5 anos,clasificacion d,2002-03-01,0,2,0,2,2
41401,SANTIAGO DE HUARI,estado nutricional en menores de 5 anos,clasificacion d,2002-03-01,17,22,17,22,39
21901,SANTIAGO DE MACHACA,estado nutricional en menores de 5 anos,clasificacion d,2002-03-01,8,5,8,5,13
30702,SANTIVAÃ‘ES,estado nutricional en menores de 5 anos,clasificacion d,2002-03-01,36,40,36,40,76
40202,SANTUARIO DE QUILLACAS,estado nutricional en menores de 5 anos,clasificacion d,2002-03-01,6,18,6,18,24
20902,SAPAHAQUI,estado nutricional en menores de 5 anos,clasificacion d,2002-03-01,0,29,0,29,29
21301,SICA SICA (VILLA AROMA),estado nutricional en menores de 5 anos,clasificacion d,2002-03-01,31,15,31,15,46
30703,SICAYA,estado nutricional en menores de 5 anos,clasificacion d,2002-03-01,0,27,0,27,27
30902,SIPE SIPE,estado nutricional en menores de 5 anos,clasificacion d,2002-03-01,122,93,122,93,215
10403,SOPACHUY,estado nutricional en menores de 5 anos,clasificacion d,2002-03-01,60,74,60,74,134
20601,SORATA,estado nutricional en menores de 5 anos,clasificacion d,2002-03-01,10,46,10,46,56
10101,SUCRE,estado nutricional en menores de 5 anos,clasificacion d,2002-03-01,242,1154,242,1154,1396
31404,TACACHI,estado nutricional en menores de 5 anos,clasificacion d,2002-03-01,0,12,0,12,12
20603,TACACOMA,estado nutricional en menores de 5 anos,clasificacion d,2002-03-01,10,15,10,15,25
50303,TACOBAMBA,estado nutricional en menores de 5 anos,clasificacion d,2002-03-01,27,58,27,58,85
30602,TACOPAYA,estado nutricional en menores de 5 anos,clasificacion d,2002-03-01,0,82,0,82,82
51402,TAHUA,estado nutricional en menores de 5 anos,clasificacion d,2002-03-01,0,11,0,11,11
31101,TAPACARI,estado nutricional en menores de 5 anos,clasificacion d,2002-03-01,5,106,5,106,111
10601,TARABUCO,estado nutricional en menores de 5 anos,clasificacion d,2002-03-01,70,666,70,666,736
30401,TARATA,estado nutricional en menores de 5 anos,clasificacion d,2002-03-01,2,41,2,41,43
60101,TARIJA,estado nutricional en menores de 5 anos,clasificacion d,2002-03-01,74,199,74,199,273
10202,TARVITA,estado nutricional en menores de 5 anos,clasificacion d,2002-03-01,52,90,52,90,142
20803,TIAWANACU,estado nutricional en menores de 5 anos,clasificacion d,2002-03-01,15,15,15,15,30
50102,TINGUIPAYA,estado nutricional en menores de 5 anos,clasificacion d,2002-03-01,19,78,19,78,97
20606,TIPUANI,estado nutricional en menores de 5 anos,clasificacion d,2002-03-01,10,5,10,5,15
30903,TIQUIPAYA,estado nutricional en menores de 5 anos,clasificacion d,2002-03-01,0,33,0,33,33
31601,TIRAQUE (CBBA),estado nutricional en menores de 5 anos,clasificacion d,2002-03-01,44,117,44,117,161
21703,TITO YUPANQUI (PARQUIPUJIO),estado nutricional en menores de 5 anos,clasificacion d,2002-03-01,0,21,0,21,21
30802,TOCO,estado nutricional en menores de 5 anos,clasificacion d,2002-03-01,0,9,0,9,9
30803,TOLATA,estado nutricional en menores de 5 anos,clasificacion d,2002-03-01,0,2,0,2,2
41001,TOLEDO,estado nutricional en menores de 5 anos,clasificacion d,2002-03-01,8,2,8,2,10
51202,TOMAVE,estado nutricional en menores de 5 anos,clasificacion d,2002-03-01,3,179,3,179,182
10402,TOMINA,estado nutricional en menores de 5 anos,clasificacion d,2002-03-01,108,185,108,185,293
50502,TORO TORO,estado nutricional en menores de 5 anos,clasificacion d,2002-03-01,7,72,7,72,79
31201,TOTORA(CBBA),estado nutricional en menores de 5 anos,clasificacion d,2002-03-01,38,47,38,47,85
41301,TOTORA(ORR),estado nutricional en menores de 5 anos,clasificacion d,2002-03-01,1,31,1,31,32
70802,TRIGAL,estado nutricional en menores de 5 anos,clasificacion d,2002-03-01,4,4,4,4,8
80101,TRINIDAD,estado nutricional en menores de 5 anos,clasificacion d,2002-03-01,80,147,80,147,227
50801,TUPIZA,estado nutricional en menores de 5 anos,clasificacion d,2002-03-01,8,437,8,437,445
40402,TURCO,estado nutricional en menores de 5 anos,clasificacion d,2002-03-01,10,12,10,12,22
21302,UMALA,estado nutricional en menores de 5 anos,clasificacion d,2002-03-01,4,15,4,15,19
60401,URIONDO (A. CONCEPCION),estado nutricional en menores de 5 anos,clasificacion d,2002-03-01,12,40,12,40,52
71502,URUBICHA,estado nutricional en menores de 5 anos,clasificacion d,2002-03-01,0,19,0,19,19
51201,UYUNI,estado nutricional en menores de 5 anos,clasificacion d,2002-03-01,5,139,5,139,144
30502,VACAS,estado nutricional en menores de 5 anos,clasificacion d,2002-03-01,3,34,3,34,37
70801,VALLEGRANDE,estado nutricional en menores de 5 anos,clasificacion d,2002-03-01,34,108,34,108,142
20801,VIACHA,estado nutricional en menores de 5 anos,clasificacion d,2002-03-01,7,129,7,129,136
31302,VILA VILA,estado nutricional en menores de 5 anos,clasificacion d,2002-03-01,0,64,0,64,64
60303,VILLA MONTES,estado nutricional en menores de 5 anos,clasificacion d,2002-03-01,57,73,57,73,130
90502,VILLA NUEVA (LOMA ALTA),estado nutricional en menores de 5 anos,clasificacion d,2002-03-01,1,0,1,0,1
31402,VILLA RIVERO,estado nutricional en menores de 5 anos,clasificacion d,2002-03-01,2,16,2,16,18
10801,VILLA SERRANO,estado nutricional en menores de 5 anos,clasificacion d,2002-03-01,113,176,113,176,289
31003,VILLA TUNARI,estado nutricional en menores de 5 anos,clasificacion d,2002-03-01,60,141,60,141,201
11001,VILLA VACA GUZMAN (MUYUPAMPA),estado nutricional en menores de 5 anos,clasificacion d,2002-03-01,60,95,60,95,155
51501,VILLAZON,estado nutricional en menores de 5 anos,clasificacion d,2002-03-01,4,236,4,236,240
30904,VINTO,estado nutricional en menores de 5 anos,clasificacion d,2002-03-01,24,21,24,21,45
50602,VITICHI,estado nutricional en menores de 5 anos,clasificacion d,2002-03-01,18,114,18,114,132
20306,WALDO BALLIVIAN,estado nutricional en menores de 5 anos,clasificacion d,2002-03-01,1,3,1,3,4
70201,WARNES,estado nutricional en menores de 5 anos,clasificacion d,2002-03-01,95,115,95,115,210
20903,YACO,estado nutricional en menores de 5 anos,clasificacion d,2002-03-01,2,38,2,38,40
60301,YACUIBA,estado nutricional en menores de 5 anos,clasificacion d,2002-03-01,69,109,69,109,178
10602,YAMPARAEZ,estado nutricional en menores de 5 anos,clasificacion d,2002-03-01,147,298,147,298,445
21103,YANACACHI,estado nutricional en menores de 5 anos,clasificacion d,2002-03-01,8,3,8,3,11
70403,YAPACANI,estado nutricional en menores de 5 anos,clasificacion d,2002-03-01,80,100,80,100,180
50103,YOCALLA,estado nutricional en menores de 5 anos,clasificacion d,2002-03-01,0,84,0,84,84
10102,YOTALA,estado nutricional en menores de 5 anos,clasificacion d,2002-03-01,96,213,96,213,309
60402,YUNCHARA,estado nutricional en menores de 5 anos,clasificacion d,2002-03-01,7,37,7,37,44
10301,ZUDAÃ‘EZ,estado nutricional en menores de 5 anos,clasificacion d,2002-03-01,76,147,76,147,223
51302,ACACIO,estado nutricional en menores de 5 anos,clasificacion d,2002-04-01,22,112,22,112,134
20201,ACHACACHI,estado nutricional en menores de 5 anos,clasificacion d,2002-04-01,121,154,121,154,275
20104,ACHOCALLA,estado nutricional en menores de 5 anos,clasificacion d,2002-04-01,13,11,13,11,24
30201,AIQUILE,estado nutricional en menores de 5 anos,clasificacion d,2002-04-01,8,26,8,26,34
31303,ALALAY,estado nutricional en menores de 5 anos,clasificacion d,2002-04-01,7,15,7,15,22
10404,ALCALA,estado nutricional en menores de 5 anos,clasificacion d,2002-04-01,42,62,42,62,104
20202,ANCORAIMES,estado nutricional en menores de 5 anos,clasificacion d,2002-04-01,80,114,80,114,194
41201,ANDAMARCA,estado nutricional en menores de 5 anos,clasificacion d,2002-04-01,4,0,4,0,4
40603,ANTEQUERA,estado nutricional en menores de 5 anos,clasificacion d,2002-04-01,0,2,0,2,2
30402,ANZALDO,estado nutricional en menores de 5 anos,clasificacion d,2002-04-01,3,82,3,82,85
20701,APOLO,estado nutricional en menores de 5 anos,clasificacion d,2002-04-01,20,8,20,8,28
51301,ARAMPAMPA,estado nutricional en menores de 5 anos,clasificacion d,2002-04-01,19,94,19,94,113
30501,ARANI,estado nutricional en menores de 5 anos,clasificacion d,2002-04-01,7,33,7,33,40
30403,ARBIETO,estado nutricional en menores de 5 anos,clasificacion d,2002-04-01,7,29,7,29,36
30601,ARQUE,estado nutricional en menores de 5 anos,clasificacion d,2002-04-01,17,32,17,32,49
71501,ASCENCION DE GUARAYOS,estado nutricional en menores de 5 anos,clasificacion d,2002-04-01,167,243,167,243,410
50802,ATOCHA,estado nutricional en menores de 5 anos,clasificacion d,2002-04-01,1,71,1,71,72
20503,AUCAPATA,estado nutricional en menores de 5 anos,clasificacion d,2002-04-01,19,6,19,6,25
20502,AYATA,estado nutricional en menores de 5 anos,clasificacion d,2002-04-01,6,13,6,13,19
21303,AYO AYO,estado nutricional en menores de 5 anos,clasificacion d,2002-04-01,23,3,23,3,26
30301,AYOPAYA (V. DE INDEPENDENCIA),estado nutricional en menores de 5 anos,clasificacion d,2002-04-01,109,92,109,92,201
10201,AZURDUY,estado nutricional en menores de 5 anos,clasificacion d,2002-04-01,98,114,98,114,212
21203,BATALLAS,estado nutricional en menores de 5 anos,clasificacion d,2002-04-01,1,45,1,45,46
80802,BAURES,estado nutricional en menores de 5 anos,clasificacion d,2002-04-01,22,32,22,32,54
41202,BELEN DE ANDAMARCA,estado nutricional en menores de 5 anos,clasificacion d,2002-04-01,0,3,0,3,3
50104,BELEN DE URMIRI,estado nutricional en menores de 5 anos,clasificacion d,2002-04-01,7,27,7,27,34
90104,BELLA FLOR,estado nutricional en menores de 5 anos,clasificacion d,2002-04-01,10,11,10,11,21
60202,BERMEJO,estado nutricional en menores de 5 anos,clasificacion d,2002-04-01,4,7,4,7,11
50301,BETANZOS,estado nutricional en menores de 5 anos,clasificacion d,2002-04-01,78,325,78,325,403
31501,BOLIVAR,estado nutricional en menores de 5 anos,clasificacion d,2002-04-01,53,97,53,97,150
90103,BOLPEBRA,estado nutricional en menores de 5 anos,clasificacion d,2002-04-01,0,2,0,2,2
70707,BOYUIBE,estado nutricional en menores de 5 anos,clasificacion d,2002-04-01,2,31,2,31,33
70401,BUENA VISTA,estado nutricional en menores de 5 anos,clasificacion d,2002-04-01,51,39,51,39,90
70703,CABEZAS,estado nutricional en menores de 5 anos,clasificacion d,2002-04-01,1,50,1,50,51
20905,CAIROMA,estado nutricional en menores de 5 anos,clasificacion d,2002-04-01,0,22,0,22,22
51102,"CAIZA ""D""",estado nutricional en menores de 5 anos,clasificacion d,2002-04-01,27,60,27,60,87
21003,CAJUATA,estado nutricional en menores de 5 anos,clasificacion d,2002-04-01,15,9,15,9,24
20303,CALACOTO,estado nutricional en menores de 5 anos,clasificacion d,2002-04-01,8,26,8,26,34
21304,CALAMARCA,estado nutricional en menores de 5 anos,clasificacion d,2002-04-01,23,13,23,13,36
10701,CAMARGO,estado nutricional en menores de 5 anos,clasificacion d,2002-04-01,2,89,2,89,91
10901,CAMATAQUI (C. VILLA ABECIA),estado nutricional en menores de 5 anos,clasificacion d,2002-04-01,1,51,1,51,52
70706,CAMIRI,estado nutricional en menores de 5 anos,clasificacion d,2002-04-01,57,121,57,121,178
30701,CAPINOTA,estado nutricional en menores de 5 anos,clasificacion d,2002-04-01,22,20,22,20,42
20302,CAQUIAVIRI,estado nutricional en menores de 5 anos,clasificacion d,2002-04-01,32,43,32,43,75
40102,CARACOLLO,estado nutricional en menores de 5 anos,clasificacion d,2002-04-01,27,42,27,42,69
22001,CARANAVI,estado nutricional en menores de 5 anos,clasificacion d,2002-04-01,158,205,158,205,363
41503,CARANGAS,estado nutricional en menores de 5 anos,clasificacion d,2002-04-01,0,1,0,1,1
60302,CARAPARI,estado nutricional en menores de 5 anos,clasificacion d,2002-04-01,22,44,22,44,66
50702,CARIPUYO,estado nutricional en menores de 5 anos,clasificacion d,2002-04-01,8,83,8,83,91
21902,CATACORA,estado nutricional en menores de 5 anos,clasificacion d,2002-04-01,4,9,4,9,13
40201,CHALLAPATA,estado nutricional en menores de 5 anos,clasificacion d,2002-04-01,52,91,52,91,143
50302,CHAQUI,estado nutricional en menores de 5 anos,clasificacion d,2002-04-01,0,105,0,105,105
70702,CHARAGUA,estado nutricional en menores de 5 anos,clasificacion d,2002-04-01,6,247,6,247,253
20305,CHARAÃ‘A,estado nutricional en menores de 5 anos,clasificacion d,2002-04-01,0,19,0,19,19
31204,CHIMORE,estado nutricional en menores de 5 anos,clasificacion d,2002-04-01,27,10,27,10,37
40302,CHOQUE COTA,estado nutricional en menores de 5 anos,clasificacion d,2002-04-01,0,20,0,20,20
21101,CHULUMANI (V. DE LA LIBERTAD),estado nutricional en menores de 5 anos,clasificacion d,2002-04-01,3,27,3,27,30
20501,CHUMA,estado nutricional en menores de 5 anos,clasificacion d,2002-04-01,16,25,16,25,41
30801,CLIZA,estado nutricional en menores de 5 anos,clasificacion d,2002-04-01,4,20,4,20,24
90101,COBIJA,estado nutricional en menores de 5 anos,clasificacion d,2002-04-01,103,73,103,73,176
30101,COCHABAMBA,estado nutricional en menores de 5 anos,clasificacion d,2002-04-01,379,373,379,373,752
40902,COIPASA,estado nutricional en menores de 5 anos,clasificacion d,2002-04-01,0,1,0,1,1
30905,COLCAPIRHUA,estado nutricional en menores de 5 anos,clasificacion d,2002-04-01,38,52,38,52,90
50901,"COLCHA ""K""",estado nutricional en menores de 5 anos,clasificacion d,2002-04-01,1,68,1,68,69
21307,COLLANA,estado nutricional en menores de 5 anos,clasificacion d,2002-04-01,3,0,3,0,3
31002,COLOMI,estado nutricional en menores de 5 anos,clasificacion d,2002-04-01,36,57,36,57,93
50401,COLQUECHACA,estado nutricional en menores de 5 anos,clasificacion d,2002-04-01,72,117,72,117,189
21306,COLQUENCHA,estado nutricional en menores de 5 anos,clasificacion d,2002-04-01,20,7,20,7,27
21004,COLQUIRI,estado nutricional en menores de 5 anos,clasificacion d,2002-04-01,60,52,60,52,112
20304,COMANCHE,estado nutricional en menores de 5 anos,clasificacion d,2002-04-01,3,8,3,8,11
71301,COMARAPA,estado nutricional en menores de 5 anos,clasificacion d,2002-04-01,16,19,16,19,35
20605,COMBAYA,estado nutricional en menores de 5 anos,clasificacion d,2002-04-01,10,12,10,12,22
71101,CONCEPCION,estado nutricional en menores de 5 anos,clasificacion d,2002-04-01,2,10,2,10,12
21701,COPACABANA,estado nutricional en menores de 5 anos,clasificacion d,2002-04-01,4,34,4,34,38
21402,CORIPATA,estado nutricional en menores de 5 anos,clasificacion d,2002-04-01,6,17,6,17,23
20301,CORO CORO,estado nutricional en menores de 5 anos,clasificacion d,2002-04-01,27,46,27,46,73
21401,COROICO,estado nutricional en menores de 5 anos,clasificacion d,2002-04-01,8,8,8,8,16
40301,CORQUE,estado nutricional en menores de 5 anos,clasificacion d,2002-04-01,14,14,14,14,28
50601,COTAGAITA,estado nutricional en menores de 5 anos,clasificacion d,2002-04-01,11,199,11,199,210
70102,COTOCA,estado nutricional en menores de 5 anos,clasificacion d,2002-04-01,35,42,35,42,77
31405,CUCHUMUELA (V. G. VILLARROEL),estado nutricional en menores de 5 anos,clasificacion d,2002-04-01,0,23,0,23,23
70704,CUEVO,estado nutricional en menores de 5 anos,clasificacion d,2002-04-01,16,10,16,10,26
10902,CULPINA,estado nutricional en menores de 5 anos,clasificacion d,2002-04-01,101,108,101,108,209
40401,CURAHUARA DE CARANGAS,estado nutricional en menores de 5 anos,clasificacion d,2002-04-01,17,12,17,12,29
20804,DESAGUADERO,estado nutricional en menores de 5 anos,clasificacion d,2002-04-01,2,16,2,16,18
20105,EL ALTO,estado nutricional en menores de 5 anos,clasificacion d,2002-04-01,1344,1270,1344,1270,2614
40103,EL CHORO,estado nutricional en menores de 5 anos,clasificacion d,2002-04-01,1,0,1,0,1
71503,EL PUENTE(STC),estado nutricional en menores de 5 anos,clasificacion d,2002-04-01,18,143,18,143,161
60502,EL PUENTE(TJA),estado nutricional en menores de 5 anos,clasificacion d,2002-04-01,24,50,24,50,74
70105,EL TORNO,estado nutricional en menores de 5 anos,clasificacion d,2002-04-01,63,41,63,41,104
10405,EL VILLAR,estado nutricional en menores de 5 anos,clasificacion d,2002-04-01,50,113,50,113,163
60601,ENTRE RIOS,estado nutricional en menores de 5 anos,clasificacion d,2002-04-01,50,65,50,65,115
41101,EUCALIPTUS,estado nutricional en menores de 5 anos,clasificacion d,2002-04-01,1,26,1,26,27
80402,EXALTACION,estado nutricional en menores de 5 anos,clasificacion d,2002-04-01,11,20,11,20,31
90203,FILADELFIA,estado nutricional en menores de 5 anos,clasificacion d,2002-04-01,0,11,0,11,11
21601,GRAL. J.J. PEREZ (CHARAZANI),estado nutricional en menores de 5 anos,clasificacion d,2002-04-01,12,5,12,5,17
20602,GUANAY,estado nutricional en menores de 5 anos,clasificacion d,2002-04-01,11,121,11,121,132
20802,GUAQUI,estado nutricional en menores de 5 anos,clasificacion d,2002-04-01,0,6,0,6,6
80202,GUAYARAMERIN,estado nutricional en menores de 5 anos,clasificacion d,2002-04-01,109,83,109,83,192
70705,GUTIERREZ,estado nutricional en menores de 5 anos,clasificacion d,2002-04-01,9,154,9,154,163
10502,HUACARETA,estado nutricional en menores de 5 anos,clasificacion d,2002-04-01,81,104,81,104,185
11002,HUACAYA (VILLA DE HUACAYA),estado nutricional en menores de 5 anos,clasificacion d,2002-04-01,11,24,11,24,35
40501,HUACHACALLA,estado nutricional en menores de 5 anos,clasificacion d,2002-04-01,1,10,1,10,11
40701,HUANUNI,estado nutricional en menores de 5 anos,clasificacion d,2002-04-01,4,1,4,1,5
80803,HUARACAJE,estado nutricional en menores de 5 anos,clasificacion d,2002-04-01,6,4,6,4,10
41601,HUAYLLAMARCA,estado nutricional en menores de 5 anos,clasificacion d,2002-04-01,11,17,11,17,28
21005,ICHOCA,estado nutricional en menores de 5 anos,clasificacion d,2002-04-01,12,21,12,21,33
10304,ICLA,estado nutricional en menores de 5 anos,clasificacion d,2002-04-01,83,139,83,139,222
10703,INCAHUASI,estado nutricional en menores de 5 anos,clasificacion d,2002-04-01,17,181,17,181,198
21001,INQUISIVI,estado nutricional en menores de 5 anos,clasificacion d,2002-04-01,4,42,4,42,46
21102,IRUPANA (VILLA DE LANZA),estado nutricional en menores de 5 anos,clasificacion d,2002-04-01,9,23,9,23,32
21501,IXIAMAS,estado nutricional en menores de 5 anos,clasificacion d,2002-04-01,29,38,29,38,67
21105,LA ASUNTA,estado nutricional en menores de 5 anos,clasificacion d,2002-04-01,19,50,19,50,69
70104,LA GUARDIA,estado nutricional en menores de 5 anos,clasificacion d,2002-04-01,90,45,90,45,135
20101,LA PAZ,estado nutricional en menores de 5 anos,clasificacion d,2002-04-01,1000,955,1000,955,1955
70701,LAGUNILLAS,estado nutricional en menores de 5 anos,clasificacion d,2002-04-01,21,58,21,58,79
21202,LAJA,estado nutricional en menores de 5 anos,clasificacion d,2002-04-01,0,47,0,47,47
10903,LAS CARRERAS,estado nutricional en menores de 5 anos,clasificacion d,2002-04-01,14,41,14,41,55
21006,LICOMA PAMPA,estado nutricional en menores de 5 anos,clasificacion d,2002-04-01,0,5,0,5,5
51401,LLICA,estado nutricional en menores de 5 anos,clasificacion d,2002-04-01,0,11,0,11,11
80601,LORETO,estado nutricional en menores de 5 anos,clasificacion d,2002-04-01,3,7,3,7,10
20901,LURIBAY,estado nutricional en menores de 5 anos,clasificacion d,2002-04-01,8,17,8,17,25
40702,MACHACAMARCA,estado nutricional en menores de 5 anos,clasificacion d,2002-04-01,6,10,6,10,16
11003,MACHARETI,estado nutricional en menores de 5 anos,clasificacion d,2002-04-01,26,100,26,100,126
80801,MAGDALENA,estado nutricional en menores de 5 anos,clasificacion d,2002-04-01,12,17,12,17,29
70903,MAIRANA,estado nutricional en menores de 5 anos,clasificacion d,2002-04-01,15,16,15,16,31
20904,MALLA,estado nutricional en menores de 5 anos,clasificacion d,2002-04-01,0,10,0,10,10
20103,MECAPACA,estado nutricional en menores de 5 anos,clasificacion d,2002-04-01,5,24,5,24,29
71003,MINEROS,estado nutricional en menores de 5 anos,clasificacion d,2002-04-01,29,20,29,20,49
31301,MIZQUE,estado nutricional en menores de 5 anos,clasificacion d,2002-04-01,11,26,11,26,37
20402,MOCOMOCO,estado nutricional en menores de 5 anos,clasificacion d,2002-04-01,27,19,27,19,46
51002,MOJINETE,estado nutricional en menores de 5 anos,clasificacion d,2002-04-01,0,15,0,15,15
10303,MOJOCOYA,estado nutricional en menores de 5 anos,clasificacion d,2002-04-01,77,124,77,124,201
10501,MONTEAGUDO,estado nutricional en menores de 5 anos,clasificacion d,2002-04-01,120,194,120,194,314
71001,MONTERO,estado nutricional en menores de 5 anos,clasificacion d,2002-04-01,0,33,0,33,33
70803,MORO MORO,estado nutricional en menores de 5 anos,clasificacion d,2002-04-01,17,15,17,15,32
30302,MOROCHATA,estado nutricional en menores de 5 anos,clasificacion d,2002-04-01,23,52,23,52,75
90401,NACEBE (SANTA ROSA DEL ABUNA),estado nutricional en menores de 5 anos,clasificacion d,2002-04-01,0,11,0,11,11
20307,NAZACARA DE PACAJES,estado nutricional en menores de 5 anos,clasificacion d,2002-04-01,1,7,1,7,8
90501,NUEVO MANOA (NUEVA ESPERANZA),estado nutricional en menores de 5 anos,clasificacion d,2002-04-01,11,1,11,1,12
50404,OCURI,estado nutricional en menores de 5 anos,clasificacion d,2002-04-01,38,46,38,46,84
70202,OKINAWA,estado nutricional en menores de 5 anos,clasificacion d,2002-04-01,11,32,11,32,43
30203,OMEREQUE,estado nutricional en menores de 5 anos,clasificacion d,2002-04-01,0,26,0,26,26
40101,ORURO,estado nutricional en menores de 5 anos,clasificacion d,2002-04-01,389,420,389,420,809
60201,PADCAYA,estado nutricional en menores de 5 anos,clasificacion d,2002-04-01,56,77,56,77,133
10401,PADILLA,estado nutricional en menores de 5 anos,clasificacion d,2002-04-01,152,245,152,245,397
70502,PAILON,estado nutricional en menores de 5 anos,clasificacion d,2002-04-01,0,56,0,56,56
20102,PALCA,estado nutricional en menores de 5 anos,clasificacion d,2002-04-01,33,41,33,41,74
21104,PALOS BLANCOS,estado nutricional en menores de 5 anos,clasificacion d,2002-04-01,66,165,66,165,231
40802,PAMPA AULLAGAS,estado nutricional en menores de 5 anos,clasificacion d,2002-04-01,0,37,0,37,37
70902,PAMPA GRANDE,estado nutricional en menores de 5 anos,clasificacion d,2002-04-01,26,15,26,15,41
21802,PAPEL PAMPA,estado nutricional en menores de 5 anos,clasificacion d,2002-04-01,10,6,10,6,16
30202,PASORAPA,estado nutricional en menores de 5 anos,clasificacion d,2002-04-01,6,38,6,38,44
21305,PATACAMAYA,estado nutricional en menores de 5 anos,clasificacion d,2002-04-01,30,7,30,7,37
40602,PAZÃ‘A,estado nutricional en menores de 5 anos,clasificacion d,2002-04-01,0,13,0,13,13
20702,PELECHUCO,estado nutricional en menores de 5 anos,clasificacion d,2002-04-01,14,14,14,14,28
50403,POCOATA,estado nutricional en menores de 5 anos,clasificacion d,2002-04-01,88,158,88,158,246
31203,POCONA,estado nutricional en menores de 5 anos,clasificacion d,2002-04-01,42,67,42,67,109
31202,POJO (CBBA),estado nutricional en menores de 5 anos,clasificacion d,2002-04-01,115,110,115,110,225
40601,POOPO,estado nutricional en menores de 5 anos,clasificacion d,2002-04-01,3,19,3,19,22
51203,PORCO,estado nutricional en menores de 5 anos,clasificacion d,2002-04-01,23,50,23,50,73
10103,POROMA,estado nutricional en menores de 5 anos,clasificacion d,2002-04-01,78,92,78,92,170
70103,PORONGO,estado nutricional en menores de 5 anos,clasificacion d,2002-04-01,14,17,14,17,31
70601,PORTACHUELO,estado nutricional en menores de 5 anos,clasificacion d,2002-04-01,58,63,58,63,121
50101,POTOSI,estado nutricional en menores de 5 anos,clasificacion d,2002-04-01,500,410,500,410,910
10302,PRESTO,estado nutricional en menores de 5 anos,clasificacion d,2002-04-01,74,71,74,71,145
70805,PUCARA,estado nutricional en menores de 5 anos,clasificacion d,2002-04-01,2,7,2,7,9
21201,PUCARANI,estado nutricional en menores de 5 anos,clasificacion d,2002-04-01,4,51,4,51,55
20401,PUERTO ACOSTA,estado nutricional en menores de 5 anos,clasificacion d,2002-04-01,75,123,75,123,198
20403,PUERTO CARABUCO,estado nutricional en menores de 5 anos,clasificacion d,2002-04-01,62,57,62,57,119
90301,PUERTO GONZALO MORENO,estado nutricional en menores de 5 anos,clasificacion d,2002-04-01,9,17,9,17,26
21204,PUERTO PEREZ,estado nutricional en menores de 5 anos,clasificacion d,2002-04-01,0,10,0,10,10
71402,PUERTO QUIJARRO,estado nutricional en menores de 5 anos,clasificacion d,2002-04-01,33,19,33,19,52
90201,PUERTO RICO,estado nutricional en menores de 5 anos,clasificacion d,2002-04-01,4,16,4,16,20
80703,PUERTO SILES,estado nutricional en menores de 5 anos,clasificacion d,2002-04-01,0,5,0,5,5
71401,PUERTO SUAREZ,estado nutricional en menores de 5 anos,clasificacion d,2002-04-01,38,11,38,11,49
31205,PUERTO VILLARROEL,estado nutricional en menores de 5 anos,clasificacion d,2002-04-01,103,92,103,92,195
51101,PUNA,estado nutricional en menores de 5 anos,clasificacion d,2002-04-01,48,253,48,253,301
31401,PUNATA,estado nutricional en menores de 5 anos,clasificacion d,2002-04-01,32,133,32,133,165
20604,QUIABAYA,estado nutricional en menores de 5 anos,clasificacion d,2002-04-01,11,24,11,24,35
30901,QUILLACOLLO,estado nutricional en menores de 5 anos,clasificacion d,2002-04-01,33,21,33,21,54
21002,QUIME,estado nutricional en menores de 5 anos,clasificacion d,2002-04-01,18,33,18,33,51
50402,RAVELO,estado nutricional en menores de 5 anos,clasificacion d,2002-04-01,71,128,71,128,199
80301,REYES,estado nutricional en menores de 5 anos,clasificacion d,2002-04-01,31,41,31,41,72
80201,RIBERALTA,estado nutricional en menores de 5 anos,clasificacion d,2002-04-01,381,316,381,316,697
70503,ROBORE,estado nutricional en menores de 5 anos,clasificacion d,2002-04-01,0,69,0,69,69
80304,RURRENABAQUE,estado nutricional en menores de 5 anos,clasificacion d,2002-04-01,21,28,21,28,49
40901,SABAYA,estado nutricional en menores de 5 anos,clasificacion d,2002-04-01,0,3,0,3,3
31001,SACABA,estado nutricional en menores de 5 anos,clasificacion d,2002-04-01,49,24,49,24,73
30404,SACABAMBA,estado nutricional en menores de 5 anos,clasificacion d,2002-04-01,1,25,1,25,26
50701,SACACA,estado nutricional en menores de 5 anos,clasificacion d,2002-04-01,79,196,79,196,275
71302,SAIPINA,estado nutricional en menores de 5 anos,clasificacion d,2002-04-01,27,19,27,19,46
40801,SALINAS DE GARCI MENDOZA,estado nutricional en menores de 5 anos,clasificacion d,2002-04-01,19,21,19,21,40
70901,SAMAIPATA,estado nutricional en menores de 5 anos,clasificacion d,2002-04-01,8,14,8,14,22
51601,SAN AGUSTIN,estado nutricional en menores de 5 anos,clasificacion d,2002-04-01,0,17,0,17,17
80602,SAN ANDRES,estado nutricional en menores de 5 anos,clasificacion d,2002-04-01,20,55,20,55,75
51003,SAN ANTONIO DE ESMORUCO,estado nutricional en menores de 5 anos,clasificacion d,2002-04-01,0,13,0,13,13
71105,SAN ANTONIO DE LOMERIO,estado nutricional en menores de 5 anos,clasificacion d,2002-04-01,74,137,74,137,211
31403,SAN BENITO,estado nutricional en menores de 5 anos,clasificacion d,2002-04-01,0,41,0,41,41
80302,SAN BORJA,estado nutricional en menores de 5 anos,clasificacion d,2002-04-01,117,112,117,112,229
21502,SAN BUENA VENTURA,estado nutricional en menores de 5 anos,clasificacion d,2002-04-01,51,90,51,90,141
70402,SAN CARLOS,estado nutricional en menores de 5 anos,clasificacion d,2002-04-01,2,27,2,27,29
80501,SAN IGNACIO,estado nutricional en menores de 5 anos,clasificacion d,2002-04-01,28,146,28,146,174
70301,SAN IGNACIO DE VELASCO,estado nutricional en menores de 5 anos,clasificacion d,2002-04-01,224,175,224,175,399
80102,SAN JAVIER(BNI),estado nutricional en menores de 5 anos,clasificacion d,2002-04-01,6,32,6,32,38
71102,SAN JAVIER(STC),estado nutricional en menores de 5 anos,clasificacion d,2002-04-01,14,7,14,7,21
80701,SAN JOAQUIN,estado nutricional en menores de 5 anos,clasificacion d,2002-04-01,3,22,3,22,25
70501,SAN JOSE DE CHIQUITOS,estado nutricional en menores de 5 anos,clasificacion d,2002-04-01,58,44,58,44,102
71104,SAN JULIAN,estado nutricional en menores de 5 anos,clasificacion d,2002-04-01,103,282,103,282,385
60501,SAN LORENZO(TJA),estado nutricional en menores de 5 anos,clasificacion d,2002-04-01,19,23,19,23,42
10702,SAN LUCAS,estado nutricional en menores de 5 anos,clasificacion d,2002-04-01,306,424,306,424,730
71201,SAN MATIAS,estado nutricional en menores de 5 anos,clasificacion d,2002-04-01,55,33,55,33,88
70302,SAN MIGUEL DE VELASCO,estado nutricional en menores de 5 anos,clasificacion d,2002-04-01,87,78,87,78,165
51001,SAN PABLO DE LIPEZ,estado nutricional en menores de 5 anos,clasificacion d,2002-04-01,1,16,1,16,17
50501,SAN PEDRO DE BUENA VISTA,estado nutricional en menores de 5 anos,clasificacion d,2002-04-01,7,137,7,137,144
21801,SAN PEDRO DE CURAHUARA,estado nutricional en menores de 5 anos,clasificacion d,2002-04-01,2,15,2,15,17
50902,SAN PEDRO DE QUEMES,estado nutricional en menores de 5 anos,clasificacion d,2002-04-01,0,4,0,4,4
21702,SAN PEDRO DE TIQUINA,estado nutricional en menores de 5 anos,clasificacion d,2002-04-01,0,7,0,7,7
90202,SAN PEDRO(PND),estado nutricional en menores de 5 anos,clasificacion d,2002-04-01,1,0,1,0,1
70303,SAN RAFAEL,estado nutricional en menores de 5 anos,clasificacion d,2002-04-01,37,23,37,23,60
80702,SAN RAMON,estado nutricional en menores de 5 anos,clasificacion d,2002-04-01,2,2,2,2,4
80702,SAN RAMON,estado nutricional en menores de 5 anos,clasificacion d,2002-04-01,10,32,10,32,42
80401,SANTA ANA,estado nutricional en menores de 5 anos,clasificacion d,2002-04-01,42,18,42,18,60
70101,SANTA CRUZ DE LA SIERRA,estado nutricional en menores de 5 anos,clasificacion d,2002-04-01,286,427,286,427,713
80303,SANTA ROSA,estado nutricional en menores de 5 anos,clasificacion d,2002-04-01,23,4,23,4,27
70602,SANTA ROSA DEL SARA,estado nutricional en menores de 5 anos,clasificacion d,2002-04-01,15,14,15,14,29
20308,SANTIAGO DE CALLAPA,estado nutricional en menores de 5 anos,clasificacion d,2002-04-01,8,39,8,39,47
41401,SANTIAGO DE HUARI,estado nutricional en menores de 5 anos,clasificacion d,2002-04-01,15,18,15,18,33
21901,SANTIAGO DE MACHACA,estado nutricional en menores de 5 anos,clasificacion d,2002-04-01,14,20,14,20,34
30702,SANTIVAÃ‘ES,estado nutricional en menores de 5 anos,clasificacion d,2002-04-01,23,15,23,15,38
40202,SANTUARIO DE QUILLACAS,estado nutricional en menores de 5 anos,clasificacion d,2002-04-01,3,26,3,26,29
20902,SAPAHAQUI,estado nutricional en menores de 5 anos,clasificacion d,2002-04-01,0,6,0,6,6
21301,SICA SICA (VILLA AROMA),estado nutricional en menores de 5 anos,clasificacion d,2002-04-01,28,18,28,18,46
30703,SICAYA,estado nutricional en menores de 5 anos,clasificacion d,2002-04-01,1,27,1,27,28
30902,SIPE SIPE,estado nutricional en menores de 5 anos,clasificacion d,2002-04-01,132,122,132,122,254
10403,SOPACHUY,estado nutricional en menores de 5 anos,clasificacion d,2002-04-01,44,72,44,72,116
20601,SORATA,estado nutricional en menores de 5 anos,clasificacion d,2002-04-01,11,30,11,30,41
10101,SUCRE,estado nutricional en menores de 5 anos,clasificacion d,2002-04-01,778,757,778,757,1535
31404,TACACHI,estado nutricional en menores de 5 anos,clasificacion d,2002-04-01,1,15,1,15,16
20603,TACACOMA,estado nutricional en menores de 5 anos,clasificacion d,2002-04-01,1,25,1,25,26
50303,TACOBAMBA,estado nutricional en menores de 5 anos,clasificacion d,2002-04-01,48,57,48,57,105
30602,TACOPAYA,estado nutricional en menores de 5 anos,clasificacion d,2002-04-01,26,67,26,67,93
51402,TAHUA,estado nutricional en menores de 5 anos,clasificacion d,2002-04-01,0,9,0,9,9
31101,TAPACARI,estado nutricional en menores de 5 anos,clasificacion d,2002-04-01,7,100,7,100,107
10601,TARABUCO,estado nutricional en menores de 5 anos,clasificacion d,2002-04-01,151,584,151,584,735
30401,TARATA,estado nutricional en menores de 5 anos,clasificacion d,2002-04-01,2,54,2,54,56
60101,TARIJA,estado nutricional en menores de 5 anos,clasificacion d,2002-04-01,134,285,134,285,419
10202,TARVITA,estado nutricional en menores de 5 anos,clasificacion d,2002-04-01,80,130,80,130,210
20803,TIAWANACU,estado nutricional en menores de 5 anos,clasificacion d,2002-04-01,24,12,24,12,36
50102,TINGUIPAYA,estado nutricional en menores de 5 anos,clasificacion d,2002-04-01,1,105,1,105,106
20606,TIPUANI,estado nutricional en menores de 5 anos,clasificacion d,2002-04-01,15,10,15,10,25
30903,TIQUIPAYA,estado nutricional en menores de 5 anos,clasificacion d,2002-04-01,0,25,0,25,25
31601,TIRAQUE (CBBA),estado nutricional en menores de 5 anos,clasificacion d,2002-04-01,70,149,70,149,219
21703,TITO YUPANQUI (PARQUIPUJIO),estado nutricional en menores de 5 anos,clasificacion d,2002-04-01,0,18,0,18,18
30802,TOCO,estado nutricional en menores de 5 anos,clasificacion d,2002-04-01,1,6,1,6,7
41001,TOLEDO,estado nutricional en menores de 5 anos,clasificacion d,2002-04-01,8,8,8,8,16
51202,TOMAVE,estado nutricional en menores de 5 anos,clasificacion d,2002-04-01,2,132,2,132,134
10402,TOMINA,estado nutricional en menores de 5 anos,clasificacion d,2002-04-01,106,178,106,178,284
50502,TORO TORO,estado nutricional en menores de 5 anos,clasificacion d,2002-04-01,5,28,5,28,33
31201,TOTORA(CBBA),estado nutricional en menores de 5 anos,clasificacion d,2002-04-01,66,61,66,61,127
41301,TOTORA(ORR),estado nutricional en menores de 5 anos,clasificacion d,2002-04-01,0,26,0,26,26
70802,TRIGAL,estado nutricional en menores de 5 anos,clasificacion d,2002-04-01,6,5,6,5,11
80101,TRINIDAD,estado nutricional en menores de 5 anos,clasificacion d,2002-04-01,140,177,140,177,317
50801,TUPIZA,estado nutricional en menores de 5 anos,clasificacion d,2002-04-01,7,327,7,327,334
40402,TURCO,estado nutricional en menores de 5 anos,clasificacion d,2002-04-01,5,11,5,11,16
21302,UMALA,estado nutricional en menores de 5 anos,clasificacion d,2002-04-01,6,2,6,2,8
60401,URIONDO (A. CONCEPCION),estado nutricional en menores de 5 anos,clasificacion d,2002-04-01,19,40,19,40,59
71502,URUBICHA,estado nutricional en menores de 5 anos,clasificacion d,2002-04-01,79,198,79,198,277
51201,UYUNI,estado nutricional en menores de 5 anos,clasificacion d,2002-04-01,6,190,6,190,196
30502,VACAS,estado nutricional en menores de 5 anos,clasificacion d,2002-04-01,4,33,4,33,37
70801,VALLEGRANDE,estado nutricional en menores de 5 anos,clasificacion d,2002-04-01,40,56,40,56,96
20801,VIACHA,estado nutricional en menores de 5 anos,clasificacion d,2002-04-01,12,134,12,134,146
31302,VILA VILA,estado nutricional en menores de 5 anos,clasificacion d,2002-04-01,6,35,6,35,41
60303,VILLA MONTES,estado nutricional en menores de 5 anos,clasificacion d,2002-04-01,43,78,43,78,121
90502,VILLA NUEVA (LOMA ALTA),estado nutricional en menores de 5 anos,clasificacion d,2002-04-01,2,0,2,0,2
31402,VILLA RIVERO,estado nutricional en menores de 5 anos,clasificacion d,2002-04-01,2,72,2,72,74
10801,VILLA SERRANO,estado nutricional en menores de 5 anos,clasificacion d,2002-04-01,64,224,64,224,288
31003,VILLA TUNARI,estado nutricional en menores de 5 anos,clasificacion d,2002-04-01,104,78,104,78,182
11001,VILLA VACA GUZMAN (MUYUPAMPA),estado nutricional en menores de 5 anos,clasificacion d,2002-04-01,56,98,56,98,154
51501,VILLAZON,estado nutricional en menores de 5 anos,clasificacion d,2002-04-01,8,260,8,260,268
30904,VINTO,estado nutricional en menores de 5 anos,clasificacion d,2002-04-01,66,35,66,35,101
50602,VITICHI,estado nutricional en menores de 5 anos,clasificacion d,2002-04-01,49,174,49,174,223
20306,WALDO BALLIVIAN,estado nutricional en menores de 5 anos,clasificacion d,2002-04-01,7,1,7,1,8
70201,WARNES,estado nutricional en menores de 5 anos,clasificacion d,2002-04-01,88,122,88,122,210
20903,YACO,estado nutricional en menores de 5 anos,clasificacion d,2002-04-01,0,14,0,14,14
60301,YACUIBA,estado nutricional en menores de 5 anos,clasificacion d,2002-04-01,76,96,76,96,172
10602,YAMPARAEZ,estado nutricional en menores de 5 anos,clasificacion d,2002-04-01,141,283,141,283,424
21103,YANACACHI,estado nutricional en menores de 5 anos,clasificacion d,2002-04-01,6,7,6,7,13
70403,YAPACANI,estado nutricional en menores de 5 anos,clasificacion d,2002-04-01,69,144,69,144,213
50103,YOCALLA,estado nutricional en menores de 5 anos,clasificacion d,2002-04-01,2,59,2,59,61
10102,YOTALA,estado nutricional en menores de 5 anos,clasificacion d,2002-04-01,100,218,100,218,318
60402,YUNCHARA,estado nutricional en menores de 5 anos,clasificacion d,2002-04-01,3,36,3,36,39
10301,ZUDAÃ‘EZ,estado nutricional en menores de 5 anos,clasificacion d,2002-04-01,70,129,70,129,199
51302,ACACIO,estado nutricional en menores de 5 anos,clasificacion d,2002-05-01,23,93,23,93,116
20201,ACHACACHI,estado nutricional en menores de 5 anos,clasificacion d,2002-05-01,99,105,99,105,204
20104,ACHOCALLA,estado nutricional en menores de 5 anos,clasificacion d,2002-05-01,13,12,13,12,25
30201,AIQUILE,estado nutricional en menores de 5 anos,clasificacion d,2002-05-01,31,42,31,42,73
31303,ALALAY,estado nutricional en menores de 5 anos,clasificacion d,2002-05-01,13,17,13,17,30
10404,ALCALA,estado nutricional en menores de 5 anos,clasificacion d,2002-05-01,35,71,35,71,106
20202,ANCORAIMES,estado nutricional en menores de 5 anos,clasificacion d,2002-05-01,86,139,86,139,225
41201,ANDAMARCA,estado nutricional en menores de 5 anos,clasificacion d,2002-05-01,5,3,5,3,8
40603,ANTEQUERA,estado nutricional en menores de 5 anos,clasificacion d,2002-05-01,1,2,1,2,3
30402,ANZALDO,estado nutricional en menores de 5 anos,clasificacion d,2002-05-01,2,60,2,60,62
20701,APOLO,estado nutricional en menores de 5 anos,clasificacion d,2002-05-01,36,20,36,20,56
51301,ARAMPAMPA,estado nutricional en menores de 5 anos,clasificacion d,2002-05-01,50,53,50,53,103
30501,ARANI,estado nutricional en menores de 5 anos,clasificacion d,2002-05-01,11,27,11,27,38
30403,ARBIETO,estado nutricional en menores de 5 anos,clasificacion d,2002-05-01,0,31,0,31,31
30601,ARQUE,estado nutricional en menores de 5 anos,clasificacion d,2002-05-01,51,51,51,51,102
71501,ASCENCION DE GUARAYOS,estado nutricional en menores de 5 anos,clasificacion d,2002-05-01,0,1,0,1,1
50802,ATOCHA,estado nutricional en menores de 5 anos,clasificacion d,2002-05-01,3,128,3,128,131
20502,AYATA,estado nutricional en menores de 5 anos,clasificacion d,2002-05-01,1,29,1,29,30
21303,AYO AYO,estado nutricional en menores de 5 anos,clasificacion d,2002-05-01,33,9,33,9,42
30301,AYOPAYA (V. DE INDEPENDENCIA),estado nutricional en menores de 5 anos,clasificacion d,2002-05-01,92,88,92,88,180
10201,AZURDUY,estado nutricional en menores de 5 anos,clasificacion d,2002-05-01,133,117,133,117,250
21203,BATALLAS,estado nutricional en menores de 5 anos,clasificacion d,2002-05-01,7,54,7,54,61
80802,BAURES,estado nutricional en menores de 5 anos,clasificacion d,2002-05-01,8,18,8,18,26
41202,BELEN DE ANDAMARCA,estado nutricional en menores de 5 anos,clasificacion d,2002-05-01,0,2,0,2,2
50104,BELEN DE URMIRI,estado nutricional en menores de 5 anos,clasificacion d,2002-05-01,1,32,1,32,33
90104,BELLA FLOR,estado nutricional en menores de 5 anos,clasificacion d,2002-05-01,8,8,8,8,16
60202,BERMEJO,estado nutricional en menores de 5 anos,clasificacion d,2002-05-01,2,14,2,14,16
50301,BETANZOS,estado nutricional en menores de 5 anos,clasificacion d,2002-05-01,200,421,200,421,621
31501,BOLIVAR,estado nutricional en menores de 5 anos,clasificacion d,2002-05-01,11,80,11,80,91
90103,BOLPEBRA,estado nutricional en menores de 5 anos,clasificacion d,2002-05-01,0,2,0,2,2
70707,BOYUIBE,estado nutricional en menores de 5 anos,clasificacion d,2002-05-01,1,32,1,32,33
70401,BUENA VISTA,estado nutricional en menores de 5 anos,clasificacion d,2002-05-01,44,59,44,59,103
70703,CABEZAS,estado nutricional en menores de 5 anos,clasificacion d,2002-05-01,0,9,0,9,9
20905,CAIROMA,estado nutricional en menores de 5 anos,clasificacion d,2002-05-01,1,8,1,8,9
51102,"CAIZA ""D""",estado nutricional en menores de 5 anos,clasificacion d,2002-05-01,34,144,34,144,178
21003,CAJUATA,estado nutricional en menores de 5 anos,clasificacion d,2002-05-01,17,18,17,18,35
20303,CALACOTO,estado nutricional en menores de 5 anos,clasificacion d,2002-05-01,5,5,5,5,10
21304,CALAMARCA,estado nutricional en menores de 5 anos,clasificacion d,2002-05-01,35,39,35,39,74
10701,CAMARGO,estado nutricional en menores de 5 anos,clasificacion d,2002-05-01,56,114,56,114,170
10901,CAMATAQUI (C. VILLA ABECIA),estado nutricional en menores de 5 anos,clasificacion d,2002-05-01,18,38,18,38,56
70706,CAMIRI,estado nutricional en menores de 5 anos,clasificacion d,2002-05-01,19,81,19,81,100
30701,CAPINOTA,estado nutricional en menores de 5 anos,clasificacion d,2002-05-01,10,29,10,29,39
20302,CAQUIAVIRI,estado nutricional en menores de 5 anos,clasificacion d,2002-05-01,29,23,29,23,52
40102,CARACOLLO,estado nutricional en menores de 5 anos,clasificacion d,2002-05-01,27,96,27,96,123
22001,CARANAVI,estado nutricional en menores de 5 anos,clasificacion d,2002-05-01,86,126,86,126,212
41503,CARANGAS,estado nutricional en menores de 5 anos,clasificacion d,2002-05-01,0,2,0,2,2
60302,CARAPARI,estado nutricional en menores de 5 anos,clasificacion d,2002-05-01,19,43,19,43,62
50702,CARIPUYO,estado nutricional en menores de 5 anos,clasificacion d,2002-05-01,24,208,24,208,232
21803,CHACARILLA,estado nutricional en menores de 5 anos,clasificacion d,2002-05-01,1,1,1,1,2
40201,CHALLAPATA,estado nutricional en menores de 5 anos,clasificacion d,2002-05-01,63,93,63,93,156
50302,CHAQUI,estado nutricional en menores de 5 anos,clasificacion d,2002-05-01,66,112,66,112,178
70702,CHARAGUA,estado nutricional en menores de 5 anos,clasificacion d,2002-05-01,14,220,14,220,234
20305,CHARAÃ‘A,estado nutricional en menores de 5 anos,clasificacion d,2002-05-01,0,11,0,11,11
31204,CHIMORE,estado nutricional en menores de 5 anos,clasificacion d,2002-05-01,23,28,23,28,51
40903,CHIPAYA,estado nutricional en menores de 5 anos,clasificacion d,2002-05-01,0,8,0,8,8
40302,CHOQUE COTA,estado nutricional en menores de 5 anos,clasificacion d,2002-05-01,1,16,1,16,17
21101,CHULUMANI (V. DE LA LIBERTAD),estado nutricional en menores de 5 anos,clasificacion d,2002-05-01,2,23,2,23,25
20501,CHUMA,estado nutricional en menores de 5 anos,clasificacion d,2002-05-01,8,12,8,12,20
30801,CLIZA,estado nutricional en menores de 5 anos,clasificacion d,2002-05-01,2,32,2,32,34
90101,COBIJA,estado nutricional en menores de 5 anos,clasificacion d,2002-05-01,77,66,77,66,143
30101,COCHABAMBA,estado nutricional en menores de 5 anos,clasificacion d,2002-05-01,422,402,422,402,824
40902,COIPASA,estado nutricional en menores de 5 anos,clasificacion d,2002-05-01,0,1,0,1,1
30905,COLCAPIRHUA,estado nutricional en menores de 5 anos,clasificacion d,2002-05-01,74,62,74,62,136
50901,"COLCHA ""K""",estado nutricional en menores de 5 anos,clasificacion d,2002-05-01,2,141,2,141,143
21307,COLLANA,estado nutricional en menores de 5 anos,clasificacion d,2002-05-01,5,0,5,0,5
31002,COLOMI,estado nutricional en menores de 5 anos,clasificacion d,2002-05-01,32,46,32,46,78
50401,COLQUECHACA,estado nutricional en menores de 5 anos,clasificacion d,2002-05-01,107,131,107,131,238
21306,COLQUENCHA,estado nutricional en menores de 5 anos,clasificacion d,2002-05-01,32,25,32,25,57
21004,COLQUIRI,estado nutricional en menores de 5 anos,clasificacion d,2002-05-01,26,25,26,25,51
20304,COMANCHE,estado nutricional en menores de 5 anos,clasificacion d,2002-05-01,1,12,1,12,13
71301,COMARAPA,estado nutricional en menores de 5 anos,clasificacion d,2002-05-01,17,55,17,55,72
20605,COMBAYA,estado nutricional en menores de 5 anos,clasificacion d,2002-05-01,11,30,11,30,41
71101,CONCEPCION,estado nutricional en menores de 5 anos,clasificacion d,2002-05-01,2,4,2,4,6
21701,COPACABANA,estado nutricional en menores de 5 anos,clasificacion d,2002-05-01,3,56,3,56,59
21402,CORIPATA,estado nutricional en menores de 5 anos,clasificacion d,2002-05-01,4,17,4,17,21
20301,CORO CORO,estado nutricional en menores de 5 anos,clasificacion d,2002-05-01,30,22,30,22,52
21401,COROICO,estado nutricional en menores de 5 anos,clasificacion d,2002-05-01,32,12,32,12,44
40301,CORQUE,estado nutricional en menores de 5 anos,clasificacion d,2002-05-01,23,16,23,16,39
50601,COTAGAITA,estado nutricional en menores de 5 anos,clasificacion d,2002-05-01,22,198,22,198,220
70102,COTOCA,estado nutricional en menores de 5 anos,clasificacion d,2002-05-01,28,27,28,27,55
31405,CUCHUMUELA (V. G. VILLARROEL),estado nutricional en menores de 5 anos,clasificacion d,2002-05-01,0,40,0,40,40
70704,CUEVO,estado nutricional en menores de 5 anos,clasificacion d,2002-05-01,25,28,25,28,53
10902,CULPINA,estado nutricional en menores de 5 anos,clasificacion d,2002-05-01,184,193,184,193,377
40401,CURAHUARA DE CARANGAS,estado nutricional en menores de 5 anos,clasificacion d,2002-05-01,22,8,22,8,30
21602,CURVA,estado nutricional en menores de 5 anos,clasificacion d,2002-05-01,15,8,15,8,23
20804,DESAGUADERO,estado nutricional en menores de 5 anos,clasificacion d,2002-05-01,1,37,1,37,38
20105,EL ALTO,estado nutricional en menores de 5 anos,clasificacion d,2002-05-01,1728,1503,1728,1503,3231
40103,EL CHORO,estado nutricional en menores de 5 anos,clasificacion d,2002-05-01,5,7,5,7,12
71503,EL PUENTE(STC),estado nutricional en menores de 5 anos,clasificacion d,2002-05-01,2,71,2,71,73
60502,EL PUENTE(TJA),estado nutricional en menores de 5 anos,clasificacion d,2002-05-01,31,104,31,104,135
70105,EL TORNO,estado nutricional en menores de 5 anos,clasificacion d,2002-05-01,82,100,82,100,182
10405,EL VILLAR,estado nutricional en menores de 5 anos,clasificacion d,2002-05-01,54,133,54,133,187
60601,ENTRE RIOS,estado nutricional en menores de 5 anos,clasificacion d,2002-05-01,38,86,38,86,124
41101,EUCALIPTUS,estado nutricional en menores de 5 anos,clasificacion d,2002-05-01,0,3,0,3,3
80402,EXALTACION,estado nutricional en menores de 5 anos,clasificacion d,2002-05-01,32,62,32,62,94
90203,FILADELFIA,estado nutricional en menores de 5 anos,clasificacion d,2002-05-01,0,5,0,5,5
71002,GENERAL SAAVEDRA,estado nutricional en menores de 5 anos,clasificacion d,2002-05-01,88,93,88,93,181
21601,GRAL. J.J. PEREZ (CHARAZANI),estado nutricional en menores de 5 anos,clasificacion d,2002-05-01,1,3,1,3,4
20602,GUANAY,estado nutricional en menores de 5 anos,clasificacion d,2002-05-01,51,122,51,122,173
20802,GUAQUI,estado nutricional en menores de 5 anos,clasificacion d,2002-05-01,10,20,10,20,30
80202,GUAYARAMERIN,estado nutricional en menores de 5 anos,clasificacion d,2002-05-01,84,82,84,82,166
70705,GUTIERREZ,estado nutricional en menores de 5 anos,clasificacion d,2002-05-01,32,144,32,144,176
10502,HUACARETA,estado nutricional en menores de 5 anos,clasificacion d,2002-05-01,90,111,90,111,201
11002,HUACAYA (VILLA DE HUACAYA),estado nutricional en menores de 5 anos,clasificacion d,2002-05-01,13,20,13,20,33
40501,HUACHACALLA,estado nutricional en menores de 5 anos,clasificacion d,2002-05-01,2,10,2,10,12
40701,HUANUNI,estado nutricional en menores de 5 anos,clasificacion d,2002-05-01,6,2,6,2,8
80803,HUARACAJE,estado nutricional en menores de 5 anos,clasificacion d,2002-05-01,11,4,11,4,15
41601,HUAYLLAMARCA,estado nutricional en menores de 5 anos,clasificacion d,2002-05-01,22,10,22,10,32
21005,ICHOCA,estado nutricional en menores de 5 anos,clasificacion d,2002-05-01,5,3,5,3,8
10304,ICLA,estado nutricional en menores de 5 anos,clasificacion d,2002-05-01,117,205,117,205,322
10703,INCAHUASI,estado nutricional en menores de 5 anos,clasificacion d,2002-05-01,98,148,98,148,246
90402,INGAVI (HUMAITA),estado nutricional en menores de 5 anos,clasificacion d,2002-05-01,0,3,0,3,3
21001,INQUISIVI,estado nutricional en menores de 5 anos,clasificacion d,2002-05-01,29,87,29,87,116
21102,IRUPANA (VILLA DE LANZA),estado nutricional en menores de 5 anos,clasificacion d,2002-05-01,8,34,8,34,42
21501,IXIAMAS,estado nutricional en menores de 5 anos,clasificacion d,2002-05-01,20,36,20,36,56
21105,LA ASUNTA,estado nutricional en menores de 5 anos,clasificacion d,2002-05-01,17,57,17,57,74
70104,LA GUARDIA,estado nutricional en menores de 5 anos,clasificacion d,2002-05-01,82,56,82,56,138
20101,LA PAZ,estado nutricional en menores de 5 anos,clasificacion d,2002-05-01,1204,1011,1204,1011,2215
41501,LA RIVERA,estado nutricional en menores de 5 anos,clasificacion d,2002-05-01,0,1,0,1,1
70701,LAGUNILLAS,estado nutricional en menores de 5 anos,clasificacion d,2002-05-01,40,42,40,42,82
21202,LAJA,estado nutricional en menores de 5 anos,clasificacion d,2002-05-01,3,47,3,47,50
10903,LAS CARRERAS,estado nutricional en menores de 5 anos,clasificacion d,2002-05-01,40,50,40,50,90
51401,LLICA,estado nutricional en menores de 5 anos,clasificacion d,2002-05-01,15,16,15,16,31
80601,LORETO,estado nutricional en menores de 5 anos,clasificacion d,2002-05-01,5,19,5,19,24
20901,LURIBAY,estado nutricional en menores de 5 anos,clasificacion d,2002-05-01,9,16,9,16,25
40702,MACHACAMARCA,estado nutricional en menores de 5 anos,clasificacion d,2002-05-01,12,12,12,12,24
11003,MACHARETI,estado nutricional en menores de 5 anos,clasificacion d,2002-05-01,33,125,33,125,158
80801,MAGDALENA,estado nutricional en menores de 5 anos,clasificacion d,2002-05-01,18,46,18,46,64
70903,MAIRANA,estado nutricional en menores de 5 anos,clasificacion d,2002-05-01,14,31,14,31,45
20904,MALLA,estado nutricional en menores de 5 anos,clasificacion d,2002-05-01,3,2,3,2,5
20103,MECAPACA,estado nutricional en menores de 5 anos,clasificacion d,2002-05-01,7,24,7,24,31
71003,MINEROS,estado nutricional en menores de 5 anos,clasificacion d,2002-05-01,114,93,114,93,207
31301,MIZQUE,estado nutricional en menores de 5 anos,clasificacion d,2002-05-01,55,74,55,74,129
20402,MOCOMOCO,estado nutricional en menores de 5 anos,clasificacion d,2002-05-01,37,46,37,46,83
51002,MOJINETE,estado nutricional en menores de 5 anos,clasificacion d,2002-05-01,0,11,0,11,11
10303,MOJOCOYA,estado nutricional en menores de 5 anos,clasificacion d,2002-05-01,79,139,79,139,218
10501,MONTEAGUDO,estado nutricional en menores de 5 anos,clasificacion d,2002-05-01,194,289,194,289,483
71001,MONTERO,estado nutricional en menores de 5 anos,clasificacion d,2002-05-01,91,359,91,359,450
70803,MORO MORO,estado nutricional en menores de 5 anos,clasificacion d,2002-05-01,17,7,17,7,24
30302,MOROCHATA,estado nutricional en menores de 5 anos,clasificacion d,2002-05-01,26,52,26,52,78
20307,NAZACARA DE PACAJES,estado nutricional en menores de 5 anos,clasificacion d,2002-05-01,0,4,0,4,4
90501,NUEVO MANOA (NUEVA ESPERANZA),estado nutricional en menores de 5 anos,clasificacion d,2002-05-01,3,5,3,5,8
50404,OCURI,estado nutricional en menores de 5 anos,clasificacion d,2002-05-01,70,68,70,68,138
70202,OKINAWA,estado nutricional en menores de 5 anos,clasificacion d,2002-05-01,5,12,5,12,17
30203,OMEREQUE,estado nutricional en menores de 5 anos,clasificacion d,2002-05-01,1,6,1,6,7
40101,ORURO,estado nutricional en menores de 5 anos,clasificacion d,2002-05-01,507,497,507,497,1004
60201,PADCAYA,estado nutricional en menores de 5 anos,clasificacion d,2002-05-01,51,78,51,78,129
10401,PADILLA,estado nutricional en menores de 5 anos,clasificacion d,2002-05-01,157,258,157,258,415
70502,PAILON,estado nutricional en menores de 5 anos,clasificacion d,2002-05-01,3,51,3,51,54
20102,PALCA,estado nutricional en menores de 5 anos,clasificacion d,2002-05-01,34,44,34,44,78
21104,PALOS BLANCOS,estado nutricional en menores de 5 anos,clasificacion d,2002-05-01,42,97,42,97,139
40802,PAMPA AULLAGAS,estado nutricional en menores de 5 anos,clasificacion d,2002-05-01,12,19,12,19,31
70902,PAMPA GRANDE,estado nutricional en menores de 5 anos,clasificacion d,2002-05-01,13,13,13,13,26
21802,PAPEL PAMPA,estado nutricional en menores de 5 anos,clasificacion d,2002-05-01,5,3,5,3,8
30202,PASORAPA,estado nutricional en menores de 5 anos,clasificacion d,2002-05-01,29,41,29,41,70
21305,PATACAMAYA,estado nutricional en menores de 5 anos,clasificacion d,2002-05-01,44,31,44,31,75
40602,PAZÃ‘A,estado nutricional en menores de 5 anos,clasificacion d,2002-05-01,1,45,1,45,46
20702,PELECHUCO,estado nutricional en menores de 5 anos,clasificacion d,2002-05-01,10,32,10,32,42
50403,POCOATA,estado nutricional en menores de 5 anos,clasificacion d,2002-05-01,141,260,141,260,401
31203,POCONA,estado nutricional en menores de 5 anos,clasificacion d,2002-05-01,88,68,88,68,156
31202,POJO (CBBA),estado nutricional en menores de 5 anos,clasificacion d,2002-05-01,113,90,113,90,203
40601,POOPO,estado nutricional en menores de 5 anos,clasificacion d,2002-05-01,1,31,1,31,32
51203,PORCO,estado nutricional en menores de 5 anos,clasificacion d,2002-05-01,21,37,21,37,58
10103,POROMA,estado nutricional en menores de 5 anos,clasificacion d,2002-05-01,147,193,147,193,340
70103,PORONGO,estado nutricional en menores de 5 anos,clasificacion d,2002-05-01,18,18,18,18,36
70601,PORTACHUELO,estado nutricional en menores de 5 anos,clasificacion d,2002-05-01,43,38,43,38,81
90102,PORVENIR,estado nutricional en menores de 5 anos,clasificacion d,2002-05-01,1,0,1,0,1
50101,POTOSI,estado nutricional en menores de 5 anos,clasificacion d,2002-05-01,456,425,456,425,881
10302,PRESTO,estado nutricional en menores de 5 anos,clasificacion d,2002-05-01,69,77,69,77,146
70805,PUCARA,estado nutricional en menores de 5 anos,clasificacion d,2002-05-01,5,8,5,8,13
21201,PUCARANI,estado nutricional en menores de 5 anos,clasificacion d,2002-05-01,3,92,3,92,95
20401,PUERTO ACOSTA,estado nutricional en menores de 5 anos,clasificacion d,2002-05-01,58,66,58,66,124
20403,PUERTO CARABUCO,estado nutricional en menores de 5 anos,clasificacion d,2002-05-01,42,59,42,59,101
90301,PUERTO GONZALO MORENO,estado nutricional en menores de 5 anos,clasificacion d,2002-05-01,14,15,14,15,29
21204,PUERTO PEREZ,estado nutricional en menores de 5 anos,clasificacion d,2002-05-01,5,13,5,13,18
71402,PUERTO QUIJARRO,estado nutricional en menores de 5 anos,clasificacion d,2002-05-01,24,6,24,6,30
90201,PUERTO RICO,estado nutricional en menores de 5 anos,clasificacion d,2002-05-01,0,26,0,26,26
80703,PUERTO SILES,estado nutricional en menores de 5 anos,clasificacion d,2002-05-01,1,3,1,3,4
71401,PUERTO SUAREZ,estado nutricional en menores de 5 anos,clasificacion d,2002-05-01,63,21,63,21,84
31205,PUERTO VILLARROEL,estado nutricional en menores de 5 anos,clasificacion d,2002-05-01,155,141,155,141,296
51101,PUNA,estado nutricional en menores de 5 anos,clasificacion d,2002-05-01,131,360,131,360,491
31401,PUNATA,estado nutricional en menores de 5 anos,clasificacion d,2002-05-01,1,23,1,23,24
20604,QUIABAYA,estado nutricional en menores de 5 anos,clasificacion d,2002-05-01,12,26,12,26,38
30901,QUILLACOLLO,estado nutricional en menores de 5 anos,clasificacion d,2002-05-01,62,44,62,44,106
21002,QUIME,estado nutricional en menores de 5 anos,clasificacion d,2002-05-01,24,13,24,13,37
50402,RAVELO,estado nutricional en menores de 5 anos,clasificacion d,2002-05-01,140,234,140,234,374
80301,REYES,estado nutricional en menores de 5 anos,clasificacion d,2002-05-01,25,32,25,32,57
80201,RIBERALTA,estado nutricional en menores de 5 anos,clasificacion d,2002-05-01,382,242,382,242,624
70503,ROBORE,estado nutricional en menores de 5 anos,clasificacion d,2002-05-01,26,45,26,45,71
80304,RURRENABAQUE,estado nutricional en menores de 5 anos,clasificacion d,2002-05-01,13,9,13,9,22
40901,SABAYA,estado nutricional en menores de 5 anos,clasificacion d,2002-05-01,0,3,0,3,3
31001,SACABA,estado nutricional en menores de 5 anos,clasificacion d,2002-05-01,16,144,16,144,160
30404,SACABAMBA,estado nutricional en menores de 5 anos,clasificacion d,2002-05-01,0,61,0,61,61
50701,SACACA,estado nutricional en menores de 5 anos,clasificacion d,2002-05-01,171,301,171,301,472
71302,SAIPINA,estado nutricional en menores de 5 anos,clasificacion d,2002-05-01,9,23,9,23,32
40801,SALINAS DE GARCI MENDOZA,estado nutricional en menores de 5 anos,clasificacion d,2002-05-01,9,13,9,13,22
70901,SAMAIPATA,estado nutricional en menores de 5 anos,clasificacion d,2002-05-01,21,20,21,20,41
51601,SAN AGUSTIN,estado nutricional en menores de 5 anos,clasificacion d,2002-05-01,1,9,1,9,10
80602,SAN ANDRES,estado nutricional en menores de 5 anos,clasificacion d,2002-05-01,4,6,4,6,10
51003,SAN ANTONIO DE ESMORUCO,estado nutricional en menores de 5 anos,clasificacion d,2002-05-01,1,14,1,14,15
71105,SAN ANTONIO DE LOMERIO,estado nutricional en menores de 5 anos,clasificacion d,2002-05-01,67,122,67,122,189
31403,SAN BENITO,estado nutricional en menores de 5 anos,clasificacion d,2002-05-01,18,21,18,21,39
80302,SAN BORJA,estado nutricional en menores de 5 anos,clasificacion d,2002-05-01,91,71,91,71,162
21502,SAN BUENA VENTURA,estado nutricional en menores de 5 anos,clasificacion d,2002-05-01,12,23,12,23,35
70402,SAN CARLOS,estado nutricional en menores de 5 anos,clasificacion d,2002-05-01,0,21,0,21,21
80501,SAN IGNACIO,estado nutricional en menores de 5 anos,clasificacion d,2002-05-01,51,155,51,155,206
70301,SAN IGNACIO DE VELASCO,estado nutricional en menores de 5 anos,clasificacion d,2002-05-01,153,123,153,123,276
80102,SAN JAVIER(BNI),estado nutricional en menores de 5 anos,clasificacion d,2002-05-01,9,16,9,16,25
71102,SAN JAVIER(STC),estado nutricional en menores de 5 anos,clasificacion d,2002-05-01,24,10,24,10,34
80701,SAN JOAQUIN,estado nutricional en menores de 5 anos,clasificacion d,2002-05-01,0,25,0,25,25
70501,SAN JOSE DE CHIQUITOS,estado nutricional en menores de 5 anos,clasificacion d,2002-05-01,39,21,39,21,60
71104,SAN JULIAN,estado nutricional en menores de 5 anos,clasificacion d,2002-05-01,153,327,153,327,480
90302,SAN LORENZO(PND),estado nutricional en menores de 5 anos,clasificacion d,2002-05-01,2,3,2,3,5
60501,SAN LORENZO(TJA),estado nutricional en menores de 5 anos,clasificacion d,2002-05-01,9,45,9,45,54
10702,SAN LUCAS,estado nutricional en menores de 5 anos,clasificacion d,2002-05-01,342,338,342,338,680
71201,SAN MATIAS,estado nutricional en menores de 5 anos,clasificacion d,2002-05-01,41,26,41,26,67
70302,SAN MIGUEL DE VELASCO,estado nutricional en menores de 5 anos,clasificacion d,2002-05-01,50,64,50,64,114
51001,SAN PABLO DE LIPEZ,estado nutricional en menores de 5 anos,clasificacion d,2002-05-01,2,68,2,68,70
50501,SAN PEDRO DE BUENA VISTA,estado nutricional en menores de 5 anos,clasificacion d,2002-05-01,11,304,11,304,315
21801,SAN PEDRO DE CURAHUARA,estado nutricional en menores de 5 anos,clasificacion d,2002-05-01,9,18,9,18,27
50902,SAN PEDRO DE QUEMES,estado nutricional en menores de 5 anos,clasificacion d,2002-05-01,0,3,0,3,3
21702,SAN PEDRO DE TIQUINA,estado nutricional en menores de 5 anos,clasificacion d,2002-05-01,1,6,1,6,7
90202,SAN PEDRO(PND),estado nutricional en menores de 5 anos,clasificacion d,2002-05-01,1,5,1,5,6
70303,SAN RAFAEL,estado nutricional en menores de 5 anos,clasificacion d,2002-05-01,25,16,25,16,41
80702,SAN RAMON,estado nutricional en menores de 5 anos,clasificacion d,2002-05-01,18,48,18,48,66
80401,SANTA ANA,estado nutricional en menores de 5 anos,clasificacion d,2002-05-01,20,26,20,26,46
70101,SANTA CRUZ DE LA SIERRA,estado nutricional en menores de 5 anos,clasificacion d,2002-05-01,398,298,398,298,696
80303,SANTA ROSA,estado nutricional en menores de 5 anos,clasificacion d,2002-05-01,44,25,44,25,69
70602,SANTA ROSA DEL SARA,estado nutricional en menores de 5 anos,clasificacion d,2002-05-01,12,17,12,17,29
20308,SANTIAGO DE CALLAPA,estado nutricional en menores de 5 anos,clasificacion d,2002-05-01,2,12,2,12,14
41401,SANTIAGO DE HUARI,estado nutricional en menores de 5 anos,clasificacion d,2002-05-01,23,30,23,30,53
21901,SANTIAGO DE MACHACA,estado nutricional en menores de 5 anos,clasificacion d,2002-05-01,4,7,4,7,11
30702,SANTIVAÃ‘ES,estado nutricional en menores de 5 anos,clasificacion d,2002-05-01,15,10,15,10,25
40202,SANTUARIO DE QUILLACAS,estado nutricional en menores de 5 anos,clasificacion d,2002-05-01,3,10,3,10,13
20902,SAPAHAQUI,estado nutricional en menores de 5 anos,clasificacion d,2002-05-01,0,22,0,22,22
21301,SICA SICA (VILLA AROMA),estado nutricional en menores de 5 anos,clasificacion d,2002-05-01,44,13,44,13,57
30703,SICAYA,estado nutricional en menores de 5 anos,clasificacion d,2002-05-01,2,32,2,32,34
30902,SIPE SIPE,estado nutricional en menores de 5 anos,clasificacion d,2002-05-01,143,169,143,169,312
10403,SOPACHUY,estado nutricional en menores de 5 anos,clasificacion d,2002-05-01,46,49,46,49,95
20601,SORATA,estado nutricional en menores de 5 anos,clasificacion d,2002-05-01,38,84,38,84,122
10101,SUCRE,estado nutricional en menores de 5 anos,clasificacion d,2002-05-01,641,776,641,776,1417
31404,TACACHI,estado nutricional en menores de 5 anos,clasificacion d,2002-05-01,0,3,0,3,3
20603,TACACOMA,estado nutricional en menores de 5 anos,clasificacion d,2002-05-01,12,51,12,51,63
50303,TACOBAMBA,estado nutricional en menores de 5 anos,clasificacion d,2002-05-01,46,52,46,52,98
30602,TACOPAYA,estado nutricional en menores de 5 anos,clasificacion d,2002-05-01,49,96,49,96,145
51402,TAHUA,estado nutricional en menores de 5 anos,clasificacion d,2002-05-01,0,16,0,16,16
31101,TAPACARI,estado nutricional en menores de 5 anos,clasificacion d,2002-05-01,5,149,5,149,154
10601,TARABUCO,estado nutricional en menores de 5 anos,clasificacion d,2002-05-01,120,625,120,625,745
30401,TARATA,estado nutricional en menores de 5 anos,clasificacion d,2002-05-01,52,55,52,55,107
60101,TARIJA,estado nutricional en menores de 5 anos,clasificacion d,2002-05-01,183,189,183,189,372
10202,TARVITA,estado nutricional en menores de 5 anos,clasificacion d,2002-05-01,86,121,86,121,207
20803,TIAWANACU,estado nutricional en menores de 5 anos,clasificacion d,2002-05-01,29,10,29,10,39
50102,TINGUIPAYA,estado nutricional en menores de 5 anos,clasificacion d,2002-05-01,8,114,8,114,122
20606,TIPUANI,estado nutricional en menores de 5 anos,clasificacion d,2002-05-01,12,16,12,16,28
30903,TIQUIPAYA,estado nutricional en menores de 5 anos,clasificacion d,2002-05-01,1,76,1,76,77
31601,TIRAQUE (CBBA),estado nutricional en menores de 5 anos,clasificacion d,2002-05-01,51,126,51,126,177
21703,TITO YUPANQUI (PARQUIPUJIO),estado nutricional en menores de 5 anos,clasificacion d,2002-05-01,0,22,0,22,22
30802,TOCO,estado nutricional en menores de 5 anos,clasificacion d,2002-05-01,6,9,6,9,15
30803,TOLATA,estado nutricional en menores de 5 anos,clasificacion d,2002-05-01,0,18,0,18,18
41001,TOLEDO,estado nutricional en menores de 5 anos,clasificacion d,2002-05-01,9,7,9,7,16
51202,TOMAVE,estado nutricional en menores de 5 anos,clasificacion d,2002-05-01,5,137,5,137,142
10402,TOMINA,estado nutricional en menores de 5 anos,clasificacion d,2002-05-01,102,161,102,161,263
50502,TORO TORO,estado nutricional en menores de 5 anos,clasificacion d,2002-05-01,0,54,0,54,54
31201,TOTORA(CBBA),estado nutricional en menores de 5 anos,clasificacion d,2002-05-01,72,81,72,81,153
41301,TOTORA(ORR),estado nutricional en menores de 5 anos,clasificacion d,2002-05-01,7,12,7,12,19
70802,TRIGAL,estado nutricional en menores de 5 anos,clasificacion d,2002-05-01,1,3,1,3,4
80101,TRINIDAD,estado nutricional en menores de 5 anos,clasificacion d,2002-05-01,143,192,143,192,335
50801,TUPIZA,estado nutricional en menores de 5 anos,clasificacion d,2002-05-01,8,387,8,387,395
40402,TURCO,estado nutricional en menores de 5 anos,clasificacion d,2002-05-01,12,2,12,2,14
21302,UMALA,estado nutricional en menores de 5 anos,clasificacion d,2002-05-01,2,10,2,10,12
60401,URIONDO (A. CONCEPCION),estado nutricional en menores de 5 anos,clasificacion d,2002-05-01,27,47,27,47,74
71502,URUBICHA,estado nutricional en menores de 5 anos,clasificacion d,2002-05-01,0,29,0,29,29
51201,UYUNI,estado nutricional en menores de 5 anos,clasificacion d,2002-05-01,13,340,13,340,353
30502,VACAS,estado nutricional en menores de 5 anos,clasificacion d,2002-05-01,1,47,1,47,48
70801,VALLEGRANDE,estado nutricional en menores de 5 anos,clasificacion d,2002-05-01,46,70,46,70,116
20801,VIACHA,estado nutricional en menores de 5 anos,clasificacion d,2002-05-01,8,171,8,171,179
31302,VILA VILA,estado nutricional en menores de 5 anos,clasificacion d,2002-05-01,24,33,24,33,57
60303,VILLA MONTES,estado nutricional en menores de 5 anos,clasificacion d,2002-05-01,42,60,42,60,102
31402,VILLA RIVERO,estado nutricional en menores de 5 anos,clasificacion d,2002-05-01,0,25,0,25,25
10801,VILLA SERRANO,estado nutricional en menores de 5 anos,clasificacion d,2002-05-01,99,252,99,252,351
31003,VILLA TUNARI,estado nutricional en menores de 5 anos,clasificacion d,2002-05-01,132,104,132,104,236
11001,VILLA VACA GUZMAN (MUYUPAMPA),estado nutricional en menores de 5 anos,clasificacion d,2002-05-01,91,125,91,125,216
51501,VILLAZON,estado nutricional en menores de 5 anos,clasificacion d,2002-05-01,26,259,26,259,285
30904,VINTO,estado nutricional en menores de 5 anos,clasificacion d,2002-05-01,104,48,104,48,152
50602,VITICHI,estado nutricional en menores de 5 anos,clasificacion d,2002-05-01,11,160,11,160,171
20306,WALDO BALLIVIAN,estado nutricional en menores de 5 anos,clasificacion d,2002-05-01,3,2,3,2,5
70201,WARNES,estado nutricional en menores de 5 anos,clasificacion d,2002-05-01,114,94,114,94,208
20903,YACO,estado nutricional en menores de 5 anos,clasificacion d,2002-05-01,2,23,2,23,25
60301,YACUIBA,estado nutricional en menores de 5 anos,clasificacion d,2002-05-01,70,58,70,58,128
10602,YAMPARAEZ,estado nutricional en menores de 5 anos,clasificacion d,2002-05-01,155,302,155,302,457
21103,YANACACHI,estado nutricional en menores de 5 anos,clasificacion d,2002-05-01,16,17,16,17,33
70403,YAPACANI,estado nutricional en menores de 5 anos,clasificacion d,2002-05-01,13,130,13,130,143
50103,YOCALLA,estado nutricional en menores de 5 anos,clasificacion d,2002-05-01,1,72,1,72,73
10102,YOTALA,estado nutricional en menores de 5 anos,clasificacion d,2002-05-01,122,214,122,214,336
60402,YUNCHARA,estado nutricional en menores de 5 anos,clasificacion d,2002-05-01,15,29,15,29,44
10301,ZUDAÃ‘EZ,estado nutricional en menores de 5 anos,clasificacion d,2002-05-01,49,127,49,127,176
51302,ACACIO,estado nutricional en menores de 5 anos,clasificacion d,2002-06-01,29,171,29,171,200
20201,ACHACACHI,estado nutricional en menores de 5 anos,clasificacion d,2002-06-01,142,122,142,122,264
20104,ACHOCALLA,estado nutricional en menores de 5 anos,clasificacion d,2002-06-01,16,8,16,8,24
30201,AIQUILE,estado nutricional en menores de 5 anos,clasificacion d,2002-06-01,17,68,17,68,85
31303,ALALAY,estado nutricional en menores de 5 anos,clasificacion d,2002-06-01,10,11,10,11,21
10404,ALCALA,estado nutricional en menores de 5 anos,clasificacion d,2002-06-01,36,63,36,63,99
20202,ANCORAIMES,estado nutricional en menores de 5 anos,clasificacion d,2002-06-01,70,116,70,116,186
41201,ANDAMARCA,estado nutricional en menores de 5 anos,clasificacion d,2002-06-01,11,10,11,10,21
40603,ANTEQUERA,estado nutricional en menores de 5 anos,clasificacion d,2002-06-01,0,10,0,10,10
30402,ANZALDO,estado nutricional en menores de 5 anos,clasificacion d,2002-06-01,2,112,2,112,114
20701,APOLO,estado nutricional en menores de 5 anos,clasificacion d,2002-06-01,26,16,26,16,42
51301,ARAMPAMPA,estado nutricional en menores de 5 anos,clasificacion d,2002-06-01,25,29,25,29,54
30501,ARANI,estado nutricional en menores de 5 anos,clasificacion d,2002-06-01,1,26,1,26,27
30403,ARBIETO,estado nutricional en menores de 5 anos,clasificacion d,2002-06-01,3,17,3,17,20
30601,ARQUE,estado nutricional en menores de 5 anos,clasificacion d,2002-06-01,31,37,31,37,68
71501,ASCENCION DE GUARAYOS,estado nutricional en menores de 5 anos,clasificacion d,2002-06-01,162,227,162,227,389
50802,ATOCHA,estado nutricional en menores de 5 anos,clasificacion d,2002-06-01,4,74,4,74,78
20503,AUCAPATA,estado nutricional en menores de 5 anos,clasificacion d,2002-06-01,15,4,15,4,19
20502,AYATA,estado nutricional en menores de 5 anos,clasificacion d,2002-06-01,9,6,9,6,15
21303,AYO AYO,estado nutricional en menores de 5 anos,clasificacion d,2002-06-01,15,10,15,10,25
30301,AYOPAYA (V. DE INDEPENDENCIA),estado nutricional en menores de 5 anos,clasificacion d,2002-06-01,91,135,91,135,226
10201,AZURDUY,estado nutricional en menores de 5 anos,clasificacion d,2002-06-01,186,223,186,223,409
21203,BATALLAS,estado nutricional en menores de 5 anos,clasificacion d,2002-06-01,1,60,1,60,61
80802,BAURES,estado nutricional en menores de 5 anos,clasificacion d,2002-06-01,17,41,17,41,58
41202,BELEN DE ANDAMARCA,estado nutricional en menores de 5 anos,clasificacion d,2002-06-01,0,1,0,1,1
50104,BELEN DE URMIRI,estado nutricional en menores de 5 anos,clasificacion d,2002-06-01,7,34,7,34,41
90104,BELLA FLOR,estado nutricional en menores de 5 anos,clasificacion d,2002-06-01,12,14,12,14,26
60202,BERMEJO,estado nutricional en menores de 5 anos,clasificacion d,2002-06-01,1,9,1,9,10
50301,BETANZOS,estado nutricional en menores de 5 anos,clasificacion d,2002-06-01,95,204,95,204,299
31501,BOLIVAR,estado nutricional en menores de 5 anos,clasificacion d,2002-06-01,39,67,39,67,106
90103,BOLPEBRA,estado nutricional en menores de 5 anos,clasificacion d,2002-06-01,0,3,0,3,3
70707,BOYUIBE,estado nutricional en menores de 5 anos,clasificacion d,2002-06-01,2,2,2,2,4
70703,CABEZAS,estado nutricional en menores de 5 anos,clasificacion d,2002-06-01,1,63,1,63,64
20905,CAIROMA,estado nutricional en menores de 5 anos,clasificacion d,2002-06-01,14,48,14,48,62
51102,"CAIZA ""D""",estado nutricional en menores de 5 anos,clasificacion d,2002-06-01,27,106,27,106,133
21003,CAJUATA,estado nutricional en menores de 5 anos,clasificacion d,2002-06-01,23,15,23,15,38
20303,CALACOTO,estado nutricional en menores de 5 anos,clasificacion d,2002-06-01,10,17,10,17,27
21304,CALAMARCA,estado nutricional en menores de 5 anos,clasificacion d,2002-06-01,30,56,30,56,86
10701,CAMARGO,estado nutricional en menores de 5 anos,clasificacion d,2002-06-01,20,98,20,98,118
10901,CAMATAQUI (C. VILLA ABECIA),estado nutricional en menores de 5 anos,clasificacion d,2002-06-01,30,47,30,47,77
70706,CAMIRI,estado nutricional en menores de 5 anos,clasificacion d,2002-06-01,29,59,29,59,88
30701,CAPINOTA,estado nutricional en menores de 5 anos,clasificacion d,2002-06-01,17,31,17,31,48
20302,CAQUIAVIRI,estado nutricional en menores de 5 anos,clasificacion d,2002-06-01,24,31,24,31,55
40102,CARACOLLO,estado nutricional en menores de 5 anos,clasificacion d,2002-06-01,14,83,14,83,97
22001,CARANAVI,estado nutricional en menores de 5 anos,clasificacion d,2002-06-01,125,115,125,115,240
41503,CARANGAS,estado nutricional en menores de 5 anos,clasificacion d,2002-06-01,1,0,1,0,1
60302,CARAPARI,estado nutricional en menores de 5 anos,clasificacion d,2002-06-01,25,60,25,60,85
50702,CARIPUYO,estado nutricional en menores de 5 anos,clasificacion d,2002-06-01,9,138,9,138,147
21902,CATACORA,estado nutricional en menores de 5 anos,clasificacion d,2002-06-01,10,11,10,11,21
21803,CHACARILLA,estado nutricional en menores de 5 anos,clasificacion d,2002-06-01,0,8,0,8,8
40201,CHALLAPATA,estado nutricional en menores de 5 anos,clasificacion d,2002-06-01,32,72,32,72,104
50302,CHAQUI,estado nutricional en menores de 5 anos,clasificacion d,2002-06-01,82,57,82,57,139
70702,CHARAGUA,estado nutricional en menores de 5 anos,clasificacion d,2002-06-01,2,170,2,170,172
20305,CHARAÃ‘A,estado nutricional en menores de 5 anos,clasificacion d,2002-06-01,3,2,3,2,5
50202,CHAYANTA,estado nutricional en menores de 5 anos,clasificacion d,2002-06-01,14,99,14,99,113
31204,CHIMORE,estado nutricional en menores de 5 anos,clasificacion d,2002-06-01,9,5,9,5,14
40903,CHIPAYA,estado nutricional en menores de 5 anos,clasificacion d,2002-06-01,5,5,5,5,10
40302,CHOQUE COTA,estado nutricional en menores de 5 anos,clasificacion d,2002-06-01,9,4,9,4,13
21101,CHULUMANI (V. DE LA LIBERTAD),estado nutricional en menores de 5 anos,clasificacion d,2002-06-01,5,20,5,20,25
20501,CHUMA,estado nutricional en menores de 5 anos,clasificacion d,2002-06-01,8,13,8,13,21
30801,CLIZA,estado nutricional en menores de 5 anos,clasificacion d,2002-06-01,2,13,2,13,15
90101,COBIJA,estado nutricional en menores de 5 anos,clasificacion d,2002-06-01,51,49,51,49,100
30101,COCHABAMBA,estado nutricional en menores de 5 anos,clasificacion d,2002-06-01,243,346,243,346,589
40902,COIPASA,estado nutricional en menores de 5 anos,clasificacion d,2002-06-01,0,2,0,2,2
30905,COLCAPIRHUA,estado nutricional en menores de 5 anos,clasificacion d,2002-06-01,60,65,60,65,125
50901,"COLCHA ""K""",estado nutricional en menores de 5 anos,clasificacion d,2002-06-01,10,98,10,98,108
21307,COLLANA,estado nutricional en menores de 5 anos,clasificacion d,2002-06-01,7,0,7,0,7
31002,COLOMI,estado nutricional en menores de 5 anos,clasificacion d,2002-06-01,15,53,15,53,68
50401,COLQUECHACA,estado nutricional en menores de 5 anos,clasificacion d,2002-06-01,123,62,123,62,185
21306,COLQUENCHA,estado nutricional en menores de 5 anos,clasificacion d,2002-06-01,34,26,34,26,60
21004,COLQUIRI,estado nutricional en menores de 5 anos,clasificacion d,2002-06-01,43,31,43,31,74
20304,COMANCHE,estado nutricional en menores de 5 anos,clasificacion d,2002-06-01,10,17,10,17,27
71301,COMARAPA,estado nutricional en menores de 5 anos,clasificacion d,2002-06-01,41,57,41,57,98
20605,COMBAYA,estado nutricional en menores de 5 anos,clasificacion d,2002-06-01,8,22,8,22,30
71101,CONCEPCION,estado nutricional en menores de 5 anos,clasificacion d,2002-06-01,9,8,9,8,17
21701,COPACABANA,estado nutricional en menores de 5 anos,clasificacion d,2002-06-01,12,43,12,43,55
21402,CORIPATA,estado nutricional en menores de 5 anos,clasificacion d,2002-06-01,3,11,3,11,14
20301,CORO CORO,estado nutricional en menores de 5 anos,clasificacion d,2002-06-01,46,21,46,21,67
21401,COROICO,estado nutricional en menores de 5 anos,clasificacion d,2002-06-01,8,5,8,5,13
40301,CORQUE,estado nutricional en menores de 5 anos,clasificacion d,2002-06-01,20,28,20,28,48
50601,COTAGAITA,estado nutricional en menores de 5 anos,clasificacion d,2002-06-01,61,305,61,305,366
70102,COTOCA,estado nutricional en menores de 5 anos,clasificacion d,2002-06-01,26,21,26,21,47
31405,CUCHUMUELA (V. G. VILLARROEL),estado nutricional en menores de 5 anos,clasificacion d,2002-06-01,5,50,5,50,55
70704,CUEVO,estado nutricional en menores de 5 anos,clasificacion d,2002-06-01,12,14,12,14,26
10902,CULPINA,estado nutricional en menores de 5 anos,clasificacion d,2002-06-01,200,206,200,206,406
40401,CURAHUARA DE CARANGAS,estado nutricional en menores de 5 anos,clasificacion d,2002-06-01,19,7,19,7,26
21602,CURVA,estado nutricional en menores de 5 anos,clasificacion d,2002-06-01,27,11,27,11,38
20804,DESAGUADERO,estado nutricional en menores de 5 anos,clasificacion d,2002-06-01,2,21,2,21,23
20105,EL ALTO,estado nutricional en menores de 5 anos,clasificacion d,2002-06-01,1560,1046,1560,1046,2606
40103,EL CHORO,estado nutricional en menores de 5 anos,clasificacion d,2002-06-01,5,1,5,1,6
71503,EL PUENTE(STC),estado nutricional en menores de 5 anos,clasificacion d,2002-06-01,6,105,6,105,111
60502,EL PUENTE(TJA),estado nutricional en menores de 5 anos,clasificacion d,2002-06-01,55,132,55,132,187
70105,EL TORNO,estado nutricional en menores de 5 anos,clasificacion d,2002-06-01,33,57,33,57,90
10405,EL VILLAR,estado nutricional en menores de 5 anos,clasificacion d,2002-06-01,55,133,55,133,188
60601,ENTRE RIOS,estado nutricional en menores de 5 anos,clasificacion d,2002-06-01,51,56,51,56,107
41101,EUCALIPTUS,estado nutricional en menores de 5 anos,clasificacion d,2002-06-01,1,37,1,37,38
80402,EXALTACION,estado nutricional en menores de 5 anos,clasificacion d,2002-06-01,5,6,5,6,11
90203,FILADELFIA,estado nutricional en menores de 5 anos,clasificacion d,2002-06-01,13,20,13,20,33
71002,GENERAL SAAVEDRA,estado nutricional en menores de 5 anos,clasificacion d,2002-06-01,49,61,49,61,110
20602,GUANAY,estado nutricional en menores de 5 anos,clasificacion d,2002-06-01,125,135,125,135,260
20802,GUAQUI,estado nutricional en menores de 5 anos,clasificacion d,2002-06-01,8,10,8,10,18
80202,GUAYARAMERIN,estado nutricional en menores de 5 anos,clasificacion d,2002-06-01,59,58,59,58,117
70705,GUTIERREZ,estado nutricional en menores de 5 anos,clasificacion d,2002-06-01,20,133,20,133,153
10502,HUACARETA,estado nutricional en menores de 5 anos,clasificacion d,2002-06-01,86,106,86,106,192
11002,HUACAYA (VILLA DE HUACAYA),estado nutricional en menores de 5 anos,clasificacion d,2002-06-01,13,18,13,18,31
40501,HUACHACALLA,estado nutricional en menores de 5 anos,clasificacion d,2002-06-01,6,1,6,1,7
40701,HUANUNI,estado nutricional en menores de 5 anos,clasificacion d,2002-06-01,2,0,2,0,2
80803,HUARACAJE,estado nutricional en menores de 5 anos,clasificacion d,2002-06-01,8,0,8,0,8
41601,HUAYLLAMARCA,estado nutricional en menores de 5 anos,clasificacion d,2002-06-01,18,9,18,9,27
21005,ICHOCA,estado nutricional en menores de 5 anos,clasificacion d,2002-06-01,10,14,10,14,24
10304,ICLA,estado nutricional en menores de 5 anos,clasificacion d,2002-06-01,136,187,136,187,323
10703,INCAHUASI,estado nutricional en menores de 5 anos,clasificacion d,2002-06-01,139,181,139,181,320
90402,INGAVI (HUMAITA),estado nutricional en menores de 5 anos,clasificacion d,2002-06-01,1,0,1,0,1
21001,INQUISIVI,estado nutricional en menores de 5 anos,clasificacion d,2002-06-01,33,116,33,116,149
21102,IRUPANA (VILLA DE LANZA),estado nutricional en menores de 5 anos,clasificacion d,2002-06-01,14,34,14,34,48
21501,IXIAMAS,estado nutricional en menores de 5 anos,clasificacion d,2002-06-01,21,29,21,29,50
21105,LA ASUNTA,estado nutricional en menores de 5 anos,clasificacion d,2002-06-01,47,45,47,45,92
70104,LA GUARDIA,estado nutricional en menores de 5 anos,clasificacion d,2002-06-01,56,41,56,41,97
20101,LA PAZ,estado nutricional en menores de 5 anos,clasificacion d,2002-06-01,1225,874,1225,874,2099
70701,LAGUNILLAS,estado nutricional en menores de 5 anos,clasificacion d,2002-06-01,30,17,30,17,47
21202,LAJA,estado nutricional en menores de 5 anos,clasificacion d,2002-06-01,1,39,1,39,40
10903,LAS CARRERAS,estado nutricional en menores de 5 anos,clasificacion d,2002-06-01,23,32,23,32,55
50203,LLALLAGUA,estado nutricional en menores de 5 anos,clasificacion d,2002-06-01,1,42,1,42,43
51401,LLICA,estado nutricional en menores de 5 anos,clasificacion d,2002-06-01,9,15,9,15,24
80601,LORETO,estado nutricional en menores de 5 anos,clasificacion d,2002-06-01,3,14,3,14,17
20901,LURIBAY,estado nutricional en menores de 5 anos,clasificacion d,2002-06-01,2,22,2,22,24
11003,MACHARETI,estado nutricional en menores de 5 anos,clasificacion d,2002-06-01,31,92,31,92,123
80801,MAGDALENA,estado nutricional en menores de 5 anos,clasificacion d,2002-06-01,11,26,11,26,37
70903,MAIRANA,estado nutricional en menores de 5 anos,clasificacion d,2002-06-01,8,10,8,10,18
20103,MECAPACA,estado nutricional en menores de 5 anos,clasificacion d,2002-06-01,15,26,15,26,41
71003,MINEROS,estado nutricional en menores de 5 anos,clasificacion d,2002-06-01,53,24,53,24,77
31301,MIZQUE,estado nutricional en menores de 5 anos,clasificacion d,2002-06-01,15,34,15,34,49
20402,MOCOMOCO,estado nutricional en menores de 5 anos,clasificacion d,2002-06-01,36,35,36,35,71
51002,MOJINETE,estado nutricional en menores de 5 anos,clasificacion d,2002-06-01,0,17,0,17,17
10303,MOJOCOYA,estado nutricional en menores de 5 anos,clasificacion d,2002-06-01,77,129,77,129,206
10501,MONTEAGUDO,estado nutricional en menores de 5 anos,clasificacion d,2002-06-01,136,227,136,227,363
71001,MONTERO,estado nutricional en menores de 5 anos,clasificacion d,2002-06-01,108,276,108,276,384
70803,MORO MORO,estado nutricional en menores de 5 anos,clasificacion d,2002-06-01,18,17,18,17,35
30302,MOROCHATA,estado nutricional en menores de 5 anos,clasificacion d,2002-06-01,29,78,29,78,107
90401,NACEBE (SANTA ROSA DEL ABUNA),estado nutricional en menores de 5 anos,clasificacion d,2002-06-01,2,1,2,1,3
20307,NAZACARA DE PACAJES,estado nutricional en menores de 5 anos,clasificacion d,2002-06-01,2,0,2,0,2
90501,NUEVO MANOA (NUEVA ESPERANZA),estado nutricional en menores de 5 anos,clasificacion d,2002-06-01,0,6,0,6,6
50404,OCURI,estado nutricional en menores de 5 anos,clasificacion d,2002-06-01,48,139,48,139,187
70202,OKINAWA,estado nutricional en menores de 5 anos,clasificacion d,2002-06-01,10,31,10,31,41
40101,ORURO,estado nutricional en menores de 5 anos,clasificacion d,2002-06-01,455,378,455,378,833
60201,PADCAYA,estado nutricional en menores de 5 anos,clasificacion d,2002-06-01,30,67,30,67,97
10401,PADILLA,estado nutricional en menores de 5 anos,clasificacion d,2002-06-01,128,258,128,258,386
70502,PAILON,estado nutricional en menores de 5 anos,clasificacion d,2002-06-01,15,13,15,13,28
20102,PALCA,estado nutricional en menores de 5 anos,clasificacion d,2002-06-01,8,36,8,36,44
21104,PALOS BLANCOS,estado nutricional en menores de 5 anos,clasificacion d,2002-06-01,73,105,73,105,178
40802,PAMPA AULLAGAS,estado nutricional en menores de 5 anos,clasificacion d,2002-06-01,17,24,17,24,41
70902,PAMPA GRANDE,estado nutricional en menores de 5 anos,clasificacion d,2002-06-01,5,9,5,9,14
21802,PAPEL PAMPA,estado nutricional en menores de 5 anos,clasificacion d,2002-06-01,9,13,9,13,22
30202,PASORAPA,estado nutricional en menores de 5 anos,clasificacion d,2002-06-01,16,27,16,27,43
21305,PATACAMAYA,estado nutricional en menores de 5 anos,clasificacion d,2002-06-01,39,16,39,16,55
40602,PAZÃ‘A,estado nutricional en menores de 5 anos,clasificacion d,2002-06-01,5,27,5,27,32
20702,PELECHUCO,estado nutricional en menores de 5 anos,clasificacion d,2002-06-01,11,26,11,26,37
50403,POCOATA,estado nutricional en menores de 5 anos,clasificacion d,2002-06-01,195,236,195,236,431
31203,POCONA,estado nutricional en menores de 5 anos,clasificacion d,2002-06-01,50,46,50,46,96
31202,POJO (CBBA),estado nutricional en menores de 5 anos,clasificacion d,2002-06-01,98,105,98,105,203
40601,POOPO,estado nutricional en menores de 5 anos,clasificacion d,2002-06-01,0,18,0,18,18
51203,PORCO,estado nutricional en menores de 5 anos,clasificacion d,2002-06-01,29,36,29,36,65
10103,POROMA,estado nutricional en menores de 5 anos,clasificacion d,2002-06-01,156,180,156,180,336
70103,PORONGO,estado nutricional en menores de 5 anos,clasificacion d,2002-06-01,16,13,16,13,29
70601,PORTACHUELO,estado nutricional en menores de 5 anos,clasificacion d,2002-06-01,39,19,39,19,58
70804,POSTRER VALLE,estado nutricional en menores de 5 anos,clasificacion d,2002-06-01,2,6,2,6,8
50101,POTOSI,estado nutricional en menores de 5 anos,clasificacion d,2002-06-01,475,371,475,371,846
10302,PRESTO,estado nutricional en menores de 5 anos,clasificacion d,2002-06-01,45,71,45,71,116
21201,PUCARANI,estado nutricional en menores de 5 anos,clasificacion d,2002-06-01,4,77,4,77,81
20401,PUERTO ACOSTA,estado nutricional en menores de 5 anos,clasificacion d,2002-06-01,83,90,83,90,173
20403,PUERTO CARABUCO,estado nutricional en menores de 5 anos,clasificacion d,2002-06-01,50,57,50,57,107
90301,PUERTO GONZALO MORENO,estado nutricional en menores de 5 anos,clasificacion d,2002-06-01,1,4,1,4,5
21204,PUERTO PEREZ,estado nutricional en menores de 5 anos,clasificacion d,2002-06-01,1,23,1,23,24
71402,PUERTO QUIJARRO,estado nutricional en menores de 5 anos,clasificacion d,2002-06-01,26,13,26,13,39
90201,PUERTO RICO,estado nutricional en menores de 5 anos,clasificacion d,2002-06-01,9,13,9,13,22
80703,PUERTO SILES,estado nutricional en menores de 5 anos,clasificacion d,2002-06-01,2,1,2,1,3
71401,PUERTO SUAREZ,estado nutricional en menores de 5 anos,clasificacion d,2002-06-01,29,13,29,13,42
31205,PUERTO VILLARROEL,estado nutricional en menores de 5 anos,clasificacion d,2002-06-01,104,125,104,125,229
51101,PUNA,estado nutricional en menores de 5 anos,clasificacion d,2002-06-01,19,147,19,147,166
31401,PUNATA,estado nutricional en menores de 5 anos,clasificacion d,2002-06-01,75,58,75,58,133
20604,QUIABAYA,estado nutricional en menores de 5 anos,clasificacion d,2002-06-01,9,24,9,24,33
30901,QUILLACOLLO,estado nutricional en menores de 5 anos,clasificacion d,2002-06-01,37,30,37,30,67
21002,QUIME,estado nutricional en menores de 5 anos,clasificacion d,2002-06-01,32,34,32,34,66
70904,QUIRUSILLAS,estado nutricional en menores de 5 anos,clasificacion d,2002-06-01,0,1,0,1,1
50402,RAVELO,estado nutricional en menores de 5 anos,clasificacion d,2002-06-01,240,289,240,289,529
80301,REYES,estado nutricional en menores de 5 anos,clasificacion d,2002-06-01,20,22,20,22,42
80201,RIBERALTA,estado nutricional en menores de 5 anos,clasificacion d,2002-06-01,241,171,241,171,412
70503,ROBORE,estado nutricional en menores de 5 anos,clasificacion d,2002-06-01,21,38,21,38,59
80304,RURRENABAQUE,estado nutricional en menores de 5 anos,clasificacion d,2002-06-01,17,8,17,8,25
40901,SABAYA,estado nutricional en menores de 5 anos,clasificacion d,2002-06-01,2,4,2,4,6
31001,SACABA,estado nutricional en menores de 5 anos,clasificacion d,2002-06-01,69,28,69,28,97
30404,SACABAMBA,estado nutricional en menores de 5 anos,clasificacion d,2002-06-01,0,56,0,56,56
50701,SACACA,estado nutricional en menores de 5 anos,clasificacion d,2002-06-01,120,474,120,474,594
71302,SAIPINA,estado nutricional en menores de 5 anos,clasificacion d,2002-06-01,12,10,12,10,22
40801,SALINAS DE GARCI MENDOZA,estado nutricional en menores de 5 anos,clasificacion d,2002-06-01,21,7,21,7,28
70901,SAMAIPATA,estado nutricional en menores de 5 anos,clasificacion d,2002-06-01,10,19,10,19,29
51601,SAN AGUSTIN,estado nutricional en menores de 5 anos,clasificacion d,2002-06-01,5,15,5,15,20
80602,SAN ANDRES,estado nutricional en menores de 5 anos,clasificacion d,2002-06-01,17,37,17,37,54
51003,SAN ANTONIO DE ESMORUCO,estado nutricional en menores de 5 anos,clasificacion d,2002-06-01,0,1,0,1,1
71105,SAN ANTONIO DE LOMERIO,estado nutricional en menores de 5 anos,clasificacion d,2002-06-01,56,92,56,92,148
31403,SAN BENITO,estado nutricional en menores de 5 anos,clasificacion d,2002-06-01,8,31,8,31,39
80302,SAN BORJA,estado nutricional en menores de 5 anos,clasificacion d,2002-06-01,132,85,132,85,217
21502,SAN BUENA VENTURA,estado nutricional en menores de 5 anos,clasificacion d,2002-06-01,43,31,43,31,74
80501,SAN IGNACIO,estado nutricional en menores de 5 anos,clasificacion d,2002-06-01,19,93,19,93,112
70301,SAN IGNACIO DE VELASCO,estado nutricional en menores de 5 anos,clasificacion d,2002-06-01,194,191,194,191,385
80102,SAN JAVIER(BNI),estado nutricional en menores de 5 anos,clasificacion d,2002-06-01,15,27,15,27,42
71102,SAN JAVIER(STC),estado nutricional en menores de 5 anos,clasificacion d,2002-06-01,35,55,35,55,90
80701,SAN JOAQUIN,estado nutricional en menores de 5 anos,clasificacion d,2002-06-01,0,15,0,15,15
70501,SAN JOSE DE CHIQUITOS,estado nutricional en menores de 5 anos,clasificacion d,2002-06-01,30,5,30,5,35
71104,SAN JULIAN,estado nutricional en menores de 5 anos,clasificacion d,2002-06-01,63,144,63,144,207
90302,SAN LORENZO(PND),estado nutricional en menores de 5 anos,clasificacion d,2002-06-01,2,5,2,5,7
60501,SAN LORENZO(TJA),estado nutricional en menores de 5 anos,clasificacion d,2002-06-01,35,40,35,40,75
10702,SAN LUCAS,estado nutricional en menores de 5 anos,clasificacion d,2002-06-01,340,419,340,419,759
71201,SAN MATIAS,estado nutricional en menores de 5 anos,clasificacion d,2002-06-01,0,2,0,2,2
70302,SAN MIGUEL DE VELASCO,estado nutricional en menores de 5 anos,clasificacion d,2002-06-01,78,69,78,69,147
51001,SAN PABLO DE LIPEZ,estado nutricional en menores de 5 anos,clasificacion d,2002-06-01,1,17,1,17,18
50501,SAN PEDRO DE BUENA VISTA,estado nutricional en menores de 5 anos,clasificacion d,2002-06-01,20,340,20,340,360
21801,SAN PEDRO DE CURAHUARA,estado nutricional en menores de 5 anos,clasificacion d,2002-06-01,20,37,20,37,57
50902,SAN PEDRO DE QUEMES,estado nutricional en menores de 5 anos,clasificacion d,2002-06-01,1,4,1,4,5
21702,SAN PEDRO DE TIQUINA,estado nutricional en menores de 5 anos,clasificacion d,2002-06-01,0,10,0,10,10
90202,SAN PEDRO(PND),estado nutricional en menores de 5 anos,clasificacion d,2002-06-01,10,23,10,23,33
70303,SAN RAFAEL,estado nutricional en menores de 5 anos,clasificacion d,2002-06-01,36,43,36,43,79
80702,SAN RAMON,estado nutricional en menores de 5 anos,clasificacion d,2002-06-01,1,2,1,2,3
80702,SAN RAMON,estado nutricional en menores de 5 anos,clasificacion d,2002-06-01,12,12,12,12,24
80401,SANTA ANA,estado nutricional en menores de 5 anos,clasificacion d,2002-06-01,6,10,6,10,16
70101,SANTA CRUZ DE LA SIERRA,estado nutricional en menores de 5 anos,clasificacion d,2002-06-01,314,203,314,203,517
80303,SANTA ROSA,estado nutricional en menores de 5 anos,clasificacion d,2002-06-01,13,7,13,7,20
70602,SANTA ROSA DEL SARA,estado nutricional en menores de 5 anos,clasificacion d,2002-06-01,18,23,18,23,41
20308,SANTIAGO DE CALLAPA,estado nutricional en menores de 5 anos,clasificacion d,2002-06-01,6,5,6,5,11
41401,SANTIAGO DE HUARI,estado nutricional en menores de 5 anos,clasificacion d,2002-06-01,14,28,14,28,42
21901,SANTIAGO DE MACHACA,estado nutricional en menores de 5 anos,clasificacion d,2002-06-01,13,6,13,6,19
30702,SANTIVAÃ‘ES,estado nutricional en menores de 5 anos,clasificacion d,2002-06-01,28,15,28,15,43
40202,SANTUARIO DE QUILLACAS,estado nutricional en menores de 5 anos,clasificacion d,2002-06-01,9,18,9,18,27
20902,SAPAHAQUI,estado nutricional en menores de 5 anos,clasificacion d,2002-06-01,1,11,1,11,12
90303,SENA,estado nutricional en menores de 5 anos,clasificacion d,2002-06-01,20,11,20,11,31
21301,SICA SICA (VILLA AROMA),estado nutricional en menores de 5 anos,clasificacion d,2002-06-01,54,23,54,23,77
30703,SICAYA,estado nutricional en menores de 5 anos,clasificacion d,2002-06-01,0,28,0,28,28
30902,SIPE SIPE,estado nutricional en menores de 5 anos,clasificacion d,2002-06-01,164,170,164,170,334
10403,SOPACHUY,estado nutricional en menores de 5 anos,clasificacion d,2002-06-01,64,73,64,73,137
20601,SORATA,estado nutricional en menores de 5 anos,clasificacion d,2002-06-01,27,41,27,41,68
10101,SUCRE,estado nutricional en menores de 5 anos,clasificacion d,2002-06-01,595,616,595,616,1211
31404,TACACHI,estado nutricional en menores de 5 anos,clasificacion d,2002-06-01,0,5,0,5,5
20603,TACACOMA,estado nutricional en menores de 5 anos,clasificacion d,2002-06-01,14,15,14,15,29
50303,TACOBAMBA,estado nutricional en menores de 5 anos,clasificacion d,2002-06-01,55,55,55,55,110
30602,TACOPAYA,estado nutricional en menores de 5 anos,clasificacion d,2002-06-01,30,93,30,93,123
51402,TAHUA,estado nutricional en menores de 5 anos,clasificacion d,2002-06-01,1,4,1,4,5
31101,TAPACARI,estado nutricional en menores de 5 anos,clasificacion d,2002-06-01,7,129,7,129,136
10601,TARABUCO,estado nutricional en menores de 5 anos,clasificacion d,2002-06-01,232,516,232,516,748
30401,TARATA,estado nutricional en menores de 5 anos,clasificacion d,2002-06-01,26,19,26,19,45
60101,TARIJA,estado nutricional en menores de 5 anos,clasificacion d,2002-06-01,204,160,204,160,364
10202,TARVITA,estado nutricional en menores de 5 anos,clasificacion d,2002-06-01,107,140,107,140,247
20803,TIAWANACU,estado nutricional en menores de 5 anos,clasificacion d,2002-06-01,20,20,20,20,40
50102,TINGUIPAYA,estado nutricional en menores de 5 anos,clasificacion d,2002-06-01,23,139,23,139,162
20606,TIPUANI,estado nutricional en menores de 5 anos,clasificacion d,2002-06-01,1,8,1,8,9
30903,TIQUIPAYA,estado nutricional en menores de 5 anos,clasificacion d,2002-06-01,40,45,40,45,85
31601,TIRAQUE (CBBA),estado nutricional en menores de 5 anos,clasificacion d,2002-06-01,64,88,64,88,152
21703,TITO YUPANQUI (PARQUIPUJIO),estado nutricional en menores de 5 anos,clasificacion d,2002-06-01,11,7,11,7,18
30802,TOCO,estado nutricional en menores de 5 anos,clasificacion d,2002-06-01,5,9,5,9,14
30803,TOLATA,estado nutricional en menores de 5 anos,clasificacion d,2002-06-01,12,3,12,3,15
41001,TOLEDO,estado nutricional en menores de 5 anos,clasificacion d,2002-06-01,2,9,2,9,11
51202,TOMAVE,estado nutricional en menores de 5 anos,clasificacion d,2002-06-01,2,172,2,172,174
10402,TOMINA,estado nutricional en menores de 5 anos,clasificacion d,2002-06-01,104,230,104,230,334
50502,TORO TORO,estado nutricional en menores de 5 anos,clasificacion d,2002-06-01,5,30,5,30,35
31201,TOTORA(CBBA),estado nutricional en menores de 5 anos,clasificacion d,2002-06-01,45,48,45,48,93
41301,TOTORA(ORR),estado nutricional en menores de 5 anos,clasificacion d,2002-06-01,15,22,15,22,37
70802,TRIGAL,estado nutricional en menores de 5 anos,clasificacion d,2002-06-01,1,2,1,2,3
80101,TRINIDAD,estado nutricional en menores de 5 anos,clasificacion d,2002-06-01,112,152,112,152,264
50801,TUPIZA,estado nutricional en menores de 5 anos,clasificacion d,2002-06-01,7,283,7,283,290
40402,TURCO,estado nutricional en menores de 5 anos,clasificacion d,2002-06-01,3,4,3,4,7
21302,UMALA,estado nutricional en menores de 5 anos,clasificacion d,2002-06-01,9,11,9,11,20
50201,UNCIA,estado nutricional en menores de 5 anos,clasificacion d,2002-06-01,47,141,47,141,188
60401,URIONDO (A. CONCEPCION),estado nutricional en menores de 5 anos,clasificacion d,2002-06-01,12,34,12,34,46
71502,URUBICHA,estado nutricional en menores de 5 anos,clasificacion d,2002-06-01,68,232,68,232,300
51201,UYUNI,estado nutricional en menores de 5 anos,clasificacion d,2002-06-01,41,165,41,165,206
30502,VACAS,estado nutricional en menores de 5 anos,clasificacion d,2002-06-01,0,65,0,65,65
70801,VALLEGRANDE,estado nutricional en menores de 5 anos,clasificacion d,2002-06-01,19,84,19,84,103
20801,VIACHA,estado nutricional en menores de 5 anos,clasificacion d,2002-06-01,22,120,22,120,142
31302,VILA VILA,estado nutricional en menores de 5 anos,clasificacion d,2002-06-01,9,15,9,15,24
60303,VILLA MONTES,estado nutricional en menores de 5 anos,clasificacion d,2002-06-01,33,43,33,43,76
90502,VILLA NUEVA (LOMA ALTA),estado nutricional en menores de 5 anos,clasificacion d,2002-06-01,1,1,1,1,2
31402,VILLA RIVERO,estado nutricional en menores de 5 anos,clasificacion d,2002-06-01,6,23,6,23,29
10801,VILLA SERRANO,estado nutricional en menores de 5 anos,clasificacion d,2002-06-01,122,262,122,262,384
31003,VILLA TUNARI,estado nutricional en menores de 5 anos,clasificacion d,2002-06-01,139,142,139,142,281
11001,VILLA VACA GUZMAN (MUYUPAMPA),estado nutricional en menores de 5 anos,clasificacion d,2002-06-01,52,90,52,90,142
51501,VILLAZON,estado nutricional en menores de 5 anos,clasificacion d,2002-06-01,26,182,26,182,208
30904,VINTO,estado nutricional en menores de 5 anos,clasificacion d,2002-06-01,48,23,48,23,71
50602,VITICHI,estado nutricional en menores de 5 anos,clasificacion d,2002-06-01,49,136,49,136,185
20306,WALDO BALLIVIAN,estado nutricional en menores de 5 anos,clasificacion d,2002-06-01,3,3,3,3,6
70201,WARNES,estado nutricional en menores de 5 anos,clasificacion d,2002-06-01,73,59,73,59,132
20903,YACO,estado nutricional en menores de 5 anos,clasificacion d,2002-06-01,0,19,0,19,19
60301,YACUIBA,estado nutricional en menores de 5 anos,clasificacion d,2002-06-01,72,53,72,53,125
10602,YAMPARAEZ,estado nutricional en menores de 5 anos,clasificacion d,2002-06-01,153,281,153,281,434
21103,YANACACHI,estado nutricional en menores de 5 anos,clasificacion d,2002-06-01,4,6,4,6,10
50103,YOCALLA,estado nutricional en menores de 5 anos,clasificacion d,2002-06-01,4,93,4,93,97
10102,YOTALA,estado nutricional en menores de 5 anos,clasificacion d,2002-06-01,130,209,130,209,339
60402,YUNCHARA,estado nutricional en menores de 5 anos,clasificacion d,2002-06-01,21,20,21,20,41
10301,ZUDAÃ‘EZ,estado nutricional en menores de 5 anos,clasificacion d,2002-06-01,63,146,63,146,209
51302,ACACIO,estado nutricional en menores de 5 anos,clasificacion d,2002-07-01,44,106,44,106,150
20201,ACHACACHI,estado nutricional en menores de 5 anos,clasificacion d,2002-07-01,112,111,112,111,223
20104,ACHOCALLA,estado nutricional en menores de 5 anos,clasificacion d,2002-07-01,17,8,17,8,25
30201,AIQUILE,estado nutricional en menores de 5 anos,clasificacion d,2002-07-01,30,86,30,86,116
31303,ALALAY,estado nutricional en menores de 5 anos,clasificacion d,2002-07-01,11,6,11,6,17
10404,ALCALA,estado nutricional en menores de 5 anos,clasificacion d,2002-07-01,39,66,39,66,105
20202,ANCORAIMES,estado nutricional en menores de 5 anos,clasificacion d,2002-07-01,54,106,54,106,160
41201,ANDAMARCA,estado nutricional en menores de 5 anos,clasificacion d,2002-07-01,5,11,5,11,16
40603,ANTEQUERA,estado nutricional en menores de 5 anos,clasificacion d,2002-07-01,0,36,0,36,36
30402,ANZALDO,estado nutricional en menores de 5 anos,clasificacion d,2002-07-01,3,92,3,92,95
20701,APOLO,estado nutricional en menores de 5 anos,clasificacion d,2002-07-01,40,29,40,29,69
51301,ARAMPAMPA,estado nutricional en menores de 5 anos,clasificacion d,2002-07-01,44,58,44,58,102
30501,ARANI,estado nutricional en menores de 5 anos,clasificacion d,2002-07-01,20,39,20,39,59
30403,ARBIETO,estado nutricional en menores de 5 anos,clasificacion d,2002-07-01,0,36,0,36,36
30601,ARQUE,estado nutricional en menores de 5 anos,clasificacion d,2002-07-01,43,73,43,73,116
71501,ASCENCION DE GUARAYOS,estado nutricional en menores de 5 anos,clasificacion d,2002-07-01,1,1,1,1,2
50802,ATOCHA,estado nutricional en menores de 5 anos,clasificacion d,2002-07-01,1,90,1,90,91
20503,AUCAPATA,estado nutricional en menores de 5 anos,clasificacion d,2002-07-01,4,2,4,2,6
20502,AYATA,estado nutricional en menores de 5 anos,clasificacion d,2002-07-01,16,3,16,3,19
21303,AYO AYO,estado nutricional en menores de 5 anos,clasificacion d,2002-07-01,28,20,28,20,48
30301,AYOPAYA (V. DE INDEPENDENCIA),estado nutricional en menores de 5 anos,clasificacion d,2002-07-01,110,106,110,106,216
10201,AZURDUY,estado nutricional en menores de 5 anos,clasificacion d,2002-07-01,82,101,82,101,183
21203,BATALLAS,estado nutricional en menores de 5 anos,clasificacion d,2002-07-01,21,19,21,19,40
80802,BAURES,estado nutricional en menores de 5 anos,clasificacion d,2002-07-01,17,31,17,31,48
41202,BELEN DE ANDAMARCA,estado nutricional en menores de 5 anos,clasificacion d,2002-07-01,0,2,0,2,2
50104,BELEN DE URMIRI,estado nutricional en menores de 5 anos,clasificacion d,2002-07-01,5,25,5,25,30
90104,BELLA FLOR,estado nutricional en menores de 5 anos,clasificacion d,2002-07-01,3,6,3,6,9
60202,BERMEJO,estado nutricional en menores de 5 anos,clasificacion d,2002-07-01,4,10,4,10,14
50301,BETANZOS,estado nutricional en menores de 5 anos,clasificacion d,2002-07-01,225,351,225,351,576
31501,BOLIVAR,estado nutricional en menores de 5 anos,clasificacion d,2002-07-01,63,70,63,70,133
90103,BOLPEBRA,estado nutricional en menores de 5 anos,clasificacion d,2002-07-01,2,7,2,7,9
70707,BOYUIBE,estado nutricional en menores de 5 anos,clasificacion d,2002-07-01,1,45,1,45,46
70703,CABEZAS,estado nutricional en menores de 5 anos,clasificacion d,2002-07-01,17,13,17,13,30
20905,CAIROMA,estado nutricional en menores de 5 anos,clasificacion d,2002-07-01,24,35,24,35,59
51102,"CAIZA ""D""",estado nutricional en menores de 5 anos,clasificacion d,2002-07-01,63,71,63,71,134
21003,CAJUATA,estado nutricional en menores de 5 anos,clasificacion d,2002-07-01,18,15,18,15,33
20303,CALACOTO,estado nutricional en menores de 5 anos,clasificacion d,2002-07-01,10,12,10,12,22
21304,CALAMARCA,estado nutricional en menores de 5 anos,clasificacion d,2002-07-01,31,24,31,24,55
10701,CAMARGO,estado nutricional en menores de 5 anos,clasificacion d,2002-07-01,40,85,40,85,125
10901,CAMATAQUI (C. VILLA ABECIA),estado nutricional en menores de 5 anos,clasificacion d,2002-07-01,26,34,26,34,60
70706,CAMIRI,estado nutricional en menores de 5 anos,clasificacion d,2002-07-01,24,53,24,53,77
30701,CAPINOTA,estado nutricional en menores de 5 anos,clasificacion d,2002-07-01,23,39,23,39,62
20302,CAQUIAVIRI,estado nutricional en menores de 5 anos,clasificacion d,2002-07-01,22,11,22,11,33
40102,CARACOLLO,estado nutricional en menores de 5 anos,clasificacion d,2002-07-01,30,40,30,40,70
22001,CARANAVI,estado nutricional en menores de 5 anos,clasificacion d,2002-07-01,175,148,175,148,323
41503,CARANGAS,estado nutricional en menores de 5 anos,clasificacion d,2002-07-01,0,3,0,3,3
60302,CARAPARI,estado nutricional en menores de 5 anos,clasificacion d,2002-07-01,27,42,27,42,69
50702,CARIPUYO,estado nutricional en menores de 5 anos,clasificacion d,2002-07-01,62,96,62,96,158
21902,CATACORA,estado nutricional en menores de 5 anos,clasificacion d,2002-07-01,2,2,2,2,4
21803,CHACARILLA,estado nutricional en menores de 5 anos,clasificacion d,2002-07-01,7,0,7,0,7
40201,CHALLAPATA,estado nutricional en menores de 5 anos,clasificacion d,2002-07-01,29,73,29,73,102
50302,CHAQUI,estado nutricional en menores de 5 anos,clasificacion d,2002-07-01,64,58,64,58,122
70702,CHARAGUA,estado nutricional en menores de 5 anos,clasificacion d,2002-07-01,33,171,33,171,204
20305,CHARAÃ‘A,estado nutricional en menores de 5 anos,clasificacion d,2002-07-01,17,16,17,16,33
50202,CHAYANTA,estado nutricional en menores de 5 anos,clasificacion d,2002-07-01,58,59,58,59,117
31204,CHIMORE,estado nutricional en menores de 5 anos,clasificacion d,2002-07-01,20,17,20,17,37
40903,CHIPAYA,estado nutricional en menores de 5 anos,clasificacion d,2002-07-01,0,3,0,3,3
40302,CHOQUE COTA,estado nutricional en menores de 5 anos,clasificacion d,2002-07-01,2,3,2,3,5
21101,CHULUMANI (V. DE LA LIBERTAD),estado nutricional en menores de 5 anos,clasificacion d,2002-07-01,11,28,11,28,39
20501,CHUMA,estado nutricional en menores de 5 anos,clasificacion d,2002-07-01,11,22,11,22,33
30801,CLIZA,estado nutricional en menores de 5 anos,clasificacion d,2002-07-01,4,17,4,17,21
90101,COBIJA,estado nutricional en menores de 5 anos,clasificacion d,2002-07-01,71,70,71,70,141
30101,COCHABAMBA,estado nutricional en menores de 5 anos,clasificacion d,2002-07-01,324,402,324,402,726
40902,COIPASA,estado nutricional en menores de 5 anos,clasificacion d,2002-07-01,0,2,0,2,2
30905,COLCAPIRHUA,estado nutricional en menores de 5 anos,clasificacion d,2002-07-01,28,96,28,96,124
50901,"COLCHA ""K""",estado nutricional en menores de 5 anos,clasificacion d,2002-07-01,39,70,39,70,109
21307,COLLANA,estado nutricional en menores de 5 anos,clasificacion d,2002-07-01,3,0,3,0,3
31002,COLOMI,estado nutricional en menores de 5 anos,clasificacion d,2002-07-01,22,40,22,40,62
50401,COLQUECHACA,estado nutricional en menores de 5 anos,clasificacion d,2002-07-01,124,71,124,71,195
21306,COLQUENCHA,estado nutricional en menores de 5 anos,clasificacion d,2002-07-01,27,22,27,22,49
21004,COLQUIRI,estado nutricional en menores de 5 anos,clasificacion d,2002-07-01,52,28,52,28,80
20304,COMANCHE,estado nutricional en menores de 5 anos,clasificacion d,2002-07-01,2,1,2,1,3
71301,COMARAPA,estado nutricional en menores de 5 anos,clasificacion d,2002-07-01,59,80,59,80,139
20605,COMBAYA,estado nutricional en menores de 5 anos,clasificacion d,2002-07-01,5,12,5,12,17
71101,CONCEPCION,estado nutricional en menores de 5 anos,clasificacion d,2002-07-01,15,12,15,12,27
21701,COPACABANA,estado nutricional en menores de 5 anos,clasificacion d,2002-07-01,14,45,14,45,59
21402,CORIPATA,estado nutricional en menores de 5 anos,clasificacion d,2002-07-01,7,11,7,11,18
20301,CORO CORO,estado nutricional en menores de 5 anos,clasificacion d,2002-07-01,26,18,26,18,44
21401,COROICO,estado nutricional en menores de 5 anos,clasificacion d,2002-07-01,24,25,24,25,49
40301,CORQUE,estado nutricional en menores de 5 anos,clasificacion d,2002-07-01,21,16,21,16,37
50601,COTAGAITA,estado nutricional en menores de 5 anos,clasificacion d,2002-07-01,70,149,70,149,219
70102,COTOCA,estado nutricional en menores de 5 anos,clasificacion d,2002-07-01,36,20,36,20,56
31405,CUCHUMUELA (V. G. VILLARROEL),estado nutricional en menores de 5 anos,clasificacion d,2002-07-01,16,14,16,14,30
70704,CUEVO,estado nutricional en menores de 5 anos,clasificacion d,2002-07-01,19,24,19,24,43
10902,CULPINA,estado nutricional en menores de 5 anos,clasificacion d,2002-07-01,182,183,182,183,365
40401,CURAHUARA DE CARANGAS,estado nutricional en menores de 5 anos,clasificacion d,2002-07-01,23,4,23,4,27
21602,CURVA,estado nutricional en menores de 5 anos,clasificacion d,2002-07-01,18,8,18,8,26
20804,DESAGUADERO,estado nutricional en menores de 5 anos,clasificacion d,2002-07-01,21,11,21,11,32
20105,EL ALTO,estado nutricional en menores de 5 anos,clasificacion d,2002-07-01,1746,1142,1746,1142,2888
40103,EL CHORO,estado nutricional en menores de 5 anos,clasificacion d,2002-07-01,2,5,2,5,7
71503,EL PUENTE(STC),estado nutricional en menores de 5 anos,clasificacion d,2002-07-01,2,91,2,91,93
60502,EL PUENTE(TJA),estado nutricional en menores de 5 anos,clasificacion d,2002-07-01,54,75,54,75,129
70105,EL TORNO,estado nutricional en menores de 5 anos,clasificacion d,2002-07-01,95,104,95,104,199
10405,EL VILLAR,estado nutricional en menores de 5 anos,clasificacion d,2002-07-01,55,119,55,119,174
60601,ENTRE RIOS,estado nutricional en menores de 5 anos,clasificacion d,2002-07-01,36,52,36,52,88
41101,EUCALIPTUS,estado nutricional en menores de 5 anos,clasificacion d,2002-07-01,6,7,6,7,13
90503,EUREKA (SANTOS MERCADO),estado nutricional en menores de 5 anos,clasificacion d,2002-07-01,0,1,0,1,1
80402,EXALTACION,estado nutricional en menores de 5 anos,clasificacion d,2002-07-01,2,16,2,16,18
90203,FILADELFIA,estado nutricional en menores de 5 anos,clasificacion d,2002-07-01,5,9,5,9,14
71002,GENERAL SAAVEDRA,estado nutricional en menores de 5 anos,clasificacion d,2002-07-01,85,88,85,88,173
21601,GRAL. J.J. PEREZ (CHARAZANI),estado nutricional en menores de 5 anos,clasificacion d,2002-07-01,13,26,13,26,39
20602,GUANAY,estado nutricional en menores de 5 anos,clasificacion d,2002-07-01,144,115,144,115,259
20802,GUAQUI,estado nutricional en menores de 5 anos,clasificacion d,2002-07-01,21,26,21,26,47
80202,GUAYARAMERIN,estado nutricional en menores de 5 anos,clasificacion d,2002-07-01,104,112,104,112,216
70705,GUTIERREZ,estado nutricional en menores de 5 anos,clasificacion d,2002-07-01,66,131,66,131,197
10502,HUACARETA,estado nutricional en menores de 5 anos,clasificacion d,2002-07-01,77,130,77,130,207
11002,HUACAYA (VILLA DE HUACAYA),estado nutricional en menores de 5 anos,clasificacion d,2002-07-01,13,18,13,18,31
40501,HUACHACALLA,estado nutricional en menores de 5 anos,clasificacion d,2002-07-01,1,2,1,2,3
40701,HUANUNI,estado nutricional en menores de 5 anos,clasificacion d,2002-07-01,80,74,80,74,154
80803,HUARACAJE,estado nutricional en menores de 5 anos,clasificacion d,2002-07-01,6,3,6,3,9
41601,HUAYLLAMARCA,estado nutricional en menores de 5 anos,clasificacion d,2002-07-01,24,24,24,24,48
21005,ICHOCA,estado nutricional en menores de 5 anos,clasificacion d,2002-07-01,4,8,4,8,12
10304,ICLA,estado nutricional en menores de 5 anos,clasificacion d,2002-07-01,115,177,115,177,292
10703,INCAHUASI,estado nutricional en menores de 5 anos,clasificacion d,2002-07-01,104,192,104,192,296
21001,INQUISIVI,estado nutricional en menores de 5 anos,clasificacion d,2002-07-01,35,78,35,78,113
21102,IRUPANA (VILLA DE LANZA),estado nutricional en menores de 5 anos,clasificacion d,2002-07-01,12,52,12,52,64
21501,IXIAMAS,estado nutricional en menores de 5 anos,clasificacion d,2002-07-01,30,43,30,43,73
21105,LA ASUNTA,estado nutricional en menores de 5 anos,clasificacion d,2002-07-01,53,36,53,36,89
70104,LA GUARDIA,estado nutricional en menores de 5 anos,clasificacion d,2002-07-01,49,33,49,33,82
20101,LA PAZ,estado nutricional en menores de 5 anos,clasificacion d,2002-07-01,1248,881,1248,881,2129
70701,LAGUNILLAS,estado nutricional en menores de 5 anos,clasificacion d,2002-07-01,39,29,39,29,68
21202,LAJA,estado nutricional en menores de 5 anos,clasificacion d,2002-07-01,13,23,13,23,36
10903,LAS CARRERAS,estado nutricional en menores de 5 anos,clasificacion d,2002-07-01,25,44,25,44,69
21006,LICOMA PAMPA,estado nutricional en menores de 5 anos,clasificacion d,2002-07-01,3,9,3,9,12
50203,LLALLAGUA,estado nutricional en menores de 5 anos,clasificacion d,2002-07-01,9,168,9,168,177
51401,LLICA,estado nutricional en menores de 5 anos,clasificacion d,2002-07-01,4,5,4,5,9
80601,LORETO,estado nutricional en menores de 5 anos,clasificacion d,2002-07-01,8,10,8,10,18
20901,LURIBAY,estado nutricional en menores de 5 anos,clasificacion d,2002-07-01,11,33,11,33,44
40702,MACHACAMARCA,estado nutricional en menores de 5 anos,clasificacion d,2002-07-01,6,15,6,15,21
11003,MACHARETI,estado nutricional en menores de 5 anos,clasificacion d,2002-07-01,35,79,35,79,114
80801,MAGDALENA,estado nutricional en menores de 5 anos,clasificacion d,2002-07-01,23,22,23,22,45
70903,MAIRANA,estado nutricional en menores de 5 anos,clasificacion d,2002-07-01,19,15,19,15,34
20103,MECAPACA,estado nutricional en menores de 5 anos,clasificacion d,2002-07-01,9,22,9,22,31
71003,MINEROS,estado nutricional en menores de 5 anos,clasificacion d,2002-07-01,87,59,87,59,146
31301,MIZQUE,estado nutricional en menores de 5 anos,clasificacion d,2002-07-01,29,38,29,38,67
20402,MOCOMOCO,estado nutricional en menores de 5 anos,clasificacion d,2002-07-01,41,34,41,34,75
51002,MOJINETE,estado nutricional en menores de 5 anos,clasificacion d,2002-07-01,0,10,0,10,10
10303,MOJOCOYA,estado nutricional en menores de 5 anos,clasificacion d,2002-07-01,77,113,77,113,190
10501,MONTEAGUDO,estado nutricional en menores de 5 anos,clasificacion d,2002-07-01,152,286,152,286,438
71001,MONTERO,estado nutricional en menores de 5 anos,clasificacion d,2002-07-01,150,211,150,211,361
70803,MORO MORO,estado nutricional en menores de 5 anos,clasificacion d,2002-07-01,9,14,9,14,23
30302,MOROCHATA,estado nutricional en menores de 5 anos,clasificacion d,2002-07-01,70,86,70,86,156
90401,NACEBE (SANTA ROSA DEL ABUNA),estado nutricional en menores de 5 anos,clasificacion d,2002-07-01,2,0,2,0,2
20307,NAZACARA DE PACAJES,estado nutricional en menores de 5 anos,clasificacion d,2002-07-01,6,1,6,1,7
90501,NUEVO MANOA (NUEVA ESPERANZA),estado nutricional en menores de 5 anos,clasificacion d,2002-07-01,3,5,3,5,8
50404,OCURI,estado nutricional en menores de 5 anos,clasificacion d,2002-07-01,87,55,87,55,142
70202,OKINAWA,estado nutricional en menores de 5 anos,clasificacion d,2002-07-01,7,45,7,45,52
30203,OMEREQUE,estado nutricional en menores de 5 anos,clasificacion d,2002-07-01,1,7,1,7,8
40101,ORURO,estado nutricional en menores de 5 anos,clasificacion d,2002-07-01,436,377,436,377,813
60201,PADCAYA,estado nutricional en menores de 5 anos,clasificacion d,2002-07-01,42,47,42,47,89
10401,PADILLA,estado nutricional en menores de 5 anos,clasificacion d,2002-07-01,120,234,120,234,354
70502,PAILON,estado nutricional en menores de 5 anos,clasificacion d,2002-07-01,33,18,33,18,51
20102,PALCA,estado nutricional en menores de 5 anos,clasificacion d,2002-07-01,33,34,33,34,67
21104,PALOS BLANCOS,estado nutricional en menores de 5 anos,clasificacion d,2002-07-01,58,95,58,95,153
40802,PAMPA AULLAGAS,estado nutricional en menores de 5 anos,clasificacion d,2002-07-01,17,16,17,16,33
70902,PAMPA GRANDE,estado nutricional en menores de 5 anos,clasificacion d,2002-07-01,11,7,11,7,18
21802,PAPEL PAMPA,estado nutricional en menores de 5 anos,clasificacion d,2002-07-01,4,11,4,11,15
30202,PASORAPA,estado nutricional en menores de 5 anos,clasificacion d,2002-07-01,12,23,12,23,35
21305,PATACAMAYA,estado nutricional en menores de 5 anos,clasificacion d,2002-07-01,37,22,37,22,59
40602,PAZÃ‘A,estado nutricional en menores de 5 anos,clasificacion d,2002-07-01,17,18,17,18,35
20702,PELECHUCO,estado nutricional en menores de 5 anos,clasificacion d,2002-07-01,14,32,14,32,46
50403,POCOATA,estado nutricional en menores de 5 anos,clasificacion d,2002-07-01,146,151,146,151,297
31203,POCONA,estado nutricional en menores de 5 anos,clasificacion d,2002-07-01,36,38,36,38,74
31202,POJO (CBBA),estado nutricional en menores de 5 anos,clasificacion d,2002-07-01,86,112,86,112,198
40601,POOPO,estado nutricional en menores de 5 anos,clasificacion d,2002-07-01,3,11,3,11,14
51203,PORCO,estado nutricional en menores de 5 anos,clasificacion d,2002-07-01,19,11,19,11,30
10103,POROMA,estado nutricional en menores de 5 anos,clasificacion d,2002-07-01,98,111,98,111,209
70103,PORONGO,estado nutricional en menores de 5 anos,clasificacion d,2002-07-01,13,12,13,12,25
70601,PORTACHUELO,estado nutricional en menores de 5 anos,clasificacion d,2002-07-01,25,24,25,24,49
90102,PORVENIR,estado nutricional en menores de 5 anos,clasificacion d,2002-07-01,0,3,0,3,3
70804,POSTRER VALLE,estado nutricional en menores de 5 anos,clasificacion d,2002-07-01,3,7,3,7,10
50101,POTOSI,estado nutricional en menores de 5 anos,clasificacion d,2002-07-01,552,430,552,430,982
10302,PRESTO,estado nutricional en menores de 5 anos,clasificacion d,2002-07-01,65,80,65,80,145
70805,PUCARA,estado nutricional en menores de 5 anos,clasificacion d,2002-07-01,0,3,0,3,3
21201,PUCARANI,estado nutricional en menores de 5 anos,clasificacion d,2002-07-01,9,53,9,53,62
20401,PUERTO ACOSTA,estado nutricional en menores de 5 anos,clasificacion d,2002-07-01,101,87,101,87,188
20403,PUERTO CARABUCO,estado nutricional en menores de 5 anos,clasificacion d,2002-07-01,42,69,42,69,111
90301,PUERTO GONZALO MORENO,estado nutricional en menores de 5 anos,clasificacion d,2002-07-01,17,12,17,12,29
21204,PUERTO PEREZ,estado nutricional en menores de 5 anos,clasificacion d,2002-07-01,15,7,15,7,22
71402,PUERTO QUIJARRO,estado nutricional en menores de 5 anos,clasificacion d,2002-07-01,29,16,29,16,45
90201,PUERTO RICO,estado nutricional en menores de 5 anos,clasificacion d,2002-07-01,10,9,10,9,19
80703,PUERTO SILES,estado nutricional en menores de 5 anos,clasificacion d,2002-07-01,0,13,0,13,13
71401,PUERTO SUAREZ,estado nutricional en menores de 5 anos,clasificacion d,2002-07-01,27,30,27,30,57
31205,PUERTO VILLARROEL,estado nutricional en menores de 5 anos,clasificacion d,2002-07-01,137,106,137,106,243
51101,PUNA,estado nutricional en menores de 5 anos,clasificacion d,2002-07-01,117,271,117,271,388
31401,PUNATA,estado nutricional en menores de 5 anos,clasificacion d,2002-07-01,57,26,57,26,83
20604,QUIABAYA,estado nutricional en menores de 5 anos,clasificacion d,2002-07-01,8,17,8,17,25
30901,QUILLACOLLO,estado nutricional en menores de 5 anos,clasificacion d,2002-07-01,21,35,21,35,56
21002,QUIME,estado nutricional en menores de 5 anos,clasificacion d,2002-07-01,19,19,19,19,38
70904,QUIRUSILLAS,estado nutricional en menores de 5 anos,clasificacion d,2002-07-01,1,3,1,3,4
50402,RAVELO,estado nutricional en menores de 5 anos,clasificacion d,2002-07-01,123,123,123,123,246
80201,RIBERALTA,estado nutricional en menores de 5 anos,clasificacion d,2002-07-01,361,216,361,216,577
70503,ROBORE,estado nutricional en menores de 5 anos,clasificacion d,2002-07-01,33,30,33,30,63
80304,RURRENABAQUE,estado nutricional en menores de 5 anos,clasificacion d,2002-07-01,24,17,24,17,41
40901,SABAYA,estado nutricional en menores de 5 anos,clasificacion d,2002-07-01,3,3,3,3,6
31001,SACABA,estado nutricional en menores de 5 anos,clasificacion d,2002-07-01,63,168,63,168,231
30404,SACABAMBA,estado nutricional en menores de 5 anos,clasificacion d,2002-07-01,0,72,0,72,72
50701,SACACA,estado nutricional en menores de 5 anos,clasificacion d,2002-07-01,143,224,143,224,367
71302,SAIPINA,estado nutricional en menores de 5 anos,clasificacion d,2002-07-01,8,7,8,7,15
40801,SALINAS DE GARCI MENDOZA,estado nutricional en menores de 5 anos,clasificacion d,2002-07-01,11,23,11,23,34
70901,SAMAIPATA,estado nutricional en menores de 5 anos,clasificacion d,2002-07-01,18,18,18,18,36
51601,SAN AGUSTIN,estado nutricional en menores de 5 anos,clasificacion d,2002-07-01,4,18,4,18,22
80602,SAN ANDRES,estado nutricional en menores de 5 anos,clasificacion d,2002-07-01,22,27,22,27,49
51003,SAN ANTONIO DE ESMORUCO,estado nutricional en menores de 5 anos,clasificacion d,2002-07-01,1,14,1,14,15
71105,SAN ANTONIO DE LOMERIO,estado nutricional en menores de 5 anos,clasificacion d,2002-07-01,91,109,91,109,200
31403,SAN BENITO,estado nutricional en menores de 5 anos,clasificacion d,2002-07-01,24,16,24,16,40
80302,SAN BORJA,estado nutricional en menores de 5 anos,clasificacion d,2002-07-01,75,51,75,51,126
21502,SAN BUENA VENTURA,estado nutricional en menores de 5 anos,clasificacion d,2002-07-01,32,53,32,53,85
80501,SAN IGNACIO,estado nutricional en menores de 5 anos,clasificacion d,2002-07-01,62,76,62,76,138
70301,SAN IGNACIO DE VELASCO,estado nutricional en menores de 5 anos,clasificacion d,2002-07-01,174,112,174,112,286
80102,SAN JAVIER(BNI),estado nutricional en menores de 5 anos,clasificacion d,2002-07-01,22,27,22,27,49
71102,SAN JAVIER(STC),estado nutricional en menores de 5 anos,clasificacion d,2002-07-01,43,51,43,51,94
80701,SAN JOAQUIN,estado nutricional en menores de 5 anos,clasificacion d,2002-07-01,12,14,12,14,26
70501,SAN JOSE DE CHIQUITOS,estado nutricional en menores de 5 anos,clasificacion d,2002-07-01,40,18,40,18,58
71104,SAN JULIAN,estado nutricional en menores de 5 anos,clasificacion d,2002-07-01,129,187,129,187,316
90302,SAN LORENZO(PND),estado nutricional en menores de 5 anos,clasificacion d,2002-07-01,6,33,6,33,39
60501,SAN LORENZO(TJA),estado nutricional en menores de 5 anos,clasificacion d,2002-07-01,66,82,66,82,148
10702,SAN LUCAS,estado nutricional en menores de 5 anos,clasificacion d,2002-07-01,289,346,289,346,635
71201,SAN MATIAS,estado nutricional en menores de 5 anos,clasificacion d,2002-07-01,0,6,0,6,6
70302,SAN MIGUEL DE VELASCO,estado nutricional en menores de 5 anos,clasificacion d,2002-07-01,61,125,61,125,186
51001,SAN PABLO DE LIPEZ,estado nutricional en menores de 5 anos,clasificacion d,2002-07-01,0,16,0,16,16
50501,SAN PEDRO DE BUENA VISTA,estado nutricional en menores de 5 anos,clasificacion d,2002-07-01,14,199,14,199,213
21801,SAN PEDRO DE CURAHUARA,estado nutricional en menores de 5 anos,clasificacion d,2002-07-01,9,18,9,18,27
50902,SAN PEDRO DE QUEMES,estado nutricional en menores de 5 anos,clasificacion d,2002-07-01,2,4,2,4,6
21702,SAN PEDRO DE TIQUINA,estado nutricional en menores de 5 anos,clasificacion d,2002-07-01,2,7,2,7,9
70303,SAN RAFAEL,estado nutricional en menores de 5 anos,clasificacion d,2002-07-01,35,31,35,31,66
80702,SAN RAMON,estado nutricional en menores de 5 anos,clasificacion d,2002-07-01,14,6,14,6,20
80401,SANTA ANA,estado nutricional en menores de 5 anos,clasificacion d,2002-07-01,30,37,30,37,67
70101,SANTA CRUZ DE LA SIERRA,estado nutricional en menores de 5 anos,clasificacion d,2002-07-01,497,251,497,251,748
80303,SANTA ROSA,estado nutricional en menores de 5 anos,clasificacion d,2002-07-01,16,7,16,7,23
70602,SANTA ROSA DEL SARA,estado nutricional en menores de 5 anos,clasificacion d,2002-07-01,10,22,10,22,32
41401,SANTIAGO DE HUARI,estado nutricional en menores de 5 anos,clasificacion d,2002-07-01,3,20,3,20,23
21901,SANTIAGO DE MACHACA,estado nutricional en menores de 5 anos,clasificacion d,2002-07-01,8,10,8,10,18
30702,SANTIVAÃ‘ES,estado nutricional en menores de 5 anos,clasificacion d,2002-07-01,28,10,28,10,38
40202,SANTUARIO DE QUILLACAS,estado nutricional en menores de 5 anos,clasificacion d,2002-07-01,5,18,5,18,23
20902,SAPAHAQUI,estado nutricional en menores de 5 anos,clasificacion d,2002-07-01,0,15,0,15,15
21301,SICA SICA (VILLA AROMA),estado nutricional en menores de 5 anos,clasificacion d,2002-07-01,31,19,31,19,50
30703,SICAYA,estado nutricional en menores de 5 anos,clasificacion d,2002-07-01,21,7,21,7,28
30902,SIPE SIPE,estado nutricional en menores de 5 anos,clasificacion d,2002-07-01,101,85,101,85,186
10403,SOPACHUY,estado nutricional en menores de 5 anos,clasificacion d,2002-07-01,48,59,48,59,107
20601,SORATA,estado nutricional en menores de 5 anos,clasificacion d,2002-07-01,40,62,40,62,102
10101,SUCRE,estado nutricional en menores de 5 anos,clasificacion d,2002-07-01,640,585,640,585,1225
31404,TACACHI,estado nutricional en menores de 5 anos,clasificacion d,2002-07-01,3,1,3,1,4
20603,TACACOMA,estado nutricional en menores de 5 anos,clasificacion d,2002-07-01,13,34,13,34,47
50303,TACOBAMBA,estado nutricional en menores de 5 anos,clasificacion d,2002-07-01,40,33,40,33,73
30602,TACOPAYA,estado nutricional en menores de 5 anos,clasificacion d,2002-07-01,20,38,20,38,58
51402,TAHUA,estado nutricional en menores de 5 anos,clasificacion d,2002-07-01,5,4,5,4,9
31101,TAPACARI,estado nutricional en menores de 5 anos,clasificacion d,2002-07-01,1,77,1,77,78
10601,TARABUCO,estado nutricional en menores de 5 anos,clasificacion d,2002-07-01,275,463,275,463,738
30401,TARATA,estado nutricional en menores de 5 anos,clasificacion d,2002-07-01,13,12,13,12,25
60101,TARIJA,estado nutricional en menores de 5 anos,clasificacion d,2002-07-01,195,143,195,143,338
10202,TARVITA,estado nutricional en menores de 5 anos,clasificacion d,2002-07-01,103,104,103,104,207
20803,TIAWANACU,estado nutricional en menores de 5 anos,clasificacion d,2002-07-01,30,18,30,18,48
50102,TINGUIPAYA,estado nutricional en menores de 5 anos,clasificacion d,2002-07-01,1,107,1,107,108
20606,TIPUANI,estado nutricional en menores de 5 anos,clasificacion d,2002-07-01,17,10,17,10,27
30903,TIQUIPAYA,estado nutricional en menores de 5 anos,clasificacion d,2002-07-01,40,53,40,53,93
31601,TIRAQUE (CBBA),estado nutricional en menores de 5 anos,clasificacion d,2002-07-01,30,184,30,184,214
21703,TITO YUPANQUI (PARQUIPUJIO),estado nutricional en menores de 5 anos,clasificacion d,2002-07-01,0,19,0,19,19
30802,TOCO,estado nutricional en menores de 5 anos,clasificacion d,2002-07-01,2,16,2,16,18
41502,TODOS SANTOS,estado nutricional en menores de 5 anos,clasificacion d,2002-07-01,0,1,0,1,1
30803,TOLATA,estado nutricional en menores de 5 anos,clasificacion d,2002-07-01,9,6,9,6,15
41001,TOLEDO,estado nutricional en menores de 5 anos,clasificacion d,2002-07-01,7,3,7,3,10
51202,TOMAVE,estado nutricional en menores de 5 anos,clasificacion d,2002-07-01,43,94,43,94,137
10402,TOMINA,estado nutricional en menores de 5 anos,clasificacion d,2002-07-01,104,197,104,197,301
50502,TORO TORO,estado nutricional en menores de 5 anos,clasificacion d,2002-07-01,17,45,17,45,62
31201,TOTORA(CBBA),estado nutricional en menores de 5 anos,clasificacion d,2002-07-01,73,63,73,63,136
41301,TOTORA(ORR),estado nutricional en menores de 5 anos,clasificacion d,2002-07-01,6,9,6,9,15
70802,TRIGAL,estado nutricional en menores de 5 anos,clasificacion d,2002-07-01,2,6,2,6,8
80101,TRINIDAD,estado nutricional en menores de 5 anos,clasificacion d,2002-07-01,170,205,170,205,375
50801,TUPIZA,estado nutricional en menores de 5 anos,clasificacion d,2002-07-01,12,387,12,387,399
40402,TURCO,estado nutricional en menores de 5 anos,clasificacion d,2002-07-01,10,8,10,8,18
21302,UMALA,estado nutricional en menores de 5 anos,clasificacion d,2002-07-01,6,22,6,22,28
50201,UNCIA,estado nutricional en menores de 5 anos,clasificacion d,2002-07-01,5,53,5,53,58
60401,URIONDO (A. CONCEPCION),estado nutricional en menores de 5 anos,clasificacion d,2002-07-01,30,25,30,25,55
71502,URUBICHA,estado nutricional en menores de 5 anos,clasificacion d,2002-07-01,0,8,0,8,8
51201,UYUNI,estado nutricional en menores de 5 anos,clasificacion d,2002-07-01,35,124,35,124,159
30502,VACAS,estado nutricional en menores de 5 anos,clasificacion d,2002-07-01,1,42,1,42,43
70801,VALLEGRANDE,estado nutricional en menores de 5 anos,clasificacion d,2002-07-01,16,65,16,65,81
20801,VIACHA,estado nutricional en menores de 5 anos,clasificacion d,2002-07-01,40,98,40,98,138
31302,VILA VILA,estado nutricional en menores de 5 anos,clasificacion d,2002-07-01,11,20,11,20,31
60303,VILLA MONTES,estado nutricional en menores de 5 anos,clasificacion d,2002-07-01,33,56,33,56,89
31402,VILLA RIVERO,estado nutricional en menores de 5 anos,clasificacion d,2002-07-01,17,15,17,15,32
10801,VILLA SERRANO,estado nutricional en menores de 5 anos,clasificacion d,2002-07-01,132,289,132,289,421
31003,VILLA TUNARI,estado nutricional en menores de 5 anos,clasificacion d,2002-07-01,139,118,139,118,257
11001,VILLA VACA GUZMAN (MUYUPAMPA),estado nutricional en menores de 5 anos,clasificacion d,2002-07-01,67,100,67,100,167
51501,VILLAZON,estado nutricional en menores de 5 anos,clasificacion d,2002-07-01,41,162,41,162,203
30904,VINTO,estado nutricional en menores de 5 anos,clasificacion d,2002-07-01,22,18,22,18,40
50602,VITICHI,estado nutricional en menores de 5 anos,clasificacion d,2002-07-01,14,78,14,78,92
20306,WALDO BALLIVIAN,estado nutricional en menores de 5 anos,clasificacion d,2002-07-01,9,3,9,3,12
70201,WARNES,estado nutricional en menores de 5 anos,clasificacion d,2002-07-01,103,75,103,75,178
20903,YACO,estado nutricional en menores de 5 anos,clasificacion d,2002-07-01,0,14,0,14,14
60301,YACUIBA,estado nutricional en menores de 5 anos,clasificacion d,2002-07-01,72,37,72,37,109
10602,YAMPARAEZ,estado nutricional en menores de 5 anos,clasificacion d,2002-07-01,147,248,147,248,395
21103,YANACACHI,estado nutricional en menores de 5 anos,clasificacion d,2002-07-01,3,7,3,7,10
50103,YOCALLA,estado nutricional en menores de 5 anos,clasificacion d,2002-07-01,2,57,2,57,59
10102,YOTALA,estado nutricional en menores de 5 anos,clasificacion d,2002-07-01,114,204,114,204,318
60402,YUNCHARA,estado nutricional en menores de 5 anos,clasificacion d,2002-07-01,7,18,7,18,25
10301,ZUDAÃ‘EZ,estado nutricional en menores de 5 anos,clasificacion d,2002-07-01,70,115,70,115,185
51302,ACACIO,estado nutricional en menores de 5 anos,clasificacion d,2002-08-01,38,97,38,97,135
20201,ACHACACHI,estado nutricional en menores de 5 anos,clasificacion d,2002-08-01,134,104,134,104,238
20104,ACHOCALLA,estado nutricional en menores de 5 anos,clasificacion d,2002-08-01,21,29,21,29,50
30201,AIQUILE,estado nutricional en menores de 5 anos,clasificacion d,2002-08-01,25,77,25,77,102
31303,ALALAY,estado nutricional en menores de 5 anos,clasificacion d,2002-08-01,12,10,12,10,22
10404,ALCALA,estado nutricional en menores de 5 anos,clasificacion d,2002-08-01,30,65,30,65,95
20202,ANCORAIMES,estado nutricional en menores de 5 anos,clasificacion d,2002-08-01,78,121,78,121,199
41201,ANDAMARCA,estado nutricional en menores de 5 anos,clasificacion d,2002-08-01,4,2,4,2,6
30402,ANZALDO,estado nutricional en menores de 5 anos,clasificacion d,2002-08-01,3,69,3,69,72
20701,APOLO,estado nutricional en menores de 5 anos,clasificacion d,2002-08-01,13,38,13,38,51
51301,ARAMPAMPA,estado nutricional en menores de 5 anos,clasificacion d,2002-08-01,36,41,36,41,77
30403,ARBIETO,estado nutricional en menores de 5 anos,clasificacion d,2002-08-01,7,12,7,12,19
30601,ARQUE,estado nutricional en menores de 5 anos,clasificacion d,2002-08-01,42,57,42,57,99
71501,ASCENCION DE GUARAYOS,estado nutricional en menores de 5 anos,clasificacion d,2002-08-01,170,240,170,240,410
50802,ATOCHA,estado nutricional en menores de 5 anos,clasificacion d,2002-08-01,0,14,0,14,14
20503,AUCAPATA,estado nutricional en menores de 5 anos,clasificacion d,2002-08-01,38,8,38,8,46
20502,AYATA,estado nutricional en menores de 5 anos,clasificacion d,2002-08-01,36,30,36,30,66
21303,AYO AYO,estado nutricional en menores de 5 anos,clasificacion d,2002-08-01,15,12,15,12,27
30301,AYOPAYA (V. DE INDEPENDENCIA),estado nutricional en menores de 5 anos,clasificacion d,2002-08-01,117,170,117,170,287
10201,AZURDUY,estado nutricional en menores de 5 anos,clasificacion d,2002-08-01,140,166,140,166,306
21203,BATALLAS,estado nutricional en menores de 5 anos,clasificacion d,2002-08-01,23,38,23,38,61
80802,BAURES,estado nutricional en menores de 5 anos,clasificacion d,2002-08-01,15,28,15,28,43
41202,BELEN DE ANDAMARCA,estado nutricional en menores de 5 anos,clasificacion d,2002-08-01,1,2,1,2,3
50104,BELEN DE URMIRI,estado nutricional en menores de 5 anos,clasificacion d,2002-08-01,2,10,2,10,12
90104,BELLA FLOR,estado nutricional en menores de 5 anos,clasificacion d,2002-08-01,3,0,3,0,3
60202,BERMEJO,estado nutricional en menores de 5 anos,clasificacion d,2002-08-01,1,12,1,12,13
50301,BETANZOS,estado nutricional en menores de 5 anos,clasificacion d,2002-08-01,147,206,147,206,353
31501,BOLIVAR,estado nutricional en menores de 5 anos,clasificacion d,2002-08-01,32,72,32,72,104
90103,BOLPEBRA,estado nutricional en menores de 5 anos,clasificacion d,2002-08-01,3,64,3,64,67
70707,BOYUIBE,estado nutricional en menores de 5 anos,clasificacion d,2002-08-01,0,23,0,23,23
70703,CABEZAS,estado nutricional en menores de 5 anos,clasificacion d,2002-08-01,37,27,37,27,64
20905,CAIROMA,estado nutricional en menores de 5 anos,clasificacion d,2002-08-01,50,31,50,31,81
51102,"CAIZA ""D""",estado nutricional en menores de 5 anos,clasificacion d,2002-08-01,94,83,94,83,177
21003,CAJUATA,estado nutricional en menores de 5 anos,clasificacion d,2002-08-01,29,30,29,30,59
20303,CALACOTO,estado nutricional en menores de 5 anos,clasificacion d,2002-08-01,16,22,16,22,38
21304,CALAMARCA,estado nutricional en menores de 5 anos,clasificacion d,2002-08-01,64,60,64,60,124
10701,CAMARGO,estado nutricional en menores de 5 anos,clasificacion d,2002-08-01,26,125,26,125,151
10901,CAMATAQUI (C. VILLA ABECIA),estado nutricional en menores de 5 anos,clasificacion d,2002-08-01,35,36,35,36,71
70706,CAMIRI,estado nutricional en menores de 5 anos,clasificacion d,2002-08-01,65,65,65,65,130
30701,CAPINOTA,estado nutricional en menores de 5 anos,clasificacion d,2002-08-01,25,63,25,63,88
20302,CAQUIAVIRI,estado nutricional en menores de 5 anos,clasificacion d,2002-08-01,26,31,26,31,57
40102,CARACOLLO,estado nutricional en menores de 5 anos,clasificacion d,2002-08-01,29,56,29,56,85
22001,CARANAVI,estado nutricional en menores de 5 anos,clasificacion d,2002-08-01,160,215,160,215,375
41503,CARANGAS,estado nutricional en menores de 5 anos,clasificacion d,2002-08-01,1,2,1,2,3
60302,CARAPARI,estado nutricional en menores de 5 anos,clasificacion d,2002-08-01,18,57,18,57,75
50702,CARIPUYO,estado nutricional en menores de 5 anos,clasificacion d,2002-08-01,60,118,60,118,178
21902,CATACORA,estado nutricional en menores de 5 anos,clasificacion d,2002-08-01,7,7,7,7,14
40201,CHALLAPATA,estado nutricional en menores de 5 anos,clasificacion d,2002-08-01,59,94,59,94,153
50302,CHAQUI,estado nutricional en menores de 5 anos,clasificacion d,2002-08-01,50,61,50,61,111
70702,CHARAGUA,estado nutricional en menores de 5 anos,clasificacion d,2002-08-01,35,172,35,172,207
20305,CHARAÃ‘A,estado nutricional en menores de 5 anos,clasificacion d,2002-08-01,9,11,9,11,20
31204,CHIMORE,estado nutricional en menores de 5 anos,clasificacion d,2002-08-01,7,10,7,10,17
40302,CHOQUE COTA,estado nutricional en menores de 5 anos,clasificacion d,2002-08-01,5,0,5,0,5
21101,CHULUMANI (V. DE LA LIBERTAD),estado nutricional en menores de 5 anos,clasificacion d,2002-08-01,7,19,7,19,26
20501,CHUMA,estado nutricional en menores de 5 anos,clasificacion d,2002-08-01,33,30,33,30,63
30801,CLIZA,estado nutricional en menores de 5 anos,clasificacion d,2002-08-01,7,13,7,13,20
90101,COBIJA,estado nutricional en menores de 5 anos,clasificacion d,2002-08-01,89,76,89,76,165
30101,COCHABAMBA,estado nutricional en menores de 5 anos,clasificacion d,2002-08-01,334,329,334,329,663
40902,COIPASA,estado nutricional en menores de 5 anos,clasificacion d,2002-08-01,0,2,0,2,2
30905,COLCAPIRHUA,estado nutricional en menores de 5 anos,clasificacion d,2002-08-01,69,32,69,32,101
50901,"COLCHA ""K""",estado nutricional en menores de 5 anos,clasificacion d,2002-08-01,46,49,46,49,95
21307,COLLANA,estado nutricional en menores de 5 anos,clasificacion d,2002-08-01,5,1,5,1,6
31002,COLOMI,estado nutricional en menores de 5 anos,clasificacion d,2002-08-01,9,81,9,81,90
50401,COLQUECHACA,estado nutricional en menores de 5 anos,clasificacion d,2002-08-01,133,108,133,108,241
21306,COLQUENCHA,estado nutricional en menores de 5 anos,clasificacion d,2002-08-01,28,28,28,28,56
21004,COLQUIRI,estado nutricional en menores de 5 anos,clasificacion d,2002-08-01,119,103,119,103,222
20304,COMANCHE,estado nutricional en menores de 5 anos,clasificacion d,2002-08-01,14,21,14,21,35
71301,COMARAPA,estado nutricional en menores de 5 anos,clasificacion d,2002-08-01,54,61,54,61,115
20605,COMBAYA,estado nutricional en menores de 5 anos,clasificacion d,2002-08-01,11,16,11,16,27
71101,CONCEPCION,estado nutricional en menores de 5 anos,clasificacion d,2002-08-01,8,0,8,0,8
21701,COPACABANA,estado nutricional en menores de 5 anos,clasificacion d,2002-08-01,19,13,19,13,32
21402,CORIPATA,estado nutricional en menores de 5 anos,clasificacion d,2002-08-01,10,8,10,8,18
20301,CORO CORO,estado nutricional en menores de 5 anos,clasificacion d,2002-08-01,46,39,46,39,85
21401,COROICO,estado nutricional en menores de 5 anos,clasificacion d,2002-08-01,13,10,13,10,23
40301,CORQUE,estado nutricional en menores de 5 anos,clasificacion d,2002-08-01,21,4,21,4,25
50601,COTAGAITA,estado nutricional en menores de 5 anos,clasificacion d,2002-08-01,87,129,87,129,216
70102,COTOCA,estado nutricional en menores de 5 anos,clasificacion d,2002-08-01,46,19,46,19,65
70704,CUEVO,estado nutricional en menores de 5 anos,clasificacion d,2002-08-01,23,21,23,21,44
10902,CULPINA,estado nutricional en menores de 5 anos,clasificacion d,2002-08-01,179,255,179,255,434
40401,CURAHUARA DE CARANGAS,estado nutricional en menores de 5 anos,clasificacion d,2002-08-01,22,16,22,16,38
21602,CURVA,estado nutricional en menores de 5 anos,clasificacion d,2002-08-01,14,7,14,7,21
20804,DESAGUADERO,estado nutricional en menores de 5 anos,clasificacion d,2002-08-01,20,16,20,16,36
20105,EL ALTO,estado nutricional en menores de 5 anos,clasificacion d,2002-08-01,1438,1179,1438,1179,2617
40103,EL CHORO,estado nutricional en menores de 5 anos,clasificacion d,2002-08-01,4,3,4,3,7
71503,EL PUENTE(STC),estado nutricional en menores de 5 anos,clasificacion d,2002-08-01,2,89,2,89,91
60502,EL PUENTE(TJA),estado nutricional en menores de 5 anos,clasificacion d,2002-08-01,28,56,28,56,84
70105,EL TORNO,estado nutricional en menores de 5 anos,clasificacion d,2002-08-01,53,40,53,40,93
10405,EL VILLAR,estado nutricional en menores de 5 anos,clasificacion d,2002-08-01,47,138,47,138,185
60601,ENTRE RIOS,estado nutricional en menores de 5 anos,clasificacion d,2002-08-01,39,64,39,64,103
40502,ESCARA,estado nutricional en menores de 5 anos,clasificacion d,2002-08-01,0,1,0,1,1
41101,EUCALIPTUS,estado nutricional en menores de 5 anos,clasificacion d,2002-08-01,25,42,25,42,67
90503,EUREKA (SANTOS MERCADO),estado nutricional en menores de 5 anos,clasificacion d,2002-08-01,3,3,3,3,6
80402,EXALTACION,estado nutricional en menores de 5 anos,clasificacion d,2002-08-01,5,29,5,29,34
90203,FILADELFIA,estado nutricional en menores de 5 anos,clasificacion d,2002-08-01,4,4,4,4,8
71002,GENERAL SAAVEDRA,estado nutricional en menores de 5 anos,clasificacion d,2002-08-01,63,64,63,64,127
21601,GRAL. J.J. PEREZ (CHARAZANI),estado nutricional en menores de 5 anos,clasificacion d,2002-08-01,34,48,34,48,82
20602,GUANAY,estado nutricional en menores de 5 anos,clasificacion d,2002-08-01,141,139,141,139,280
20802,GUAQUI,estado nutricional en menores de 5 anos,clasificacion d,2002-08-01,15,18,15,18,33
80202,GUAYARAMERIN,estado nutricional en menores de 5 anos,clasificacion d,2002-08-01,92,145,92,145,237
70705,GUTIERREZ,estado nutricional en menores de 5 anos,clasificacion d,2002-08-01,106,153,106,153,259
10502,HUACARETA,estado nutricional en menores de 5 anos,clasificacion d,2002-08-01,54,114,54,114,168
11002,HUACAYA (VILLA DE HUACAYA),estado nutricional en menores de 5 anos,clasificacion d,2002-08-01,13,31,13,31,44
40501,HUACHACALLA,estado nutricional en menores de 5 anos,clasificacion d,2002-08-01,3,2,3,2,5
40701,HUANUNI,estado nutricional en menores de 5 anos,clasificacion d,2002-08-01,82,37,82,37,119
80803,HUARACAJE,estado nutricional en menores de 5 anos,clasificacion d,2002-08-01,2,1,2,1,3
41601,HUAYLLAMARCA,estado nutricional en menores de 5 anos,clasificacion d,2002-08-01,30,14,30,14,44
21005,ICHOCA,estado nutricional en menores de 5 anos,clasificacion d,2002-08-01,27,36,27,36,63
10304,ICLA,estado nutricional en menores de 5 anos,clasificacion d,2002-08-01,138,219,138,219,357
10703,INCAHUASI,estado nutricional en menores de 5 anos,clasificacion d,2002-08-01,110,164,110,164,274
21001,INQUISIVI,estado nutricional en menores de 5 anos,clasificacion d,2002-08-01,54,116,54,116,170
21102,IRUPANA (VILLA DE LANZA),estado nutricional en menores de 5 anos,clasificacion d,2002-08-01,9,40,9,40,49
21501,IXIAMAS,estado nutricional en menores de 5 anos,clasificacion d,2002-08-01,30,30,30,30,60
21105,LA ASUNTA,estado nutricional en menores de 5 anos,clasificacion d,2002-08-01,21,45,21,45,66
70104,LA GUARDIA,estado nutricional en menores de 5 anos,clasificacion d,2002-08-01,58,45,58,45,103
20101,LA PAZ,estado nutricional en menores de 5 anos,clasificacion d,2002-08-01,989,852,989,852,1841
70701,LAGUNILLAS,estado nutricional en menores de 5 anos,clasificacion d,2002-08-01,25,33,25,33,58
21202,LAJA,estado nutricional en menores de 5 anos,clasificacion d,2002-08-01,19,12,19,12,31
10903,LAS CARRERAS,estado nutricional en menores de 5 anos,clasificacion d,2002-08-01,33,53,33,53,86
21006,LICOMA PAMPA,estado nutricional en menores de 5 anos,clasificacion d,2002-08-01,15,14,15,14,29
50203,LLALLAGUA,estado nutricional en menores de 5 anos,clasificacion d,2002-08-01,0,5,0,5,5
51401,LLICA,estado nutricional en menores de 5 anos,clasificacion d,2002-08-01,14,9,14,9,23
80601,LORETO,estado nutricional en menores de 5 anos,clasificacion d,2002-08-01,1,10,1,10,11
20901,LURIBAY,estado nutricional en menores de 5 anos,clasificacion d,2002-08-01,30,23,30,23,53
40702,MACHACAMARCA,estado nutricional en menores de 5 anos,clasificacion d,2002-08-01,7,20,7,20,27
11003,MACHARETI,estado nutricional en menores de 5 anos,clasificacion d,2002-08-01,61,98,61,98,159
80801,MAGDALENA,estado nutricional en menores de 5 anos,clasificacion d,2002-08-01,14,40,14,40,54
70903,MAIRANA,estado nutricional en menores de 5 anos,clasificacion d,2002-08-01,19,15,19,15,34
20103,MECAPACA,estado nutricional en menores de 5 anos,clasificacion d,2002-08-01,13,18,13,18,31
71003,MINEROS,estado nutricional en menores de 5 anos,clasificacion d,2002-08-01,36,37,36,37,73
31301,MIZQUE,estado nutricional en menores de 5 anos,clasificacion d,2002-08-01,34,24,34,24,58
20402,MOCOMOCO,estado nutricional en menores de 5 anos,clasificacion d,2002-08-01,106,102,106,102,208
10303,MOJOCOYA,estado nutricional en menores de 5 anos,clasificacion d,2002-08-01,87,112,87,112,199
10501,MONTEAGUDO,estado nutricional en menores de 5 anos,clasificacion d,2002-08-01,112,180,112,180,292
71001,MONTERO,estado nutricional en menores de 5 anos,clasificacion d,2002-08-01,126,112,126,112,238
70803,MORO MORO,estado nutricional en menores de 5 anos,clasificacion d,2002-08-01,7,13,7,13,20
30302,MOROCHATA,estado nutricional en menores de 5 anos,clasificacion d,2002-08-01,65,75,65,75,140
90401,NACEBE (SANTA ROSA DEL ABUNA),estado nutricional en menores de 5 anos,clasificacion d,2002-08-01,5,12,5,12,17
20307,NAZACARA DE PACAJES,estado nutricional en menores de 5 anos,clasificacion d,2002-08-01,5,1,5,1,6
90501,NUEVO MANOA (NUEVA ESPERANZA),estado nutricional en menores de 5 anos,clasificacion d,2002-08-01,0,2,0,2,2
50404,OCURI,estado nutricional en menores de 5 anos,clasificacion d,2002-08-01,82,114,82,114,196
70202,OKINAWA,estado nutricional en menores de 5 anos,clasificacion d,2002-08-01,9,25,9,25,34
30203,OMEREQUE,estado nutricional en menores de 5 anos,clasificacion d,2002-08-01,1,33,1,33,34
40101,ORURO,estado nutricional en menores de 5 anos,clasificacion d,2002-08-01,488,346,488,346,834
60201,PADCAYA,estado nutricional en menores de 5 anos,clasificacion d,2002-08-01,25,53,25,53,78
10401,PADILLA,estado nutricional en menores de 5 anos,clasificacion d,2002-08-01,150,264,150,264,414
70502,PAILON,estado nutricional en menores de 5 anos,clasificacion d,2002-08-01,34,36,34,36,70
20102,PALCA,estado nutricional en menores de 5 anos,clasificacion d,2002-08-01,36,34,36,34,70
21104,PALOS BLANCOS,estado nutricional en menores de 5 anos,clasificacion d,2002-08-01,55,166,55,166,221
40802,PAMPA AULLAGAS,estado nutricional en menores de 5 anos,clasificacion d,2002-08-01,14,25,14,25,39
70902,PAMPA GRANDE,estado nutricional en menores de 5 anos,clasificacion d,2002-08-01,12,18,12,18,30
21802,PAPEL PAMPA,estado nutricional en menores de 5 anos,clasificacion d,2002-08-01,6,10,6,10,16
30202,PASORAPA,estado nutricional en menores de 5 anos,clasificacion d,2002-08-01,29,31,29,31,60
21305,PATACAMAYA,estado nutricional en menores de 5 anos,clasificacion d,2002-08-01,29,29,29,29,58
40602,PAZÃ‘A,estado nutricional en menores de 5 anos,clasificacion d,2002-08-01,16,11,16,11,27
20702,PELECHUCO,estado nutricional en menores de 5 anos,clasificacion d,2002-08-01,24,23,24,23,47
50403,POCOATA,estado nutricional en menores de 5 anos,clasificacion d,2002-08-01,138,133,138,133,271
31203,POCONA,estado nutricional en menores de 5 anos,clasificacion d,2002-08-01,43,59,43,59,102
31202,POJO (CBBA),estado nutricional en menores de 5 anos,clasificacion d,2002-08-01,180,155,180,155,335
40601,POOPO,estado nutricional en menores de 5 anos,clasificacion d,2002-08-01,14,24,14,24,38
51203,PORCO,estado nutricional en menores de 5 anos,clasificacion d,2002-08-01,16,16,16,16,32
10103,POROMA,estado nutricional en menores de 5 anos,clasificacion d,2002-08-01,113,132,113,132,245
70103,PORONGO,estado nutricional en menores de 5 anos,clasificacion d,2002-08-01,21,20,21,20,41
70601,PORTACHUELO,estado nutricional en menores de 5 anos,clasificacion d,2002-08-01,42,34,42,34,76
90102,PORVENIR,estado nutricional en menores de 5 anos,clasificacion d,2002-08-01,7,5,7,5,12
70804,POSTRER VALLE,estado nutricional en menores de 5 anos,clasificacion d,2002-08-01,1,7,1,7,8
50101,POTOSI,estado nutricional en menores de 5 anos,clasificacion d,2002-08-01,515,438,515,438,953
10302,PRESTO,estado nutricional en menores de 5 anos,clasificacion d,2002-08-01,73,70,73,70,143
70805,PUCARA,estado nutricional en menores de 5 anos,clasificacion d,2002-08-01,2,10,2,10,12
21201,PUCARANI,estado nutricional en menores de 5 anos,clasificacion d,2002-08-01,22,40,22,40,62
20401,PUERTO ACOSTA,estado nutricional en menores de 5 anos,clasificacion d,2002-08-01,85,86,85,86,171
20403,PUERTO CARABUCO,estado nutricional en menores de 5 anos,clasificacion d,2002-08-01,56,83,56,83,139
90301,PUERTO GONZALO MORENO,estado nutricional en menores de 5 anos,clasificacion d,2002-08-01,13,4,13,4,17
21204,PUERTO PEREZ,estado nutricional en menores de 5 anos,clasificacion d,2002-08-01,8,13,8,13,21
71402,PUERTO QUIJARRO,estado nutricional en menores de 5 anos,clasificacion d,2002-08-01,36,11,36,11,47
90201,PUERTO RICO,estado nutricional en menores de 5 anos,clasificacion d,2002-08-01,8,14,8,14,22
80703,PUERTO SILES,estado nutricional en menores de 5 anos,clasificacion d,2002-08-01,0,2,0,2,2
71401,PUERTO SUAREZ,estado nutricional en menores de 5 anos,clasificacion d,2002-08-01,47,25,47,25,72
31205,PUERTO VILLARROEL,estado nutricional en menores de 5 anos,clasificacion d,2002-08-01,138,83,138,83,221
51101,PUNA,estado nutricional en menores de 5 anos,clasificacion d,2002-08-01,76,108,76,108,184
20604,QUIABAYA,estado nutricional en menores de 5 anos,clasificacion d,2002-08-01,22,33,22,33,55
30901,QUILLACOLLO,estado nutricional en menores de 5 anos,clasificacion d,2002-08-01,54,44,54,44,98
21002,QUIME,estado nutricional en menores de 5 anos,clasificacion d,2002-08-01,56,48,56,48,104
70904,QUIRUSILLAS,estado nutricional en menores de 5 anos,clasificacion d,2002-08-01,2,1,2,1,3
50402,RAVELO,estado nutricional en menores de 5 anos,clasificacion d,2002-08-01,161,155,161,155,316
80301,REYES,estado nutricional en menores de 5 anos,clasificacion d,2002-08-01,30,31,30,31,61
80201,RIBERALTA,estado nutricional en menores de 5 anos,clasificacion d,2002-08-01,391,248,391,248,639
70503,ROBORE,estado nutricional en menores de 5 anos,clasificacion d,2002-08-01,16,22,16,22,38
80304,RURRENABAQUE,estado nutricional en menores de 5 anos,clasificacion d,2002-08-01,17,12,17,12,29
40901,SABAYA,estado nutricional en menores de 5 anos,clasificacion d,2002-08-01,3,1,3,1,4
31001,SACABA,estado nutricional en menores de 5 anos,clasificacion d,2002-08-01,60,48,60,48,108
30404,SACABAMBA,estado nutricional en menores de 5 anos,clasificacion d,2002-08-01,0,98,0,98,98
50701,SACACA,estado nutricional en menores de 5 anos,clasificacion d,2002-08-01,146,231,146,231,377
71302,SAIPINA,estado nutricional en menores de 5 anos,clasificacion d,2002-08-01,11,17,11,17,28
40801,SALINAS DE GARCI MENDOZA,estado nutricional en menores de 5 anos,clasificacion d,2002-08-01,14,16,14,16,30
70901,SAMAIPATA,estado nutricional en menores de 5 anos,clasificacion d,2002-08-01,37,20,37,20,57
51601,SAN AGUSTIN,estado nutricional en menores de 5 anos,clasificacion d,2002-08-01,7,3,7,3,10
80602,SAN ANDRES,estado nutricional en menores de 5 anos,clasificacion d,2002-08-01,22,31,22,31,53
71105,SAN ANTONIO DE LOMERIO,estado nutricional en menores de 5 anos,clasificacion d,2002-08-01,76,129,76,129,205
31403,SAN BENITO,estado nutricional en menores de 5 anos,clasificacion d,2002-08-01,0,5,0,5,5
80302,SAN BORJA,estado nutricional en menores de 5 anos,clasificacion d,2002-08-01,83,92,83,92,175
21502,SAN BUENA VENTURA,estado nutricional en menores de 5 anos,clasificacion d,2002-08-01,26,15,26,15,41
80501,SAN IGNACIO,estado nutricional en menores de 5 anos,clasificacion d,2002-08-01,86,132,86,132,218
70301,SAN IGNACIO DE VELASCO,estado nutricional en menores de 5 anos,clasificacion d,2002-08-01,177,126,177,126,303
80102,SAN JAVIER(BNI),estado nutricional en menores de 5 anos,clasificacion d,2002-08-01,12,30,12,30,42
71102,SAN JAVIER(STC),estado nutricional en menores de 5 anos,clasificacion d,2002-08-01,36,40,36,40,76
80701,SAN JOAQUIN,estado nutricional en menores de 5 anos,clasificacion d,2002-08-01,3,19,3,19,22
70501,SAN JOSE DE CHIQUITOS,estado nutricional en menores de 5 anos,clasificacion d,2002-08-01,36,20,36,20,56
71104,SAN JULIAN,estado nutricional en menores de 5 anos,clasificacion d,2002-08-01,157,194,157,194,351
90302,SAN LORENZO(PND),estado nutricional en menores de 5 anos,clasificacion d,2002-08-01,0,5,0,5,5
60501,SAN LORENZO(TJA),estado nutricional en menores de 5 anos,clasificacion d,2002-08-01,7,24,7,24,31
10702,SAN LUCAS,estado nutricional en menores de 5 anos,clasificacion d,2002-08-01,330,343,330,343,673
71201,SAN MATIAS,estado nutricional en menores de 5 anos,clasificacion d,2002-08-01,59,29,59,29,88
70302,SAN MIGUEL DE VELASCO,estado nutricional en menores de 5 anos,clasificacion d,2002-08-01,44,52,44,52,96
50501,SAN PEDRO DE BUENA VISTA,estado nutricional en menores de 5 anos,clasificacion d,2002-08-01,122,324,122,324,446
21801,SAN PEDRO DE CURAHUARA,estado nutricional en menores de 5 anos,clasificacion d,2002-08-01,10,12,10,12,22
50902,SAN PEDRO DE QUEMES,estado nutricional en menores de 5 anos,clasificacion d,2002-08-01,1,2,1,2,3
21702,SAN PEDRO DE TIQUINA,estado nutricional en menores de 5 anos,clasificacion d,2002-08-01,0,7,0,7,7
70303,SAN RAFAEL,estado nutricional en menores de 5 anos,clasificacion d,2002-08-01,42,42,42,42,84
80702,SAN RAMON,estado nutricional en menores de 5 anos,clasificacion d,2002-08-01,6,14,6,14,20
80401,SANTA ANA,estado nutricional en menores de 5 anos,clasificacion d,2002-08-01,19,9,19,9,28
70101,SANTA CRUZ DE LA SIERRA,estado nutricional en menores de 5 anos,clasificacion d,2002-08-01,637,402,637,402,1039
80303,SANTA ROSA,estado nutricional en menores de 5 anos,clasificacion d,2002-08-01,12,7,12,7,19
70602,SANTA ROSA DEL SARA,estado nutricional en menores de 5 anos,clasificacion d,2002-08-01,9,5,9,5,14
20308,SANTIAGO DE CALLAPA,estado nutricional en menores de 5 anos,clasificacion d,2002-08-01,19,12,19,12,31
41401,SANTIAGO DE HUARI,estado nutricional en menores de 5 anos,clasificacion d,2002-08-01,8,22,8,22,30
21901,SANTIAGO DE MACHACA,estado nutricional en menores de 5 anos,clasificacion d,2002-08-01,22,15,22,15,37
30702,SANTIVAÃ‘ES,estado nutricional en menores de 5 anos,clasificacion d,2002-08-01,18,17,18,17,35
40202,SANTUARIO DE QUILLACAS,estado nutricional en menores de 5 anos,clasificacion d,2002-08-01,4,10,4,10,14
20902,SAPAHAQUI,estado nutricional en menores de 5 anos,clasificacion d,2002-08-01,7,13,7,13,20
21301,SICA SICA (VILLA AROMA),estado nutricional en menores de 5 anos,clasificacion d,2002-08-01,38,25,38,25,63
30703,SICAYA,estado nutricional en menores de 5 anos,clasificacion d,2002-08-01,16,32,16,32,48
30902,SIPE SIPE,estado nutricional en menores de 5 anos,clasificacion d,2002-08-01,111,97,111,97,208
10403,SOPACHUY,estado nutricional en menores de 5 anos,clasificacion d,2002-08-01,49,60,49,60,109
20601,SORATA,estado nutricional en menores de 5 anos,clasificacion d,2002-08-01,35,53,35,53,88
10101,SUCRE,estado nutricional en menores de 5 anos,clasificacion d,2002-08-01,662,777,662,777,1439
20603,TACACOMA,estado nutricional en menores de 5 anos,clasificacion d,2002-08-01,20,24,20,24,44
50303,TACOBAMBA,estado nutricional en menores de 5 anos,clasificacion d,2002-08-01,60,64,60,64,124
30602,TACOPAYA,estado nutricional en menores de 5 anos,clasificacion d,2002-08-01,23,32,23,32,55
51402,TAHUA,estado nutricional en menores de 5 anos,clasificacion d,2002-08-01,7,4,7,4,11
31101,TAPACARI,estado nutricional en menores de 5 anos,clasificacion d,2002-08-01,50,163,50,163,213
10601,TARABUCO,estado nutricional en menores de 5 anos,clasificacion d,2002-08-01,261,461,261,461,722
30401,TARATA,estado nutricional en menores de 5 anos,clasificacion d,2002-08-01,35,25,35,25,60
60101,TARIJA,estado nutricional en menores de 5 anos,clasificacion d,2002-08-01,210,183,210,183,393
10202,TARVITA,estado nutricional en menores de 5 anos,clasificacion d,2002-08-01,105,167,105,167,272
20803,TIAWANACU,estado nutricional en menores de 5 anos,clasificacion d,2002-08-01,24,17,24,17,41
50102,TINGUIPAYA,estado nutricional en menores de 5 anos,clasificacion d,2002-08-01,24,89,24,89,113
20606,TIPUANI,estado nutricional en menores de 5 anos,clasificacion d,2002-08-01,9,9,9,9,18
30903,TIQUIPAYA,estado nutricional en menores de 5 anos,clasificacion d,2002-08-01,34,123,34,123,157
31601,TIRAQUE (CBBA),estado nutricional en menores de 5 anos,clasificacion d,2002-08-01,89,88,89,88,177
21703,TITO YUPANQUI (PARQUIPUJIO),estado nutricional en menores de 5 anos,clasificacion d,2002-08-01,0,18,0,18,18
30802,TOCO,estado nutricional en menores de 5 anos,clasificacion d,2002-08-01,4,13,4,13,17
41001,TOLEDO,estado nutricional en menores de 5 anos,clasificacion d,2002-08-01,6,13,6,13,19
51202,TOMAVE,estado nutricional en menores de 5 anos,clasificacion d,2002-08-01,43,78,43,78,121
10402,TOMINA,estado nutricional en menores de 5 anos,clasificacion d,2002-08-01,87,165,87,165,252
50502,TORO TORO,estado nutricional en menores de 5 anos,clasificacion d,2002-08-01,70,80,70,80,150
31201,TOTORA(CBBA),estado nutricional en menores de 5 anos,clasificacion d,2002-08-01,49,85,49,85,134
41301,TOTORA(ORR),estado nutricional en menores de 5 anos,clasificacion d,2002-08-01,22,44,22,44,66
70802,TRIGAL,estado nutricional en menores de 5 anos,clasificacion d,2002-08-01,5,7,5,7,12
80101,TRINIDAD,estado nutricional en menores de 5 anos,clasificacion d,2002-08-01,170,230,170,230,400
40402,TURCO,estado nutricional en menores de 5 anos,clasificacion d,2002-08-01,14,8,14,8,22
21302,UMALA,estado nutricional en menores de 5 anos,clasificacion d,2002-08-01,16,10,16,10,26
60401,URIONDO (A. CONCEPCION),estado nutricional en menores de 5 anos,clasificacion d,2002-08-01,19,26,19,26,45
71502,URUBICHA,estado nutricional en menores de 5 anos,clasificacion d,2002-08-01,14,145,14,145,159
51201,UYUNI,estado nutricional en menores de 5 anos,clasificacion d,2002-08-01,47,150,47,150,197
70801,VALLEGRANDE,estado nutricional en menores de 5 anos,clasificacion d,2002-08-01,61,64,61,64,125
20801,VIACHA,estado nutricional en menores de 5 anos,clasificacion d,2002-08-01,61,125,61,125,186
31302,VILA VILA,estado nutricional en menores de 5 anos,clasificacion d,2002-08-01,0,48,0,48,48
60303,VILLA MONTES,estado nutricional en menores de 5 anos,clasificacion d,2002-08-01,37,45,37,45,82
90502,VILLA NUEVA (LOMA ALTA),estado nutricional en menores de 5 anos,clasificacion d,2002-08-01,0,1,0,1,1
31402,VILLA RIVERO,estado nutricional en menores de 5 anos,clasificacion d,2002-08-01,4,1,4,1,5
10801,VILLA SERRANO,estado nutricional en menores de 5 anos,clasificacion d,2002-08-01,109,242,109,242,351
31003,VILLA TUNARI,estado nutricional en menores de 5 anos,clasificacion d,2002-08-01,137,114,137,114,251
11001,VILLA VACA GUZMAN (MUYUPAMPA),estado nutricional en menores de 5 anos,clasificacion d,2002-08-01,77,115,77,115,192
51501,VILLAZON,estado nutricional en menores de 5 anos,clasificacion d,2002-08-01,124,166,124,166,290
50602,VITICHI,estado nutricional en menores de 5 anos,clasificacion d,2002-08-01,35,157,35,157,192
20306,WALDO BALLIVIAN,estado nutricional en menores de 5 anos,clasificacion d,2002-08-01,11,5,11,5,16
70201,WARNES,estado nutricional en menores de 5 anos,clasificacion d,2002-08-01,85,100,85,100,185
20903,YACO,estado nutricional en menores de 5 anos,clasificacion d,2002-08-01,10,36,10,36,46
60301,YACUIBA,estado nutricional en menores de 5 anos,clasificacion d,2002-08-01,57,31,57,31,88
10602,YAMPARAEZ,estado nutricional en menores de 5 anos,clasificacion d,2002-08-01,159,274,159,274,433
21103,YANACACHI,estado nutricional en menores de 5 anos,clasificacion d,2002-08-01,5,3,5,3,8
70403,YAPACANI,estado nutricional en menores de 5 anos,clasificacion d,2002-08-01,1,0,1,0,1
50103,YOCALLA,estado nutricional en menores de 5 anos,clasificacion d,2002-08-01,17,59,17,59,76
10102,YOTALA,estado nutricional en menores de 5 anos,clasificacion d,2002-08-01,105,196,105,196,301
60402,YUNCHARA,estado nutricional en menores de 5 anos,clasificacion d,2002-08-01,6,22,6,22,28
10301,ZUDAÃ‘EZ,estado nutricional en menores de 5 anos,clasificacion d,2002-08-01,74,118,74,118,192
51302,ACACIO,estado nutricional en menores de 5 anos,clasificacion d,2002-09-01,19,131,19,131,150
20201,ACHACACHI,estado nutricional en menores de 5 anos,clasificacion d,2002-09-01,106,124,106,124,230
20104,ACHOCALLA,estado nutricional en menores de 5 anos,clasificacion d,2002-09-01,34,29,34,29,63
30201,AIQUILE,estado nutricional en menores de 5 anos,clasificacion d,2002-09-01,19,84,19,84,103
31303,ALALAY,estado nutricional en menores de 5 anos,clasificacion d,2002-09-01,11,15,11,15,26
10404,ALCALA,estado nutricional en menores de 5 anos,clasificacion d,2002-09-01,29,65,29,65,94
20202,ANCORAIMES,estado nutricional en menores de 5 anos,clasificacion d,2002-09-01,59,90,59,90,149
41201,ANDAMARCA,estado nutricional en menores de 5 anos,clasificacion d,2002-09-01,5,9,5,9,14
40603,ANTEQUERA,estado nutricional en menores de 5 anos,clasificacion d,2002-09-01,8,14,8,14,22
30402,ANZALDO,estado nutricional en menores de 5 anos,clasificacion d,2002-09-01,3,112,3,112,115
20701,APOLO,estado nutricional en menores de 5 anos,clasificacion d,2002-09-01,45,42,45,42,87
51301,ARAMPAMPA,estado nutricional en menores de 5 anos,clasificacion d,2002-09-01,38,46,38,46,84
30501,ARANI,estado nutricional en menores de 5 anos,clasificacion d,2002-09-01,18,55,18,55,73
30403,ARBIETO,estado nutricional en menores de 5 anos,clasificacion d,2002-09-01,16,23,16,23,39
30601,ARQUE,estado nutricional en menores de 5 anos,clasificacion d,2002-09-01,40,43,40,43,83
50802,ATOCHA,estado nutricional en menores de 5 anos,clasificacion d,2002-09-01,3,97,3,97,100
20503,AUCAPATA,estado nutricional en menores de 5 anos,clasificacion d,2002-09-01,8,5,8,5,13
20502,AYATA,estado nutricional en menores de 5 anos,clasificacion d,2002-09-01,29,31,29,31,60
21303,AYO AYO,estado nutricional en menores de 5 anos,clasificacion d,2002-09-01,13,10,13,10,23
30301,AYOPAYA (V. DE INDEPENDENCIA),estado nutricional en menores de 5 anos,clasificacion d,2002-09-01,101,126,101,126,227
10201,AZURDUY,estado nutricional en menores de 5 anos,clasificacion d,2002-09-01,165,211,165,211,376
21203,BATALLAS,estado nutricional en menores de 5 anos,clasificacion d,2002-09-01,30,42,30,42,72
80802,BAURES,estado nutricional en menores de 5 anos,clasificacion d,2002-09-01,20,27,20,27,47
50104,BELEN DE URMIRI,estado nutricional en menores de 5 anos,clasificacion d,2002-09-01,10,27,10,27,37
60202,BERMEJO,estado nutricional en menores de 5 anos,clasificacion d,2002-09-01,8,10,8,10,18
50301,BETANZOS,estado nutricional en menores de 5 anos,clasificacion d,2002-09-01,335,362,335,362,697
31501,BOLIVAR,estado nutricional en menores de 5 anos,clasificacion d,2002-09-01,71,87,71,87,158
90103,BOLPEBRA,estado nutricional en menores de 5 anos,clasificacion d,2002-09-01,2,11,2,11,13
70707,BOYUIBE,estado nutricional en menores de 5 anos,clasificacion d,2002-09-01,11,46,11,46,57
70401,BUENA VISTA,estado nutricional en menores de 5 anos,clasificacion d,2002-09-01,59,60,59,60,119
70703,CABEZAS,estado nutricional en menores de 5 anos,clasificacion d,2002-09-01,27,32,27,32,59
20905,CAIROMA,estado nutricional en menores de 5 anos,clasificacion d,2002-09-01,37,40,37,40,77
51102,"CAIZA ""D""",estado nutricional en menores de 5 anos,clasificacion d,2002-09-01,125,104,125,104,229
21003,CAJUATA,estado nutricional en menores de 5 anos,clasificacion d,2002-09-01,10,12,10,12,22
20303,CALACOTO,estado nutricional en menores de 5 anos,clasificacion d,2002-09-01,16,19,16,19,35
21304,CALAMARCA,estado nutricional en menores de 5 anos,clasificacion d,2002-09-01,88,57,88,57,145
10701,CAMARGO,estado nutricional en menores de 5 anos,clasificacion d,2002-09-01,51,137,51,137,188
10901,CAMATAQUI (C. VILLA ABECIA),estado nutricional en menores de 5 anos,clasificacion d,2002-09-01,24,44,24,44,68
70706,CAMIRI,estado nutricional en menores de 5 anos,clasificacion d,2002-09-01,48,88,48,88,136
30701,CAPINOTA,estado nutricional en menores de 5 anos,clasificacion d,2002-09-01,32,56,32,56,88
20302,CAQUIAVIRI,estado nutricional en menores de 5 anos,clasificacion d,2002-09-01,25,29,25,29,54
40102,CARACOLLO,estado nutricional en menores de 5 anos,clasificacion d,2002-09-01,31,54,31,54,85
22001,CARANAVI,estado nutricional en menores de 5 anos,clasificacion d,2002-09-01,108,122,108,122,230
41503,CARANGAS,estado nutricional en menores de 5 anos,clasificacion d,2002-09-01,0,2,0,2,2
60302,CARAPARI,estado nutricional en menores de 5 anos,clasificacion d,2002-09-01,27,36,27,36,63
50702,CARIPUYO,estado nutricional en menores de 5 anos,clasificacion d,2002-09-01,61,77,61,77,138
21902,CATACORA,estado nutricional en menores de 5 anos,clasificacion d,2002-09-01,12,5,12,5,17
21803,CHACARILLA,estado nutricional en menores de 5 anos,clasificacion d,2002-09-01,0,1,0,1,1
40201,CHALLAPATA,estado nutricional en menores de 5 anos,clasificacion d,2002-09-01,40,109,40,109,149
50302,CHAQUI,estado nutricional en menores de 5 anos,clasificacion d,2002-09-01,77,51,77,51,128
70702,CHARAGUA,estado nutricional en menores de 5 anos,clasificacion d,2002-09-01,53,165,53,165,218
20305,CHARAÃ‘A,estado nutricional en menores de 5 anos,clasificacion d,2002-09-01,23,19,23,19,42
50202,CHAYANTA,estado nutricional en menores de 5 anos,clasificacion d,2002-09-01,53,55,53,55,108
31204,CHIMORE,estado nutricional en menores de 5 anos,clasificacion d,2002-09-01,4,5,4,5,9
40903,CHIPAYA,estado nutricional en menores de 5 anos,clasificacion d,2002-09-01,0,1,0,1,1
40302,CHOQUE COTA,estado nutricional en menores de 5 anos,clasificacion d,2002-09-01,12,0,12,0,12
21101,CHULUMANI (V. DE LA LIBERTAD),estado nutricional en menores de 5 anos,clasificacion d,2002-09-01,11,16,11,16,27
20501,CHUMA,estado nutricional en menores de 5 anos,clasificacion d,2002-09-01,35,36,35,36,71
30801,CLIZA,estado nutricional en menores de 5 anos,clasificacion d,2002-09-01,5,38,5,38,43
90101,COBIJA,estado nutricional en menores de 5 anos,clasificacion d,2002-09-01,89,59,89,59,148
30101,COCHABAMBA,estado nutricional en menores de 5 anos,clasificacion d,2002-09-01,359,373,359,373,732
30905,COLCAPIRHUA,estado nutricional en menores de 5 anos,clasificacion d,2002-09-01,57,42,57,42,99
50901,"COLCHA ""K""",estado nutricional en menores de 5 anos,clasificacion d,2002-09-01,58,50,58,50,108
21307,COLLANA,estado nutricional en menores de 5 anos,clasificacion d,2002-09-01,3,2,3,2,5
31002,COLOMI,estado nutricional en menores de 5 anos,clasificacion d,2002-09-01,32,57,32,57,89
50401,COLQUECHACA,estado nutricional en menores de 5 anos,clasificacion d,2002-09-01,141,118,141,118,259
21306,COLQUENCHA,estado nutricional en menores de 5 anos,clasificacion d,2002-09-01,11,23,11,23,34
21004,COLQUIRI,estado nutricional en menores de 5 anos,clasificacion d,2002-09-01,61,79,61,79,140
20304,COMANCHE,estado nutricional en menores de 5 anos,clasificacion d,2002-09-01,17,9,17,9,26
71301,COMARAPA,estado nutricional en menores de 5 anos,clasificacion d,2002-09-01,57,52,57,52,109
20605,COMBAYA,estado nutricional en menores de 5 anos,clasificacion d,2002-09-01,4,15,4,15,19
71101,CONCEPCION,estado nutricional en menores de 5 anos,clasificacion d,2002-09-01,11,18,11,18,29
21701,COPACABANA,estado nutricional en menores de 5 anos,clasificacion d,2002-09-01,5,25,5,25,30
21402,CORIPATA,estado nutricional en menores de 5 anos,clasificacion d,2002-09-01,2,13,2,13,15
20301,CORO CORO,estado nutricional en menores de 5 anos,clasificacion d,2002-09-01,47,32,47,32,79
21401,COROICO,estado nutricional en menores de 5 anos,clasificacion d,2002-09-01,21,12,21,12,33
40301,CORQUE,estado nutricional en menores de 5 anos,clasificacion d,2002-09-01,25,21,25,21,46
50601,COTAGAITA,estado nutricional en menores de 5 anos,clasificacion d,2002-09-01,56,97,56,97,153
70102,COTOCA,estado nutricional en menores de 5 anos,clasificacion d,2002-09-01,30,27,30,27,57
31405,CUCHUMUELA (V. G. VILLARROEL),estado nutricional en menores de 5 anos,clasificacion d,2002-09-01,11,9,11,9,20
70704,CUEVO,estado nutricional en menores de 5 anos,clasificacion d,2002-09-01,22,29,22,29,51
10902,CULPINA,estado nutricional en menores de 5 anos,clasificacion d,2002-09-01,213,320,213,320,533
40401,CURAHUARA DE CARANGAS,estado nutricional en menores de 5 anos,clasificacion d,2002-09-01,29,6,29,6,35
21602,CURVA,estado nutricional en menores de 5 anos,clasificacion d,2002-09-01,10,15,10,15,25
20804,DESAGUADERO,estado nutricional en menores de 5 anos,clasificacion d,2002-09-01,17,6,17,6,23
20105,EL ALTO,estado nutricional en menores de 5 anos,clasificacion d,2002-09-01,1515,1206,1515,1206,2721
40103,EL CHORO,estado nutricional en menores de 5 anos,clasificacion d,2002-09-01,9,0,9,0,9
71503,EL PUENTE(STC),estado nutricional en menores de 5 anos,clasificacion d,2002-09-01,3,93,3,93,96
60502,EL PUENTE(TJA),estado nutricional en menores de 5 anos,clasificacion d,2002-09-01,37,79,37,79,116
70105,EL TORNO,estado nutricional en menores de 5 anos,clasificacion d,2002-09-01,81,103,81,103,184
10405,EL VILLAR,estado nutricional en menores de 5 anos,clasificacion d,2002-09-01,37,145,37,145,182
60601,ENTRE RIOS,estado nutricional en menores de 5 anos,clasificacion d,2002-09-01,43,51,43,51,94
41101,EUCALIPTUS,estado nutricional en menores de 5 anos,clasificacion d,2002-09-01,16,18,16,18,34
80402,EXALTACION,estado nutricional en menores de 5 anos,clasificacion d,2002-09-01,1,13,1,13,14
90203,FILADELFIA,estado nutricional en menores de 5 anos,clasificacion d,2002-09-01,0,5,0,5,5
71002,GENERAL SAAVEDRA,estado nutricional en menores de 5 anos,clasificacion d,2002-09-01,17,16,17,16,33
21601,GRAL. J.J. PEREZ (CHARAZANI),estado nutricional en menores de 5 anos,clasificacion d,2002-09-01,54,70,54,70,124
20602,GUANAY,estado nutricional en menores de 5 anos,clasificacion d,2002-09-01,98,118,98,118,216
20802,GUAQUI,estado nutricional en menores de 5 anos,clasificacion d,2002-09-01,23,7,23,7,30
80202,GUAYARAMERIN,estado nutricional en menores de 5 anos,clasificacion d,2002-09-01,108,126,108,126,234
70705,GUTIERREZ,estado nutricional en menores de 5 anos,clasificacion d,2002-09-01,60,107,60,107,167
10502,HUACARETA,estado nutricional en menores de 5 anos,clasificacion d,2002-09-01,60,71,60,71,131
11002,HUACAYA (VILLA DE HUACAYA),estado nutricional en menores de 5 anos,clasificacion d,2002-09-01,13,33,13,33,46
40501,HUACHACALLA,estado nutricional en menores de 5 anos,clasificacion d,2002-09-01,5,0,5,0,5
40701,HUANUNI,estado nutricional en menores de 5 anos,clasificacion d,2002-09-01,93,47,93,47,140
80803,HUARACAJE,estado nutricional en menores de 5 anos,clasificacion d,2002-09-01,1,5,1,5,6
41601,HUAYLLAMARCA,estado nutricional en menores de 5 anos,clasificacion d,2002-09-01,17,5,17,5,22
21005,ICHOCA,estado nutricional en menores de 5 anos,clasificacion d,2002-09-01,11,15,11,15,26
10304,ICLA,estado nutricional en menores de 5 anos,clasificacion d,2002-09-01,135,187,135,187,322
10703,INCAHUASI,estado nutricional en menores de 5 anos,clasificacion d,2002-09-01,132,186,132,186,318
21001,INQUISIVI,estado nutricional en menores de 5 anos,clasificacion d,2002-09-01,42,83,42,83,125
21102,IRUPANA (VILLA DE LANZA),estado nutricional en menores de 5 anos,clasificacion d,2002-09-01,19,37,19,37,56
21501,IXIAMAS,estado nutricional en menores de 5 anos,clasificacion d,2002-09-01,35,39,35,39,74
21105,LA ASUNTA,estado nutricional en menores de 5 anos,clasificacion d,2002-09-01,36,57,36,57,93
70104,LA GUARDIA,estado nutricional en menores de 5 anos,clasificacion d,2002-09-01,64,35,64,35,99
20101,LA PAZ,estado nutricional en menores de 5 anos,clasificacion d,2002-09-01,1092,905,1092,905,1997
70701,LAGUNILLAS,estado nutricional en menores de 5 anos,clasificacion d,2002-09-01,34,33,34,33,67
21202,LAJA,estado nutricional en menores de 5 anos,clasificacion d,2002-09-01,20,27,20,27,47
10903,LAS CARRERAS,estado nutricional en menores de 5 anos,clasificacion d,2002-09-01,33,38,33,38,71
21006,LICOMA PAMPA,estado nutricional en menores de 5 anos,clasificacion d,2002-09-01,9,20,9,20,29
50203,LLALLAGUA,estado nutricional en menores de 5 anos,clasificacion d,2002-09-01,5,172,5,172,177
51401,LLICA,estado nutricional en menores de 5 anos,clasificacion d,2002-09-01,8,8,8,8,16
80601,LORETO,estado nutricional en menores de 5 anos,clasificacion d,2002-09-01,0,15,0,15,15
20901,LURIBAY,estado nutricional en menores de 5 anos,clasificacion d,2002-09-01,25,36,25,36,61
40702,MACHACAMARCA,estado nutricional en menores de 5 anos,clasificacion d,2002-09-01,9,15,9,15,24
11003,MACHARETI,estado nutricional en menores de 5 anos,clasificacion d,2002-09-01,52,103,52,103,155
80801,MAGDALENA,estado nutricional en menores de 5 anos,clasificacion d,2002-09-01,15,10,15,10,25
70903,MAIRANA,estado nutricional en menores de 5 anos,clasificacion d,2002-09-01,20,20,20,20,40
20904,MALLA,estado nutricional en menores de 5 anos,clasificacion d,2002-09-01,5,8,5,8,13
20103,MECAPACA,estado nutricional en menores de 5 anos,clasificacion d,2002-09-01,29,11,29,11,40
71003,MINEROS,estado nutricional en menores de 5 anos,clasificacion d,2002-09-01,6,3,6,3,9
31301,MIZQUE,estado nutricional en menores de 5 anos,clasificacion d,2002-09-01,28,39,28,39,67
20402,MOCOMOCO,estado nutricional en menores de 5 anos,clasificacion d,2002-09-01,35,25,35,25,60
51002,MOJINETE,estado nutricional en menores de 5 anos,clasificacion d,2002-09-01,0,10,0,10,10
10303,MOJOCOYA,estado nutricional en menores de 5 anos,clasificacion d,2002-09-01,59,97,59,97,156
10501,MONTEAGUDO,estado nutricional en menores de 5 anos,clasificacion d,2002-09-01,155,289,155,289,444
71001,MONTERO,estado nutricional en menores de 5 anos,clasificacion d,2002-09-01,210,162,210,162,372
70803,MORO MORO,estado nutricional en menores de 5 anos,clasificacion d,2002-09-01,24,31,24,31,55
30302,MOROCHATA,estado nutricional en menores de 5 anos,clasificacion d,2002-09-01,70,99,70,99,169
90401,NACEBE (SANTA ROSA DEL ABUNA),estado nutricional en menores de 5 anos,clasificacion d,2002-09-01,2,0,2,0,2
20307,NAZACARA DE PACAJES,estado nutricional en menores de 5 anos,clasificacion d,2002-09-01,2,2,2,2,4
90501,NUEVO MANOA (NUEVA ESPERANZA),estado nutricional en menores de 5 anos,clasificacion d,2002-09-01,2,3,2,3,5
50404,OCURI,estado nutricional en menores de 5 anos,clasificacion d,2002-09-01,46,85,46,85,131
70202,OKINAWA,estado nutricional en menores de 5 anos,clasificacion d,2002-09-01,13,21,13,21,34
30203,OMEREQUE,estado nutricional en menores de 5 anos,clasificacion d,2002-09-01,0,41,0,41,41
40101,ORURO,estado nutricional en menores de 5 anos,clasificacion d,2002-09-01,520,360,520,360,880
60201,PADCAYA,estado nutricional en menores de 5 anos,clasificacion d,2002-09-01,40,55,40,55,95
10401,PADILLA,estado nutricional en menores de 5 anos,clasificacion d,2002-09-01,140,264,140,264,404
70502,PAILON,estado nutricional en menores de 5 anos,clasificacion d,2002-09-01,55,51,55,51,106
20102,PALCA,estado nutricional en menores de 5 anos,clasificacion d,2002-09-01,54,75,54,75,129
21104,PALOS BLANCOS,estado nutricional en menores de 5 anos,clasificacion d,2002-09-01,52,74,52,74,126
40802,PAMPA AULLAGAS,estado nutricional en menores de 5 anos,clasificacion d,2002-09-01,12,22,12,22,34
70902,PAMPA GRANDE,estado nutricional en menores de 5 anos,clasificacion d,2002-09-01,19,20,19,20,39
21802,PAPEL PAMPA,estado nutricional en menores de 5 anos,clasificacion d,2002-09-01,9,1,9,1,10
30202,PASORAPA,estado nutricional en menores de 5 anos,clasificacion d,2002-09-01,15,29,15,29,44
21305,PATACAMAYA,estado nutricional en menores de 5 anos,clasificacion d,2002-09-01,52,47,52,47,99
40602,PAZÃ‘A,estado nutricional en menores de 5 anos,clasificacion d,2002-09-01,10,16,10,16,26
20702,PELECHUCO,estado nutricional en menores de 5 anos,clasificacion d,2002-09-01,53,47,53,47,100
50403,POCOATA,estado nutricional en menores de 5 anos,clasificacion d,2002-09-01,127,155,127,155,282
31203,POCONA,estado nutricional en menores de 5 anos,clasificacion d,2002-09-01,38,47,38,47,85
31202,POJO (CBBA),estado nutricional en menores de 5 anos,clasificacion d,2002-09-01,111,134,111,134,245
40601,POOPO,estado nutricional en menores de 5 anos,clasificacion d,2002-09-01,7,15,7,15,22
51203,PORCO,estado nutricional en menores de 5 anos,clasificacion d,2002-09-01,23,14,23,14,37
10103,POROMA,estado nutricional en menores de 5 anos,clasificacion d,2002-09-01,145,181,145,181,326
70103,PORONGO,estado nutricional en menores de 5 anos,clasificacion d,2002-09-01,14,12,14,12,26
70601,PORTACHUELO,estado nutricional en menores de 5 anos,clasificacion d,2002-09-01,40,35,40,35,75
90102,PORVENIR,estado nutricional en menores de 5 anos,clasificacion d,2002-09-01,13,15,13,15,28
70804,POSTRER VALLE,estado nutricional en menores de 5 anos,clasificacion d,2002-09-01,9,14,9,14,23
50101,POTOSI,estado nutricional en menores de 5 anos,clasificacion d,2002-09-01,510,378,510,378,888
10302,PRESTO,estado nutricional en menores de 5 anos,clasificacion d,2002-09-01,72,83,72,83,155
70805,PUCARA,estado nutricional en menores de 5 anos,clasificacion d,2002-09-01,0,1,0,1,1
21201,PUCARANI,estado nutricional en menores de 5 anos,clasificacion d,2002-09-01,25,53,25,53,78
20401,PUERTO ACOSTA,estado nutricional en menores de 5 anos,clasificacion d,2002-09-01,111,122,111,122,233
20403,PUERTO CARABUCO,estado nutricional en menores de 5 anos,clasificacion d,2002-09-01,43,38,43,38,81
90301,PUERTO GONZALO MORENO,estado nutricional en menores de 5 anos,clasificacion d,2002-09-01,6,16,6,16,22
21204,PUERTO PEREZ,estado nutricional en menores de 5 anos,clasificacion d,2002-09-01,12,6,12,6,18
71402,PUERTO QUIJARRO,estado nutricional en menores de 5 anos,clasificacion d,2002-09-01,39,22,39,22,61
90201,PUERTO RICO,estado nutricional en menores de 5 anos,clasificacion d,2002-09-01,3,19,3,19,22
71401,PUERTO SUAREZ,estado nutricional en menores de 5 anos,clasificacion d,2002-09-01,33,19,33,19,52
31205,PUERTO VILLARROEL,estado nutricional en menores de 5 anos,clasificacion d,2002-09-01,126,102,126,102,228
51101,PUNA,estado nutricional en menores de 5 anos,clasificacion d,2002-09-01,238,402,238,402,640
31401,PUNATA,estado nutricional en menores de 5 anos,clasificacion d,2002-09-01,49,6,49,6,55
20604,QUIABAYA,estado nutricional en menores de 5 anos,clasificacion d,2002-09-01,13,25,13,25,38
30901,QUILLACOLLO,estado nutricional en menores de 5 anos,clasificacion d,2002-09-01,61,63,61,63,124
21002,QUIME,estado nutricional en menores de 5 anos,clasificacion d,2002-09-01,53,53,53,53,106
70904,QUIRUSILLAS,estado nutricional en menores de 5 anos,clasificacion d,2002-09-01,1,1,1,1,2
50402,RAVELO,estado nutricional en menores de 5 anos,clasificacion d,2002-09-01,163,235,163,235,398
80301,REYES,estado nutricional en menores de 5 anos,clasificacion d,2002-09-01,18,13,18,13,31
80201,RIBERALTA,estado nutricional en menores de 5 anos,clasificacion d,2002-09-01,394,290,394,290,684
70503,ROBORE,estado nutricional en menores de 5 anos,clasificacion d,2002-09-01,21,43,21,43,64
80304,RURRENABAQUE,estado nutricional en menores de 5 anos,clasificacion d,2002-09-01,10,6,10,6,16
40901,SABAYA,estado nutricional en menores de 5 anos,clasificacion d,2002-09-01,0,12,0,12,12
31001,SACABA,estado nutricional en menores de 5 anos,clasificacion d,2002-09-01,180,134,180,134,314
30404,SACABAMBA,estado nutricional en menores de 5 anos,clasificacion d,2002-09-01,2,82,2,82,84
50701,SACACA,estado nutricional en menores de 5 anos,clasificacion d,2002-09-01,181,263,181,263,444
71302,SAIPINA,estado nutricional en menores de 5 anos,clasificacion d,2002-09-01,8,12,8,12,20
40801,SALINAS DE GARCI MENDOZA,estado nutricional en menores de 5 anos,clasificacion d,2002-09-01,11,12,11,12,23
70901,SAMAIPATA,estado nutricional en menores de 5 anos,clasificacion d,2002-09-01,32,18,32,18,50
51601,SAN AGUSTIN,estado nutricional en menores de 5 anos,clasificacion d,2002-09-01,4,0,4,0,4
80602,SAN ANDRES,estado nutricional en menores de 5 anos,clasificacion d,2002-09-01,6,24,6,24,30
51003,SAN ANTONIO DE ESMORUCO,estado nutricional en menores de 5 anos,clasificacion d,2002-09-01,1,14,1,14,15
71105,SAN ANTONIO DE LOMERIO,estado nutricional en menores de 5 anos,clasificacion d,2002-09-01,76,117,76,117,193
31403,SAN BENITO,estado nutricional en menores de 5 anos,clasificacion d,2002-09-01,26,15,26,15,41
80302,SAN BORJA,estado nutricional en menores de 5 anos,clasificacion d,2002-09-01,97,93,97,93,190
21502,SAN BUENA VENTURA,estado nutricional en menores de 5 anos,clasificacion d,2002-09-01,54,86,54,86,140
70402,SAN CARLOS,estado nutricional en menores de 5 anos,clasificacion d,2002-09-01,29,56,29,56,85
80501,SAN IGNACIO,estado nutricional en menores de 5 anos,clasificacion d,2002-09-01,104,149,104,149,253
70301,SAN IGNACIO DE VELASCO,estado nutricional en menores de 5 anos,clasificacion d,2002-09-01,188,164,188,164,352
80102,SAN JAVIER(BNI),estado nutricional en menores de 5 anos,clasificacion d,2002-09-01,0,34,0,34,34
71102,SAN JAVIER(STC),estado nutricional en menores de 5 anos,clasificacion d,2002-09-01,13,12,13,12,25
80701,SAN JOAQUIN,estado nutricional en menores de 5 anos,clasificacion d,2002-09-01,1,27,1,27,28
70501,SAN JOSE DE CHIQUITOS,estado nutricional en menores de 5 anos,clasificacion d,2002-09-01,28,24,28,24,52
71104,SAN JULIAN,estado nutricional en menores de 5 anos,clasificacion d,2002-09-01,118,107,118,107,225
90302,SAN LORENZO(PND),estado nutricional en menores de 5 anos,clasificacion d,2002-09-01,8,19,8,19,27
60501,SAN LORENZO(TJA),estado nutricional en menores de 5 anos,clasificacion d,2002-09-01,28,24,28,24,52
10702,SAN LUCAS,estado nutricional en menores de 5 anos,clasificacion d,2002-09-01,355,403,355,403,758
71201,SAN MATIAS,estado nutricional en menores de 5 anos,clasificacion d,2002-09-01,34,37,34,37,71
70302,SAN MIGUEL DE VELASCO,estado nutricional en menores de 5 anos,clasificacion d,2002-09-01,64,78,64,78,142
51001,SAN PABLO DE LIPEZ,estado nutricional en menores de 5 anos,clasificacion d,2002-09-01,8,10,8,10,18
50501,SAN PEDRO DE BUENA VISTA,estado nutricional en menores de 5 anos,clasificacion d,2002-09-01,112,265,112,265,377
21801,SAN PEDRO DE CURAHUARA,estado nutricional en menores de 5 anos,clasificacion d,2002-09-01,14,22,14,22,36
50902,SAN PEDRO DE QUEMES,estado nutricional en menores de 5 anos,clasificacion d,2002-09-01,3,1,3,1,4
21702,SAN PEDRO DE TIQUINA,estado nutricional en menores de 5 anos,clasificacion d,2002-09-01,2,4,2,4,6
70303,SAN RAFAEL,estado nutricional en menores de 5 anos,clasificacion d,2002-09-01,34,18,34,18,52
80702,SAN RAMON,estado nutricional en menores de 5 anos,clasificacion d,2002-09-01,6,8,6,8,14
80401,SANTA ANA,estado nutricional en menores de 5 anos,clasificacion d,2002-09-01,23,24,23,24,47
70101,SANTA CRUZ DE LA SIERRA,estado nutricional en menores de 5 anos,clasificacion d,2002-09-01,777,561,777,561,1338
80303,SANTA ROSA,estado nutricional en menores de 5 anos,clasificacion d,2002-09-01,11,9,11,9,20
70602,SANTA ROSA DEL SARA,estado nutricional en menores de 5 anos,clasificacion d,2002-09-01,14,16,14,16,30
20308,SANTIAGO DE CALLAPA,estado nutricional en menores de 5 anos,clasificacion d,2002-09-01,12,24,12,24,36
41401,SANTIAGO DE HUARI,estado nutricional en menores de 5 anos,clasificacion d,2002-09-01,14,27,14,27,41
21901,SANTIAGO DE MACHACA,estado nutricional en menores de 5 anos,clasificacion d,2002-09-01,21,19,21,19,40
30702,SANTIVAÃ‘ES,estado nutricional en menores de 5 anos,clasificacion d,2002-09-01,22,31,22,31,53
40202,SANTUARIO DE QUILLACAS,estado nutricional en menores de 5 anos,clasificacion d,2002-09-01,4,6,4,6,10
20902,SAPAHAQUI,estado nutricional en menores de 5 anos,clasificacion d,2002-09-01,11,6,11,6,17
90303,SENA,estado nutricional en menores de 5 anos,clasificacion d,2002-09-01,12,12,12,12,24
21301,SICA SICA (VILLA AROMA),estado nutricional en menores de 5 anos,clasificacion d,2002-09-01,40,24,40,24,64
30703,SICAYA,estado nutricional en menores de 5 anos,clasificacion d,2002-09-01,25,34,25,34,59
30902,SIPE SIPE,estado nutricional en menores de 5 anos,clasificacion d,2002-09-01,149,146,149,146,295
10403,SOPACHUY,estado nutricional en menores de 5 anos,clasificacion d,2002-09-01,58,75,58,75,133
20601,SORATA,estado nutricional en menores de 5 anos,clasificacion d,2002-09-01,34,71,34,71,105
10101,SUCRE,estado nutricional en menores de 5 anos,clasificacion d,2002-09-01,566,676,566,676,1242
31404,TACACHI,estado nutricional en menores de 5 anos,clasificacion d,2002-09-01,1,3,1,3,4
20603,TACACOMA,estado nutricional en menores de 5 anos,clasificacion d,2002-09-01,13,14,13,14,27
50303,TACOBAMBA,estado nutricional en menores de 5 anos,clasificacion d,2002-09-01,33,44,33,44,77
30602,TACOPAYA,estado nutricional en menores de 5 anos,clasificacion d,2002-09-01,91,101,91,101,192
51402,TAHUA,estado nutricional en menores de 5 anos,clasificacion d,2002-09-01,1,0,1,0,1
31101,TAPACARI,estado nutricional en menores de 5 anos,clasificacion d,2002-09-01,68,165,68,165,233
10601,TARABUCO,estado nutricional en menores de 5 anos,clasificacion d,2002-09-01,263,449,263,449,712
30401,TARATA,estado nutricional en menores de 5 anos,clasificacion d,2002-09-01,18,37,18,37,55
60101,TARIJA,estado nutricional en menores de 5 anos,clasificacion d,2002-09-01,215,197,215,197,412
10202,TARVITA,estado nutricional en menores de 5 anos,clasificacion d,2002-09-01,103,195,103,195,298
20803,TIAWANACU,estado nutricional en menores de 5 anos,clasificacion d,2002-09-01,19,24,19,24,43
50102,TINGUIPAYA,estado nutricional en menores de 5 anos,clasificacion d,2002-09-01,35,145,35,145,180
20606,TIPUANI,estado nutricional en menores de 5 anos,clasificacion d,2002-09-01,10,5,10,5,15
30903,TIQUIPAYA,estado nutricional en menores de 5 anos,clasificacion d,2002-09-01,26,67,26,67,93
31601,TIRAQUE (CBBA),estado nutricional en menores de 5 anos,clasificacion d,2002-09-01,134,175,134,175,309
21703,TITO YUPANQUI (PARQUIPUJIO),estado nutricional en menores de 5 anos,clasificacion d,2002-09-01,6,4,6,4,10
30802,TOCO,estado nutricional en menores de 5 anos,clasificacion d,2002-09-01,0,4,0,4,4
30803,TOLATA,estado nutricional en menores de 5 anos,clasificacion d,2002-09-01,5,4,5,4,9
41001,TOLEDO,estado nutricional en menores de 5 anos,clasificacion d,2002-09-01,3,17,3,17,20
51202,TOMAVE,estado nutricional en menores de 5 anos,clasificacion d,2002-09-01,52,84,52,84,136
10402,TOMINA,estado nutricional en menores de 5 anos,clasificacion d,2002-09-01,88,183,88,183,271
50502,TORO TORO,estado nutricional en menores de 5 anos,clasificacion d,2002-09-01,44,43,44,43,87
31201,TOTORA(CBBA),estado nutricional en menores de 5 anos,clasificacion d,2002-09-01,74,81,74,81,155
41301,TOTORA(ORR),estado nutricional en menores de 5 anos,clasificacion d,2002-09-01,12,16,12,16,28
70802,TRIGAL,estado nutricional en menores de 5 anos,clasificacion d,2002-09-01,3,5,3,5,8
80101,TRINIDAD,estado nutricional en menores de 5 anos,clasificacion d,2002-09-01,31,389,31,389,420
50801,TUPIZA,estado nutricional en menores de 5 anos,clasificacion d,2002-09-01,29,377,29,377,406
40402,TURCO,estado nutricional en menores de 5 anos,clasificacion d,2002-09-01,8,8,8,8,16
21302,UMALA,estado nutricional en menores de 5 anos,clasificacion d,2002-09-01,17,9,17,9,26
50201,UNCIA,estado nutricional en menores de 5 anos,clasificacion d,2002-09-01,5,30,5,30,35
60401,URIONDO (A. CONCEPCION),estado nutricional en menores de 5 anos,clasificacion d,2002-09-01,11,25,11,25,36
71502,URUBICHA,estado nutricional en menores de 5 anos,clasificacion d,2002-09-01,11,22,11,22,33
51201,UYUNI,estado nutricional en menores de 5 anos,clasificacion d,2002-09-01,59,112,59,112,171
30502,VACAS,estado nutricional en menores de 5 anos,clasificacion d,2002-09-01,58,19,58,19,77
70801,VALLEGRANDE,estado nutricional en menores de 5 anos,clasificacion d,2002-09-01,49,59,49,59,108
20801,VIACHA,estado nutricional en menores de 5 anos,clasificacion d,2002-09-01,59,133,59,133,192
31302,VILA VILA,estado nutricional en menores de 5 anos,clasificacion d,2002-09-01,6,23,6,23,29
60303,VILLA MONTES,estado nutricional en menores de 5 anos,clasificacion d,2002-09-01,46,37,46,37,83
31402,VILLA RIVERO,estado nutricional en menores de 5 anos,clasificacion d,2002-09-01,24,25,24,25,49
10801,VILLA SERRANO,estado nutricional en menores de 5 anos,clasificacion d,2002-09-01,105,274,105,274,379
31003,VILLA TUNARI,estado nutricional en menores de 5 anos,clasificacion d,2002-09-01,99,98,99,98,197
11001,VILLA VACA GUZMAN (MUYUPAMPA),estado nutricional en menores de 5 anos,clasificacion d,2002-09-01,56,99,56,99,155
51501,VILLAZON,estado nutricional en menores de 5 anos,clasificacion d,2002-09-01,131,180,131,180,311
30904,VINTO,estado nutricional en menores de 5 anos,clasificacion d,2002-09-01,36,5,36,5,41
50602,VITICHI,estado nutricional en menores de 5 anos,clasificacion d,2002-09-01,18,58,18,58,76
20306,WALDO BALLIVIAN,estado nutricional en menores de 5 anos,clasificacion d,2002-09-01,5,1,5,1,6
70201,WARNES,estado nutricional en menores de 5 anos,clasificacion d,2002-09-01,115,56,115,56,171
20903,YACO,estado nutricional en menores de 5 anos,clasificacion d,2002-09-01,15,16,15,16,31
60301,YACUIBA,estado nutricional en menores de 5 anos,clasificacion d,2002-09-01,114,119,114,119,233
10602,YAMPARAEZ,estado nutricional en menores de 5 anos,clasificacion d,2002-09-01,153,267,153,267,420
21103,YANACACHI,estado nutricional en menores de 5 anos,clasificacion d,2002-09-01,9,16,9,16,25
70403,YAPACANI,estado nutricional en menores de 5 anos,clasificacion d,2002-09-01,100,133,100,133,233
50103,YOCALLA,estado nutricional en menores de 5 anos,clasificacion d,2002-09-01,24,73,24,73,97
10102,YOTALA,estado nutricional en menores de 5 anos,clasificacion d,2002-09-01,100,190,100,190,290
60402,YUNCHARA,estado nutricional en menores de 5 anos,clasificacion d,2002-09-01,14,30,14,30,44
10301,ZUDAÃ‘EZ,estado nutricional en menores de 5 anos,clasificacion d,2002-09-01,66,129,66,129,195
51302,ACACIO,estado nutricional en menores de 5 anos,clasificacion d,2002-10-01,27,102,27,102,129
20201,ACHACACHI,estado nutricional en menores de 5 anos,clasificacion d,2002-10-01,193,179,193,179,372
20104,ACHOCALLA,estado nutricional en menores de 5 anos,clasificacion d,2002-10-01,34,30,34,30,64
30201,AIQUILE,estado nutricional en menores de 5 anos,clasificacion d,2002-10-01,50,78,50,78,128
31303,ALALAY,estado nutricional en menores de 5 anos,clasificacion d,2002-10-01,11,63,11,63,74
10404,ALCALA,estado nutricional en menores de 5 anos,clasificacion d,2002-10-01,38,65,38,65,103
20202,ANCORAIMES,estado nutricional en menores de 5 anos,clasificacion d,2002-10-01,69,135,69,135,204
41201,ANDAMARCA,estado nutricional en menores de 5 anos,clasificacion d,2002-10-01,1,1,1,1,2
30402,ANZALDO,estado nutricional en menores de 5 anos,clasificacion d,2002-10-01,17,108,17,108,125
20701,APOLO,estado nutricional en menores de 5 anos,clasificacion d,2002-10-01,43,35,43,35,78
51301,ARAMPAMPA,estado nutricional en menores de 5 anos,clasificacion d,2002-10-01,47,79,47,79,126
30501,ARANI,estado nutricional en menores de 5 anos,clasificacion d,2002-10-01,18,23,18,23,41
30403,ARBIETO,estado nutricional en menores de 5 anos,clasificacion d,2002-10-01,8,35,8,35,43
30601,ARQUE,estado nutricional en menores de 5 anos,clasificacion d,2002-10-01,39,42,39,42,81
71501,ASCENCION DE GUARAYOS,estado nutricional en menores de 5 anos,clasificacion d,2002-10-01,222,313,222,313,535
50802,ATOCHA,estado nutricional en menores de 5 anos,clasificacion d,2002-10-01,2,122,2,122,124
20503,AUCAPATA,estado nutricional en menores de 5 anos,clasificacion d,2002-10-01,18,8,18,8,26
20502,AYATA,estado nutricional en menores de 5 anos,clasificacion d,2002-10-01,39,36,39,36,75
21303,AYO AYO,estado nutricional en menores de 5 anos,clasificacion d,2002-10-01,24,2,24,2,26
30301,AYOPAYA (V. DE INDEPENDENCIA),estado nutricional en menores de 5 anos,clasificacion d,2002-10-01,156,156,156,156,312
10201,AZURDUY,estado nutricional en menores de 5 anos,clasificacion d,2002-10-01,126,207,126,207,333
21203,BATALLAS,estado nutricional en menores de 5 anos,clasificacion d,2002-10-01,33,51,33,51,84
80802,BAURES,estado nutricional en menores de 5 anos,clasificacion d,2002-10-01,28,42,28,42,70
41202,BELEN DE ANDAMARCA,estado nutricional en menores de 5 anos,clasificacion d,2002-10-01,0,3,0,3,3
50104,BELEN DE URMIRI,estado nutricional en menores de 5 anos,clasificacion d,2002-10-01,9,27,9,27,36
90104,BELLA FLOR,estado nutricional en menores de 5 anos,clasificacion d,2002-10-01,0,2,0,2,2
60202,BERMEJO,estado nutricional en menores de 5 anos,clasificacion d,2002-10-01,5,5,5,5,10
50301,BETANZOS,estado nutricional en menores de 5 anos,clasificacion d,2002-10-01,168,252,168,252,420
31501,BOLIVAR,estado nutricional en menores de 5 anos,clasificacion d,2002-10-01,70,105,70,105,175
90103,BOLPEBRA,estado nutricional en menores de 5 anos,clasificacion d,2002-10-01,1,24,1,24,25
70707,BOYUIBE,estado nutricional en menores de 5 anos,clasificacion d,2002-10-01,5,11,5,11,16
70703,CABEZAS,estado nutricional en menores de 5 anos,clasificacion d,2002-10-01,28,27,28,27,55
20905,CAIROMA,estado nutricional en menores de 5 anos,clasificacion d,2002-10-01,57,54,57,54,111
51102,"CAIZA ""D""",estado nutricional en menores de 5 anos,clasificacion d,2002-10-01,81,69,81,69,150
21003,CAJUATA,estado nutricional en menores de 5 anos,clasificacion d,2002-10-01,52,32,52,32,84
20303,CALACOTO,estado nutricional en menores de 5 anos,clasificacion d,2002-10-01,7,12,7,12,19
21304,CALAMARCA,estado nutricional en menores de 5 anos,clasificacion d,2002-10-01,115,107,115,107,222
10701,CAMARGO,estado nutricional en menores de 5 anos,clasificacion d,2002-10-01,69,165,69,165,234
10901,CAMATAQUI (C. VILLA ABECIA),estado nutricional en menores de 5 anos,clasificacion d,2002-10-01,25,36,25,36,61
70706,CAMIRI,estado nutricional en menores de 5 anos,clasificacion d,2002-10-01,169,129,169,129,298
30701,CAPINOTA,estado nutricional en menores de 5 anos,clasificacion d,2002-10-01,66,51,66,51,117
20302,CAQUIAVIRI,estado nutricional en menores de 5 anos,clasificacion d,2002-10-01,17,33,17,33,50
40102,CARACOLLO,estado nutricional en menores de 5 anos,clasificacion d,2002-10-01,17,74,17,74,91
22001,CARANAVI,estado nutricional en menores de 5 anos,clasificacion d,2002-10-01,147,123,147,123,270
41503,CARANGAS,estado nutricional en menores de 5 anos,clasificacion d,2002-10-01,0,2,0,2,2
60302,CARAPARI,estado nutricional en menores de 5 anos,clasificacion d,2002-10-01,42,61,42,61,103
50702,CARIPUYO,estado nutricional en menores de 5 anos,clasificacion d,2002-10-01,35,87,35,87,122
21803,CHACARILLA,estado nutricional en menores de 5 anos,clasificacion d,2002-10-01,1,0,1,0,1
40201,CHALLAPATA,estado nutricional en menores de 5 anos,clasificacion d,2002-10-01,48,102,48,102,150
50302,CHAQUI,estado nutricional en menores de 5 anos,clasificacion d,2002-10-01,61,87,61,87,148
70702,CHARAGUA,estado nutricional en menores de 5 anos,clasificacion d,2002-10-01,36,169,36,169,205
20305,CHARAÃ‘A,estado nutricional en menores de 5 anos,clasificacion d,2002-10-01,11,7,11,7,18
50202,CHAYANTA,estado nutricional en menores de 5 anos,clasificacion d,2002-10-01,39,58,39,58,97
31204,CHIMORE,estado nutricional en menores de 5 anos,clasificacion d,2002-10-01,12,17,12,17,29
40302,CHOQUE COTA,estado nutricional en menores de 5 anos,clasificacion d,2002-10-01,5,12,5,12,17
21101,CHULUMANI (V. DE LA LIBERTAD),estado nutricional en menores de 5 anos,clasificacion d,2002-10-01,4,14,4,14,18
20501,CHUMA,estado nutricional en menores de 5 anos,clasificacion d,2002-10-01,27,17,27,17,44
30801,CLIZA,estado nutricional en menores de 5 anos,clasificacion d,2002-10-01,14,34,14,34,48
90101,COBIJA,estado nutricional en menores de 5 anos,clasificacion d,2002-10-01,104,112,104,112,216
30101,COCHABAMBA,estado nutricional en menores de 5 anos,clasificacion d,2002-10-01,470,510,470,510,980
40902,COIPASA,estado nutricional en menores de 5 anos,clasificacion d,2002-10-01,1,2,1,2,3
30905,COLCAPIRHUA,estado nutricional en menores de 5 anos,clasificacion d,2002-10-01,46,68,46,68,114
50901,"COLCHA ""K""",estado nutricional en menores de 5 anos,clasificacion d,2002-10-01,65,84,65,84,149
21307,COLLANA,estado nutricional en menores de 5 anos,clasificacion d,2002-10-01,6,2,6,2,8
31002,COLOMI,estado nutricional en menores de 5 anos,clasificacion d,2002-10-01,34,82,34,82,116
50401,COLQUECHACA,estado nutricional en menores de 5 anos,clasificacion d,2002-10-01,192,206,192,206,398
21306,COLQUENCHA,estado nutricional en menores de 5 anos,clasificacion d,2002-10-01,29,37,29,37,66
21004,COLQUIRI,estado nutricional en menores de 5 anos,clasificacion d,2002-10-01,104,80,104,80,184
20304,COMANCHE,estado nutricional en menores de 5 anos,clasificacion d,2002-10-01,9,24,9,24,33
71301,COMARAPA,estado nutricional en menores de 5 anos,clasificacion d,2002-10-01,58,68,58,68,126
20605,COMBAYA,estado nutricional en menores de 5 anos,clasificacion d,2002-10-01,12,24,12,24,36
71101,CONCEPCION,estado nutricional en menores de 5 anos,clasificacion d,2002-10-01,74,30,74,30,104
21701,COPACABANA,estado nutricional en menores de 5 anos,clasificacion d,2002-10-01,46,31,46,31,77
21402,CORIPATA,estado nutricional en menores de 5 anos,clasificacion d,2002-10-01,2,10,2,10,12
20301,CORO CORO,estado nutricional en menores de 5 anos,clasificacion d,2002-10-01,19,23,19,23,42
21401,COROICO,estado nutricional en menores de 5 anos,clasificacion d,2002-10-01,20,18,20,18,38
40301,CORQUE,estado nutricional en menores de 5 anos,clasificacion d,2002-10-01,15,27,15,27,42
50601,COTAGAITA,estado nutricional en menores de 5 anos,clasificacion d,2002-10-01,127,300,127,300,427
70102,COTOCA,estado nutricional en menores de 5 anos,clasificacion d,2002-10-01,97,38,97,38,135
31405,CUCHUMUELA (V. G. VILLARROEL),estado nutricional en menores de 5 anos,clasificacion d,2002-10-01,11,10,11,10,21
70704,CUEVO,estado nutricional en menores de 5 anos,clasificacion d,2002-10-01,22,24,22,24,46
10902,CULPINA,estado nutricional en menores de 5 anos,clasificacion d,2002-10-01,184,216,184,216,400
40401,CURAHUARA DE CARANGAS,estado nutricional en menores de 5 anos,clasificacion d,2002-10-01,11,13,11,13,24
21602,CURVA,estado nutricional en menores de 5 anos,clasificacion d,2002-10-01,20,13,20,13,33
20804,DESAGUADERO,estado nutricional en menores de 5 anos,clasificacion d,2002-10-01,16,15,16,15,31
20105,EL ALTO,estado nutricional en menores de 5 anos,clasificacion d,2002-10-01,1970,1594,1970,1594,3564
40103,EL CHORO,estado nutricional en menores de 5 anos,clasificacion d,2002-10-01,4,5,4,5,9
71503,EL PUENTE(STC),estado nutricional en menores de 5 anos,clasificacion d,2002-10-01,12,95,12,95,107
60502,EL PUENTE(TJA),estado nutricional en menores de 5 anos,clasificacion d,2002-10-01,84,193,84,193,277
70105,EL TORNO,estado nutricional en menores de 5 anos,clasificacion d,2002-10-01,54,70,54,70,124
10405,EL VILLAR,estado nutricional en menores de 5 anos,clasificacion d,2002-10-01,46,130,46,130,176
60601,ENTRE RIOS,estado nutricional en menores de 5 anos,clasificacion d,2002-10-01,65,98,65,98,163
41101,EUCALIPTUS,estado nutricional en menores de 5 anos,clasificacion d,2002-10-01,15,10,15,10,25
80402,EXALTACION,estado nutricional en menores de 5 anos,clasificacion d,2002-10-01,2,2,2,2,4
90203,FILADELFIA,estado nutricional en menores de 5 anos,clasificacion d,2002-10-01,0,11,0,11,11
71002,GENERAL SAAVEDRA,estado nutricional en menores de 5 anos,clasificacion d,2002-10-01,60,118,60,118,178
21601,GRAL. J.J. PEREZ (CHARAZANI),estado nutricional en menores de 5 anos,clasificacion d,2002-10-01,34,85,34,85,119
20602,GUANAY,estado nutricional en menores de 5 anos,clasificacion d,2002-10-01,107,111,107,111,218
20802,GUAQUI,estado nutricional en menores de 5 anos,clasificacion d,2002-10-01,14,6,14,6,20
80202,GUAYARAMERIN,estado nutricional en menores de 5 anos,clasificacion d,2002-10-01,117,118,117,118,235
70705,GUTIERREZ,estado nutricional en menores de 5 anos,clasificacion d,2002-10-01,62,146,62,146,208
10502,HUACARETA,estado nutricional en menores de 5 anos,clasificacion d,2002-10-01,80,121,80,121,201
11002,HUACAYA (VILLA DE HUACAYA),estado nutricional en menores de 5 anos,clasificacion d,2002-10-01,4,26,4,26,30
40501,HUACHACALLA,estado nutricional en menores de 5 anos,clasificacion d,2002-10-01,0,12,0,12,12
40701,HUANUNI,estado nutricional en menores de 5 anos,clasificacion d,2002-10-01,96,96,96,96,192
80803,HUARACAJE,estado nutricional en menores de 5 anos,clasificacion d,2002-10-01,7,9,7,9,16
41601,HUAYLLAMARCA,estado nutricional en menores de 5 anos,clasificacion d,2002-10-01,17,23,17,23,40
21005,ICHOCA,estado nutricional en menores de 5 anos,clasificacion d,2002-10-01,30,30,30,30,60
10304,ICLA,estado nutricional en menores de 5 anos,clasificacion d,2002-10-01,108,179,108,179,287
10703,INCAHUASI,estado nutricional en menores de 5 anos,clasificacion d,2002-10-01,102,95,102,95,197
21001,INQUISIVI,estado nutricional en menores de 5 anos,clasificacion d,2002-10-01,90,64,90,64,154
21102,IRUPANA (VILLA DE LANZA),estado nutricional en menores de 5 anos,clasificacion d,2002-10-01,13,37,13,37,50
21501,IXIAMAS,estado nutricional en menores de 5 anos,clasificacion d,2002-10-01,34,50,34,50,84
21105,LA ASUNTA,estado nutricional en menores de 5 anos,clasificacion d,2002-10-01,39,21,39,21,60
70104,LA GUARDIA,estado nutricional en menores de 5 anos,clasificacion d,2002-10-01,47,47,47,47,94
20101,LA PAZ,estado nutricional en menores de 5 anos,clasificacion d,2002-10-01,1357,1152,1357,1152,2509
41501,LA RIVERA,estado nutricional en menores de 5 anos,clasificacion d,2002-10-01,1,0,1,0,1
70701,LAGUNILLAS,estado nutricional en menores de 5 anos,clasificacion d,2002-10-01,32,50,32,50,82
21202,LAJA,estado nutricional en menores de 5 anos,clasificacion d,2002-10-01,50,37,50,37,87
10903,LAS CARRERAS,estado nutricional en menores de 5 anos,clasificacion d,2002-10-01,38,46,38,46,84
21006,LICOMA PAMPA,estado nutricional en menores de 5 anos,clasificacion d,2002-10-01,13,14,13,14,27
50203,LLALLAGUA,estado nutricional en menores de 5 anos,clasificacion d,2002-10-01,20,182,20,182,202
51401,LLICA,estado nutricional en menores de 5 anos,clasificacion d,2002-10-01,16,11,16,11,27
80601,LORETO,estado nutricional en menores de 5 anos,clasificacion d,2002-10-01,11,14,11,14,25
20901,LURIBAY,estado nutricional en menores de 5 anos,clasificacion d,2002-10-01,34,32,34,32,66
40702,MACHACAMARCA,estado nutricional en menores de 5 anos,clasificacion d,2002-10-01,12,8,12,8,20
11003,MACHARETI,estado nutricional en menores de 5 anos,clasificacion d,2002-10-01,60,121,60,121,181
80801,MAGDALENA,estado nutricional en menores de 5 anos,clasificacion d,2002-10-01,23,32,23,32,55
70903,MAIRANA,estado nutricional en menores de 5 anos,clasificacion d,2002-10-01,19,23,19,23,42
20904,MALLA,estado nutricional en menores de 5 anos,clasificacion d,2002-10-01,5,6,5,6,11
20103,MECAPACA,estado nutricional en menores de 5 anos,clasificacion d,2002-10-01,25,47,25,47,72
71003,MINEROS,estado nutricional en menores de 5 anos,clasificacion d,2002-10-01,119,76,119,76,195
31301,MIZQUE,estado nutricional en menores de 5 anos,clasificacion d,2002-10-01,57,85,57,85,142
20402,MOCOMOCO,estado nutricional en menores de 5 anos,clasificacion d,2002-10-01,63,51,63,51,114
51002,MOJINETE,estado nutricional en menores de 5 anos,clasificacion d,2002-10-01,4,13,4,13,17
10303,MOJOCOYA,estado nutricional en menores de 5 anos,clasificacion d,2002-10-01,91,146,91,146,237
10501,MONTEAGUDO,estado nutricional en menores de 5 anos,clasificacion d,2002-10-01,145,227,145,227,372
71001,MONTERO,estado nutricional en menores de 5 anos,clasificacion d,2002-10-01,340,238,340,238,578
70803,MORO MORO,estado nutricional en menores de 5 anos,clasificacion d,2002-10-01,17,18,17,18,35
30302,MOROCHATA,estado nutricional en menores de 5 anos,clasificacion d,2002-10-01,76,113,76,113,189
90401,NACEBE (SANTA ROSA DEL ABUNA),estado nutricional en menores de 5 anos,clasificacion d,2002-10-01,3,10,3,10,13
20307,NAZACARA DE PACAJES,estado nutricional en menores de 5 anos,clasificacion d,2002-10-01,7,1,7,1,8
90501,NUEVO MANOA (NUEVA ESPERANZA),estado nutricional en menores de 5 anos,clasificacion d,2002-10-01,2,7,2,7,9
50404,OCURI,estado nutricional en menores de 5 anos,clasificacion d,2002-10-01,73,72,73,72,145
70202,OKINAWA,estado nutricional en menores de 5 anos,clasificacion d,2002-10-01,9,15,9,15,24
30203,OMEREQUE,estado nutricional en menores de 5 anos,clasificacion d,2002-10-01,0,38,0,38,38
40101,ORURO,estado nutricional en menores de 5 anos,clasificacion d,2002-10-01,699,559,699,559,1258
60201,PADCAYA,estado nutricional en menores de 5 anos,clasificacion d,2002-10-01,54,63,54,63,117
10401,PADILLA,estado nutricional en menores de 5 anos,clasificacion d,2002-10-01,132,248,132,248,380
70502,PAILON,estado nutricional en menores de 5 anos,clasificacion d,2002-10-01,20,17,20,17,37
20102,PALCA,estado nutricional en menores de 5 anos,clasificacion d,2002-10-01,29,48,29,48,77
21104,PALOS BLANCOS,estado nutricional en menores de 5 anos,clasificacion d,2002-10-01,73,72,73,72,145
40802,PAMPA AULLAGAS,estado nutricional en menores de 5 anos,clasificacion d,2002-10-01,12,28,12,28,40
70902,PAMPA GRANDE,estado nutricional en menores de 5 anos,clasificacion d,2002-10-01,22,30,22,30,52
21802,PAPEL PAMPA,estado nutricional en menores de 5 anos,clasificacion d,2002-10-01,11,11,11,11,22
30202,PASORAPA,estado nutricional en menores de 5 anos,clasificacion d,2002-10-01,23,38,23,38,61
21305,PATACAMAYA,estado nutricional en menores de 5 anos,clasificacion d,2002-10-01,66,45,66,45,111
40602,PAZÃ‘A,estado nutricional en menores de 5 anos,clasificacion d,2002-10-01,5,11,5,11,16
20702,PELECHUCO,estado nutricional en menores de 5 anos,clasificacion d,2002-10-01,24,21,24,21,45
50403,POCOATA,estado nutricional en menores de 5 anos,clasificacion d,2002-10-01,187,254,187,254,441
31203,POCONA,estado nutricional en menores de 5 anos,clasificacion d,2002-10-01,40,59,40,59,99
31202,POJO (CBBA),estado nutricional en menores de 5 anos,clasificacion d,2002-10-01,153,120,153,120,273
40601,POOPO,estado nutricional en menores de 5 anos,clasificacion d,2002-10-01,20,26,20,26,46
51203,PORCO,estado nutricional en menores de 5 anos,clasificacion d,2002-10-01,42,64,42,64,106
10103,POROMA,estado nutricional en menores de 5 anos,clasificacion d,2002-10-01,139,209,139,209,348
70103,PORONGO,estado nutricional en menores de 5 anos,clasificacion d,2002-10-01,16,15,16,15,31
70601,PORTACHUELO,estado nutricional en menores de 5 anos,clasificacion d,2002-10-01,54,30,54,30,84
90102,PORVENIR,estado nutricional en menores de 5 anos,clasificacion d,2002-10-01,7,1,7,1,8
70804,POSTRER VALLE,estado nutricional en menores de 5 anos,clasificacion d,2002-10-01,5,13,5,13,18
50101,POTOSI,estado nutricional en menores de 5 anos,clasificacion d,2002-10-01,592,541,592,541,1133
10302,PRESTO,estado nutricional en menores de 5 anos,clasificacion d,2002-10-01,78,108,78,108,186
70805,PUCARA,estado nutricional en menores de 5 anos,clasificacion d,2002-10-01,3,10,3,10,13
21201,PUCARANI,estado nutricional en menores de 5 anos,clasificacion d,2002-10-01,47,56,47,56,103
20401,PUERTO ACOSTA,estado nutricional en menores de 5 anos,clasificacion d,2002-10-01,99,86,99,86,185
20403,PUERTO CARABUCO,estado nutricional en menores de 5 anos,clasificacion d,2002-10-01,54,53,54,53,107
90301,PUERTO GONZALO MORENO,estado nutricional en menores de 5 anos,clasificacion d,2002-10-01,6,10,6,10,16
21204,PUERTO PEREZ,estado nutricional en menores de 5 anos,clasificacion d,2002-10-01,28,21,28,21,49
71402,PUERTO QUIJARRO,estado nutricional en menores de 5 anos,clasificacion d,2002-10-01,15,17,15,17,32
90201,PUERTO RICO,estado nutricional en menores de 5 anos,clasificacion d,2002-10-01,10,19,10,19,29
80703,PUERTO SILES,estado nutricional en menores de 5 anos,clasificacion d,2002-10-01,0,1,0,1,1
71401,PUERTO SUAREZ,estado nutricional en menores de 5 anos,clasificacion d,2002-10-01,68,25,68,25,93
31205,PUERTO VILLARROEL,estado nutricional en menores de 5 anos,clasificacion d,2002-10-01,163,132,163,132,295
51101,PUNA,estado nutricional en menores de 5 anos,clasificacion d,2002-10-01,53,68,53,68,121
31401,PUNATA,estado nutricional en menores de 5 anos,clasificacion d,2002-10-01,182,77,182,77,259
20604,QUIABAYA,estado nutricional en menores de 5 anos,clasificacion d,2002-10-01,14,44,14,44,58
30901,QUILLACOLLO,estado nutricional en menores de 5 anos,clasificacion d,2002-10-01,147,172,147,172,319
21002,QUIME,estado nutricional en menores de 5 anos,clasificacion d,2002-10-01,68,87,68,87,155
70904,QUIRUSILLAS,estado nutricional en menores de 5 anos,clasificacion d,2002-10-01,0,1,0,1,1
50402,RAVELO,estado nutricional en menores de 5 anos,clasificacion d,2002-10-01,181,199,181,199,380
80301,REYES,estado nutricional en menores de 5 anos,clasificacion d,2002-10-01,23,31,23,31,54
80201,RIBERALTA,estado nutricional en menores de 5 anos,clasificacion d,2002-10-01,451,317,451,317,768
70503,ROBORE,estado nutricional en menores de 5 anos,clasificacion d,2002-10-01,21,29,21,29,50
80304,RURRENABAQUE,estado nutricional en menores de 5 anos,clasificacion d,2002-10-01,31,5,31,5,36
40901,SABAYA,estado nutricional en menores de 5 anos,clasificacion d,2002-10-01,3,5,3,5,8
31001,SACABA,estado nutricional en menores de 5 anos,clasificacion d,2002-10-01,196,87,196,87,283
30404,SACABAMBA,estado nutricional en menores de 5 anos,clasificacion d,2002-10-01,25,70,25,70,95
50701,SACACA,estado nutricional en menores de 5 anos,clasificacion d,2002-10-01,127,290,127,290,417
71302,SAIPINA,estado nutricional en menores de 5 anos,clasificacion d,2002-10-01,12,9,12,9,21
40801,SALINAS DE GARCI MENDOZA,estado nutricional en menores de 5 anos,clasificacion d,2002-10-01,13,17,13,17,30
70901,SAMAIPATA,estado nutricional en menores de 5 anos,clasificacion d,2002-10-01,21,21,21,21,42
51601,SAN AGUSTIN,estado nutricional en menores de 5 anos,clasificacion d,2002-10-01,4,5,4,5,9
80602,SAN ANDRES,estado nutricional en menores de 5 anos,clasificacion d,2002-10-01,14,37,14,37,51
51003,SAN ANTONIO DE ESMORUCO,estado nutricional en menores de 5 anos,clasificacion d,2002-10-01,6,20,6,20,26
71105,SAN ANTONIO DE LOMERIO,estado nutricional en menores de 5 anos,clasificacion d,2002-10-01,86,145,86,145,231
31403,SAN BENITO,estado nutricional en menores de 5 anos,clasificacion d,2002-10-01,12,33,12,33,45
80302,SAN BORJA,estado nutricional en menores de 5 anos,clasificacion d,2002-10-01,137,147,137,147,284
21502,SAN BUENA VENTURA,estado nutricional en menores de 5 anos,clasificacion d,2002-10-01,27,25,27,25,52
80501,SAN IGNACIO,estado nutricional en menores de 5 anos,clasificacion d,2002-10-01,129,99,129,99,228
70301,SAN IGNACIO DE VELASCO,estado nutricional en menores de 5 anos,clasificacion d,2002-10-01,196,189,196,189,385
80102,SAN JAVIER(BNI),estado nutricional en menores de 5 anos,clasificacion d,2002-10-01,1,18,1,18,19
71102,SAN JAVIER(STC),estado nutricional en menores de 5 anos,clasificacion d,2002-10-01,49,63,49,63,112
80701,SAN JOAQUIN,estado nutricional en menores de 5 anos,clasificacion d,2002-10-01,9,14,9,14,23
70501,SAN JOSE DE CHIQUITOS,estado nutricional en menores de 5 anos,clasificacion d,2002-10-01,53,22,53,22,75
71104,SAN JULIAN,estado nutricional en menores de 5 anos,clasificacion d,2002-10-01,166,197,166,197,363
90302,SAN LORENZO(PND),estado nutricional en menores de 5 anos,clasificacion d,2002-10-01,4,36,4,36,40
60501,SAN LORENZO(TJA),estado nutricional en menores de 5 anos,clasificacion d,2002-10-01,36,20,36,20,56
10702,SAN LUCAS,estado nutricional en menores de 5 anos,clasificacion d,2002-10-01,481,481,481,481,962
71201,SAN MATIAS,estado nutricional en menores de 5 anos,clasificacion d,2002-10-01,66,40,66,40,106
70302,SAN MIGUEL DE VELASCO,estado nutricional en menores de 5 anos,clasificacion d,2002-10-01,85,141,85,141,226
51001,SAN PABLO DE LIPEZ,estado nutricional en menores de 5 anos,clasificacion d,2002-10-01,8,27,8,27,35
50501,SAN PEDRO DE BUENA VISTA,estado nutricional en menores de 5 anos,clasificacion d,2002-10-01,81,196,81,196,277
21801,SAN PEDRO DE CURAHUARA,estado nutricional en menores de 5 anos,clasificacion d,2002-10-01,23,35,23,35,58
50902,SAN PEDRO DE QUEMES,estado nutricional en menores de 5 anos,clasificacion d,2002-10-01,6,3,6,3,9
21702,SAN PEDRO DE TIQUINA,estado nutricional en menores de 5 anos,clasificacion d,2002-10-01,4,6,4,6,10
90202,SAN PEDRO(PND),estado nutricional en menores de 5 anos,clasificacion d,2002-10-01,4,1,4,1,5
70303,SAN RAFAEL,estado nutricional en menores de 5 anos,clasificacion d,2002-10-01,37,39,37,39,76
80702,SAN RAMON,estado nutricional en menores de 5 anos,clasificacion d,2002-10-01,14,4,14,4,18
80401,SANTA ANA,estado nutricional en menores de 5 anos,clasificacion d,2002-10-01,25,3,25,3,28
70101,SANTA CRUZ DE LA SIERRA,estado nutricional en menores de 5 anos,clasificacion d,2002-10-01,1052,640,1052,640,1692
80303,SANTA ROSA,estado nutricional en menores de 5 anos,clasificacion d,2002-10-01,7,17,7,17,24
70602,SANTA ROSA DEL SARA,estado nutricional en menores de 5 anos,clasificacion d,2002-10-01,12,16,12,16,28
20308,SANTIAGO DE CALLAPA,estado nutricional en menores de 5 anos,clasificacion d,2002-10-01,38,24,38,24,62
41401,SANTIAGO DE HUARI,estado nutricional en menores de 5 anos,clasificacion d,2002-10-01,22,38,22,38,60
21901,SANTIAGO DE MACHACA,estado nutricional en menores de 5 anos,clasificacion d,2002-10-01,10,10,10,10,20
30702,SANTIVAÃ‘ES,estado nutricional en menores de 5 anos,clasificacion d,2002-10-01,19,12,19,12,31
40202,SANTUARIO DE QUILLACAS,estado nutricional en menores de 5 anos,clasificacion d,2002-10-01,6,16,6,16,22
20902,SAPAHAQUI,estado nutricional en menores de 5 anos,clasificacion d,2002-10-01,47,41,47,41,88
90303,SENA,estado nutricional en menores de 5 anos,clasificacion d,2002-10-01,22,12,22,12,34
21301,SICA SICA (VILLA AROMA),estado nutricional en menores de 5 anos,clasificacion d,2002-10-01,59,57,59,57,116
30703,SICAYA,estado nutricional en menores de 5 anos,clasificacion d,2002-10-01,26,16,26,16,42
30902,SIPE SIPE,estado nutricional en menores de 5 anos,clasificacion d,2002-10-01,149,112,149,112,261
10403,SOPACHUY,estado nutricional en menores de 5 anos,clasificacion d,2002-10-01,57,82,57,82,139
20601,SORATA,estado nutricional en menores de 5 anos,clasificacion d,2002-10-01,75,113,75,113,188
10101,SUCRE,estado nutricional en menores de 5 anos,clasificacion d,2002-10-01,746,832,746,832,1578
31404,TACACHI,estado nutricional en menores de 5 anos,clasificacion d,2002-10-01,1,10,1,10,11
20603,TACACOMA,estado nutricional en menores de 5 anos,clasificacion d,2002-10-01,20,34,20,34,54
50303,TACOBAMBA,estado nutricional en menores de 5 anos,clasificacion d,2002-10-01,66,109,66,109,175
30602,TACOPAYA,estado nutricional en menores de 5 anos,clasificacion d,2002-10-01,55,163,55,163,218
51402,TAHUA,estado nutricional en menores de 5 anos,clasificacion d,2002-10-01,2,0,2,0,2
31101,TAPACARI,estado nutricional en menores de 5 anos,clasificacion d,2002-10-01,114,145,114,145,259
10601,TARABUCO,estado nutricional en menores de 5 anos,clasificacion d,2002-10-01,278,480,278,480,758
30401,TARATA,estado nutricional en menores de 5 anos,clasificacion d,2002-10-01,46,38,46,38,84
60101,TARIJA,estado nutricional en menores de 5 anos,clasificacion d,2002-10-01,310,301,310,301,611
10202,TARVITA,estado nutricional en menores de 5 anos,clasificacion d,2002-10-01,123,204,123,204,327
20803,TIAWANACU,estado nutricional en menores de 5 anos,clasificacion d,2002-10-01,20,23,20,23,43
50102,TINGUIPAYA,estado nutricional en menores de 5 anos,clasificacion d,2002-10-01,104,222,104,222,326
20606,TIPUANI,estado nutricional en menores de 5 anos,clasificacion d,2002-10-01,24,12,24,12,36
30903,TIQUIPAYA,estado nutricional en menores de 5 anos,clasificacion d,2002-10-01,91,97,91,97,188
31601,TIRAQUE (CBBA),estado nutricional en menores de 5 anos,clasificacion d,2002-10-01,99,194,99,194,293
21703,TITO YUPANQUI (PARQUIPUJIO),estado nutricional en menores de 5 anos,clasificacion d,2002-10-01,0,19,0,19,19
30802,TOCO,estado nutricional en menores de 5 anos,clasificacion d,2002-10-01,3,17,3,17,20
30803,TOLATA,estado nutricional en menores de 5 anos,clasificacion d,2002-10-01,3,0,3,0,3
41001,TOLEDO,estado nutricional en menores de 5 anos,clasificacion d,2002-10-01,9,12,9,12,21
51202,TOMAVE,estado nutricional en menores de 5 anos,clasificacion d,2002-10-01,64,78,64,78,142
10402,TOMINA,estado nutricional en menores de 5 anos,clasificacion d,2002-10-01,97,207,97,207,304
50502,TORO TORO,estado nutricional en menores de 5 anos,clasificacion d,2002-10-01,53,64,53,64,117
31201,TOTORA(CBBA),estado nutricional en menores de 5 anos,clasificacion d,2002-10-01,54,47,54,47,101
41301,TOTORA(ORR),estado nutricional en menores de 5 anos,clasificacion d,2002-10-01,12,8,12,8,20
70802,TRIGAL,estado nutricional en menores de 5 anos,clasificacion d,2002-10-01,4,5,4,5,9
80101,TRINIDAD,estado nutricional en menores de 5 anos,clasificacion d,2002-10-01,114,217,114,217,331
50801,TUPIZA,estado nutricional en menores de 5 anos,clasificacion d,2002-10-01,68,411,68,411,479
40402,TURCO,estado nutricional en menores de 5 anos,clasificacion d,2002-10-01,7,9,7,9,16
21302,UMALA,estado nutricional en menores de 5 anos,clasificacion d,2002-10-01,18,7,18,7,25
50201,UNCIA,estado nutricional en menores de 5 anos,clasificacion d,2002-10-01,4,0,4,0,4
60401,URIONDO (A. CONCEPCION),estado nutricional en menores de 5 anos,clasificacion d,2002-10-01,25,31,25,31,56
71502,URUBICHA,estado nutricional en menores de 5 anos,clasificacion d,2002-10-01,105,184,105,184,289
51201,UYUNI,estado nutricional en menores de 5 anos,clasificacion d,2002-10-01,82,130,82,130,212
30502,VACAS,estado nutricional en menores de 5 anos,clasificacion d,2002-10-01,37,54,37,54,91
70801,VALLEGRANDE,estado nutricional en menores de 5 anos,clasificacion d,2002-10-01,65,85,65,85,150
20801,VIACHA,estado nutricional en menores de 5 anos,clasificacion d,2002-10-01,106,114,106,114,220
31302,VILA VILA,estado nutricional en menores de 5 anos,clasificacion d,2002-10-01,17,95,17,95,112
60303,VILLA MONTES,estado nutricional en menores de 5 anos,clasificacion d,2002-10-01,49,59,49,59,108
90502,VILLA NUEVA (LOMA ALTA),estado nutricional en menores de 5 anos,clasificacion d,2002-10-01,1,0,1,0,1
31402,VILLA RIVERO,estado nutricional en menores de 5 anos,clasificacion d,2002-10-01,12,23,12,23,35
10801,VILLA SERRANO,estado nutricional en menores de 5 anos,clasificacion d,2002-10-01,107,242,107,242,349
31003,VILLA TUNARI,estado nutricional en menores de 5 anos,clasificacion d,2002-10-01,132,147,132,147,279
11001,VILLA VACA GUZMAN (MUYUPAMPA),estado nutricional en menores de 5 anos,clasificacion d,2002-10-01,59,117,59,117,176
51501,VILLAZON,estado nutricional en menores de 5 anos,clasificacion d,2002-10-01,147,233,147,233,380
30904,VINTO,estado nutricional en menores de 5 anos,clasificacion d,2002-10-01,77,39,77,39,116
50602,VITICHI,estado nutricional en menores de 5 anos,clasificacion d,2002-10-01,61,150,61,150,211
20306,WALDO BALLIVIAN,estado nutricional en menores de 5 anos,clasificacion d,2002-10-01,5,3,5,3,8
70201,WARNES,estado nutricional en menores de 5 anos,clasificacion d,2002-10-01,113,94,113,94,207
20903,YACO,estado nutricional en menores de 5 anos,clasificacion d,2002-10-01,32,59,32,59,91
60301,YACUIBA,estado nutricional en menores de 5 anos,clasificacion d,2002-10-01,99,112,99,112,211
10602,YAMPARAEZ,estado nutricional en menores de 5 anos,clasificacion d,2002-10-01,129,215,129,215,344
21103,YANACACHI,estado nutricional en menores de 5 anos,clasificacion d,2002-10-01,13,16,13,16,29
50103,YOCALLA,estado nutricional en menores de 5 anos,clasificacion d,2002-10-01,43,68,43,68,111
10102,YOTALA,estado nutricional en menores de 5 anos,clasificacion d,2002-10-01,105,191,105,191,296
60402,YUNCHARA,estado nutricional en menores de 5 anos,clasificacion d,2002-10-01,26,49,26,49,75
10301,ZUDAÃ‘EZ,estado nutricional en menores de 5 anos,clasificacion d,2002-10-01,75,125,75,125,200
51302,ACACIO,estado nutricional en menores de 5 anos,clasificacion d,2002-11-01,31,109,31,109,140
20201,ACHACACHI,estado nutricional en menores de 5 anos,clasificacion d,2002-11-01,187,196,187,196,383
20104,ACHOCALLA,estado nutricional en menores de 5 anos,clasificacion d,2002-11-01,32,18,32,18,50
30201,AIQUILE,estado nutricional en menores de 5 anos,clasificacion d,2002-11-01,58,84,58,84,142
31303,ALALAY,estado nutricional en menores de 5 anos,clasificacion d,2002-11-01,16,64,16,64,80
10404,ALCALA,estado nutricional en menores de 5 anos,clasificacion d,2002-11-01,32,72,32,72,104
20202,ANCORAIMES,estado nutricional en menores de 5 anos,clasificacion d,2002-11-01,78,136,78,136,214
41201,ANDAMARCA,estado nutricional en menores de 5 anos,clasificacion d,2002-11-01,8,3,8,3,11
40603,ANTEQUERA,estado nutricional en menores de 5 anos,clasificacion d,2002-11-01,4,4,4,4,8
30402,ANZALDO,estado nutricional en menores de 5 anos,clasificacion d,2002-11-01,11,81,11,81,92
20701,APOLO,estado nutricional en menores de 5 anos,clasificacion d,2002-11-01,64,66,64,66,130
51301,ARAMPAMPA,estado nutricional en menores de 5 anos,clasificacion d,2002-11-01,35,71,35,71,106
30501,ARANI,estado nutricional en menores de 5 anos,clasificacion d,2002-11-01,34,14,34,14,48
30403,ARBIETO,estado nutricional en menores de 5 anos,clasificacion d,2002-11-01,7,4,7,4,11
30601,ARQUE,estado nutricional en menores de 5 anos,clasificacion d,2002-11-01,37,31,37,31,68
50802,ATOCHA,estado nutricional en menores de 5 anos,clasificacion d,2002-11-01,1,99,1,99,100
20503,AUCAPATA,estado nutricional en menores de 5 anos,clasificacion d,2002-11-01,25,7,25,7,32
20502,AYATA,estado nutricional en menores de 5 anos,clasificacion d,2002-11-01,25,18,25,18,43
21303,AYO AYO,estado nutricional en menores de 5 anos,clasificacion d,2002-11-01,9,4,9,4,13
30301,AYOPAYA (V. DE INDEPENDENCIA),estado nutricional en menores de 5 anos,clasificacion d,2002-11-01,107,161,107,161,268
10201,AZURDUY,estado nutricional en menores de 5 anos,clasificacion d,2002-11-01,103,169,103,169,272
21203,BATALLAS,estado nutricional en menores de 5 anos,clasificacion d,2002-11-01,46,22,46,22,68
80802,BAURES,estado nutricional en menores de 5 anos,clasificacion d,2002-11-01,21,29,21,29,50
41202,BELEN DE ANDAMARCA,estado nutricional en menores de 5 anos,clasificacion d,2002-11-01,1,2,1,2,3
50104,BELEN DE URMIRI,estado nutricional en menores de 5 anos,clasificacion d,2002-11-01,9,17,9,17,26
90104,BELLA FLOR,estado nutricional en menores de 5 anos,clasificacion d,2002-11-01,0,8,0,8,8
60202,BERMEJO,estado nutricional en menores de 5 anos,clasificacion d,2002-11-01,11,10,11,10,21
50301,BETANZOS,estado nutricional en menores de 5 anos,clasificacion d,2002-11-01,336,449,336,449,785
31501,BOLIVAR,estado nutricional en menores de 5 anos,clasificacion d,2002-11-01,95,94,95,94,189
90103,BOLPEBRA,estado nutricional en menores de 5 anos,clasificacion d,2002-11-01,5,19,5,19,24
70707,BOYUIBE,estado nutricional en menores de 5 anos,clasificacion d,2002-11-01,5,16,5,16,21
70401,BUENA VISTA,estado nutricional en menores de 5 anos,clasificacion d,2002-11-01,35,40,35,40,75
70703,CABEZAS,estado nutricional en menores de 5 anos,clasificacion d,2002-11-01,39,57,39,57,96
20905,CAIROMA,estado nutricional en menores de 5 anos,clasificacion d,2002-11-01,27,23,27,23,50
51102,"CAIZA ""D""",estado nutricional en menores de 5 anos,clasificacion d,2002-11-01,131,116,131,116,247
21003,CAJUATA,estado nutricional en menores de 5 anos,clasificacion d,2002-11-01,36,56,36,56,92
20303,CALACOTO,estado nutricional en menores de 5 anos,clasificacion d,2002-11-01,24,9,24,9,33
21304,CALAMARCA,estado nutricional en menores de 5 anos,clasificacion d,2002-11-01,86,66,86,66,152
10701,CAMARGO,estado nutricional en menores de 5 anos,clasificacion d,2002-11-01,46,91,46,91,137
10901,CAMATAQUI (C. VILLA ABECIA),estado nutricional en menores de 5 anos,clasificacion d,2002-11-01,19,25,19,25,44
70706,CAMIRI,estado nutricional en menores de 5 anos,clasificacion d,2002-11-01,115,78,115,78,193
30701,CAPINOTA,estado nutricional en menores de 5 anos,clasificacion d,2002-11-01,54,58,54,58,112
20302,CAQUIAVIRI,estado nutricional en menores de 5 anos,clasificacion d,2002-11-01,23,37,23,37,60
40102,CARACOLLO,estado nutricional en menores de 5 anos,clasificacion d,2002-11-01,21,122,21,122,143
22001,CARANAVI,estado nutricional en menores de 5 anos,clasificacion d,2002-11-01,181,150,181,150,331
60302,CARAPARI,estado nutricional en menores de 5 anos,clasificacion d,2002-11-01,17,39,17,39,56
50702,CARIPUYO,estado nutricional en menores de 5 anos,clasificacion d,2002-11-01,90,97,90,97,187
21902,CATACORA,estado nutricional en menores de 5 anos,clasificacion d,2002-11-01,6,6,6,6,12
21803,CHACARILLA,estado nutricional en menores de 5 anos,clasificacion d,2002-11-01,1,0,1,0,1
40201,CHALLAPATA,estado nutricional en menores de 5 anos,clasificacion d,2002-11-01,45,90,45,90,135
50302,CHAQUI,estado nutricional en menores de 5 anos,clasificacion d,2002-11-01,97,60,97,60,157
70702,CHARAGUA,estado nutricional en menores de 5 anos,clasificacion d,2002-11-01,23,173,23,173,196
20305,CHARAÃ‘A,estado nutricional en menores de 5 anos,clasificacion d,2002-11-01,11,12,11,12,23
50202,CHAYANTA,estado nutricional en menores de 5 anos,clasificacion d,2002-11-01,80,119,80,119,199
31204,CHIMORE,estado nutricional en menores de 5 anos,clasificacion d,2002-11-01,15,18,15,18,33
40903,CHIPAYA,estado nutricional en menores de 5 anos,clasificacion d,2002-11-01,1,0,1,0,1
21101,CHULUMANI (V. DE LA LIBERTAD),estado nutricional en menores de 5 anos,clasificacion d,2002-11-01,14,5,14,5,19
20501,CHUMA,estado nutricional en menores de 5 anos,clasificacion d,2002-11-01,39,40,39,40,79
30801,CLIZA,estado nutricional en menores de 5 anos,clasificacion d,2002-11-01,9,6,9,6,15
90101,COBIJA,estado nutricional en menores de 5 anos,clasificacion d,2002-11-01,37,38,37,38,75
30101,COCHABAMBA,estado nutricional en menores de 5 anos,clasificacion d,2002-11-01,408,419,408,419,827
30905,COLCAPIRHUA,estado nutricional en menores de 5 anos,clasificacion d,2002-11-01,36,25,36,25,61
50901,"COLCHA ""K""",estado nutricional en menores de 5 anos,clasificacion d,2002-11-01,47,73,47,73,120
21307,COLLANA,estado nutricional en menores de 5 anos,clasificacion d,2002-11-01,2,1,2,1,3
31002,COLOMI,estado nutricional en menores de 5 anos,clasificacion d,2002-11-01,24,39,24,39,63
50401,COLQUECHACA,estado nutricional en menores de 5 anos,clasificacion d,2002-11-01,132,108,132,108,240
21306,COLQUENCHA,estado nutricional en menores de 5 anos,clasificacion d,2002-11-01,29,14,29,14,43
21004,COLQUIRI,estado nutricional en menores de 5 anos,clasificacion d,2002-11-01,98,89,98,89,187
20304,COMANCHE,estado nutricional en menores de 5 anos,clasificacion d,2002-11-01,11,10,11,10,21
71301,COMARAPA,estado nutricional en menores de 5 anos,clasificacion d,2002-11-01,62,37,62,37,99
20605,COMBAYA,estado nutricional en menores de 5 anos,clasificacion d,2002-11-01,3,13,3,13,16
71101,CONCEPCION,estado nutricional en menores de 5 anos,clasificacion d,2002-11-01,19,15,19,15,34
21701,COPACABANA,estado nutricional en menores de 5 anos,clasificacion d,2002-11-01,61,45,61,45,106
21402,CORIPATA,estado nutricional en menores de 5 anos,clasificacion d,2002-11-01,7,8,7,8,15
20301,CORO CORO,estado nutricional en menores de 5 anos,clasificacion d,2002-11-01,27,32,27,32,59
21401,COROICO,estado nutricional en menores de 5 anos,clasificacion d,2002-11-01,37,16,37,16,53
40301,CORQUE,estado nutricional en menores de 5 anos,clasificacion d,2002-11-01,9,9,9,9,18
50601,COTAGAITA,estado nutricional en menores de 5 anos,clasificacion d,2002-11-01,83,149,83,149,232
70102,COTOCA,estado nutricional en menores de 5 anos,clasificacion d,2002-11-01,46,47,46,47,93
31405,CUCHUMUELA (V. G. VILLARROEL),estado nutricional en menores de 5 anos,clasificacion d,2002-11-01,1,6,1,6,7
70704,CUEVO,estado nutricional en menores de 5 anos,clasificacion d,2002-11-01,17,35,17,35,52
10902,CULPINA,estado nutricional en menores de 5 anos,clasificacion d,2002-11-01,175,219,175,219,394
40401,CURAHUARA DE CARANGAS,estado nutricional en menores de 5 anos,clasificacion d,2002-11-01,14,11,14,11,25
21602,CURVA,estado nutricional en menores de 5 anos,clasificacion d,2002-11-01,19,14,19,14,33
20804,DESAGUADERO,estado nutricional en menores de 5 anos,clasificacion d,2002-11-01,13,9,13,9,22
20105,EL ALTO,estado nutricional en menores de 5 anos,clasificacion d,2002-11-01,1941,1296,1941,1296,3237
40103,EL CHORO,estado nutricional en menores de 5 anos,clasificacion d,2002-11-01,5,6,5,6,11
71503,EL PUENTE(STC),estado nutricional en menores de 5 anos,clasificacion d,2002-11-01,31,81,31,81,112
60502,EL PUENTE(TJA),estado nutricional en menores de 5 anos,clasificacion d,2002-11-01,66,154,66,154,220
70105,EL TORNO,estado nutricional en menores de 5 anos,clasificacion d,2002-11-01,73,55,73,55,128
10405,EL VILLAR,estado nutricional en menores de 5 anos,clasificacion d,2002-11-01,44,109,44,109,153
60601,ENTRE RIOS,estado nutricional en menores de 5 anos,clasificacion d,2002-11-01,25,39,25,39,64
40502,ESCARA,estado nutricional en menores de 5 anos,clasificacion d,2002-11-01,0,1,0,1,1
41101,EUCALIPTUS,estado nutricional en menores de 5 anos,clasificacion d,2002-11-01,22,19,22,19,41
90503,EUREKA (SANTOS MERCADO),estado nutricional en menores de 5 anos,clasificacion d,2002-11-01,2,1,2,1,3
80402,EXALTACION,estado nutricional en menores de 5 anos,clasificacion d,2002-11-01,3,17,3,17,20
90203,FILADELFIA,estado nutricional en menores de 5 anos,clasificacion d,2002-11-01,3,7,3,7,10
71002,GENERAL SAAVEDRA,estado nutricional en menores de 5 anos,clasificacion d,2002-11-01,61,100,61,100,161
21601,GRAL. J.J. PEREZ (CHARAZANI),estado nutricional en menores de 5 anos,clasificacion d,2002-11-01,34,47,34,47,81
20602,GUANAY,estado nutricional en menores de 5 anos,clasificacion d,2002-11-01,84,72,84,72,156
20802,GUAQUI,estado nutricional en menores de 5 anos,clasificacion d,2002-11-01,9,6,9,6,15
80202,GUAYARAMERIN,estado nutricional en menores de 5 anos,clasificacion d,2002-11-01,77,81,77,81,158
70705,GUTIERREZ,estado nutricional en menores de 5 anos,clasificacion d,2002-11-01,100,142,100,142,242
10502,HUACARETA,estado nutricional en menores de 5 anos,clasificacion d,2002-11-01,67,101,67,101,168
11002,HUACAYA (VILLA DE HUACAYA),estado nutricional en menores de 5 anos,clasificacion d,2002-11-01,8,18,8,18,26
40501,HUACHACALLA,estado nutricional en menores de 5 anos,clasificacion d,2002-11-01,0,15,0,15,15
40701,HUANUNI,estado nutricional en menores de 5 anos,clasificacion d,2002-11-01,70,48,70,48,118
80803,HUARACAJE,estado nutricional en menores de 5 anos,clasificacion d,2002-11-01,9,5,9,5,14
41601,HUAYLLAMARCA,estado nutricional en menores de 5 anos,clasificacion d,2002-11-01,23,19,23,19,42
21005,ICHOCA,estado nutricional en menores de 5 anos,clasificacion d,2002-11-01,20,26,20,26,46
10304,ICLA,estado nutricional en menores de 5 anos,clasificacion d,2002-11-01,128,237,128,237,365
10703,INCAHUASI,estado nutricional en menores de 5 anos,clasificacion d,2002-11-01,215,136,215,136,351
21001,INQUISIVI,estado nutricional en menores de 5 anos,clasificacion d,2002-11-01,91,106,91,106,197
21102,IRUPANA (VILLA DE LANZA),estado nutricional en menores de 5 anos,clasificacion d,2002-11-01,11,25,11,25,36
21501,IXIAMAS,estado nutricional en menores de 5 anos,clasificacion d,2002-11-01,28,39,28,39,67
21105,LA ASUNTA,estado nutricional en menores de 5 anos,clasificacion d,2002-11-01,20,22,20,22,42
70104,LA GUARDIA,estado nutricional en menores de 5 anos,clasificacion d,2002-11-01,54,37,54,37,91
20101,LA PAZ,estado nutricional en menores de 5 anos,clasificacion d,2002-11-01,1156,1002,1156,1002,2158
70701,LAGUNILLAS,estado nutricional en menores de 5 anos,clasificacion d,2002-11-01,39,49,39,49,88
21202,LAJA,estado nutricional en menores de 5 anos,clasificacion d,2002-11-01,23,19,23,19,42
10903,LAS CARRERAS,estado nutricional en menores de 5 anos,clasificacion d,2002-11-01,31,40,31,40,71
21006,LICOMA PAMPA,estado nutricional en menores de 5 anos,clasificacion d,2002-11-01,17,4,17,4,21
50203,LLALLAGUA,estado nutricional en menores de 5 anos,clasificacion d,2002-11-01,40,210,40,210,250
51401,LLICA,estado nutricional en menores de 5 anos,clasificacion d,2002-11-01,10,25,10,25,35
80601,LORETO,estado nutricional en menores de 5 anos,clasificacion d,2002-11-01,14,28,14,28,42
20901,LURIBAY,estado nutricional en menores de 5 anos,clasificacion d,2002-11-01,36,15,36,15,51
40702,MACHACAMARCA,estado nutricional en menores de 5 anos,clasificacion d,2002-11-01,6,3,6,3,9
11003,MACHARETI,estado nutricional en menores de 5 anos,clasificacion d,2002-11-01,43,91,43,91,134
80801,MAGDALENA,estado nutricional en menores de 5 anos,clasificacion d,2002-11-01,12,12,12,12,24
70903,MAIRANA,estado nutricional en menores de 5 anos,clasificacion d,2002-11-01,25,13,25,13,38
20904,MALLA,estado nutricional en menores de 5 anos,clasificacion d,2002-11-01,13,17,13,17,30
20103,MECAPACA,estado nutricional en menores de 5 anos,clasificacion d,2002-11-01,18,30,18,30,48
71003,MINEROS,estado nutricional en menores de 5 anos,clasificacion d,2002-11-01,114,66,114,66,180
31301,MIZQUE,estado nutricional en menores de 5 anos,clasificacion d,2002-11-01,11,31,11,31,42
20402,MOCOMOCO,estado nutricional en menores de 5 anos,clasificacion d,2002-11-01,36,26,36,26,62
51002,MOJINETE,estado nutricional en menores de 5 anos,clasificacion d,2002-11-01,5,14,5,14,19
10303,MOJOCOYA,estado nutricional en menores de 5 anos,clasificacion d,2002-11-01,71,113,71,113,184
10501,MONTEAGUDO,estado nutricional en menores de 5 anos,clasificacion d,2002-11-01,130,183,130,183,313
71001,MONTERO,estado nutricional en menores de 5 anos,clasificacion d,2002-11-01,252,177,252,177,429
70803,MORO MORO,estado nutricional en menores de 5 anos,clasificacion d,2002-11-01,18,20,18,20,38
30302,MOROCHATA,estado nutricional en menores de 5 anos,clasificacion d,2002-11-01,47,150,47,150,197
90401,NACEBE (SANTA ROSA DEL ABUNA),estado nutricional en menores de 5 anos,clasificacion d,2002-11-01,2,0,2,0,2
20307,NAZACARA DE PACAJES,estado nutricional en menores de 5 anos,clasificacion d,2002-11-01,1,0,1,0,1
90501,NUEVO MANOA (NUEVA ESPERANZA),estado nutricional en menores de 5 anos,clasificacion d,2002-11-01,2,0,2,0,2
50404,OCURI,estado nutricional en menores de 5 anos,clasificacion d,2002-11-01,45,106,45,106,151
70202,OKINAWA,estado nutricional en menores de 5 anos,clasificacion d,2002-11-01,8,26,8,26,34
30203,OMEREQUE,estado nutricional en menores de 5 anos,clasificacion d,2002-11-01,9,12,9,12,21
40101,ORURO,estado nutricional en menores de 5 anos,clasificacion d,2002-11-01,545,484,545,484,1029
60201,PADCAYA,estado nutricional en menores de 5 anos,clasificacion d,2002-11-01,53,54,53,54,107
10401,PADILLA,estado nutricional en menores de 5 anos,clasificacion d,2002-11-01,131,258,131,258,389
70502,PAILON,estado nutricional en menores de 5 anos,clasificacion d,2002-11-01,43,21,43,21,64
20102,PALCA,estado nutricional en menores de 5 anos,clasificacion d,2002-11-01,29,17,29,17,46
21104,PALOS BLANCOS,estado nutricional en menores de 5 anos,clasificacion d,2002-11-01,53,106,53,106,159
40802,PAMPA AULLAGAS,estado nutricional en menores de 5 anos,clasificacion d,2002-11-01,12,25,12,25,37
70902,PAMPA GRANDE,estado nutricional en menores de 5 anos,clasificacion d,2002-11-01,8,11,8,11,19
21802,PAPEL PAMPA,estado nutricional en menores de 5 anos,clasificacion d,2002-11-01,0,3,0,3,3
30202,PASORAPA,estado nutricional en menores de 5 anos,clasificacion d,2002-11-01,13,34,13,34,47
21305,PATACAMAYA,estado nutricional en menores de 5 anos,clasificacion d,2002-11-01,68,21,68,21,89
40602,PAZÃ‘A,estado nutricional en menores de 5 anos,clasificacion d,2002-11-01,9,24,9,24,33
20702,PELECHUCO,estado nutricional en menores de 5 anos,clasificacion d,2002-11-01,23,30,23,30,53
50403,POCOATA,estado nutricional en menores de 5 anos,clasificacion d,2002-11-01,199,168,199,168,367
31203,POCONA,estado nutricional en menores de 5 anos,clasificacion d,2002-11-01,68,32,68,32,100
31202,POJO (CBBA),estado nutricional en menores de 5 anos,clasificacion d,2002-11-01,114,113,114,113,227
40601,POOPO,estado nutricional en menores de 5 anos,clasificacion d,2002-11-01,8,23,8,23,31
10103,POROMA,estado nutricional en menores de 5 anos,clasificacion d,2002-11-01,101,159,101,159,260
70103,PORONGO,estado nutricional en menores de 5 anos,clasificacion d,2002-11-01,13,13,13,13,26
70601,PORTACHUELO,estado nutricional en menores de 5 anos,clasificacion d,2002-11-01,45,28,45,28,73
90102,PORVENIR,estado nutricional en menores de 5 anos,clasificacion d,2002-11-01,14,18,14,18,32
70804,POSTRER VALLE,estado nutricional en menores de 5 anos,clasificacion d,2002-11-01,3,8,3,8,11
50101,POTOSI,estado nutricional en menores de 5 anos,clasificacion d,2002-11-01,461,324,461,324,785
10302,PRESTO,estado nutricional en menores de 5 anos,clasificacion d,2002-11-01,79,84,79,84,163
70805,PUCARA,estado nutricional en menores de 5 anos,clasificacion d,2002-11-01,1,11,1,11,12
21201,PUCARANI,estado nutricional en menores de 5 anos,clasificacion d,2002-11-01,5,43,5,43,48
20401,PUERTO ACOSTA,estado nutricional en menores de 5 anos,clasificacion d,2002-11-01,58,64,58,64,122
20403,PUERTO CARABUCO,estado nutricional en menores de 5 anos,clasificacion d,2002-11-01,35,59,35,59,94
90301,PUERTO GONZALO MORENO,estado nutricional en menores de 5 anos,clasificacion d,2002-11-01,21,22,21,22,43
21204,PUERTO PEREZ,estado nutricional en menores de 5 anos,clasificacion d,2002-11-01,10,5,10,5,15
71402,PUERTO QUIJARRO,estado nutricional en menores de 5 anos,clasificacion d,2002-11-01,34,29,34,29,63
90201,PUERTO RICO,estado nutricional en menores de 5 anos,clasificacion d,2002-11-01,11,19,11,19,30
80703,PUERTO SILES,estado nutricional en menores de 5 anos,clasificacion d,2002-11-01,1,0,1,0,1
71401,PUERTO SUAREZ,estado nutricional en menores de 5 anos,clasificacion d,2002-11-01,44,13,44,13,57
31205,PUERTO VILLARROEL,estado nutricional en menores de 5 anos,clasificacion d,2002-11-01,154,120,154,120,274
51101,PUNA,estado nutricional en menores de 5 anos,clasificacion d,2002-11-01,209,243,209,243,452
31401,PUNATA,estado nutricional en menores de 5 anos,clasificacion d,2002-11-01,114,81,114,81,195
20604,QUIABAYA,estado nutricional en menores de 5 anos,clasificacion d,2002-11-01,8,11,8,11,19
30901,QUILLACOLLO,estado nutricional en menores de 5 anos,clasificacion d,2002-11-01,60,87,60,87,147
21002,QUIME,estado nutricional en menores de 5 anos,clasificacion d,2002-11-01,76,70,76,70,146
70904,QUIRUSILLAS,estado nutricional en menores de 5 anos,clasificacion d,2002-11-01,1,1,1,1,2
50402,RAVELO,estado nutricional en menores de 5 anos,clasificacion d,2002-11-01,155,141,155,141,296
80301,REYES,estado nutricional en menores de 5 anos,clasificacion d,2002-11-01,41,43,41,43,84
80201,RIBERALTA,estado nutricional en menores de 5 anos,clasificacion d,2002-11-01,330,207,330,207,537
70503,ROBORE,estado nutricional en menores de 5 anos,clasificacion d,2002-11-01,100,36,100,36,136
80304,RURRENABAQUE,estado nutricional en menores de 5 anos,clasificacion d,2002-11-01,5,9,5,9,14
40901,SABAYA,estado nutricional en menores de 5 anos,clasificacion d,2002-11-01,0,6,0,6,6
31001,SACABA,estado nutricional en menores de 5 anos,clasificacion d,2002-11-01,170,79,170,79,249
30404,SACABAMBA,estado nutricional en menores de 5 anos,clasificacion d,2002-11-01,6,51,6,51,57
50701,SACACA,estado nutricional en menores de 5 anos,clasificacion d,2002-11-01,160,267,160,267,427
71302,SAIPINA,estado nutricional en menores de 5 anos,clasificacion d,2002-11-01,25,27,25,27,52
40801,SALINAS DE GARCI MENDOZA,estado nutricional en menores de 5 anos,clasificacion d,2002-11-01,16,15,16,15,31
70901,SAMAIPATA,estado nutricional en menores de 5 anos,clasificacion d,2002-11-01,40,14,40,14,54
51601,SAN AGUSTIN,estado nutricional en menores de 5 anos,clasificacion d,2002-11-01,8,6,8,6,14
80602,SAN ANDRES,estado nutricional en menores de 5 anos,clasificacion d,2002-11-01,29,54,29,54,83
51003,SAN ANTONIO DE ESMORUCO,estado nutricional en menores de 5 anos,clasificacion d,2002-11-01,4,17,4,17,21
71105,SAN ANTONIO DE LOMERIO,estado nutricional en menores de 5 anos,clasificacion d,2002-11-01,65,103,65,103,168
31403,SAN BENITO,estado nutricional en menores de 5 anos,clasificacion d,2002-11-01,36,52,36,52,88
80302,SAN BORJA,estado nutricional en menores de 5 anos,clasificacion d,2002-11-01,114,100,114,100,214
21502,SAN BUENA VENTURA,estado nutricional en menores de 5 anos,clasificacion d,2002-11-01,40,88,40,88,128
70402,SAN CARLOS,estado nutricional en menores de 5 anos,clasificacion d,2002-11-01,58,45,58,45,103
80501,SAN IGNACIO,estado nutricional en menores de 5 anos,clasificacion d,2002-11-01,65,112,65,112,177
70301,SAN IGNACIO DE VELASCO,estado nutricional en menores de 5 anos,clasificacion d,2002-11-01,181,269,181,269,450
80102,SAN JAVIER(BNI),estado nutricional en menores de 5 anos,clasificacion d,2002-11-01,17,24,17,24,41
71102,SAN JAVIER(STC),estado nutricional en menores de 5 anos,clasificacion d,2002-11-01,31,23,31,23,54
80701,SAN JOAQUIN,estado nutricional en menores de 5 anos,clasificacion d,2002-11-01,0,11,0,11,11
70501,SAN JOSE DE CHIQUITOS,estado nutricional en menores de 5 anos,clasificacion d,2002-11-01,52,31,52,31,83
71104,SAN JULIAN,estado nutricional en menores de 5 anos,clasificacion d,2002-11-01,172,210,172,210,382
90302,SAN LORENZO(PND),estado nutricional en menores de 5 anos,clasificacion d,2002-11-01,4,7,4,7,11
60501,SAN LORENZO(TJA),estado nutricional en menores de 5 anos,clasificacion d,2002-11-01,30,15,30,15,45
10702,SAN LUCAS,estado nutricional en menores de 5 anos,clasificacion d,2002-11-01,323,383,323,383,706
70302,SAN MIGUEL DE VELASCO,estado nutricional en menores de 5 anos,clasificacion d,2002-11-01,22,36,22,36,58
51001,SAN PABLO DE LIPEZ,estado nutricional en menores de 5 anos,clasificacion d,2002-11-01,10,9,10,9,19
50501,SAN PEDRO DE BUENA VISTA,estado nutricional en menores de 5 anos,clasificacion d,2002-11-01,105,255,105,255,360
21801,SAN PEDRO DE CURAHUARA,estado nutricional en menores de 5 anos,clasificacion d,2002-11-01,22,28,22,28,50
50902,SAN PEDRO DE QUEMES,estado nutricional en menores de 5 anos,clasificacion d,2002-11-01,4,4,4,4,8
21702,SAN PEDRO DE TIQUINA,estado nutricional en menores de 5 anos,clasificacion d,2002-11-01,3,8,3,8,11
90202,SAN PEDRO(PND),estado nutricional en menores de 5 anos,clasificacion d,2002-11-01,12,16,12,16,28
70303,SAN RAFAEL,estado nutricional en menores de 5 anos,clasificacion d,2002-11-01,29,30,29,30,59
80702,SAN RAMON,estado nutricional en menores de 5 anos,clasificacion d,2002-11-01,8,0,8,0,8
80401,SANTA ANA,estado nutricional en menores de 5 anos,clasificacion d,2002-11-01,45,48,45,48,93
70101,SANTA CRUZ DE LA SIERRA,estado nutricional en menores de 5 anos,clasificacion d,2002-11-01,758,436,758,436,1194
80303,SANTA ROSA,estado nutricional en menores de 5 anos,clasificacion d,2002-11-01,11,5,11,5,16
70602,SANTA ROSA DEL SARA,estado nutricional en menores de 5 anos,clasificacion d,2002-11-01,4,7,4,7,11
20308,SANTIAGO DE CALLAPA,estado nutricional en menores de 5 anos,clasificacion d,2002-11-01,39,32,39,32,71
41401,SANTIAGO DE HUARI,estado nutricional en menores de 5 anos,clasificacion d,2002-11-01,10,37,10,37,47
21901,SANTIAGO DE MACHACA,estado nutricional en menores de 5 anos,clasificacion d,2002-11-01,5,2,5,2,7
30702,SANTIVAÃ‘ES,estado nutricional en menores de 5 anos,clasificacion d,2002-11-01,20,16,20,16,36
40202,SANTUARIO DE QUILLACAS,estado nutricional en menores de 5 anos,clasificacion d,2002-11-01,5,9,5,9,14
20902,SAPAHAQUI,estado nutricional en menores de 5 anos,clasificacion d,2002-11-01,30,52,30,52,82
90303,SENA,estado nutricional en menores de 5 anos,clasificacion d,2002-11-01,4,2,4,2,6
21301,SICA SICA (VILLA AROMA),estado nutricional en menores de 5 anos,clasificacion d,2002-11-01,52,63,52,63,115
30703,SICAYA,estado nutricional en menores de 5 anos,clasificacion d,2002-11-01,4,5,4,5,9
30902,SIPE SIPE,estado nutricional en menores de 5 anos,clasificacion d,2002-11-01,201,133,201,133,334
10403,SOPACHUY,estado nutricional en menores de 5 anos,clasificacion d,2002-11-01,42,46,42,46,88
20601,SORATA,estado nutricional en menores de 5 anos,clasificacion d,2002-11-01,59,117,59,117,176
10101,SUCRE,estado nutricional en menores de 5 anos,clasificacion d,2002-11-01,555,604,555,604,1159
31404,TACACHI,estado nutricional en menores de 5 anos,clasificacion d,2002-11-01,6,4,6,4,10
20603,TACACOMA,estado nutricional en menores de 5 anos,clasificacion d,2002-11-01,9,30,9,30,39
50303,TACOBAMBA,estado nutricional en menores de 5 anos,clasificacion d,2002-11-01,68,66,68,66,134
30602,TACOPAYA,estado nutricional en menores de 5 anos,clasificacion d,2002-11-01,79,124,79,124,203
51402,TAHUA,estado nutricional en menores de 5 anos,clasificacion d,2002-11-01,8,7,8,7,15
31101,TAPACARI,estado nutricional en menores de 5 anos,clasificacion d,2002-11-01,62,96,62,96,158
10601,TARABUCO,estado nutricional en menores de 5 anos,clasificacion d,2002-11-01,260,497,260,497,757
30401,TARATA,estado nutricional en menores de 5 anos,clasificacion d,2002-11-01,23,22,23,22,45
60101,TARIJA,estado nutricional en menores de 5 anos,clasificacion d,2002-11-01,227,206,227,206,433
10202,TARVITA,estado nutricional en menores de 5 anos,clasificacion d,2002-11-01,78,119,78,119,197
20803,TIAWANACU,estado nutricional en menores de 5 anos,clasificacion d,2002-11-01,19,22,19,22,41
50102,TINGUIPAYA,estado nutricional en menores de 5 anos,clasificacion d,2002-11-01,16,91,16,91,107
20606,TIPUANI,estado nutricional en menores de 5 anos,clasificacion d,2002-11-01,13,9,13,9,22
30903,TIQUIPAYA,estado nutricional en menores de 5 anos,clasificacion d,2002-11-01,115,82,115,82,197
31601,TIRAQUE (CBBA),estado nutricional en menores de 5 anos,clasificacion d,2002-11-01,113,113,113,113,226
21703,TITO YUPANQUI (PARQUIPUJIO),estado nutricional en menores de 5 anos,clasificacion d,2002-11-01,9,11,9,11,20
30802,TOCO,estado nutricional en menores de 5 anos,clasificacion d,2002-11-01,2,11,2,11,13
41502,TODOS SANTOS,estado nutricional en menores de 5 anos,clasificacion d,2002-11-01,0,1,0,1,1
30803,TOLATA,estado nutricional en menores de 5 anos,clasificacion d,2002-11-01,10,1,10,1,11
41001,TOLEDO,estado nutricional en menores de 5 anos,clasificacion d,2002-11-01,6,16,6,16,22
51202,TOMAVE,estado nutricional en menores de 5 anos,clasificacion d,2002-11-01,71,97,71,97,168
10402,TOMINA,estado nutricional en menores de 5 anos,clasificacion d,2002-11-01,101,200,101,200,301
50502,TORO TORO,estado nutricional en menores de 5 anos,clasificacion d,2002-11-01,31,51,31,51,82
31201,TOTORA(CBBA),estado nutricional en menores de 5 anos,clasificacion d,2002-11-01,43,34,43,34,77
41301,TOTORA(ORR),estado nutricional en menores de 5 anos,clasificacion d,2002-11-01,13,20,13,20,33
70802,TRIGAL,estado nutricional en menores de 5 anos,clasificacion d,2002-11-01,2,1,2,1,3
80101,TRINIDAD,estado nutricional en menores de 5 anos,clasificacion d,2002-11-01,127,181,127,181,308
50801,TUPIZA,estado nutricional en menores de 5 anos,clasificacion d,2002-11-01,52,338,52,338,390
40402,TURCO,estado nutricional en menores de 5 anos,clasificacion d,2002-11-01,8,5,8,5,13
21302,UMALA,estado nutricional en menores de 5 anos,clasificacion d,2002-11-01,18,9,18,9,27
50201,UNCIA,estado nutricional en menores de 5 anos,clasificacion d,2002-11-01,13,28,13,28,41
60401,URIONDO (A. CONCEPCION),estado nutricional en menores de 5 anos,clasificacion d,2002-11-01,13,21,13,21,34
71502,URUBICHA,estado nutricional en menores de 5 anos,clasificacion d,2002-11-01,41,31,41,31,72
51201,UYUNI,estado nutricional en menores de 5 anos,clasificacion d,2002-11-01,95,152,95,152,247
30502,VACAS,estado nutricional en menores de 5 anos,clasificacion d,2002-11-01,20,74,20,74,94
70801,VALLEGRANDE,estado nutricional en menores de 5 anos,clasificacion d,2002-11-01,50,66,50,66,116
20801,VIACHA,estado nutricional en menores de 5 anos,clasificacion d,2002-11-01,107,110,107,110,217
31302,VILA VILA,estado nutricional en menores de 5 anos,clasificacion d,2002-11-01,1,22,1,22,23
60303,VILLA MONTES,estado nutricional en menores de 5 anos,clasificacion d,2002-11-01,58,49,58,49,107
90502,VILLA NUEVA (LOMA ALTA),estado nutricional en menores de 5 anos,clasificacion d,2002-11-01,3,2,3,2,5
31402,VILLA RIVERO,estado nutricional en menores de 5 anos,clasificacion d,2002-11-01,26,2,26,2,28
10801,VILLA SERRANO,estado nutricional en menores de 5 anos,clasificacion d,2002-11-01,112,271,112,271,383
31003,VILLA TUNARI,estado nutricional en menores de 5 anos,clasificacion d,2002-11-01,77,88,77,88,165
11001,VILLA VACA GUZMAN (MUYUPAMPA),estado nutricional en menores de 5 anos,clasificacion d,2002-11-01,57,95,57,95,152
51501,VILLAZON,estado nutricional en menores de 5 anos,clasificacion d,2002-11-01,161,181,161,181,342
30904,VINTO,estado nutricional en menores de 5 anos,clasificacion d,2002-11-01,48,9,48,9,57
50602,VITICHI,estado nutricional en menores de 5 anos,clasificacion d,2002-11-01,72,121,72,121,193
20306,WALDO BALLIVIAN,estado nutricional en menores de 5 anos,clasificacion d,2002-11-01,1,2,1,2,3
70201,WARNES,estado nutricional en menores de 5 anos,clasificacion d,2002-11-01,108,95,108,95,203
20903,YACO,estado nutricional en menores de 5 anos,clasificacion d,2002-11-01,45,26,45,26,71
60301,YACUIBA,estado nutricional en menores de 5 anos,clasificacion d,2002-11-01,96,111,96,111,207
10602,YAMPARAEZ,estado nutricional en menores de 5 anos,clasificacion d,2002-11-01,171,293,171,293,464
21103,YANACACHI,estado nutricional en menores de 5 anos,clasificacion d,2002-11-01,7,16,7,16,23
70403,YAPACANI,estado nutricional en menores de 5 anos,clasificacion d,2002-11-01,57,99,57,99,156
50103,YOCALLA,estado nutricional en menores de 5 anos,clasificacion d,2002-11-01,38,83,38,83,121
10102,YOTALA,estado nutricional en menores de 5 anos,clasificacion d,2002-11-01,104,206,104,206,310
60402,YUNCHARA,estado nutricional en menores de 5 anos,clasificacion d,2002-11-01,26,29,26,29,55
10301,ZUDAÃ‘EZ,estado nutricional en menores de 5 anos,clasificacion d,2002-11-01,61,127,61,127,188
51302,ACACIO,estado nutricional en menores de 5 anos,clasificacion d,2002-12-01,29,112,29,112,141
20201,ACHACACHI,estado nutricional en menores de 5 anos,clasificacion d,2002-12-01,109,135,109,135,244
20104,ACHOCALLA,estado nutricional en menores de 5 anos,clasificacion d,2002-12-01,21,13,21,13,34
30201,AIQUILE,estado nutricional en menores de 5 anos,clasificacion d,2002-12-01,38,52,38,52,90
31303,ALALAY,estado nutricional en menores de 5 anos,clasificacion d,2002-12-01,1,25,1,25,26
10404,ALCALA,estado nutricional en menores de 5 anos,clasificacion d,2002-12-01,34,56,34,56,90
20202,ANCORAIMES,estado nutricional en menores de 5 anos,clasificacion d,2002-12-01,80,114,80,114,194
41201,ANDAMARCA,estado nutricional en menores de 5 anos,clasificacion d,2002-12-01,5,6,5,6,11
40603,ANTEQUERA,estado nutricional en menores de 5 anos,clasificacion d,2002-12-01,7,5,7,5,12
30402,ANZALDO,estado nutricional en menores de 5 anos,clasificacion d,2002-12-01,5,33,5,33,38
20701,APOLO,estado nutricional en menores de 5 anos,clasificacion d,2002-12-01,26,32,26,32,58
51301,ARAMPAMPA,estado nutricional en menores de 5 anos,clasificacion d,2002-12-01,37,109,37,109,146
30501,ARANI,estado nutricional en menores de 5 anos,clasificacion d,2002-12-01,10,10,10,10,20
30403,ARBIETO,estado nutricional en menores de 5 anos,clasificacion d,2002-12-01,4,4,4,4,8
30601,ARQUE,estado nutricional en menores de 5 anos,clasificacion d,2002-12-01,13,15,13,15,28
71501,ASCENCION DE GUARAYOS,estado nutricional en menores de 5 anos,clasificacion d,2002-12-01,8,15,8,15,23
50802,ATOCHA,estado nutricional en menores de 5 anos,clasificacion d,2002-12-01,4,80,4,80,84
20503,AUCAPATA,estado nutricional en menores de 5 anos,clasificacion d,2002-12-01,3,10,3,10,13
20502,AYATA,estado nutricional en menores de 5 anos,clasificacion d,2002-12-01,14,4,14,4,18
21303,AYO AYO,estado nutricional en menores de 5 anos,clasificacion d,2002-12-01,39,3,39,3,42
30301,AYOPAYA (V. DE INDEPENDENCIA),estado nutricional en menores de 5 anos,clasificacion d,2002-12-01,87,82,87,82,169
10201,AZURDUY,estado nutricional en menores de 5 anos,clasificacion d,2002-12-01,107,127,107,127,234
21203,BATALLAS,estado nutricional en menores de 5 anos,clasificacion d,2002-12-01,16,17,16,17,33
80802,BAURES,estado nutricional en menores de 5 anos,clasificacion d,2002-12-01,13,27,13,27,40
41202,BELEN DE ANDAMARCA,estado nutricional en menores de 5 anos,clasificacion d,2002-12-01,1,2,1,2,3
50104,BELEN DE URMIRI,estado nutricional en menores de 5 anos,clasificacion d,2002-12-01,9,15,9,15,24
90104,BELLA FLOR,estado nutricional en menores de 5 anos,clasificacion d,2002-12-01,0,4,0,4,4
60202,BERMEJO,estado nutricional en menores de 5 anos,clasificacion d,2002-12-01,10,14,10,14,24
50301,BETANZOS,estado nutricional en menores de 5 anos,clasificacion d,2002-12-01,167,196,167,196,363
31501,BOLIVAR,estado nutricional en menores de 5 anos,clasificacion d,2002-12-01,52,32,52,32,84
90103,BOLPEBRA,estado nutricional en menores de 5 anos,clasificacion d,2002-12-01,2,1,2,1,3
70707,BOYUIBE,estado nutricional en menores de 5 anos,clasificacion d,2002-12-01,2,9,2,9,11
70703,CABEZAS,estado nutricional en menores de 5 anos,clasificacion d,2002-12-01,29,27,29,27,56
20905,CAIROMA,estado nutricional en menores de 5 anos,clasificacion d,2002-12-01,35,34,35,34,69
51102,"CAIZA ""D""",estado nutricional en menores de 5 anos,clasificacion d,2002-12-01,84,87,84,87,171
21003,CAJUATA,estado nutricional en menores de 5 anos,clasificacion d,2002-12-01,20,17,20,17,37
20303,CALACOTO,estado nutricional en menores de 5 anos,clasificacion d,2002-12-01,17,5,17,5,22
21304,CALAMARCA,estado nutricional en menores de 5 anos,clasificacion d,2002-12-01,73,82,73,82,155
10701,CAMARGO,estado nutricional en menores de 5 anos,clasificacion d,2002-12-01,59,82,59,82,141
10901,CAMATAQUI (C. VILLA ABECIA),estado nutricional en menores de 5 anos,clasificacion d,2002-12-01,28,24,28,24,52
70706,CAMIRI,estado nutricional en menores de 5 anos,clasificacion d,2002-12-01,115,83,115,83,198
30701,CAPINOTA,estado nutricional en menores de 5 anos,clasificacion d,2002-12-01,43,43,43,43,86
20302,CAQUIAVIRI,estado nutricional en menores de 5 anos,clasificacion d,2002-12-01,11,23,11,23,34
40102,CARACOLLO,estado nutricional en menores de 5 anos,clasificacion d,2002-12-01,18,81,18,81,99
22001,CARANAVI,estado nutricional en menores de 5 anos,clasificacion d,2002-12-01,110,106,110,106,216
60302,CARAPARI,estado nutricional en menores de 5 anos,clasificacion d,2002-12-01,28,36,28,36,64
50702,CARIPUYO,estado nutricional en menores de 5 anos,clasificacion d,2002-12-01,53,102,53,102,155
21902,CATACORA,estado nutricional en menores de 5 anos,clasificacion d,2002-12-01,5,8,5,8,13
40201,CHALLAPATA,estado nutricional en menores de 5 anos,clasificacion d,2002-12-01,35,59,35,59,94
50302,CHAQUI,estado nutricional en menores de 5 anos,clasificacion d,2002-12-01,60,73,60,73,133
70702,CHARAGUA,estado nutricional en menores de 5 anos,clasificacion d,2002-12-01,55,148,55,148,203
20305,CHARAÃ‘A,estado nutricional en menores de 5 anos,clasificacion d,2002-12-01,5,6,5,6,11
50202,CHAYANTA,estado nutricional en menores de 5 anos,clasificacion d,2002-12-01,53,89,53,89,142
31204,CHIMORE,estado nutricional en menores de 5 anos,clasificacion d,2002-12-01,14,7,14,7,21
40903,CHIPAYA,estado nutricional en menores de 5 anos,clasificacion d,2002-12-01,0,1,0,1,1
21101,CHULUMANI (V. DE LA LIBERTAD),estado nutricional en menores de 5 anos,clasificacion d,2002-12-01,5,10,5,10,15
20501,CHUMA,estado nutricional en menores de 5 anos,clasificacion d,2002-12-01,31,23,31,23,54
30801,CLIZA,estado nutricional en menores de 5 anos,clasificacion d,2002-12-01,12,5,12,5,17
90101,COBIJA,estado nutricional en menores de 5 anos,clasificacion d,2002-12-01,94,87,94,87,181
30101,COCHABAMBA,estado nutricional en menores de 5 anos,clasificacion d,2002-12-01,388,327,388,327,715
40902,COIPASA,estado nutricional en menores de 5 anos,clasificacion d,2002-12-01,0,1,0,1,1
30905,COLCAPIRHUA,estado nutricional en menores de 5 anos,clasificacion d,2002-12-01,70,35,70,35,105
50901,"COLCHA ""K""",estado nutricional en menores de 5 anos,clasificacion d,2002-12-01,29,36,29,36,65
21307,COLLANA,estado nutricional en menores de 5 anos,clasificacion d,2002-12-01,3,0,3,0,3
31002,COLOMI,estado nutricional en menores de 5 anos,clasificacion d,2002-12-01,56,32,56,32,88
50401,COLQUECHACA,estado nutricional en menores de 5 anos,clasificacion d,2002-12-01,99,63,99,63,162
21306,COLQUENCHA,estado nutricional en menores de 5 anos,clasificacion d,2002-12-01,29,10,29,10,39
21004,COLQUIRI,estado nutricional en menores de 5 anos,clasificacion d,2002-12-01,46,40,46,40,86
20304,COMANCHE,estado nutricional en menores de 5 anos,clasificacion d,2002-12-01,10,12,10,12,22
71301,COMARAPA,estado nutricional en menores de 5 anos,clasificacion d,2002-12-01,63,54,63,54,117
20605,COMBAYA,estado nutricional en menores de 5 anos,clasificacion d,2002-12-01,12,13,12,13,25
71101,CONCEPCION,estado nutricional en menores de 5 anos,clasificacion d,2002-12-01,22,3,22,3,25
21701,COPACABANA,estado nutricional en menores de 5 anos,clasificacion d,2002-12-01,23,21,23,21,44
21402,CORIPATA,estado nutricional en menores de 5 anos,clasificacion d,2002-12-01,2,5,2,5,7
20301,CORO CORO,estado nutricional en menores de 5 anos,clasificacion d,2002-12-01,29,17,29,17,46
21401,COROICO,estado nutricional en menores de 5 anos,clasificacion d,2002-12-01,28,9,28,9,37
40301,CORQUE,estado nutricional en menores de 5 anos,clasificacion d,2002-12-01,18,16,18,16,34
50601,COTAGAITA,estado nutricional en menores de 5 anos,clasificacion d,2002-12-01,88,115,88,115,203
70102,COTOCA,estado nutricional en menores de 5 anos,clasificacion d,2002-12-01,22,21,22,21,43
70704,CUEVO,estado nutricional en menores de 5 anos,clasificacion d,2002-12-01,16,14,16,14,30
10902,CULPINA,estado nutricional en menores de 5 anos,clasificacion d,2002-12-01,141,181,141,181,322
40401,CURAHUARA DE CARANGAS,estado nutricional en menores de 5 anos,clasificacion d,2002-12-01,11,3,11,3,14
21602,CURVA,estado nutricional en menores de 5 anos,clasificacion d,2002-12-01,8,5,8,5,13
20804,DESAGUADERO,estado nutricional en menores de 5 anos,clasificacion d,2002-12-01,6,5,6,5,11
20105,EL ALTO,estado nutricional en menores de 5 anos,clasificacion d,2002-12-01,1543,951,1543,951,2494
40103,EL CHORO,estado nutricional en menores de 5 anos,clasificacion d,2002-12-01,6,5,6,5,11
71503,EL PUENTE(STC),estado nutricional en menores de 5 anos,clasificacion d,2002-12-01,15,101,15,101,116
60502,EL PUENTE(TJA),estado nutricional en menores de 5 anos,clasificacion d,2002-12-01,44,93,44,93,137
70105,EL TORNO,estado nutricional en menores de 5 anos,clasificacion d,2002-12-01,58,62,58,62,120
10405,EL VILLAR,estado nutricional en menores de 5 anos,clasificacion d,2002-12-01,44,115,44,115,159
60601,ENTRE RIOS,estado nutricional en menores de 5 anos,clasificacion d,2002-12-01,20,33,20,33,53
41101,EUCALIPTUS,estado nutricional en menores de 5 anos,clasificacion d,2002-12-01,6,7,6,7,13
90503,EUREKA (SANTOS MERCADO),estado nutricional en menores de 5 anos,clasificacion d,2002-12-01,2,0,2,0,2
80402,EXALTACION,estado nutricional en menores de 5 anos,clasificacion d,2002-12-01,8,19,8,19,27
71002,GENERAL SAAVEDRA,estado nutricional en menores de 5 anos,clasificacion d,2002-12-01,50,85,50,85,135
21601,GRAL. J.J. PEREZ (CHARAZANI),estado nutricional en menores de 5 anos,clasificacion d,2002-12-01,16,13,16,13,29
20602,GUANAY,estado nutricional en menores de 5 anos,clasificacion d,2002-12-01,68,67,68,67,135
20802,GUAQUI,estado nutricional en menores de 5 anos,clasificacion d,2002-12-01,10,4,10,4,14
80202,GUAYARAMERIN,estado nutricional en menores de 5 anos,clasificacion d,2002-12-01,80,94,80,94,174
70705,GUTIERREZ,estado nutricional en menores de 5 anos,clasificacion d,2002-12-01,83,119,83,119,202
10502,HUACARETA,estado nutricional en menores de 5 anos,clasificacion d,2002-12-01,48,79,48,79,127
11002,HUACAYA (VILLA DE HUACAYA),estado nutricional en menores de 5 anos,clasificacion d,2002-12-01,2,5,2,5,7
40501,HUACHACALLA,estado nutricional en menores de 5 anos,clasificacion d,2002-12-01,1,7,1,7,8
40701,HUANUNI,estado nutricional en menores de 5 anos,clasificacion d,2002-12-01,74,43,74,43,117
80803,HUARACAJE,estado nutricional en menores de 5 anos,clasificacion d,2002-12-01,8,4,8,4,12
41601,HUAYLLAMARCA,estado nutricional en menores de 5 anos,clasificacion d,2002-12-01,8,8,8,8,16
21005,ICHOCA,estado nutricional en menores de 5 anos,clasificacion d,2002-12-01,15,14,15,14,29
10304,ICLA,estado nutricional en menores de 5 anos,clasificacion d,2002-12-01,95,179,95,179,274
10703,INCAHUASI,estado nutricional en menores de 5 anos,clasificacion d,2002-12-01,131,122,131,122,253
21001,INQUISIVI,estado nutricional en menores de 5 anos,clasificacion d,2002-12-01,59,70,59,70,129
21102,IRUPANA (VILLA DE LANZA),estado nutricional en menores de 5 anos,clasificacion d,2002-12-01,15,36,15,36,51
21501,IXIAMAS,estado nutricional en menores de 5 anos,clasificacion d,2002-12-01,43,56,43,56,99
21105,LA ASUNTA,estado nutricional en menores de 5 anos,clasificacion d,2002-12-01,16,29,16,29,45
70104,LA GUARDIA,estado nutricional en menores de 5 anos,clasificacion d,2002-12-01,33,40,33,40,73
20101,LA PAZ,estado nutricional en menores de 5 anos,clasificacion d,2002-12-01,930,715,930,715,1645
41501,LA RIVERA,estado nutricional en menores de 5 anos,clasificacion d,2002-12-01,0,1,0,1,1
70701,LAGUNILLAS,estado nutricional en menores de 5 anos,clasificacion d,2002-12-01,45,41,45,41,86
21202,LAJA,estado nutricional en menores de 5 anos,clasificacion d,2002-12-01,16,18,16,18,34
10903,LAS CARRERAS,estado nutricional en menores de 5 anos,clasificacion d,2002-12-01,19,37,19,37,56
21006,LICOMA PAMPA,estado nutricional en menores de 5 anos,clasificacion d,2002-12-01,9,7,9,7,16
50203,LLALLAGUA,estado nutricional en menores de 5 anos,clasificacion d,2002-12-01,22,221,22,221,243
51401,LLICA,estado nutricional en menores de 5 anos,clasificacion d,2002-12-01,8,13,8,13,21
80601,LORETO,estado nutricional en menores de 5 anos,clasificacion d,2002-12-01,11,8,11,8,19
20901,LURIBAY,estado nutricional en menores de 5 anos,clasificacion d,2002-12-01,6,7,6,7,13
40702,MACHACAMARCA,estado nutricional en menores de 5 anos,clasificacion d,2002-12-01,10,8,10,8,18
11003,MACHARETI,estado nutricional en menores de 5 anos,clasificacion d,2002-12-01,40,107,40,107,147
80801,MAGDALENA,estado nutricional en menores de 5 anos,clasificacion d,2002-12-01,22,29,22,29,51
70903,MAIRANA,estado nutricional en menores de 5 anos,clasificacion d,2002-12-01,27,16,27,16,43
20904,MALLA,estado nutricional en menores de 5 anos,clasificacion d,2002-12-01,1,2,1,2,3
20103,MECAPACA,estado nutricional en menores de 5 anos,clasificacion d,2002-12-01,13,12,13,12,25
71003,MINEROS,estado nutricional en menores de 5 anos,clasificacion d,2002-12-01,115,84,115,84,199
31301,MIZQUE,estado nutricional en menores de 5 anos,clasificacion d,2002-12-01,67,35,67,35,102
20402,MOCOMOCO,estado nutricional en menores de 5 anos,clasificacion d,2002-12-01,33,21,33,21,54
51002,MOJINETE,estado nutricional en menores de 5 anos,clasificacion d,2002-12-01,0,4,0,4,4
10303,MOJOCOYA,estado nutricional en menores de 5 anos,clasificacion d,2002-12-01,56,94,56,94,150
10501,MONTEAGUDO,estado nutricional en menores de 5 anos,clasificacion d,2002-12-01,106,220,106,220,326
71001,MONTERO,estado nutricional en menores de 5 anos,clasificacion d,2002-12-01,244,145,244,145,389
70803,MORO MORO,estado nutricional en menores de 5 anos,clasificacion d,2002-12-01,4,7,4,7,11
30302,MOROCHATA,estado nutricional en menores de 5 anos,clasificacion d,2002-12-01,43,75,43,75,118
90401,NACEBE (SANTA ROSA DEL ABUNA),estado nutricional en menores de 5 anos,clasificacion d,2002-12-01,0,5,0,5,5
20307,NAZACARA DE PACAJES,estado nutricional en menores de 5 anos,clasificacion d,2002-12-01,3,1,3,1,4
90501,NUEVO MANOA (NUEVA ESPERANZA),estado nutricional en menores de 5 anos,clasificacion d,2002-12-01,1,2,1,2,3
50404,OCURI,estado nutricional en menores de 5 anos,clasificacion d,2002-12-01,46,102,46,102,148
70202,OKINAWA,estado nutricional en menores de 5 anos,clasificacion d,2002-12-01,8,14,8,14,22
30203,OMEREQUE,estado nutricional en menores de 5 anos,clasificacion d,2002-12-01,0,29,0,29,29
40101,ORURO,estado nutricional en menores de 5 anos,clasificacion d,2002-12-01,498,348,498,348,846
60201,PADCAYA,estado nutricional en menores de 5 anos,clasificacion d,2002-12-01,34,43,34,43,77
10401,PADILLA,estado nutricional en menores de 5 anos,clasificacion d,2002-12-01,120,203,120,203,323
70502,PAILON,estado nutricional en menores de 5 anos,clasificacion d,2002-12-01,24,25,24,25,49
20102,PALCA,estado nutricional en menores de 5 anos,clasificacion d,2002-12-01,18,26,18,26,44
21104,PALOS BLANCOS,estado nutricional en menores de 5 anos,clasificacion d,2002-12-01,37,51,37,51,88
40802,PAMPA AULLAGAS,estado nutricional en menores de 5 anos,clasificacion d,2002-12-01,12,15,12,15,27
70902,PAMPA GRANDE,estado nutricional en menores de 5 anos,clasificacion d,2002-12-01,8,10,8,10,18
21802,PAPEL PAMPA,estado nutricional en menores de 5 anos,clasificacion d,2002-12-01,8,9,8,9,17
30202,PASORAPA,estado nutricional en menores de 5 anos,clasificacion d,2002-12-01,26,34,26,34,60
21305,PATACAMAYA,estado nutricional en menores de 5 anos,clasificacion d,2002-12-01,34,19,34,19,53
40602,PAZÃ‘A,estado nutricional en menores de 5 anos,clasificacion d,2002-12-01,11,27,11,27,38
20702,PELECHUCO,estado nutricional en menores de 5 anos,clasificacion d,2002-12-01,20,12,20,12,32
50403,POCOATA,estado nutricional en menores de 5 anos,clasificacion d,2002-12-01,179,226,179,226,405
31203,POCONA,estado nutricional en menores de 5 anos,clasificacion d,2002-12-01,34,18,34,18,52
31202,POJO (CBBA),estado nutricional en menores de 5 anos,clasificacion d,2002-12-01,73,66,73,66,139
40601,POOPO,estado nutricional en menores de 5 anos,clasificacion d,2002-12-01,2,7,2,7,9
51203,PORCO,estado nutricional en menores de 5 anos,clasificacion d,2002-12-01,7,9,7,9,16
10103,POROMA,estado nutricional en menores de 5 anos,clasificacion d,2002-12-01,82,128,82,128,210
70103,PORONGO,estado nutricional en menores de 5 anos,clasificacion d,2002-12-01,11,11,11,11,22
70601,PORTACHUELO,estado nutricional en menores de 5 anos,clasificacion d,2002-12-01,46,32,46,32,78
90102,PORVENIR,estado nutricional en menores de 5 anos,clasificacion d,2002-12-01,11,12,11,12,23
70804,POSTRER VALLE,estado nutricional en menores de 5 anos,clasificacion d,2002-12-01,2,8,2,8,10
50101,POTOSI,estado nutricional en menores de 5 anos,clasificacion d,2002-12-01,410,280,410,280,690
10302,PRESTO,estado nutricional en menores de 5 anos,clasificacion d,2002-12-01,70,68,70,68,138
21201,PUCARANI,estado nutricional en menores de 5 anos,clasificacion d,2002-12-01,7,13,7,13,20
20401,PUERTO ACOSTA,estado nutricional en menores de 5 anos,clasificacion d,2002-12-01,60,79,60,79,139
20403,PUERTO CARABUCO,estado nutricional en menores de 5 anos,clasificacion d,2002-12-01,40,42,40,42,82
90301,PUERTO GONZALO MORENO,estado nutricional en menores de 5 anos,clasificacion d,2002-12-01,2,3,2,3,5
21204,PUERTO PEREZ,estado nutricional en menores de 5 anos,clasificacion d,2002-12-01,4,15,4,15,19
71402,PUERTO QUIJARRO,estado nutricional en menores de 5 anos,clasificacion d,2002-12-01,33,11,33,11,44
90201,PUERTO RICO,estado nutricional en menores de 5 anos,clasificacion d,2002-12-01,7,6,7,6,13
80703,PUERTO SILES,estado nutricional en menores de 5 anos,clasificacion d,2002-12-01,2,0,2,0,2
71401,PUERTO SUAREZ,estado nutricional en menores de 5 anos,clasificacion d,2002-12-01,45,17,45,17,62
31205,PUERTO VILLARROEL,estado nutricional en menores de 5 anos,clasificacion d,2002-12-01,129,106,129,106,235
51101,PUNA,estado nutricional en menores de 5 anos,clasificacion d,2002-12-01,81,58,81,58,139
31401,PUNATA,estado nutricional en menores de 5 anos,clasificacion d,2002-12-01,133,27,133,27,160
30901,QUILLACOLLO,estado nutricional en menores de 5 anos,clasificacion d,2002-12-01,50,35,50,35,85
21002,QUIME,estado nutricional en menores de 5 anos,clasificacion d,2002-12-01,41,19,41,19,60
70904,QUIRUSILLAS,estado nutricional en menores de 5 anos,clasificacion d,2002-12-01,0,2,0,2,2
50402,RAVELO,estado nutricional en menores de 5 anos,clasificacion d,2002-12-01,206,273,206,273,479
80301,REYES,estado nutricional en menores de 5 anos,clasificacion d,2002-12-01,22,17,22,17,39
80201,RIBERALTA,estado nutricional en menores de 5 anos,clasificacion d,2002-12-01,335,203,335,203,538
70503,ROBORE,estado nutricional en menores de 5 anos,clasificacion d,2002-12-01,49,26,49,26,75
80304,RURRENABAQUE,estado nutricional en menores de 5 anos,clasificacion d,2002-12-01,6,3,6,3,9
40901,SABAYA,estado nutricional en menores de 5 anos,clasificacion d,2002-12-01,0,11,0,11,11
31001,SACABA,estado nutricional en menores de 5 anos,clasificacion d,2002-12-01,85,55,85,55,140
30404,SACABAMBA,estado nutricional en menores de 5 anos,clasificacion d,2002-12-01,4,21,4,21,25
50701,SACACA,estado nutricional en menores de 5 anos,clasificacion d,2002-12-01,114,316,114,316,430
71302,SAIPINA,estado nutricional en menores de 5 anos,clasificacion d,2002-12-01,17,26,17,26,43
40801,SALINAS DE GARCI MENDOZA,estado nutricional en menores de 5 anos,clasificacion d,2002-12-01,13,18,13,18,31
70901,SAMAIPATA,estado nutricional en menores de 5 anos,clasificacion d,2002-12-01,28,19,28,19,47
51601,SAN AGUSTIN,estado nutricional en menores de 5 anos,clasificacion d,2002-12-01,3,10,3,10,13
80602,SAN ANDRES,estado nutricional en menores de 5 anos,clasificacion d,2002-12-01,17,15,17,15,32
51003,SAN ANTONIO DE ESMORUCO,estado nutricional en menores de 5 anos,clasificacion d,2002-12-01,3,5,3,5,8
71105,SAN ANTONIO DE LOMERIO,estado nutricional en menores de 5 anos,clasificacion d,2002-12-01,88,124,88,124,212
31403,SAN BENITO,estado nutricional en menores de 5 anos,clasificacion d,2002-12-01,8,8,8,8,16
80302,SAN BORJA,estado nutricional en menores de 5 anos,clasificacion d,2002-12-01,78,109,78,109,187
21502,SAN BUENA VENTURA,estado nutricional en menores de 5 anos,clasificacion d,2002-12-01,19,32,19,32,51
70402,SAN CARLOS,estado nutricional en menores de 5 anos,clasificacion d,2002-12-01,44,24,44,24,68
80501,SAN IGNACIO,estado nutricional en menores de 5 anos,clasificacion d,2002-12-01,57,52,57,52,109
70301,SAN IGNACIO DE VELASCO,estado nutricional en menores de 5 anos,clasificacion d,2002-12-01,167,279,167,279,446
80102,SAN JAVIER(BNI),estado nutricional en menores de 5 anos,clasificacion d,2002-12-01,2,0,2,0,2
71102,SAN JAVIER(STC),estado nutricional en menores de 5 anos,clasificacion d,2002-12-01,47,83,47,83,130
80701,SAN JOAQUIN,estado nutricional en menores de 5 anos,clasificacion d,2002-12-01,4,6,4,6,10
70501,SAN JOSE DE CHIQUITOS,estado nutricional en menores de 5 anos,clasificacion d,2002-12-01,25,13,25,13,38
71104,SAN JULIAN,estado nutricional en menores de 5 anos,clasificacion d,2002-12-01,92,138,92,138,230
90302,SAN LORENZO(PND),estado nutricional en menores de 5 anos,clasificacion d,2002-12-01,5,6,5,6,11
60501,SAN LORENZO(TJA),estado nutricional en menores de 5 anos,clasificacion d,2002-12-01,72,102,72,102,174
10702,SAN LUCAS,estado nutricional en menores de 5 anos,clasificacion d,2002-12-01,283,376,283,376,659
70302,SAN MIGUEL DE VELASCO,estado nutricional en menores de 5 anos,clasificacion d,2002-12-01,72,97,72,97,169
51001,SAN PABLO DE LIPEZ,estado nutricional en menores de 5 anos,clasificacion d,2002-12-01,5,21,5,21,26
50501,SAN PEDRO DE BUENA VISTA,estado nutricional en menores de 5 anos,clasificacion d,2002-12-01,75,173,75,173,248
21801,SAN PEDRO DE CURAHUARA,estado nutricional en menores de 5 anos,clasificacion d,2002-12-01,21,29,21,29,50
50902,SAN PEDRO DE QUEMES,estado nutricional en menores de 5 anos,clasificacion d,2002-12-01,4,0,4,0,4
21702,SAN PEDRO DE TIQUINA,estado nutricional en menores de 5 anos,clasificacion d,2002-12-01,7,8,7,8,15
70303,SAN RAFAEL,estado nutricional en menores de 5 anos,clasificacion d,2002-12-01,15,22,15,22,37
80702,SAN RAMON,estado nutricional en menores de 5 anos,clasificacion d,2002-12-01,2,1,2,1,3
80702,SAN RAMON,estado nutricional en menores de 5 anos,clasificacion d,2002-12-01,12,26,12,26,38
80401,SANTA ANA,estado nutricional en menores de 5 anos,clasificacion d,2002-12-01,29,51,29,51,80
70101,SANTA CRUZ DE LA SIERRA,estado nutricional en menores de 5 anos,clasificacion d,2002-12-01,600,272,600,272,872
80303,SANTA ROSA,estado nutricional en menores de 5 anos,clasificacion d,2002-12-01,13,11,13,11,24
70602,SANTA ROSA DEL SARA,estado nutricional en menores de 5 anos,clasificacion d,2002-12-01,12,37,12,37,49
20308,SANTIAGO DE CALLAPA,estado nutricional en menores de 5 anos,clasificacion d,2002-12-01,36,87,36,87,123
41401,SANTIAGO DE HUARI,estado nutricional en menores de 5 anos,clasificacion d,2002-12-01,9,15,9,15,24
21901,SANTIAGO DE MACHACA,estado nutricional en menores de 5 anos,clasificacion d,2002-12-01,5,7,5,7,12
30702,SANTIVAÃ‘ES,estado nutricional en menores de 5 anos,clasificacion d,2002-12-01,8,8,8,8,16
40202,SANTUARIO DE QUILLACAS,estado nutricional en menores de 5 anos,clasificacion d,2002-12-01,5,11,5,11,16
20902,SAPAHAQUI,estado nutricional en menores de 5 anos,clasificacion d,2002-12-01,19,27,19,27,46
90303,SENA,estado nutricional en menores de 5 anos,clasificacion d,2002-12-01,4,2,4,2,6
21301,SICA SICA (VILLA AROMA),estado nutricional en menores de 5 anos,clasificacion d,2002-12-01,49,44,49,44,93
30703,SICAYA,estado nutricional en menores de 5 anos,clasificacion d,2002-12-01,10,19,10,19,29
30902,SIPE SIPE,estado nutricional en menores de 5 anos,clasificacion d,2002-12-01,140,73,140,73,213
10403,SOPACHUY,estado nutricional en menores de 5 anos,clasificacion d,2002-12-01,70,67,70,67,137
20601,SORATA,estado nutricional en menores de 5 anos,clasificacion d,2002-12-01,37,89,37,89,126
10101,SUCRE,estado nutricional en menores de 5 anos,clasificacion d,2002-12-01,413,439,413,439,852
31404,TACACHI,estado nutricional en menores de 5 anos,clasificacion d,2002-12-01,2,6,2,6,8
20603,TACACOMA,estado nutricional en menores de 5 anos,clasificacion d,2002-12-01,13,35,13,35,48
50303,TACOBAMBA,estado nutricional en menores de 5 anos,clasificacion d,2002-12-01,39,62,39,62,101
30602,TACOPAYA,estado nutricional en menores de 5 anos,clasificacion d,2002-12-01,22,26,22,26,48
51402,TAHUA,estado nutricional en menores de 5 anos,clasificacion d,2002-12-01,3,6,3,6,9
31101,TAPACARI,estado nutricional en menores de 5 anos,clasificacion d,2002-12-01,52,79,52,79,131
10601,TARABUCO,estado nutricional en menores de 5 anos,clasificacion d,2002-12-01,288,453,288,453,741
30401,TARATA,estado nutricional en menores de 5 anos,clasificacion d,2002-12-01,6,6,6,6,12
60101,TARIJA,estado nutricional en menores de 5 anos,clasificacion d,2002-12-01,198,184,198,184,382
10202,TARVITA,estado nutricional en menores de 5 anos,clasificacion d,2002-12-01,94,218,94,218,312
20803,TIAWANACU,estado nutricional en menores de 5 anos,clasificacion d,2002-12-01,10,17,10,17,27
50102,TINGUIPAYA,estado nutricional en menores de 5 anos,clasificacion d,2002-12-01,35,78,35,78,113
20606,TIPUANI,estado nutricional en menores de 5 anos,clasificacion d,2002-12-01,11,9,11,9,20
30903,TIQUIPAYA,estado nutricional en menores de 5 anos,clasificacion d,2002-12-01,18,55,18,55,73
31601,TIRAQUE (CBBA),estado nutricional en menores de 5 anos,clasificacion d,2002-12-01,82,154,82,154,236
21703,TITO YUPANQUI (PARQUIPUJIO),estado nutricional en menores de 5 anos,clasificacion d,2002-12-01,4,5,4,5,9
30802,TOCO,estado nutricional en menores de 5 anos,clasificacion d,2002-12-01,3,5,3,5,8
41502,TODOS SANTOS,estado nutricional en menores de 5 anos,clasificacion d,2002-12-01,0,1,0,1,1
30803,TOLATA,estado nutricional en menores de 5 anos,clasificacion d,2002-12-01,2,1,2,1,3
41001,TOLEDO,estado nutricional en menores de 5 anos,clasificacion d,2002-12-01,11,5,11,5,16
51202,TOMAVE,estado nutricional en menores de 5 anos,clasificacion d,2002-12-01,40,62,40,62,102
10402,TOMINA,estado nutricional en menores de 5 anos,clasificacion d,2002-12-01,101,174,101,174,275
50502,TORO TORO,estado nutricional en menores de 5 anos,clasificacion d,2002-12-01,42,74,42,74,116
31201,TOTORA(CBBA),estado nutricional en menores de 5 anos,clasificacion d,2002-12-01,38,33,38,33,71
41301,TOTORA(ORR),estado nutricional en menores de 5 anos,clasificacion d,2002-12-01,16,13,16,13,29
70802,TRIGAL,estado nutricional en menores de 5 anos,clasificacion d,2002-12-01,4,4,4,4,8
80101,TRINIDAD,estado nutricional en menores de 5 anos,clasificacion d,2002-12-01,95,179,95,179,274
50801,TUPIZA,estado nutricional en menores de 5 anos,clasificacion d,2002-12-01,49,348,49,348,397
40402,TURCO,estado nutricional en menores de 5 anos,clasificacion d,2002-12-01,7,13,7,13,20
21302,UMALA,estado nutricional en menores de 5 anos,clasificacion d,2002-12-01,9,16,9,16,25
50201,UNCIA,estado nutricional en menores de 5 anos,clasificacion d,2002-12-01,12,3,12,3,15
60401,URIONDO (A. CONCEPCION),estado nutricional en menores de 5 anos,clasificacion d,2002-12-01,24,23,24,23,47
71502,URUBICHA,estado nutricional en menores de 5 anos,clasificacion d,2002-12-01,30,48,30,48,78
51201,UYUNI,estado nutricional en menores de 5 anos,clasificacion d,2002-12-01,53,81,53,81,134
30502,VACAS,estado nutricional en menores de 5 anos,clasificacion d,2002-12-01,26,52,26,52,78
70801,VALLEGRANDE,estado nutricional en menores de 5 anos,clasificacion d,2002-12-01,42,52,42,52,94
20801,VIACHA,estado nutricional en menores de 5 anos,clasificacion d,2002-12-01,64,81,64,81,145
31302,VILA VILA,estado nutricional en menores de 5 anos,clasificacion d,2002-12-01,3,31,3,31,34
60303,VILLA MONTES,estado nutricional en menores de 5 anos,clasificacion d,2002-12-01,44,41,44,41,85
31402,VILLA RIVERO,estado nutricional en menores de 5 anos,clasificacion d,2002-12-01,5,16,5,16,21
10801,VILLA SERRANO,estado nutricional en menores de 5 anos,clasificacion d,2002-12-01,106,200,106,200,306
31003,VILLA TUNARI,estado nutricional en menores de 5 anos,clasificacion d,2002-12-01,66,75,66,75,141
11001,VILLA VACA GUZMAN (MUYUPAMPA),estado nutricional en menores de 5 anos,clasificacion d,2002-12-01,76,91,76,91,167
51501,VILLAZON,estado nutricional en menores de 5 anos,clasificacion d,2002-12-01,147,169,147,169,316
30904,VINTO,estado nutricional en menores de 5 anos,clasificacion d,2002-12-01,47,22,47,22,69
50602,VITICHI,estado nutricional en menores de 5 anos,clasificacion d,2002-12-01,63,99,63,99,162
20306,WALDO BALLIVIAN,estado nutricional en menores de 5 anos,clasificacion d,2002-12-01,5,1,5,1,6
70201,WARNES,estado nutricional en menores de 5 anos,clasificacion d,2002-12-01,90,59,90,59,149
20903,YACO,estado nutricional en menores de 5 anos,clasificacion d,2002-12-01,12,19,12,19,31
60301,YACUIBA,estado nutricional en menores de 5 anos,clasificacion d,2002-12-01,75,62,75,62,137
10602,YAMPARAEZ,estado nutricional en menores de 5 anos,clasificacion d,2002-12-01,159,284,159,284,443
21103,YANACACHI,estado nutricional en menores de 5 anos,clasificacion d,2002-12-01,10,7,10,7,17
50103,YOCALLA,estado nutricional en menores de 5 anos,clasificacion d,2002-12-01,13,37,13,37,50
10102,YOTALA,estado nutricional en menores de 5 anos,clasificacion d,2002-12-01,83,157,83,157,240
60402,YUNCHARA,estado nutricional en menores de 5 anos,clasificacion d,2002-12-01,13,31,13,31,44
10301,ZUDAÃ‘EZ,estado nutricional en menores de 5 anos,clasificacion d,2002-12-01,53,119,53,119,172
