codigo_municipio,municipio,grupo,variable,mes,total-H,total-M,TOTAL-H1,TOTAL-M1,TOTAL
51302,ACACIO,estado nutricional en menores de 5 anos,clasificacion a y b,2002-01-01,1,7,1,7,8
20201,ACHACACHI,estado nutricional en menores de 5 anos,clasificacion a y b,2002-01-01,11,39,11,39,50
20104,ACHOCALLA,estado nutricional en menores de 5 anos,clasificacion a y b,2002-01-01,17,2,17,2,19
30201,AIQUILE,estado nutricional en menores de 5 anos,clasificacion a y b,2002-01-01,3,6,3,6,9
10404,ALCALA,estado nutricional en menores de 5 anos,clasificacion a y b,2002-01-01,3,12,3,12,15
20202,ANCORAIMES,estado nutricional en menores de 5 anos,clasificacion a y b,2002-01-01,4,14,4,14,18
41201,ANDAMARCA,estado nutricional en menores de 5 anos,clasificacion a y b,2002-01-01,4,0,4,0,4
40603,ANTEQUERA,estado nutricional en menores de 5 anos,clasificacion a y b,2002-01-01,1,0,1,0,1
30402,ANZALDO,estado nutricional en menores de 5 anos,clasificacion a y b,2002-01-01,0,3,0,3,3
20701,APOLO,estado nutricional en menores de 5 anos,clasificacion a y b,2002-01-01,14,0,14,0,14
51301,ARAMPAMPA,estado nutricional en menores de 5 anos,clasificacion a y b,2002-01-01,4,4,4,4,8
30501,ARANI,estado nutricional en menores de 5 anos,clasificacion a y b,2002-01-01,2,16,2,16,18
30403,ARBIETO,estado nutricional en menores de 5 anos,clasificacion a y b,2002-01-01,3,14,3,14,17
50802,ATOCHA,estado nutricional en menores de 5 anos,clasificacion a y b,2002-01-01,2,5,2,5,7
20502,AYATA,estado nutricional en menores de 5 anos,clasificacion a y b,2002-01-01,2,0,2,0,2
21303,AYO AYO,estado nutricional en menores de 5 anos,clasificacion a y b,2002-01-01,15,4,15,4,19
30301,AYOPAYA (V. DE INDEPENDENCIA),estado nutricional en menores de 5 anos,clasificacion a y b,2002-01-01,19,2,19,2,21
10201,AZURDUY,estado nutricional en menores de 5 anos,clasificacion a y b,2002-01-01,5,21,5,21,26
21203,BATALLAS,estado nutricional en menores de 5 anos,clasificacion a y b,2002-01-01,1,14,1,14,15
80802,BAURES,estado nutricional en menores de 5 anos,clasificacion a y b,2002-01-01,9,14,9,14,23
50104,BELEN DE URMIRI,estado nutricional en menores de 5 anos,clasificacion a y b,2002-01-01,1,1,1,1,2
90104,BELLA FLOR,estado nutricional en menores de 5 anos,clasificacion a y b,2002-01-01,10,0,10,0,10
60202,BERMEJO,estado nutricional en menores de 5 anos,clasificacion a y b,2002-01-01,6,36,6,36,42
50301,BETANZOS,estado nutricional en menores de 5 anos,clasificacion a y b,2002-01-01,25,64,25,64,89
31501,BOLIVAR,estado nutricional en menores de 5 anos,clasificacion a y b,2002-01-01,7,1,7,1,8
90103,BOLPEBRA,estado nutricional en menores de 5 anos,clasificacion a y b,2002-01-01,2,1,2,1,3
70707,BOYUIBE,estado nutricional en menores de 5 anos,clasificacion a y b,2002-01-01,3,7,3,7,10
70401,BUENA VISTA,estado nutricional en menores de 5 anos,clasificacion a y b,2002-01-01,121,24,121,24,145
70703,CABEZAS,estado nutricional en menores de 5 anos,clasificacion a y b,2002-01-01,21,31,21,31,52
20905,CAIROMA,estado nutricional en menores de 5 anos,clasificacion a y b,2002-01-01,4,6,4,6,10
51102,"CAIZA ""D""",estado nutricional en menores de 5 anos,clasificacion a y b,2002-01-01,10,13,10,13,23
21003,CAJUATA,estado nutricional en menores de 5 anos,clasificacion a y b,2002-01-01,10,2,10,2,12
21304,CALAMARCA,estado nutricional en menores de 5 anos,clasificacion a y b,2002-01-01,8,6,8,6,14
10701,CAMARGO,estado nutricional en menores de 5 anos,clasificacion a y b,2002-01-01,19,31,19,31,50
10901,CAMATAQUI (C. VILLA ABECIA),estado nutricional en menores de 5 anos,clasificacion a y b,2002-01-01,4,6,4,6,10
70706,CAMIRI,estado nutricional en menores de 5 anos,clasificacion a y b,2002-01-01,74,31,74,31,105
30701,CAPINOTA,estado nutricional en menores de 5 anos,clasificacion a y b,2002-01-01,45,1,45,1,46
20302,CAQUIAVIRI,estado nutricional en menores de 5 anos,clasificacion a y b,2002-01-01,17,7,17,7,24
40102,CARACOLLO,estado nutricional en menores de 5 anos,clasificacion a y b,2002-01-01,22,9,22,9,31
22001,CARANAVI,estado nutricional en menores de 5 anos,clasificacion a y b,2002-01-01,75,42,75,42,117
41503,CARANGAS,estado nutricional en menores de 5 anos,clasificacion a y b,2002-01-01,0,1,0,1,1
60302,CARAPARI,estado nutricional en menores de 5 anos,clasificacion a y b,2002-01-01,18,23,18,23,41
50702,CARIPUYO,estado nutricional en menores de 5 anos,clasificacion a y b,2002-01-01,4,4,4,4,8
40201,CHALLAPATA,estado nutricional en menores de 5 anos,clasificacion a y b,2002-01-01,11,14,11,14,25
50302,CHAQUI,estado nutricional en menores de 5 anos,clasificacion a y b,2002-01-01,3,34,3,34,37
70702,CHARAGUA,estado nutricional en menores de 5 anos,clasificacion a y b,2002-01-01,27,77,27,77,104
31204,CHIMORE,estado nutricional en menores de 5 anos,clasificacion a y b,2002-01-01,8,15,8,15,23
21101,CHULUMANI (V. DE LA LIBERTAD),estado nutricional en menores de 5 anos,clasificacion a y b,2002-01-01,11,8,11,8,19
20501,CHUMA,estado nutricional en menores de 5 anos,clasificacion a y b,2002-01-01,2,5,2,5,7
30801,CLIZA,estado nutricional en menores de 5 anos,clasificacion a y b,2002-01-01,2,25,2,25,27
90101,COBIJA,estado nutricional en menores de 5 anos,clasificacion a y b,2002-01-01,85,4,85,4,89
30101,COCHABAMBA,estado nutricional en menores de 5 anos,clasificacion a y b,2002-01-01,309,195,309,195,504
30905,COLCAPIRHUA,estado nutricional en menores de 5 anos,clasificacion a y b,2002-01-01,39,29,39,29,68
50901,"COLCHA ""K""",estado nutricional en menores de 5 anos,clasificacion a y b,2002-01-01,3,14,3,14,17
21307,COLLANA,estado nutricional en menores de 5 anos,clasificacion a y b,2002-01-01,1,0,1,0,1
31002,COLOMI,estado nutricional en menores de 5 anos,clasificacion a y b,2002-01-01,8,3,8,3,11
50401,COLQUECHACA,estado nutricional en menores de 5 anos,clasificacion a y b,2002-01-01,2,1,2,1,3
21306,COLQUENCHA,estado nutricional en menores de 5 anos,clasificacion a y b,2002-01-01,13,3,13,3,16
21004,COLQUIRI,estado nutricional en menores de 5 anos,clasificacion a y b,2002-01-01,8,5,8,5,13
20304,COMANCHE,estado nutricional en menores de 5 anos,clasificacion a y b,2002-01-01,1,2,1,2,3
71301,COMARAPA,estado nutricional en menores de 5 anos,clasificacion a y b,2002-01-01,18,12,18,12,30
20605,COMBAYA,estado nutricional en menores de 5 anos,clasificacion a y b,2002-01-01,0,12,0,12,12
71101,CONCEPCION,estado nutricional en menores de 5 anos,clasificacion a y b,2002-01-01,11,30,11,30,41
21701,COPACABANA,estado nutricional en menores de 5 anos,clasificacion a y b,2002-01-01,8,13,8,13,21
21402,CORIPATA,estado nutricional en menores de 5 anos,clasificacion a y b,2002-01-01,9,14,9,14,23
20301,CORO CORO,estado nutricional en menores de 5 anos,clasificacion a y b,2002-01-01,8,6,8,6,14
21401,COROICO,estado nutricional en menores de 5 anos,clasificacion a y b,2002-01-01,12,4,12,4,16
40301,CORQUE,estado nutricional en menores de 5 anos,clasificacion a y b,2002-01-01,5,3,5,3,8
50601,COTAGAITA,estado nutricional en menores de 5 anos,clasificacion a y b,2002-01-01,21,26,21,26,47
70102,COTOCA,estado nutricional en menores de 5 anos,clasificacion a y b,2002-01-01,125,63,125,63,188
31405,CUCHUMUELA (V. G. VILLARROEL),estado nutricional en menores de 5 anos,clasificacion a y b,2002-01-01,1,3,1,3,4
70704,CUEVO,estado nutricional en menores de 5 anos,clasificacion a y b,2002-01-01,26,4,26,4,30
10902,CULPINA,estado nutricional en menores de 5 anos,clasificacion a y b,2002-01-01,17,48,17,48,65
40401,CURAHUARA DE CARANGAS,estado nutricional en menores de 5 anos,clasificacion a y b,2002-01-01,6,1,6,1,7
20804,DESAGUADERO,estado nutricional en menores de 5 anos,clasificacion a y b,2002-01-01,0,5,0,5,5
20105,EL ALTO,estado nutricional en menores de 5 anos,clasificacion a y b,2002-01-01,565,448,565,448,1013
40103,EL CHORO,estado nutricional en menores de 5 anos,clasificacion a y b,2002-01-01,4,0,4,0,4
71503,EL PUENTE(STC),estado nutricional en menores de 5 anos,clasificacion a y b,2002-01-01,20,27,20,27,47
60502,EL PUENTE(TJA),estado nutricional en menores de 5 anos,clasificacion a y b,2002-01-01,0,6,0,6,6
70105,EL TORNO,estado nutricional en menores de 5 anos,clasificacion a y b,2002-01-01,99,94,99,94,193
10405,EL VILLAR,estado nutricional en menores de 5 anos,clasificacion a y b,2002-01-01,1,17,1,17,18
60601,ENTRE RIOS,estado nutricional en menores de 5 anos,clasificacion a y b,2002-01-01,38,19,38,19,57
41101,EUCALIPTUS,estado nutricional en menores de 5 anos,clasificacion a y b,2002-01-01,2,4,2,4,6
80402,EXALTACION,estado nutricional en menores de 5 anos,clasificacion a y b,2002-01-01,1,4,1,4,5
90203,FILADELFIA,estado nutricional en menores de 5 anos,clasificacion a y b,2002-01-01,2,3,2,3,5
71002,GENERAL SAAVEDRA,estado nutricional en menores de 5 anos,clasificacion a y b,2002-01-01,23,67,23,67,90
21601,GRAL. J.J. PEREZ (CHARAZANI),estado nutricional en menores de 5 anos,clasificacion a y b,2002-01-01,3,4,3,4,7
20602,GUANAY,estado nutricional en menores de 5 anos,clasificacion a y b,2002-01-01,18,82,18,82,100
20802,GUAQUI,estado nutricional en menores de 5 anos,clasificacion a y b,2002-01-01,2,3,2,3,5
80202,GUAYARAMERIN,estado nutricional en menores de 5 anos,clasificacion a y b,2002-01-01,84,27,84,27,111
70705,GUTIERREZ,estado nutricional en menores de 5 anos,clasificacion a y b,2002-01-01,33,87,33,87,120
10502,HUACARETA,estado nutricional en menores de 5 anos,clasificacion a y b,2002-01-01,7,56,7,56,63
11002,HUACAYA (VILLA DE HUACAYA),estado nutricional en menores de 5 anos,clasificacion a y b,2002-01-01,4,4,4,4,8
40501,HUACHACALLA,estado nutricional en menores de 5 anos,clasificacion a y b,2002-01-01,0,2,0,2,2
80803,HUARACAJE,estado nutricional en menores de 5 anos,clasificacion a y b,2002-01-01,2,1,2,1,3
21005,ICHOCA,estado nutricional en menores de 5 anos,clasificacion a y b,2002-01-01,1,1,1,1,2
10304,ICLA,estado nutricional en menores de 5 anos,clasificacion a y b,2002-01-01,11,5,11,5,16
10703,INCAHUASI,estado nutricional en menores de 5 anos,clasificacion a y b,2002-01-01,2,21,2,21,23
21001,INQUISIVI,estado nutricional en menores de 5 anos,clasificacion a y b,2002-01-01,12,7,12,7,19
21102,IRUPANA (VILLA DE LANZA),estado nutricional en menores de 5 anos,clasificacion a y b,2002-01-01,32,26,32,26,58
21501,IXIAMAS,estado nutricional en menores de 5 anos,clasificacion a y b,2002-01-01,33,16,33,16,49
21105,LA ASUNTA,estado nutricional en menores de 5 anos,clasificacion a y b,2002-01-01,23,16,23,16,39
70104,LA GUARDIA,estado nutricional en menores de 5 anos,clasificacion a y b,2002-01-01,114,76,114,76,190
20101,LA PAZ,estado nutricional en menores de 5 anos,clasificacion a y b,2002-01-01,460,345,460,345,805
70701,LAGUNILLAS,estado nutricional en menores de 5 anos,clasificacion a y b,2002-01-01,11,14,11,14,25
21202,LAJA,estado nutricional en menores de 5 anos,clasificacion a y b,2002-01-01,4,27,4,27,31
10903,LAS CARRERAS,estado nutricional en menores de 5 anos,clasificacion a y b,2002-01-01,1,4,1,4,5
51401,LLICA,estado nutricional en menores de 5 anos,clasificacion a y b,2002-01-01,1,4,1,4,5
80601,LORETO,estado nutricional en menores de 5 anos,clasificacion a y b,2002-01-01,2,8,2,8,10
20901,LURIBAY,estado nutricional en menores de 5 anos,clasificacion a y b,2002-01-01,3,9,3,9,12
40702,MACHACAMARCA,estado nutricional en menores de 5 anos,clasificacion a y b,2002-01-01,10,4,10,4,14
11003,MACHARETI,estado nutricional en menores de 5 anos,clasificacion a y b,2002-01-01,11,33,11,33,44
80801,MAGDALENA,estado nutricional en menores de 5 anos,clasificacion a y b,2002-01-01,16,23,16,23,39
70903,MAIRANA,estado nutricional en menores de 5 anos,clasificacion a y b,2002-01-01,55,11,55,11,66
20103,MECAPACA,estado nutricional en menores de 5 anos,clasificacion a y b,2002-01-01,2,13,2,13,15
71003,MINEROS,estado nutricional en menores de 5 anos,clasificacion a y b,2002-01-01,40,124,40,124,164
31301,MIZQUE,estado nutricional en menores de 5 anos,clasificacion a y b,2002-01-01,3,3,3,3,6
20402,MOCOMOCO,estado nutricional en menores de 5 anos,clasificacion a y b,2002-01-01,6,5,6,5,11
10303,MOJOCOYA,estado nutricional en menores de 5 anos,clasificacion a y b,2002-01-01,42,10,42,10,52
10501,MONTEAGUDO,estado nutricional en menores de 5 anos,clasificacion a y b,2002-01-01,43,60,43,60,103
71001,MONTERO,estado nutricional en menores de 5 anos,clasificacion a y b,2002-01-01,57,422,57,422,479
70803,MORO MORO,estado nutricional en menores de 5 anos,clasificacion a y b,2002-01-01,9,5,9,5,14
30302,MOROCHATA,estado nutricional en menores de 5 anos,clasificacion a y b,2002-01-01,3,1,3,1,4
90401,NACEBE (SANTA ROSA DEL ABUNA),estado nutricional en menores de 5 anos,clasificacion a y b,2002-01-01,0,4,0,4,4
50404,OCURI,estado nutricional en menores de 5 anos,clasificacion a y b,2002-01-01,4,6,4,6,10
70202,OKINAWA,estado nutricional en menores de 5 anos,clasificacion a y b,2002-01-01,5,2,5,2,7
30203,OMEREQUE,estado nutricional en menores de 5 anos,clasificacion a y b,2002-01-01,1,1,1,1,2
40101,ORURO,estado nutricional en menores de 5 anos,clasificacion a y b,2002-01-01,90,281,90,281,371
60201,PADCAYA,estado nutricional en menores de 5 anos,clasificacion a y b,2002-01-01,25,29,25,29,54
10401,PADILLA,estado nutricional en menores de 5 anos,clasificacion a y b,2002-01-01,11,34,11,34,45
70502,PAILON,estado nutricional en menores de 5 anos,clasificacion a y b,2002-01-01,19,66,19,66,85
20102,PALCA,estado nutricional en menores de 5 anos,clasificacion a y b,2002-01-01,23,3,23,3,26
21104,PALOS BLANCOS,estado nutricional en menores de 5 anos,clasificacion a y b,2002-01-01,27,18,27,18,45
40802,PAMPA AULLAGAS,estado nutricional en menores de 5 anos,clasificacion a y b,2002-01-01,9,2,9,2,11
70902,PAMPA GRANDE,estado nutricional en menores de 5 anos,clasificacion a y b,2002-01-01,19,8,19,8,27
21802,PAPEL PAMPA,estado nutricional en menores de 5 anos,clasificacion a y b,2002-01-01,3,2,3,2,5
30202,PASORAPA,estado nutricional en menores de 5 anos,clasificacion a y b,2002-01-01,12,5,12,5,17
21305,PATACAMAYA,estado nutricional en menores de 5 anos,clasificacion a y b,2002-01-01,25,9,25,9,34
40602,PAZÑA,estado nutricional en menores de 5 anos,clasificacion a y b,2002-01-01,0,3,0,3,3
20702,PELECHUCO,estado nutricional en menores de 5 anos,clasificacion a y b,2002-01-01,3,0,3,0,3
50403,POCOATA,estado nutricional en menores de 5 anos,clasificacion a y b,2002-01-01,17,11,17,11,28
31203,POCONA,estado nutricional en menores de 5 anos,clasificacion a y b,2002-01-01,3,4,3,4,7
31202,POJO (CBBA),estado nutricional en menores de 5 anos,clasificacion a y b,2002-01-01,67,39,67,39,106
40601,POOPO,estado nutricional en menores de 5 anos,clasificacion a y b,2002-01-01,1,0,1,0,1
51203,PORCO,estado nutricional en menores de 5 anos,clasificacion a y b,2002-01-01,2,8,2,8,10
10103,POROMA,estado nutricional en menores de 5 anos,clasificacion a y b,2002-01-01,6,12,6,12,18
70103,PORONGO,estado nutricional en menores de 5 anos,clasificacion a y b,2002-01-01,6,41,6,41,47
70601,PORTACHUELO,estado nutricional en menores de 5 anos,clasificacion a y b,2002-01-01,105,71,105,71,176
90102,PORVENIR,estado nutricional en menores de 5 anos,clasificacion a y b,2002-01-01,21,6,21,6,27
70804,POSTRER VALLE,estado nutricional en menores de 5 anos,clasificacion a y b,2002-01-01,2,12,2,12,14
50101,POTOSI,estado nutricional en menores de 5 anos,clasificacion a y b,2002-01-01,36,58,36,58,94
10302,PRESTO,estado nutricional en menores de 5 anos,clasificacion a y b,2002-01-01,33,2,33,2,35
21201,PUCARANI,estado nutricional en menores de 5 anos,clasificacion a y b,2002-01-01,7,14,7,14,21
20401,PUERTO ACOSTA,estado nutricional en menores de 5 anos,clasificacion a y b,2002-01-01,19,2,19,2,21
20403,PUERTO CARABUCO,estado nutricional en menores de 5 anos,clasificacion a y b,2002-01-01,23,2,23,2,25
90301,PUERTO GONZALO MORENO,estado nutricional en menores de 5 anos,clasificacion a y b,2002-01-01,2,0,2,0,2
21204,PUERTO PEREZ,estado nutricional en menores de 5 anos,clasificacion a y b,2002-01-01,1,4,1,4,5
71402,PUERTO QUIJARRO,estado nutricional en menores de 5 anos,clasificacion a y b,2002-01-01,60,9,60,9,69
90201,PUERTO RICO,estado nutricional en menores de 5 anos,clasificacion a y b,2002-01-01,6,0,6,0,6
71401,PUERTO SUAREZ,estado nutricional en menores de 5 anos,clasificacion a y b,2002-01-01,74,10,74,10,84
31205,PUERTO VILLARROEL,estado nutricional en menores de 5 anos,clasificacion a y b,2002-01-01,119,63,119,63,182
51101,PUNA,estado nutricional en menores de 5 anos,clasificacion a y b,2002-01-01,11,32,11,32,43
31401,PUNATA,estado nutricional en menores de 5 anos,clasificacion a y b,2002-01-01,7,0,7,0,7
20604,QUIABAYA,estado nutricional en menores de 5 anos,clasificacion a y b,2002-01-01,3,0,3,0,3
30901,QUILLACOLLO,estado nutricional en menores de 5 anos,clasificacion a y b,2002-01-01,20,31,20,31,51
21002,QUIME,estado nutricional en menores de 5 anos,clasificacion a y b,2002-01-01,7,18,7,18,25
70904,QUIRUSILLAS,estado nutricional en menores de 5 anos,clasificacion a y b,2002-01-01,2,0,2,0,2
50402,RAVELO,estado nutricional en menores de 5 anos,clasificacion a y b,2002-01-01,7,11,7,11,18
80301,REYES,estado nutricional en menores de 5 anos,clasificacion a y b,2002-01-01,26,6,26,6,32
80201,RIBERALTA,estado nutricional en menores de 5 anos,clasificacion a y b,2002-01-01,200,81,200,81,281
70503,ROBORE,estado nutricional en menores de 5 anos,clasificacion a y b,2002-01-01,10,53,10,53,63
80304,RURRENABAQUE,estado nutricional en menores de 5 anos,clasificacion a y b,2002-01-01,44,36,44,36,80
40901,SABAYA,estado nutricional en menores de 5 anos,clasificacion a y b,2002-01-01,2,0,2,0,2
31001,SACABA,estado nutricional en menores de 5 anos,clasificacion a y b,2002-01-01,55,21,55,21,76
30404,SACABAMBA,estado nutricional en menores de 5 anos,clasificacion a y b,2002-01-01,1,1,1,1,2
50701,SACACA,estado nutricional en menores de 5 anos,clasificacion a y b,2002-01-01,10,14,10,14,24
71302,SAIPINA,estado nutricional en menores de 5 anos,clasificacion a y b,2002-01-01,58,18,58,18,76
40801,SALINAS DE GARCI MENDOZA,estado nutricional en menores de 5 anos,clasificacion a y b,2002-01-01,3,0,3,0,3
70901,SAMAIPATA,estado nutricional en menores de 5 anos,clasificacion a y b,2002-01-01,31,6,31,6,37
51601,SAN AGUSTIN,estado nutricional en menores de 5 anos,clasificacion a y b,2002-01-01,0,1,0,1,1
71105,SAN ANTONIO DE LOMERIO,estado nutricional en menores de 5 anos,clasificacion a y b,2002-01-01,21,4,21,4,25
31403,SAN BENITO,estado nutricional en menores de 5 anos,clasificacion a y b,2002-01-01,1,0,1,0,1
80302,SAN BORJA,estado nutricional en menores de 5 anos,clasificacion a y b,2002-01-01,81,33,81,33,114
21502,SAN BUENA VENTURA,estado nutricional en menores de 5 anos,clasificacion a y b,2002-01-01,10,4,10,4,14
70402,SAN CARLOS,estado nutricional en menores de 5 anos,clasificacion a y b,2002-01-01,10,1,10,1,11
80501,SAN IGNACIO,estado nutricional en menores de 5 anos,clasificacion a y b,2002-01-01,29,28,29,28,57
70301,SAN IGNACIO DE VELASCO,estado nutricional en menores de 5 anos,clasificacion a y b,2002-01-01,170,27,170,27,197
80102,SAN JAVIER(BNI),estado nutricional en menores de 5 anos,clasificacion a y b,2002-01-01,1,0,1,0,1
71102,SAN JAVIER(STC),estado nutricional en menores de 5 anos,clasificacion a y b,2002-01-01,27,25,27,25,52
80701,SAN JOAQUIN,estado nutricional en menores de 5 anos,clasificacion a y b,2002-01-01,7,13,7,13,20
70501,SAN JOSE DE CHIQUITOS,estado nutricional en menores de 5 anos,clasificacion a y b,2002-01-01,15,7,15,7,22
71104,SAN JULIAN,estado nutricional en menores de 5 anos,clasificacion a y b,2002-01-01,84,45,84,45,129
90302,SAN LORENZO(PND),estado nutricional en menores de 5 anos,clasificacion a y b,2002-01-01,1,3,1,3,4
60501,SAN LORENZO(TJA),estado nutricional en menores de 5 anos,clasificacion a y b,2002-01-01,2,8,2,8,10
10702,SAN LUCAS,estado nutricional en menores de 5 anos,clasificacion a y b,2002-01-01,21,64,21,64,85
71201,SAN MATIAS,estado nutricional en menores de 5 anos,clasificacion a y b,2002-01-01,31,12,31,12,43
70302,SAN MIGUEL DE VELASCO,estado nutricional en menores de 5 anos,clasificacion a y b,2002-01-01,32,15,32,15,47
51001,SAN PABLO DE LIPEZ,estado nutricional en menores de 5 anos,clasificacion a y b,2002-01-01,1,5,1,5,6
50501,SAN PEDRO DE BUENA VISTA,estado nutricional en menores de 5 anos,clasificacion a y b,2002-01-01,2,5,2,5,7
21801,SAN PEDRO DE CURAHUARA,estado nutricional en menores de 5 anos,clasificacion a y b,2002-01-01,2,11,2,11,13
21702,SAN PEDRO DE TIQUINA,estado nutricional en menores de 5 anos,clasificacion a y b,2002-01-01,6,22,6,22,28
90202,SAN PEDRO(PND),estado nutricional en menores de 5 anos,clasificacion a y b,2002-01-01,2,0,2,0,2
70303,SAN RAFAEL,estado nutricional en menores de 5 anos,clasificacion a y b,2002-01-01,14,0,14,0,14
80702,SAN RAMON,estado nutricional en menores de 5 anos,clasificacion a y b,2002-01-01,0,12,0,12,12
80702,SAN RAMON,estado nutricional en menores de 5 anos,clasificacion a y b,2002-01-01,48,90,48,90,138
80401,SANTA ANA,estado nutricional en menores de 5 anos,clasificacion a y b,2002-01-01,105,22,105,22,127
70101,SANTA CRUZ DE LA SIERRA,estado nutricional en menores de 5 anos,clasificacion a y b,2002-01-01,637,628,637,628,1265
80303,SANTA ROSA,estado nutricional en menores de 5 anos,clasificacion a y b,2002-01-01,10,2,10,2,12
70602,SANTA ROSA DEL SARA,estado nutricional en menores de 5 anos,clasificacion a y b,2002-01-01,15,29,15,29,44
41401,SANTIAGO DE HUARI,estado nutricional en menores de 5 anos,clasificacion a y b,2002-01-01,5,3,5,3,8
21901,SANTIAGO DE MACHACA,estado nutricional en menores de 5 anos,clasificacion a y b,2002-01-01,1,0,1,0,1
30702,SANTIVAÑES,estado nutricional en menores de 5 anos,clasificacion a y b,2002-01-01,4,1,4,1,5
40202,SANTUARIO DE QUILLACAS,estado nutricional en menores de 5 anos,clasificacion a y b,2002-01-01,0,1,0,1,1
20902,SAPAHAQUI,estado nutricional en menores de 5 anos,clasificacion a y b,2002-01-01,1,2,1,2,3
90303,SENA,estado nutricional en menores de 5 anos,clasificacion a y b,2002-01-01,2,18,2,18,20
21301,SICA SICA (VILLA AROMA),estado nutricional en menores de 5 anos,clasificacion a y b,2002-01-01,11,5,11,5,16
30703,SICAYA,estado nutricional en menores de 5 anos,clasificacion a y b,2002-01-01,1,0,1,0,1
30902,SIPE SIPE,estado nutricional en menores de 5 anos,clasificacion a y b,2002-01-01,97,58,97,58,155
10403,SOPACHUY,estado nutricional en menores de 5 anos,clasificacion a y b,2002-01-01,4,16,4,16,20
20601,SORATA,estado nutricional en menores de 5 anos,clasificacion a y b,2002-01-01,1,9,1,9,10
10101,SUCRE,estado nutricional en menores de 5 anos,clasificacion a y b,2002-01-01,99,316,99,316,415
31404,TACACHI,estado nutricional en menores de 5 anos,clasificacion a y b,2002-01-01,2,1,2,1,3
20603,TACACOMA,estado nutricional en menores de 5 anos,clasificacion a y b,2002-01-01,0,6,0,6,6
50303,TACOBAMBA,estado nutricional en menores de 5 anos,clasificacion a y b,2002-01-01,5,17,5,17,22
30602,TACOPAYA,estado nutricional en menores de 5 anos,clasificacion a y b,2002-01-01,10,10,10,10,20
51402,TAHUA,estado nutricional en menores de 5 anos,clasificacion a y b,2002-01-01,0,2,0,2,2
31101,TAPACARI,estado nutricional en menores de 5 anos,clasificacion a y b,2002-01-01,3,15,3,15,18
10601,TARABUCO,estado nutricional en menores de 5 anos,clasificacion a y b,2002-01-01,16,48,16,48,64
30401,TARATA,estado nutricional en menores de 5 anos,clasificacion a y b,2002-01-01,5,26,5,26,31
60101,TARIJA,estado nutricional en menores de 5 anos,clasificacion a y b,2002-01-01,150,197,150,197,347
10202,TARVITA,estado nutricional en menores de 5 anos,clasificacion a y b,2002-01-01,22,14,22,14,36
20803,TIAWANACU,estado nutricional en menores de 5 anos,clasificacion a y b,2002-01-01,13,2,13,2,15
50102,TINGUIPAYA,estado nutricional en menores de 5 anos,clasificacion a y b,2002-01-01,3,2,3,2,5
20606,TIPUANI,estado nutricional en menores de 5 anos,clasificacion a y b,2002-01-01,12,4,12,4,16
30903,TIQUIPAYA,estado nutricional en menores de 5 anos,clasificacion a y b,2002-01-01,1,18,1,18,19
31601,TIRAQUE (CBBA),estado nutricional en menores de 5 anos,clasificacion a y b,2002-01-01,50,24,50,24,74
30802,TOCO,estado nutricional en menores de 5 anos,clasificacion a y b,2002-01-01,0,1,0,1,1
41502,TODOS SANTOS,estado nutricional en menores de 5 anos,clasificacion a y b,2002-01-01,0,1,0,1,1
41001,TOLEDO,estado nutricional en menores de 5 anos,clasificacion a y b,2002-01-01,16,2,16,2,18
51202,TOMAVE,estado nutricional en menores de 5 anos,clasificacion a y b,2002-01-01,4,21,4,21,25
10402,TOMINA,estado nutricional en menores de 5 anos,clasificacion a y b,2002-01-01,16,21,16,21,37
50502,TORO TORO,estado nutricional en menores de 5 anos,clasificacion a y b,2002-01-01,5,15,5,15,20
31201,TOTORA(CBBA),estado nutricional en menores de 5 anos,clasificacion a y b,2002-01-01,19,28,19,28,47
41301,TOTORA(ORR),estado nutricional en menores de 5 anos,clasificacion a y b,2002-01-01,2,5,2,5,7
70802,TRIGAL,estado nutricional en menores de 5 anos,clasificacion a y b,2002-01-01,4,0,4,0,4
80101,TRINIDAD,estado nutricional en menores de 5 anos,clasificacion a y b,2002-01-01,64,94,64,94,158
50801,TUPIZA,estado nutricional en menores de 5 anos,clasificacion a y b,2002-01-01,17,98,17,98,115
40402,TURCO,estado nutricional en menores de 5 anos,clasificacion a y b,2002-01-01,6,0,6,0,6
60401,URIONDO (A. CONCEPCION),estado nutricional en menores de 5 anos,clasificacion a y b,2002-01-01,24,26,24,26,50
71502,URUBICHA,estado nutricional en menores de 5 anos,clasificacion a y b,2002-01-01,2,17,2,17,19
51201,UYUNI,estado nutricional en menores de 5 anos,clasificacion a y b,2002-01-01,6,11,6,11,17
30502,VACAS,estado nutricional en menores de 5 anos,clasificacion a y b,2002-01-01,1,0,1,0,1
70801,VALLEGRANDE,estado nutricional en menores de 5 anos,clasificacion a y b,2002-01-01,37,53,37,53,90
20801,VIACHA,estado nutricional en menores de 5 anos,clasificacion a y b,2002-01-01,21,46,21,46,67
31302,VILA VILA,estado nutricional en menores de 5 anos,clasificacion a y b,2002-01-01,4,0,4,0,4
60303,VILLA MONTES,estado nutricional en menores de 5 anos,clasificacion a y b,2002-01-01,35,9,35,9,44
31402,VILLA RIVERO,estado nutricional en menores de 5 anos,clasificacion a y b,2002-01-01,0,7,0,7,7
10801,VILLA SERRANO,estado nutricional en menores de 5 anos,clasificacion a y b,2002-01-01,10,26,10,26,36
31003,VILLA TUNARI,estado nutricional en menores de 5 anos,clasificacion a y b,2002-01-01,50,66,50,66,116
11001,VILLA VACA GUZMAN (MUYUPAMPA),estado nutricional en menores de 5 anos,clasificacion a y b,2002-01-01,14,34,14,34,48
51501,VILLAZON,estado nutricional en menores de 5 anos,clasificacion a y b,2002-01-01,28,104,28,104,132
30904,VINTO,estado nutricional en menores de 5 anos,clasificacion a y b,2002-01-01,41,45,41,45,86
50602,VITICHI,estado nutricional en menores de 5 anos,clasificacion a y b,2002-01-01,5,18,5,18,23
20306,WALDO BALLIVIAN,estado nutricional en menores de 5 anos,clasificacion a y b,2002-01-01,2,0,2,0,2
70201,WARNES,estado nutricional en menores de 5 anos,clasificacion a y b,2002-01-01,97,49,97,49,146
20903,YACO,estado nutricional en menores de 5 anos,clasificacion a y b,2002-01-01,3,14,3,14,17
60301,YACUIBA,estado nutricional en menores de 5 anos,clasificacion a y b,2002-01-01,64,4,64,4,68
10602,YAMPARAEZ,estado nutricional en menores de 5 anos,clasificacion a y b,2002-01-01,51,7,51,7,58
21103,YANACACHI,estado nutricional en menores de 5 anos,clasificacion a y b,2002-01-01,25,4,25,4,29
70403,YAPACANI,estado nutricional en menores de 5 anos,clasificacion a y b,2002-01-01,107,41,107,41,148
50103,YOCALLA,estado nutricional en menores de 5 anos,clasificacion a y b,2002-01-01,0,8,0,8,8
10102,YOTALA,estado nutricional en menores de 5 anos,clasificacion a y b,2002-01-01,34,6,34,6,40
60402,YUNCHARA,estado nutricional en menores de 5 anos,clasificacion a y b,2002-01-01,7,4,7,4,11
10301,ZUDAÑEZ,estado nutricional en menores de 5 anos,clasificacion a y b,2002-01-01,35,5,35,5,40
51302,ACACIO,estado nutricional en menores de 5 anos,clasificacion a y b,2002-02-01,4,10,4,10,14
20201,ACHACACHI,estado nutricional en menores de 5 anos,clasificacion a y b,2002-02-01,38,58,38,58,96
20104,ACHOCALLA,estado nutricional en menores de 5 anos,clasificacion a y b,2002-02-01,0,3,0,3,3
30201,AIQUILE,estado nutricional en menores de 5 anos,clasificacion a y b,2002-02-01,3,0,3,0,3
31303,ALALAY,estado nutricional en menores de 5 anos,clasificacion a y b,2002-02-01,0,1,0,1,1
10404,ALCALA,estado nutricional en menores de 5 anos,clasificacion a y b,2002-02-01,19,4,19,4,23
20202,ANCORAIMES,estado nutricional en menores de 5 anos,clasificacion a y b,2002-02-01,15,5,15,5,20
41201,ANDAMARCA,estado nutricional en menores de 5 anos,clasificacion a y b,2002-02-01,2,0,2,0,2
30402,ANZALDO,estado nutricional en menores de 5 anos,clasificacion a y b,2002-02-01,1,4,1,4,5
20701,APOLO,estado nutricional en menores de 5 anos,clasificacion a y b,2002-02-01,22,0,22,0,22
51301,ARAMPAMPA,estado nutricional en menores de 5 anos,clasificacion a y b,2002-02-01,2,7,2,7,9
30501,ARANI,estado nutricional en menores de 5 anos,clasificacion a y b,2002-02-01,3,9,3,9,12
30403,ARBIETO,estado nutricional en menores de 5 anos,clasificacion a y b,2002-02-01,0,2,0,2,2
71501,ASCENCION DE GUARAYOS,estado nutricional en menores de 5 anos,clasificacion a y b,2002-02-01,47,35,47,35,82
50802,ATOCHA,estado nutricional en menores de 5 anos,clasificacion a y b,2002-02-01,3,8,3,8,11
21303,AYO AYO,estado nutricional en menores de 5 anos,clasificacion a y b,2002-02-01,7,2,7,2,9
30301,AYOPAYA (V. DE INDEPENDENCIA),estado nutricional en menores de 5 anos,clasificacion a y b,2002-02-01,7,1,7,1,8
10201,AZURDUY,estado nutricional en menores de 5 anos,clasificacion a y b,2002-02-01,15,17,15,17,32
21203,BATALLAS,estado nutricional en menores de 5 anos,clasificacion a y b,2002-02-01,5,30,5,30,35
80802,BAURES,estado nutricional en menores de 5 anos,clasificacion a y b,2002-02-01,10,7,10,7,17
50104,BELEN DE URMIRI,estado nutricional en menores de 5 anos,clasificacion a y b,2002-02-01,2,4,2,4,6
90104,BELLA FLOR,estado nutricional en menores de 5 anos,clasificacion a y b,2002-02-01,7,6,7,6,13
60202,BERMEJO,estado nutricional en menores de 5 anos,clasificacion a y b,2002-02-01,11,44,11,44,55
50301,BETANZOS,estado nutricional en menores de 5 anos,clasificacion a y b,2002-02-01,12,11,12,11,23
31501,BOLIVAR,estado nutricional en menores de 5 anos,clasificacion a y b,2002-02-01,3,6,3,6,9
90103,BOLPEBRA,estado nutricional en menores de 5 anos,clasificacion a y b,2002-02-01,2,0,2,0,2
70707,BOYUIBE,estado nutricional en menores de 5 anos,clasificacion a y b,2002-02-01,8,24,8,24,32
70401,BUENA VISTA,estado nutricional en menores de 5 anos,clasificacion a y b,2002-02-01,89,17,89,17,106
70703,CABEZAS,estado nutricional en menores de 5 anos,clasificacion a y b,2002-02-01,16,48,16,48,64
20905,CAIROMA,estado nutricional en menores de 5 anos,clasificacion a y b,2002-02-01,0,5,0,5,5
51102,"CAIZA ""D""",estado nutricional en menores de 5 anos,clasificacion a y b,2002-02-01,15,16,15,16,31
21003,CAJUATA,estado nutricional en menores de 5 anos,clasificacion a y b,2002-02-01,8,0,8,0,8
20303,CALACOTO,estado nutricional en menores de 5 anos,clasificacion a y b,2002-02-01,1,0,1,0,1
21304,CALAMARCA,estado nutricional en menores de 5 anos,clasificacion a y b,2002-02-01,6,7,6,7,13
10701,CAMARGO,estado nutricional en menores de 5 anos,clasificacion a y b,2002-02-01,12,13,12,13,25
10901,CAMATAQUI (C. VILLA ABECIA),estado nutricional en menores de 5 anos,clasificacion a y b,2002-02-01,0,3,0,3,3
70706,CAMIRI,estado nutricional en menores de 5 anos,clasificacion a y b,2002-02-01,63,38,63,38,101
30701,CAPINOTA,estado nutricional en menores de 5 anos,clasificacion a y b,2002-02-01,3,2,3,2,5
20302,CAQUIAVIRI,estado nutricional en menores de 5 anos,clasificacion a y b,2002-02-01,13,3,13,3,16
40102,CARACOLLO,estado nutricional en menores de 5 anos,clasificacion a y b,2002-02-01,22,17,22,17,39
22001,CARANAVI,estado nutricional en menores de 5 anos,clasificacion a y b,2002-02-01,96,30,96,30,126
60302,CARAPARI,estado nutricional en menores de 5 anos,clasificacion a y b,2002-02-01,20,15,20,15,35
50702,CARIPUYO,estado nutricional en menores de 5 anos,clasificacion a y b,2002-02-01,4,3,4,3,7
40201,CHALLAPATA,estado nutricional en menores de 5 anos,clasificacion a y b,2002-02-01,15,2,15,2,17
50302,CHAQUI,estado nutricional en menores de 5 anos,clasificacion a y b,2002-02-01,2,3,2,3,5
70702,CHARAGUA,estado nutricional en menores de 5 anos,clasificacion a y b,2002-02-01,18,71,18,71,89
31204,CHIMORE,estado nutricional en menores de 5 anos,clasificacion a y b,2002-02-01,7,3,7,3,10
40302,CHOQUE COTA,estado nutricional en menores de 5 anos,clasificacion a y b,2002-02-01,1,0,1,0,1
21101,CHULUMANI (V. DE LA LIBERTAD),estado nutricional en menores de 5 anos,clasificacion a y b,2002-02-01,8,3,8,3,11
20501,CHUMA,estado nutricional en menores de 5 anos,clasificacion a y b,2002-02-01,3,1,3,1,4
30801,CLIZA,estado nutricional en menores de 5 anos,clasificacion a y b,2002-02-01,6,10,6,10,16
90101,COBIJA,estado nutricional en menores de 5 anos,clasificacion a y b,2002-02-01,40,10,40,10,50
30101,COCHABAMBA,estado nutricional en menores de 5 anos,clasificacion a y b,2002-02-01,1156,885,1156,885,2041
40902,COIPASA,estado nutricional en menores de 5 anos,clasificacion a y b,2002-02-01,0,1,0,1,1
30905,COLCAPIRHUA,estado nutricional en menores de 5 anos,clasificacion a y b,2002-02-01,24,19,24,19,43
50901,"COLCHA ""K""",estado nutricional en menores de 5 anos,clasificacion a y b,2002-02-01,1,7,1,7,8
21307,COLLANA,estado nutricional en menores de 5 anos,clasificacion a y b,2002-02-01,1,0,1,0,1
31002,COLOMI,estado nutricional en menores de 5 anos,clasificacion a y b,2002-02-01,16,3,16,3,19
50401,COLQUECHACA,estado nutricional en menores de 5 anos,clasificacion a y b,2002-02-01,1,2,1,2,3
21306,COLQUENCHA,estado nutricional en menores de 5 anos,clasificacion a y b,2002-02-01,4,2,4,2,6
21004,COLQUIRI,estado nutricional en menores de 5 anos,clasificacion a y b,2002-02-01,8,9,8,9,17
20304,COMANCHE,estado nutricional en menores de 5 anos,clasificacion a y b,2002-02-01,4,1,4,1,5
71301,COMARAPA,estado nutricional en menores de 5 anos,clasificacion a y b,2002-02-01,11,9,11,9,20
20605,COMBAYA,estado nutricional en menores de 5 anos,clasificacion a y b,2002-02-01,1,5,1,5,6
71101,CONCEPCION,estado nutricional en menores de 5 anos,clasificacion a y b,2002-02-01,4,39,4,39,43
21701,COPACABANA,estado nutricional en menores de 5 anos,clasificacion a y b,2002-02-01,8,8,8,8,16
21402,CORIPATA,estado nutricional en menores de 5 anos,clasificacion a y b,2002-02-01,12,13,12,13,25
20301,CORO CORO,estado nutricional en menores de 5 anos,clasificacion a y b,2002-02-01,7,1,7,1,8
21401,COROICO,estado nutricional en menores de 5 anos,clasificacion a y b,2002-02-01,4,6,4,6,10
40301,CORQUE,estado nutricional en menores de 5 anos,clasificacion a y b,2002-02-01,4,1,4,1,5
50601,COTAGAITA,estado nutricional en menores de 5 anos,clasificacion a y b,2002-02-01,11,14,11,14,25
70102,COTOCA,estado nutricional en menores de 5 anos,clasificacion a y b,2002-02-01,90,64,90,64,154
31405,CUCHUMUELA (V. G. VILLARROEL),estado nutricional en menores de 5 anos,clasificacion a y b,2002-02-01,0,2,0,2,2
70704,CUEVO,estado nutricional en menores de 5 anos,clasificacion a y b,2002-02-01,24,0,24,0,24
10902,CULPINA,estado nutricional en menores de 5 anos,clasificacion a y b,2002-02-01,3,48,3,48,51
40401,CURAHUARA DE CARANGAS,estado nutricional en menores de 5 anos,clasificacion a y b,2002-02-01,2,0,2,0,2
21602,CURVA,estado nutricional en menores de 5 anos,clasificacion a y b,2002-02-01,4,0,4,0,4
20804,DESAGUADERO,estado nutricional en menores de 5 anos,clasificacion a y b,2002-02-01,1,6,1,6,7
20105,EL ALTO,estado nutricional en menores de 5 anos,clasificacion a y b,2002-02-01,348,241,348,241,589
40103,EL CHORO,estado nutricional en menores de 5 anos,clasificacion a y b,2002-02-01,3,0,3,0,3
71503,EL PUENTE(STC),estado nutricional en menores de 5 anos,clasificacion a y b,2002-02-01,32,24,32,24,56
60502,EL PUENTE(TJA),estado nutricional en menores de 5 anos,clasificacion a y b,2002-02-01,3,3,3,3,6
70105,EL TORNO,estado nutricional en menores de 5 anos,clasificacion a y b,2002-02-01,117,29,117,29,146
10405,EL VILLAR,estado nutricional en menores de 5 anos,clasificacion a y b,2002-02-01,14,3,14,3,17
60601,ENTRE RIOS,estado nutricional en menores de 5 anos,clasificacion a y b,2002-02-01,17,13,17,13,30
41101,EUCALIPTUS,estado nutricional en menores de 5 anos,clasificacion a y b,2002-02-01,1,9,1,9,10
90503,EUREKA (SANTOS MERCADO),estado nutricional en menores de 5 anos,clasificacion a y b,2002-02-01,0,2,0,2,2
80402,EXALTACION,estado nutricional en menores de 5 anos,clasificacion a y b,2002-02-01,0,41,0,41,41
90203,FILADELFIA,estado nutricional en menores de 5 anos,clasificacion a y b,2002-02-01,2,2,2,2,4
71002,GENERAL SAAVEDRA,estado nutricional en menores de 5 anos,clasificacion a y b,2002-02-01,29,61,29,61,90
21601,GRAL. J.J. PEREZ (CHARAZANI),estado nutricional en menores de 5 anos,clasificacion a y b,2002-02-01,2,0,2,0,2
20602,GUANAY,estado nutricional en menores de 5 anos,clasificacion a y b,2002-02-01,25,81,25,81,106
20802,GUAQUI,estado nutricional en menores de 5 anos,clasificacion a y b,2002-02-01,2,5,2,5,7
80202,GUAYARAMERIN,estado nutricional en menores de 5 anos,clasificacion a y b,2002-02-01,43,9,43,9,52
70705,GUTIERREZ,estado nutricional en menores de 5 anos,clasificacion a y b,2002-02-01,35,58,35,58,93
10502,HUACARETA,estado nutricional en menores de 5 anos,clasificacion a y b,2002-02-01,26,21,26,21,47
11002,HUACAYA (VILLA DE HUACAYA),estado nutricional en menores de 5 anos,clasificacion a y b,2002-02-01,7,5,7,5,12
40501,HUACHACALLA,estado nutricional en menores de 5 anos,clasificacion a y b,2002-02-01,1,6,1,6,7
80803,HUARACAJE,estado nutricional en menores de 5 anos,clasificacion a y b,2002-02-01,21,8,21,8,29
41601,HUAYLLAMARCA,estado nutricional en menores de 5 anos,clasificacion a y b,2002-02-01,1,2,1,2,3
21005,ICHOCA,estado nutricional en menores de 5 anos,clasificacion a y b,2002-02-01,3,0,3,0,3
10304,ICLA,estado nutricional en menores de 5 anos,clasificacion a y b,2002-02-01,9,6,9,6,15
10703,INCAHUASI,estado nutricional en menores de 5 anos,clasificacion a y b,2002-02-01,6,22,6,22,28
21001,INQUISIVI,estado nutricional en menores de 5 anos,clasificacion a y b,2002-02-01,4,3,4,3,7
21102,IRUPANA (VILLA DE LANZA),estado nutricional en menores de 5 anos,clasificacion a y b,2002-02-01,7,29,7,29,36
21501,IXIAMAS,estado nutricional en menores de 5 anos,clasificacion a y b,2002-02-01,50,21,50,21,71
21105,LA ASUNTA,estado nutricional en menores de 5 anos,clasificacion a y b,2002-02-01,15,24,15,24,39
70104,LA GUARDIA,estado nutricional en menores de 5 anos,clasificacion a y b,2002-02-01,158,26,158,26,184
20101,LA PAZ,estado nutricional en menores de 5 anos,clasificacion a y b,2002-02-01,420,276,420,276,696
70701,LAGUNILLAS,estado nutricional en menores de 5 anos,clasificacion a y b,2002-02-01,8,12,8,12,20
21202,LAJA,estado nutricional en menores de 5 anos,clasificacion a y b,2002-02-01,3,12,3,12,15
10903,LAS CARRERAS,estado nutricional en menores de 5 anos,clasificacion a y b,2002-02-01,0,7,0,7,7
51401,LLICA,estado nutricional en menores de 5 anos,clasificacion a y b,2002-02-01,0,2,0,2,2
80601,LORETO,estado nutricional en menores de 5 anos,clasificacion a y b,2002-02-01,0,1,0,1,1
20901,LURIBAY,estado nutricional en menores de 5 anos,clasificacion a y b,2002-02-01,1,9,1,9,10
40702,MACHACAMARCA,estado nutricional en menores de 5 anos,clasificacion a y b,2002-02-01,12,2,12,2,14
11003,MACHARETI,estado nutricional en menores de 5 anos,clasificacion a y b,2002-02-01,37,8,37,8,45
80801,MAGDALENA,estado nutricional en menores de 5 anos,clasificacion a y b,2002-02-01,2,2,2,2,4
70903,MAIRANA,estado nutricional en menores de 5 anos,clasificacion a y b,2002-02-01,42,8,42,8,50
20103,MECAPACA,estado nutricional en menores de 5 anos,clasificacion a y b,2002-02-01,7,5,7,5,12
71003,MINEROS,estado nutricional en menores de 5 anos,clasificacion a y b,2002-02-01,57,70,57,70,127
31301,MIZQUE,estado nutricional en menores de 5 anos,clasificacion a y b,2002-02-01,2,13,2,13,15
20402,MOCOMOCO,estado nutricional en menores de 5 anos,clasificacion a y b,2002-02-01,4,14,4,14,18
10303,MOJOCOYA,estado nutricional en menores de 5 anos,clasificacion a y b,2002-02-01,32,8,32,8,40
10501,MONTEAGUDO,estado nutricional en menores de 5 anos,clasificacion a y b,2002-02-01,101,26,101,26,127
71001,MONTERO,estado nutricional en menores de 5 anos,clasificacion a y b,2002-02-01,42,325,42,325,367
70803,MORO MORO,estado nutricional en menores de 5 anos,clasificacion a y b,2002-02-01,1,3,1,3,4
30302,MOROCHATA,estado nutricional en menores de 5 anos,clasificacion a y b,2002-02-01,10,3,10,3,13
90401,NACEBE (SANTA ROSA DEL ABUNA),estado nutricional en menores de 5 anos,clasificacion a y b,2002-02-01,1,0,1,0,1
50404,OCURI,estado nutricional en menores de 5 anos,clasificacion a y b,2002-02-01,6,5,6,5,11
70202,OKINAWA,estado nutricional en menores de 5 anos,clasificacion a y b,2002-02-01,12,0,12,0,12
30203,OMEREQUE,estado nutricional en menores de 5 anos,clasificacion a y b,2002-02-01,2,8,2,8,10
40101,ORURO,estado nutricional en menores de 5 anos,clasificacion a y b,2002-02-01,71,146,71,146,217
60201,PADCAYA,estado nutricional en menores de 5 anos,clasificacion a y b,2002-02-01,17,12,17,12,29
10401,PADILLA,estado nutricional en menores de 5 anos,clasificacion a y b,2002-02-01,42,10,42,10,52
70502,PAILON,estado nutricional en menores de 5 anos,clasificacion a y b,2002-02-01,15,53,15,53,68
20102,PALCA,estado nutricional en menores de 5 anos,clasificacion a y b,2002-02-01,15,2,15,2,17
21104,PALOS BLANCOS,estado nutricional en menores de 5 anos,clasificacion a y b,2002-02-01,36,8,36,8,44
40802,PAMPA AULLAGAS,estado nutricional en menores de 5 anos,clasificacion a y b,2002-02-01,7,1,7,1,8
70902,PAMPA GRANDE,estado nutricional en menores de 5 anos,clasificacion a y b,2002-02-01,21,8,21,8,29
21802,PAPEL PAMPA,estado nutricional en menores de 5 anos,clasificacion a y b,2002-02-01,1,4,1,4,5
30202,PASORAPA,estado nutricional en menores de 5 anos,clasificacion a y b,2002-02-01,12,1,12,1,13
21305,PATACAMAYA,estado nutricional en menores de 5 anos,clasificacion a y b,2002-02-01,27,0,27,0,27
40602,PAZÑA,estado nutricional en menores de 5 anos,clasificacion a y b,2002-02-01,0,1,0,1,1
20702,PELECHUCO,estado nutricional en menores de 5 anos,clasificacion a y b,2002-02-01,1,2,1,2,3
50403,POCOATA,estado nutricional en menores de 5 anos,clasificacion a y b,2002-02-01,22,6,22,6,28
31203,POCONA,estado nutricional en menores de 5 anos,clasificacion a y b,2002-02-01,4,7,4,7,11
31202,POJO (CBBA),estado nutricional en menores de 5 anos,clasificacion a y b,2002-02-01,44,48,44,48,92
51203,PORCO,estado nutricional en menores de 5 anos,clasificacion a y b,2002-02-01,8,8,8,8,16
10103,POROMA,estado nutricional en menores de 5 anos,clasificacion a y b,2002-02-01,14,10,14,10,24
70103,PORONGO,estado nutricional en menores de 5 anos,clasificacion a y b,2002-02-01,22,6,22,6,28
70601,PORTACHUELO,estado nutricional en menores de 5 anos,clasificacion a y b,2002-02-01,44,13,44,13,57
90102,PORVENIR,estado nutricional en menores de 5 anos,clasificacion a y b,2002-02-01,0,1,0,1,1
50101,POTOSI,estado nutricional en menores de 5 anos,clasificacion a y b,2002-02-01,51,10,51,10,61
10302,PRESTO,estado nutricional en menores de 5 anos,clasificacion a y b,2002-02-01,28,2,28,2,30
21201,PUCARANI,estado nutricional en menores de 5 anos,clasificacion a y b,2002-02-01,5,20,5,20,25
20401,PUERTO ACOSTA,estado nutricional en menores de 5 anos,clasificacion a y b,2002-02-01,9,3,9,3,12
20403,PUERTO CARABUCO,estado nutricional en menores de 5 anos,clasificacion a y b,2002-02-01,21,6,21,6,27
21204,PUERTO PEREZ,estado nutricional en menores de 5 anos,clasificacion a y b,2002-02-01,1,3,1,3,4
71402,PUERTO QUIJARRO,estado nutricional en menores de 5 anos,clasificacion a y b,2002-02-01,31,1,31,1,32
90201,PUERTO RICO,estado nutricional en menores de 5 anos,clasificacion a y b,2002-02-01,1,3,1,3,4
71401,PUERTO SUAREZ,estado nutricional en menores de 5 anos,clasificacion a y b,2002-02-01,33,7,33,7,40
31205,PUERTO VILLARROEL,estado nutricional en menores de 5 anos,clasificacion a y b,2002-02-01,59,19,59,19,78
51101,PUNA,estado nutricional en menores de 5 anos,clasificacion a y b,2002-02-01,11,29,11,29,40
31401,PUNATA,estado nutricional en menores de 5 anos,clasificacion a y b,2002-02-01,0,3,0,3,3
20604,QUIABAYA,estado nutricional en menores de 5 anos,clasificacion a y b,2002-02-01,2,1,2,1,3
30901,QUILLACOLLO,estado nutricional en menores de 5 anos,clasificacion a y b,2002-02-01,2,0,2,0,2
21002,QUIME,estado nutricional en menores de 5 anos,clasificacion a y b,2002-02-01,8,15,8,15,23
50402,RAVELO,estado nutricional en menores de 5 anos,clasificacion a y b,2002-02-01,19,2,19,2,21
80301,REYES,estado nutricional en menores de 5 anos,clasificacion a y b,2002-02-01,10,2,10,2,12
80201,RIBERALTA,estado nutricional en menores de 5 anos,clasificacion a y b,2002-02-01,98,26,98,26,124
70503,ROBORE,estado nutricional en menores de 5 anos,clasificacion a y b,2002-02-01,11,17,11,17,28
80304,RURRENABAQUE,estado nutricional en menores de 5 anos,clasificacion a y b,2002-02-01,3,2,3,2,5
40901,SABAYA,estado nutricional en menores de 5 anos,clasificacion a y b,2002-02-01,1,3,1,3,4
31001,SACABA,estado nutricional en menores de 5 anos,clasificacion a y b,2002-02-01,86,23,86,23,109
30404,SACABAMBA,estado nutricional en menores de 5 anos,clasificacion a y b,2002-02-01,1,6,1,6,7
50701,SACACA,estado nutricional en menores de 5 anos,clasificacion a y b,2002-02-01,3,9,3,9,12
71302,SAIPINA,estado nutricional en menores de 5 anos,clasificacion a y b,2002-02-01,29,9,29,9,38
40801,SALINAS DE GARCI MENDOZA,estado nutricional en menores de 5 anos,clasificacion a y b,2002-02-01,1,0,1,0,1
70901,SAMAIPATA,estado nutricional en menores de 5 anos,clasificacion a y b,2002-02-01,17,1,17,1,18
51601,SAN AGUSTIN,estado nutricional en menores de 5 anos,clasificacion a y b,2002-02-01,1,5,1,5,6
51003,SAN ANTONIO DE ESMORUCO,estado nutricional en menores de 5 anos,clasificacion a y b,2002-02-01,1,0,1,0,1
71105,SAN ANTONIO DE LOMERIO,estado nutricional en menores de 5 anos,clasificacion a y b,2002-02-01,17,4,17,4,21
31403,SAN BENITO,estado nutricional en menores de 5 anos,clasificacion a y b,2002-02-01,0,6,0,6,6
80302,SAN BORJA,estado nutricional en menores de 5 anos,clasificacion a y b,2002-02-01,60,14,60,14,74
21502,SAN BUENA VENTURA,estado nutricional en menores de 5 anos,clasificacion a y b,2002-02-01,21,4,21,4,25
70402,SAN CARLOS,estado nutricional en menores de 5 anos,clasificacion a y b,2002-02-01,22,7,22,7,29
80501,SAN IGNACIO,estado nutricional en menores de 5 anos,clasificacion a y b,2002-02-01,12,28,12,28,40
70301,SAN IGNACIO DE VELASCO,estado nutricional en menores de 5 anos,clasificacion a y b,2002-02-01,144,36,144,36,180
80102,SAN JAVIER(BNI),estado nutricional en menores de 5 anos,clasificacion a y b,2002-02-01,3,9,3,9,12
71102,SAN JAVIER(STC),estado nutricional en menores de 5 anos,clasificacion a y b,2002-02-01,7,49,7,49,56
80701,SAN JOAQUIN,estado nutricional en menores de 5 anos,clasificacion a y b,2002-02-01,1,8,1,8,9
70501,SAN JOSE DE CHIQUITOS,estado nutricional en menores de 5 anos,clasificacion a y b,2002-02-01,16,10,16,10,26
71104,SAN JULIAN,estado nutricional en menores de 5 anos,clasificacion a y b,2002-02-01,118,58,118,58,176
60501,SAN LORENZO(TJA),estado nutricional en menores de 5 anos,clasificacion a y b,2002-02-01,5,1,5,1,6
10702,SAN LUCAS,estado nutricional en menores de 5 anos,clasificacion a y b,2002-02-01,5,26,5,26,31
71201,SAN MATIAS,estado nutricional en menores de 5 anos,clasificacion a y b,2002-02-01,27,34,27,34,61
70302,SAN MIGUEL DE VELASCO,estado nutricional en menores de 5 anos,clasificacion a y b,2002-02-01,25,6,25,6,31
51001,SAN PABLO DE LIPEZ,estado nutricional en menores de 5 anos,clasificacion a y b,2002-02-01,1,0,1,0,1
50501,SAN PEDRO DE BUENA VISTA,estado nutricional en menores de 5 anos,clasificacion a y b,2002-02-01,2,11,2,11,13
21801,SAN PEDRO DE CURAHUARA,estado nutricional en menores de 5 anos,clasificacion a y b,2002-02-01,2,5,2,5,7
50902,SAN PEDRO DE QUEMES,estado nutricional en menores de 5 anos,clasificacion a y b,2002-02-01,0,1,0,1,1
21702,SAN PEDRO DE TIQUINA,estado nutricional en menores de 5 anos,clasificacion a y b,2002-02-01,2,9,2,9,11
90202,SAN PEDRO(PND),estado nutricional en menores de 5 anos,clasificacion a y b,2002-02-01,1,0,1,0,1
70303,SAN RAFAEL,estado nutricional en menores de 5 anos,clasificacion a y b,2002-02-01,13,3,13,3,16
80702,SAN RAMON,estado nutricional en menores de 5 anos,clasificacion a y b,2002-02-01,4,14,4,14,18
80702,SAN RAMON,estado nutricional en menores de 5 anos,clasificacion a y b,2002-02-01,49,93,49,93,142
80401,SANTA ANA,estado nutricional en menores de 5 anos,clasificacion a y b,2002-02-01,31,29,31,29,60
70101,SANTA CRUZ DE LA SIERRA,estado nutricional en menores de 5 anos,clasificacion a y b,2002-02-01,827,559,827,559,1386
80303,SANTA ROSA,estado nutricional en menores de 5 anos,clasificacion a y b,2002-02-01,5,1,5,1,6
70602,SANTA ROSA DEL SARA,estado nutricional en menores de 5 anos,clasificacion a y b,2002-02-01,8,10,8,10,18
41401,SANTIAGO DE HUARI,estado nutricional en menores de 5 anos,clasificacion a y b,2002-02-01,12,1,12,1,13
21901,SANTIAGO DE MACHACA,estado nutricional en menores de 5 anos,clasificacion a y b,2002-02-01,2,0,2,0,2
30702,SANTIVAÑES,estado nutricional en menores de 5 anos,clasificacion a y b,2002-02-01,3,2,3,2,5
40202,SANTUARIO DE QUILLACAS,estado nutricional en menores de 5 anos,clasificacion a y b,2002-02-01,1,0,1,0,1
20902,SAPAHAQUI,estado nutricional en menores de 5 anos,clasificacion a y b,2002-02-01,0,2,0,2,2
21301,SICA SICA (VILLA AROMA),estado nutricional en menores de 5 anos,clasificacion a y b,2002-02-01,6,3,6,3,9
30703,SICAYA,estado nutricional en menores de 5 anos,clasificacion a y b,2002-02-01,2,3,2,3,5
30902,SIPE SIPE,estado nutricional en menores de 5 anos,clasificacion a y b,2002-02-01,40,27,40,27,67
10403,SOPACHUY,estado nutricional en menores de 5 anos,clasificacion a y b,2002-02-01,9,2,9,2,11
20601,SORATA,estado nutricional en menores de 5 anos,clasificacion a y b,2002-02-01,11,6,11,6,17
10101,SUCRE,estado nutricional en menores de 5 anos,clasificacion a y b,2002-02-01,64,262,64,262,326
31404,TACACHI,estado nutricional en menores de 5 anos,clasificacion a y b,2002-02-01,2,1,2,1,3
20603,TACACOMA,estado nutricional en menores de 5 anos,clasificacion a y b,2002-02-01,9,6,9,6,15
50303,TACOBAMBA,estado nutricional en menores de 5 anos,clasificacion a y b,2002-02-01,5,12,5,12,17
51402,TAHUA,estado nutricional en menores de 5 anos,clasificacion a y b,2002-02-01,1,2,1,2,3
31101,TAPACARI,estado nutricional en menores de 5 anos,clasificacion a y b,2002-02-01,5,15,5,15,20
10601,TARABUCO,estado nutricional en menores de 5 anos,clasificacion a y b,2002-02-01,30,47,30,47,77
30401,TARATA,estado nutricional en menores de 5 anos,clasificacion a y b,2002-02-01,1,3,1,3,4
60101,TARIJA,estado nutricional en menores de 5 anos,clasificacion a y b,2002-02-01,70,153,70,153,223
10202,TARVITA,estado nutricional en menores de 5 anos,clasificacion a y b,2002-02-01,20,2,20,2,22
20803,TIAWANACU,estado nutricional en menores de 5 anos,clasificacion a y b,2002-02-01,26,3,26,3,29
20606,TIPUANI,estado nutricional en menores de 5 anos,clasificacion a y b,2002-02-01,12,2,12,2,14
30903,TIQUIPAYA,estado nutricional en menores de 5 anos,clasificacion a y b,2002-02-01,3,10,3,10,13
31601,TIRAQUE (CBBA),estado nutricional en menores de 5 anos,clasificacion a y b,2002-02-01,56,31,56,31,87
30802,TOCO,estado nutricional en menores de 5 anos,clasificacion a y b,2002-02-01,1,2,1,2,3
41001,TOLEDO,estado nutricional en menores de 5 anos,clasificacion a y b,2002-02-01,7,1,7,1,8
51202,TOMAVE,estado nutricional en menores de 5 anos,clasificacion a y b,2002-02-01,6,20,6,20,26
10402,TOMINA,estado nutricional en menores de 5 anos,clasificacion a y b,2002-02-01,29,9,29,9,38
50502,TORO TORO,estado nutricional en menores de 5 anos,clasificacion a y b,2002-02-01,5,2,5,2,7
31201,TOTORA(CBBA),estado nutricional en menores de 5 anos,clasificacion a y b,2002-02-01,21,7,21,7,28
41301,TOTORA(ORR),estado nutricional en menores de 5 anos,clasificacion a y b,2002-02-01,2,4,2,4,6
70802,TRIGAL,estado nutricional en menores de 5 anos,clasificacion a y b,2002-02-01,3,0,3,0,3
50801,TUPIZA,estado nutricional en menores de 5 anos,clasificacion a y b,2002-02-01,14,48,14,48,62
40402,TURCO,estado nutricional en menores de 5 anos,clasificacion a y b,2002-02-01,10,1,10,1,11
21302,UMALA,estado nutricional en menores de 5 anos,clasificacion a y b,2002-02-01,1,0,1,0,1
60401,URIONDO (A. CONCEPCION),estado nutricional en menores de 5 anos,clasificacion a y b,2002-02-01,14,40,14,40,54
71502,URUBICHA,estado nutricional en menores de 5 anos,clasificacion a y b,2002-02-01,6,20,6,20,26
51201,UYUNI,estado nutricional en menores de 5 anos,clasificacion a y b,2002-02-01,4,6,4,6,10
30502,VACAS,estado nutricional en menores de 5 anos,clasificacion a y b,2002-02-01,1,1,1,1,2
70801,VALLEGRANDE,estado nutricional en menores de 5 anos,clasificacion a y b,2002-02-01,25,24,25,24,49
20801,VIACHA,estado nutricional en menores de 5 anos,clasificacion a y b,2002-02-01,11,20,11,20,31
31302,VILA VILA,estado nutricional en menores de 5 anos,clasificacion a y b,2002-02-01,1,4,1,4,5
60303,VILLA MONTES,estado nutricional en menores de 5 anos,clasificacion a y b,2002-02-01,19,13,19,13,32
90502,VILLA NUEVA (LOMA ALTA),estado nutricional en menores de 5 anos,clasificacion a y b,2002-02-01,2,0,2,0,2
31402,VILLA RIVERO,estado nutricional en menores de 5 anos,clasificacion a y b,2002-02-01,0,5,0,5,5
10801,VILLA SERRANO,estado nutricional en menores de 5 anos,clasificacion a y b,2002-02-01,12,4,12,4,16
31003,VILLA TUNARI,estado nutricional en menores de 5 anos,clasificacion a y b,2002-02-01,29,36,29,36,65
11001,VILLA VACA GUZMAN (MUYUPAMPA),estado nutricional en menores de 5 anos,clasificacion a y b,2002-02-01,41,21,41,21,62
51501,VILLAZON,estado nutricional en menores de 5 anos,clasificacion a y b,2002-02-01,13,55,13,55,68
30904,VINTO,estado nutricional en menores de 5 anos,clasificacion a y b,2002-02-01,30,34,30,34,64
50602,VITICHI,estado nutricional en menores de 5 anos,clasificacion a y b,2002-02-01,23,5,23,5,28
70201,WARNES,estado nutricional en menores de 5 anos,clasificacion a y b,2002-02-01,70,61,70,61,131
20903,YACO,estado nutricional en menores de 5 anos,clasificacion a y b,2002-02-01,3,6,3,6,9
60301,YACUIBA,estado nutricional en menores de 5 anos,clasificacion a y b,2002-02-01,30,4,30,4,34
10602,YAMPARAEZ,estado nutricional en menores de 5 anos,clasificacion a y b,2002-02-01,38,10,38,10,48
21103,YANACACHI,estado nutricional en menores de 5 anos,clasificacion a y b,2002-02-01,8,5,8,5,13
70403,YAPACANI,estado nutricional en menores de 5 anos,clasificacion a y b,2002-02-01,78,34,78,34,112
50103,YOCALLA,estado nutricional en menores de 5 anos,clasificacion a y b,2002-02-01,3,7,3,7,10
10102,YOTALA,estado nutricional en menores de 5 anos,clasificacion a y b,2002-02-01,41,6,41,6,47
60402,YUNCHARA,estado nutricional en menores de 5 anos,clasificacion a y b,2002-02-01,8,6,8,6,14
10301,ZUDAÑEZ,estado nutricional en menores de 5 anos,clasificacion a y b,2002-02-01,26,7,26,7,33
51302,ACACIO,estado nutricional en menores de 5 anos,clasificacion a y b,2002-03-01,1,0,1,0,1
20201,ACHACACHI,estado nutricional en menores de 5 anos,clasificacion a y b,2002-03-01,49,85,49,85,134
20104,ACHOCALLA,estado nutricional en menores de 5 anos,clasificacion a y b,2002-03-01,12,1,12,1,13
30201,AIQUILE,estado nutricional en menores de 5 anos,clasificacion a y b,2002-03-01,3,0,3,0,3
31303,ALALAY,estado nutricional en menores de 5 anos,clasificacion a y b,2002-03-01,0,1,0,1,1
10404,ALCALA,estado nutricional en menores de 5 anos,clasificacion a y b,2002-03-01,18,6,18,6,24
20202,ANCORAIMES,estado nutricional en menores de 5 anos,clasificacion a y b,2002-03-01,18,5,18,5,23
41201,ANDAMARCA,estado nutricional en menores de 5 anos,clasificacion a y b,2002-03-01,1,0,1,0,1
30402,ANZALDO,estado nutricional en menores de 5 anos,clasificacion a y b,2002-03-01,0,7,0,7,7
20701,APOLO,estado nutricional en menores de 5 anos,clasificacion a y b,2002-03-01,20,3,20,3,23
51301,ARAMPAMPA,estado nutricional en menores de 5 anos,clasificacion a y b,2002-03-01,3,8,3,8,11
30501,ARANI,estado nutricional en menores de 5 anos,clasificacion a y b,2002-03-01,3,11,3,11,14
30403,ARBIETO,estado nutricional en menores de 5 anos,clasificacion a y b,2002-03-01,7,17,7,17,24
30601,ARQUE,estado nutricional en menores de 5 anos,clasificacion a y b,2002-03-01,9,3,9,3,12
71501,ASCENCION DE GUARAYOS,estado nutricional en menores de 5 anos,clasificacion a y b,2002-03-01,0,1,0,1,1
50802,ATOCHA,estado nutricional en menores de 5 anos,clasificacion a y b,2002-03-01,0,4,0,4,4
21303,AYO AYO,estado nutricional en menores de 5 anos,clasificacion a y b,2002-03-01,9,0,9,0,9
30301,AYOPAYA (V. DE INDEPENDENCIA),estado nutricional en menores de 5 anos,clasificacion a y b,2002-03-01,20,6,20,6,26
10201,AZURDUY,estado nutricional en menores de 5 anos,clasificacion a y b,2002-03-01,20,14,20,14,34
21203,BATALLAS,estado nutricional en menores de 5 anos,clasificacion a y b,2002-03-01,2,25,2,25,27
80802,BAURES,estado nutricional en menores de 5 anos,clasificacion a y b,2002-03-01,7,4,7,4,11
41202,BELEN DE ANDAMARCA,estado nutricional en menores de 5 anos,clasificacion a y b,2002-03-01,1,0,1,0,1
50104,BELEN DE URMIRI,estado nutricional en menores de 5 anos,clasificacion a y b,2002-03-01,0,5,0,5,5
90104,BELLA FLOR,estado nutricional en menores de 5 anos,clasificacion a y b,2002-03-01,2,4,2,4,6
60202,BERMEJO,estado nutricional en menores de 5 anos,clasificacion a y b,2002-03-01,2,34,2,34,36
50301,BETANZOS,estado nutricional en menores de 5 anos,clasificacion a y b,2002-03-01,46,35,46,35,81
31501,BOLIVAR,estado nutricional en menores de 5 anos,clasificacion a y b,2002-03-01,1,3,1,3,4
90103,BOLPEBRA,estado nutricional en menores de 5 anos,clasificacion a y b,2002-03-01,2,7,2,7,9
70707,BOYUIBE,estado nutricional en menores de 5 anos,clasificacion a y b,2002-03-01,6,18,6,18,24
70401,BUENA VISTA,estado nutricional en menores de 5 anos,clasificacion a y b,2002-03-01,79,19,79,19,98
70703,CABEZAS,estado nutricional en menores de 5 anos,clasificacion a y b,2002-03-01,7,50,7,50,57
20905,CAIROMA,estado nutricional en menores de 5 anos,clasificacion a y b,2002-03-01,3,10,3,10,13
51102,"CAIZA ""D""",estado nutricional en menores de 5 anos,clasificacion a y b,2002-03-01,20,7,20,7,27
21003,CAJUATA,estado nutricional en menores de 5 anos,clasificacion a y b,2002-03-01,14,0,14,0,14
21304,CALAMARCA,estado nutricional en menores de 5 anos,clasificacion a y b,2002-03-01,6,3,6,3,9
10701,CAMARGO,estado nutricional en menores de 5 anos,clasificacion a y b,2002-03-01,10,40,10,40,50
10901,CAMATAQUI (C. VILLA ABECIA),estado nutricional en menores de 5 anos,clasificacion a y b,2002-03-01,3,11,3,11,14
70706,CAMIRI,estado nutricional en menores de 5 anos,clasificacion a y b,2002-03-01,55,24,55,24,79
30701,CAPINOTA,estado nutricional en menores de 5 anos,clasificacion a y b,2002-03-01,1,1,1,1,2
20302,CAQUIAVIRI,estado nutricional en menores de 5 anos,clasificacion a y b,2002-03-01,20,5,20,5,25
40102,CARACOLLO,estado nutricional en menores de 5 anos,clasificacion a y b,2002-03-01,14,17,14,17,31
22001,CARANAVI,estado nutricional en menores de 5 anos,clasificacion a y b,2002-03-01,101,47,101,47,148
41503,CARANGAS,estado nutricional en menores de 5 anos,clasificacion a y b,2002-03-01,0,1,0,1,1
60302,CARAPARI,estado nutricional en menores de 5 anos,clasificacion a y b,2002-03-01,17,32,17,32,49
50702,CARIPUYO,estado nutricional en menores de 5 anos,clasificacion a y b,2002-03-01,3,4,3,4,7
21902,CATACORA,estado nutricional en menores de 5 anos,clasificacion a y b,2002-03-01,1,0,1,0,1
40201,CHALLAPATA,estado nutricional en menores de 5 anos,clasificacion a y b,2002-03-01,21,1,21,1,22
50302,CHAQUI,estado nutricional en menores de 5 anos,clasificacion a y b,2002-03-01,1,8,1,8,9
70702,CHARAGUA,estado nutricional en menores de 5 anos,clasificacion a y b,2002-03-01,22,63,22,63,85
20305,CHARAÑA,estado nutricional en menores de 5 anos,clasificacion a y b,2002-03-01,0,1,0,1,1
31204,CHIMORE,estado nutricional en menores de 5 anos,clasificacion a y b,2002-03-01,16,5,16,5,21
40903,CHIPAYA,estado nutricional en menores de 5 anos,clasificacion a y b,2002-03-01,0,2,0,2,2
21101,CHULUMANI (V. DE LA LIBERTAD),estado nutricional en menores de 5 anos,clasificacion a y b,2002-03-01,6,9,6,9,15
20501,CHUMA,estado nutricional en menores de 5 anos,clasificacion a y b,2002-03-01,8,3,8,3,11
30801,CLIZA,estado nutricional en menores de 5 anos,clasificacion a y b,2002-03-01,10,14,10,14,24
90101,COBIJA,estado nutricional en menores de 5 anos,clasificacion a y b,2002-03-01,71,0,71,0,71
30101,COCHABAMBA,estado nutricional en menores de 5 anos,clasificacion a y b,2002-03-01,938,1398,938,1398,2336
30905,COLCAPIRHUA,estado nutricional en menores de 5 anos,clasificacion a y b,2002-03-01,53,11,53,11,64
50901,"COLCHA ""K""",estado nutricional en menores de 5 anos,clasificacion a y b,2002-03-01,3,18,3,18,21
21307,COLLANA,estado nutricional en menores de 5 anos,clasificacion a y b,2002-03-01,2,0,2,0,2
31002,COLOMI,estado nutricional en menores de 5 anos,clasificacion a y b,2002-03-01,20,4,20,4,24
50401,COLQUECHACA,estado nutricional en menores de 5 anos,clasificacion a y b,2002-03-01,6,1,6,1,7
21306,COLQUENCHA,estado nutricional en menores de 5 anos,clasificacion a y b,2002-03-01,10,0,10,0,10
21004,COLQUIRI,estado nutricional en menores de 5 anos,clasificacion a y b,2002-03-01,14,12,14,12,26
20304,COMANCHE,estado nutricional en menores de 5 anos,clasificacion a y b,2002-03-01,2,3,2,3,5
71301,COMARAPA,estado nutricional en menores de 5 anos,clasificacion a y b,2002-03-01,10,9,10,9,19
20605,COMBAYA,estado nutricional en menores de 5 anos,clasificacion a y b,2002-03-01,4,2,4,2,6
71101,CONCEPCION,estado nutricional en menores de 5 anos,clasificacion a y b,2002-03-01,4,27,4,27,31
21701,COPACABANA,estado nutricional en menores de 5 anos,clasificacion a y b,2002-03-01,1,13,1,13,14
21402,CORIPATA,estado nutricional en menores de 5 anos,clasificacion a y b,2002-03-01,18,31,18,31,49
20301,CORO CORO,estado nutricional en menores de 5 anos,clasificacion a y b,2002-03-01,6,3,6,3,9
21401,COROICO,estado nutricional en menores de 5 anos,clasificacion a y b,2002-03-01,11,3,11,3,14
40301,CORQUE,estado nutricional en menores de 5 anos,clasificacion a y b,2002-03-01,5,0,5,0,5
50601,COTAGAITA,estado nutricional en menores de 5 anos,clasificacion a y b,2002-03-01,15,25,15,25,40
70102,COTOCA,estado nutricional en menores de 5 anos,clasificacion a y b,2002-03-01,172,21,172,21,193
31405,CUCHUMUELA (V. G. VILLARROEL),estado nutricional en menores de 5 anos,clasificacion a y b,2002-03-01,1,8,1,8,9
70704,CUEVO,estado nutricional en menores de 5 anos,clasificacion a y b,2002-03-01,19,5,19,5,24
10902,CULPINA,estado nutricional en menores de 5 anos,clasificacion a y b,2002-03-01,26,37,26,37,63
40401,CURAHUARA DE CARANGAS,estado nutricional en menores de 5 anos,clasificacion a y b,2002-03-01,4,2,4,2,6
21602,CURVA,estado nutricional en menores de 5 anos,clasificacion a y b,2002-03-01,3,0,3,0,3
20804,DESAGUADERO,estado nutricional en menores de 5 anos,clasificacion a y b,2002-03-01,0,5,0,5,5
20105,EL ALTO,estado nutricional en menores de 5 anos,clasificacion a y b,2002-03-01,467,287,467,287,754
40103,EL CHORO,estado nutricional en menores de 5 anos,clasificacion a y b,2002-03-01,2,2,2,2,4
71503,EL PUENTE(STC),estado nutricional en menores de 5 anos,clasificacion a y b,2002-03-01,23,22,23,22,45
60502,EL PUENTE(TJA),estado nutricional en menores de 5 anos,clasificacion a y b,2002-03-01,2,4,2,4,6
70105,EL TORNO,estado nutricional en menores de 5 anos,clasificacion a y b,2002-03-01,123,40,123,40,163
10405,EL VILLAR,estado nutricional en menores de 5 anos,clasificacion a y b,2002-03-01,16,4,16,4,20
60601,ENTRE RIOS,estado nutricional en menores de 5 anos,clasificacion a y b,2002-03-01,25,17,25,17,42
41101,EUCALIPTUS,estado nutricional en menores de 5 anos,clasificacion a y b,2002-03-01,2,6,2,6,8
80402,EXALTACION,estado nutricional en menores de 5 anos,clasificacion a y b,2002-03-01,1,0,1,0,1
90203,FILADELFIA,estado nutricional en menores de 5 anos,clasificacion a y b,2002-03-01,3,5,3,5,8
71002,GENERAL SAAVEDRA,estado nutricional en menores de 5 anos,clasificacion a y b,2002-03-01,55,63,55,63,118
21601,GRAL. J.J. PEREZ (CHARAZANI),estado nutricional en menores de 5 anos,clasificacion a y b,2002-03-01,4,3,4,3,7
20602,GUANAY,estado nutricional en menores de 5 anos,clasificacion a y b,2002-03-01,21,94,21,94,115
20802,GUAQUI,estado nutricional en menores de 5 anos,clasificacion a y b,2002-03-01,0,5,0,5,5
80202,GUAYARAMERIN,estado nutricional en menores de 5 anos,clasificacion a y b,2002-03-01,47,17,47,17,64
70705,GUTIERREZ,estado nutricional en menores de 5 anos,clasificacion a y b,2002-03-01,16,48,16,48,64
10502,HUACARETA,estado nutricional en menores de 5 anos,clasificacion a y b,2002-03-01,59,15,59,15,74
11002,HUACAYA (VILLA DE HUACAYA),estado nutricional en menores de 5 anos,clasificacion a y b,2002-03-01,4,0,4,0,4
40501,HUACHACALLA,estado nutricional en menores de 5 anos,clasificacion a y b,2002-03-01,0,2,0,2,2
40701,HUANUNI,estado nutricional en menores de 5 anos,clasificacion a y b,2002-03-01,1,0,1,0,1
80803,HUARACAJE,estado nutricional en menores de 5 anos,clasificacion a y b,2002-03-01,9,8,9,8,17
41601,HUAYLLAMARCA,estado nutricional en menores de 5 anos,clasificacion a y b,2002-03-01,2,0,2,0,2
21005,ICHOCA,estado nutricional en menores de 5 anos,clasificacion a y b,2002-03-01,1,1,1,1,2
10304,ICLA,estado nutricional en menores de 5 anos,clasificacion a y b,2002-03-01,14,11,14,11,25
10703,INCAHUASI,estado nutricional en menores de 5 anos,clasificacion a y b,2002-03-01,11,50,11,50,61
21001,INQUISIVI,estado nutricional en menores de 5 anos,clasificacion a y b,2002-03-01,3,4,3,4,7
21102,IRUPANA (VILLA DE LANZA),estado nutricional en menores de 5 anos,clasificacion a y b,2002-03-01,16,14,16,14,30
21501,IXIAMAS,estado nutricional en menores de 5 anos,clasificacion a y b,2002-03-01,49,14,49,14,63
21105,LA ASUNTA,estado nutricional en menores de 5 anos,clasificacion a y b,2002-03-01,21,27,21,27,48
70104,LA GUARDIA,estado nutricional en menores de 5 anos,clasificacion a y b,2002-03-01,134,25,134,25,159
20101,LA PAZ,estado nutricional en menores de 5 anos,clasificacion a y b,2002-03-01,445,278,445,278,723
70701,LAGUNILLAS,estado nutricional en menores de 5 anos,clasificacion a y b,2002-03-01,14,23,14,23,37
21202,LAJA,estado nutricional en menores de 5 anos,clasificacion a y b,2002-03-01,5,15,5,15,20
10903,LAS CARRERAS,estado nutricional en menores de 5 anos,clasificacion a y b,2002-03-01,5,8,5,8,13
21006,LICOMA PAMPA,estado nutricional en menores de 5 anos,clasificacion a y b,2002-03-01,1,6,1,6,7
51401,LLICA,estado nutricional en menores de 5 anos,clasificacion a y b,2002-03-01,3,7,3,7,10
80601,LORETO,estado nutricional en menores de 5 anos,clasificacion a y b,2002-03-01,1,3,1,3,4
20901,LURIBAY,estado nutricional en menores de 5 anos,clasificacion a y b,2002-03-01,9,45,9,45,54
40702,MACHACAMARCA,estado nutricional en menores de 5 anos,clasificacion a y b,2002-03-01,5,4,5,4,9
11003,MACHARETI,estado nutricional en menores de 5 anos,clasificacion a y b,2002-03-01,25,15,25,15,40
80801,MAGDALENA,estado nutricional en menores de 5 anos,clasificacion a y b,2002-03-01,7,6,7,6,13
70903,MAIRANA,estado nutricional en menores de 5 anos,clasificacion a y b,2002-03-01,47,10,47,10,57
20103,MECAPACA,estado nutricional en menores de 5 anos,clasificacion a y b,2002-03-01,11,4,11,4,15
71003,MINEROS,estado nutricional en menores de 5 anos,clasificacion a y b,2002-03-01,76,54,76,54,130
31301,MIZQUE,estado nutricional en menores de 5 anos,clasificacion a y b,2002-03-01,4,14,4,14,18
20402,MOCOMOCO,estado nutricional en menores de 5 anos,clasificacion a y b,2002-03-01,14,2,14,2,16
10303,MOJOCOYA,estado nutricional en menores de 5 anos,clasificacion a y b,2002-03-01,47,13,47,13,60
10501,MONTEAGUDO,estado nutricional en menores de 5 anos,clasificacion a y b,2002-03-01,118,31,118,31,149
71001,MONTERO,estado nutricional en menores de 5 anos,clasificacion a y b,2002-03-01,48,358,48,358,406
70803,MORO MORO,estado nutricional en menores de 5 anos,clasificacion a y b,2002-03-01,12,5,12,5,17
30302,MOROCHATA,estado nutricional en menores de 5 anos,clasificacion a y b,2002-03-01,30,21,30,21,51
90401,NACEBE (SANTA ROSA DEL ABUNA),estado nutricional en menores de 5 anos,clasificacion a y b,2002-03-01,0,5,0,5,5
50404,OCURI,estado nutricional en menores de 5 anos,clasificacion a y b,2002-03-01,5,15,5,15,20
70202,OKINAWA,estado nutricional en menores de 5 anos,clasificacion a y b,2002-03-01,10,3,10,3,13
30203,OMEREQUE,estado nutricional en menores de 5 anos,clasificacion a y b,2002-03-01,2,4,2,4,6
40101,ORURO,estado nutricional en menores de 5 anos,clasificacion a y b,2002-03-01,230,112,230,112,342
60201,PADCAYA,estado nutricional en menores de 5 anos,clasificacion a y b,2002-03-01,29,26,29,26,55
10401,PADILLA,estado nutricional en menores de 5 anos,clasificacion a y b,2002-03-01,46,6,46,6,52
70502,PAILON,estado nutricional en menores de 5 anos,clasificacion a y b,2002-03-01,26,80,26,80,106
20102,PALCA,estado nutricional en menores de 5 anos,clasificacion a y b,2002-03-01,22,3,22,3,25
21104,PALOS BLANCOS,estado nutricional en menores de 5 anos,clasificacion a y b,2002-03-01,49,17,49,17,66
40802,PAMPA AULLAGAS,estado nutricional en menores de 5 anos,clasificacion a y b,2002-03-01,0,3,0,3,3
70902,PAMPA GRANDE,estado nutricional en menores de 5 anos,clasificacion a y b,2002-03-01,25,7,25,7,32
21802,PAPEL PAMPA,estado nutricional en menores de 5 anos,clasificacion a y b,2002-03-01,0,8,0,8,8
30202,PASORAPA,estado nutricional en menores de 5 anos,clasificacion a y b,2002-03-01,15,6,15,6,21
21305,PATACAMAYA,estado nutricional en menores de 5 anos,clasificacion a y b,2002-03-01,9,2,9,2,11
40602,PAZÑA,estado nutricional en menores de 5 anos,clasificacion a y b,2002-03-01,3,4,3,4,7
50403,POCOATA,estado nutricional en menores de 5 anos,clasificacion a y b,2002-03-01,21,8,21,8,29
31203,POCONA,estado nutricional en menores de 5 anos,clasificacion a y b,2002-03-01,10,5,10,5,15
31202,POJO (CBBA),estado nutricional en menores de 5 anos,clasificacion a y b,2002-03-01,61,65,61,65,126
40601,POOPO,estado nutricional en menores de 5 anos,clasificacion a y b,2002-03-01,1,3,1,3,4
51203,PORCO,estado nutricional en menores de 5 anos,clasificacion a y b,2002-03-01,4,6,4,6,10
10103,POROMA,estado nutricional en menores de 5 anos,clasificacion a y b,2002-03-01,20,14,20,14,34
70103,PORONGO,estado nutricional en menores de 5 anos,clasificacion a y b,2002-03-01,22,5,22,5,27
70601,PORTACHUELO,estado nutricional en menores de 5 anos,clasificacion a y b,2002-03-01,74,22,74,22,96
90102,PORVENIR,estado nutricional en menores de 5 anos,clasificacion a y b,2002-03-01,0,1,0,1,1
70804,POSTRER VALLE,estado nutricional en menores de 5 anos,clasificacion a y b,2002-03-01,6,2,6,2,8
50101,POTOSI,estado nutricional en menores de 5 anos,clasificacion a y b,2002-03-01,65,25,65,25,90
10302,PRESTO,estado nutricional en menores de 5 anos,clasificacion a y b,2002-03-01,30,2,30,2,32
21201,PUCARANI,estado nutricional en menores de 5 anos,clasificacion a y b,2002-03-01,9,46,9,46,55
20401,PUERTO ACOSTA,estado nutricional en menores de 5 anos,clasificacion a y b,2002-03-01,5,5,5,5,10
20403,PUERTO CARABUCO,estado nutricional en menores de 5 anos,clasificacion a y b,2002-03-01,19,2,19,2,21
90301,PUERTO GONZALO MORENO,estado nutricional en menores de 5 anos,clasificacion a y b,2002-03-01,3,0,3,0,3
21204,PUERTO PEREZ,estado nutricional en menores de 5 anos,clasificacion a y b,2002-03-01,1,8,1,8,9
71402,PUERTO QUIJARRO,estado nutricional en menores de 5 anos,clasificacion a y b,2002-03-01,33,8,33,8,41
90201,PUERTO RICO,estado nutricional en menores de 5 anos,clasificacion a y b,2002-03-01,3,13,3,13,16
71401,PUERTO SUAREZ,estado nutricional en menores de 5 anos,clasificacion a y b,2002-03-01,33,15,33,15,48
31205,PUERTO VILLARROEL,estado nutricional en menores de 5 anos,clasificacion a y b,2002-03-01,64,26,64,26,90
51101,PUNA,estado nutricional en menores de 5 anos,clasificacion a y b,2002-03-01,30,47,30,47,77
31401,PUNATA,estado nutricional en menores de 5 anos,clasificacion a y b,2002-03-01,5,10,5,10,15
20604,QUIABAYA,estado nutricional en menores de 5 anos,clasificacion a y b,2002-03-01,2,6,2,6,8
30901,QUILLACOLLO,estado nutricional en menores de 5 anos,clasificacion a y b,2002-03-01,23,6,23,6,29
21002,QUIME,estado nutricional en menores de 5 anos,clasificacion a y b,2002-03-01,9,17,9,17,26
50402,RAVELO,estado nutricional en menores de 5 anos,clasificacion a y b,2002-03-01,11,6,11,6,17
80301,REYES,estado nutricional en menores de 5 anos,clasificacion a y b,2002-03-01,7,2,7,2,9
80201,RIBERALTA,estado nutricional en menores de 5 anos,clasificacion a y b,2002-03-01,177,40,177,40,217
70503,ROBORE,estado nutricional en menores de 5 anos,clasificacion a y b,2002-03-01,6,30,6,30,36
80304,RURRENABAQUE,estado nutricional en menores de 5 anos,clasificacion a y b,2002-03-01,37,33,37,33,70
40901,SABAYA,estado nutricional en menores de 5 anos,clasificacion a y b,2002-03-01,0,1,0,1,1
31001,SACABA,estado nutricional en menores de 5 anos,clasificacion a y b,2002-03-01,75,43,75,43,118
30404,SACABAMBA,estado nutricional en menores de 5 anos,clasificacion a y b,2002-03-01,2,2,2,2,4
50701,SACACA,estado nutricional en menores de 5 anos,clasificacion a y b,2002-03-01,8,2,8,2,10
71302,SAIPINA,estado nutricional en menores de 5 anos,clasificacion a y b,2002-03-01,40,17,40,17,57
40801,SALINAS DE GARCI MENDOZA,estado nutricional en menores de 5 anos,clasificacion a y b,2002-03-01,5,5,5,5,10
70901,SAMAIPATA,estado nutricional en menores de 5 anos,clasificacion a y b,2002-03-01,21,6,21,6,27
51601,SAN AGUSTIN,estado nutricional en menores de 5 anos,clasificacion a y b,2002-03-01,6,2,6,2,8
80602,SAN ANDRES,estado nutricional en menores de 5 anos,clasificacion a y b,2002-03-01,15,1,15,1,16
51003,SAN ANTONIO DE ESMORUCO,estado nutricional en menores de 5 anos,clasificacion a y b,2002-03-01,0,5,0,5,5
71105,SAN ANTONIO DE LOMERIO,estado nutricional en menores de 5 anos,clasificacion a y b,2002-03-01,17,5,17,5,22
31403,SAN BENITO,estado nutricional en menores de 5 anos,clasificacion a y b,2002-03-01,1,9,1,9,10
80302,SAN BORJA,estado nutricional en menores de 5 anos,clasificacion a y b,2002-03-01,85,16,85,16,101
21502,SAN BUENA VENTURA,estado nutricional en menores de 5 anos,clasificacion a y b,2002-03-01,24,6,24,6,30
70402,SAN CARLOS,estado nutricional en menores de 5 anos,clasificacion a y b,2002-03-01,18,13,18,13,31
80501,SAN IGNACIO,estado nutricional en menores de 5 anos,clasificacion a y b,2002-03-01,21,55,21,55,76
70301,SAN IGNACIO DE VELASCO,estado nutricional en menores de 5 anos,clasificacion a y b,2002-03-01,130,39,130,39,169
80102,SAN JAVIER(BNI),estado nutricional en menores de 5 anos,clasificacion a y b,2002-03-01,5,13,5,13,18
71102,SAN JAVIER(STC),estado nutricional en menores de 5 anos,clasificacion a y b,2002-03-01,12,27,12,27,39
80701,SAN JOAQUIN,estado nutricional en menores de 5 anos,clasificacion a y b,2002-03-01,2,21,2,21,23
70501,SAN JOSE DE CHIQUITOS,estado nutricional en menores de 5 anos,clasificacion a y b,2002-03-01,23,15,23,15,38
71104,SAN JULIAN,estado nutricional en menores de 5 anos,clasificacion a y b,2002-03-01,73,50,73,50,123
60501,SAN LORENZO(TJA),estado nutricional en menores de 5 anos,clasificacion a y b,2002-03-01,16,1,16,1,17
10702,SAN LUCAS,estado nutricional en menores de 5 anos,clasificacion a y b,2002-03-01,22,53,22,53,75
71201,SAN MATIAS,estado nutricional en menores de 5 anos,clasificacion a y b,2002-03-01,46,15,46,15,61
70302,SAN MIGUEL DE VELASCO,estado nutricional en menores de 5 anos,clasificacion a y b,2002-03-01,17,4,17,4,21
51001,SAN PABLO DE LIPEZ,estado nutricional en menores de 5 anos,clasificacion a y b,2002-03-01,1,5,1,5,6
50501,SAN PEDRO DE BUENA VISTA,estado nutricional en menores de 5 anos,clasificacion a y b,2002-03-01,0,12,0,12,12
21801,SAN PEDRO DE CURAHUARA,estado nutricional en menores de 5 anos,clasificacion a y b,2002-03-01,4,4,4,4,8
21702,SAN PEDRO DE TIQUINA,estado nutricional en menores de 5 anos,clasificacion a y b,2002-03-01,5,10,5,10,15
90202,SAN PEDRO(PND),estado nutricional en menores de 5 anos,clasificacion a y b,2002-03-01,1,0,1,0,1
70303,SAN RAFAEL,estado nutricional en menores de 5 anos,clasificacion a y b,2002-03-01,11,4,11,4,15
80702,SAN RAMON,estado nutricional en menores de 5 anos,clasificacion a y b,2002-03-01,22,10,22,10,32
80702,SAN RAMON,estado nutricional en menores de 5 anos,clasificacion a y b,2002-03-01,2,42,2,42,44
80401,SANTA ANA,estado nutricional en menores de 5 anos,clasificacion a y b,2002-03-01,22,24,22,24,46
70101,SANTA CRUZ DE LA SIERRA,estado nutricional en menores de 5 anos,clasificacion a y b,2002-03-01,688,487,688,487,1175
80303,SANTA ROSA,estado nutricional en menores de 5 anos,clasificacion a y b,2002-03-01,8,4,8,4,12
70602,SANTA ROSA DEL SARA,estado nutricional en menores de 5 anos,clasificacion a y b,2002-03-01,18,8,18,8,26
41401,SANTIAGO DE HUARI,estado nutricional en menores de 5 anos,clasificacion a y b,2002-03-01,5,0,5,0,5
21901,SANTIAGO DE MACHACA,estado nutricional en menores de 5 anos,clasificacion a y b,2002-03-01,7,0,7,0,7
30702,SANTIVAÑES,estado nutricional en menores de 5 anos,clasificacion a y b,2002-03-01,2,1,2,1,3
40202,SANTUARIO DE QUILLACAS,estado nutricional en menores de 5 anos,clasificacion a y b,2002-03-01,1,0,1,0,1
20902,SAPAHAQUI,estado nutricional en menores de 5 anos,clasificacion a y b,2002-03-01,0,6,0,6,6
21301,SICA SICA (VILLA AROMA),estado nutricional en menores de 5 anos,clasificacion a y b,2002-03-01,11,5,11,5,16
30902,SIPE SIPE,estado nutricional en menores de 5 anos,clasificacion a y b,2002-03-01,69,25,69,25,94
10403,SOPACHUY,estado nutricional en menores de 5 anos,clasificacion a y b,2002-03-01,8,1,8,1,9
20601,SORATA,estado nutricional en menores de 5 anos,clasificacion a y b,2002-03-01,2,19,2,19,21
10101,SUCRE,estado nutricional en menores de 5 anos,clasificacion a y b,2002-03-01,176,313,176,313,489
31404,TACACHI,estado nutricional en menores de 5 anos,clasificacion a y b,2002-03-01,0,1,0,1,1
20603,TACACOMA,estado nutricional en menores de 5 anos,clasificacion a y b,2002-03-01,13,1,13,1,14
50303,TACOBAMBA,estado nutricional en menores de 5 anos,clasificacion a y b,2002-03-01,9,3,9,3,12
30602,TACOPAYA,estado nutricional en menores de 5 anos,clasificacion a y b,2002-03-01,0,1,0,1,1
51402,TAHUA,estado nutricional en menores de 5 anos,clasificacion a y b,2002-03-01,0,3,0,3,3
31101,TAPACARI,estado nutricional en menores de 5 anos,clasificacion a y b,2002-03-01,4,8,4,8,12
10601,TARABUCO,estado nutricional en menores de 5 anos,clasificacion a y b,2002-03-01,18,54,18,54,72
30401,TARATA,estado nutricional en menores de 5 anos,clasificacion a y b,2002-03-01,2,11,2,11,13
60101,TARIJA,estado nutricional en menores de 5 anos,clasificacion a y b,2002-03-01,94,151,94,151,245
10202,TARVITA,estado nutricional en menores de 5 anos,clasificacion a y b,2002-03-01,21,0,21,0,21
20803,TIAWANACU,estado nutricional en menores de 5 anos,clasificacion a y b,2002-03-01,24,9,24,9,33
50102,TINGUIPAYA,estado nutricional en menores de 5 anos,clasificacion a y b,2002-03-01,6,1,6,1,7
20606,TIPUANI,estado nutricional en menores de 5 anos,clasificacion a y b,2002-03-01,20,2,20,2,22
30903,TIQUIPAYA,estado nutricional en menores de 5 anos,clasificacion a y b,2002-03-01,6,15,6,15,21
31601,TIRAQUE (CBBA),estado nutricional en menores de 5 anos,clasificacion a y b,2002-03-01,48,24,48,24,72
30802,TOCO,estado nutricional en menores de 5 anos,clasificacion a y b,2002-03-01,1,1,1,1,2
41001,TOLEDO,estado nutricional en menores de 5 anos,clasificacion a y b,2002-03-01,7,2,7,2,9
51202,TOMAVE,estado nutricional en menores de 5 anos,clasificacion a y b,2002-03-01,3,14,3,14,17
10402,TOMINA,estado nutricional en menores de 5 anos,clasificacion a y b,2002-03-01,36,16,36,16,52
50502,TORO TORO,estado nutricional en menores de 5 anos,clasificacion a y b,2002-03-01,6,0,6,0,6
31201,TOTORA(CBBA),estado nutricional en menores de 5 anos,clasificacion a y b,2002-03-01,29,10,29,10,39
41301,TOTORA(ORR),estado nutricional en menores de 5 anos,clasificacion a y b,2002-03-01,0,5,0,5,5
70802,TRIGAL,estado nutricional en menores de 5 anos,clasificacion a y b,2002-03-01,3,0,3,0,3
80101,TRINIDAD,estado nutricional en menores de 5 anos,clasificacion a y b,2002-03-01,96,96,96,96,192
50801,TUPIZA,estado nutricional en menores de 5 anos,clasificacion a y b,2002-03-01,16,63,16,63,79
40402,TURCO,estado nutricional en menores de 5 anos,clasificacion a y b,2002-03-01,9,1,9,1,10
21302,UMALA,estado nutricional en menores de 5 anos,clasificacion a y b,2002-03-01,2,3,2,3,5
60401,URIONDO (A. CONCEPCION),estado nutricional en menores de 5 anos,clasificacion a y b,2002-03-01,34,45,34,45,79
51201,UYUNI,estado nutricional en menores de 5 anos,clasificacion a y b,2002-03-01,11,17,11,17,28
30502,VACAS,estado nutricional en menores de 5 anos,clasificacion a y b,2002-03-01,3,1,3,1,4
70801,VALLEGRANDE,estado nutricional en menores de 5 anos,clasificacion a y b,2002-03-01,35,20,35,20,55
20801,VIACHA,estado nutricional en menores de 5 anos,clasificacion a y b,2002-03-01,17,51,17,51,68
31302,VILA VILA,estado nutricional en menores de 5 anos,clasificacion a y b,2002-03-01,2,8,2,8,10
60303,VILLA MONTES,estado nutricional en menores de 5 anos,clasificacion a y b,2002-03-01,25,28,25,28,53
90502,VILLA NUEVA (LOMA ALTA),estado nutricional en menores de 5 anos,clasificacion a y b,2002-03-01,1,0,1,0,1
31402,VILLA RIVERO,estado nutricional en menores de 5 anos,clasificacion a y b,2002-03-01,0,7,0,7,7
10801,VILLA SERRANO,estado nutricional en menores de 5 anos,clasificacion a y b,2002-03-01,21,5,21,5,26
31003,VILLA TUNARI,estado nutricional en menores de 5 anos,clasificacion a y b,2002-03-01,42,50,42,50,92
11001,VILLA VACA GUZMAN (MUYUPAMPA),estado nutricional en menores de 5 anos,clasificacion a y b,2002-03-01,69,18,69,18,87
51501,VILLAZON,estado nutricional en menores de 5 anos,clasificacion a y b,2002-03-01,17,71,17,71,88
30904,VINTO,estado nutricional en menores de 5 anos,clasificacion a y b,2002-03-01,45,5,45,5,50
50602,VITICHI,estado nutricional en menores de 5 anos,clasificacion a y b,2002-03-01,12,21,12,21,33
70201,WARNES,estado nutricional en menores de 5 anos,clasificacion a y b,2002-03-01,83,53,83,53,136
20903,YACO,estado nutricional en menores de 5 anos,clasificacion a y b,2002-03-01,3,5,3,5,8
60301,YACUIBA,estado nutricional en menores de 5 anos,clasificacion a y b,2002-03-01,120,47,120,47,167
10602,YAMPARAEZ,estado nutricional en menores de 5 anos,clasificacion a y b,2002-03-01,43,12,43,12,55
21103,YANACACHI,estado nutricional en menores de 5 anos,clasificacion a y b,2002-03-01,13,16,13,16,29
70403,YAPACANI,estado nutricional en menores de 5 anos,clasificacion a y b,2002-03-01,55,33,55,33,88
50103,YOCALLA,estado nutricional en menores de 5 anos,clasificacion a y b,2002-03-01,2,2,2,2,4
10102,YOTALA,estado nutricional en menores de 5 anos,clasificacion a y b,2002-03-01,42,4,42,4,46
60402,YUNCHARA,estado nutricional en menores de 5 anos,clasificacion a y b,2002-03-01,11,7,11,7,18
10301,ZUDAÑEZ,estado nutricional en menores de 5 anos,clasificacion a y b,2002-03-01,19,8,19,8,27
51302,ACACIO,estado nutricional en menores de 5 anos,clasificacion a y b,2002-04-01,2,1,2,1,3
20201,ACHACACHI,estado nutricional en menores de 5 anos,clasificacion a y b,2002-04-01,73,46,73,46,119
20104,ACHOCALLA,estado nutricional en menores de 5 anos,clasificacion a y b,2002-04-01,21,2,21,2,23
30201,AIQUILE,estado nutricional en menores de 5 anos,clasificacion a y b,2002-04-01,0,4,0,4,4
31303,ALALAY,estado nutricional en menores de 5 anos,clasificacion a y b,2002-04-01,0,1,0,1,1
10404,ALCALA,estado nutricional en menores de 5 anos,clasificacion a y b,2002-04-01,15,2,15,2,17
20202,ANCORAIMES,estado nutricional en menores de 5 anos,clasificacion a y b,2002-04-01,13,4,13,4,17
40603,ANTEQUERA,estado nutricional en menores de 5 anos,clasificacion a y b,2002-04-01,0,13,0,13,13
30402,ANZALDO,estado nutricional en menores de 5 anos,clasificacion a y b,2002-04-01,4,9,4,9,13
20701,APOLO,estado nutricional en menores de 5 anos,clasificacion a y b,2002-04-01,19,1,19,1,20
51301,ARAMPAMPA,estado nutricional en menores de 5 anos,clasificacion a y b,2002-04-01,2,3,2,3,5
30501,ARANI,estado nutricional en menores de 5 anos,clasificacion a y b,2002-04-01,7,5,7,5,12
30403,ARBIETO,estado nutricional en menores de 5 anos,clasificacion a y b,2002-04-01,7,12,7,12,19
30601,ARQUE,estado nutricional en menores de 5 anos,clasificacion a y b,2002-04-01,3,0,3,0,3
71501,ASCENCION DE GUARAYOS,estado nutricional en menores de 5 anos,clasificacion a y b,2002-04-01,48,29,48,29,77
50802,ATOCHA,estado nutricional en menores de 5 anos,clasificacion a y b,2002-04-01,2,14,2,14,16
20503,AUCAPATA,estado nutricional en menores de 5 anos,clasificacion a y b,2002-04-01,7,0,7,0,7
20502,AYATA,estado nutricional en menores de 5 anos,clasificacion a y b,2002-04-01,0,1,0,1,1
21303,AYO AYO,estado nutricional en menores de 5 anos,clasificacion a y b,2002-04-01,18,8,18,8,26
30301,AYOPAYA (V. DE INDEPENDENCIA),estado nutricional en menores de 5 anos,clasificacion a y b,2002-04-01,19,8,19,8,27
10201,AZURDUY,estado nutricional en menores de 5 anos,clasificacion a y b,2002-04-01,36,9,36,9,45
21203,BATALLAS,estado nutricional en menores de 5 anos,clasificacion a y b,2002-04-01,4,17,4,17,21
80802,BAURES,estado nutricional en menores de 5 anos,clasificacion a y b,2002-04-01,10,9,10,9,19
41202,BELEN DE ANDAMARCA,estado nutricional en menores de 5 anos,clasificacion a y b,2002-04-01,1,0,1,0,1
50104,BELEN DE URMIRI,estado nutricional en menores de 5 anos,clasificacion a y b,2002-04-01,2,2,2,2,4
90104,BELLA FLOR,estado nutricional en menores de 5 anos,clasificacion a y b,2002-04-01,3,3,3,3,6
60202,BERMEJO,estado nutricional en menores de 5 anos,clasificacion a y b,2002-04-01,21,36,21,36,57
50301,BETANZOS,estado nutricional en menores de 5 anos,clasificacion a y b,2002-04-01,10,14,10,14,24
31501,BOLIVAR,estado nutricional en menores de 5 anos,clasificacion a y b,2002-04-01,5,4,5,4,9
70707,BOYUIBE,estado nutricional en menores de 5 anos,clasificacion a y b,2002-04-01,0,14,0,14,14
70401,BUENA VISTA,estado nutricional en menores de 5 anos,clasificacion a y b,2002-04-01,60,26,60,26,86
70703,CABEZAS,estado nutricional en menores de 5 anos,clasificacion a y b,2002-04-01,2,24,2,24,26
20905,CAIROMA,estado nutricional en menores de 5 anos,clasificacion a y b,2002-04-01,2,25,2,25,27
51102,"CAIZA ""D""",estado nutricional en menores de 5 anos,clasificacion a y b,2002-04-01,16,6,16,6,22
21003,CAJUATA,estado nutricional en menores de 5 anos,clasificacion a y b,2002-04-01,14,0,14,0,14
20303,CALACOTO,estado nutricional en menores de 5 anos,clasificacion a y b,2002-04-01,1,5,1,5,6
21304,CALAMARCA,estado nutricional en menores de 5 anos,clasificacion a y b,2002-04-01,7,8,7,8,15
10701,CAMARGO,estado nutricional en menores de 5 anos,clasificacion a y b,2002-04-01,4,17,4,17,21
10901,CAMATAQUI (C. VILLA ABECIA),estado nutricional en menores de 5 anos,clasificacion a y b,2002-04-01,1,3,1,3,4
70706,CAMIRI,estado nutricional en menores de 5 anos,clasificacion a y b,2002-04-01,56,42,56,42,98
30701,CAPINOTA,estado nutricional en menores de 5 anos,clasificacion a y b,2002-04-01,7,4,7,4,11
20302,CAQUIAVIRI,estado nutricional en menores de 5 anos,clasificacion a y b,2002-04-01,30,17,30,17,47
40102,CARACOLLO,estado nutricional en menores de 5 anos,clasificacion a y b,2002-04-01,23,21,23,21,44
22001,CARANAVI,estado nutricional en menores de 5 anos,clasificacion a y b,2002-04-01,94,60,94,60,154
60302,CARAPARI,estado nutricional en menores de 5 anos,clasificacion a y b,2002-04-01,23,26,23,26,49
50702,CARIPUYO,estado nutricional en menores de 5 anos,clasificacion a y b,2002-04-01,8,4,8,4,12
21902,CATACORA,estado nutricional en menores de 5 anos,clasificacion a y b,2002-04-01,2,0,2,0,2
40201,CHALLAPATA,estado nutricional en menores de 5 anos,clasificacion a y b,2002-04-01,8,6,8,6,14
50302,CHAQUI,estado nutricional en menores de 5 anos,clasificacion a y b,2002-04-01,0,7,0,7,7
70702,CHARAGUA,estado nutricional en menores de 5 anos,clasificacion a y b,2002-04-01,20,115,20,115,135
31204,CHIMORE,estado nutricional en menores de 5 anos,clasificacion a y b,2002-04-01,10,10,10,10,20
40302,CHOQUE COTA,estado nutricional en menores de 5 anos,clasificacion a y b,2002-04-01,3,3,3,3,6
21101,CHULUMANI (V. DE LA LIBERTAD),estado nutricional en menores de 5 anos,clasificacion a y b,2002-04-01,8,8,8,8,16
20501,CHUMA,estado nutricional en menores de 5 anos,clasificacion a y b,2002-04-01,6,8,6,8,14
30801,CLIZA,estado nutricional en menores de 5 anos,clasificacion a y b,2002-04-01,4,24,4,24,28
90101,COBIJA,estado nutricional en menores de 5 anos,clasificacion a y b,2002-04-01,99,14,99,14,113
30101,COCHABAMBA,estado nutricional en menores de 5 anos,clasificacion a y b,2002-04-01,1676,1148,1676,1148,2824
30905,COLCAPIRHUA,estado nutricional en menores de 5 anos,clasificacion a y b,2002-04-01,37,12,37,12,49
50901,"COLCHA ""K""",estado nutricional en menores de 5 anos,clasificacion a y b,2002-04-01,1,11,1,11,12
31002,COLOMI,estado nutricional en menores de 5 anos,clasificacion a y b,2002-04-01,19,17,19,17,36
50401,COLQUECHACA,estado nutricional en menores de 5 anos,clasificacion a y b,2002-04-01,3,3,3,3,6
21306,COLQUENCHA,estado nutricional en menores de 5 anos,clasificacion a y b,2002-04-01,5,0,5,0,5
21004,COLQUIRI,estado nutricional en menores de 5 anos,clasificacion a y b,2002-04-01,16,9,16,9,25
20304,COMANCHE,estado nutricional en menores de 5 anos,clasificacion a y b,2002-04-01,2,0,2,0,2
71301,COMARAPA,estado nutricional en menores de 5 anos,clasificacion a y b,2002-04-01,6,15,6,15,21
20605,COMBAYA,estado nutricional en menores de 5 anos,clasificacion a y b,2002-04-01,1,1,1,1,2
71101,CONCEPCION,estado nutricional en menores de 5 anos,clasificacion a y b,2002-04-01,6,35,6,35,41
21701,COPACABANA,estado nutricional en menores de 5 anos,clasificacion a y b,2002-04-01,4,7,4,7,11
21402,CORIPATA,estado nutricional en menores de 5 anos,clasificacion a y b,2002-04-01,13,19,13,19,32
20301,CORO CORO,estado nutricional en menores de 5 anos,clasificacion a y b,2002-04-01,9,6,9,6,15
21401,COROICO,estado nutricional en menores de 5 anos,clasificacion a y b,2002-04-01,3,5,3,5,8
40301,CORQUE,estado nutricional en menores de 5 anos,clasificacion a y b,2002-04-01,2,1,2,1,3
50601,COTAGAITA,estado nutricional en menores de 5 anos,clasificacion a y b,2002-04-01,9,16,9,16,25
70102,COTOCA,estado nutricional en menores de 5 anos,clasificacion a y b,2002-04-01,103,56,103,56,159
31405,CUCHUMUELA (V. G. VILLARROEL),estado nutricional en menores de 5 anos,clasificacion a y b,2002-04-01,0,6,0,6,6
70704,CUEVO,estado nutricional en menores de 5 anos,clasificacion a y b,2002-04-01,32,1,32,1,33
10902,CULPINA,estado nutricional en menores de 5 anos,clasificacion a y b,2002-04-01,26,4,26,4,30
40401,CURAHUARA DE CARANGAS,estado nutricional en menores de 5 anos,clasificacion a y b,2002-04-01,9,1,9,1,10
20804,DESAGUADERO,estado nutricional en menores de 5 anos,clasificacion a y b,2002-04-01,0,7,0,7,7
20105,EL ALTO,estado nutricional en menores de 5 anos,clasificacion a y b,2002-04-01,526,329,526,329,855
40103,EL CHORO,estado nutricional en menores de 5 anos,clasificacion a y b,2002-04-01,1,0,1,0,1
71503,EL PUENTE(STC),estado nutricional en menores de 5 anos,clasificacion a y b,2002-04-01,27,41,27,41,68
60502,EL PUENTE(TJA),estado nutricional en menores de 5 anos,clasificacion a y b,2002-04-01,4,5,4,5,9
70105,EL TORNO,estado nutricional en menores de 5 anos,clasificacion a y b,2002-04-01,122,14,122,14,136
10405,EL VILLAR,estado nutricional en menores de 5 anos,clasificacion a y b,2002-04-01,14,4,14,4,18
60601,ENTRE RIOS,estado nutricional en menores de 5 anos,clasificacion a y b,2002-04-01,36,19,36,19,55
41101,EUCALIPTUS,estado nutricional en menores de 5 anos,clasificacion a y b,2002-04-01,2,8,2,8,10
80402,EXALTACION,estado nutricional en menores de 5 anos,clasificacion a y b,2002-04-01,1,4,1,4,5
90203,FILADELFIA,estado nutricional en menores de 5 anos,clasificacion a y b,2002-04-01,2,5,2,5,7
21601,GRAL. J.J. PEREZ (CHARAZANI),estado nutricional en menores de 5 anos,clasificacion a y b,2002-04-01,4,0,4,0,4
20602,GUANAY,estado nutricional en menores de 5 anos,clasificacion a y b,2002-04-01,18,56,18,56,74
80202,GUAYARAMERIN,estado nutricional en menores de 5 anos,clasificacion a y b,2002-04-01,113,26,113,26,139
70705,GUTIERREZ,estado nutricional en menores de 5 anos,clasificacion a y b,2002-04-01,20,47,20,47,67
10502,HUACARETA,estado nutricional en menores de 5 anos,clasificacion a y b,2002-04-01,39,13,39,13,52
11002,HUACAYA (VILLA DE HUACAYA),estado nutricional en menores de 5 anos,clasificacion a y b,2002-04-01,11,4,11,4,15
40501,HUACHACALLA,estado nutricional en menores de 5 anos,clasificacion a y b,2002-04-01,0,2,0,2,2
40701,HUANUNI,estado nutricional en menores de 5 anos,clasificacion a y b,2002-04-01,2,1,2,1,3
80803,HUARACAJE,estado nutricional en menores de 5 anos,clasificacion a y b,2002-04-01,12,9,12,9,21
10304,ICLA,estado nutricional en menores de 5 anos,clasificacion a y b,2002-04-01,8,2,8,2,10
10703,INCAHUASI,estado nutricional en menores de 5 anos,clasificacion a y b,2002-04-01,18,42,18,42,60
21001,INQUISIVI,estado nutricional en menores de 5 anos,clasificacion a y b,2002-04-01,1,1,1,1,2
21102,IRUPANA (VILLA DE LANZA),estado nutricional en menores de 5 anos,clasificacion a y b,2002-04-01,14,13,14,13,27
21501,IXIAMAS,estado nutricional en menores de 5 anos,clasificacion a y b,2002-04-01,21,6,21,6,27
21105,LA ASUNTA,estado nutricional en menores de 5 anos,clasificacion a y b,2002-04-01,26,14,26,14,40
70104,LA GUARDIA,estado nutricional en menores de 5 anos,clasificacion a y b,2002-04-01,142,26,142,26,168
20101,LA PAZ,estado nutricional en menores de 5 anos,clasificacion a y b,2002-04-01,504,271,504,271,775
70701,LAGUNILLAS,estado nutricional en menores de 5 anos,clasificacion a y b,2002-04-01,10,28,10,28,38
21202,LAJA,estado nutricional en menores de 5 anos,clasificacion a y b,2002-04-01,2,10,2,10,12
10903,LAS CARRERAS,estado nutricional en menores de 5 anos,clasificacion a y b,2002-04-01,4,10,4,10,14
21006,LICOMA PAMPA,estado nutricional en menores de 5 anos,clasificacion a y b,2002-04-01,0,4,0,4,4
51401,LLICA,estado nutricional en menores de 5 anos,clasificacion a y b,2002-04-01,1,4,1,4,5
80601,LORETO,estado nutricional en menores de 5 anos,clasificacion a y b,2002-04-01,5,4,5,4,9
20901,LURIBAY,estado nutricional en menores de 5 anos,clasificacion a y b,2002-04-01,4,8,4,8,12
40702,MACHACAMARCA,estado nutricional en menores de 5 anos,clasificacion a y b,2002-04-01,4,3,4,3,7
11003,MACHARETI,estado nutricional en menores de 5 anos,clasificacion a y b,2002-04-01,23,20,23,20,43
80801,MAGDALENA,estado nutricional en menores de 5 anos,clasificacion a y b,2002-04-01,6,9,6,9,15
70903,MAIRANA,estado nutricional en menores de 5 anos,clasificacion a y b,2002-04-01,34,6,34,6,40
20904,MALLA,estado nutricional en menores de 5 anos,clasificacion a y b,2002-04-01,0,1,0,1,1
20103,MECAPACA,estado nutricional en menores de 5 anos,clasificacion a y b,2002-04-01,15,3,15,3,18
71003,MINEROS,estado nutricional en menores de 5 anos,clasificacion a y b,2002-04-01,26,7,26,7,33
31301,MIZQUE,estado nutricional en menores de 5 anos,clasificacion a y b,2002-04-01,14,6,14,6,20
20402,MOCOMOCO,estado nutricional en menores de 5 anos,clasificacion a y b,2002-04-01,23,6,23,6,29
10303,MOJOCOYA,estado nutricional en menores de 5 anos,clasificacion a y b,2002-04-01,27,14,27,14,41
10501,MONTEAGUDO,estado nutricional en menores de 5 anos,clasificacion a y b,2002-04-01,97,28,97,28,125
71001,MONTERO,estado nutricional en menores de 5 anos,clasificacion a y b,2002-04-01,0,17,0,17,17
70803,MORO MORO,estado nutricional en menores de 5 anos,clasificacion a y b,2002-04-01,5,2,5,2,7
30302,MOROCHATA,estado nutricional en menores de 5 anos,clasificacion a y b,2002-04-01,10,10,10,10,20
90401,NACEBE (SANTA ROSA DEL ABUNA),estado nutricional en menores de 5 anos,clasificacion a y b,2002-04-01,1,8,1,8,9
20307,NAZACARA DE PACAJES,estado nutricional en menores de 5 anos,clasificacion a y b,2002-04-01,0,2,0,2,2
90501,NUEVO MANOA (NUEVA ESPERANZA),estado nutricional en menores de 5 anos,clasificacion a y b,2002-04-01,5,3,5,3,8
50404,OCURI,estado nutricional en menores de 5 anos,clasificacion a y b,2002-04-01,6,3,6,3,9
70202,OKINAWA,estado nutricional en menores de 5 anos,clasificacion a y b,2002-04-01,15,7,15,7,22
30203,OMEREQUE,estado nutricional en menores de 5 anos,clasificacion a y b,2002-04-01,2,24,2,24,26
40101,ORURO,estado nutricional en menores de 5 anos,clasificacion a y b,2002-04-01,260,76,260,76,336
60201,PADCAYA,estado nutricional en menores de 5 anos,clasificacion a y b,2002-04-01,30,28,30,28,58
10401,PADILLA,estado nutricional en menores de 5 anos,clasificacion a y b,2002-04-01,49,7,49,7,56
70502,PAILON,estado nutricional en menores de 5 anos,clasificacion a y b,2002-04-01,14,53,14,53,67
20102,PALCA,estado nutricional en menores de 5 anos,clasificacion a y b,2002-04-01,10,0,10,0,10
21104,PALOS BLANCOS,estado nutricional en menores de 5 anos,clasificacion a y b,2002-04-01,31,29,31,29,60
40802,PAMPA AULLAGAS,estado nutricional en menores de 5 anos,clasificacion a y b,2002-04-01,1,5,1,5,6
70902,PAMPA GRANDE,estado nutricional en menores de 5 anos,clasificacion a y b,2002-04-01,33,9,33,9,42
21802,PAPEL PAMPA,estado nutricional en menores de 5 anos,clasificacion a y b,2002-04-01,1,3,1,3,4
30202,PASORAPA,estado nutricional en menores de 5 anos,clasificacion a y b,2002-04-01,10,5,10,5,15
21305,PATACAMAYA,estado nutricional en menores de 5 anos,clasificacion a y b,2002-04-01,24,2,24,2,26
40602,PAZÑA,estado nutricional en menores de 5 anos,clasificacion a y b,2002-04-01,0,2,0,2,2
20702,PELECHUCO,estado nutricional en menores de 5 anos,clasificacion a y b,2002-04-01,2,0,2,0,2
50403,POCOATA,estado nutricional en menores de 5 anos,clasificacion a y b,2002-04-01,13,6,13,6,19
31203,POCONA,estado nutricional en menores de 5 anos,clasificacion a y b,2002-04-01,22,3,22,3,25
31202,POJO (CBBA),estado nutricional en menores de 5 anos,clasificacion a y b,2002-04-01,105,29,105,29,134
40601,POOPO,estado nutricional en menores de 5 anos,clasificacion a y b,2002-04-01,0,1,0,1,1
51203,PORCO,estado nutricional en menores de 5 anos,clasificacion a y b,2002-04-01,9,8,9,8,17
10103,POROMA,estado nutricional en menores de 5 anos,clasificacion a y b,2002-04-01,21,10,21,10,31
70103,PORONGO,estado nutricional en menores de 5 anos,clasificacion a y b,2002-04-01,21,11,21,11,32
70601,PORTACHUELO,estado nutricional en menores de 5 anos,clasificacion a y b,2002-04-01,83,28,83,28,111
90102,PORVENIR,estado nutricional en menores de 5 anos,clasificacion a y b,2002-04-01,1,2,1,2,3
50101,POTOSI,estado nutricional en menores de 5 anos,clasificacion a y b,2002-04-01,125,34,125,34,159
10302,PRESTO,estado nutricional en menores de 5 anos,clasificacion a y b,2002-04-01,13,3,13,3,16
21201,PUCARANI,estado nutricional en menores de 5 anos,clasificacion a y b,2002-04-01,2,18,2,18,20
20401,PUERTO ACOSTA,estado nutricional en menores de 5 anos,clasificacion a y b,2002-04-01,25,24,25,24,49
20403,PUERTO CARABUCO,estado nutricional en menores de 5 anos,clasificacion a y b,2002-04-01,23,5,23,5,28
90301,PUERTO GONZALO MORENO,estado nutricional en menores de 5 anos,clasificacion a y b,2002-04-01,0,1,0,1,1
21204,PUERTO PEREZ,estado nutricional en menores de 5 anos,clasificacion a y b,2002-04-01,2,7,2,7,9
71402,PUERTO QUIJARRO,estado nutricional en menores de 5 anos,clasificacion a y b,2002-04-01,54,16,54,16,70
80703,PUERTO SILES,estado nutricional en menores de 5 anos,clasificacion a y b,2002-04-01,0,1,0,1,1
71401,PUERTO SUAREZ,estado nutricional en menores de 5 anos,clasificacion a y b,2002-04-01,20,4,20,4,24
31205,PUERTO VILLARROEL,estado nutricional en menores de 5 anos,clasificacion a y b,2002-04-01,114,37,114,37,151
51101,PUNA,estado nutricional en menores de 5 anos,clasificacion a y b,2002-04-01,31,23,31,23,54
31401,PUNATA,estado nutricional en menores de 5 anos,clasificacion a y b,2002-04-01,4,29,4,29,33
20604,QUIABAYA,estado nutricional en menores de 5 anos,clasificacion a y b,2002-04-01,3,0,3,0,3
30901,QUILLACOLLO,estado nutricional en menores de 5 anos,clasificacion a y b,2002-04-01,22,40,22,40,62
21002,QUIME,estado nutricional en menores de 5 anos,clasificacion a y b,2002-04-01,5,15,5,15,20
50402,RAVELO,estado nutricional en menores de 5 anos,clasificacion a y b,2002-04-01,6,2,6,2,8
80301,REYES,estado nutricional en menores de 5 anos,clasificacion a y b,2002-04-01,38,5,38,5,43
80201,RIBERALTA,estado nutricional en menores de 5 anos,clasificacion a y b,2002-04-01,177,25,177,25,202
70503,ROBORE,estado nutricional en menores de 5 anos,clasificacion a y b,2002-04-01,23,26,23,26,49
80304,RURRENABAQUE,estado nutricional en menores de 5 anos,clasificacion a y b,2002-04-01,31,31,31,31,62
40901,SABAYA,estado nutricional en menores de 5 anos,clasificacion a y b,2002-04-01,0,2,0,2,2
31001,SACABA,estado nutricional en menores de 5 anos,clasificacion a y b,2002-04-01,37,2,37,2,39
30404,SACABAMBA,estado nutricional en menores de 5 anos,clasificacion a y b,2002-04-01,1,0,1,0,1
50701,SACACA,estado nutricional en menores de 5 anos,clasificacion a y b,2002-04-01,6,1,6,1,7
71302,SAIPINA,estado nutricional en menores de 5 anos,clasificacion a y b,2002-04-01,32,20,32,20,52
40801,SALINAS DE GARCI MENDOZA,estado nutricional en menores de 5 anos,clasificacion a y b,2002-04-01,9,2,9,2,11
70901,SAMAIPATA,estado nutricional en menores de 5 anos,clasificacion a y b,2002-04-01,6,4,6,4,10
51601,SAN AGUSTIN,estado nutricional en menores de 5 anos,clasificacion a y b,2002-04-01,2,1,2,1,3
80602,SAN ANDRES,estado nutricional en menores de 5 anos,clasificacion a y b,2002-04-01,12,7,12,7,19
51003,SAN ANTONIO DE ESMORUCO,estado nutricional en menores de 5 anos,clasificacion a y b,2002-04-01,0,2,0,2,2
71105,SAN ANTONIO DE LOMERIO,estado nutricional en menores de 5 anos,clasificacion a y b,2002-04-01,26,3,26,3,29
31403,SAN BENITO,estado nutricional en menores de 5 anos,clasificacion a y b,2002-04-01,1,13,1,13,14
80302,SAN BORJA,estado nutricional en menores de 5 anos,clasificacion a y b,2002-04-01,114,21,114,21,135
21502,SAN BUENA VENTURA,estado nutricional en menores de 5 anos,clasificacion a y b,2002-04-01,24,8,24,8,32
70402,SAN CARLOS,estado nutricional en menores de 5 anos,clasificacion a y b,2002-04-01,31,6,31,6,37
80501,SAN IGNACIO,estado nutricional en menores de 5 anos,clasificacion a y b,2002-04-01,26,45,26,45,71
70301,SAN IGNACIO DE VELASCO,estado nutricional en menores de 5 anos,clasificacion a y b,2002-04-01,154,21,154,21,175
80102,SAN JAVIER(BNI),estado nutricional en menores de 5 anos,clasificacion a y b,2002-04-01,3,6,3,6,9
71102,SAN JAVIER(STC),estado nutricional en menores de 5 anos,clasificacion a y b,2002-04-01,29,2,29,2,31
80701,SAN JOAQUIN,estado nutricional en menores de 5 anos,clasificacion a y b,2002-04-01,12,19,12,19,31
70501,SAN JOSE DE CHIQUITOS,estado nutricional en menores de 5 anos,clasificacion a y b,2002-04-01,9,5,9,5,14
71104,SAN JULIAN,estado nutricional en menores de 5 anos,clasificacion a y b,2002-04-01,80,148,80,148,228
60501,SAN LORENZO(TJA),estado nutricional en menores de 5 anos,clasificacion a y b,2002-04-01,4,2,4,2,6
10702,SAN LUCAS,estado nutricional en menores de 5 anos,clasificacion a y b,2002-04-01,30,33,30,33,63
71201,SAN MATIAS,estado nutricional en menores de 5 anos,clasificacion a y b,2002-04-01,26,12,26,12,38
70302,SAN MIGUEL DE VELASCO,estado nutricional en menores de 5 anos,clasificacion a y b,2002-04-01,24,10,24,10,34
51001,SAN PABLO DE LIPEZ,estado nutricional en menores de 5 anos,clasificacion a y b,2002-04-01,0,1,0,1,1
50501,SAN PEDRO DE BUENA VISTA,estado nutricional en menores de 5 anos,clasificacion a y b,2002-04-01,3,12,3,12,15
21801,SAN PEDRO DE CURAHUARA,estado nutricional en menores de 5 anos,clasificacion a y b,2002-04-01,0,3,0,3,3
50902,SAN PEDRO DE QUEMES,estado nutricional en menores de 5 anos,clasificacion a y b,2002-04-01,0,4,0,4,4
21702,SAN PEDRO DE TIQUINA,estado nutricional en menores de 5 anos,clasificacion a y b,2002-04-01,4,11,4,11,15
90202,SAN PEDRO(PND),estado nutricional en menores de 5 anos,clasificacion a y b,2002-04-01,1,0,1,0,1
70303,SAN RAFAEL,estado nutricional en menores de 5 anos,clasificacion a y b,2002-04-01,4,2,4,2,6
80702,SAN RAMON,estado nutricional en menores de 5 anos,clasificacion a y b,2002-04-01,28,4,28,4,32
80702,SAN RAMON,estado nutricional en menores de 5 anos,clasificacion a y b,2002-04-01,47,72,47,72,119
80401,SANTA ANA,estado nutricional en menores de 5 anos,clasificacion a y b,2002-04-01,15,9,15,9,24
70101,SANTA CRUZ DE LA SIERRA,estado nutricional en menores de 5 anos,clasificacion a y b,2002-04-01,659,550,659,550,1209
80303,SANTA ROSA,estado nutricional en menores de 5 anos,clasificacion a y b,2002-04-01,5,0,5,0,5
70602,SANTA ROSA DEL SARA,estado nutricional en menores de 5 anos,clasificacion a y b,2002-04-01,4,3,4,3,7
20308,SANTIAGO DE CALLAPA,estado nutricional en menores de 5 anos,clasificacion a y b,2002-04-01,4,3,4,3,7
41401,SANTIAGO DE HUARI,estado nutricional en menores de 5 anos,clasificacion a y b,2002-04-01,3,2,3,2,5
21901,SANTIAGO DE MACHACA,estado nutricional en menores de 5 anos,clasificacion a y b,2002-04-01,8,3,8,3,11
30702,SANTIVAÑES,estado nutricional en menores de 5 anos,clasificacion a y b,2002-04-01,3,0,3,0,3
20902,SAPAHAQUI,estado nutricional en menores de 5 anos,clasificacion a y b,2002-04-01,1,4,1,4,5
21301,SICA SICA (VILLA AROMA),estado nutricional en menores de 5 anos,clasificacion a y b,2002-04-01,27,1,27,1,28
30703,SICAYA,estado nutricional en menores de 5 anos,clasificacion a y b,2002-04-01,0,3,0,3,3
30902,SIPE SIPE,estado nutricional en menores de 5 anos,clasificacion a y b,2002-04-01,113,35,113,35,148
10403,SOPACHUY,estado nutricional en menores de 5 anos,clasificacion a y b,2002-04-01,22,1,22,1,23
20601,SORATA,estado nutricional en menores de 5 anos,clasificacion a y b,2002-04-01,9,9,9,9,18
10101,SUCRE,estado nutricional en menores de 5 anos,clasificacion a y b,2002-04-01,260,98,260,98,358
20603,TACACOMA,estado nutricional en menores de 5 anos,clasificacion a y b,2002-04-01,4,26,4,26,30
50303,TACOBAMBA,estado nutricional en menores de 5 anos,clasificacion a y b,2002-04-01,13,2,13,2,15
30602,TACOPAYA,estado nutricional en menores de 5 anos,clasificacion a y b,2002-04-01,2,2,2,2,4
31101,TAPACARI,estado nutricional en menores de 5 anos,clasificacion a y b,2002-04-01,4,18,4,18,22
10601,TARABUCO,estado nutricional en menores de 5 anos,clasificacion a y b,2002-04-01,32,43,32,43,75
30401,TARATA,estado nutricional en menores de 5 anos,clasificacion a y b,2002-04-01,7,12,7,12,19
60101,TARIJA,estado nutricional en menores de 5 anos,clasificacion a y b,2002-04-01,177,169,177,169,346
10202,TARVITA,estado nutricional en menores de 5 anos,clasificacion a y b,2002-04-01,13,4,13,4,17
20803,TIAWANACU,estado nutricional en menores de 5 anos,clasificacion a y b,2002-04-01,20,12,20,12,32
50102,TINGUIPAYA,estado nutricional en menores de 5 anos,clasificacion a y b,2002-04-01,5,0,5,0,5
20606,TIPUANI,estado nutricional en menores de 5 anos,clasificacion a y b,2002-04-01,14,2,14,2,16
30903,TIQUIPAYA,estado nutricional en menores de 5 anos,clasificacion a y b,2002-04-01,3,13,3,13,16
31601,TIRAQUE (CBBA),estado nutricional en menores de 5 anos,clasificacion a y b,2002-04-01,63,60,63,60,123
21703,TITO YUPANQUI (PARQUIPUJIO),estado nutricional en menores de 5 anos,clasificacion a y b,2002-04-01,1,0,1,0,1
30802,TOCO,estado nutricional en menores de 5 anos,clasificacion a y b,2002-04-01,5,1,5,1,6
41001,TOLEDO,estado nutricional en menores de 5 anos,clasificacion a y b,2002-04-01,6,0,6,0,6
51202,TOMAVE,estado nutricional en menores de 5 anos,clasificacion a y b,2002-04-01,4,11,4,11,15
10402,TOMINA,estado nutricional en menores de 5 anos,clasificacion a y b,2002-04-01,38,3,38,3,41
31201,TOTORA(CBBA),estado nutricional en menores de 5 anos,clasificacion a y b,2002-04-01,18,12,18,12,30
41301,TOTORA(ORR),estado nutricional en menores de 5 anos,clasificacion a y b,2002-04-01,1,5,1,5,6
70802,TRIGAL,estado nutricional en menores de 5 anos,clasificacion a y b,2002-04-01,1,1,1,1,2
80101,TRINIDAD,estado nutricional en menores de 5 anos,clasificacion a y b,2002-04-01,147,124,147,124,271
50801,TUPIZA,estado nutricional en menores de 5 anos,clasificacion a y b,2002-04-01,7,51,7,51,58
40402,TURCO,estado nutricional en menores de 5 anos,clasificacion a y b,2002-04-01,9,0,9,0,9
21302,UMALA,estado nutricional en menores de 5 anos,clasificacion a y b,2002-04-01,3,1,3,1,4
60401,URIONDO (A. CONCEPCION),estado nutricional en menores de 5 anos,clasificacion a y b,2002-04-01,18,53,18,53,71
71502,URUBICHA,estado nutricional en menores de 5 anos,clasificacion a y b,2002-04-01,4,5,4,5,9
51201,UYUNI,estado nutricional en menores de 5 anos,clasificacion a y b,2002-04-01,12,50,12,50,62
70801,VALLEGRANDE,estado nutricional en menores de 5 anos,clasificacion a y b,2002-04-01,41,16,41,16,57
20801,VIACHA,estado nutricional en menores de 5 anos,clasificacion a y b,2002-04-01,32,58,32,58,90
31302,VILA VILA,estado nutricional en menores de 5 anos,clasificacion a y b,2002-04-01,3,5,3,5,8
60303,VILLA MONTES,estado nutricional en menores de 5 anos,clasificacion a y b,2002-04-01,33,20,33,20,53
90502,VILLA NUEVA (LOMA ALTA),estado nutricional en menores de 5 anos,clasificacion a y b,2002-04-01,2,0,2,0,2
31402,VILLA RIVERO,estado nutricional en menores de 5 anos,clasificacion a y b,2002-04-01,7,15,7,15,22
10801,VILLA SERRANO,estado nutricional en menores de 5 anos,clasificacion a y b,2002-04-01,18,31,18,31,49
31003,VILLA TUNARI,estado nutricional en menores de 5 anos,clasificacion a y b,2002-04-01,88,33,88,33,121
11001,VILLA VACA GUZMAN (MUYUPAMPA),estado nutricional en menores de 5 anos,clasificacion a y b,2002-04-01,51,11,51,11,62
51501,VILLAZON,estado nutricional en menores de 5 anos,clasificacion a y b,2002-04-01,32,52,32,52,84
30904,VINTO,estado nutricional en menores de 5 anos,clasificacion a y b,2002-04-01,83,5,83,5,88
50602,VITICHI,estado nutricional en menores de 5 anos,clasificacion a y b,2002-04-01,24,11,24,11,35
70201,WARNES,estado nutricional en menores de 5 anos,clasificacion a y b,2002-04-01,57,46,57,46,103
20903,YACO,estado nutricional en menores de 5 anos,clasificacion a y b,2002-04-01,3,15,3,15,18
60301,YACUIBA,estado nutricional en menores de 5 anos,clasificacion a y b,2002-04-01,131,48,131,48,179
10602,YAMPARAEZ,estado nutricional en menores de 5 anos,clasificacion a y b,2002-04-01,27,7,27,7,34
21103,YANACACHI,estado nutricional en menores de 5 anos,clasificacion a y b,2002-04-01,9,8,9,8,17
70403,YAPACANI,estado nutricional en menores de 5 anos,clasificacion a y b,2002-04-01,57,43,57,43,100
50103,YOCALLA,estado nutricional en menores de 5 anos,clasificacion a y b,2002-04-01,2,7,2,7,9
10102,YOTALA,estado nutricional en menores de 5 anos,clasificacion a y b,2002-04-01,31,16,31,16,47
60402,YUNCHARA,estado nutricional en menores de 5 anos,clasificacion a y b,2002-04-01,8,10,8,10,18
10301,ZUDAÑEZ,estado nutricional en menores de 5 anos,clasificacion a y b,2002-04-01,15,5,15,5,20
51302,ACACIO,estado nutricional en menores de 5 anos,clasificacion a y b,2002-05-01,4,2,4,2,6
20201,ACHACACHI,estado nutricional en menores de 5 anos,clasificacion a y b,2002-05-01,60,33,60,33,93
20104,ACHOCALLA,estado nutricional en menores de 5 anos,clasificacion a y b,2002-05-01,18,0,18,0,18
30201,AIQUILE,estado nutricional en menores de 5 anos,clasificacion a y b,2002-05-01,4,0,4,0,4
31303,ALALAY,estado nutricional en menores de 5 anos,clasificacion a y b,2002-05-01,0,1,0,1,1
10404,ALCALA,estado nutricional en menores de 5 anos,clasificacion a y b,2002-05-01,13,2,13,2,15
20202,ANCORAIMES,estado nutricional en menores de 5 anos,clasificacion a y b,2002-05-01,21,9,21,9,30
41201,ANDAMARCA,estado nutricional en menores de 5 anos,clasificacion a y b,2002-05-01,1,0,1,0,1
40603,ANTEQUERA,estado nutricional en menores de 5 anos,clasificacion a y b,2002-05-01,6,20,6,20,26
30402,ANZALDO,estado nutricional en menores de 5 anos,clasificacion a y b,2002-05-01,7,2,7,2,9
20701,APOLO,estado nutricional en menores de 5 anos,clasificacion a y b,2002-05-01,25,3,25,3,28
51301,ARAMPAMPA,estado nutricional en menores de 5 anos,clasificacion a y b,2002-05-01,1,1,1,1,2
30501,ARANI,estado nutricional en menores de 5 anos,clasificacion a y b,2002-05-01,2,10,2,10,12
30403,ARBIETO,estado nutricional en menores de 5 anos,clasificacion a y b,2002-05-01,3,5,3,5,8
30601,ARQUE,estado nutricional en menores de 5 anos,clasificacion a y b,2002-05-01,5,2,5,2,7
71501,ASCENCION DE GUARAYOS,estado nutricional en menores de 5 anos,clasificacion a y b,2002-05-01,1,0,1,0,1
50802,ATOCHA,estado nutricional en menores de 5 anos,clasificacion a y b,2002-05-01,4,12,4,12,16
21303,AYO AYO,estado nutricional en menores de 5 anos,clasificacion a y b,2002-05-01,19,2,19,2,21
30301,AYOPAYA (V. DE INDEPENDENCIA),estado nutricional en menores de 5 anos,clasificacion a y b,2002-05-01,19,7,19,7,26
10201,AZURDUY,estado nutricional en menores de 5 anos,clasificacion a y b,2002-05-01,28,2,28,2,30
21203,BATALLAS,estado nutricional en menores de 5 anos,clasificacion a y b,2002-05-01,10,36,10,36,46
80802,BAURES,estado nutricional en menores de 5 anos,clasificacion a y b,2002-05-01,4,2,4,2,6
50104,BELEN DE URMIRI,estado nutricional en menores de 5 anos,clasificacion a y b,2002-05-01,2,10,2,10,12
60202,BERMEJO,estado nutricional en menores de 5 anos,clasificacion a y b,2002-05-01,13,53,13,53,66
50301,BETANZOS,estado nutricional en menores de 5 anos,clasificacion a y b,2002-05-01,24,70,24,70,94
31501,BOLIVAR,estado nutricional en menores de 5 anos,clasificacion a y b,2002-05-01,0,2,0,2,2
70707,BOYUIBE,estado nutricional en menores de 5 anos,clasificacion a y b,2002-05-01,3,23,3,23,26
70401,BUENA VISTA,estado nutricional en menores de 5 anos,clasificacion a y b,2002-05-01,90,17,90,17,107
70703,CABEZAS,estado nutricional en menores de 5 anos,clasificacion a y b,2002-05-01,1,3,1,3,4
20905,CAIROMA,estado nutricional en menores de 5 anos,clasificacion a y b,2002-05-01,1,9,1,9,10
51102,"CAIZA ""D""",estado nutricional en menores de 5 anos,clasificacion a y b,2002-05-01,17,11,17,11,28
21003,CAJUATA,estado nutricional en menores de 5 anos,clasificacion a y b,2002-05-01,13,10,13,10,23
20303,CALACOTO,estado nutricional en menores de 5 anos,clasificacion a y b,2002-05-01,1,0,1,0,1
21304,CALAMARCA,estado nutricional en menores de 5 anos,clasificacion a y b,2002-05-01,18,2,18,2,20
10701,CAMARGO,estado nutricional en menores de 5 anos,clasificacion a y b,2002-05-01,27,14,27,14,41
10901,CAMATAQUI (C. VILLA ABECIA),estado nutricional en menores de 5 anos,clasificacion a y b,2002-05-01,11,1,11,1,12
70706,CAMIRI,estado nutricional en menores de 5 anos,clasificacion a y b,2002-05-01,49,24,49,24,73
30701,CAPINOTA,estado nutricional en menores de 5 anos,clasificacion a y b,2002-05-01,7,6,7,6,13
20302,CAQUIAVIRI,estado nutricional en menores de 5 anos,clasificacion a y b,2002-05-01,21,5,21,5,26
40102,CARACOLLO,estado nutricional en menores de 5 anos,clasificacion a y b,2002-05-01,25,48,25,48,73
22001,CARANAVI,estado nutricional en menores de 5 anos,clasificacion a y b,2002-05-01,43,55,43,55,98
60302,CARAPARI,estado nutricional en menores de 5 anos,clasificacion a y b,2002-05-01,16,35,16,35,51
50702,CARIPUYO,estado nutricional en menores de 5 anos,clasificacion a y b,2002-05-01,11,4,11,4,15
21803,CHACARILLA,estado nutricional en menores de 5 anos,clasificacion a y b,2002-05-01,1,0,1,0,1
40201,CHALLAPATA,estado nutricional en menores de 5 anos,clasificacion a y b,2002-05-01,10,12,10,12,22
50302,CHAQUI,estado nutricional en menores de 5 anos,clasificacion a y b,2002-05-01,8,1,8,1,9
70702,CHARAGUA,estado nutricional en menores de 5 anos,clasificacion a y b,2002-05-01,21,56,21,56,77
20305,CHARAÑA,estado nutricional en menores de 5 anos,clasificacion a y b,2002-05-01,0,3,0,3,3
31204,CHIMORE,estado nutricional en menores de 5 anos,clasificacion a y b,2002-05-01,14,18,14,18,32
40302,CHOQUE COTA,estado nutricional en menores de 5 anos,clasificacion a y b,2002-05-01,0,2,0,2,2
21101,CHULUMANI (V. DE LA LIBERTAD),estado nutricional en menores de 5 anos,clasificacion a y b,2002-05-01,12,10,12,10,22
20501,CHUMA,estado nutricional en menores de 5 anos,clasificacion a y b,2002-05-01,3,1,3,1,4
30801,CLIZA,estado nutricional en menores de 5 anos,clasificacion a y b,2002-05-01,10,36,10,36,46
90101,COBIJA,estado nutricional en menores de 5 anos,clasificacion a y b,2002-05-01,80,17,80,17,97
30101,COCHABAMBA,estado nutricional en menores de 5 anos,clasificacion a y b,2002-05-01,1544,1237,1544,1237,2781
30905,COLCAPIRHUA,estado nutricional en menores de 5 anos,clasificacion a y b,2002-05-01,51,17,51,17,68
50901,"COLCHA ""K""",estado nutricional en menores de 5 anos,clasificacion a y b,2002-05-01,4,28,4,28,32
21307,COLLANA,estado nutricional en menores de 5 anos,clasificacion a y b,2002-05-01,2,0,2,0,2
31002,COLOMI,estado nutricional en menores de 5 anos,clasificacion a y b,2002-05-01,23,12,23,12,35
50401,COLQUECHACA,estado nutricional en menores de 5 anos,clasificacion a y b,2002-05-01,8,6,8,6,14
21306,COLQUENCHA,estado nutricional en menores de 5 anos,clasificacion a y b,2002-05-01,13,7,13,7,20
21004,COLQUIRI,estado nutricional en menores de 5 anos,clasificacion a y b,2002-05-01,7,10,7,10,17
20304,COMANCHE,estado nutricional en menores de 5 anos,clasificacion a y b,2002-05-01,1,0,1,0,1
71301,COMARAPA,estado nutricional en menores de 5 anos,clasificacion a y b,2002-05-01,23,68,23,68,91
20605,COMBAYA,estado nutricional en menores de 5 anos,clasificacion a y b,2002-05-01,3,0,3,0,3
71101,CONCEPCION,estado nutricional en menores de 5 anos,clasificacion a y b,2002-05-01,1,5,1,5,6
21701,COPACABANA,estado nutricional en menores de 5 anos,clasificacion a y b,2002-05-01,2,11,2,11,13
21402,CORIPATA,estado nutricional en menores de 5 anos,clasificacion a y b,2002-05-01,14,20,14,20,34
20301,CORO CORO,estado nutricional en menores de 5 anos,clasificacion a y b,2002-05-01,15,2,15,2,17
21401,COROICO,estado nutricional en menores de 5 anos,clasificacion a y b,2002-05-01,10,4,10,4,14
40301,CORQUE,estado nutricional en menores de 5 anos,clasificacion a y b,2002-05-01,3,0,3,0,3
50601,COTAGAITA,estado nutricional en menores de 5 anos,clasificacion a y b,2002-05-01,6,23,6,23,29
70102,COTOCA,estado nutricional en menores de 5 anos,clasificacion a y b,2002-05-01,106,27,106,27,133
70704,CUEVO,estado nutricional en menores de 5 anos,clasificacion a y b,2002-05-01,25,4,25,4,29
10902,CULPINA,estado nutricional en menores de 5 anos,clasificacion a y b,2002-05-01,28,12,28,12,40
40401,CURAHUARA DE CARANGAS,estado nutricional en menores de 5 anos,clasificacion a y b,2002-05-01,7,1,7,1,8
21602,CURVA,estado nutricional en menores de 5 anos,clasificacion a y b,2002-05-01,1,0,1,0,1
20804,DESAGUADERO,estado nutricional en menores de 5 anos,clasificacion a y b,2002-05-01,0,9,0,9,9
20105,EL ALTO,estado nutricional en menores de 5 anos,clasificacion a y b,2002-05-01,536,298,536,298,834
40103,EL CHORO,estado nutricional en menores de 5 anos,clasificacion a y b,2002-05-01,2,1,2,1,3
71503,EL PUENTE(STC),estado nutricional en menores de 5 anos,clasificacion a y b,2002-05-01,13,30,13,30,43
60502,EL PUENTE(TJA),estado nutricional en menores de 5 anos,clasificacion a y b,2002-05-01,9,5,9,5,14
70105,EL TORNO,estado nutricional en menores de 5 anos,clasificacion a y b,2002-05-01,158,80,158,80,238
10405,EL VILLAR,estado nutricional en menores de 5 anos,clasificacion a y b,2002-05-01,10,4,10,4,14
60601,ENTRE RIOS,estado nutricional en menores de 5 anos,clasificacion a y b,2002-05-01,28,26,28,26,54
41101,EUCALIPTUS,estado nutricional en menores de 5 anos,clasificacion a y b,2002-05-01,2,6,2,6,8
80402,EXALTACION,estado nutricional en menores de 5 anos,clasificacion a y b,2002-05-01,5,8,5,8,13
90203,FILADELFIA,estado nutricional en menores de 5 anos,clasificacion a y b,2002-05-01,1,10,1,10,11
71002,GENERAL SAAVEDRA,estado nutricional en menores de 5 anos,clasificacion a y b,2002-05-01,51,37,51,37,88
20602,GUANAY,estado nutricional en menores de 5 anos,clasificacion a y b,2002-05-01,41,69,41,69,110
20802,GUAQUI,estado nutricional en menores de 5 anos,clasificacion a y b,2002-05-01,7,5,7,5,12
80202,GUAYARAMERIN,estado nutricional en menores de 5 anos,clasificacion a y b,2002-05-01,79,32,79,32,111
70705,GUTIERREZ,estado nutricional en menores de 5 anos,clasificacion a y b,2002-05-01,18,43,18,43,61
10502,HUACARETA,estado nutricional en menores de 5 anos,clasificacion a y b,2002-05-01,28,11,28,11,39
11002,HUACAYA (VILLA DE HUACAYA),estado nutricional en menores de 5 anos,clasificacion a y b,2002-05-01,8,3,8,3,11
40501,HUACHACALLA,estado nutricional en menores de 5 anos,clasificacion a y b,2002-05-01,1,3,1,3,4
40701,HUANUNI,estado nutricional en menores de 5 anos,clasificacion a y b,2002-05-01,2,0,2,0,2
80803,HUARACAJE,estado nutricional en menores de 5 anos,clasificacion a y b,2002-05-01,11,7,11,7,18
41601,HUAYLLAMARCA,estado nutricional en menores de 5 anos,clasificacion a y b,2002-05-01,4,0,4,0,4
21005,ICHOCA,estado nutricional en menores de 5 anos,clasificacion a y b,2002-05-01,0,1,0,1,1
10304,ICLA,estado nutricional en menores de 5 anos,clasificacion a y b,2002-05-01,13,32,13,32,45
10703,INCAHUASI,estado nutricional en menores de 5 anos,clasificacion a y b,2002-05-01,47,26,47,26,73
90402,INGAVI (HUMAITA),estado nutricional en menores de 5 anos,clasificacion a y b,2002-05-01,0,3,0,3,3
21001,INQUISIVI,estado nutricional en menores de 5 anos,clasificacion a y b,2002-05-01,14,4,14,4,18
21102,IRUPANA (VILLA DE LANZA),estado nutricional en menores de 5 anos,clasificacion a y b,2002-05-01,9,15,9,15,24
21501,IXIAMAS,estado nutricional en menores de 5 anos,clasificacion a y b,2002-05-01,27,11,27,11,38
21105,LA ASUNTA,estado nutricional en menores de 5 anos,clasificacion a y b,2002-05-01,26,24,26,24,50
70104,LA GUARDIA,estado nutricional en menores de 5 anos,clasificacion a y b,2002-05-01,169,39,169,39,208
20101,LA PAZ,estado nutricional en menores de 5 anos,clasificacion a y b,2002-05-01,610,292,610,292,902
41501,LA RIVERA,estado nutricional en menores de 5 anos,clasificacion a y b,2002-05-01,1,1,1,1,2
70701,LAGUNILLAS,estado nutricional en menores de 5 anos,clasificacion a y b,2002-05-01,26,15,26,15,41
21202,LAJA,estado nutricional en menores de 5 anos,clasificacion a y b,2002-05-01,7,15,7,15,22
10903,LAS CARRERAS,estado nutricional en menores de 5 anos,clasificacion a y b,2002-05-01,6,3,6,3,9
51401,LLICA,estado nutricional en menores de 5 anos,clasificacion a y b,2002-05-01,6,5,6,5,11
80601,LORETO,estado nutricional en menores de 5 anos,clasificacion a y b,2002-05-01,6,6,6,6,12
20901,LURIBAY,estado nutricional en menores de 5 anos,clasificacion a y b,2002-05-01,7,3,7,3,10
40702,MACHACAMARCA,estado nutricional en menores de 5 anos,clasificacion a y b,2002-05-01,4,4,4,4,8
11003,MACHARETI,estado nutricional en menores de 5 anos,clasificacion a y b,2002-05-01,45,25,45,25,70
80801,MAGDALENA,estado nutricional en menores de 5 anos,clasificacion a y b,2002-05-01,15,15,15,15,30
70903,MAIRANA,estado nutricional en menores de 5 anos,clasificacion a y b,2002-05-01,45,8,45,8,53
20103,MECAPACA,estado nutricional en menores de 5 anos,clasificacion a y b,2002-05-01,28,7,28,7,35
71003,MINEROS,estado nutricional en menores de 5 anos,clasificacion a y b,2002-05-01,140,32,140,32,172
31301,MIZQUE,estado nutricional en menores de 5 anos,clasificacion a y b,2002-05-01,11,21,11,21,32
20402,MOCOMOCO,estado nutricional en menores de 5 anos,clasificacion a y b,2002-05-01,17,1,17,1,18
10303,MOJOCOYA,estado nutricional en menores de 5 anos,clasificacion a y b,2002-05-01,32,12,32,12,44
10501,MONTEAGUDO,estado nutricional en menores de 5 anos,clasificacion a y b,2002-05-01,124,33,124,33,157
71001,MONTERO,estado nutricional en menores de 5 anos,clasificacion a y b,2002-05-01,204,284,204,284,488
70803,MORO MORO,estado nutricional en menores de 5 anos,clasificacion a y b,2002-05-01,9,4,9,4,13
30302,MOROCHATA,estado nutricional en menores de 5 anos,clasificacion a y b,2002-05-01,8,8,8,8,16
90501,NUEVO MANOA (NUEVA ESPERANZA),estado nutricional en menores de 5 anos,clasificacion a y b,2002-05-01,1,0,1,0,1
50404,OCURI,estado nutricional en menores de 5 anos,clasificacion a y b,2002-05-01,15,6,15,6,21
70202,OKINAWA,estado nutricional en menores de 5 anos,clasificacion a y b,2002-05-01,3,1,3,1,4
30203,OMEREQUE,estado nutricional en menores de 5 anos,clasificacion a y b,2002-05-01,2,12,2,12,14
40101,ORURO,estado nutricional en menores de 5 anos,clasificacion a y b,2002-05-01,283,169,283,169,452
60201,PADCAYA,estado nutricional en menores de 5 anos,clasificacion a y b,2002-05-01,26,35,26,35,61
10401,PADILLA,estado nutricional en menores de 5 anos,clasificacion a y b,2002-05-01,38,9,38,9,47
70502,PAILON,estado nutricional en menores de 5 anos,clasificacion a y b,2002-05-01,7,19,7,19,26
20102,PALCA,estado nutricional en menores de 5 anos,clasificacion a y b,2002-05-01,16,3,16,3,19
21104,PALOS BLANCOS,estado nutricional en menores de 5 anos,clasificacion a y b,2002-05-01,50,15,50,15,65
40802,PAMPA AULLAGAS,estado nutricional en menores de 5 anos,clasificacion a y b,2002-05-01,2,0,2,0,2
70902,PAMPA GRANDE,estado nutricional en menores de 5 anos,clasificacion a y b,2002-05-01,20,3,20,3,23
21802,PAPEL PAMPA,estado nutricional en menores de 5 anos,clasificacion a y b,2002-05-01,4,1,4,1,5
30202,PASORAPA,estado nutricional en menores de 5 anos,clasificacion a y b,2002-05-01,22,6,22,6,28
21305,PATACAMAYA,estado nutricional en menores de 5 anos,clasificacion a y b,2002-05-01,45,5,45,5,50
40602,PAZÑA,estado nutricional en menores de 5 anos,clasificacion a y b,2002-05-01,1,4,1,4,5
20702,PELECHUCO,estado nutricional en menores de 5 anos,clasificacion a y b,2002-05-01,2,2,2,2,4
50403,POCOATA,estado nutricional en menores de 5 anos,clasificacion a y b,2002-05-01,23,21,23,21,44
31203,POCONA,estado nutricional en menores de 5 anos,clasificacion a y b,2002-05-01,10,7,10,7,17
31202,POJO (CBBA),estado nutricional en menores de 5 anos,clasificacion a y b,2002-05-01,87,19,87,19,106
40601,POOPO,estado nutricional en menores de 5 anos,clasificacion a y b,2002-05-01,0,1,0,1,1
51203,PORCO,estado nutricional en menores de 5 anos,clasificacion a y b,2002-05-01,11,6,11,6,17
10103,POROMA,estado nutricional en menores de 5 anos,clasificacion a y b,2002-05-01,27,3,27,3,30
70103,PORONGO,estado nutricional en menores de 5 anos,clasificacion a y b,2002-05-01,24,2,24,2,26
70601,PORTACHUELO,estado nutricional en menores de 5 anos,clasificacion a y b,2002-05-01,72,25,72,25,97
50101,POTOSI,estado nutricional en menores de 5 anos,clasificacion a y b,2002-05-01,131,27,131,27,158
10302,PRESTO,estado nutricional en menores de 5 anos,clasificacion a y b,2002-05-01,16,2,16,2,18
70805,PUCARA,estado nutricional en menores de 5 anos,clasificacion a y b,2002-05-01,1,0,1,0,1
21201,PUCARANI,estado nutricional en menores de 5 anos,clasificacion a y b,2002-05-01,4,31,4,31,35
20401,PUERTO ACOSTA,estado nutricional en menores de 5 anos,clasificacion a y b,2002-05-01,23,20,23,20,43
20403,PUERTO CARABUCO,estado nutricional en menores de 5 anos,clasificacion a y b,2002-05-01,16,2,16,2,18
90301,PUERTO GONZALO MORENO,estado nutricional en menores de 5 anos,clasificacion a y b,2002-05-01,8,3,8,3,11
21204,PUERTO PEREZ,estado nutricional en menores de 5 anos,clasificacion a y b,2002-05-01,3,6,3,6,9
71402,PUERTO QUIJARRO,estado nutricional en menores de 5 anos,clasificacion a y b,2002-05-01,47,7,47,7,54
90201,PUERTO RICO,estado nutricional en menores de 5 anos,clasificacion a y b,2002-05-01,3,9,3,9,12
80703,PUERTO SILES,estado nutricional en menores de 5 anos,clasificacion a y b,2002-05-01,3,1,3,1,4
71401,PUERTO SUAREZ,estado nutricional en menores de 5 anos,clasificacion a y b,2002-05-01,54,9,54,9,63
31205,PUERTO VILLARROEL,estado nutricional en menores de 5 anos,clasificacion a y b,2002-05-01,148,59,148,59,207
51101,PUNA,estado nutricional en menores de 5 anos,clasificacion a y b,2002-05-01,46,35,46,35,81
31401,PUNATA,estado nutricional en menores de 5 anos,clasificacion a y b,2002-05-01,0,8,0,8,8
20604,QUIABAYA,estado nutricional en menores de 5 anos,clasificacion a y b,2002-05-01,7,1,7,1,8
30901,QUILLACOLLO,estado nutricional en menores de 5 anos,clasificacion a y b,2002-05-01,36,4,36,4,40
21002,QUIME,estado nutricional en menores de 5 anos,clasificacion a y b,2002-05-01,5,5,5,5,10
70904,QUIRUSILLAS,estado nutricional en menores de 5 anos,clasificacion a y b,2002-05-01,0,2,0,2,2
50402,RAVELO,estado nutricional en menores de 5 anos,clasificacion a y b,2002-05-01,10,5,10,5,15
80301,REYES,estado nutricional en menores de 5 anos,clasificacion a y b,2002-05-01,37,4,37,4,41
80201,RIBERALTA,estado nutricional en menores de 5 anos,clasificacion a y b,2002-05-01,213,68,213,68,281
70503,ROBORE,estado nutricional en menores de 5 anos,clasificacion a y b,2002-05-01,25,15,25,15,40
80304,RURRENABAQUE,estado nutricional en menores de 5 anos,clasificacion a y b,2002-05-01,25,16,25,16,41
40901,SABAYA,estado nutricional en menores de 5 anos,clasificacion a y b,2002-05-01,1,1,1,1,2
31001,SACABA,estado nutricional en menores de 5 anos,clasificacion a y b,2002-05-01,19,6,19,6,25
30404,SACABAMBA,estado nutricional en menores de 5 anos,clasificacion a y b,2002-05-01,1,7,1,7,8
50701,SACACA,estado nutricional en menores de 5 anos,clasificacion a y b,2002-05-01,15,4,15,4,19
71302,SAIPINA,estado nutricional en menores de 5 anos,clasificacion a y b,2002-05-01,36,16,36,16,52
40801,SALINAS DE GARCI MENDOZA,estado nutricional en menores de 5 anos,clasificacion a y b,2002-05-01,3,1,3,1,4
70901,SAMAIPATA,estado nutricional en menores de 5 anos,clasificacion a y b,2002-05-01,15,6,15,6,21
51601,SAN AGUSTIN,estado nutricional en menores de 5 anos,clasificacion a y b,2002-05-01,1,2,1,2,3
80602,SAN ANDRES,estado nutricional en menores de 5 anos,clasificacion a y b,2002-05-01,4,1,4,1,5
51003,SAN ANTONIO DE ESMORUCO,estado nutricional en menores de 5 anos,clasificacion a y b,2002-05-01,1,2,1,2,3
71105,SAN ANTONIO DE LOMERIO,estado nutricional en menores de 5 anos,clasificacion a y b,2002-05-01,27,6,27,6,33
31403,SAN BENITO,estado nutricional en menores de 5 anos,clasificacion a y b,2002-05-01,6,9,6,9,15
80302,SAN BORJA,estado nutricional en menores de 5 anos,clasificacion a y b,2002-05-01,93,20,93,20,113
21502,SAN BUENA VENTURA,estado nutricional en menores de 5 anos,clasificacion a y b,2002-05-01,5,4,5,4,9
70402,SAN CARLOS,estado nutricional en menores de 5 anos,clasificacion a y b,2002-05-01,8,6,8,6,14
80501,SAN IGNACIO,estado nutricional en menores de 5 anos,clasificacion a y b,2002-05-01,28,64,28,64,92
70301,SAN IGNACIO DE VELASCO,estado nutricional en menores de 5 anos,clasificacion a y b,2002-05-01,154,31,154,31,185
80102,SAN JAVIER(BNI),estado nutricional en menores de 5 anos,clasificacion a y b,2002-05-01,3,3,3,3,6
71102,SAN JAVIER(STC),estado nutricional en menores de 5 anos,clasificacion a y b,2002-05-01,25,6,25,6,31
80701,SAN JOAQUIN,estado nutricional en menores de 5 anos,clasificacion a y b,2002-05-01,5,17,5,17,22
70501,SAN JOSE DE CHIQUITOS,estado nutricional en menores de 5 anos,clasificacion a y b,2002-05-01,18,6,18,6,24
71104,SAN JULIAN,estado nutricional en menores de 5 anos,clasificacion a y b,2002-05-01,115,89,115,89,204
60501,SAN LORENZO(TJA),estado nutricional en menores de 5 anos,clasificacion a y b,2002-05-01,3,5,3,5,8
10702,SAN LUCAS,estado nutricional en menores de 5 anos,clasificacion a y b,2002-05-01,44,12,44,12,56
71201,SAN MATIAS,estado nutricional en menores de 5 anos,clasificacion a y b,2002-05-01,27,17,27,17,44
70302,SAN MIGUEL DE VELASCO,estado nutricional en menores de 5 anos,clasificacion a y b,2002-05-01,33,7,33,7,40
51001,SAN PABLO DE LIPEZ,estado nutricional en menores de 5 anos,clasificacion a y b,2002-05-01,2,10,2,10,12
50501,SAN PEDRO DE BUENA VISTA,estado nutricional en menores de 5 anos,clasificacion a y b,2002-05-01,0,21,0,21,21
21801,SAN PEDRO DE CURAHUARA,estado nutricional en menores de 5 anos,clasificacion a y b,2002-05-01,6,7,6,7,13
21702,SAN PEDRO DE TIQUINA,estado nutricional en menores de 5 anos,clasificacion a y b,2002-05-01,7,18,7,18,25
70303,SAN RAFAEL,estado nutricional en menores de 5 anos,clasificacion a y b,2002-05-01,8,0,8,0,8
80702,SAN RAMON,estado nutricional en menores de 5 anos,clasificacion a y b,2002-05-01,36,36,36,36,72
80401,SANTA ANA,estado nutricional en menores de 5 anos,clasificacion a y b,2002-05-01,43,10,43,10,53
70101,SANTA CRUZ DE LA SIERRA,estado nutricional en menores de 5 anos,clasificacion a y b,2002-05-01,1160,698,1160,698,1858
80303,SANTA ROSA,estado nutricional en menores de 5 anos,clasificacion a y b,2002-05-01,20,5,20,5,25
70602,SANTA ROSA DEL SARA,estado nutricional en menores de 5 anos,clasificacion a y b,2002-05-01,18,23,18,23,41
20308,SANTIAGO DE CALLAPA,estado nutricional en menores de 5 anos,clasificacion a y b,2002-05-01,0,2,0,2,2
41401,SANTIAGO DE HUARI,estado nutricional en menores de 5 anos,clasificacion a y b,2002-05-01,7,2,7,2,9
21901,SANTIAGO DE MACHACA,estado nutricional en menores de 5 anos,clasificacion a y b,2002-05-01,9,1,9,1,10
30702,SANTIVAÑES,estado nutricional en menores de 5 anos,clasificacion a y b,2002-05-01,3,0,3,0,3
40202,SANTUARIO DE QUILLACAS,estado nutricional en menores de 5 anos,clasificacion a y b,2002-05-01,3,1,3,1,4
20902,SAPAHAQUI,estado nutricional en menores de 5 anos,clasificacion a y b,2002-05-01,1,0,1,0,1
21301,SICA SICA (VILLA AROMA),estado nutricional en menores de 5 anos,clasificacion a y b,2002-05-01,16,9,16,9,25
30703,SICAYA,estado nutricional en menores de 5 anos,clasificacion a y b,2002-05-01,0,2,0,2,2
30902,SIPE SIPE,estado nutricional en menores de 5 anos,clasificacion a y b,2002-05-01,123,70,123,70,193
10403,SOPACHUY,estado nutricional en menores de 5 anos,clasificacion a y b,2002-05-01,17,1,17,1,18
20601,SORATA,estado nutricional en menores de 5 anos,clasificacion a y b,2002-05-01,16,9,16,9,25
10101,SUCRE,estado nutricional en menores de 5 anos,clasificacion a y b,2002-05-01,361,170,361,170,531
31404,TACACHI,estado nutricional en menores de 5 anos,clasificacion a y b,2002-05-01,0,1,0,1,1
20603,TACACOMA,estado nutricional en menores de 5 anos,clasificacion a y b,2002-05-01,4,22,4,22,26
50303,TACOBAMBA,estado nutricional en menores de 5 anos,clasificacion a y b,2002-05-01,17,0,17,0,17
30602,TACOPAYA,estado nutricional en menores de 5 anos,clasificacion a y b,2002-05-01,6,4,6,4,10
51402,TAHUA,estado nutricional en menores de 5 anos,clasificacion a y b,2002-05-01,0,2,0,2,2
31101,TAPACARI,estado nutricional en menores de 5 anos,clasificacion a y b,2002-05-01,13,33,13,33,46
10601,TARABUCO,estado nutricional en menores de 5 anos,clasificacion a y b,2002-05-01,30,52,30,52,82
30401,TARATA,estado nutricional en menores de 5 anos,clasificacion a y b,2002-05-01,16,10,16,10,26
60101,TARIJA,estado nutricional en menores de 5 anos,clasificacion a y b,2002-05-01,317,190,317,190,507
10202,TARVITA,estado nutricional en menores de 5 anos,clasificacion a y b,2002-05-01,15,0,15,0,15
20803,TIAWANACU,estado nutricional en menores de 5 anos,clasificacion a y b,2002-05-01,22,7,22,7,29
50102,TINGUIPAYA,estado nutricional en menores de 5 anos,clasificacion a y b,2002-05-01,10,2,10,2,12
20606,TIPUANI,estado nutricional en menores de 5 anos,clasificacion a y b,2002-05-01,13,9,13,9,22
30903,TIQUIPAYA,estado nutricional en menores de 5 anos,clasificacion a y b,2002-05-01,11,34,11,34,45
31601,TIRAQUE (CBBA),estado nutricional en menores de 5 anos,clasificacion a y b,2002-05-01,46,89,46,89,135
30802,TOCO,estado nutricional en menores de 5 anos,clasificacion a y b,2002-05-01,3,3,3,3,6
30803,TOLATA,estado nutricional en menores de 5 anos,clasificacion a y b,2002-05-01,1,5,1,5,6
41001,TOLEDO,estado nutricional en menores de 5 anos,clasificacion a y b,2002-05-01,3,2,3,2,5
51202,TOMAVE,estado nutricional en menores de 5 anos,clasificacion a y b,2002-05-01,2,17,2,17,19
10402,TOMINA,estado nutricional en menores de 5 anos,clasificacion a y b,2002-05-01,31,19,31,19,50
50502,TORO TORO,estado nutricional en menores de 5 anos,clasificacion a y b,2002-05-01,0,1,0,1,1
31201,TOTORA(CBBA),estado nutricional en menores de 5 anos,clasificacion a y b,2002-05-01,27,32,27,32,59
41301,TOTORA(ORR),estado nutricional en menores de 5 anos,clasificacion a y b,2002-05-01,0,1,0,1,1
70802,TRIGAL,estado nutricional en menores de 5 anos,clasificacion a y b,2002-05-01,4,0,4,0,4
80101,TRINIDAD,estado nutricional en menores de 5 anos,clasificacion a y b,2002-05-01,163,102,163,102,265
50801,TUPIZA,estado nutricional en menores de 5 anos,clasificacion a y b,2002-05-01,14,64,14,64,78
40402,TURCO,estado nutricional en menores de 5 anos,clasificacion a y b,2002-05-01,4,0,4,0,4
21302,UMALA,estado nutricional en menores de 5 anos,clasificacion a y b,2002-05-01,0,8,0,8,8
60401,URIONDO (A. CONCEPCION),estado nutricional en menores de 5 anos,clasificacion a y b,2002-05-01,15,38,15,38,53
51201,UYUNI,estado nutricional en menores de 5 anos,clasificacion a y b,2002-05-01,12,40,12,40,52
70801,VALLEGRANDE,estado nutricional en menores de 5 anos,clasificacion a y b,2002-05-01,59,29,59,29,88
20801,VIACHA,estado nutricional en menores de 5 anos,clasificacion a y b,2002-05-01,35,74,35,74,109
31302,VILA VILA,estado nutricional en menores de 5 anos,clasificacion a y b,2002-05-01,2,3,2,3,5
60303,VILLA MONTES,estado nutricional en menores de 5 anos,clasificacion a y b,2002-05-01,35,15,35,15,50
31402,VILLA RIVERO,estado nutricional en menores de 5 anos,clasificacion a y b,2002-05-01,0,5,0,5,5
10801,VILLA SERRANO,estado nutricional en menores de 5 anos,clasificacion a y b,2002-05-01,10,23,10,23,33
31003,VILLA TUNARI,estado nutricional en menores de 5 anos,clasificacion a y b,2002-05-01,119,17,119,17,136
11001,VILLA VACA GUZMAN (MUYUPAMPA),estado nutricional en menores de 5 anos,clasificacion a y b,2002-05-01,63,17,63,17,80
51501,VILLAZON,estado nutricional en menores de 5 anos,clasificacion a y b,2002-05-01,33,78,33,78,111
30904,VINTO,estado nutricional en menores de 5 anos,clasificacion a y b,2002-05-01,31,12,31,12,43
50602,VITICHI,estado nutricional en menores de 5 anos,clasificacion a y b,2002-05-01,4,9,4,9,13
20306,WALDO BALLIVIAN,estado nutricional en menores de 5 anos,clasificacion a y b,2002-05-01,0,1,0,1,1
70201,WARNES,estado nutricional en menores de 5 anos,clasificacion a y b,2002-05-01,76,33,76,33,109
20903,YACO,estado nutricional en menores de 5 anos,clasificacion a y b,2002-05-01,8,7,8,7,15
60301,YACUIBA,estado nutricional en menores de 5 anos,clasificacion a y b,2002-05-01,194,112,194,112,306
10602,YAMPARAEZ,estado nutricional en menores de 5 anos,clasificacion a y b,2002-05-01,34,4,34,4,38
21103,YANACACHI,estado nutricional en menores de 5 anos,clasificacion a y b,2002-05-01,4,6,4,6,10
70403,YAPACANI,estado nutricional en menores de 5 anos,clasificacion a y b,2002-05-01,34,23,34,23,57
50103,YOCALLA,estado nutricional en menores de 5 anos,clasificacion a y b,2002-05-01,1,6,1,6,7
10102,YOTALA,estado nutricional en menores de 5 anos,clasificacion a y b,2002-05-01,33,10,33,10,43
60402,YUNCHARA,estado nutricional en menores de 5 anos,clasificacion a y b,2002-05-01,9,8,9,8,17
10301,ZUDAÑEZ,estado nutricional en menores de 5 anos,clasificacion a y b,2002-05-01,22,2,22,2,24
51302,ACACIO,estado nutricional en menores de 5 anos,clasificacion a y b,2002-06-01,1,1,1,1,2
20201,ACHACACHI,estado nutricional en menores de 5 anos,clasificacion a y b,2002-06-01,85,30,85,30,115
20104,ACHOCALLA,estado nutricional en menores de 5 anos,clasificacion a y b,2002-06-01,5,2,5,2,7
30201,AIQUILE,estado nutricional en menores de 5 anos,clasificacion a y b,2002-06-01,7,4,7,4,11
31303,ALALAY,estado nutricional en menores de 5 anos,clasificacion a y b,2002-06-01,0,3,0,3,3
10404,ALCALA,estado nutricional en menores de 5 anos,clasificacion a y b,2002-06-01,12,3,12,3,15
20202,ANCORAIMES,estado nutricional en menores de 5 anos,clasificacion a y b,2002-06-01,14,8,14,8,22
41201,ANDAMARCA,estado nutricional en menores de 5 anos,clasificacion a y b,2002-06-01,2,0,2,0,2
40603,ANTEQUERA,estado nutricional en menores de 5 anos,clasificacion a y b,2002-06-01,0,4,0,4,4
30402,ANZALDO,estado nutricional en menores de 5 anos,clasificacion a y b,2002-06-01,2,14,2,14,16
20701,APOLO,estado nutricional en menores de 5 anos,clasificacion a y b,2002-06-01,26,3,26,3,29
51301,ARAMPAMPA,estado nutricional en menores de 5 anos,clasificacion a y b,2002-06-01,5,1,5,1,6
30501,ARANI,estado nutricional en menores de 5 anos,clasificacion a y b,2002-06-01,3,6,3,6,9
30403,ARBIETO,estado nutricional en menores de 5 anos,clasificacion a y b,2002-06-01,4,11,4,11,15
30601,ARQUE,estado nutricional en menores de 5 anos,clasificacion a y b,2002-06-01,2,2,2,2,4
71501,ASCENCION DE GUARAYOS,estado nutricional en menores de 5 anos,clasificacion a y b,2002-06-01,109,34,109,34,143
50802,ATOCHA,estado nutricional en menores de 5 anos,clasificacion a y b,2002-06-01,1,11,1,11,12
20503,AUCAPATA,estado nutricional en menores de 5 anos,clasificacion a y b,2002-06-01,7,1,7,1,8
20502,AYATA,estado nutricional en menores de 5 anos,clasificacion a y b,2002-06-01,2,0,2,0,2
21303,AYO AYO,estado nutricional en menores de 5 anos,clasificacion a y b,2002-06-01,21,1,21,1,22
30301,AYOPAYA (V. DE INDEPENDENCIA),estado nutricional en menores de 5 anos,clasificacion a y b,2002-06-01,18,10,18,10,28
10201,AZURDUY,estado nutricional en menores de 5 anos,clasificacion a y b,2002-06-01,43,11,43,11,54
21203,BATALLAS,estado nutricional en menores de 5 anos,clasificacion a y b,2002-06-01,8,40,8,40,48
80802,BAURES,estado nutricional en menores de 5 anos,clasificacion a y b,2002-06-01,14,8,14,8,22
41202,BELEN DE ANDAMARCA,estado nutricional en menores de 5 anos,clasificacion a y b,2002-06-01,2,0,2,0,2
50104,BELEN DE URMIRI,estado nutricional en menores de 5 anos,clasificacion a y b,2002-06-01,8,2,8,2,10
60202,BERMEJO,estado nutricional en menores de 5 anos,clasificacion a y b,2002-06-01,20,36,20,36,56
50301,BETANZOS,estado nutricional en menores de 5 anos,clasificacion a y b,2002-06-01,10,11,10,11,21
31501,BOLIVAR,estado nutricional en menores de 5 anos,clasificacion a y b,2002-06-01,4,3,4,3,7
90103,BOLPEBRA,estado nutricional en menores de 5 anos,clasificacion a y b,2002-06-01,0,2,0,2,2
70707,BOYUIBE,estado nutricional en menores de 5 anos,clasificacion a y b,2002-06-01,1,2,1,2,3
70703,CABEZAS,estado nutricional en menores de 5 anos,clasificacion a y b,2002-06-01,7,68,7,68,75
20905,CAIROMA,estado nutricional en menores de 5 anos,clasificacion a y b,2002-06-01,21,10,21,10,31
51102,"CAIZA ""D""",estado nutricional en menores de 5 anos,clasificacion a y b,2002-06-01,9,6,9,6,15
21003,CAJUATA,estado nutricional en menores de 5 anos,clasificacion a y b,2002-06-01,24,2,24,2,26
20303,CALACOTO,estado nutricional en menores de 5 anos,clasificacion a y b,2002-06-01,3,0,3,0,3
21304,CALAMARCA,estado nutricional en menores de 5 anos,clasificacion a y b,2002-06-01,12,6,12,6,18
10701,CAMARGO,estado nutricional en menores de 5 anos,clasificacion a y b,2002-06-01,30,12,30,12,42
10901,CAMATAQUI (C. VILLA ABECIA),estado nutricional en menores de 5 anos,clasificacion a y b,2002-06-01,24,5,24,5,29
70706,CAMIRI,estado nutricional en menores de 5 anos,clasificacion a y b,2002-06-01,62,26,62,26,88
30701,CAPINOTA,estado nutricional en menores de 5 anos,clasificacion a y b,2002-06-01,9,2,9,2,11
20302,CAQUIAVIRI,estado nutricional en menores de 5 anos,clasificacion a y b,2002-06-01,19,10,19,10,29
40102,CARACOLLO,estado nutricional en menores de 5 anos,clasificacion a y b,2002-06-01,24,18,24,18,42
22001,CARANAVI,estado nutricional en menores de 5 anos,clasificacion a y b,2002-06-01,108,42,108,42,150
60302,CARAPARI,estado nutricional en menores de 5 anos,clasificacion a y b,2002-06-01,27,39,27,39,66
50702,CARIPUYO,estado nutricional en menores de 5 anos,clasificacion a y b,2002-06-01,2,3,2,3,5
21902,CATACORA,estado nutricional en menores de 5 anos,clasificacion a y b,2002-06-01,1,0,1,0,1
21803,CHACARILLA,estado nutricional en menores de 5 anos,clasificacion a y b,2002-06-01,1,1,1,1,2
40201,CHALLAPATA,estado nutricional en menores de 5 anos,clasificacion a y b,2002-06-01,9,7,9,7,16
50302,CHAQUI,estado nutricional en menores de 5 anos,clasificacion a y b,2002-06-01,16,3,16,3,19
70702,CHARAGUA,estado nutricional en menores de 5 anos,clasificacion a y b,2002-06-01,18,93,18,93,111
50202,CHAYANTA,estado nutricional en menores de 5 anos,clasificacion a y b,2002-06-01,2,7,2,7,9
31204,CHIMORE,estado nutricional en menores de 5 anos,clasificacion a y b,2002-06-01,7,2,7,2,9
40903,CHIPAYA,estado nutricional en menores de 5 anos,clasificacion a y b,2002-06-01,0,2,0,2,2
40302,CHOQUE COTA,estado nutricional en menores de 5 anos,clasificacion a y b,2002-06-01,0,2,0,2,2
21101,CHULUMANI (V. DE LA LIBERTAD),estado nutricional en menores de 5 anos,clasificacion a y b,2002-06-01,6,2,6,2,8
20501,CHUMA,estado nutricional en menores de 5 anos,clasificacion a y b,2002-06-01,8,4,8,4,12
30801,CLIZA,estado nutricional en menores de 5 anos,clasificacion a y b,2002-06-01,2,14,2,14,16
90101,COBIJA,estado nutricional en menores de 5 anos,clasificacion a y b,2002-06-01,43,14,43,14,57
30101,COCHABAMBA,estado nutricional en menores de 5 anos,clasificacion a y b,2002-06-01,330,298,330,298,628
40902,COIPASA,estado nutricional en menores de 5 anos,clasificacion a y b,2002-06-01,1,1,1,1,2
30905,COLCAPIRHUA,estado nutricional en menores de 5 anos,clasificacion a y b,2002-06-01,51,7,51,7,58
50901,"COLCHA ""K""",estado nutricional en menores de 5 anos,clasificacion a y b,2002-06-01,1,17,1,17,18
21307,COLLANA,estado nutricional en menores de 5 anos,clasificacion a y b,2002-06-01,3,0,3,0,3
31002,COLOMI,estado nutricional en menores de 5 anos,clasificacion a y b,2002-06-01,16,4,16,4,20
50401,COLQUECHACA,estado nutricional en menores de 5 anos,clasificacion a y b,2002-06-01,7,8,7,8,15
21306,COLQUENCHA,estado nutricional en menores de 5 anos,clasificacion a y b,2002-06-01,11,7,11,7,18
21004,COLQUIRI,estado nutricional en menores de 5 anos,clasificacion a y b,2002-06-01,22,5,22,5,27
20304,COMANCHE,estado nutricional en menores de 5 anos,clasificacion a y b,2002-06-01,2,0,2,0,2
71301,COMARAPA,estado nutricional en menores de 5 anos,clasificacion a y b,2002-06-01,50,28,50,28,78
20605,COMBAYA,estado nutricional en menores de 5 anos,clasificacion a y b,2002-06-01,3,0,3,0,3
71101,CONCEPCION,estado nutricional en menores de 5 anos,clasificacion a y b,2002-06-01,25,3,25,3,28
21701,COPACABANA,estado nutricional en menores de 5 anos,clasificacion a y b,2002-06-01,4,7,4,7,11
21402,CORIPATA,estado nutricional en menores de 5 anos,clasificacion a y b,2002-06-01,22,30,22,30,52
20301,CORO CORO,estado nutricional en menores de 5 anos,clasificacion a y b,2002-06-01,24,9,24,9,33
21401,COROICO,estado nutricional en menores de 5 anos,clasificacion a y b,2002-06-01,4,1,4,1,5
40301,CORQUE,estado nutricional en menores de 5 anos,clasificacion a y b,2002-06-01,7,1,7,1,8
50601,COTAGAITA,estado nutricional en menores de 5 anos,clasificacion a y b,2002-06-01,19,33,19,33,52
70102,COTOCA,estado nutricional en menores de 5 anos,clasificacion a y b,2002-06-01,135,17,135,17,152
31405,CUCHUMUELA (V. G. VILLARROEL),estado nutricional en menores de 5 anos,clasificacion a y b,2002-06-01,2,0,2,0,2
70704,CUEVO,estado nutricional en menores de 5 anos,clasificacion a y b,2002-06-01,17,0,17,0,17
10902,CULPINA,estado nutricional en menores de 5 anos,clasificacion a y b,2002-06-01,32,9,32,9,41
40401,CURAHUARA DE CARANGAS,estado nutricional en menores de 5 anos,clasificacion a y b,2002-06-01,6,0,6,0,6
21602,CURVA,estado nutricional en menores de 5 anos,clasificacion a y b,2002-06-01,3,0,3,0,3
20804,DESAGUADERO,estado nutricional en menores de 5 anos,clasificacion a y b,2002-06-01,1,9,1,9,10
20105,EL ALTO,estado nutricional en menores de 5 anos,clasificacion a y b,2002-06-01,570,203,570,203,773
40103,EL CHORO,estado nutricional en menores de 5 anos,clasificacion a y b,2002-06-01,2,2,2,2,4
71503,EL PUENTE(STC),estado nutricional en menores de 5 anos,clasificacion a y b,2002-06-01,15,26,15,26,41
60502,EL PUENTE(TJA),estado nutricional en menores de 5 anos,clasificacion a y b,2002-06-01,6,5,6,5,11
70105,EL TORNO,estado nutricional en menores de 5 anos,clasificacion a y b,2002-06-01,95,36,95,36,131
10405,EL VILLAR,estado nutricional en menores de 5 anos,clasificacion a y b,2002-06-01,13,6,13,6,19
60601,ENTRE RIOS,estado nutricional en menores de 5 anos,clasificacion a y b,2002-06-01,47,26,47,26,73
41101,EUCALIPTUS,estado nutricional en menores de 5 anos,clasificacion a y b,2002-06-01,0,8,0,8,8
90203,FILADELFIA,estado nutricional en menores de 5 anos,clasificacion a y b,2002-06-01,13,23,13,23,36
71002,GENERAL SAAVEDRA,estado nutricional en menores de 5 anos,clasificacion a y b,2002-06-01,43,19,43,19,62
20602,GUANAY,estado nutricional en menores de 5 anos,clasificacion a y b,2002-06-01,113,27,113,27,140
20802,GUAQUI,estado nutricional en menores de 5 anos,clasificacion a y b,2002-06-01,1,1,1,1,2
80202,GUAYARAMERIN,estado nutricional en menores de 5 anos,clasificacion a y b,2002-06-01,84,14,84,14,98
70705,GUTIERREZ,estado nutricional en menores de 5 anos,clasificacion a y b,2002-06-01,46,47,46,47,93
10502,HUACARETA,estado nutricional en menores de 5 anos,clasificacion a y b,2002-06-01,31,31,31,31,62
11002,HUACAYA (VILLA DE HUACAYA),estado nutricional en menores de 5 anos,clasificacion a y b,2002-06-01,7,2,7,2,9
40501,HUACHACALLA,estado nutricional en menores de 5 anos,clasificacion a y b,2002-06-01,2,4,2,4,6
40701,HUANUNI,estado nutricional en menores de 5 anos,clasificacion a y b,2002-06-01,3,0,3,0,3
80803,HUARACAJE,estado nutricional en menores de 5 anos,clasificacion a y b,2002-06-01,18,7,18,7,25
41601,HUAYLLAMARCA,estado nutricional en menores de 5 anos,clasificacion a y b,2002-06-01,4,0,4,0,4
10304,ICLA,estado nutricional en menores de 5 anos,clasificacion a y b,2002-06-01,14,8,14,8,22
10703,INCAHUASI,estado nutricional en menores de 5 anos,clasificacion a y b,2002-06-01,34,20,34,20,54
90402,INGAVI (HUMAITA),estado nutricional en menores de 5 anos,clasificacion a y b,2002-06-01,19,0,19,0,19
21001,INQUISIVI,estado nutricional en menores de 5 anos,clasificacion a y b,2002-06-01,41,7,41,7,48
21102,IRUPANA (VILLA DE LANZA),estado nutricional en menores de 5 anos,clasificacion a y b,2002-06-01,16,48,16,48,64
21501,IXIAMAS,estado nutricional en menores de 5 anos,clasificacion a y b,2002-06-01,29,13,29,13,42
21105,LA ASUNTA,estado nutricional en menores de 5 anos,clasificacion a y b,2002-06-01,18,4,18,4,22
70104,LA GUARDIA,estado nutricional en menores de 5 anos,clasificacion a y b,2002-06-01,156,36,156,36,192
20101,LA PAZ,estado nutricional en menores de 5 anos,clasificacion a y b,2002-06-01,561,211,561,211,772
41501,LA RIVERA,estado nutricional en menores de 5 anos,clasificacion a y b,2002-06-01,2,0,2,0,2
70701,LAGUNILLAS,estado nutricional en menores de 5 anos,clasificacion a y b,2002-06-01,37,17,37,17,54
21202,LAJA,estado nutricional en menores de 5 anos,clasificacion a y b,2002-06-01,8,8,8,8,16
10903,LAS CARRERAS,estado nutricional en menores de 5 anos,clasificacion a y b,2002-06-01,8,4,8,4,12
21006,LICOMA PAMPA,estado nutricional en menores de 5 anos,clasificacion a y b,2002-06-01,0,2,0,2,2
50203,LLALLAGUA,estado nutricional en menores de 5 anos,clasificacion a y b,2002-06-01,1,0,1,0,1
51401,LLICA,estado nutricional en menores de 5 anos,clasificacion a y b,2002-06-01,9,1,9,1,10
80601,LORETO,estado nutricional en menores de 5 anos,clasificacion a y b,2002-06-01,9,13,9,13,22
20901,LURIBAY,estado nutricional en menores de 5 anos,clasificacion a y b,2002-06-01,5,11,5,11,16
11003,MACHARETI,estado nutricional en menores de 5 anos,clasificacion a y b,2002-06-01,29,26,29,26,55
80801,MAGDALENA,estado nutricional en menores de 5 anos,clasificacion a y b,2002-06-01,18,3,18,3,21
70903,MAIRANA,estado nutricional en menores de 5 anos,clasificacion a y b,2002-06-01,46,9,46,9,55
20103,MECAPACA,estado nutricional en menores de 5 anos,clasificacion a y b,2002-06-01,16,1,16,1,17
71003,MINEROS,estado nutricional en menores de 5 anos,clasificacion a y b,2002-06-01,52,19,52,19,71
31301,MIZQUE,estado nutricional en menores de 5 anos,clasificacion a y b,2002-06-01,11,14,11,14,25
20402,MOCOMOCO,estado nutricional en menores de 5 anos,clasificacion a y b,2002-06-01,22,2,22,2,24
10303,MOJOCOYA,estado nutricional en menores de 5 anos,clasificacion a y b,2002-06-01,26,6,26,6,32
10501,MONTEAGUDO,estado nutricional en menores de 5 anos,clasificacion a y b,2002-06-01,111,26,111,26,137
71001,MONTERO,estado nutricional en menores de 5 anos,clasificacion a y b,2002-06-01,217,218,217,218,435
70803,MORO MORO,estado nutricional en menores de 5 anos,clasificacion a y b,2002-06-01,6,2,6,2,8
30302,MOROCHATA,estado nutricional en menores de 5 anos,clasificacion a y b,2002-06-01,11,14,11,14,25
90501,NUEVO MANOA (NUEVA ESPERANZA),estado nutricional en menores de 5 anos,clasificacion a y b,2002-06-01,1,1,1,1,2
50404,OCURI,estado nutricional en menores de 5 anos,clasificacion a y b,2002-06-01,17,19,17,19,36
70202,OKINAWA,estado nutricional en menores de 5 anos,clasificacion a y b,2002-06-01,0,4,0,4,4
40101,ORURO,estado nutricional en menores de 5 anos,clasificacion a y b,2002-06-01,279,80,279,80,359
60201,PADCAYA,estado nutricional en menores de 5 anos,clasificacion a y b,2002-06-01,32,44,32,44,76
10401,PADILLA,estado nutricional en menores de 5 anos,clasificacion a y b,2002-06-01,44,8,44,8,52
70502,PAILON,estado nutricional en menores de 5 anos,clasificacion a y b,2002-06-01,28,10,28,10,38
20102,PALCA,estado nutricional en menores de 5 anos,clasificacion a y b,2002-06-01,10,2,10,2,12
21104,PALOS BLANCOS,estado nutricional en menores de 5 anos,clasificacion a y b,2002-06-01,51,15,51,15,66
40802,PAMPA AULLAGAS,estado nutricional en menores de 5 anos,clasificacion a y b,2002-06-01,4,0,4,0,4
70902,PAMPA GRANDE,estado nutricional en menores de 5 anos,clasificacion a y b,2002-06-01,18,6,18,6,24
21802,PAPEL PAMPA,estado nutricional en menores de 5 anos,clasificacion a y b,2002-06-01,7,0,7,0,7
30202,PASORAPA,estado nutricional en menores de 5 anos,clasificacion a y b,2002-06-01,14,2,14,2,16
21305,PATACAMAYA,estado nutricional en menores de 5 anos,clasificacion a y b,2002-06-01,31,1,31,1,32
40602,PAZÑA,estado nutricional en menores de 5 anos,clasificacion a y b,2002-06-01,2,1,2,1,3
20702,PELECHUCO,estado nutricional en menores de 5 anos,clasificacion a y b,2002-06-01,1,2,1,2,3
50403,POCOATA,estado nutricional en menores de 5 anos,clasificacion a y b,2002-06-01,16,20,16,20,36
31203,POCONA,estado nutricional en menores de 5 anos,clasificacion a y b,2002-06-01,10,6,10,6,16
31202,POJO (CBBA),estado nutricional en menores de 5 anos,clasificacion a y b,2002-06-01,54,22,54,22,76
40601,POOPO,estado nutricional en menores de 5 anos,clasificacion a y b,2002-06-01,1,0,1,0,1
51203,PORCO,estado nutricional en menores de 5 anos,clasificacion a y b,2002-06-01,11,10,11,10,21
10103,POROMA,estado nutricional en menores de 5 anos,clasificacion a y b,2002-06-01,40,13,40,13,53
70103,PORONGO,estado nutricional en menores de 5 anos,clasificacion a y b,2002-06-01,35,9,35,9,44
70601,PORTACHUELO,estado nutricional en menores de 5 anos,clasificacion a y b,2002-06-01,69,22,69,22,91
70804,POSTRER VALLE,estado nutricional en menores de 5 anos,clasificacion a y b,2002-06-01,7,8,7,8,15
50101,POTOSI,estado nutricional en menores de 5 anos,clasificacion a y b,2002-06-01,135,27,135,27,162
10302,PRESTO,estado nutricional en menores de 5 anos,clasificacion a y b,2002-06-01,10,5,10,5,15
21201,PUCARANI,estado nutricional en menores de 5 anos,clasificacion a y b,2002-06-01,3,17,3,17,20
20401,PUERTO ACOSTA,estado nutricional en menores de 5 anos,clasificacion a y b,2002-06-01,40,29,40,29,69
20403,PUERTO CARABUCO,estado nutricional en menores de 5 anos,clasificacion a y b,2002-06-01,17,7,17,7,24
90301,PUERTO GONZALO MORENO,estado nutricional en menores de 5 anos,clasificacion a y b,2002-06-01,1,0,1,0,1
21204,PUERTO PEREZ,estado nutricional en menores de 5 anos,clasificacion a y b,2002-06-01,3,6,3,6,9
71402,PUERTO QUIJARRO,estado nutricional en menores de 5 anos,clasificacion a y b,2002-06-01,59,6,59,6,65
90201,PUERTO RICO,estado nutricional en menores de 5 anos,clasificacion a y b,2002-06-01,8,7,8,7,15
71401,PUERTO SUAREZ,estado nutricional en menores de 5 anos,clasificacion a y b,2002-06-01,24,6,24,6,30
31205,PUERTO VILLARROEL,estado nutricional en menores de 5 anos,clasificacion a y b,2002-06-01,110,40,110,40,150
51101,PUNA,estado nutricional en menores de 5 anos,clasificacion a y b,2002-06-01,21,15,21,15,36
31401,PUNATA,estado nutricional en menores de 5 anos,clasificacion a y b,2002-06-01,16,6,16,6,22
20604,QUIABAYA,estado nutricional en menores de 5 anos,clasificacion a y b,2002-06-01,3,3,3,3,6
30901,QUILLACOLLO,estado nutricional en menores de 5 anos,clasificacion a y b,2002-06-01,25,11,25,11,36
21002,QUIME,estado nutricional en menores de 5 anos,clasificacion a y b,2002-06-01,10,36,10,36,46
70904,QUIRUSILLAS,estado nutricional en menores de 5 anos,clasificacion a y b,2002-06-01,1,1,1,1,2
50402,RAVELO,estado nutricional en menores de 5 anos,clasificacion a y b,2002-06-01,13,9,13,9,22
80301,REYES,estado nutricional en menores de 5 anos,clasificacion a y b,2002-06-01,32,5,32,5,37
80201,RIBERALTA,estado nutricional en menores de 5 anos,clasificacion a y b,2002-06-01,183,48,183,48,231
70503,ROBORE,estado nutricional en menores de 5 anos,clasificacion a y b,2002-06-01,64,18,64,18,82
80304,RURRENABAQUE,estado nutricional en menores de 5 anos,clasificacion a y b,2002-06-01,6,1,6,1,7
40901,SABAYA,estado nutricional en menores de 5 anos,clasificacion a y b,2002-06-01,1,1,1,1,2
31001,SACABA,estado nutricional en menores de 5 anos,clasificacion a y b,2002-06-01,49,4,49,4,53
30404,SACABAMBA,estado nutricional en menores de 5 anos,clasificacion a y b,2002-06-01,0,2,0,2,2
50701,SACACA,estado nutricional en menores de 5 anos,clasificacion a y b,2002-06-01,6,2,6,2,8
71302,SAIPINA,estado nutricional en menores de 5 anos,clasificacion a y b,2002-06-01,13,12,13,12,25
40801,SALINAS DE GARCI MENDOZA,estado nutricional en menores de 5 anos,clasificacion a y b,2002-06-01,4,2,4,2,6
70901,SAMAIPATA,estado nutricional en menores de 5 anos,clasificacion a y b,2002-06-01,11,4,11,4,15
51601,SAN AGUSTIN,estado nutricional en menores de 5 anos,clasificacion a y b,2002-06-01,4,0,4,0,4
80602,SAN ANDRES,estado nutricional en menores de 5 anos,clasificacion a y b,2002-06-01,21,10,21,10,31
51003,SAN ANTONIO DE ESMORUCO,estado nutricional en menores de 5 anos,clasificacion a y b,2002-06-01,1,0,1,0,1
71105,SAN ANTONIO DE LOMERIO,estado nutricional en menores de 5 anos,clasificacion a y b,2002-06-01,26,19,26,19,45
31403,SAN BENITO,estado nutricional en menores de 5 anos,clasificacion a y b,2002-06-01,1,5,1,5,6
80302,SAN BORJA,estado nutricional en menores de 5 anos,clasificacion a y b,2002-06-01,119,13,119,13,132
21502,SAN BUENA VENTURA,estado nutricional en menores de 5 anos,clasificacion a y b,2002-06-01,14,5,14,5,19
80501,SAN IGNACIO,estado nutricional en menores de 5 anos,clasificacion a y b,2002-06-01,27,48,27,48,75
70301,SAN IGNACIO DE VELASCO,estado nutricional en menores de 5 anos,clasificacion a y b,2002-06-01,200,16,200,16,216
80102,SAN JAVIER(BNI),estado nutricional en menores de 5 anos,clasificacion a y b,2002-06-01,14,14,14,14,28
71102,SAN JAVIER(STC),estado nutricional en menores de 5 anos,clasificacion a y b,2002-06-01,60,12,60,12,72
80701,SAN JOAQUIN,estado nutricional en menores de 5 anos,clasificacion a y b,2002-06-01,3,29,3,29,32
70501,SAN JOSE DE CHIQUITOS,estado nutricional en menores de 5 anos,clasificacion a y b,2002-06-01,14,4,14,4,18
71104,SAN JULIAN,estado nutricional en menores de 5 anos,clasificacion a y b,2002-06-01,93,78,93,78,171
90302,SAN LORENZO(PND),estado nutricional en menores de 5 anos,clasificacion a y b,2002-06-01,3,4,3,4,7
60501,SAN LORENZO(TJA),estado nutricional en menores de 5 anos,clasificacion a y b,2002-06-01,33,8,33,8,41
10702,SAN LUCAS,estado nutricional en menores de 5 anos,clasificacion a y b,2002-06-01,37,21,37,21,58
71201,SAN MATIAS,estado nutricional en menores de 5 anos,clasificacion a y b,2002-06-01,0,5,0,5,5
70302,SAN MIGUEL DE VELASCO,estado nutricional en menores de 5 anos,clasificacion a y b,2002-06-01,14,4,14,4,18
50501,SAN PEDRO DE BUENA VISTA,estado nutricional en menores de 5 anos,clasificacion a y b,2002-06-01,5,25,5,25,30
21801,SAN PEDRO DE CURAHUARA,estado nutricional en menores de 5 anos,clasificacion a y b,2002-06-01,2,7,2,7,9
50902,SAN PEDRO DE QUEMES,estado nutricional en menores de 5 anos,clasificacion a y b,2002-06-01,0,2,0,2,2
21702,SAN PEDRO DE TIQUINA,estado nutricional en menores de 5 anos,clasificacion a y b,2002-06-01,0,12,0,12,12
90202,SAN PEDRO(PND),estado nutricional en menores de 5 anos,clasificacion a y b,2002-06-01,0,2,0,2,2
70303,SAN RAFAEL,estado nutricional en menores de 5 anos,clasificacion a y b,2002-06-01,13,6,13,6,19
80702,SAN RAMON,estado nutricional en menores de 5 anos,clasificacion a y b,2002-06-01,50,82,50,82,132
80702,SAN RAMON,estado nutricional en menores de 5 anos,clasificacion a y b,2002-06-01,22,14,22,14,36
80401,SANTA ANA,estado nutricional en menores de 5 anos,clasificacion a y b,2002-06-01,13,8,13,8,21
70101,SANTA CRUZ DE LA SIERRA,estado nutricional en menores de 5 anos,clasificacion a y b,2002-06-01,1183,417,1183,417,1600
80303,SANTA ROSA,estado nutricional en menores de 5 anos,clasificacion a y b,2002-06-01,5,2,5,2,7
70602,SANTA ROSA DEL SARA,estado nutricional en menores de 5 anos,clasificacion a y b,2002-06-01,23,31,23,31,54
20308,SANTIAGO DE CALLAPA,estado nutricional en menores de 5 anos,clasificacion a y b,2002-06-01,2,0,2,0,2
41401,SANTIAGO DE HUARI,estado nutricional en menores de 5 anos,clasificacion a y b,2002-06-01,5,1,5,1,6
21901,SANTIAGO DE MACHACA,estado nutricional en menores de 5 anos,clasificacion a y b,2002-06-01,2,0,2,0,2
30702,SANTIVAÑES,estado nutricional en menores de 5 anos,clasificacion a y b,2002-06-01,1,0,1,0,1
40202,SANTUARIO DE QUILLACAS,estado nutricional en menores de 5 anos,clasificacion a y b,2002-06-01,2,1,2,1,3
20902,SAPAHAQUI,estado nutricional en menores de 5 anos,clasificacion a y b,2002-06-01,1,2,1,2,3
90303,SENA,estado nutricional en menores de 5 anos,clasificacion a y b,2002-06-01,16,6,16,6,22
21301,SICA SICA (VILLA AROMA),estado nutricional en menores de 5 anos,clasificacion a y b,2002-06-01,11,9,11,9,20
30703,SICAYA,estado nutricional en menores de 5 anos,clasificacion a y b,2002-06-01,0,3,0,3,3
30902,SIPE SIPE,estado nutricional en menores de 5 anos,clasificacion a y b,2002-06-01,143,33,143,33,176
10403,SOPACHUY,estado nutricional en menores de 5 anos,clasificacion a y b,2002-06-01,12,1,12,1,13
20601,SORATA,estado nutricional en menores de 5 anos,clasificacion a y b,2002-06-01,7,1,7,1,8
10101,SUCRE,estado nutricional en menores de 5 anos,clasificacion a y b,2002-06-01,304,88,304,88,392
31404,TACACHI,estado nutricional en menores de 5 anos,clasificacion a y b,2002-06-01,0,1,0,1,1
20603,TACACOMA,estado nutricional en menores de 5 anos,clasificacion a y b,2002-06-01,19,4,19,4,23
50303,TACOBAMBA,estado nutricional en menores de 5 anos,clasificacion a y b,2002-06-01,15,0,15,0,15
30602,TACOPAYA,estado nutricional en menores de 5 anos,clasificacion a y b,2002-06-01,9,8,9,8,17
51402,TAHUA,estado nutricional en menores de 5 anos,clasificacion a y b,2002-06-01,1,0,1,0,1
31101,TAPACARI,estado nutricional en menores de 5 anos,clasificacion a y b,2002-06-01,6,16,6,16,22
10601,TARABUCO,estado nutricional en menores de 5 anos,clasificacion a y b,2002-06-01,36,15,36,15,51
30401,TARATA,estado nutricional en menores de 5 anos,clasificacion a y b,2002-06-01,13,8,13,8,21
60101,TARIJA,estado nutricional en menores de 5 anos,clasificacion a y b,2002-06-01,376,132,376,132,508
10202,TARVITA,estado nutricional en menores de 5 anos,clasificacion a y b,2002-06-01,39,12,39,12,51
20803,TIAWANACU,estado nutricional en menores de 5 anos,clasificacion a y b,2002-06-01,24,12,24,12,36
50102,TINGUIPAYA,estado nutricional en menores de 5 anos,clasificacion a y b,2002-06-01,5,2,5,2,7
20606,TIPUANI,estado nutricional en menores de 5 anos,clasificacion a y b,2002-06-01,12,11,12,11,23
30903,TIQUIPAYA,estado nutricional en menores de 5 anos,clasificacion a y b,2002-06-01,20,22,20,22,42
31601,TIRAQUE (CBBA),estado nutricional en menores de 5 anos,clasificacion a y b,2002-06-01,58,34,58,34,92
21703,TITO YUPANQUI (PARQUIPUJIO),estado nutricional en menores de 5 anos,clasificacion a y b,2002-06-01,1,4,1,4,5
30802,TOCO,estado nutricional en menores de 5 anos,clasificacion a y b,2002-06-01,2,3,2,3,5
30803,TOLATA,estado nutricional en menores de 5 anos,clasificacion a y b,2002-06-01,3,0,3,0,3
41001,TOLEDO,estado nutricional en menores de 5 anos,clasificacion a y b,2002-06-01,3,2,3,2,5
51202,TOMAVE,estado nutricional en menores de 5 anos,clasificacion a y b,2002-06-01,3,15,3,15,18
10402,TOMINA,estado nutricional en menores de 5 anos,clasificacion a y b,2002-06-01,27,3,27,3,30
50502,TORO TORO,estado nutricional en menores de 5 anos,clasificacion a y b,2002-06-01,0,1,0,1,1
31201,TOTORA(CBBA),estado nutricional en menores de 5 anos,clasificacion a y b,2002-06-01,24,4,24,4,28
41301,TOTORA(ORR),estado nutricional en menores de 5 anos,clasificacion a y b,2002-06-01,5,2,5,2,7
70802,TRIGAL,estado nutricional en menores de 5 anos,clasificacion a y b,2002-06-01,1,1,1,1,2
80101,TRINIDAD,estado nutricional en menores de 5 anos,clasificacion a y b,2002-06-01,180,142,180,142,322
50801,TUPIZA,estado nutricional en menores de 5 anos,clasificacion a y b,2002-06-01,15,67,15,67,82
40402,TURCO,estado nutricional en menores de 5 anos,clasificacion a y b,2002-06-01,1,0,1,0,1
21302,UMALA,estado nutricional en menores de 5 anos,clasificacion a y b,2002-06-01,7,8,7,8,15
50201,UNCIA,estado nutricional en menores de 5 anos,clasificacion a y b,2002-06-01,21,22,21,22,43
60401,URIONDO (A. CONCEPCION),estado nutricional en menores de 5 anos,clasificacion a y b,2002-06-01,27,18,27,18,45
71502,URUBICHA,estado nutricional en menores de 5 anos,clasificacion a y b,2002-06-01,4,10,4,10,14
51201,UYUNI,estado nutricional en menores de 5 anos,clasificacion a y b,2002-06-01,30,38,30,38,68
70801,VALLEGRANDE,estado nutricional en menores de 5 anos,clasificacion a y b,2002-06-01,31,30,31,30,61
20801,VIACHA,estado nutricional en menores de 5 anos,clasificacion a y b,2002-06-01,22,44,22,44,66
31302,VILA VILA,estado nutricional en menores de 5 anos,clasificacion a y b,2002-06-01,5,0,5,0,5
60303,VILLA MONTES,estado nutricional en menores de 5 anos,clasificacion a y b,2002-06-01,34,15,34,15,49
90502,VILLA NUEVA (LOMA ALTA),estado nutricional en menores de 5 anos,clasificacion a y b,2002-06-01,1,0,1,0,1
31402,VILLA RIVERO,estado nutricional en menores de 5 anos,clasificacion a y b,2002-06-01,5,5,5,5,10
10801,VILLA SERRANO,estado nutricional en menores de 5 anos,clasificacion a y b,2002-06-01,16,27,16,27,43
31003,VILLA TUNARI,estado nutricional en menores de 5 anos,clasificacion a y b,2002-06-01,87,21,87,21,108
11001,VILLA VACA GUZMAN (MUYUPAMPA),estado nutricional en menores de 5 anos,clasificacion a y b,2002-06-01,52,29,52,29,81
51501,VILLAZON,estado nutricional en menores de 5 anos,clasificacion a y b,2002-06-01,26,76,26,76,102
30904,VINTO,estado nutricional en menores de 5 anos,clasificacion a y b,2002-06-01,65,4,65,4,69
50602,VITICHI,estado nutricional en menores de 5 anos,clasificacion a y b,2002-06-01,17,5,17,5,22
70201,WARNES,estado nutricional en menores de 5 anos,clasificacion a y b,2002-06-01,108,49,108,49,157
20903,YACO,estado nutricional en menores de 5 anos,clasificacion a y b,2002-06-01,6,12,6,12,18
60301,YACUIBA,estado nutricional en menores de 5 anos,clasificacion a y b,2002-06-01,174,37,174,37,211
10602,YAMPARAEZ,estado nutricional en menores de 5 anos,clasificacion a y b,2002-06-01,33,6,33,6,39
21103,YANACACHI,estado nutricional en menores de 5 anos,clasificacion a y b,2002-06-01,4,5,4,5,9
50103,YOCALLA,estado nutricional en menores de 5 anos,clasificacion a y b,2002-06-01,1,9,1,9,10
10102,YOTALA,estado nutricional en menores de 5 anos,clasificacion a y b,2002-06-01,34,12,34,12,46
60402,YUNCHARA,estado nutricional en menores de 5 anos,clasificacion a y b,2002-06-01,11,5,11,5,16
10301,ZUDAÑEZ,estado nutricional en menores de 5 anos,clasificacion a y b,2002-06-01,16,1,16,1,17
51302,ACACIO,estado nutricional en menores de 5 anos,clasificacion a y b,2002-07-01,2,1,2,1,3
20201,ACHACACHI,estado nutricional en menores de 5 anos,clasificacion a y b,2002-07-01,83,41,83,41,124
20104,ACHOCALLA,estado nutricional en menores de 5 anos,clasificacion a y b,2002-07-01,14,2,14,2,16
30201,AIQUILE,estado nutricional en menores de 5 anos,clasificacion a y b,2002-07-01,10,6,10,6,16
10404,ALCALA,estado nutricional en menores de 5 anos,clasificacion a y b,2002-07-01,14,4,14,4,18
20202,ANCORAIMES,estado nutricional en menores de 5 anos,clasificacion a y b,2002-07-01,16,3,16,3,19
41201,ANDAMARCA,estado nutricional en menores de 5 anos,clasificacion a y b,2002-07-01,1,0,1,0,1
40603,ANTEQUERA,estado nutricional en menores de 5 anos,clasificacion a y b,2002-07-01,0,3,0,3,3
30402,ANZALDO,estado nutricional en menores de 5 anos,clasificacion a y b,2002-07-01,5,12,5,12,17
20701,APOLO,estado nutricional en menores de 5 anos,clasificacion a y b,2002-07-01,31,2,31,2,33
51301,ARAMPAMPA,estado nutricional en menores de 5 anos,clasificacion a y b,2002-07-01,4,6,4,6,10
30501,ARANI,estado nutricional en menores de 5 anos,clasificacion a y b,2002-07-01,2,6,2,6,8
30403,ARBIETO,estado nutricional en menores de 5 anos,clasificacion a y b,2002-07-01,8,4,8,4,12
30601,ARQUE,estado nutricional en menores de 5 anos,clasificacion a y b,2002-07-01,5,3,5,3,8
71501,ASCENCION DE GUARAYOS,estado nutricional en menores de 5 anos,clasificacion a y b,2002-07-01,2,0,2,0,2
50802,ATOCHA,estado nutricional en menores de 5 anos,clasificacion a y b,2002-07-01,3,21,3,21,24
20503,AUCAPATA,estado nutricional en menores de 5 anos,clasificacion a y b,2002-07-01,2,0,2,0,2
20502,AYATA,estado nutricional en menores de 5 anos,clasificacion a y b,2002-07-01,3,0,3,0,3
21303,AYO AYO,estado nutricional en menores de 5 anos,clasificacion a y b,2002-07-01,18,2,18,2,20
30301,AYOPAYA (V. DE INDEPENDENCIA),estado nutricional en menores de 5 anos,clasificacion a y b,2002-07-01,11,4,11,4,15
10201,AZURDUY,estado nutricional en menores de 5 anos,clasificacion a y b,2002-07-01,26,4,26,4,30
21203,BATALLAS,estado nutricional en menores de 5 anos,clasificacion a y b,2002-07-01,36,12,36,12,48
80802,BAURES,estado nutricional en menores de 5 anos,clasificacion a y b,2002-07-01,23,16,23,16,39
50104,BELEN DE URMIRI,estado nutricional en menores de 5 anos,clasificacion a y b,2002-07-01,5,4,5,4,9
90104,BELLA FLOR,estado nutricional en menores de 5 anos,clasificacion a y b,2002-07-01,4,1,4,1,5
60202,BERMEJO,estado nutricional en menores de 5 anos,clasificacion a y b,2002-07-01,19,51,19,51,70
50301,BETANZOS,estado nutricional en menores de 5 anos,clasificacion a y b,2002-07-01,67,25,67,25,92
31501,BOLIVAR,estado nutricional en menores de 5 anos,clasificacion a y b,2002-07-01,8,8,8,8,16
70707,BOYUIBE,estado nutricional en menores de 5 anos,clasificacion a y b,2002-07-01,5,30,5,30,35
70703,CABEZAS,estado nutricional en menores de 5 anos,clasificacion a y b,2002-07-01,54,42,54,42,96
20905,CAIROMA,estado nutricional en menores de 5 anos,clasificacion a y b,2002-07-01,4,8,4,8,12
51102,"CAIZA ""D""",estado nutricional en menores de 5 anos,clasificacion a y b,2002-07-01,22,3,22,3,25
21003,CAJUATA,estado nutricional en menores de 5 anos,clasificacion a y b,2002-07-01,17,4,17,4,21
20303,CALACOTO,estado nutricional en menores de 5 anos,clasificacion a y b,2002-07-01,2,0,2,0,2
21304,CALAMARCA,estado nutricional en menores de 5 anos,clasificacion a y b,2002-07-01,14,2,14,2,16
10701,CAMARGO,estado nutricional en menores de 5 anos,clasificacion a y b,2002-07-01,32,20,32,20,52
10901,CAMATAQUI (C. VILLA ABECIA),estado nutricional en menores de 5 anos,clasificacion a y b,2002-07-01,16,5,16,5,21
70706,CAMIRI,estado nutricional en menores de 5 anos,clasificacion a y b,2002-07-01,56,29,56,29,85
30701,CAPINOTA,estado nutricional en menores de 5 anos,clasificacion a y b,2002-07-01,6,1,6,1,7
20302,CAQUIAVIRI,estado nutricional en menores de 5 anos,clasificacion a y b,2002-07-01,13,7,13,7,20
40102,CARACOLLO,estado nutricional en menores de 5 anos,clasificacion a y b,2002-07-01,21,6,21,6,27
22001,CARANAVI,estado nutricional en menores de 5 anos,clasificacion a y b,2002-07-01,143,40,143,40,183
60302,CARAPARI,estado nutricional en menores de 5 anos,clasificacion a y b,2002-07-01,18,24,18,24,42
50702,CARIPUYO,estado nutricional en menores de 5 anos,clasificacion a y b,2002-07-01,7,1,7,1,8
21803,CHACARILLA,estado nutricional en menores de 5 anos,clasificacion a y b,2002-07-01,4,1,4,1,5
40201,CHALLAPATA,estado nutricional en menores de 5 anos,clasificacion a y b,2002-07-01,11,7,11,7,18
50302,CHAQUI,estado nutricional en menores de 5 anos,clasificacion a y b,2002-07-01,18,0,18,0,18
70702,CHARAGUA,estado nutricional en menores de 5 anos,clasificacion a y b,2002-07-01,42,98,42,98,140
20305,CHARAÑA,estado nutricional en menores de 5 anos,clasificacion a y b,2002-07-01,1,1,1,1,2
50202,CHAYANTA,estado nutricional en menores de 5 anos,clasificacion a y b,2002-07-01,8,6,8,6,14
31204,CHIMORE,estado nutricional en menores de 5 anos,clasificacion a y b,2002-07-01,26,4,26,4,30
40903,CHIPAYA,estado nutricional en menores de 5 anos,clasificacion a y b,2002-07-01,1,1,1,1,2
21101,CHULUMANI (V. DE LA LIBERTAD),estado nutricional en menores de 5 anos,clasificacion a y b,2002-07-01,4,9,4,9,13
20501,CHUMA,estado nutricional en menores de 5 anos,clasificacion a y b,2002-07-01,9,8,9,8,17
30801,CLIZA,estado nutricional en menores de 5 anos,clasificacion a y b,2002-07-01,8,17,8,17,25
90101,COBIJA,estado nutricional en menores de 5 anos,clasificacion a y b,2002-07-01,116,20,116,20,136
30101,COCHABAMBA,estado nutricional en menores de 5 anos,clasificacion a y b,2002-07-01,1469,1135,1469,1135,2604
40902,COIPASA,estado nutricional en menores de 5 anos,clasificacion a y b,2002-07-01,1,0,1,0,1
30905,COLCAPIRHUA,estado nutricional en menores de 5 anos,clasificacion a y b,2002-07-01,29,36,29,36,65
50901,"COLCHA ""K""",estado nutricional en menores de 5 anos,clasificacion a y b,2002-07-01,18,4,18,4,22
21307,COLLANA,estado nutricional en menores de 5 anos,clasificacion a y b,2002-07-01,3,0,3,0,3
31002,COLOMI,estado nutricional en menores de 5 anos,clasificacion a y b,2002-07-01,23,25,23,25,48
50401,COLQUECHACA,estado nutricional en menores de 5 anos,clasificacion a y b,2002-07-01,13,1,13,1,14
21306,COLQUENCHA,estado nutricional en menores de 5 anos,clasificacion a y b,2002-07-01,13,6,13,6,19
21004,COLQUIRI,estado nutricional en menores de 5 anos,clasificacion a y b,2002-07-01,14,3,14,3,17
20304,COMANCHE,estado nutricional en menores de 5 anos,clasificacion a y b,2002-07-01,1,0,1,0,1
71301,COMARAPA,estado nutricional en menores de 5 anos,clasificacion a y b,2002-07-01,87,49,87,49,136
20605,COMBAYA,estado nutricional en menores de 5 anos,clasificacion a y b,2002-07-01,2,1,2,1,3
71101,CONCEPCION,estado nutricional en menores de 5 anos,clasificacion a y b,2002-07-01,21,4,21,4,25
21701,COPACABANA,estado nutricional en menores de 5 anos,clasificacion a y b,2002-07-01,17,5,17,5,22
21402,CORIPATA,estado nutricional en menores de 5 anos,clasificacion a y b,2002-07-01,13,31,13,31,44
20301,CORO CORO,estado nutricional en menores de 5 anos,clasificacion a y b,2002-07-01,16,4,16,4,20
21401,COROICO,estado nutricional en menores de 5 anos,clasificacion a y b,2002-07-01,50,6,50,6,56
40301,CORQUE,estado nutricional en menores de 5 anos,clasificacion a y b,2002-07-01,3,1,3,1,4
50601,COTAGAITA,estado nutricional en menores de 5 anos,clasificacion a y b,2002-07-01,27,17,27,17,44
70102,COTOCA,estado nutricional en menores de 5 anos,clasificacion a y b,2002-07-01,70,13,70,13,83
31405,CUCHUMUELA (V. G. VILLARROEL),estado nutricional en menores de 5 anos,clasificacion a y b,2002-07-01,1,0,1,0,1
70704,CUEVO,estado nutricional en menores de 5 anos,clasificacion a y b,2002-07-01,17,3,17,3,20
10902,CULPINA,estado nutricional en menores de 5 anos,clasificacion a y b,2002-07-01,35,9,35,9,44
40401,CURAHUARA DE CARANGAS,estado nutricional en menores de 5 anos,clasificacion a y b,2002-07-01,2,2,2,2,4
21602,CURVA,estado nutricional en menores de 5 anos,clasificacion a y b,2002-07-01,2,0,2,0,2
20804,DESAGUADERO,estado nutricional en menores de 5 anos,clasificacion a y b,2002-07-01,8,2,8,2,10
20105,EL ALTO,estado nutricional en menores de 5 anos,clasificacion a y b,2002-07-01,649,243,649,243,892
40103,EL CHORO,estado nutricional en menores de 5 anos,clasificacion a y b,2002-07-01,3,0,3,0,3
71503,EL PUENTE(STC),estado nutricional en menores de 5 anos,clasificacion a y b,2002-07-01,8,32,8,32,40
60502,EL PUENTE(TJA),estado nutricional en menores de 5 anos,clasificacion a y b,2002-07-01,4,6,4,6,10
70105,EL TORNO,estado nutricional en menores de 5 anos,clasificacion a y b,2002-07-01,175,68,175,68,243
10405,EL VILLAR,estado nutricional en menores de 5 anos,clasificacion a y b,2002-07-01,17,6,17,6,23
60601,ENTRE RIOS,estado nutricional en menores de 5 anos,clasificacion a y b,2002-07-01,34,13,34,13,47
41101,EUCALIPTUS,estado nutricional en menores de 5 anos,clasificacion a y b,2002-07-01,3,4,3,4,7
80402,EXALTACION,estado nutricional en menores de 5 anos,clasificacion a y b,2002-07-01,2,2,2,2,4
90203,FILADELFIA,estado nutricional en menores de 5 anos,clasificacion a y b,2002-07-01,0,5,0,5,5
71002,GENERAL SAAVEDRA,estado nutricional en menores de 5 anos,clasificacion a y b,2002-07-01,53,36,53,36,89
21601,GRAL. J.J. PEREZ (CHARAZANI),estado nutricional en menores de 5 anos,clasificacion a y b,2002-07-01,0,4,0,4,4
20602,GUANAY,estado nutricional en menores de 5 anos,clasificacion a y b,2002-07-01,150,44,150,44,194
20802,GUAQUI,estado nutricional en menores de 5 anos,clasificacion a y b,2002-07-01,16,3,16,3,19
80202,GUAYARAMERIN,estado nutricional en menores de 5 anos,clasificacion a y b,2002-07-01,75,17,75,17,92
70705,GUTIERREZ,estado nutricional en menores de 5 anos,clasificacion a y b,2002-07-01,47,23,47,23,70
10502,HUACARETA,estado nutricional en menores de 5 anos,clasificacion a y b,2002-07-01,24,27,24,27,51
11002,HUACAYA (VILLA DE HUACAYA),estado nutricional en menores de 5 anos,clasificacion a y b,2002-07-01,4,4,4,4,8
40501,HUACHACALLA,estado nutricional en menores de 5 anos,clasificacion a y b,2002-07-01,1,2,1,2,3
40701,HUANUNI,estado nutricional en menores de 5 anos,clasificacion a y b,2002-07-01,31,8,31,8,39
80803,HUARACAJE,estado nutricional en menores de 5 anos,clasificacion a y b,2002-07-01,21,10,21,10,31
41601,HUAYLLAMARCA,estado nutricional en menores de 5 anos,clasificacion a y b,2002-07-01,3,1,3,1,4
10304,ICLA,estado nutricional en menores de 5 anos,clasificacion a y b,2002-07-01,9,3,9,3,12
10703,INCAHUASI,estado nutricional en menores de 5 anos,clasificacion a y b,2002-07-01,30,5,30,5,35
90402,INGAVI (HUMAITA),estado nutricional en menores de 5 anos,clasificacion a y b,2002-07-01,0,13,0,13,13
21001,INQUISIVI,estado nutricional en menores de 5 anos,clasificacion a y b,2002-07-01,26,6,26,6,32
21102,IRUPANA (VILLA DE LANZA),estado nutricional en menores de 5 anos,clasificacion a y b,2002-07-01,25,47,25,47,72
21501,IXIAMAS,estado nutricional en menores de 5 anos,clasificacion a y b,2002-07-01,18,7,18,7,25
21105,LA ASUNTA,estado nutricional en menores de 5 anos,clasificacion a y b,2002-07-01,26,24,26,24,50
70104,LA GUARDIA,estado nutricional en menores de 5 anos,clasificacion a y b,2002-07-01,188,52,188,52,240
20101,LA PAZ,estado nutricional en menores de 5 anos,clasificacion a y b,2002-07-01,662,230,662,230,892
70701,LAGUNILLAS,estado nutricional en menores de 5 anos,clasificacion a y b,2002-07-01,32,18,32,18,50
21202,LAJA,estado nutricional en menores de 5 anos,clasificacion a y b,2002-07-01,21,7,21,7,28
10903,LAS CARRERAS,estado nutricional en menores de 5 anos,clasificacion a y b,2002-07-01,10,1,10,1,11
21006,LICOMA PAMPA,estado nutricional en menores de 5 anos,clasificacion a y b,2002-07-01,2,2,2,2,4
50203,LLALLAGUA,estado nutricional en menores de 5 anos,clasificacion a y b,2002-07-01,14,97,14,97,111
51401,LLICA,estado nutricional en menores de 5 anos,clasificacion a y b,2002-07-01,5,2,5,2,7
80601,LORETO,estado nutricional en menores de 5 anos,clasificacion a y b,2002-07-01,7,3,7,3,10
20901,LURIBAY,estado nutricional en menores de 5 anos,clasificacion a y b,2002-07-01,5,9,5,9,14
40702,MACHACAMARCA,estado nutricional en menores de 5 anos,clasificacion a y b,2002-07-01,6,2,6,2,8
11003,MACHARETI,estado nutricional en menores de 5 anos,clasificacion a y b,2002-07-01,49,40,49,40,89
80801,MAGDALENA,estado nutricional en menores de 5 anos,clasificacion a y b,2002-07-01,17,5,17,5,22
70903,MAIRANA,estado nutricional en menores de 5 anos,clasificacion a y b,2002-07-01,52,4,52,4,56
20103,MECAPACA,estado nutricional en menores de 5 anos,clasificacion a y b,2002-07-01,3,2,3,2,5
71003,MINEROS,estado nutricional en menores de 5 anos,clasificacion a y b,2002-07-01,123,64,123,64,187
31301,MIZQUE,estado nutricional en menores de 5 anos,clasificacion a y b,2002-07-01,18,7,18,7,25
20402,MOCOMOCO,estado nutricional en menores de 5 anos,clasificacion a y b,2002-07-01,26,6,26,6,32
10303,MOJOCOYA,estado nutricional en menores de 5 anos,clasificacion a y b,2002-07-01,37,6,37,6,43
10501,MONTEAGUDO,estado nutricional en menores de 5 anos,clasificacion a y b,2002-07-01,146,35,146,35,181
71001,MONTERO,estado nutricional en menores de 5 anos,clasificacion a y b,2002-07-01,258,160,258,160,418
70803,MORO MORO,estado nutricional en menores de 5 anos,clasificacion a y b,2002-07-01,2,2,2,2,4
30302,MOROCHATA,estado nutricional en menores de 5 anos,clasificacion a y b,2002-07-01,27,7,27,7,34
90501,NUEVO MANOA (NUEVA ESPERANZA),estado nutricional en menores de 5 anos,clasificacion a y b,2002-07-01,4,3,4,3,7
50404,OCURI,estado nutricional en menores de 5 anos,clasificacion a y b,2002-07-01,18,8,18,8,26
70202,OKINAWA,estado nutricional en menores de 5 anos,clasificacion a y b,2002-07-01,6,2,6,2,8
30203,OMEREQUE,estado nutricional en menores de 5 anos,clasificacion a y b,2002-07-01,0,7,0,7,7
40101,ORURO,estado nutricional en menores de 5 anos,clasificacion a y b,2002-07-01,263,71,263,71,334
60201,PADCAYA,estado nutricional en menores de 5 anos,clasificacion a y b,2002-07-01,36,29,36,29,65
10401,PADILLA,estado nutricional en menores de 5 anos,clasificacion a y b,2002-07-01,46,5,46,5,51
70502,PAILON,estado nutricional en menores de 5 anos,clasificacion a y b,2002-07-01,30,7,30,7,37
20102,PALCA,estado nutricional en menores de 5 anos,clasificacion a y b,2002-07-01,19,5,19,5,24
21104,PALOS BLANCOS,estado nutricional en menores de 5 anos,clasificacion a y b,2002-07-01,58,22,58,22,80
40802,PAMPA AULLAGAS,estado nutricional en menores de 5 anos,clasificacion a y b,2002-07-01,2,0,2,0,2
70902,PAMPA GRANDE,estado nutricional en menores de 5 anos,clasificacion a y b,2002-07-01,30,1,30,1,31
21802,PAPEL PAMPA,estado nutricional en menores de 5 anos,clasificacion a y b,2002-07-01,5,0,5,0,5
30202,PASORAPA,estado nutricional en menores de 5 anos,clasificacion a y b,2002-07-01,11,1,11,1,12
21305,PATACAMAYA,estado nutricional en menores de 5 anos,clasificacion a y b,2002-07-01,37,12,37,12,49
40602,PAZÑA,estado nutricional en menores de 5 anos,clasificacion a y b,2002-07-01,5,2,5,2,7
20702,PELECHUCO,estado nutricional en menores de 5 anos,clasificacion a y b,2002-07-01,0,2,0,2,2
50403,POCOATA,estado nutricional en menores de 5 anos,clasificacion a y b,2002-07-01,22,10,22,10,32
31203,POCONA,estado nutricional en menores de 5 anos,clasificacion a y b,2002-07-01,9,2,9,2,11
31202,POJO (CBBA),estado nutricional en menores de 5 anos,clasificacion a y b,2002-07-01,119,16,119,16,135
40601,POOPO,estado nutricional en menores de 5 anos,clasificacion a y b,2002-07-01,0,2,0,2,2
51203,PORCO,estado nutricional en menores de 5 anos,clasificacion a y b,2002-07-01,19,1,19,1,20
10103,POROMA,estado nutricional en menores de 5 anos,clasificacion a y b,2002-07-01,46,4,46,4,50
70103,PORONGO,estado nutricional en menores de 5 anos,clasificacion a y b,2002-07-01,18,11,18,11,29
70601,PORTACHUELO,estado nutricional en menores de 5 anos,clasificacion a y b,2002-07-01,78,20,78,20,98
70804,POSTRER VALLE,estado nutricional en menores de 5 anos,clasificacion a y b,2002-07-01,7,1,7,1,8
50101,POTOSI,estado nutricional en menores de 5 anos,clasificacion a y b,2002-07-01,165,22,165,22,187
10302,PRESTO,estado nutricional en menores de 5 anos,clasificacion a y b,2002-07-01,19,6,19,6,25
21201,PUCARANI,estado nutricional en menores de 5 anos,clasificacion a y b,2002-07-01,12,7,12,7,19
20401,PUERTO ACOSTA,estado nutricional en menores de 5 anos,clasificacion a y b,2002-07-01,52,29,52,29,81
20403,PUERTO CARABUCO,estado nutricional en menores de 5 anos,clasificacion a y b,2002-07-01,13,5,13,5,18
90301,PUERTO GONZALO MORENO,estado nutricional en menores de 5 anos,clasificacion a y b,2002-07-01,4,1,4,1,5
21204,PUERTO PEREZ,estado nutricional en menores de 5 anos,clasificacion a y b,2002-07-01,6,1,6,1,7
71402,PUERTO QUIJARRO,estado nutricional en menores de 5 anos,clasificacion a y b,2002-07-01,58,9,58,9,67
90201,PUERTO RICO,estado nutricional en menores de 5 anos,clasificacion a y b,2002-07-01,8,5,8,5,13
80703,PUERTO SILES,estado nutricional en menores de 5 anos,clasificacion a y b,2002-07-01,2,7,2,7,9
71401,PUERTO SUAREZ,estado nutricional en menores de 5 anos,clasificacion a y b,2002-07-01,52,12,52,12,64
31205,PUERTO VILLARROEL,estado nutricional en menores de 5 anos,clasificacion a y b,2002-07-01,164,48,164,48,212
51101,PUNA,estado nutricional en menores de 5 anos,clasificacion a y b,2002-07-01,34,45,34,45,79
31401,PUNATA,estado nutricional en menores de 5 anos,clasificacion a y b,2002-07-01,10,5,10,5,15
20604,QUIABAYA,estado nutricional en menores de 5 anos,clasificacion a y b,2002-07-01,4,2,4,2,6
30901,QUILLACOLLO,estado nutricional en menores de 5 anos,clasificacion a y b,2002-07-01,51,18,51,18,69
21002,QUIME,estado nutricional en menores de 5 anos,clasificacion a y b,2002-07-01,14,9,14,9,23
70904,QUIRUSILLAS,estado nutricional en menores de 5 anos,clasificacion a y b,2002-07-01,4,5,4,5,9
50402,RAVELO,estado nutricional en menores de 5 anos,clasificacion a y b,2002-07-01,7,1,7,1,8
80201,RIBERALTA,estado nutricional en menores de 5 anos,clasificacion a y b,2002-07-01,190,35,190,35,225
70503,ROBORE,estado nutricional en menores de 5 anos,clasificacion a y b,2002-07-01,93,33,93,33,126
80304,RURRENABAQUE,estado nutricional en menores de 5 anos,clasificacion a y b,2002-07-01,1,4,1,4,5
40901,SABAYA,estado nutricional en menores de 5 anos,clasificacion a y b,2002-07-01,2,1,2,1,3
31001,SACABA,estado nutricional en menores de 5 anos,clasificacion a y b,2002-07-01,57,18,57,18,75
30404,SACABAMBA,estado nutricional en menores de 5 anos,clasificacion a y b,2002-07-01,2,4,2,4,6
50701,SACACA,estado nutricional en menores de 5 anos,clasificacion a y b,2002-07-01,7,1,7,1,8
71302,SAIPINA,estado nutricional en menores de 5 anos,clasificacion a y b,2002-07-01,19,8,19,8,27
40801,SALINAS DE GARCI MENDOZA,estado nutricional en menores de 5 anos,clasificacion a y b,2002-07-01,1,7,1,7,8
70901,SAMAIPATA,estado nutricional en menores de 5 anos,clasificacion a y b,2002-07-01,27,4,27,4,31
51601,SAN AGUSTIN,estado nutricional en menores de 5 anos,clasificacion a y b,2002-07-01,3,2,3,2,5
80602,SAN ANDRES,estado nutricional en menores de 5 anos,clasificacion a y b,2002-07-01,21,3,21,3,24
71105,SAN ANTONIO DE LOMERIO,estado nutricional en menores de 5 anos,clasificacion a y b,2002-07-01,25,9,25,9,34
31403,SAN BENITO,estado nutricional en menores de 5 anos,clasificacion a y b,2002-07-01,9,2,9,2,11
80302,SAN BORJA,estado nutricional en menores de 5 anos,clasificacion a y b,2002-07-01,87,18,87,18,105
21502,SAN BUENA VENTURA,estado nutricional en menores de 5 anos,clasificacion a y b,2002-07-01,17,4,17,4,21
80501,SAN IGNACIO,estado nutricional en menores de 5 anos,clasificacion a y b,2002-07-01,20,40,20,40,60
70301,SAN IGNACIO DE VELASCO,estado nutricional en menores de 5 anos,clasificacion a y b,2002-07-01,205,14,205,14,219
80102,SAN JAVIER(BNI),estado nutricional en menores de 5 anos,clasificacion a y b,2002-07-01,22,6,22,6,28
71102,SAN JAVIER(STC),estado nutricional en menores de 5 anos,clasificacion a y b,2002-07-01,73,4,73,4,77
80701,SAN JOAQUIN,estado nutricional en menores de 5 anos,clasificacion a y b,2002-07-01,13,17,13,17,30
70501,SAN JOSE DE CHIQUITOS,estado nutricional en menores de 5 anos,clasificacion a y b,2002-07-01,28,2,28,2,30
71104,SAN JULIAN,estado nutricional en menores de 5 anos,clasificacion a y b,2002-07-01,112,61,112,61,173
90302,SAN LORENZO(PND),estado nutricional en menores de 5 anos,clasificacion a y b,2002-07-01,6,7,6,7,13
60501,SAN LORENZO(TJA),estado nutricional en menores de 5 anos,clasificacion a y b,2002-07-01,38,19,38,19,57
10702,SAN LUCAS,estado nutricional en menores de 5 anos,clasificacion a y b,2002-07-01,57,24,57,24,81
71201,SAN MATIAS,estado nutricional en menores de 5 anos,clasificacion a y b,2002-07-01,1,8,1,8,9
70302,SAN MIGUEL DE VELASCO,estado nutricional en menores de 5 anos,clasificacion a y b,2002-07-01,22,17,22,17,39
51001,SAN PABLO DE LIPEZ,estado nutricional en menores de 5 anos,clasificacion a y b,2002-07-01,0,3,0,3,3
50501,SAN PEDRO DE BUENA VISTA,estado nutricional en menores de 5 anos,clasificacion a y b,2002-07-01,1,19,1,19,20
21801,SAN PEDRO DE CURAHUARA,estado nutricional en menores de 5 anos,clasificacion a y b,2002-07-01,3,2,3,2,5
50902,SAN PEDRO DE QUEMES,estado nutricional en menores de 5 anos,clasificacion a y b,2002-07-01,1,0,1,0,1
21702,SAN PEDRO DE TIQUINA,estado nutricional en menores de 5 anos,clasificacion a y b,2002-07-01,4,12,4,12,16
70303,SAN RAFAEL,estado nutricional en menores de 5 anos,clasificacion a y b,2002-07-01,15,7,15,7,22
80702,SAN RAMON,estado nutricional en menores de 5 anos,clasificacion a y b,2002-07-01,26,8,26,8,34
80401,SANTA ANA,estado nutricional en menores de 5 anos,clasificacion a y b,2002-07-01,43,41,43,41,84
70101,SANTA CRUZ DE LA SIERRA,estado nutricional en menores de 5 anos,clasificacion a y b,2002-07-01,1494,601,1494,601,2095
80303,SANTA ROSA,estado nutricional en menores de 5 anos,clasificacion a y b,2002-07-01,6,3,6,3,9
70602,SANTA ROSA DEL SARA,estado nutricional en menores de 5 anos,clasificacion a y b,2002-07-01,16,23,16,23,39
41401,SANTIAGO DE HUARI,estado nutricional en menores de 5 anos,clasificacion a y b,2002-07-01,1,4,1,4,5
21901,SANTIAGO DE MACHACA,estado nutricional en menores de 5 anos,clasificacion a y b,2002-07-01,6,1,6,1,7
30702,SANTIVAÑES,estado nutricional en menores de 5 anos,clasificacion a y b,2002-07-01,4,0,4,0,4
40202,SANTUARIO DE QUILLACAS,estado nutricional en menores de 5 anos,clasificacion a y b,2002-07-01,1,2,1,2,3
20902,SAPAHAQUI,estado nutricional en menores de 5 anos,clasificacion a y b,2002-07-01,1,3,1,3,4
21301,SICA SICA (VILLA AROMA),estado nutricional en menores de 5 anos,clasificacion a y b,2002-07-01,25,1,25,1,26
30703,SICAYA,estado nutricional en menores de 5 anos,clasificacion a y b,2002-07-01,6,0,6,0,6
30902,SIPE SIPE,estado nutricional en menores de 5 anos,clasificacion a y b,2002-07-01,137,32,137,32,169
10403,SOPACHUY,estado nutricional en menores de 5 anos,clasificacion a y b,2002-07-01,17,1,17,1,18
20601,SORATA,estado nutricional en menores de 5 anos,clasificacion a y b,2002-07-01,20,11,20,11,31
10101,SUCRE,estado nutricional en menores de 5 anos,clasificacion a y b,2002-07-01,394,77,394,77,471
20603,TACACOMA,estado nutricional en menores de 5 anos,clasificacion a y b,2002-07-01,3,12,3,12,15
50303,TACOBAMBA,estado nutricional en menores de 5 anos,clasificacion a y b,2002-07-01,13,0,13,0,13
30602,TACOPAYA,estado nutricional en menores de 5 anos,clasificacion a y b,2002-07-01,7,0,7,0,7
31101,TAPACARI,estado nutricional en menores de 5 anos,clasificacion a y b,2002-07-01,2,13,2,13,15
10601,TARABUCO,estado nutricional en menores de 5 anos,clasificacion a y b,2002-07-01,32,11,32,11,43
30401,TARATA,estado nutricional en menores de 5 anos,clasificacion a y b,2002-07-01,18,7,18,7,25
60101,TARIJA,estado nutricional en menores de 5 anos,clasificacion a y b,2002-07-01,337,202,337,202,539
10202,TARVITA,estado nutricional en menores de 5 anos,clasificacion a y b,2002-07-01,26,7,26,7,33
20803,TIAWANACU,estado nutricional en menores de 5 anos,clasificacion a y b,2002-07-01,18,9,18,9,27
50102,TINGUIPAYA,estado nutricional en menores de 5 anos,clasificacion a y b,2002-07-01,1,2,1,2,3
20606,TIPUANI,estado nutricional en menores de 5 anos,clasificacion a y b,2002-07-01,35,9,35,9,44
30903,TIQUIPAYA,estado nutricional en menores de 5 anos,clasificacion a y b,2002-07-01,3,15,3,15,18
31601,TIRAQUE (CBBA),estado nutricional en menores de 5 anos,clasificacion a y b,2002-07-01,62,35,62,35,97
30802,TOCO,estado nutricional en menores de 5 anos,clasificacion a y b,2002-07-01,0,4,0,4,4
30803,TOLATA,estado nutricional en menores de 5 anos,clasificacion a y b,2002-07-01,0,1,0,1,1
41001,TOLEDO,estado nutricional en menores de 5 anos,clasificacion a y b,2002-07-01,8,2,8,2,10
51202,TOMAVE,estado nutricional en menores de 5 anos,clasificacion a y b,2002-07-01,13,9,13,9,22
10402,TOMINA,estado nutricional en menores de 5 anos,clasificacion a y b,2002-07-01,29,7,29,7,36
50502,TORO TORO,estado nutricional en menores de 5 anos,clasificacion a y b,2002-07-01,4,1,4,1,5
31201,TOTORA(CBBA),estado nutricional en menores de 5 anos,clasificacion a y b,2002-07-01,14,7,14,7,21
41301,TOTORA(ORR),estado nutricional en menores de 5 anos,clasificacion a y b,2002-07-01,2,0,2,0,2
70802,TRIGAL,estado nutricional en menores de 5 anos,clasificacion a y b,2002-07-01,3,4,3,4,7
80101,TRINIDAD,estado nutricional en menores de 5 anos,clasificacion a y b,2002-07-01,291,187,291,187,478
50801,TUPIZA,estado nutricional en menores de 5 anos,clasificacion a y b,2002-07-01,22,73,22,73,95
40402,TURCO,estado nutricional en menores de 5 anos,clasificacion a y b,2002-07-01,1,3,1,3,4
21302,UMALA,estado nutricional en menores de 5 anos,clasificacion a y b,2002-07-01,2,14,2,14,16
50201,UNCIA,estado nutricional en menores de 5 anos,clasificacion a y b,2002-07-01,2,5,2,5,7
60401,URIONDO (A. CONCEPCION),estado nutricional en menores de 5 anos,clasificacion a y b,2002-07-01,42,36,42,36,78
51201,UYUNI,estado nutricional en menores de 5 anos,clasificacion a y b,2002-07-01,45,29,45,29,74
70801,VALLEGRANDE,estado nutricional en menores de 5 anos,clasificacion a y b,2002-07-01,39,47,39,47,86
20801,VIACHA,estado nutricional en menores de 5 anos,clasificacion a y b,2002-07-01,59,36,59,36,95
31302,VILA VILA,estado nutricional en menores de 5 anos,clasificacion a y b,2002-07-01,5,1,5,1,6
60303,VILLA MONTES,estado nutricional en menores de 5 anos,clasificacion a y b,2002-07-01,41,20,41,20,61
90502,VILLA NUEVA (LOMA ALTA),estado nutricional en menores de 5 anos,clasificacion a y b,2002-07-01,1,0,1,0,1
31402,VILLA RIVERO,estado nutricional en menores de 5 anos,clasificacion a y b,2002-07-01,9,1,9,1,10
10801,VILLA SERRANO,estado nutricional en menores de 5 anos,clasificacion a y b,2002-07-01,16,22,16,22,38
31003,VILLA TUNARI,estado nutricional en menores de 5 anos,clasificacion a y b,2002-07-01,73,36,73,36,109
11001,VILLA VACA GUZMAN (MUYUPAMPA),estado nutricional en menores de 5 anos,clasificacion a y b,2002-07-01,35,15,35,15,50
51501,VILLAZON,estado nutricional en menores de 5 anos,clasificacion a y b,2002-07-01,40,96,40,96,136
30904,VINTO,estado nutricional en menores de 5 anos,clasificacion a y b,2002-07-01,41,7,41,7,48
50602,VITICHI,estado nutricional en menores de 5 anos,clasificacion a y b,2002-07-01,4,2,4,2,6
20306,WALDO BALLIVIAN,estado nutricional en menores de 5 anos,clasificacion a y b,2002-07-01,1,0,1,0,1
70201,WARNES,estado nutricional en menores de 5 anos,clasificacion a y b,2002-07-01,101,60,101,60,161
20903,YACO,estado nutricional en menores de 5 anos,clasificacion a y b,2002-07-01,0,4,0,4,4
60301,YACUIBA,estado nutricional en menores de 5 anos,clasificacion a y b,2002-07-01,205,32,205,32,237
10602,YAMPARAEZ,estado nutricional en menores de 5 anos,clasificacion a y b,2002-07-01,25,5,25,5,30
21103,YANACACHI,estado nutricional en menores de 5 anos,clasificacion a y b,2002-07-01,12,4,12,4,16
50103,YOCALLA,estado nutricional en menores de 5 anos,clasificacion a y b,2002-07-01,1,8,1,8,9
10102,YOTALA,estado nutricional en menores de 5 anos,clasificacion a y b,2002-07-01,32,11,32,11,43
60402,YUNCHARA,estado nutricional en menores de 5 anos,clasificacion a y b,2002-07-01,12,7,12,7,19
10301,ZUDAÑEZ,estado nutricional en menores de 5 anos,clasificacion a y b,2002-07-01,20,2,20,2,22
51302,ACACIO,estado nutricional en menores de 5 anos,clasificacion a y b,2002-08-01,2,2,2,2,4
20201,ACHACACHI,estado nutricional en menores de 5 anos,clasificacion a y b,2002-08-01,93,38,93,38,131
20104,ACHOCALLA,estado nutricional en menores de 5 anos,clasificacion a y b,2002-08-01,20,3,20,3,23
30201,AIQUILE,estado nutricional en menores de 5 anos,clasificacion a y b,2002-08-01,8,2,8,2,10
10404,ALCALA,estado nutricional en menores de 5 anos,clasificacion a y b,2002-08-01,13,3,13,3,16
20202,ANCORAIMES,estado nutricional en menores de 5 anos,clasificacion a y b,2002-08-01,26,8,26,8,34
30402,ANZALDO,estado nutricional en menores de 5 anos,clasificacion a y b,2002-08-01,1,8,1,8,9
20701,APOLO,estado nutricional en menores de 5 anos,clasificacion a y b,2002-08-01,6,11,6,11,17
51301,ARAMPAMPA,estado nutricional en menores de 5 anos,clasificacion a y b,2002-08-01,1,0,1,0,1
30403,ARBIETO,estado nutricional en menores de 5 anos,clasificacion a y b,2002-08-01,5,9,5,9,14
30601,ARQUE,estado nutricional en menores de 5 anos,clasificacion a y b,2002-08-01,1,4,1,4,5
71501,ASCENCION DE GUARAYOS,estado nutricional en menores de 5 anos,clasificacion a y b,2002-08-01,77,24,77,24,101
50802,ATOCHA,estado nutricional en menores de 5 anos,clasificacion a y b,2002-08-01,1,4,1,4,5
20503,AUCAPATA,estado nutricional en menores de 5 anos,clasificacion a y b,2002-08-01,35,2,35,2,37
20502,AYATA,estado nutricional en menores de 5 anos,clasificacion a y b,2002-08-01,3,0,3,0,3
21303,AYO AYO,estado nutricional en menores de 5 anos,clasificacion a y b,2002-08-01,16,4,16,4,20
30301,AYOPAYA (V. DE INDEPENDENCIA),estado nutricional en menores de 5 anos,clasificacion a y b,2002-08-01,24,2,24,2,26
10201,AZURDUY,estado nutricional en menores de 5 anos,clasificacion a y b,2002-08-01,29,4,29,4,33
21203,BATALLAS,estado nutricional en menores de 5 anos,clasificacion a y b,2002-08-01,20,6,20,6,26
80802,BAURES,estado nutricional en menores de 5 anos,clasificacion a y b,2002-08-01,12,1,12,1,13
50104,BELEN DE URMIRI,estado nutricional en menores de 5 anos,clasificacion a y b,2002-08-01,5,0,5,0,5
60202,BERMEJO,estado nutricional en menores de 5 anos,clasificacion a y b,2002-08-01,14,49,14,49,63
50301,BETANZOS,estado nutricional en menores de 5 anos,clasificacion a y b,2002-08-01,30,8,30,8,38
31501,BOLIVAR,estado nutricional en menores de 5 anos,clasificacion a y b,2002-08-01,1,1,1,1,2
70707,BOYUIBE,estado nutricional en menores de 5 anos,clasificacion a y b,2002-08-01,7,8,7,8,15
70703,CABEZAS,estado nutricional en menores de 5 anos,clasificacion a y b,2002-08-01,51,31,51,31,82
20905,CAIROMA,estado nutricional en menores de 5 anos,clasificacion a y b,2002-08-01,16,5,16,5,21
51102,"CAIZA ""D""",estado nutricional en menores de 5 anos,clasificacion a y b,2002-08-01,19,0,19,0,19
21003,CAJUATA,estado nutricional en menores de 5 anos,clasificacion a y b,2002-08-01,12,4,12,4,16
20303,CALACOTO,estado nutricional en menores de 5 anos,clasificacion a y b,2002-08-01,6,0,6,0,6
21304,CALAMARCA,estado nutricional en menores de 5 anos,clasificacion a y b,2002-08-01,21,4,21,4,25
10701,CAMARGO,estado nutricional en menores de 5 anos,clasificacion a y b,2002-08-01,11,3,11,3,14
10901,CAMATAQUI (C. VILLA ABECIA),estado nutricional en menores de 5 anos,clasificacion a y b,2002-08-01,17,8,17,8,25
70706,CAMIRI,estado nutricional en menores de 5 anos,clasificacion a y b,2002-08-01,52,49,52,49,101
30701,CAPINOTA,estado nutricional en menores de 5 anos,clasificacion a y b,2002-08-01,8,5,8,5,13
20302,CAQUIAVIRI,estado nutricional en menores de 5 anos,clasificacion a y b,2002-08-01,7,5,7,5,12
40102,CARACOLLO,estado nutricional en menores de 5 anos,clasificacion a y b,2002-08-01,10,2,10,2,12
22001,CARANAVI,estado nutricional en menores de 5 anos,clasificacion a y b,2002-08-01,137,52,137,52,189
60302,CARAPARI,estado nutricional en menores de 5 anos,clasificacion a y b,2002-08-01,24,44,24,44,68
50702,CARIPUYO,estado nutricional en menores de 5 anos,clasificacion a y b,2002-08-01,5,2,5,2,7
40201,CHALLAPATA,estado nutricional en menores de 5 anos,clasificacion a y b,2002-08-01,16,12,16,12,28
50302,CHAQUI,estado nutricional en menores de 5 anos,clasificacion a y b,2002-08-01,9,2,9,2,11
70702,CHARAGUA,estado nutricional en menores de 5 anos,clasificacion a y b,2002-08-01,41,66,41,66,107
20305,CHARAÑA,estado nutricional en menores de 5 anos,clasificacion a y b,2002-08-01,3,0,3,0,3
31204,CHIMORE,estado nutricional en menores de 5 anos,clasificacion a y b,2002-08-01,34,19,34,19,53
21101,CHULUMANI (V. DE LA LIBERTAD),estado nutricional en menores de 5 anos,clasificacion a y b,2002-08-01,15,1,15,1,16
20501,CHUMA,estado nutricional en menores de 5 anos,clasificacion a y b,2002-08-01,13,1,13,1,14
30801,CLIZA,estado nutricional en menores de 5 anos,clasificacion a y b,2002-08-01,7,10,7,10,17
90101,COBIJA,estado nutricional en menores de 5 anos,clasificacion a y b,2002-08-01,149,22,149,22,171
30101,COCHABAMBA,estado nutricional en menores de 5 anos,clasificacion a y b,2002-08-01,1046,1205,1046,1205,2251
40902,COIPASA,estado nutricional en menores de 5 anos,clasificacion a y b,2002-08-01,2,0,2,0,2
30905,COLCAPIRHUA,estado nutricional en menores de 5 anos,clasificacion a y b,2002-08-01,54,5,54,5,59
50901,"COLCHA ""K""",estado nutricional en menores de 5 anos,clasificacion a y b,2002-08-01,18,8,18,8,26
31002,COLOMI,estado nutricional en menores de 5 anos,clasificacion a y b,2002-08-01,12,4,12,4,16
50401,COLQUECHACA,estado nutricional en menores de 5 anos,clasificacion a y b,2002-08-01,21,9,21,9,30
21306,COLQUENCHA,estado nutricional en menores de 5 anos,clasificacion a y b,2002-08-01,21,10,21,10,31
21004,COLQUIRI,estado nutricional en menores de 5 anos,clasificacion a y b,2002-08-01,11,6,11,6,17
20304,COMANCHE,estado nutricional en menores de 5 anos,clasificacion a y b,2002-08-01,3,0,3,0,3
71301,COMARAPA,estado nutricional en menores de 5 anos,clasificacion a y b,2002-08-01,73,16,73,16,89
20605,COMBAYA,estado nutricional en menores de 5 anos,clasificacion a y b,2002-08-01,4,0,4,0,4
71101,CONCEPCION,estado nutricional en menores de 5 anos,clasificacion a y b,2002-08-01,13,1,13,1,14
21701,COPACABANA,estado nutricional en menores de 5 anos,clasificacion a y b,2002-08-01,12,1,12,1,13
21402,CORIPATA,estado nutricional en menores de 5 anos,clasificacion a y b,2002-08-01,43,11,43,11,54
20301,CORO CORO,estado nutricional en menores de 5 anos,clasificacion a y b,2002-08-01,15,6,15,6,21
21401,COROICO,estado nutricional en menores de 5 anos,clasificacion a y b,2002-08-01,3,7,3,7,10
40301,CORQUE,estado nutricional en menores de 5 anos,clasificacion a y b,2002-08-01,5,0,5,0,5
50601,COTAGAITA,estado nutricional en menores de 5 anos,clasificacion a y b,2002-08-01,25,24,25,24,49
70102,COTOCA,estado nutricional en menores de 5 anos,clasificacion a y b,2002-08-01,91,18,91,18,109
70704,CUEVO,estado nutricional en menores de 5 anos,clasificacion a y b,2002-08-01,11,3,11,3,14
10902,CULPINA,estado nutricional en menores de 5 anos,clasificacion a y b,2002-08-01,41,12,41,12,53
40401,CURAHUARA DE CARANGAS,estado nutricional en menores de 5 anos,clasificacion a y b,2002-08-01,0,2,0,2,2
20804,DESAGUADERO,estado nutricional en menores de 5 anos,clasificacion a y b,2002-08-01,4,9,4,9,13
20105,EL ALTO,estado nutricional en menores de 5 anos,clasificacion a y b,2002-08-01,543,219,543,219,762
40103,EL CHORO,estado nutricional en menores de 5 anos,clasificacion a y b,2002-08-01,3,2,3,2,5
71503,EL PUENTE(STC),estado nutricional en menores de 5 anos,clasificacion a y b,2002-08-01,9,39,9,39,48
60502,EL PUENTE(TJA),estado nutricional en menores de 5 anos,clasificacion a y b,2002-08-01,7,2,7,2,9
70105,EL TORNO,estado nutricional en menores de 5 anos,clasificacion a y b,2002-08-01,113,27,113,27,140
10405,EL VILLAR,estado nutricional en menores de 5 anos,clasificacion a y b,2002-08-01,13,4,13,4,17
60601,ENTRE RIOS,estado nutricional en menores de 5 anos,clasificacion a y b,2002-08-01,38,20,38,20,58
41101,EUCALIPTUS,estado nutricional en menores de 5 anos,clasificacion a y b,2002-08-01,19,1,19,1,20
90503,EUREKA (SANTOS MERCADO),estado nutricional en menores de 5 anos,clasificacion a y b,2002-08-01,0,7,0,7,7
80402,EXALTACION,estado nutricional en menores de 5 anos,clasificacion a y b,2002-08-01,6,11,6,11,17
90203,FILADELFIA,estado nutricional en menores de 5 anos,clasificacion a y b,2002-08-01,2,8,2,8,10
71002,GENERAL SAAVEDRA,estado nutricional en menores de 5 anos,clasificacion a y b,2002-08-01,55,28,55,28,83
21601,GRAL. J.J. PEREZ (CHARAZANI),estado nutricional en menores de 5 anos,clasificacion a y b,2002-08-01,0,3,0,3,3
20602,GUANAY,estado nutricional en menores de 5 anos,clasificacion a y b,2002-08-01,119,44,119,44,163
20802,GUAQUI,estado nutricional en menores de 5 anos,clasificacion a y b,2002-08-01,4,4,4,4,8
80202,GUAYARAMERIN,estado nutricional en menores de 5 anos,clasificacion a y b,2002-08-01,99,30,99,30,129
70705,GUTIERREZ,estado nutricional en menores de 5 anos,clasificacion a y b,2002-08-01,69,22,69,22,91
10502,HUACARETA,estado nutricional en menores de 5 anos,clasificacion a y b,2002-08-01,37,9,37,9,46
11002,HUACAYA (VILLA DE HUACAYA),estado nutricional en menores de 5 anos,clasificacion a y b,2002-08-01,5,2,5,2,7
40501,HUACHACALLA,estado nutricional en menores de 5 anos,clasificacion a y b,2002-08-01,3,2,3,2,5
40701,HUANUNI,estado nutricional en menores de 5 anos,clasificacion a y b,2002-08-01,16,7,16,7,23
41601,HUAYLLAMARCA,estado nutricional en menores de 5 anos,clasificacion a y b,2002-08-01,5,2,5,2,7
21005,ICHOCA,estado nutricional en menores de 5 anos,clasificacion a y b,2002-08-01,4,1,4,1,5
10304,ICLA,estado nutricional en menores de 5 anos,clasificacion a y b,2002-08-01,10,5,10,5,15
10703,INCAHUASI,estado nutricional en menores de 5 anos,clasificacion a y b,2002-08-01,47,19,47,19,66
21001,INQUISIVI,estado nutricional en menores de 5 anos,clasificacion a y b,2002-08-01,19,4,19,4,23
21102,IRUPANA (VILLA DE LANZA),estado nutricional en menores de 5 anos,clasificacion a y b,2002-08-01,21,27,21,27,48
21501,IXIAMAS,estado nutricional en menores de 5 anos,clasificacion a y b,2002-08-01,19,14,19,14,33
21105,LA ASUNTA,estado nutricional en menores de 5 anos,clasificacion a y b,2002-08-01,44,21,44,21,65
70104,LA GUARDIA,estado nutricional en menores de 5 anos,clasificacion a y b,2002-08-01,163,34,163,34,197
20101,LA PAZ,estado nutricional en menores de 5 anos,clasificacion a y b,2002-08-01,580,411,580,411,991
70701,LAGUNILLAS,estado nutricional en menores de 5 anos,clasificacion a y b,2002-08-01,24,3,24,3,27
21202,LAJA,estado nutricional en menores de 5 anos,clasificacion a y b,2002-08-01,21,3,21,3,24
10903,LAS CARRERAS,estado nutricional en menores de 5 anos,clasificacion a y b,2002-08-01,12,6,12,6,18
21006,LICOMA PAMPA,estado nutricional en menores de 5 anos,clasificacion a y b,2002-08-01,1,0,1,0,1
51401,LLICA,estado nutricional en menores de 5 anos,clasificacion a y b,2002-08-01,6,3,6,3,9
80601,LORETO,estado nutricional en menores de 5 anos,clasificacion a y b,2002-08-01,4,7,4,7,11
20901,LURIBAY,estado nutricional en menores de 5 anos,clasificacion a y b,2002-08-01,5,0,5,0,5
40702,MACHACAMARCA,estado nutricional en menores de 5 anos,clasificacion a y b,2002-08-01,4,4,4,4,8
11003,MACHARETI,estado nutricional en menores de 5 anos,clasificacion a y b,2002-08-01,49,26,49,26,75
80801,MAGDALENA,estado nutricional en menores de 5 anos,clasificacion a y b,2002-08-01,19,8,19,8,27
70903,MAIRANA,estado nutricional en menores de 5 anos,clasificacion a y b,2002-08-01,56,3,56,3,59
20103,MECAPACA,estado nutricional en menores de 5 anos,clasificacion a y b,2002-08-01,3,2,3,2,5
71003,MINEROS,estado nutricional en menores de 5 anos,clasificacion a y b,2002-08-01,84,50,84,50,134
31301,MIZQUE,estado nutricional en menores de 5 anos,clasificacion a y b,2002-08-01,10,2,10,2,12
20402,MOCOMOCO,estado nutricional en menores de 5 anos,clasificacion a y b,2002-08-01,27,4,27,4,31
10303,MOJOCOYA,estado nutricional en menores de 5 anos,clasificacion a y b,2002-08-01,31,10,31,10,41
10501,MONTEAGUDO,estado nutricional en menores de 5 anos,clasificacion a y b,2002-08-01,123,29,123,29,152
71001,MONTERO,estado nutricional en menores de 5 anos,clasificacion a y b,2002-08-01,514,63,514,63,577
70803,MORO MORO,estado nutricional en menores de 5 anos,clasificacion a y b,2002-08-01,4,2,4,2,6
30302,MOROCHATA,estado nutricional en menores de 5 anos,clasificacion a y b,2002-08-01,34,37,34,37,71
90401,NACEBE (SANTA ROSA DEL ABUNA),estado nutricional en menores de 5 anos,clasificacion a y b,2002-08-01,1,0,1,0,1
20307,NAZACARA DE PACAJES,estado nutricional en menores de 5 anos,clasificacion a y b,2002-08-01,2,0,2,0,2
90501,NUEVO MANOA (NUEVA ESPERANZA),estado nutricional en menores de 5 anos,clasificacion a y b,2002-08-01,2,1,2,1,3
50404,OCURI,estado nutricional en menores de 5 anos,clasificacion a y b,2002-08-01,13,6,13,6,19
70202,OKINAWA,estado nutricional en menores de 5 anos,clasificacion a y b,2002-08-01,23,3,23,3,26
30203,OMEREQUE,estado nutricional en menores de 5 anos,clasificacion a y b,2002-08-01,8,24,8,24,32
40101,ORURO,estado nutricional en menores de 5 anos,clasificacion a y b,2002-08-01,246,39,246,39,285
60201,PADCAYA,estado nutricional en menores de 5 anos,clasificacion a y b,2002-08-01,23,30,23,30,53
10401,PADILLA,estado nutricional en menores de 5 anos,clasificacion a y b,2002-08-01,49,7,49,7,56
70502,PAILON,estado nutricional en menores de 5 anos,clasificacion a y b,2002-08-01,24,36,24,36,60
20102,PALCA,estado nutricional en menores de 5 anos,clasificacion a y b,2002-08-01,34,6,34,6,40
21104,PALOS BLANCOS,estado nutricional en menores de 5 anos,clasificacion a y b,2002-08-01,56,43,56,43,99
40802,PAMPA AULLAGAS,estado nutricional en menores de 5 anos,clasificacion a y b,2002-08-01,5,0,5,0,5
70902,PAMPA GRANDE,estado nutricional en menores de 5 anos,clasificacion a y b,2002-08-01,21,4,21,4,25
21802,PAPEL PAMPA,estado nutricional en menores de 5 anos,clasificacion a y b,2002-08-01,3,0,3,0,3
30202,PASORAPA,estado nutricional en menores de 5 anos,clasificacion a y b,2002-08-01,14,0,14,0,14
21305,PATACAMAYA,estado nutricional en menores de 5 anos,clasificacion a y b,2002-08-01,28,5,28,5,33
40602,PAZÑA,estado nutricional en menores de 5 anos,clasificacion a y b,2002-08-01,4,1,4,1,5
20702,PELECHUCO,estado nutricional en menores de 5 anos,clasificacion a y b,2002-08-01,1,0,1,0,1
50403,POCOATA,estado nutricional en menores de 5 anos,clasificacion a y b,2002-08-01,34,12,34,12,46
31203,POCONA,estado nutricional en menores de 5 anos,clasificacion a y b,2002-08-01,13,4,13,4,17
31202,POJO (CBBA),estado nutricional en menores de 5 anos,clasificacion a y b,2002-08-01,119,24,119,24,143
51203,PORCO,estado nutricional en menores de 5 anos,clasificacion a y b,2002-08-01,9,1,9,1,10
10103,POROMA,estado nutricional en menores de 5 anos,clasificacion a y b,2002-08-01,43,55,43,55,98
70103,PORONGO,estado nutricional en menores de 5 anos,clasificacion a y b,2002-08-01,23,14,23,14,37
70601,PORTACHUELO,estado nutricional en menores de 5 anos,clasificacion a y b,2002-08-01,37,16,37,16,53
70804,POSTRER VALLE,estado nutricional en menores de 5 anos,clasificacion a y b,2002-08-01,12,1,12,1,13
50101,POTOSI,estado nutricional en menores de 5 anos,clasificacion a y b,2002-08-01,150,20,150,20,170
10302,PRESTO,estado nutricional en menores de 5 anos,clasificacion a y b,2002-08-01,10,7,10,7,17
70805,PUCARA,estado nutricional en menores de 5 anos,clasificacion a y b,2002-08-01,2,0,2,0,2
21201,PUCARANI,estado nutricional en menores de 5 anos,clasificacion a y b,2002-08-01,27,7,27,7,34
20401,PUERTO ACOSTA,estado nutricional en menores de 5 anos,clasificacion a y b,2002-08-01,44,27,44,27,71
20403,PUERTO CARABUCO,estado nutricional en menores de 5 anos,clasificacion a y b,2002-08-01,26,3,26,3,29
21204,PUERTO PEREZ,estado nutricional en menores de 5 anos,clasificacion a y b,2002-08-01,9,2,9,2,11
71402,PUERTO QUIJARRO,estado nutricional en menores de 5 anos,clasificacion a y b,2002-08-01,55,10,55,10,65
90201,PUERTO RICO,estado nutricional en menores de 5 anos,clasificacion a y b,2002-08-01,5,0,5,0,5
80703,PUERTO SILES,estado nutricional en menores de 5 anos,clasificacion a y b,2002-08-01,3,4,3,4,7
71401,PUERTO SUAREZ,estado nutricional en menores de 5 anos,clasificacion a y b,2002-08-01,34,14,34,14,48
31205,PUERTO VILLARROEL,estado nutricional en menores de 5 anos,clasificacion a y b,2002-08-01,158,52,158,52,210
51101,PUNA,estado nutricional en menores de 5 anos,clasificacion a y b,2002-08-01,25,13,25,13,38
20604,QUIABAYA,estado nutricional en menores de 5 anos,clasificacion a y b,2002-08-01,6,1,6,1,7
30901,QUILLACOLLO,estado nutricional en menores de 5 anos,clasificacion a y b,2002-08-01,39,8,39,8,47
21002,QUIME,estado nutricional en menores de 5 anos,clasificacion a y b,2002-08-01,11,1,11,1,12
70904,QUIRUSILLAS,estado nutricional en menores de 5 anos,clasificacion a y b,2002-08-01,4,11,4,11,15
50402,RAVELO,estado nutricional en menores de 5 anos,clasificacion a y b,2002-08-01,13,2,13,2,15
80301,REYES,estado nutricional en menores de 5 anos,clasificacion a y b,2002-08-01,10,1,10,1,11
80201,RIBERALTA,estado nutricional en menores de 5 anos,clasificacion a y b,2002-08-01,218,31,218,31,249
70503,ROBORE,estado nutricional en menores de 5 anos,clasificacion a y b,2002-08-01,43,9,43,9,52
80304,RURRENABAQUE,estado nutricional en menores de 5 anos,clasificacion a y b,2002-08-01,3,10,3,10,13
31001,SACABA,estado nutricional en menores de 5 anos,clasificacion a y b,2002-08-01,34,8,34,8,42
30404,SACABAMBA,estado nutricional en menores de 5 anos,clasificacion a y b,2002-08-01,0,2,0,2,2
50701,SACACA,estado nutricional en menores de 5 anos,clasificacion a y b,2002-08-01,3,0,3,0,3
71302,SAIPINA,estado nutricional en menores de 5 anos,clasificacion a y b,2002-08-01,26,16,26,16,42
40801,SALINAS DE GARCI MENDOZA,estado nutricional en menores de 5 anos,clasificacion a y b,2002-08-01,6,0,6,0,6
70901,SAMAIPATA,estado nutricional en menores de 5 anos,clasificacion a y b,2002-08-01,29,4,29,4,33
51601,SAN AGUSTIN,estado nutricional en menores de 5 anos,clasificacion a y b,2002-08-01,4,0,4,0,4
80602,SAN ANDRES,estado nutricional en menores de 5 anos,clasificacion a y b,2002-08-01,21,9,21,9,30
71105,SAN ANTONIO DE LOMERIO,estado nutricional en menores de 5 anos,clasificacion a y b,2002-08-01,23,11,23,11,34
80302,SAN BORJA,estado nutricional en menores de 5 anos,clasificacion a y b,2002-08-01,91,39,91,39,130
21502,SAN BUENA VENTURA,estado nutricional en menores de 5 anos,clasificacion a y b,2002-08-01,10,2,10,2,12
80501,SAN IGNACIO,estado nutricional en menores de 5 anos,clasificacion a y b,2002-08-01,59,38,59,38,97
70301,SAN IGNACIO DE VELASCO,estado nutricional en menores de 5 anos,clasificacion a y b,2002-08-01,176,11,176,11,187
80102,SAN JAVIER(BNI),estado nutricional en menores de 5 anos,clasificacion a y b,2002-08-01,6,6,6,6,12
71102,SAN JAVIER(STC),estado nutricional en menores de 5 anos,clasificacion a y b,2002-08-01,50,1,50,1,51
80701,SAN JOAQUIN,estado nutricional en menores de 5 anos,clasificacion a y b,2002-08-01,11,12,11,12,23
70501,SAN JOSE DE CHIQUITOS,estado nutricional en menores de 5 anos,clasificacion a y b,2002-08-01,25,7,25,7,32
71104,SAN JULIAN,estado nutricional en menores de 5 anos,clasificacion a y b,2002-08-01,138,65,138,65,203
90302,SAN LORENZO(PND),estado nutricional en menores de 5 anos,clasificacion a y b,2002-08-01,1,0,1,0,1
60501,SAN LORENZO(TJA),estado nutricional en menores de 5 anos,clasificacion a y b,2002-08-01,5,0,5,0,5
10702,SAN LUCAS,estado nutricional en menores de 5 anos,clasificacion a y b,2002-08-01,62,27,62,27,89
71201,SAN MATIAS,estado nutricional en menores de 5 anos,clasificacion a y b,2002-08-01,39,8,39,8,47
70302,SAN MIGUEL DE VELASCO,estado nutricional en menores de 5 anos,clasificacion a y b,2002-08-01,19,2,19,2,21
50501,SAN PEDRO DE BUENA VISTA,estado nutricional en menores de 5 anos,clasificacion a y b,2002-08-01,9,13,9,13,22
21801,SAN PEDRO DE CURAHUARA,estado nutricional en menores de 5 anos,clasificacion a y b,2002-08-01,3,0,3,0,3
21702,SAN PEDRO DE TIQUINA,estado nutricional en menores de 5 anos,clasificacion a y b,2002-08-01,0,9,0,9,9
90202,SAN PEDRO(PND),estado nutricional en menores de 5 anos,clasificacion a y b,2002-08-01,1,0,1,0,1
70303,SAN RAFAEL,estado nutricional en menores de 5 anos,clasificacion a y b,2002-08-01,22,4,22,4,26
80702,SAN RAMON,estado nutricional en menores de 5 anos,clasificacion a y b,2002-08-01,38,26,38,26,64
80401,SANTA ANA,estado nutricional en menores de 5 anos,clasificacion a y b,2002-08-01,16,0,16,0,16
70101,SANTA CRUZ DE LA SIERRA,estado nutricional en menores de 5 anos,clasificacion a y b,2002-08-01,1315,766,1315,766,2081
80303,SANTA ROSA,estado nutricional en menores de 5 anos,clasificacion a y b,2002-08-01,7,8,7,8,15
70602,SANTA ROSA DEL SARA,estado nutricional en menores de 5 anos,clasificacion a y b,2002-08-01,26,16,26,16,42
20308,SANTIAGO DE CALLAPA,estado nutricional en menores de 5 anos,clasificacion a y b,2002-08-01,2,1,2,1,3
41401,SANTIAGO DE HUARI,estado nutricional en menores de 5 anos,clasificacion a y b,2002-08-01,3,5,3,5,8
21901,SANTIAGO DE MACHACA,estado nutricional en menores de 5 anos,clasificacion a y b,2002-08-01,1,2,1,2,3
30702,SANTIVAÑES,estado nutricional en menores de 5 anos,clasificacion a y b,2002-08-01,5,0,5,0,5
40202,SANTUARIO DE QUILLACAS,estado nutricional en menores de 5 anos,clasificacion a y b,2002-08-01,3,0,3,0,3
20902,SAPAHAQUI,estado nutricional en menores de 5 anos,clasificacion a y b,2002-08-01,3,0,3,0,3
21301,SICA SICA (VILLA AROMA),estado nutricional en menores de 5 anos,clasificacion a y b,2002-08-01,17,3,17,3,20
30703,SICAYA,estado nutricional en menores de 5 anos,clasificacion a y b,2002-08-01,3,0,3,0,3
30902,SIPE SIPE,estado nutricional en menores de 5 anos,clasificacion a y b,2002-08-01,86,34,86,34,120
10403,SOPACHUY,estado nutricional en menores de 5 anos,clasificacion a y b,2002-08-01,21,2,21,2,23
20601,SORATA,estado nutricional en menores de 5 anos,clasificacion a y b,2002-08-01,21,3,21,3,24
10101,SUCRE,estado nutricional en menores de 5 anos,clasificacion a y b,2002-08-01,353,124,353,124,477
20603,TACACOMA,estado nutricional en menores de 5 anos,clasificacion a y b,2002-08-01,19,7,19,7,26
50303,TACOBAMBA,estado nutricional en menores de 5 anos,clasificacion a y b,2002-08-01,14,0,14,0,14
30602,TACOPAYA,estado nutricional en menores de 5 anos,clasificacion a y b,2002-08-01,1,0,1,0,1
51402,TAHUA,estado nutricional en menores de 5 anos,clasificacion a y b,2002-08-01,0,1,0,1,1
31101,TAPACARI,estado nutricional en menores de 5 anos,clasificacion a y b,2002-08-01,18,14,18,14,32
10601,TARABUCO,estado nutricional en menores de 5 anos,clasificacion a y b,2002-08-01,49,13,49,13,62
30401,TARATA,estado nutricional en menores de 5 anos,clasificacion a y b,2002-08-01,19,4,19,4,23
60101,TARIJA,estado nutricional en menores de 5 anos,clasificacion a y b,2002-08-01,307,142,307,142,449
10202,TARVITA,estado nutricional en menores de 5 anos,clasificacion a y b,2002-08-01,19,4,19,4,23
20803,TIAWANACU,estado nutricional en menores de 5 anos,clasificacion a y b,2002-08-01,36,5,36,5,41
50102,TINGUIPAYA,estado nutricional en menores de 5 anos,clasificacion a y b,2002-08-01,9,0,9,0,9
20606,TIPUANI,estado nutricional en menores de 5 anos,clasificacion a y b,2002-08-01,40,7,40,7,47
30903,TIQUIPAYA,estado nutricional en menores de 5 anos,clasificacion a y b,2002-08-01,13,9,13,9,22
31601,TIRAQUE (CBBA),estado nutricional en menores de 5 anos,clasificacion a y b,2002-08-01,103,17,103,17,120
30802,TOCO,estado nutricional en menores de 5 anos,clasificacion a y b,2002-08-01,0,1,0,1,1
41001,TOLEDO,estado nutricional en menores de 5 anos,clasificacion a y b,2002-08-01,3,2,3,2,5
51202,TOMAVE,estado nutricional en menores de 5 anos,clasificacion a y b,2002-08-01,1,1,1,1,2
10402,TOMINA,estado nutricional en menores de 5 anos,clasificacion a y b,2002-08-01,22,3,22,3,25
50502,TORO TORO,estado nutricional en menores de 5 anos,clasificacion a y b,2002-08-01,8,4,8,4,12
31201,TOTORA(CBBA),estado nutricional en menores de 5 anos,clasificacion a y b,2002-08-01,14,5,14,5,19
41301,TOTORA(ORR),estado nutricional en menores de 5 anos,clasificacion a y b,2002-08-01,3,2,3,2,5
70802,TRIGAL,estado nutricional en menores de 5 anos,clasificacion a y b,2002-08-01,1,2,1,2,3
80101,TRINIDAD,estado nutricional en menores de 5 anos,clasificacion a y b,2002-08-01,253,220,253,220,473
40402,TURCO,estado nutricional en menores de 5 anos,clasificacion a y b,2002-08-01,3,0,3,0,3
21302,UMALA,estado nutricional en menores de 5 anos,clasificacion a y b,2002-08-01,9,2,9,2,11
60401,URIONDO (A. CONCEPCION),estado nutricional en menores de 5 anos,clasificacion a y b,2002-08-01,31,26,31,26,57
71502,URUBICHA,estado nutricional en menores de 5 anos,clasificacion a y b,2002-08-01,6,22,6,22,28
51201,UYUNI,estado nutricional en menores de 5 anos,clasificacion a y b,2002-08-01,50,22,50,22,72
70801,VALLEGRANDE,estado nutricional en menores de 5 anos,clasificacion a y b,2002-08-01,39,21,39,21,60
20801,VIACHA,estado nutricional en menores de 5 anos,clasificacion a y b,2002-08-01,36,49,36,49,85
31302,VILA VILA,estado nutricional en menores de 5 anos,clasificacion a y b,2002-08-01,3,5,3,5,8
60303,VILLA MONTES,estado nutricional en menores de 5 anos,clasificacion a y b,2002-08-01,35,21,35,21,56
31402,VILLA RIVERO,estado nutricional en menores de 5 anos,clasificacion a y b,2002-08-01,2,0,2,0,2
10801,VILLA SERRANO,estado nutricional en menores de 5 anos,clasificacion a y b,2002-08-01,22,16,22,16,38
31003,VILLA TUNARI,estado nutricional en menores de 5 anos,clasificacion a y b,2002-08-01,83,25,83,25,108
11001,VILLA VACA GUZMAN (MUYUPAMPA),estado nutricional en menores de 5 anos,clasificacion a y b,2002-08-01,38,12,38,12,50
51501,VILLAZON,estado nutricional en menores de 5 anos,clasificacion a y b,2002-08-01,88,27,88,27,115
50602,VITICHI,estado nutricional en menores de 5 anos,clasificacion a y b,2002-08-01,8,4,8,4,12
70201,WARNES,estado nutricional en menores de 5 anos,clasificacion a y b,2002-08-01,123,68,123,68,191
20903,YACO,estado nutricional en menores de 5 anos,clasificacion a y b,2002-08-01,2,6,2,6,8
60301,YACUIBA,estado nutricional en menores de 5 anos,clasificacion a y b,2002-08-01,144,35,144,35,179
10602,YAMPARAEZ,estado nutricional en menores de 5 anos,clasificacion a y b,2002-08-01,24,6,24,6,30
21103,YANACACHI,estado nutricional en menores de 5 anos,clasificacion a y b,2002-08-01,9,2,9,2,11
70403,YAPACANI,estado nutricional en menores de 5 anos,clasificacion a y b,2002-08-01,7,2,7,2,9
50103,YOCALLA,estado nutricional en menores de 5 anos,clasificacion a y b,2002-08-01,5,7,5,7,12
10102,YOTALA,estado nutricional en menores de 5 anos,clasificacion a y b,2002-08-01,40,22,40,22,62
60402,YUNCHARA,estado nutricional en menores de 5 anos,clasificacion a y b,2002-08-01,15,2,15,2,17
10301,ZUDAÑEZ,estado nutricional en menores de 5 anos,clasificacion a y b,2002-08-01,30,0,30,0,30
51302,ACACIO,estado nutricional en menores de 5 anos,clasificacion a y b,2002-09-01,0,2,0,2,2
20201,ACHACACHI,estado nutricional en menores de 5 anos,clasificacion a y b,2002-09-01,104,78,104,78,182
20104,ACHOCALLA,estado nutricional en menores de 5 anos,clasificacion a y b,2002-09-01,24,0,24,0,24
30201,AIQUILE,estado nutricional en menores de 5 anos,clasificacion a y b,2002-09-01,5,0,5,0,5
10404,ALCALA,estado nutricional en menores de 5 anos,clasificacion a y b,2002-09-01,11,2,11,2,13
20202,ANCORAIMES,estado nutricional en menores de 5 anos,clasificacion a y b,2002-09-01,17,7,17,7,24
40603,ANTEQUERA,estado nutricional en menores de 5 anos,clasificacion a y b,2002-09-01,13,0,13,0,13
30402,ANZALDO,estado nutricional en menores de 5 anos,clasificacion a y b,2002-09-01,3,17,3,17,20
20701,APOLO,estado nutricional en menores de 5 anos,clasificacion a y b,2002-09-01,32,4,32,4,36
51301,ARAMPAMPA,estado nutricional en menores de 5 anos,clasificacion a y b,2002-09-01,8,1,8,1,9
30501,ARANI,estado nutricional en menores de 5 anos,clasificacion a y b,2002-09-01,1,4,1,4,5
30403,ARBIETO,estado nutricional en menores de 5 anos,clasificacion a y b,2002-09-01,5,11,5,11,16
30601,ARQUE,estado nutricional en menores de 5 anos,clasificacion a y b,2002-09-01,1,1,1,1,2
50802,ATOCHA,estado nutricional en menores de 5 anos,clasificacion a y b,2002-09-01,6,15,6,15,21
20503,AUCAPATA,estado nutricional en menores de 5 anos,clasificacion a y b,2002-09-01,11,0,11,0,11
20502,AYATA,estado nutricional en menores de 5 anos,clasificacion a y b,2002-09-01,26,6,26,6,32
21303,AYO AYO,estado nutricional en menores de 5 anos,clasificacion a y b,2002-09-01,19,3,19,3,22
30301,AYOPAYA (V. DE INDEPENDENCIA),estado nutricional en menores de 5 anos,clasificacion a y b,2002-09-01,22,8,22,8,30
10201,AZURDUY,estado nutricional en menores de 5 anos,clasificacion a y b,2002-09-01,44,9,44,9,53
21203,BATALLAS,estado nutricional en menores de 5 anos,clasificacion a y b,2002-09-01,23,14,23,14,37
80802,BAURES,estado nutricional en menores de 5 anos,clasificacion a y b,2002-09-01,8,2,8,2,10
50104,BELEN DE URMIRI,estado nutricional en menores de 5 anos,clasificacion a y b,2002-09-01,7,3,7,3,10
60202,BERMEJO,estado nutricional en menores de 5 anos,clasificacion a y b,2002-09-01,19,53,19,53,72
50301,BETANZOS,estado nutricional en menores de 5 anos,clasificacion a y b,2002-09-01,39,8,39,8,47
31501,BOLIVAR,estado nutricional en menores de 5 anos,clasificacion a y b,2002-09-01,10,4,10,4,14
70707,BOYUIBE,estado nutricional en menores de 5 anos,clasificacion a y b,2002-09-01,6,9,6,9,15
70401,BUENA VISTA,estado nutricional en menores de 5 anos,clasificacion a y b,2002-09-01,67,17,67,17,84
70703,CABEZAS,estado nutricional en menores de 5 anos,clasificacion a y b,2002-09-01,47,28,47,28,75
20905,CAIROMA,estado nutricional en menores de 5 anos,clasificacion a y b,2002-09-01,12,1,12,1,13
51102,"CAIZA ""D""",estado nutricional en menores de 5 anos,clasificacion a y b,2002-09-01,28,2,28,2,30
21003,CAJUATA,estado nutricional en menores de 5 anos,clasificacion a y b,2002-09-01,8,1,8,1,9
20303,CALACOTO,estado nutricional en menores de 5 anos,clasificacion a y b,2002-09-01,3,1,3,1,4
21304,CALAMARCA,estado nutricional en menores de 5 anos,clasificacion a y b,2002-09-01,14,4,14,4,18
10701,CAMARGO,estado nutricional en menores de 5 anos,clasificacion a y b,2002-09-01,15,13,15,13,28
10901,CAMATAQUI (C. VILLA ABECIA),estado nutricional en menores de 5 anos,clasificacion a y b,2002-09-01,10,5,10,5,15
70706,CAMIRI,estado nutricional en menores de 5 anos,clasificacion a y b,2002-09-01,68,24,68,24,92
30701,CAPINOTA,estado nutricional en menores de 5 anos,clasificacion a y b,2002-09-01,13,10,13,10,23
20302,CAQUIAVIRI,estado nutricional en menores de 5 anos,clasificacion a y b,2002-09-01,13,1,13,1,14
40102,CARACOLLO,estado nutricional en menores de 5 anos,clasificacion a y b,2002-09-01,24,6,24,6,30
22001,CARANAVI,estado nutricional en menores de 5 anos,clasificacion a y b,2002-09-01,128,45,128,45,173
60302,CARAPARI,estado nutricional en menores de 5 anos,clasificacion a y b,2002-09-01,39,7,39,7,46
50702,CARIPUYO,estado nutricional en menores de 5 anos,clasificacion a y b,2002-09-01,2,0,2,0,2
21902,CATACORA,estado nutricional en menores de 5 anos,clasificacion a y b,2002-09-01,0,1,0,1,1
21803,CHACARILLA,estado nutricional en menores de 5 anos,clasificacion a y b,2002-09-01,2,2,2,2,4
40201,CHALLAPATA,estado nutricional en menores de 5 anos,clasificacion a y b,2002-09-01,12,10,12,10,22
50302,CHAQUI,estado nutricional en menores de 5 anos,clasificacion a y b,2002-09-01,18,0,18,0,18
70702,CHARAGUA,estado nutricional en menores de 5 anos,clasificacion a y b,2002-09-01,37,75,37,75,112
20305,CHARAÑA,estado nutricional en menores de 5 anos,clasificacion a y b,2002-09-01,3,2,3,2,5
50202,CHAYANTA,estado nutricional en menores de 5 anos,clasificacion a y b,2002-09-01,9,4,9,4,13
31204,CHIMORE,estado nutricional en menores de 5 anos,clasificacion a y b,2002-09-01,22,10,22,10,32
40903,CHIPAYA,estado nutricional en menores de 5 anos,clasificacion a y b,2002-09-01,0,2,0,2,2
40302,CHOQUE COTA,estado nutricional en menores de 5 anos,clasificacion a y b,2002-09-01,3,0,3,0,3
21101,CHULUMANI (V. DE LA LIBERTAD),estado nutricional en menores de 5 anos,clasificacion a y b,2002-09-01,23,6,23,6,29
20501,CHUMA,estado nutricional en menores de 5 anos,clasificacion a y b,2002-09-01,18,6,18,6,24
30801,CLIZA,estado nutricional en menores de 5 anos,clasificacion a y b,2002-09-01,7,15,7,15,22
90101,COBIJA,estado nutricional en menores de 5 anos,clasificacion a y b,2002-09-01,91,20,91,20,111
30101,COCHABAMBA,estado nutricional en menores de 5 anos,clasificacion a y b,2002-09-01,1409,1265,1409,1265,2674
40902,COIPASA,estado nutricional en menores de 5 anos,clasificacion a y b,2002-09-01,1,0,1,0,1
30905,COLCAPIRHUA,estado nutricional en menores de 5 anos,clasificacion a y b,2002-09-01,37,6,37,6,43
50901,"COLCHA ""K""",estado nutricional en menores de 5 anos,clasificacion a y b,2002-09-01,11,5,11,5,16
21307,COLLANA,estado nutricional en menores de 5 anos,clasificacion a y b,2002-09-01,3,0,3,0,3
31002,COLOMI,estado nutricional en menores de 5 anos,clasificacion a y b,2002-09-01,18,6,18,6,24
50401,COLQUECHACA,estado nutricional en menores de 5 anos,clasificacion a y b,2002-09-01,41,2,41,2,43
21306,COLQUENCHA,estado nutricional en menores de 5 anos,clasificacion a y b,2002-09-01,23,13,23,13,36
21004,COLQUIRI,estado nutricional en menores de 5 anos,clasificacion a y b,2002-09-01,8,9,8,9,17
20304,COMANCHE,estado nutricional en menores de 5 anos,clasificacion a y b,2002-09-01,3,0,3,0,3
71301,COMARAPA,estado nutricional en menores de 5 anos,clasificacion a y b,2002-09-01,78,22,78,22,100
20605,COMBAYA,estado nutricional en menores de 5 anos,clasificacion a y b,2002-09-01,4,0,4,0,4
71101,CONCEPCION,estado nutricional en menores de 5 anos,clasificacion a y b,2002-09-01,5,0,5,0,5
21402,CORIPATA,estado nutricional en menores de 5 anos,clasificacion a y b,2002-09-01,29,21,29,21,50
20301,CORO CORO,estado nutricional en menores de 5 anos,clasificacion a y b,2002-09-01,21,1,21,1,22
21401,COROICO,estado nutricional en menores de 5 anos,clasificacion a y b,2002-09-01,5,5,5,5,10
40301,CORQUE,estado nutricional en menores de 5 anos,clasificacion a y b,2002-09-01,3,1,3,1,4
50601,COTAGAITA,estado nutricional en menores de 5 anos,clasificacion a y b,2002-09-01,32,6,32,6,38
70102,COTOCA,estado nutricional en menores de 5 anos,clasificacion a y b,2002-09-01,49,5,49,5,54
70704,CUEVO,estado nutricional en menores de 5 anos,clasificacion a y b,2002-09-01,12,9,12,9,21
10902,CULPINA,estado nutricional en menores de 5 anos,clasificacion a y b,2002-09-01,57,23,57,23,80
40401,CURAHUARA DE CARANGAS,estado nutricional en menores de 5 anos,clasificacion a y b,2002-09-01,2,0,2,0,2
21602,CURVA,estado nutricional en menores de 5 anos,clasificacion a y b,2002-09-01,1,0,1,0,1
20804,DESAGUADERO,estado nutricional en menores de 5 anos,clasificacion a y b,2002-09-01,6,1,6,1,7
20105,EL ALTO,estado nutricional en menores de 5 anos,clasificacion a y b,2002-09-01,605,209,605,209,814
40103,EL CHORO,estado nutricional en menores de 5 anos,clasificacion a y b,2002-09-01,0,1,0,1,1
71503,EL PUENTE(STC),estado nutricional en menores de 5 anos,clasificacion a y b,2002-09-01,6,22,6,22,28
60502,EL PUENTE(TJA),estado nutricional en menores de 5 anos,clasificacion a y b,2002-09-01,5,4,5,4,9
70105,EL TORNO,estado nutricional en menores de 5 anos,clasificacion a y b,2002-09-01,125,47,125,47,172
10405,EL VILLAR,estado nutricional en menores de 5 anos,clasificacion a y b,2002-09-01,15,3,15,3,18
60601,ENTRE RIOS,estado nutricional en menores de 5 anos,clasificacion a y b,2002-09-01,38,19,38,19,57
41101,EUCALIPTUS,estado nutricional en menores de 5 anos,clasificacion a y b,2002-09-01,51,3,51,3,54
90503,EUREKA (SANTOS MERCADO),estado nutricional en menores de 5 anos,clasificacion a y b,2002-09-01,5,3,5,3,8
80402,EXALTACION,estado nutricional en menores de 5 anos,clasificacion a y b,2002-09-01,0,2,0,2,2
71002,GENERAL SAAVEDRA,estado nutricional en menores de 5 anos,clasificacion a y b,2002-09-01,15,2,15,2,17
21601,GRAL. J.J. PEREZ (CHARAZANI),estado nutricional en menores de 5 anos,clasificacion a y b,2002-09-01,13,22,13,22,35
20602,GUANAY,estado nutricional en menores de 5 anos,clasificacion a y b,2002-09-01,84,40,84,40,124
20802,GUAQUI,estado nutricional en menores de 5 anos,clasificacion a y b,2002-09-01,4,0,4,0,4
80202,GUAYARAMERIN,estado nutricional en menores de 5 anos,clasificacion a y b,2002-09-01,89,28,89,28,117
70705,GUTIERREZ,estado nutricional en menores de 5 anos,clasificacion a y b,2002-09-01,50,17,50,17,67
10502,HUACARETA,estado nutricional en menores de 5 anos,clasificacion a y b,2002-09-01,28,14,28,14,42
11002,HUACAYA (VILLA DE HUACAYA),estado nutricional en menores de 5 anos,clasificacion a y b,2002-09-01,8,5,8,5,13
40501,HUACHACALLA,estado nutricional en menores de 5 anos,clasificacion a y b,2002-09-01,1,2,1,2,3
40701,HUANUNI,estado nutricional en menores de 5 anos,clasificacion a y b,2002-09-01,4,3,4,3,7
80803,HUARACAJE,estado nutricional en menores de 5 anos,clasificacion a y b,2002-09-01,4,1,4,1,5
41601,HUAYLLAMARCA,estado nutricional en menores de 5 anos,clasificacion a y b,2002-09-01,3,1,3,1,4
10304,ICLA,estado nutricional en menores de 5 anos,clasificacion a y b,2002-09-01,14,6,14,6,20
10703,INCAHUASI,estado nutricional en menores de 5 anos,clasificacion a y b,2002-09-01,29,13,29,13,42
21001,INQUISIVI,estado nutricional en menores de 5 anos,clasificacion a y b,2002-09-01,28,7,28,7,35
21102,IRUPANA (VILLA DE LANZA),estado nutricional en menores de 5 anos,clasificacion a y b,2002-09-01,19,12,19,12,31
21501,IXIAMAS,estado nutricional en menores de 5 anos,clasificacion a y b,2002-09-01,22,14,22,14,36
21105,LA ASUNTA,estado nutricional en menores de 5 anos,clasificacion a y b,2002-09-01,37,11,37,11,48
70104,LA GUARDIA,estado nutricional en menores de 5 anos,clasificacion a y b,2002-09-01,130,32,130,32,162
20101,LA PAZ,estado nutricional en menores de 5 anos,clasificacion a y b,2002-09-01,485,240,485,240,725
41501,LA RIVERA,estado nutricional en menores de 5 anos,clasificacion a y b,2002-09-01,1,0,1,0,1
70701,LAGUNILLAS,estado nutricional en menores de 5 anos,clasificacion a y b,2002-09-01,23,8,23,8,31
21202,LAJA,estado nutricional en menores de 5 anos,clasificacion a y b,2002-09-01,24,0,24,0,24
10903,LAS CARRERAS,estado nutricional en menores de 5 anos,clasificacion a y b,2002-09-01,6,4,6,4,10
21006,LICOMA PAMPA,estado nutricional en menores de 5 anos,clasificacion a y b,2002-09-01,1,0,1,0,1
50203,LLALLAGUA,estado nutricional en menores de 5 anos,clasificacion a y b,2002-09-01,16,63,16,63,79
51401,LLICA,estado nutricional en menores de 5 anos,clasificacion a y b,2002-09-01,3,1,3,1,4
80601,LORETO,estado nutricional en menores de 5 anos,clasificacion a y b,2002-09-01,0,16,0,16,16
20901,LURIBAY,estado nutricional en menores de 5 anos,clasificacion a y b,2002-09-01,21,2,21,2,23
40702,MACHACAMARCA,estado nutricional en menores de 5 anos,clasificacion a y b,2002-09-01,6,0,6,0,6
11003,MACHARETI,estado nutricional en menores de 5 anos,clasificacion a y b,2002-09-01,55,31,55,31,86
80801,MAGDALENA,estado nutricional en menores de 5 anos,clasificacion a y b,2002-09-01,21,5,21,5,26
70903,MAIRANA,estado nutricional en menores de 5 anos,clasificacion a y b,2002-09-01,44,4,44,4,48
20904,MALLA,estado nutricional en menores de 5 anos,clasificacion a y b,2002-09-01,3,0,3,0,3
20103,MECAPACA,estado nutricional en menores de 5 anos,clasificacion a y b,2002-09-01,4,1,4,1,5
71003,MINEROS,estado nutricional en menores de 5 anos,clasificacion a y b,2002-09-01,8,0,8,0,8
31301,MIZQUE,estado nutricional en menores de 5 anos,clasificacion a y b,2002-09-01,20,9,20,9,29
20402,MOCOMOCO,estado nutricional en menores de 5 anos,clasificacion a y b,2002-09-01,23,2,23,2,25
51002,MOJINETE,estado nutricional en menores de 5 anos,clasificacion a y b,2002-09-01,2,0,2,0,2
10303,MOJOCOYA,estado nutricional en menores de 5 anos,clasificacion a y b,2002-09-01,33,20,33,20,53
10501,MONTEAGUDO,estado nutricional en menores de 5 anos,clasificacion a y b,2002-09-01,148,22,148,22,170
71001,MONTERO,estado nutricional en menores de 5 anos,clasificacion a y b,2002-09-01,311,102,311,102,413
70803,MORO MORO,estado nutricional en menores de 5 anos,clasificacion a y b,2002-09-01,10,3,10,3,13
30302,MOROCHATA,estado nutricional en menores de 5 anos,clasificacion a y b,2002-09-01,28,10,28,10,38
20307,NAZACARA DE PACAJES,estado nutricional en menores de 5 anos,clasificacion a y b,2002-09-01,2,0,2,0,2
90501,NUEVO MANOA (NUEVA ESPERANZA),estado nutricional en menores de 5 anos,clasificacion a y b,2002-09-01,1,0,1,0,1
50404,OCURI,estado nutricional en menores de 5 anos,clasificacion a y b,2002-09-01,11,14,11,14,25
70202,OKINAWA,estado nutricional en menores de 5 anos,clasificacion a y b,2002-09-01,9,3,9,3,12
30203,OMEREQUE,estado nutricional en menores de 5 anos,clasificacion a y b,2002-09-01,0,12,0,12,12
40101,ORURO,estado nutricional en menores de 5 anos,clasificacion a y b,2002-09-01,237,41,237,41,278
60201,PADCAYA,estado nutricional en menores de 5 anos,clasificacion a y b,2002-09-01,37,40,37,40,77
10401,PADILLA,estado nutricional en menores de 5 anos,clasificacion a y b,2002-09-01,45,4,45,4,49
70502,PAILON,estado nutricional en menores de 5 anos,clasificacion a y b,2002-09-01,55,32,55,32,87
20102,PALCA,estado nutricional en menores de 5 anos,clasificacion a y b,2002-09-01,22,4,22,4,26
21104,PALOS BLANCOS,estado nutricional en menores de 5 anos,clasificacion a y b,2002-09-01,40,12,40,12,52
40802,PAMPA AULLAGAS,estado nutricional en menores de 5 anos,clasificacion a y b,2002-09-01,2,0,2,0,2
70902,PAMPA GRANDE,estado nutricional en menores de 5 anos,clasificacion a y b,2002-09-01,34,6,34,6,40
21802,PAPEL PAMPA,estado nutricional en menores de 5 anos,clasificacion a y b,2002-09-01,8,0,8,0,8
30202,PASORAPA,estado nutricional en menores de 5 anos,clasificacion a y b,2002-09-01,3,0,3,0,3
21305,PATACAMAYA,estado nutricional en menores de 5 anos,clasificacion a y b,2002-09-01,28,1,28,1,29
40602,PAZÑA,estado nutricional en menores de 5 anos,clasificacion a y b,2002-09-01,1,0,1,0,1
20702,PELECHUCO,estado nutricional en menores de 5 anos,clasificacion a y b,2002-09-01,2,0,2,0,2
50403,POCOATA,estado nutricional en menores de 5 anos,clasificacion a y b,2002-09-01,34,9,34,9,43
31203,POCONA,estado nutricional en menores de 5 anos,clasificacion a y b,2002-09-01,15,1,15,1,16
31202,POJO (CBBA),estado nutricional en menores de 5 anos,clasificacion a y b,2002-09-01,118,20,118,20,138
51203,PORCO,estado nutricional en menores de 5 anos,clasificacion a y b,2002-09-01,13,1,13,1,14
10103,POROMA,estado nutricional en menores de 5 anos,clasificacion a y b,2002-09-01,48,6,48,6,54
70103,PORONGO,estado nutricional en menores de 5 anos,clasificacion a y b,2002-09-01,8,3,8,3,11
70601,PORTACHUELO,estado nutricional en menores de 5 anos,clasificacion a y b,2002-09-01,62,18,62,18,80
90102,PORVENIR,estado nutricional en menores de 5 anos,clasificacion a y b,2002-09-01,11,2,11,2,13
70804,POSTRER VALLE,estado nutricional en menores de 5 anos,clasificacion a y b,2002-09-01,1,4,1,4,5
50101,POTOSI,estado nutricional en menores de 5 anos,clasificacion a y b,2002-09-01,167,22,167,22,189
10302,PRESTO,estado nutricional en menores de 5 anos,clasificacion a y b,2002-09-01,21,5,21,5,26
70805,PUCARA,estado nutricional en menores de 5 anos,clasificacion a y b,2002-09-01,1,0,1,0,1
21201,PUCARANI,estado nutricional en menores de 5 anos,clasificacion a y b,2002-09-01,21,6,21,6,27
20401,PUERTO ACOSTA,estado nutricional en menores de 5 anos,clasificacion a y b,2002-09-01,64,61,64,61,125
20403,PUERTO CARABUCO,estado nutricional en menores de 5 anos,clasificacion a y b,2002-09-01,17,4,17,4,21
21204,PUERTO PEREZ,estado nutricional en menores de 5 anos,clasificacion a y b,2002-09-01,7,0,7,0,7
71402,PUERTO QUIJARRO,estado nutricional en menores de 5 anos,clasificacion a y b,2002-09-01,50,8,50,8,58
90201,PUERTO RICO,estado nutricional en menores de 5 anos,clasificacion a y b,2002-09-01,6,6,6,6,12
80703,PUERTO SILES,estado nutricional en menores de 5 anos,clasificacion a y b,2002-09-01,1,0,1,0,1
71401,PUERTO SUAREZ,estado nutricional en menores de 5 anos,clasificacion a y b,2002-09-01,31,5,31,5,36
31205,PUERTO VILLARROEL,estado nutricional en menores de 5 anos,clasificacion a y b,2002-09-01,148,38,148,38,186
51101,PUNA,estado nutricional en menores de 5 anos,clasificacion a y b,2002-09-01,46,39,46,39,85
31401,PUNATA,estado nutricional en menores de 5 anos,clasificacion a y b,2002-09-01,16,2,16,2,18
20604,QUIABAYA,estado nutricional en menores de 5 anos,clasificacion a y b,2002-09-01,12,0,12,0,12
30901,QUILLACOLLO,estado nutricional en menores de 5 anos,clasificacion a y b,2002-09-01,42,24,42,24,66
21002,QUIME,estado nutricional en menores de 5 anos,clasificacion a y b,2002-09-01,15,2,15,2,17
70904,QUIRUSILLAS,estado nutricional en menores de 5 anos,clasificacion a y b,2002-09-01,3,4,3,4,7
50402,RAVELO,estado nutricional en menores de 5 anos,clasificacion a y b,2002-09-01,23,8,23,8,31
80301,REYES,estado nutricional en menores de 5 anos,clasificacion a y b,2002-09-01,25,7,25,7,32
80201,RIBERALTA,estado nutricional en menores de 5 anos,clasificacion a y b,2002-09-01,227,44,227,44,271
70503,ROBORE,estado nutricional en menores de 5 anos,clasificacion a y b,2002-09-01,39,7,39,7,46
80304,RURRENABAQUE,estado nutricional en menores de 5 anos,clasificacion a y b,2002-09-01,4,5,4,5,9
31001,SACABA,estado nutricional en menores de 5 anos,clasificacion a y b,2002-09-01,126,7,126,7,133
30404,SACABAMBA,estado nutricional en menores de 5 anos,clasificacion a y b,2002-09-01,0,5,0,5,5
50701,SACACA,estado nutricional en menores de 5 anos,clasificacion a y b,2002-09-01,26,17,26,17,43
71302,SAIPINA,estado nutricional en menores de 5 anos,clasificacion a y b,2002-09-01,22,25,22,25,47
40801,SALINAS DE GARCI MENDOZA,estado nutricional en menores de 5 anos,clasificacion a y b,2002-09-01,2,3,2,3,5
70901,SAMAIPATA,estado nutricional en menores de 5 anos,clasificacion a y b,2002-09-01,23,9,23,9,32
51601,SAN AGUSTIN,estado nutricional en menores de 5 anos,clasificacion a y b,2002-09-01,6,0,6,0,6
80602,SAN ANDRES,estado nutricional en menores de 5 anos,clasificacion a y b,2002-09-01,3,8,3,8,11
51003,SAN ANTONIO DE ESMORUCO,estado nutricional en menores de 5 anos,clasificacion a y b,2002-09-01,1,0,1,0,1
71105,SAN ANTONIO DE LOMERIO,estado nutricional en menores de 5 anos,clasificacion a y b,2002-09-01,16,7,16,7,23
31403,SAN BENITO,estado nutricional en menores de 5 anos,clasificacion a y b,2002-09-01,8,1,8,1,9
80302,SAN BORJA,estado nutricional en menores de 5 anos,clasificacion a y b,2002-09-01,72,22,72,22,94
21502,SAN BUENA VENTURA,estado nutricional en menores de 5 anos,clasificacion a y b,2002-09-01,21,5,21,5,26
70402,SAN CARLOS,estado nutricional en menores de 5 anos,clasificacion a y b,2002-09-01,75,19,75,19,94
80501,SAN IGNACIO,estado nutricional en menores de 5 anos,clasificacion a y b,2002-09-01,65,42,65,42,107
70301,SAN IGNACIO DE VELASCO,estado nutricional en menores de 5 anos,clasificacion a y b,2002-09-01,175,17,175,17,192
80102,SAN JAVIER(BNI),estado nutricional en menores de 5 anos,clasificacion a y b,2002-09-01,0,10,0,10,10
71102,SAN JAVIER(STC),estado nutricional en menores de 5 anos,clasificacion a y b,2002-09-01,21,1,21,1,22
80701,SAN JOAQUIN,estado nutricional en menores de 5 anos,clasificacion a y b,2002-09-01,4,32,4,32,36
70501,SAN JOSE DE CHIQUITOS,estado nutricional en menores de 5 anos,clasificacion a y b,2002-09-01,20,5,20,5,25
71104,SAN JULIAN,estado nutricional en menores de 5 anos,clasificacion a y b,2002-09-01,124,37,124,37,161
90302,SAN LORENZO(PND),estado nutricional en menores de 5 anos,clasificacion a y b,2002-09-01,3,2,3,2,5
60501,SAN LORENZO(TJA),estado nutricional en menores de 5 anos,clasificacion a y b,2002-09-01,8,1,8,1,9
10702,SAN LUCAS,estado nutricional en menores de 5 anos,clasificacion a y b,2002-09-01,50,21,50,21,71
71201,SAN MATIAS,estado nutricional en menores de 5 anos,clasificacion a y b,2002-09-01,48,6,48,6,54
70302,SAN MIGUEL DE VELASCO,estado nutricional en menores de 5 anos,clasificacion a y b,2002-09-01,27,3,27,3,30
51001,SAN PABLO DE LIPEZ,estado nutricional en menores de 5 anos,clasificacion a y b,2002-09-01,2,3,2,3,5
50501,SAN PEDRO DE BUENA VISTA,estado nutricional en menores de 5 anos,clasificacion a y b,2002-09-01,12,11,12,11,23
21801,SAN PEDRO DE CURAHUARA,estado nutricional en menores de 5 anos,clasificacion a y b,2002-09-01,2,0,2,0,2
50902,SAN PEDRO DE QUEMES,estado nutricional en menores de 5 anos,clasificacion a y b,2002-09-01,1,0,1,0,1
21702,SAN PEDRO DE TIQUINA,estado nutricional en menores de 5 anos,clasificacion a y b,2002-09-01,7,7,7,7,14
70303,SAN RAFAEL,estado nutricional en menores de 5 anos,clasificacion a y b,2002-09-01,12,1,12,1,13
80702,SAN RAMON,estado nutricional en menores de 5 anos,clasificacion a y b,2002-09-01,24,6,24,6,30
80401,SANTA ANA,estado nutricional en menores de 5 anos,clasificacion a y b,2002-09-01,10,6,10,6,16
70101,SANTA CRUZ DE LA SIERRA,estado nutricional en menores de 5 anos,clasificacion a y b,2002-09-01,1376,555,1376,555,1931
80303,SANTA ROSA,estado nutricional en menores de 5 anos,clasificacion a y b,2002-09-01,13,0,13,0,13
70602,SANTA ROSA DEL SARA,estado nutricional en menores de 5 anos,clasificacion a y b,2002-09-01,14,13,14,13,27
20308,SANTIAGO DE CALLAPA,estado nutricional en menores de 5 anos,clasificacion a y b,2002-09-01,5,2,5,2,7
41401,SANTIAGO DE HUARI,estado nutricional en menores de 5 anos,clasificacion a y b,2002-09-01,13,2,13,2,15
21901,SANTIAGO DE MACHACA,estado nutricional en menores de 5 anos,clasificacion a y b,2002-09-01,5,2,5,2,7
30702,SANTIVAÑES,estado nutricional en menores de 5 anos,clasificacion a y b,2002-09-01,9,1,9,1,10
40202,SANTUARIO DE QUILLACAS,estado nutricional en menores de 5 anos,clasificacion a y b,2002-09-01,1,0,1,0,1
20902,SAPAHAQUI,estado nutricional en menores de 5 anos,clasificacion a y b,2002-09-01,2,0,2,0,2
90303,SENA,estado nutricional en menores de 5 anos,clasificacion a y b,2002-09-01,3,4,3,4,7
21301,SICA SICA (VILLA AROMA),estado nutricional en menores de 5 anos,clasificacion a y b,2002-09-01,18,5,18,5,23
30703,SICAYA,estado nutricional en menores de 5 anos,clasificacion a y b,2002-09-01,3,0,3,0,3
30902,SIPE SIPE,estado nutricional en menores de 5 anos,clasificacion a y b,2002-09-01,159,78,159,78,237
10403,SOPACHUY,estado nutricional en menores de 5 anos,clasificacion a y b,2002-09-01,15,1,15,1,16
20601,SORATA,estado nutricional en menores de 5 anos,clasificacion a y b,2002-09-01,16,27,16,27,43
10101,SUCRE,estado nutricional en menores de 5 anos,clasificacion a y b,2002-09-01,303,97,303,97,400
31404,TACACHI,estado nutricional en menores de 5 anos,clasificacion a y b,2002-09-01,1,0,1,0,1
20603,TACACOMA,estado nutricional en menores de 5 anos,clasificacion a y b,2002-09-01,9,5,9,5,14
50303,TACOBAMBA,estado nutricional en menores de 5 anos,clasificacion a y b,2002-09-01,19,3,19,3,22
30602,TACOPAYA,estado nutricional en menores de 5 anos,clasificacion a y b,2002-09-01,14,21,14,21,35
31101,TAPACARI,estado nutricional en menores de 5 anos,clasificacion a y b,2002-09-01,15,7,15,7,22
10601,TARABUCO,estado nutricional en menores de 5 anos,clasificacion a y b,2002-09-01,44,10,44,10,54
30401,TARATA,estado nutricional en menores de 5 anos,clasificacion a y b,2002-09-01,16,8,16,8,24
60101,TARIJA,estado nutricional en menores de 5 anos,clasificacion a y b,2002-09-01,307,152,307,152,459
10202,TARVITA,estado nutricional en menores de 5 anos,clasificacion a y b,2002-09-01,23,10,23,10,33
20803,TIAWANACU,estado nutricional en menores de 5 anos,clasificacion a y b,2002-09-01,9,4,9,4,13
50102,TINGUIPAYA,estado nutricional en menores de 5 anos,clasificacion a y b,2002-09-01,13,8,13,8,21
20606,TIPUANI,estado nutricional en menores de 5 anos,clasificacion a y b,2002-09-01,39,8,39,8,47
30903,TIQUIPAYA,estado nutricional en menores de 5 anos,clasificacion a y b,2002-09-01,10,4,10,4,14
31601,TIRAQUE (CBBA),estado nutricional en menores de 5 anos,clasificacion a y b,2002-09-01,98,59,98,59,157
30802,TOCO,estado nutricional en menores de 5 anos,clasificacion a y b,2002-09-01,0,1,0,1,1
30803,TOLATA,estado nutricional en menores de 5 anos,clasificacion a y b,2002-09-01,1,0,1,0,1
41001,TOLEDO,estado nutricional en menores de 5 anos,clasificacion a y b,2002-09-01,2,6,2,6,8
51202,TOMAVE,estado nutricional en menores de 5 anos,clasificacion a y b,2002-09-01,12,11,12,11,23
10402,TOMINA,estado nutricional en menores de 5 anos,clasificacion a y b,2002-09-01,31,7,31,7,38
50502,TORO TORO,estado nutricional en menores de 5 anos,clasificacion a y b,2002-09-01,19,2,19,2,21
31201,TOTORA(CBBA),estado nutricional en menores de 5 anos,clasificacion a y b,2002-09-01,25,6,25,6,31
41301,TOTORA(ORR),estado nutricional en menores de 5 anos,clasificacion a y b,2002-09-01,1,4,1,4,5
70802,TRIGAL,estado nutricional en menores de 5 anos,clasificacion a y b,2002-09-01,5,0,5,0,5
80101,TRINIDAD,estado nutricional en menores de 5 anos,clasificacion a y b,2002-09-01,26,430,26,430,456
50801,TUPIZA,estado nutricional en menores de 5 anos,clasificacion a y b,2002-09-01,104,65,104,65,169
40402,TURCO,estado nutricional en menores de 5 anos,clasificacion a y b,2002-09-01,1,4,1,4,5
21302,UMALA,estado nutricional en menores de 5 anos,clasificacion a y b,2002-09-01,7,1,7,1,8
60401,URIONDO (A. CONCEPCION),estado nutricional en menores de 5 anos,clasificacion a y b,2002-09-01,14,3,14,3,17
71502,URUBICHA,estado nutricional en menores de 5 anos,clasificacion a y b,2002-09-01,1,0,1,0,1
51201,UYUNI,estado nutricional en menores de 5 anos,clasificacion a y b,2002-09-01,54,12,54,12,66
30502,VACAS,estado nutricional en menores de 5 anos,clasificacion a y b,2002-09-01,1,1,1,1,2
70801,VALLEGRANDE,estado nutricional en menores de 5 anos,clasificacion a y b,2002-09-01,47,19,47,19,66
20801,VIACHA,estado nutricional en menores de 5 anos,clasificacion a y b,2002-09-01,46,28,46,28,74
60303,VILLA MONTES,estado nutricional en menores de 5 anos,clasificacion a y b,2002-09-01,32,18,32,18,50
31402,VILLA RIVERO,estado nutricional en menores de 5 anos,clasificacion a y b,2002-09-01,3,2,3,2,5
10801,VILLA SERRANO,estado nutricional en menores de 5 anos,clasificacion a y b,2002-09-01,31,9,31,9,40
31003,VILLA TUNARI,estado nutricional en menores de 5 anos,clasificacion a y b,2002-09-01,94,24,94,24,118
11001,VILLA VACA GUZMAN (MUYUPAMPA),estado nutricional en menores de 5 anos,clasificacion a y b,2002-09-01,51,24,51,24,75
51501,VILLAZON,estado nutricional en menores de 5 anos,clasificacion a y b,2002-09-01,66,30,66,30,96
30904,VINTO,estado nutricional en menores de 5 anos,clasificacion a y b,2002-09-01,36,13,36,13,49
50602,VITICHI,estado nutricional en menores de 5 anos,clasificacion a y b,2002-09-01,5,6,5,6,11
20306,WALDO BALLIVIAN,estado nutricional en menores de 5 anos,clasificacion a y b,2002-09-01,0,1,0,1,1
70201,WARNES,estado nutricional en menores de 5 anos,clasificacion a y b,2002-09-01,112,26,112,26,138
20903,YACO,estado nutricional en menores de 5 anos,clasificacion a y b,2002-09-01,3,3,3,3,6
60301,YACUIBA,estado nutricional en menores de 5 anos,clasificacion a y b,2002-09-01,156,53,156,53,209
10602,YAMPARAEZ,estado nutricional en menores de 5 anos,clasificacion a y b,2002-09-01,31,7,31,7,38
21103,YANACACHI,estado nutricional en menores de 5 anos,clasificacion a y b,2002-09-01,13,1,13,1,14
70403,YAPACANI,estado nutricional en menores de 5 anos,clasificacion a y b,2002-09-01,123,21,123,21,144
50103,YOCALLA,estado nutricional en menores de 5 anos,clasificacion a y b,2002-09-01,6,1,6,1,7
10102,YOTALA,estado nutricional en menores de 5 anos,clasificacion a y b,2002-09-01,34,9,34,9,43
60402,YUNCHARA,estado nutricional en menores de 5 anos,clasificacion a y b,2002-09-01,10,9,10,9,19
10301,ZUDAÑEZ,estado nutricional en menores de 5 anos,clasificacion a y b,2002-09-01,20,1,20,1,21
51302,ACACIO,estado nutricional en menores de 5 anos,clasificacion a y b,2002-10-01,0,1,0,1,1
20201,ACHACACHI,estado nutricional en menores de 5 anos,clasificacion a y b,2002-10-01,142,179,142,179,321
20104,ACHOCALLA,estado nutricional en menores de 5 anos,clasificacion a y b,2002-10-01,22,5,22,5,27
30201,AIQUILE,estado nutricional en menores de 5 anos,clasificacion a y b,2002-10-01,18,5,18,5,23
10404,ALCALA,estado nutricional en menores de 5 anos,clasificacion a y b,2002-10-01,8,5,8,5,13
20202,ANCORAIMES,estado nutricional en menores de 5 anos,clasificacion a y b,2002-10-01,23,6,23,6,29
30402,ANZALDO,estado nutricional en menores de 5 anos,clasificacion a y b,2002-10-01,5,5,5,5,10
20701,APOLO,estado nutricional en menores de 5 anos,clasificacion a y b,2002-10-01,31,9,31,9,40
51301,ARAMPAMPA,estado nutricional en menores de 5 anos,clasificacion a y b,2002-10-01,8,2,8,2,10
30501,ARANI,estado nutricional en menores de 5 anos,clasificacion a y b,2002-10-01,1,7,1,7,8
30403,ARBIETO,estado nutricional en menores de 5 anos,clasificacion a y b,2002-10-01,1,11,1,11,12
30601,ARQUE,estado nutricional en menores de 5 anos,clasificacion a y b,2002-10-01,2,0,2,0,2
71501,ASCENCION DE GUARAYOS,estado nutricional en menores de 5 anos,clasificacion a y b,2002-10-01,74,23,74,23,97
50802,ATOCHA,estado nutricional en menores de 5 anos,clasificacion a y b,2002-10-01,6,15,6,15,21
20503,AUCAPATA,estado nutricional en menores de 5 anos,clasificacion a y b,2002-10-01,2,2,2,2,4
20502,AYATA,estado nutricional en menores de 5 anos,clasificacion a y b,2002-10-01,5,1,5,1,6
21303,AYO AYO,estado nutricional en menores de 5 anos,clasificacion a y b,2002-10-01,27,6,27,6,33
30301,AYOPAYA (V. DE INDEPENDENCIA),estado nutricional en menores de 5 anos,clasificacion a y b,2002-10-01,16,5,16,5,21
10201,AZURDUY,estado nutricional en menores de 5 anos,clasificacion a y b,2002-10-01,35,14,35,14,49
21203,BATALLAS,estado nutricional en menores de 5 anos,clasificacion a y b,2002-10-01,29,15,29,15,44
80802,BAURES,estado nutricional en menores de 5 anos,clasificacion a y b,2002-10-01,5,3,5,3,8
50104,BELEN DE URMIRI,estado nutricional en menores de 5 anos,clasificacion a y b,2002-10-01,6,4,6,4,10
60202,BERMEJO,estado nutricional en menores de 5 anos,clasificacion a y b,2002-10-01,23,14,23,14,37
50301,BETANZOS,estado nutricional en menores de 5 anos,clasificacion a y b,2002-10-01,12,6,12,6,18
31501,BOLIVAR,estado nutricional en menores de 5 anos,clasificacion a y b,2002-10-01,8,4,8,4,12
70707,BOYUIBE,estado nutricional en menores de 5 anos,clasificacion a y b,2002-10-01,4,4,4,4,8
70703,CABEZAS,estado nutricional en menores de 5 anos,clasificacion a y b,2002-10-01,26,20,26,20,46
20905,CAIROMA,estado nutricional en menores de 5 anos,clasificacion a y b,2002-10-01,8,0,8,0,8
51102,"CAIZA ""D""",estado nutricional en menores de 5 anos,clasificacion a y b,2002-10-01,11,3,11,3,14
21003,CAJUATA,estado nutricional en menores de 5 anos,clasificacion a y b,2002-10-01,12,3,12,3,15
20303,CALACOTO,estado nutricional en menores de 5 anos,clasificacion a y b,2002-10-01,2,0,2,0,2
21304,CALAMARCA,estado nutricional en menores de 5 anos,clasificacion a y b,2002-10-01,25,4,25,4,29
10701,CAMARGO,estado nutricional en menores de 5 anos,clasificacion a y b,2002-10-01,18,12,18,12,30
10901,CAMATAQUI (C. VILLA ABECIA),estado nutricional en menores de 5 anos,clasificacion a y b,2002-10-01,11,12,11,12,23
70706,CAMIRI,estado nutricional en menores de 5 anos,clasificacion a y b,2002-10-01,147,38,147,38,185
30701,CAPINOTA,estado nutricional en menores de 5 anos,clasificacion a y b,2002-10-01,1,6,1,6,7
20302,CAQUIAVIRI,estado nutricional en menores de 5 anos,clasificacion a y b,2002-10-01,12,4,12,4,16
40102,CARACOLLO,estado nutricional en menores de 5 anos,clasificacion a y b,2002-10-01,21,25,21,25,46
22001,CARANAVI,estado nutricional en menores de 5 anos,clasificacion a y b,2002-10-01,122,35,122,35,157
60302,CARAPARI,estado nutricional en menores de 5 anos,clasificacion a y b,2002-10-01,40,13,40,13,53
50702,CARIPUYO,estado nutricional en menores de 5 anos,clasificacion a y b,2002-10-01,4,1,4,1,5
21803,CHACARILLA,estado nutricional en menores de 5 anos,clasificacion a y b,2002-10-01,4,6,4,6,10
40201,CHALLAPATA,estado nutricional en menores de 5 anos,clasificacion a y b,2002-10-01,21,9,21,9,30
50302,CHAQUI,estado nutricional en menores de 5 anos,clasificacion a y b,2002-10-01,12,1,12,1,13
70702,CHARAGUA,estado nutricional en menores de 5 anos,clasificacion a y b,2002-10-01,28,61,28,61,89
20305,CHARAÑA,estado nutricional en menores de 5 anos,clasificacion a y b,2002-10-01,7,1,7,1,8
50202,CHAYANTA,estado nutricional en menores de 5 anos,clasificacion a y b,2002-10-01,6,6,6,6,12
31204,CHIMORE,estado nutricional en menores de 5 anos,clasificacion a y b,2002-10-01,18,10,18,10,28
40302,CHOQUE COTA,estado nutricional en menores de 5 anos,clasificacion a y b,2002-10-01,1,0,1,0,1
21101,CHULUMANI (V. DE LA LIBERTAD),estado nutricional en menores de 5 anos,clasificacion a y b,2002-10-01,5,7,5,7,12
20501,CHUMA,estado nutricional en menores de 5 anos,clasificacion a y b,2002-10-01,15,2,15,2,17
30801,CLIZA,estado nutricional en menores de 5 anos,clasificacion a y b,2002-10-01,10,15,10,15,25
90101,COBIJA,estado nutricional en menores de 5 anos,clasificacion a y b,2002-10-01,101,13,101,13,114
30101,COCHABAMBA,estado nutricional en menores de 5 anos,clasificacion a y b,2002-10-01,1665,1258,1665,1258,2923
30905,COLCAPIRHUA,estado nutricional en menores de 5 anos,clasificacion a y b,2002-10-01,36,9,36,9,45
50901,"COLCHA ""K""",estado nutricional en menores de 5 anos,clasificacion a y b,2002-10-01,25,10,25,10,35
21307,COLLANA,estado nutricional en menores de 5 anos,clasificacion a y b,2002-10-01,3,0,3,0,3
31002,COLOMI,estado nutricional en menores de 5 anos,clasificacion a y b,2002-10-01,18,12,18,12,30
50401,COLQUECHACA,estado nutricional en menores de 5 anos,clasificacion a y b,2002-10-01,15,8,15,8,23
21306,COLQUENCHA,estado nutricional en menores de 5 anos,clasificacion a y b,2002-10-01,20,12,20,12,32
21004,COLQUIRI,estado nutricional en menores de 5 anos,clasificacion a y b,2002-10-01,31,7,31,7,38
20304,COMANCHE,estado nutricional en menores de 5 anos,clasificacion a y b,2002-10-01,5,0,5,0,5
71301,COMARAPA,estado nutricional en menores de 5 anos,clasificacion a y b,2002-10-01,91,21,91,21,112
20605,COMBAYA,estado nutricional en menores de 5 anos,clasificacion a y b,2002-10-01,3,0,3,0,3
71101,CONCEPCION,estado nutricional en menores de 5 anos,clasificacion a y b,2002-10-01,6,1,6,1,7
21701,COPACABANA,estado nutricional en menores de 5 anos,clasificacion a y b,2002-10-01,21,2,21,2,23
21402,CORIPATA,estado nutricional en menores de 5 anos,clasificacion a y b,2002-10-01,44,9,44,9,53
20301,CORO CORO,estado nutricional en menores de 5 anos,clasificacion a y b,2002-10-01,12,2,12,2,14
21401,COROICO,estado nutricional en menores de 5 anos,clasificacion a y b,2002-10-01,9,3,9,3,12
40301,CORQUE,estado nutricional en menores de 5 anos,clasificacion a y b,2002-10-01,4,1,4,1,5
50601,COTAGAITA,estado nutricional en menores de 5 anos,clasificacion a y b,2002-10-01,38,28,38,28,66
70102,COTOCA,estado nutricional en menores de 5 anos,clasificacion a y b,2002-10-01,121,16,121,16,137
70704,CUEVO,estado nutricional en menores de 5 anos,clasificacion a y b,2002-10-01,18,4,18,4,22
10902,CULPINA,estado nutricional en menores de 5 anos,clasificacion a y b,2002-10-01,38,6,38,6,44
40401,CURAHUARA DE CARANGAS,estado nutricional en menores de 5 anos,clasificacion a y b,2002-10-01,3,5,3,5,8
21602,CURVA,estado nutricional en menores de 5 anos,clasificacion a y b,2002-10-01,1,0,1,0,1
20804,DESAGUADERO,estado nutricional en menores de 5 anos,clasificacion a y b,2002-10-01,8,2,8,2,10
20105,EL ALTO,estado nutricional en menores de 5 anos,clasificacion a y b,2002-10-01,753,225,753,225,978
40103,EL CHORO,estado nutricional en menores de 5 anos,clasificacion a y b,2002-10-01,10,4,10,4,14
71503,EL PUENTE(STC),estado nutricional en menores de 5 anos,clasificacion a y b,2002-10-01,19,17,19,17,36
60502,EL PUENTE(TJA),estado nutricional en menores de 5 anos,clasificacion a y b,2002-10-01,9,8,9,8,17
70105,EL TORNO,estado nutricional en menores de 5 anos,clasificacion a y b,2002-10-01,93,26,93,26,119
10405,EL VILLAR,estado nutricional en menores de 5 anos,clasificacion a y b,2002-10-01,11,4,11,4,15
60601,ENTRE RIOS,estado nutricional en menores de 5 anos,clasificacion a y b,2002-10-01,35,24,35,24,59
41101,EUCALIPTUS,estado nutricional en menores de 5 anos,clasificacion a y b,2002-10-01,5,1,5,1,6
90203,FILADELFIA,estado nutricional en menores de 5 anos,clasificacion a y b,2002-10-01,2,5,2,5,7
71002,GENERAL SAAVEDRA,estado nutricional en menores de 5 anos,clasificacion a y b,2002-10-01,60,77,60,77,137
21601,GRAL. J.J. PEREZ (CHARAZANI),estado nutricional en menores de 5 anos,clasificacion a y b,2002-10-01,12,5,12,5,17
20602,GUANAY,estado nutricional en menores de 5 anos,clasificacion a y b,2002-10-01,99,18,99,18,117
20802,GUAQUI,estado nutricional en menores de 5 anos,clasificacion a y b,2002-10-01,3,0,3,0,3
80202,GUAYARAMERIN,estado nutricional en menores de 5 anos,clasificacion a y b,2002-10-01,96,47,96,47,143
70705,GUTIERREZ,estado nutricional en menores de 5 anos,clasificacion a y b,2002-10-01,36,22,36,22,58
10502,HUACARETA,estado nutricional en menores de 5 anos,clasificacion a y b,2002-10-01,43,61,43,61,104
11002,HUACAYA (VILLA DE HUACAYA),estado nutricional en menores de 5 anos,clasificacion a y b,2002-10-01,5,6,5,6,11
40501,HUACHACALLA,estado nutricional en menores de 5 anos,clasificacion a y b,2002-10-01,2,2,2,2,4
40701,HUANUNI,estado nutricional en menores de 5 anos,clasificacion a y b,2002-10-01,33,9,33,9,42
80803,HUARACAJE,estado nutricional en menores de 5 anos,clasificacion a y b,2002-10-01,22,5,22,5,27
41601,HUAYLLAMARCA,estado nutricional en menores de 5 anos,clasificacion a y b,2002-10-01,1,0,1,0,1
21005,ICHOCA,estado nutricional en menores de 5 anos,clasificacion a y b,2002-10-01,10,9,10,9,19
10304,ICLA,estado nutricional en menores de 5 anos,clasificacion a y b,2002-10-01,8,8,8,8,16
10703,INCAHUASI,estado nutricional en menores de 5 anos,clasificacion a y b,2002-10-01,33,9,33,9,42
21001,INQUISIVI,estado nutricional en menores de 5 anos,clasificacion a y b,2002-10-01,15,3,15,3,18
21102,IRUPANA (VILLA DE LANZA),estado nutricional en menores de 5 anos,clasificacion a y b,2002-10-01,20,5,20,5,25
21501,IXIAMAS,estado nutricional en menores de 5 anos,clasificacion a y b,2002-10-01,19,11,19,11,30
21105,LA ASUNTA,estado nutricional en menores de 5 anos,clasificacion a y b,2002-10-01,66,7,66,7,73
70104,LA GUARDIA,estado nutricional en menores de 5 anos,clasificacion a y b,2002-10-01,98,37,98,37,135
20101,LA PAZ,estado nutricional en menores de 5 anos,clasificacion a y b,2002-10-01,681,321,681,321,1002
70701,LAGUNILLAS,estado nutricional en menores de 5 anos,clasificacion a y b,2002-10-01,26,6,26,6,32
21202,LAJA,estado nutricional en menores de 5 anos,clasificacion a y b,2002-10-01,46,7,46,7,53
10903,LAS CARRERAS,estado nutricional en menores de 5 anos,clasificacion a y b,2002-10-01,9,9,9,9,18
21006,LICOMA PAMPA,estado nutricional en menores de 5 anos,clasificacion a y b,2002-10-01,1,0,1,0,1
50203,LLALLAGUA,estado nutricional en menores de 5 anos,clasificacion a y b,2002-10-01,27,137,27,137,164
51401,LLICA,estado nutricional en menores de 5 anos,clasificacion a y b,2002-10-01,6,3,6,3,9
80601,LORETO,estado nutricional en menores de 5 anos,clasificacion a y b,2002-10-01,25,5,25,5,30
20901,LURIBAY,estado nutricional en menores de 5 anos,clasificacion a y b,2002-10-01,16,0,16,0,16
40702,MACHACAMARCA,estado nutricional en menores de 5 anos,clasificacion a y b,2002-10-01,6,3,6,3,9
11003,MACHARETI,estado nutricional en menores de 5 anos,clasificacion a y b,2002-10-01,41,25,41,25,66
80801,MAGDALENA,estado nutricional en menores de 5 anos,clasificacion a y b,2002-10-01,34,7,34,7,41
70903,MAIRANA,estado nutricional en menores de 5 anos,clasificacion a y b,2002-10-01,53,16,53,16,69
20103,MECAPACA,estado nutricional en menores de 5 anos,clasificacion a y b,2002-10-01,25,5,25,5,30
71003,MINEROS,estado nutricional en menores de 5 anos,clasificacion a y b,2002-10-01,163,49,163,49,212
31301,MIZQUE,estado nutricional en menores de 5 anos,clasificacion a y b,2002-10-01,10,14,10,14,24
20402,MOCOMOCO,estado nutricional en menores de 5 anos,clasificacion a y b,2002-10-01,24,3,24,3,27
51002,MOJINETE,estado nutricional en menores de 5 anos,clasificacion a y b,2002-10-01,1,0,1,0,1
10303,MOJOCOYA,estado nutricional en menores de 5 anos,clasificacion a y b,2002-10-01,28,22,28,22,50
10501,MONTEAGUDO,estado nutricional en menores de 5 anos,clasificacion a y b,2002-10-01,89,43,89,43,132
71001,MONTERO,estado nutricional en menores de 5 anos,clasificacion a y b,2002-10-01,413,121,413,121,534
70803,MORO MORO,estado nutricional en menores de 5 anos,clasificacion a y b,2002-10-01,4,5,4,5,9
30302,MOROCHATA,estado nutricional en menores de 5 anos,clasificacion a y b,2002-10-01,15,10,15,10,25
90401,NACEBE (SANTA ROSA DEL ABUNA),estado nutricional en menores de 5 anos,clasificacion a y b,2002-10-01,1,2,1,2,3
20307,NAZACARA DE PACAJES,estado nutricional en menores de 5 anos,clasificacion a y b,2002-10-01,2,0,2,0,2
90501,NUEVO MANOA (NUEVA ESPERANZA),estado nutricional en menores de 5 anos,clasificacion a y b,2002-10-01,1,2,1,2,3
50404,OCURI,estado nutricional en menores de 5 anos,clasificacion a y b,2002-10-01,12,10,12,10,22
70202,OKINAWA,estado nutricional en menores de 5 anos,clasificacion a y b,2002-10-01,4,7,4,7,11
30203,OMEREQUE,estado nutricional en menores de 5 anos,clasificacion a y b,2002-10-01,5,15,5,15,20
40101,ORURO,estado nutricional en menores de 5 anos,clasificacion a y b,2002-10-01,354,82,354,82,436
60201,PADCAYA,estado nutricional en menores de 5 anos,clasificacion a y b,2002-10-01,28,55,28,55,83
10401,PADILLA,estado nutricional en menores de 5 anos,clasificacion a y b,2002-10-01,43,3,43,3,46
70502,PAILON,estado nutricional en menores de 5 anos,clasificacion a y b,2002-10-01,23,17,23,17,40
20102,PALCA,estado nutricional en menores de 5 anos,clasificacion a y b,2002-10-01,9,2,9,2,11
21104,PALOS BLANCOS,estado nutricional en menores de 5 anos,clasificacion a y b,2002-10-01,45,8,45,8,53
40802,PAMPA AULLAGAS,estado nutricional en menores de 5 anos,clasificacion a y b,2002-10-01,2,0,2,0,2
70902,PAMPA GRANDE,estado nutricional en menores de 5 anos,clasificacion a y b,2002-10-01,34,5,34,5,39
21802,PAPEL PAMPA,estado nutricional en menores de 5 anos,clasificacion a y b,2002-10-01,5,1,5,1,6
30202,PASORAPA,estado nutricional en menores de 5 anos,clasificacion a y b,2002-10-01,11,2,11,2,13
21305,PATACAMAYA,estado nutricional en menores de 5 anos,clasificacion a y b,2002-10-01,26,3,26,3,29
40602,PAZÑA,estado nutricional en menores de 5 anos,clasificacion a y b,2002-10-01,1,0,1,0,1
20702,PELECHUCO,estado nutricional en menores de 5 anos,clasificacion a y b,2002-10-01,3,1,3,1,4
50403,POCOATA,estado nutricional en menores de 5 anos,clasificacion a y b,2002-10-01,51,10,51,10,61
31203,POCONA,estado nutricional en menores de 5 anos,clasificacion a y b,2002-10-01,16,8,16,8,24
31202,POJO (CBBA),estado nutricional en menores de 5 anos,clasificacion a y b,2002-10-01,132,60,132,60,192
40601,POOPO,estado nutricional en menores de 5 anos,clasificacion a y b,2002-10-01,2,0,2,0,2
51203,PORCO,estado nutricional en menores de 5 anos,clasificacion a y b,2002-10-01,15,5,15,5,20
10103,POROMA,estado nutricional en menores de 5 anos,clasificacion a y b,2002-10-01,46,8,46,8,54
70103,PORONGO,estado nutricional en menores de 5 anos,clasificacion a y b,2002-10-01,3,3,3,3,6
70601,PORTACHUELO,estado nutricional en menores de 5 anos,clasificacion a y b,2002-10-01,56,17,56,17,73
70804,POSTRER VALLE,estado nutricional en menores de 5 anos,clasificacion a y b,2002-10-01,4,3,4,3,7
50101,POTOSI,estado nutricional en menores de 5 anos,clasificacion a y b,2002-10-01,203,18,203,18,221
10302,PRESTO,estado nutricional en menores de 5 anos,clasificacion a y b,2002-10-01,30,6,30,6,36
70805,PUCARA,estado nutricional en menores de 5 anos,clasificacion a y b,2002-10-01,0,1,0,1,1
21201,PUCARANI,estado nutricional en menores de 5 anos,clasificacion a y b,2002-10-01,23,8,23,8,31
20401,PUERTO ACOSTA,estado nutricional en menores de 5 anos,clasificacion a y b,2002-10-01,58,65,58,65,123
20403,PUERTO CARABUCO,estado nutricional en menores de 5 anos,clasificacion a y b,2002-10-01,23,15,23,15,38
90301,PUERTO GONZALO MORENO,estado nutricional en menores de 5 anos,clasificacion a y b,2002-10-01,1,0,1,0,1
21204,PUERTO PEREZ,estado nutricional en menores de 5 anos,clasificacion a y b,2002-10-01,7,0,7,0,7
71402,PUERTO QUIJARRO,estado nutricional en menores de 5 anos,clasificacion a y b,2002-10-01,59,12,59,12,71
90201,PUERTO RICO,estado nutricional en menores de 5 anos,clasificacion a y b,2002-10-01,8,9,8,9,17
71401,PUERTO SUAREZ,estado nutricional en menores de 5 anos,clasificacion a y b,2002-10-01,34,5,34,5,39
31205,PUERTO VILLARROEL,estado nutricional en menores de 5 anos,clasificacion a y b,2002-10-01,167,50,167,50,217
51101,PUNA,estado nutricional en menores de 5 anos,clasificacion a y b,2002-10-01,16,5,16,5,21
31401,PUNATA,estado nutricional en menores de 5 anos,clasificacion a y b,2002-10-01,23,10,23,10,33
20604,QUIABAYA,estado nutricional en menores de 5 anos,clasificacion a y b,2002-10-01,10,0,10,0,10
30901,QUILLACOLLO,estado nutricional en menores de 5 anos,clasificacion a y b,2002-10-01,139,124,139,124,263
21002,QUIME,estado nutricional en menores de 5 anos,clasificacion a y b,2002-10-01,22,12,22,12,34
70904,QUIRUSILLAS,estado nutricional en menores de 5 anos,clasificacion a y b,2002-10-01,1,2,1,2,3
50402,RAVELO,estado nutricional en menores de 5 anos,clasificacion a y b,2002-10-01,27,6,27,6,33
80301,REYES,estado nutricional en menores de 5 anos,clasificacion a y b,2002-10-01,26,5,26,5,31
80201,RIBERALTA,estado nutricional en menores de 5 anos,clasificacion a y b,2002-10-01,203,35,203,35,238
70503,ROBORE,estado nutricional en menores de 5 anos,clasificacion a y b,2002-10-01,45,9,45,9,54
80304,RURRENABAQUE,estado nutricional en menores de 5 anos,clasificacion a y b,2002-10-01,9,4,9,4,13
31001,SACABA,estado nutricional en menores de 5 anos,clasificacion a y b,2002-10-01,138,10,138,10,148
30404,SACABAMBA,estado nutricional en menores de 5 anos,clasificacion a y b,2002-10-01,5,1,5,1,6
50701,SACACA,estado nutricional en menores de 5 anos,clasificacion a y b,2002-10-01,5,1,5,1,6
71302,SAIPINA,estado nutricional en menores de 5 anos,clasificacion a y b,2002-10-01,27,26,27,26,53
40801,SALINAS DE GARCI MENDOZA,estado nutricional en menores de 5 anos,clasificacion a y b,2002-10-01,4,3,4,3,7
70901,SAMAIPATA,estado nutricional en menores de 5 anos,clasificacion a y b,2002-10-01,33,3,33,3,36
51601,SAN AGUSTIN,estado nutricional en menores de 5 anos,clasificacion a y b,2002-10-01,1,0,1,0,1
80602,SAN ANDRES,estado nutricional en menores de 5 anos,clasificacion a y b,2002-10-01,6,3,6,3,9
71105,SAN ANTONIO DE LOMERIO,estado nutricional en menores de 5 anos,clasificacion a y b,2002-10-01,17,9,17,9,26
31403,SAN BENITO,estado nutricional en menores de 5 anos,clasificacion a y b,2002-10-01,4,17,4,17,21
80302,SAN BORJA,estado nutricional en menores de 5 anos,clasificacion a y b,2002-10-01,80,32,80,32,112
21502,SAN BUENA VENTURA,estado nutricional en menores de 5 anos,clasificacion a y b,2002-10-01,16,2,16,2,18
80501,SAN IGNACIO,estado nutricional en menores de 5 anos,clasificacion a y b,2002-10-01,61,25,61,25,86
70301,SAN IGNACIO DE VELASCO,estado nutricional en menores de 5 anos,clasificacion a y b,2002-10-01,136,14,136,14,150
80102,SAN JAVIER(BNI),estado nutricional en menores de 5 anos,clasificacion a y b,2002-10-01,1,2,1,2,3
71102,SAN JAVIER(STC),estado nutricional en menores de 5 anos,clasificacion a y b,2002-10-01,53,3,53,3,56
80701,SAN JOAQUIN,estado nutricional en menores de 5 anos,clasificacion a y b,2002-10-01,4,9,4,9,13
70501,SAN JOSE DE CHIQUITOS,estado nutricional en menores de 5 anos,clasificacion a y b,2002-10-01,23,2,23,2,25
71104,SAN JULIAN,estado nutricional en menores de 5 anos,clasificacion a y b,2002-10-01,117,25,117,25,142
90302,SAN LORENZO(PND),estado nutricional en menores de 5 anos,clasificacion a y b,2002-10-01,7,4,7,4,11
60501,SAN LORENZO(TJA),estado nutricional en menores de 5 anos,clasificacion a y b,2002-10-01,11,3,11,3,14
10702,SAN LUCAS,estado nutricional en menores de 5 anos,clasificacion a y b,2002-10-01,63,13,63,13,76
71201,SAN MATIAS,estado nutricional en menores de 5 anos,clasificacion a y b,2002-10-01,34,15,34,15,49
70302,SAN MIGUEL DE VELASCO,estado nutricional en menores de 5 anos,clasificacion a y b,2002-10-01,24,5,24,5,29
51001,SAN PABLO DE LIPEZ,estado nutricional en menores de 5 anos,clasificacion a y b,2002-10-01,0,1,0,1,1
50501,SAN PEDRO DE BUENA VISTA,estado nutricional en menores de 5 anos,clasificacion a y b,2002-10-01,8,11,8,11,19
21801,SAN PEDRO DE CURAHUARA,estado nutricional en menores de 5 anos,clasificacion a y b,2002-10-01,12,0,12,0,12
21702,SAN PEDRO DE TIQUINA,estado nutricional en menores de 5 anos,clasificacion a y b,2002-10-01,6,6,6,6,12
90202,SAN PEDRO(PND),estado nutricional en menores de 5 anos,clasificacion a y b,2002-10-01,2,0,2,0,2
70303,SAN RAFAEL,estado nutricional en menores de 5 anos,clasificacion a y b,2002-10-01,12,6,12,6,18
80702,SAN RAMON,estado nutricional en menores de 5 anos,clasificacion a y b,2002-10-01,18,6,18,6,24
80702,SAN RAMON,estado nutricional en menores de 5 anos,clasificacion a y b,2002-10-01,14,3,14,3,17
80401,SANTA ANA,estado nutricional en menores de 5 anos,clasificacion a y b,2002-10-01,22,14,22,14,36
70101,SANTA CRUZ DE LA SIERRA,estado nutricional en menores de 5 anos,clasificacion a y b,2002-10-01,1811,752,1811,752,2563
80303,SANTA ROSA,estado nutricional en menores de 5 anos,clasificacion a y b,2002-10-01,8,11,8,11,19
70602,SANTA ROSA DEL SARA,estado nutricional en menores de 5 anos,clasificacion a y b,2002-10-01,19,15,19,15,34
20308,SANTIAGO DE CALLAPA,estado nutricional en menores de 5 anos,clasificacion a y b,2002-10-01,9,6,9,6,15
41401,SANTIAGO DE HUARI,estado nutricional en menores de 5 anos,clasificacion a y b,2002-10-01,8,2,8,2,10
21901,SANTIAGO DE MACHACA,estado nutricional en menores de 5 anos,clasificacion a y b,2002-10-01,5,0,5,0,5
30702,SANTIVAÑES,estado nutricional en menores de 5 anos,clasificacion a y b,2002-10-01,4,0,4,0,4
40202,SANTUARIO DE QUILLACAS,estado nutricional en menores de 5 anos,clasificacion a y b,2002-10-01,0,3,0,3,3
20902,SAPAHAQUI,estado nutricional en menores de 5 anos,clasificacion a y b,2002-10-01,8,1,8,1,9
90303,SENA,estado nutricional en menores de 5 anos,clasificacion a y b,2002-10-01,1,10,1,10,11
21301,SICA SICA (VILLA AROMA),estado nutricional en menores de 5 anos,clasificacion a y b,2002-10-01,36,9,36,9,45
30703,SICAYA,estado nutricional en menores de 5 anos,clasificacion a y b,2002-10-01,1,0,1,0,1
30902,SIPE SIPE,estado nutricional en menores de 5 anos,clasificacion a y b,2002-10-01,131,35,131,35,166
10403,SOPACHUY,estado nutricional en menores de 5 anos,clasificacion a y b,2002-10-01,12,2,12,2,14
20601,SORATA,estado nutricional en menores de 5 anos,clasificacion a y b,2002-10-01,23,3,23,3,26
10101,SUCRE,estado nutricional en menores de 5 anos,clasificacion a y b,2002-10-01,405,153,405,153,558
20603,TACACOMA,estado nutricional en menores de 5 anos,clasificacion a y b,2002-10-01,9,16,9,16,25
50303,TACOBAMBA,estado nutricional en menores de 5 anos,clasificacion a y b,2002-10-01,35,3,35,3,38
30602,TACOPAYA,estado nutricional en menores de 5 anos,clasificacion a y b,2002-10-01,12,6,12,6,18
31101,TAPACARI,estado nutricional en menores de 5 anos,clasificacion a y b,2002-10-01,24,4,24,4,28
10601,TARABUCO,estado nutricional en menores de 5 anos,clasificacion a y b,2002-10-01,34,9,34,9,43
30401,TARATA,estado nutricional en menores de 5 anos,clasificacion a y b,2002-10-01,15,4,15,4,19
60101,TARIJA,estado nutricional en menores de 5 anos,clasificacion a y b,2002-10-01,557,210,557,210,767
10202,TARVITA,estado nutricional en menores de 5 anos,clasificacion a y b,2002-10-01,27,8,27,8,35
20803,TIAWANACU,estado nutricional en menores de 5 anos,clasificacion a y b,2002-10-01,19,5,19,5,24
50102,TINGUIPAYA,estado nutricional en menores de 5 anos,clasificacion a y b,2002-10-01,26,8,26,8,34
20606,TIPUANI,estado nutricional en menores de 5 anos,clasificacion a y b,2002-10-01,32,1,32,1,33
30903,TIQUIPAYA,estado nutricional en menores de 5 anos,clasificacion a y b,2002-10-01,69,18,69,18,87
31601,TIRAQUE (CBBA),estado nutricional en menores de 5 anos,clasificacion a y b,2002-10-01,75,40,75,40,115
30802,TOCO,estado nutricional en menores de 5 anos,clasificacion a y b,2002-10-01,2,3,2,3,5
41001,TOLEDO,estado nutricional en menores de 5 anos,clasificacion a y b,2002-10-01,6,2,6,2,8
51202,TOMAVE,estado nutricional en menores de 5 anos,clasificacion a y b,2002-10-01,8,3,8,3,11
10402,TOMINA,estado nutricional en menores de 5 anos,clasificacion a y b,2002-10-01,44,5,44,5,49
50502,TORO TORO,estado nutricional en menores de 5 anos,clasificacion a y b,2002-10-01,14,4,14,4,18
31201,TOTORA(CBBA),estado nutricional en menores de 5 anos,clasificacion a y b,2002-10-01,30,5,30,5,35
41301,TOTORA(ORR),estado nutricional en menores de 5 anos,clasificacion a y b,2002-10-01,2,0,2,0,2
70802,TRIGAL,estado nutricional en menores de 5 anos,clasificacion a y b,2002-10-01,3,2,3,2,5
80101,TRINIDAD,estado nutricional en menores de 5 anos,clasificacion a y b,2002-10-01,179,149,179,149,328
50801,TUPIZA,estado nutricional en menores de 5 anos,clasificacion a y b,2002-10-01,41,66,41,66,107
40402,TURCO,estado nutricional en menores de 5 anos,clasificacion a y b,2002-10-01,5,2,5,2,7
21302,UMALA,estado nutricional en menores de 5 anos,clasificacion a y b,2002-10-01,9,1,9,1,10
60401,URIONDO (A. CONCEPCION),estado nutricional en menores de 5 anos,clasificacion a y b,2002-10-01,22,23,22,23,45
71502,URUBICHA,estado nutricional en menores de 5 anos,clasificacion a y b,2002-10-01,16,11,16,11,27
51201,UYUNI,estado nutricional en menores de 5 anos,clasificacion a y b,2002-10-01,74,11,74,11,85
30502,VACAS,estado nutricional en menores de 5 anos,clasificacion a y b,2002-10-01,3,2,3,2,5
70801,VALLEGRANDE,estado nutricional en menores de 5 anos,clasificacion a y b,2002-10-01,55,35,55,35,90
20801,VIACHA,estado nutricional en menores de 5 anos,clasificacion a y b,2002-10-01,63,30,63,30,93
31302,VILA VILA,estado nutricional en menores de 5 anos,clasificacion a y b,2002-10-01,1,6,1,6,7
60303,VILLA MONTES,estado nutricional en menores de 5 anos,clasificacion a y b,2002-10-01,61,18,61,18,79
90502,VILLA NUEVA (LOMA ALTA),estado nutricional en menores de 5 anos,clasificacion a y b,2002-10-01,1,0,1,0,1
31402,VILLA RIVERO,estado nutricional en menores de 5 anos,clasificacion a y b,2002-10-01,10,4,10,4,14
10801,VILLA SERRANO,estado nutricional en menores de 5 anos,clasificacion a y b,2002-10-01,25,3,25,3,28
31003,VILLA TUNARI,estado nutricional en menores de 5 anos,clasificacion a y b,2002-10-01,102,27,102,27,129
11001,VILLA VACA GUZMAN (MUYUPAMPA),estado nutricional en menores de 5 anos,clasificacion a y b,2002-10-01,58,6,58,6,64
51501,VILLAZON,estado nutricional en menores de 5 anos,clasificacion a y b,2002-10-01,85,28,85,28,113
30904,VINTO,estado nutricional en menores de 5 anos,clasificacion a y b,2002-10-01,102,13,102,13,115
50602,VITICHI,estado nutricional en menores de 5 anos,clasificacion a y b,2002-10-01,18,11,18,11,29
70201,WARNES,estado nutricional en menores de 5 anos,clasificacion a y b,2002-10-01,152,33,152,33,185
20903,YACO,estado nutricional en menores de 5 anos,clasificacion a y b,2002-10-01,7,5,7,5,12
60301,YACUIBA,estado nutricional en menores de 5 anos,clasificacion a y b,2002-10-01,130,46,130,46,176
10602,YAMPARAEZ,estado nutricional en menores de 5 anos,clasificacion a y b,2002-10-01,25,3,25,3,28
21103,YANACACHI,estado nutricional en menores de 5 anos,clasificacion a y b,2002-10-01,5,3,5,3,8
50103,YOCALLA,estado nutricional en menores de 5 anos,clasificacion a y b,2002-10-01,2,0,2,0,2
10102,YOTALA,estado nutricional en menores de 5 anos,clasificacion a y b,2002-10-01,38,9,38,9,47
60402,YUNCHARA,estado nutricional en menores de 5 anos,clasificacion a y b,2002-10-01,16,15,16,15,31
10301,ZUDAÑEZ,estado nutricional en menores de 5 anos,clasificacion a y b,2002-10-01,25,5,25,5,30
51302,ACACIO,estado nutricional en menores de 5 anos,clasificacion a y b,2002-11-01,2,0,2,0,2
20201,ACHACACHI,estado nutricional en menores de 5 anos,clasificacion a y b,2002-11-01,132,114,132,114,246
20104,ACHOCALLA,estado nutricional en menores de 5 anos,clasificacion a y b,2002-11-01,24,1,24,1,25
30201,AIQUILE,estado nutricional en menores de 5 anos,clasificacion a y b,2002-11-01,24,13,24,13,37
31303,ALALAY,estado nutricional en menores de 5 anos,clasificacion a y b,2002-11-01,0,3,0,3,3
10404,ALCALA,estado nutricional en menores de 5 anos,clasificacion a y b,2002-11-01,12,4,12,4,16
20202,ANCORAIMES,estado nutricional en menores de 5 anos,clasificacion a y b,2002-11-01,16,7,16,7,23
30402,ANZALDO,estado nutricional en menores de 5 anos,clasificacion a y b,2002-11-01,8,12,8,12,20
20701,APOLO,estado nutricional en menores de 5 anos,clasificacion a y b,2002-11-01,50,2,50,2,52
51301,ARAMPAMPA,estado nutricional en menores de 5 anos,clasificacion a y b,2002-11-01,21,5,21,5,26
30501,ARANI,estado nutricional en menores de 5 anos,clasificacion a y b,2002-11-01,10,1,10,1,11
30403,ARBIETO,estado nutricional en menores de 5 anos,clasificacion a y b,2002-11-01,5,1,5,1,6
30601,ARQUE,estado nutricional en menores de 5 anos,clasificacion a y b,2002-11-01,0,2,0,2,2
50802,ATOCHA,estado nutricional en menores de 5 anos,clasificacion a y b,2002-11-01,5,9,5,9,14
20503,AUCAPATA,estado nutricional en menores de 5 anos,clasificacion a y b,2002-11-01,11,3,11,3,14
20502,AYATA,estado nutricional en menores de 5 anos,clasificacion a y b,2002-11-01,13,0,13,0,13
21303,AYO AYO,estado nutricional en menores de 5 anos,clasificacion a y b,2002-11-01,19,6,19,6,25
30301,AYOPAYA (V. DE INDEPENDENCIA),estado nutricional en menores de 5 anos,clasificacion a y b,2002-11-01,16,14,16,14,30
10201,AZURDUY,estado nutricional en menores de 5 anos,clasificacion a y b,2002-11-01,46,28,46,28,74
21203,BATALLAS,estado nutricional en menores de 5 anos,clasificacion a y b,2002-11-01,39,17,39,17,56
80802,BAURES,estado nutricional en menores de 5 anos,clasificacion a y b,2002-11-01,8,3,8,3,11
41202,BELEN DE ANDAMARCA,estado nutricional en menores de 5 anos,clasificacion a y b,2002-11-01,0,1,0,1,1
50104,BELEN DE URMIRI,estado nutricional en menores de 5 anos,clasificacion a y b,2002-11-01,4,1,4,1,5
60202,BERMEJO,estado nutricional en menores de 5 anos,clasificacion a y b,2002-11-01,27,20,27,20,47
50301,BETANZOS,estado nutricional en menores de 5 anos,clasificacion a y b,2002-11-01,66,11,66,11,77
31501,BOLIVAR,estado nutricional en menores de 5 anos,clasificacion a y b,2002-11-01,9,4,9,4,13
90103,BOLPEBRA,estado nutricional en menores de 5 anos,clasificacion a y b,2002-11-01,2,1,2,1,3
70707,BOYUIBE,estado nutricional en menores de 5 anos,clasificacion a y b,2002-11-01,6,3,6,3,9
70401,BUENA VISTA,estado nutricional en menores de 5 anos,clasificacion a y b,2002-11-01,50,20,50,20,70
70703,CABEZAS,estado nutricional en menores de 5 anos,clasificacion a y b,2002-11-01,26,20,26,20,46
20905,CAIROMA,estado nutricional en menores de 5 anos,clasificacion a y b,2002-11-01,6,0,6,0,6
51102,"CAIZA ""D""",estado nutricional en menores de 5 anos,clasificacion a y b,2002-11-01,29,6,29,6,35
21003,CAJUATA,estado nutricional en menores de 5 anos,clasificacion a y b,2002-11-01,19,12,19,12,31
20303,CALACOTO,estado nutricional en menores de 5 anos,clasificacion a y b,2002-11-01,4,0,4,0,4
21304,CALAMARCA,estado nutricional en menores de 5 anos,clasificacion a y b,2002-11-01,18,0,18,0,18
10701,CAMARGO,estado nutricional en menores de 5 anos,clasificacion a y b,2002-11-01,18,8,18,8,26
10901,CAMATAQUI (C. VILLA ABECIA),estado nutricional en menores de 5 anos,clasificacion a y b,2002-11-01,9,1,9,1,10
70706,CAMIRI,estado nutricional en menores de 5 anos,clasificacion a y b,2002-11-01,76,24,76,24,100
30701,CAPINOTA,estado nutricional en menores de 5 anos,clasificacion a y b,2002-11-01,9,0,9,0,9
20302,CAQUIAVIRI,estado nutricional en menores de 5 anos,clasificacion a y b,2002-11-01,18,0,18,0,18
40102,CARACOLLO,estado nutricional en menores de 5 anos,clasificacion a y b,2002-11-01,20,18,20,18,38
22001,CARANAVI,estado nutricional en menores de 5 anos,clasificacion a y b,2002-11-01,128,41,128,41,169
60302,CARAPARI,estado nutricional en menores de 5 anos,clasificacion a y b,2002-11-01,23,7,23,7,30
50702,CARIPUYO,estado nutricional en menores de 5 anos,clasificacion a y b,2002-11-01,3,1,3,1,4
21902,CATACORA,estado nutricional en menores de 5 anos,clasificacion a y b,2002-11-01,1,1,1,1,2
21803,CHACARILLA,estado nutricional en menores de 5 anos,clasificacion a y b,2002-11-01,2,0,2,0,2
40201,CHALLAPATA,estado nutricional en menores de 5 anos,clasificacion a y b,2002-11-01,7,5,7,5,12
50302,CHAQUI,estado nutricional en menores de 5 anos,clasificacion a y b,2002-11-01,8,1,8,1,9
70702,CHARAGUA,estado nutricional en menores de 5 anos,clasificacion a y b,2002-11-01,30,46,30,46,76
50202,CHAYANTA,estado nutricional en menores de 5 anos,clasificacion a y b,2002-11-01,6,5,6,5,11
31204,CHIMORE,estado nutricional en menores de 5 anos,clasificacion a y b,2002-11-01,16,9,16,9,25
40903,CHIPAYA,estado nutricional en menores de 5 anos,clasificacion a y b,2002-11-01,1,0,1,0,1
21101,CHULUMANI (V. DE LA LIBERTAD),estado nutricional en menores de 5 anos,clasificacion a y b,2002-11-01,19,10,19,10,29
20501,CHUMA,estado nutricional en menores de 5 anos,clasificacion a y b,2002-11-01,14,4,14,4,18
30801,CLIZA,estado nutricional en menores de 5 anos,clasificacion a y b,2002-11-01,12,4,12,4,16
90101,COBIJA,estado nutricional en menores de 5 anos,clasificacion a y b,2002-11-01,50,2,50,2,52
30101,COCHABAMBA,estado nutricional en menores de 5 anos,clasificacion a y b,2002-11-01,1404,1105,1404,1105,2509
40902,COIPASA,estado nutricional en menores de 5 anos,clasificacion a y b,2002-11-01,1,0,1,0,1
30905,COLCAPIRHUA,estado nutricional en menores de 5 anos,clasificacion a y b,2002-11-01,18,6,18,6,24
50901,"COLCHA ""K""",estado nutricional en menores de 5 anos,clasificacion a y b,2002-11-01,14,4,14,4,18
21307,COLLANA,estado nutricional en menores de 5 anos,clasificacion a y b,2002-11-01,1,0,1,0,1
31002,COLOMI,estado nutricional en menores de 5 anos,clasificacion a y b,2002-11-01,24,3,24,3,27
50401,COLQUECHACA,estado nutricional en menores de 5 anos,clasificacion a y b,2002-11-01,12,6,12,6,18
21306,COLQUENCHA,estado nutricional en menores de 5 anos,clasificacion a y b,2002-11-01,29,2,29,2,31
21004,COLQUIRI,estado nutricional en menores de 5 anos,clasificacion a y b,2002-11-01,19,2,19,2,21
20304,COMANCHE,estado nutricional en menores de 5 anos,clasificacion a y b,2002-11-01,3,1,3,1,4
71301,COMARAPA,estado nutricional en menores de 5 anos,clasificacion a y b,2002-11-01,78,12,78,12,90
20605,COMBAYA,estado nutricional en menores de 5 anos,clasificacion a y b,2002-11-01,5,0,5,0,5
71101,CONCEPCION,estado nutricional en menores de 5 anos,clasificacion a y b,2002-11-01,65,80,65,80,145
21701,COPACABANA,estado nutricional en menores de 5 anos,clasificacion a y b,2002-11-01,20,1,20,1,21
21402,CORIPATA,estado nutricional en menores de 5 anos,clasificacion a y b,2002-11-01,40,10,40,10,50
20301,CORO CORO,estado nutricional en menores de 5 anos,clasificacion a y b,2002-11-01,11,6,11,6,17
21401,COROICO,estado nutricional en menores de 5 anos,clasificacion a y b,2002-11-01,5,6,5,6,11
40301,CORQUE,estado nutricional en menores de 5 anos,clasificacion a y b,2002-11-01,2,0,2,0,2
50601,COTAGAITA,estado nutricional en menores de 5 anos,clasificacion a y b,2002-11-01,28,10,28,10,38
70102,COTOCA,estado nutricional en menores de 5 anos,clasificacion a y b,2002-11-01,92,27,92,27,119
31405,CUCHUMUELA (V. G. VILLARROEL),estado nutricional en menores de 5 anos,clasificacion a y b,2002-11-01,1,0,1,0,1
70704,CUEVO,estado nutricional en menores de 5 anos,clasificacion a y b,2002-11-01,19,9,19,9,28
10902,CULPINA,estado nutricional en menores de 5 anos,clasificacion a y b,2002-11-01,40,21,40,21,61
40401,CURAHUARA DE CARANGAS,estado nutricional en menores de 5 anos,clasificacion a y b,2002-11-01,2,1,2,1,3
21602,CURVA,estado nutricional en menores de 5 anos,clasificacion a y b,2002-11-01,1,0,1,0,1
20804,DESAGUADERO,estado nutricional en menores de 5 anos,clasificacion a y b,2002-11-01,4,3,4,3,7
20105,EL ALTO,estado nutricional en menores de 5 anos,clasificacion a y b,2002-11-01,733,171,733,171,904
40103,EL CHORO,estado nutricional en menores de 5 anos,clasificacion a y b,2002-11-01,3,2,3,2,5
71503,EL PUENTE(STC),estado nutricional en menores de 5 anos,clasificacion a y b,2002-11-01,19,10,19,10,29
60502,EL PUENTE(TJA),estado nutricional en menores de 5 anos,clasificacion a y b,2002-11-01,5,11,5,11,16
70105,EL TORNO,estado nutricional en menores de 5 anos,clasificacion a y b,2002-11-01,156,26,156,26,182
10405,EL VILLAR,estado nutricional en menores de 5 anos,clasificacion a y b,2002-11-01,7,3,7,3,10
60601,ENTRE RIOS,estado nutricional en menores de 5 anos,clasificacion a y b,2002-11-01,22,22,22,22,44
41101,EUCALIPTUS,estado nutricional en menores de 5 anos,clasificacion a y b,2002-11-01,10,2,10,2,12
90503,EUREKA (SANTOS MERCADO),estado nutricional en menores de 5 anos,clasificacion a y b,2002-11-01,2,1,2,1,3
80402,EXALTACION,estado nutricional en menores de 5 anos,clasificacion a y b,2002-11-01,6,10,6,10,16
71002,GENERAL SAAVEDRA,estado nutricional en menores de 5 anos,clasificacion a y b,2002-11-01,72,33,72,33,105
21601,GRAL. J.J. PEREZ (CHARAZANI),estado nutricional en menores de 5 anos,clasificacion a y b,2002-11-01,6,26,6,26,32
20602,GUANAY,estado nutricional en menores de 5 anos,clasificacion a y b,2002-11-01,99,21,99,21,120
20802,GUAQUI,estado nutricional en menores de 5 anos,clasificacion a y b,2002-11-01,8,0,8,0,8
80202,GUAYARAMERIN,estado nutricional en menores de 5 anos,clasificacion a y b,2002-11-01,92,23,92,23,115
70705,GUTIERREZ,estado nutricional en menores de 5 anos,clasificacion a y b,2002-11-01,79,8,79,8,87
10502,HUACARETA,estado nutricional en menores de 5 anos,clasificacion a y b,2002-11-01,29,15,29,15,44
11002,HUACAYA (VILLA DE HUACAYA),estado nutricional en menores de 5 anos,clasificacion a y b,2002-11-01,4,2,4,2,6
40501,HUACHACALLA,estado nutricional en menores de 5 anos,clasificacion a y b,2002-11-01,1,7,1,7,8
40701,HUANUNI,estado nutricional en menores de 5 anos,clasificacion a y b,2002-11-01,26,3,26,3,29
80803,HUARACAJE,estado nutricional en menores de 5 anos,clasificacion a y b,2002-11-01,9,6,9,6,15
41601,HUAYLLAMARCA,estado nutricional en menores de 5 anos,clasificacion a y b,2002-11-01,2,0,2,0,2
21005,ICHOCA,estado nutricional en menores de 5 anos,clasificacion a y b,2002-11-01,10,15,10,15,25
10304,ICLA,estado nutricional en menores de 5 anos,clasificacion a y b,2002-11-01,9,5,9,5,14
10703,INCAHUASI,estado nutricional en menores de 5 anos,clasificacion a y b,2002-11-01,40,14,40,14,54
90402,INGAVI (HUMAITA),estado nutricional en menores de 5 anos,clasificacion a y b,2002-11-01,1,0,1,0,1
21001,INQUISIVI,estado nutricional en menores de 5 anos,clasificacion a y b,2002-11-01,32,6,32,6,38
21102,IRUPANA (VILLA DE LANZA),estado nutricional en menores de 5 anos,clasificacion a y b,2002-11-01,9,13,9,13,22
21501,IXIAMAS,estado nutricional en menores de 5 anos,clasificacion a y b,2002-11-01,36,8,36,8,44
21105,LA ASUNTA,estado nutricional en menores de 5 anos,clasificacion a y b,2002-11-01,34,9,34,9,43
70104,LA GUARDIA,estado nutricional en menores de 5 anos,clasificacion a y b,2002-11-01,90,36,90,36,126
20101,LA PAZ,estado nutricional en menores de 5 anos,clasificacion a y b,2002-11-01,605,250,605,250,855
70701,LAGUNILLAS,estado nutricional en menores de 5 anos,clasificacion a y b,2002-11-01,43,16,43,16,59
21202,LAJA,estado nutricional en menores de 5 anos,clasificacion a y b,2002-11-01,19,5,19,5,24
10903,LAS CARRERAS,estado nutricional en menores de 5 anos,clasificacion a y b,2002-11-01,10,3,10,3,13
50203,LLALLAGUA,estado nutricional en menores de 5 anos,clasificacion a y b,2002-11-01,12,64,12,64,76
51401,LLICA,estado nutricional en menores de 5 anos,clasificacion a y b,2002-11-01,7,3,7,3,10
80601,LORETO,estado nutricional en menores de 5 anos,clasificacion a y b,2002-11-01,15,12,15,12,27
20901,LURIBAY,estado nutricional en menores de 5 anos,clasificacion a y b,2002-11-01,19,2,19,2,21
40702,MACHACAMARCA,estado nutricional en menores de 5 anos,clasificacion a y b,2002-11-01,3,10,3,10,13
11003,MACHARETI,estado nutricional en menores de 5 anos,clasificacion a y b,2002-11-01,39,11,39,11,50
80801,MAGDALENA,estado nutricional en menores de 5 anos,clasificacion a y b,2002-11-01,15,3,15,3,18
70903,MAIRANA,estado nutricional en menores de 5 anos,clasificacion a y b,2002-11-01,55,7,55,7,62
20904,MALLA,estado nutricional en menores de 5 anos,clasificacion a y b,2002-11-01,2,1,2,1,3
20103,MECAPACA,estado nutricional en menores de 5 anos,clasificacion a y b,2002-11-01,7,3,7,3,10
71003,MINEROS,estado nutricional en menores de 5 anos,clasificacion a y b,2002-11-01,179,46,179,46,225
31301,MIZQUE,estado nutricional en menores de 5 anos,clasificacion a y b,2002-11-01,16,7,16,7,23
20402,MOCOMOCO,estado nutricional en menores de 5 anos,clasificacion a y b,2002-11-01,18,2,18,2,20
51002,MOJINETE,estado nutricional en menores de 5 anos,clasificacion a y b,2002-11-01,2,1,2,1,3
10303,MOJOCOYA,estado nutricional en menores de 5 anos,clasificacion a y b,2002-11-01,32,10,32,10,42
10501,MONTEAGUDO,estado nutricional en menores de 5 anos,clasificacion a y b,2002-11-01,94,17,94,17,111
71001,MONTERO,estado nutricional en menores de 5 anos,clasificacion a y b,2002-11-01,349,115,349,115,464
70803,MORO MORO,estado nutricional en menores de 5 anos,clasificacion a y b,2002-11-01,6,1,6,1,7
30302,MOROCHATA,estado nutricional en menores de 5 anos,clasificacion a y b,2002-11-01,29,16,29,16,45
90501,NUEVO MANOA (NUEVA ESPERANZA),estado nutricional en menores de 5 anos,clasificacion a y b,2002-11-01,3,0,3,0,3
50404,OCURI,estado nutricional en menores de 5 anos,clasificacion a y b,2002-11-01,8,13,8,13,21
70202,OKINAWA,estado nutricional en menores de 5 anos,clasificacion a y b,2002-11-01,17,0,17,0,17
30203,OMEREQUE,estado nutricional en menores de 5 anos,clasificacion a y b,2002-11-01,5,1,5,1,6
40101,ORURO,estado nutricional en menores de 5 anos,clasificacion a y b,2002-11-01,282,112,282,112,394
60201,PADCAYA,estado nutricional en menores de 5 anos,clasificacion a y b,2002-11-01,41,24,41,24,65
10401,PADILLA,estado nutricional en menores de 5 anos,clasificacion a y b,2002-11-01,59,7,59,7,66
70502,PAILON,estado nutricional en menores de 5 anos,clasificacion a y b,2002-11-01,25,3,25,3,28
20102,PALCA,estado nutricional en menores de 5 anos,clasificacion a y b,2002-11-01,9,1,9,1,10
21104,PALOS BLANCOS,estado nutricional en menores de 5 anos,clasificacion a y b,2002-11-01,47,9,47,9,56
40802,PAMPA AULLAGAS,estado nutricional en menores de 5 anos,clasificacion a y b,2002-11-01,1,0,1,0,1
70902,PAMPA GRANDE,estado nutricional en menores de 5 anos,clasificacion a y b,2002-11-01,19,3,19,3,22
21802,PAPEL PAMPA,estado nutricional en menores de 5 anos,clasificacion a y b,2002-11-01,1,0,1,0,1
30202,PASORAPA,estado nutricional en menores de 5 anos,clasificacion a y b,2002-11-01,9,1,9,1,10
21305,PATACAMAYA,estado nutricional en menores de 5 anos,clasificacion a y b,2002-11-01,30,1,30,1,31
40602,PAZÑA,estado nutricional en menores de 5 anos,clasificacion a y b,2002-11-01,2,1,2,1,3
20702,PELECHUCO,estado nutricional en menores de 5 anos,clasificacion a y b,2002-11-01,1,0,1,0,1
50403,POCOATA,estado nutricional en menores de 5 anos,clasificacion a y b,2002-11-01,22,8,22,8,30
31203,POCONA,estado nutricional en menores de 5 anos,clasificacion a y b,2002-11-01,7,4,7,4,11
31202,POJO (CBBA),estado nutricional en menores de 5 anos,clasificacion a y b,2002-11-01,111,38,111,38,149
40601,POOPO,estado nutricional en menores de 5 anos,clasificacion a y b,2002-11-01,0,2,0,2,2
10103,POROMA,estado nutricional en menores de 5 anos,clasificacion a y b,2002-11-01,47,12,47,12,59
70103,PORONGO,estado nutricional en menores de 5 anos,clasificacion a y b,2002-11-01,1,1,1,1,2
70601,PORTACHUELO,estado nutricional en menores de 5 anos,clasificacion a y b,2002-11-01,84,27,84,27,111
90102,PORVENIR,estado nutricional en menores de 5 anos,clasificacion a y b,2002-11-01,6,1,6,1,7
70804,POSTRER VALLE,estado nutricional en menores de 5 anos,clasificacion a y b,2002-11-01,2,0,2,0,2
50101,POTOSI,estado nutricional en menores de 5 anos,clasificacion a y b,2002-11-01,181,19,181,19,200
10302,PRESTO,estado nutricional en menores de 5 anos,clasificacion a y b,2002-11-01,26,5,26,5,31
70805,PUCARA,estado nutricional en menores de 5 anos,clasificacion a y b,2002-11-01,2,0,2,0,2
21201,PUCARANI,estado nutricional en menores de 5 anos,clasificacion a y b,2002-11-01,16,11,16,11,27
20401,PUERTO ACOSTA,estado nutricional en menores de 5 anos,clasificacion a y b,2002-11-01,58,65,58,65,123
20403,PUERTO CARABUCO,estado nutricional en menores de 5 anos,clasificacion a y b,2002-11-01,10,4,10,4,14
90301,PUERTO GONZALO MORENO,estado nutricional en menores de 5 anos,clasificacion a y b,2002-11-01,2,0,2,0,2
21204,PUERTO PEREZ,estado nutricional en menores de 5 anos,clasificacion a y b,2002-11-01,11,0,11,0,11
71402,PUERTO QUIJARRO,estado nutricional en menores de 5 anos,clasificacion a y b,2002-11-01,52,8,52,8,60
90201,PUERTO RICO,estado nutricional en menores de 5 anos,clasificacion a y b,2002-11-01,9,8,9,8,17
80703,PUERTO SILES,estado nutricional en menores de 5 anos,clasificacion a y b,2002-11-01,1,1,1,1,2
71401,PUERTO SUAREZ,estado nutricional en menores de 5 anos,clasificacion a y b,2002-11-01,37,4,37,4,41
31205,PUERTO VILLARROEL,estado nutricional en menores de 5 anos,clasificacion a y b,2002-11-01,112,42,112,42,154
51101,PUNA,estado nutricional en menores de 5 anos,clasificacion a y b,2002-11-01,39,13,39,13,52
31401,PUNATA,estado nutricional en menores de 5 anos,clasificacion a y b,2002-11-01,9,1,9,1,10
20604,QUIABAYA,estado nutricional en menores de 5 anos,clasificacion a y b,2002-11-01,7,1,7,1,8
30901,QUILLACOLLO,estado nutricional en menores de 5 anos,clasificacion a y b,2002-11-01,72,41,72,41,113
21002,QUIME,estado nutricional en menores de 5 anos,clasificacion a y b,2002-11-01,16,6,16,6,22
70904,QUIRUSILLAS,estado nutricional en menores de 5 anos,clasificacion a y b,2002-11-01,4,1,4,1,5
50402,RAVELO,estado nutricional en menores de 5 anos,clasificacion a y b,2002-11-01,12,1,12,1,13
80301,REYES,estado nutricional en menores de 5 anos,clasificacion a y b,2002-11-01,39,4,39,4,43
80201,RIBERALTA,estado nutricional en menores de 5 anos,clasificacion a y b,2002-11-01,144,43,144,43,187
70503,ROBORE,estado nutricional en menores de 5 anos,clasificacion a y b,2002-11-01,29,12,29,12,41
80304,RURRENABAQUE,estado nutricional en menores de 5 anos,clasificacion a y b,2002-11-01,0,1,0,1,1
40901,SABAYA,estado nutricional en menores de 5 anos,clasificacion a y b,2002-11-01,3,0,3,0,3
31001,SACABA,estado nutricional en menores de 5 anos,clasificacion a y b,2002-11-01,115,9,115,9,124
30404,SACABAMBA,estado nutricional en menores de 5 anos,clasificacion a y b,2002-11-01,0,2,0,2,2
50701,SACACA,estado nutricional en menores de 5 anos,clasificacion a y b,2002-11-01,5,5,5,5,10
71302,SAIPINA,estado nutricional en menores de 5 anos,clasificacion a y b,2002-11-01,54,34,54,34,88
70901,SAMAIPATA,estado nutricional en menores de 5 anos,clasificacion a y b,2002-11-01,34,5,34,5,39
51601,SAN AGUSTIN,estado nutricional en menores de 5 anos,clasificacion a y b,2002-11-01,2,0,2,0,2
80602,SAN ANDRES,estado nutricional en menores de 5 anos,clasificacion a y b,2002-11-01,8,4,8,4,12
51003,SAN ANTONIO DE ESMORUCO,estado nutricional en menores de 5 anos,clasificacion a y b,2002-11-01,1,0,1,0,1
71105,SAN ANTONIO DE LOMERIO,estado nutricional en menores de 5 anos,clasificacion a y b,2002-11-01,12,3,12,3,15
31403,SAN BENITO,estado nutricional en menores de 5 anos,clasificacion a y b,2002-11-01,5,37,5,37,42
80302,SAN BORJA,estado nutricional en menores de 5 anos,clasificacion a y b,2002-11-01,60,47,60,47,107
21502,SAN BUENA VENTURA,estado nutricional en menores de 5 anos,clasificacion a y b,2002-11-01,25,15,25,15,40
70402,SAN CARLOS,estado nutricional en menores de 5 anos,clasificacion a y b,2002-11-01,92,22,92,22,114
80501,SAN IGNACIO,estado nutricional en menores de 5 anos,clasificacion a y b,2002-11-01,62,29,62,29,91
70301,SAN IGNACIO DE VELASCO,estado nutricional en menores de 5 anos,clasificacion a y b,2002-11-01,165,30,165,30,195
80102,SAN JAVIER(BNI),estado nutricional en menores de 5 anos,clasificacion a y b,2002-11-01,6,3,6,3,9
71102,SAN JAVIER(STC),estado nutricional en menores de 5 anos,clasificacion a y b,2002-11-01,36,4,36,4,40
70501,SAN JOSE DE CHIQUITOS,estado nutricional en menores de 5 anos,clasificacion a y b,2002-11-01,32,15,32,15,47
71104,SAN JULIAN,estado nutricional en menores de 5 anos,clasificacion a y b,2002-11-01,118,42,118,42,160
90302,SAN LORENZO(PND),estado nutricional en menores de 5 anos,clasificacion a y b,2002-11-01,4,5,4,5,9
60501,SAN LORENZO(TJA),estado nutricional en menores de 5 anos,clasificacion a y b,2002-11-01,17,4,17,4,21
10702,SAN LUCAS,estado nutricional en menores de 5 anos,clasificacion a y b,2002-11-01,51,12,51,12,63
70302,SAN MIGUEL DE VELASCO,estado nutricional en menores de 5 anos,clasificacion a y b,2002-11-01,23,4,23,4,27
51001,SAN PABLO DE LIPEZ,estado nutricional en menores de 5 anos,clasificacion a y b,2002-11-01,7,0,7,0,7
50501,SAN PEDRO DE BUENA VISTA,estado nutricional en menores de 5 anos,clasificacion a y b,2002-11-01,6,9,6,9,15
21801,SAN PEDRO DE CURAHUARA,estado nutricional en menores de 5 anos,clasificacion a y b,2002-11-01,5,0,5,0,5
21702,SAN PEDRO DE TIQUINA,estado nutricional en menores de 5 anos,clasificacion a y b,2002-11-01,8,1,8,1,9
90202,SAN PEDRO(PND),estado nutricional en menores de 5 anos,clasificacion a y b,2002-11-01,4,1,4,1,5
70303,SAN RAFAEL,estado nutricional en menores de 5 anos,clasificacion a y b,2002-11-01,19,1,19,1,20
80702,SAN RAMON,estado nutricional en menores de 5 anos,clasificacion a y b,2002-11-01,10,4,10,4,14
80702,SAN RAMON,estado nutricional en menores de 5 anos,clasificacion a y b,2002-11-01,6,2,6,2,8
80401,SANTA ANA,estado nutricional en menores de 5 anos,clasificacion a y b,2002-11-01,6,20,6,20,26
70101,SANTA CRUZ DE LA SIERRA,estado nutricional en menores de 5 anos,clasificacion a y b,2002-11-01,1607,643,1607,643,2250
80303,SANTA ROSA,estado nutricional en menores de 5 anos,clasificacion a y b,2002-11-01,34,10,34,10,44
70602,SANTA ROSA DEL SARA,estado nutricional en menores de 5 anos,clasificacion a y b,2002-11-01,7,2,7,2,9
20308,SANTIAGO DE CALLAPA,estado nutricional en menores de 5 anos,clasificacion a y b,2002-11-01,3,0,3,0,3
41401,SANTIAGO DE HUARI,estado nutricional en menores de 5 anos,clasificacion a y b,2002-11-01,11,12,11,12,23
21901,SANTIAGO DE MACHACA,estado nutricional en menores de 5 anos,clasificacion a y b,2002-11-01,10,0,10,0,10
30702,SANTIVAÑES,estado nutricional en menores de 5 anos,clasificacion a y b,2002-11-01,7,1,7,1,8
40202,SANTUARIO DE QUILLACAS,estado nutricional en menores de 5 anos,clasificacion a y b,2002-11-01,0,2,0,2,2
20902,SAPAHAQUI,estado nutricional en menores de 5 anos,clasificacion a y b,2002-11-01,10,2,10,2,12
90303,SENA,estado nutricional en menores de 5 anos,clasificacion a y b,2002-11-01,2,0,2,0,2
21301,SICA SICA (VILLA AROMA),estado nutricional en menores de 5 anos,clasificacion a y b,2002-11-01,19,7,19,7,26
30703,SICAYA,estado nutricional en menores de 5 anos,clasificacion a y b,2002-11-01,1,0,1,0,1
30902,SIPE SIPE,estado nutricional en menores de 5 anos,clasificacion a y b,2002-11-01,144,41,144,41,185
10403,SOPACHUY,estado nutricional en menores de 5 anos,clasificacion a y b,2002-11-01,17,2,17,2,19
20601,SORATA,estado nutricional en menores de 5 anos,clasificacion a y b,2002-11-01,32,13,32,13,45
10101,SUCRE,estado nutricional en menores de 5 anos,clasificacion a y b,2002-11-01,346,87,346,87,433
20603,TACACOMA,estado nutricional en menores de 5 anos,clasificacion a y b,2002-11-01,22,2,22,2,24
50303,TACOBAMBA,estado nutricional en menores de 5 anos,clasificacion a y b,2002-11-01,28,3,28,3,31
30602,TACOPAYA,estado nutricional en menores de 5 anos,clasificacion a y b,2002-11-01,9,4,9,4,13
51402,TAHUA,estado nutricional en menores de 5 anos,clasificacion a y b,2002-11-01,0,1,0,1,1
31101,TAPACARI,estado nutricional en menores de 5 anos,clasificacion a y b,2002-11-01,16,3,16,3,19
10601,TARABUCO,estado nutricional en menores de 5 anos,clasificacion a y b,2002-11-01,49,3,49,3,52
30401,TARATA,estado nutricional en menores de 5 anos,clasificacion a y b,2002-11-01,8,3,8,3,11
60101,TARIJA,estado nutricional en menores de 5 anos,clasificacion a y b,2002-11-01,269,135,269,135,404
10202,TARVITA,estado nutricional en menores de 5 anos,clasificacion a y b,2002-11-01,20,5,20,5,25
20803,TIAWANACU,estado nutricional en menores de 5 anos,clasificacion a y b,2002-11-01,25,7,25,7,32
50102,TINGUIPAYA,estado nutricional en menores de 5 anos,clasificacion a y b,2002-11-01,4,4,4,4,8
20606,TIPUANI,estado nutricional en menores de 5 anos,clasificacion a y b,2002-11-01,41,4,41,4,45
30903,TIQUIPAYA,estado nutricional en menores de 5 anos,clasificacion a y b,2002-11-01,62,11,62,11,73
31601,TIRAQUE (CBBA),estado nutricional en menores de 5 anos,clasificacion a y b,2002-11-01,76,34,76,34,110
30802,TOCO,estado nutricional en menores de 5 anos,clasificacion a y b,2002-11-01,2,1,2,1,3
30803,TOLATA,estado nutricional en menores de 5 anos,clasificacion a y b,2002-11-01,4,1,4,1,5
41001,TOLEDO,estado nutricional en menores de 5 anos,clasificacion a y b,2002-11-01,7,1,7,1,8
51202,TOMAVE,estado nutricional en menores de 5 anos,clasificacion a y b,2002-11-01,14,1,14,1,15
10402,TOMINA,estado nutricional en menores de 5 anos,clasificacion a y b,2002-11-01,35,7,35,7,42
50502,TORO TORO,estado nutricional en menores de 5 anos,clasificacion a y b,2002-11-01,6,1,6,1,7
31201,TOTORA(CBBA),estado nutricional en menores de 5 anos,clasificacion a y b,2002-11-01,15,5,15,5,20
41301,TOTORA(ORR),estado nutricional en menores de 5 anos,clasificacion a y b,2002-11-01,1,0,1,0,1
70802,TRIGAL,estado nutricional en menores de 5 anos,clasificacion a y b,2002-11-01,3,2,3,2,5
80101,TRINIDAD,estado nutricional en menores de 5 anos,clasificacion a y b,2002-11-01,126,71,126,71,197
50801,TUPIZA,estado nutricional en menores de 5 anos,clasificacion a y b,2002-11-01,34,40,34,40,74
40402,TURCO,estado nutricional en menores de 5 anos,clasificacion a y b,2002-11-01,1,0,1,0,1
21302,UMALA,estado nutricional en menores de 5 anos,clasificacion a y b,2002-11-01,4,8,4,8,12
50201,UNCIA,estado nutricional en menores de 5 anos,clasificacion a y b,2002-11-01,3,1,3,1,4
60401,URIONDO (A. CONCEPCION),estado nutricional en menores de 5 anos,clasificacion a y b,2002-11-01,25,11,25,11,36
71502,URUBICHA,estado nutricional en menores de 5 anos,clasificacion a y b,2002-11-01,2,2,2,2,4
51201,UYUNI,estado nutricional en menores de 5 anos,clasificacion a y b,2002-11-01,39,28,39,28,67
30502,VACAS,estado nutricional en menores de 5 anos,clasificacion a y b,2002-11-01,1,3,1,3,4
70801,VALLEGRANDE,estado nutricional en menores de 5 anos,clasificacion a y b,2002-11-01,49,22,49,22,71
20801,VIACHA,estado nutricional en menores de 5 anos,clasificacion a y b,2002-11-01,68,24,68,24,92
60303,VILLA MONTES,estado nutricional en menores de 5 anos,clasificacion a y b,2002-11-01,49,16,49,16,65
90502,VILLA NUEVA (LOMA ALTA),estado nutricional en menores de 5 anos,clasificacion a y b,2002-11-01,2,1,2,1,3
31402,VILLA RIVERO,estado nutricional en menores de 5 anos,clasificacion a y b,2002-11-01,14,1,14,1,15
10801,VILLA SERRANO,estado nutricional en menores de 5 anos,clasificacion a y b,2002-11-01,45,9,45,9,54
31003,VILLA TUNARI,estado nutricional en menores de 5 anos,clasificacion a y b,2002-11-01,71,20,71,20,91
11001,VILLA VACA GUZMAN (MUYUPAMPA),estado nutricional en menores de 5 anos,clasificacion a y b,2002-11-01,37,7,37,7,44
51501,VILLAZON,estado nutricional en menores de 5 anos,clasificacion a y b,2002-11-01,90,16,90,16,106
30904,VINTO,estado nutricional en menores de 5 anos,clasificacion a y b,2002-11-01,29,4,29,4,33
50602,VITICHI,estado nutricional en menores de 5 anos,clasificacion a y b,2002-11-01,17,2,17,2,19
20306,WALDO BALLIVIAN,estado nutricional en menores de 5 anos,clasificacion a y b,2002-11-01,0,1,0,1,1
70201,WARNES,estado nutricional en menores de 5 anos,clasificacion a y b,2002-11-01,138,35,138,35,173
20903,YACO,estado nutricional en menores de 5 anos,clasificacion a y b,2002-11-01,7,5,7,5,12
60301,YACUIBA,estado nutricional en menores de 5 anos,clasificacion a y b,2002-11-01,160,35,160,35,195
10602,YAMPARAEZ,estado nutricional en menores de 5 anos,clasificacion a y b,2002-11-01,33,4,33,4,37
21103,YANACACHI,estado nutricional en menores de 5 anos,clasificacion a y b,2002-11-01,10,2,10,2,12
70403,YAPACANI,estado nutricional en menores de 5 anos,clasificacion a y b,2002-11-01,53,15,53,15,68
50103,YOCALLA,estado nutricional en menores de 5 anos,clasificacion a y b,2002-11-01,13,1,13,1,14
10102,YOTALA,estado nutricional en menores de 5 anos,clasificacion a y b,2002-11-01,40,8,40,8,48
60402,YUNCHARA,estado nutricional en menores de 5 anos,clasificacion a y b,2002-11-01,21,4,21,4,25
10301,ZUDAÑEZ,estado nutricional en menores de 5 anos,clasificacion a y b,2002-11-01,17,2,17,2,19
51302,ACACIO,estado nutricional en menores de 5 anos,clasificacion a y b,2002-12-01,4,4,4,4,8
20201,ACHACACHI,estado nutricional en menores de 5 anos,clasificacion a y b,2002-12-01,78,44,78,44,122
20104,ACHOCALLA,estado nutricional en menores de 5 anos,clasificacion a y b,2002-12-01,27,1,27,1,28
30201,AIQUILE,estado nutricional en menores de 5 anos,clasificacion a y b,2002-12-01,38,12,38,12,50
31303,ALALAY,estado nutricional en menores de 5 anos,clasificacion a y b,2002-12-01,1,0,1,0,1
10404,ALCALA,estado nutricional en menores de 5 anos,clasificacion a y b,2002-12-01,14,1,14,1,15
20202,ANCORAIMES,estado nutricional en menores de 5 anos,clasificacion a y b,2002-12-01,8,4,8,4,12
30402,ANZALDO,estado nutricional en menores de 5 anos,clasificacion a y b,2002-12-01,1,3,1,3,4
20701,APOLO,estado nutricional en menores de 5 anos,clasificacion a y b,2002-12-01,27,3,27,3,30
51301,ARAMPAMPA,estado nutricional en menores de 5 anos,clasificacion a y b,2002-12-01,9,0,9,0,9
30501,ARANI,estado nutricional en menores de 5 anos,clasificacion a y b,2002-12-01,3,7,3,7,10
30403,ARBIETO,estado nutricional en menores de 5 anos,clasificacion a y b,2002-12-01,4,1,4,1,5
30601,ARQUE,estado nutricional en menores de 5 anos,clasificacion a y b,2002-12-01,0,1,0,1,1
71501,ASCENCION DE GUARAYOS,estado nutricional en menores de 5 anos,clasificacion a y b,2002-12-01,2,1,2,1,3
50802,ATOCHA,estado nutricional en menores de 5 anos,clasificacion a y b,2002-12-01,1,19,1,19,20
20503,AUCAPATA,estado nutricional en menores de 5 anos,clasificacion a y b,2002-12-01,10,15,10,15,25
21303,AYO AYO,estado nutricional en menores de 5 anos,clasificacion a y b,2002-12-01,13,4,13,4,17
30301,AYOPAYA (V. DE INDEPENDENCIA),estado nutricional en menores de 5 anos,clasificacion a y b,2002-12-01,13,3,13,3,16
10201,AZURDUY,estado nutricional en menores de 5 anos,clasificacion a y b,2002-12-01,24,14,24,14,38
21203,BATALLAS,estado nutricional en menores de 5 anos,clasificacion a y b,2002-12-01,19,5,19,5,24
80802,BAURES,estado nutricional en menores de 5 anos,clasificacion a y b,2002-12-01,11,3,11,3,14
41202,BELEN DE ANDAMARCA,estado nutricional en menores de 5 anos,clasificacion a y b,2002-12-01,0,1,0,1,1
50104,BELEN DE URMIRI,estado nutricional en menores de 5 anos,clasificacion a y b,2002-12-01,1,0,1,0,1
60202,BERMEJO,estado nutricional en menores de 5 anos,clasificacion a y b,2002-12-01,28,27,28,27,55
50301,BETANZOS,estado nutricional en menores de 5 anos,clasificacion a y b,2002-12-01,32,5,32,5,37
31501,BOLIVAR,estado nutricional en menores de 5 anos,clasificacion a y b,2002-12-01,1,4,1,4,5
70707,BOYUIBE,estado nutricional en menores de 5 anos,clasificacion a y b,2002-12-01,6,8,6,8,14
70703,CABEZAS,estado nutricional en menores de 5 anos,clasificacion a y b,2002-12-01,25,10,25,10,35
20905,CAIROMA,estado nutricional en menores de 5 anos,clasificacion a y b,2002-12-01,5,4,5,4,9
51102,"CAIZA ""D""",estado nutricional en menores de 5 anos,clasificacion a y b,2002-12-01,12,5,12,5,17
21003,CAJUATA,estado nutricional en menores de 5 anos,clasificacion a y b,2002-12-01,4,2,4,2,6
20303,CALACOTO,estado nutricional en menores de 5 anos,clasificacion a y b,2002-12-01,2,0,2,0,2
21304,CALAMARCA,estado nutricional en menores de 5 anos,clasificacion a y b,2002-12-01,25,2,25,2,27
10701,CAMARGO,estado nutricional en menores de 5 anos,clasificacion a y b,2002-12-01,13,2,13,2,15
10901,CAMATAQUI (C. VILLA ABECIA),estado nutricional en menores de 5 anos,clasificacion a y b,2002-12-01,3,2,3,2,5
70706,CAMIRI,estado nutricional en menores de 5 anos,clasificacion a y b,2002-12-01,115,17,115,17,132
30701,CAPINOTA,estado nutricional en menores de 5 anos,clasificacion a y b,2002-12-01,5,1,5,1,6
20302,CAQUIAVIRI,estado nutricional en menores de 5 anos,clasificacion a y b,2002-12-01,6,3,6,3,9
40102,CARACOLLO,estado nutricional en menores de 5 anos,clasificacion a y b,2002-12-01,7,5,7,5,12
22001,CARANAVI,estado nutricional en menores de 5 anos,clasificacion a y b,2002-12-01,131,37,131,37,168
60302,CARAPARI,estado nutricional en menores de 5 anos,clasificacion a y b,2002-12-01,27,6,27,6,33
50702,CARIPUYO,estado nutricional en menores de 5 anos,clasificacion a y b,2002-12-01,3,1,3,1,4
40201,CHALLAPATA,estado nutricional en menores de 5 anos,clasificacion a y b,2002-12-01,16,4,16,4,20
50302,CHAQUI,estado nutricional en menores de 5 anos,clasificacion a y b,2002-12-01,9,0,9,0,9
70702,CHARAGUA,estado nutricional en menores de 5 anos,clasificacion a y b,2002-12-01,52,44,52,44,96
20305,CHARAÑA,estado nutricional en menores de 5 anos,clasificacion a y b,2002-12-01,3,1,3,1,4
50202,CHAYANTA,estado nutricional en menores de 5 anos,clasificacion a y b,2002-12-01,8,2,8,2,10
31204,CHIMORE,estado nutricional en menores de 5 anos,clasificacion a y b,2002-12-01,9,9,9,9,18
21101,CHULUMANI (V. DE LA LIBERTAD),estado nutricional en menores de 5 anos,clasificacion a y b,2002-12-01,5,1,5,1,6
20501,CHUMA,estado nutricional en menores de 5 anos,clasificacion a y b,2002-12-01,7,1,7,1,8
30801,CLIZA,estado nutricional en menores de 5 anos,clasificacion a y b,2002-12-01,9,6,9,6,15
90101,COBIJA,estado nutricional en menores de 5 anos,clasificacion a y b,2002-12-01,131,19,131,19,150
30101,COCHABAMBA,estado nutricional en menores de 5 anos,clasificacion a y b,2002-12-01,1285,745,1285,745,2030
30905,COLCAPIRHUA,estado nutricional en menores de 5 anos,clasificacion a y b,2002-12-01,34,15,34,15,49
50901,"COLCHA ""K""",estado nutricional en menores de 5 anos,clasificacion a y b,2002-12-01,9,4,9,4,13
21307,COLLANA,estado nutricional en menores de 5 anos,clasificacion a y b,2002-12-01,2,0,2,0,2
31002,COLOMI,estado nutricional en menores de 5 anos,clasificacion a y b,2002-12-01,33,2,33,2,35
50401,COLQUECHACA,estado nutricional en menores de 5 anos,clasificacion a y b,2002-12-01,9,0,9,0,9
21306,COLQUENCHA,estado nutricional en menores de 5 anos,clasificacion a y b,2002-12-01,12,1,12,1,13
21004,COLQUIRI,estado nutricional en menores de 5 anos,clasificacion a y b,2002-12-01,20,12,20,12,32
20304,COMANCHE,estado nutricional en menores de 5 anos,clasificacion a y b,2002-12-01,1,0,1,0,1
71301,COMARAPA,estado nutricional en menores de 5 anos,clasificacion a y b,2002-12-01,73,14,73,14,87
20605,COMBAYA,estado nutricional en menores de 5 anos,clasificacion a y b,2002-12-01,5,0,5,0,5
71101,CONCEPCION,estado nutricional en menores de 5 anos,clasificacion a y b,2002-12-01,15,13,15,13,28
21701,COPACABANA,estado nutricional en menores de 5 anos,clasificacion a y b,2002-12-01,8,0,8,0,8
21402,CORIPATA,estado nutricional en menores de 5 anos,clasificacion a y b,2002-12-01,28,3,28,3,31
20301,CORO CORO,estado nutricional en menores de 5 anos,clasificacion a y b,2002-12-01,9,5,9,5,14
21401,COROICO,estado nutricional en menores de 5 anos,clasificacion a y b,2002-12-01,8,4,8,4,12
40301,CORQUE,estado nutricional en menores de 5 anos,clasificacion a y b,2002-12-01,3,1,3,1,4
50601,COTAGAITA,estado nutricional en menores de 5 anos,clasificacion a y b,2002-12-01,28,8,28,8,36
70102,COTOCA,estado nutricional en menores de 5 anos,clasificacion a y b,2002-12-01,117,29,117,29,146
70704,CUEVO,estado nutricional en menores de 5 anos,clasificacion a y b,2002-12-01,9,4,9,4,13
10902,CULPINA,estado nutricional en menores de 5 anos,clasificacion a y b,2002-12-01,37,12,37,12,49
20804,DESAGUADERO,estado nutricional en menores de 5 anos,clasificacion a y b,2002-12-01,3,0,3,0,3
20105,EL ALTO,estado nutricional en menores de 5 anos,clasificacion a y b,2002-12-01,603,145,603,145,748
40103,EL CHORO,estado nutricional en menores de 5 anos,clasificacion a y b,2002-12-01,7,3,7,3,10
71503,EL PUENTE(STC),estado nutricional en menores de 5 anos,clasificacion a y b,2002-12-01,15,21,15,21,36
60502,EL PUENTE(TJA),estado nutricional en menores de 5 anos,clasificacion a y b,2002-12-01,4,0,4,0,4
70105,EL TORNO,estado nutricional en menores de 5 anos,clasificacion a y b,2002-12-01,99,10,99,10,109
10405,EL VILLAR,estado nutricional en menores de 5 anos,clasificacion a y b,2002-12-01,13,1,13,1,14
60601,ENTRE RIOS,estado nutricional en menores de 5 anos,clasificacion a y b,2002-12-01,22,12,22,12,34
41101,EUCALIPTUS,estado nutricional en menores de 5 anos,clasificacion a y b,2002-12-01,1,0,1,0,1
80402,EXALTACION,estado nutricional en menores de 5 anos,clasificacion a y b,2002-12-01,2,2,2,2,4
71002,GENERAL SAAVEDRA,estado nutricional en menores de 5 anos,clasificacion a y b,2002-12-01,69,39,69,39,108
20602,GUANAY,estado nutricional en menores de 5 anos,clasificacion a y b,2002-12-01,45,18,45,18,63
20802,GUAQUI,estado nutricional en menores de 5 anos,clasificacion a y b,2002-12-01,1,0,1,0,1
80202,GUAYARAMERIN,estado nutricional en menores de 5 anos,clasificacion a y b,2002-12-01,140,22,140,22,162
70705,GUTIERREZ,estado nutricional en menores de 5 anos,clasificacion a y b,2002-12-01,61,7,61,7,68
10502,HUACARETA,estado nutricional en menores de 5 anos,clasificacion a y b,2002-12-01,19,7,19,7,26
11002,HUACAYA (VILLA DE HUACAYA),estado nutricional en menores de 5 anos,clasificacion a y b,2002-12-01,5,3,5,3,8
40501,HUACHACALLA,estado nutricional en menores de 5 anos,clasificacion a y b,2002-12-01,0,4,0,4,4
40701,HUANUNI,estado nutricional en menores de 5 anos,clasificacion a y b,2002-12-01,35,7,35,7,42
80803,HUARACAJE,estado nutricional en menores de 5 anos,clasificacion a y b,2002-12-01,6,1,6,1,7
21005,ICHOCA,estado nutricional en menores de 5 anos,clasificacion a y b,2002-12-01,3,2,3,2,5
10304,ICLA,estado nutricional en menores de 5 anos,clasificacion a y b,2002-12-01,12,4,12,4,16
10703,INCAHUASI,estado nutricional en menores de 5 anos,clasificacion a y b,2002-12-01,30,1,30,1,31
21001,INQUISIVI,estado nutricional en menores de 5 anos,clasificacion a y b,2002-12-01,12,4,12,4,16
21102,IRUPANA (VILLA DE LANZA),estado nutricional en menores de 5 anos,clasificacion a y b,2002-12-01,14,9,14,9,23
21501,IXIAMAS,estado nutricional en menores de 5 anos,clasificacion a y b,2002-12-01,34,14,34,14,48
21105,LA ASUNTA,estado nutricional en menores de 5 anos,clasificacion a y b,2002-12-01,19,0,19,0,19
70104,LA GUARDIA,estado nutricional en menores de 5 anos,clasificacion a y b,2002-12-01,80,27,80,27,107
20101,LA PAZ,estado nutricional en menores de 5 anos,clasificacion a y b,2002-12-01,478,124,478,124,602
70701,LAGUNILLAS,estado nutricional en menores de 5 anos,clasificacion a y b,2002-12-01,27,9,27,9,36
21202,LAJA,estado nutricional en menores de 5 anos,clasificacion a y b,2002-12-01,21,3,21,3,24
10903,LAS CARRERAS,estado nutricional en menores de 5 anos,clasificacion a y b,2002-12-01,6,4,6,4,10
50203,LLALLAGUA,estado nutricional en menores de 5 anos,clasificacion a y b,2002-12-01,14,73,14,73,87
51401,LLICA,estado nutricional en menores de 5 anos,clasificacion a y b,2002-12-01,1,0,1,0,1
80601,LORETO,estado nutricional en menores de 5 anos,clasificacion a y b,2002-12-01,9,10,9,10,19
20901,LURIBAY,estado nutricional en menores de 5 anos,clasificacion a y b,2002-12-01,10,4,10,4,14
40702,MACHACAMARCA,estado nutricional en menores de 5 anos,clasificacion a y b,2002-12-01,0,4,0,4,4
11003,MACHARETI,estado nutricional en menores de 5 anos,clasificacion a y b,2002-12-01,31,16,31,16,47
80801,MAGDALENA,estado nutricional en menores de 5 anos,clasificacion a y b,2002-12-01,9,6,9,6,15
70903,MAIRANA,estado nutricional en menores de 5 anos,clasificacion a y b,2002-12-01,25,1,25,1,26
20103,MECAPACA,estado nutricional en menores de 5 anos,clasificacion a y b,2002-12-01,7,5,7,5,12
71003,MINEROS,estado nutricional en menores de 5 anos,clasificacion a y b,2002-12-01,120,51,120,51,171
31301,MIZQUE,estado nutricional en menores de 5 anos,clasificacion a y b,2002-12-01,5,7,5,7,12
20402,MOCOMOCO,estado nutricional en menores de 5 anos,clasificacion a y b,2002-12-01,6,8,6,8,14
10303,MOJOCOYA,estado nutricional en menores de 5 anos,clasificacion a y b,2002-12-01,30,6,30,6,36
10501,MONTEAGUDO,estado nutricional en menores de 5 anos,clasificacion a y b,2002-12-01,91,40,91,40,131
71001,MONTERO,estado nutricional en menores de 5 anos,clasificacion a y b,2002-12-01,248,76,248,76,324
70803,MORO MORO,estado nutricional en menores de 5 anos,clasificacion a y b,2002-12-01,6,0,6,0,6
30302,MOROCHATA,estado nutricional en menores de 5 anos,clasificacion a y b,2002-12-01,20,434,20,434,454
90401,NACEBE (SANTA ROSA DEL ABUNA),estado nutricional en menores de 5 anos,clasificacion a y b,2002-12-01,0,1,0,1,1
90501,NUEVO MANOA (NUEVA ESPERANZA),estado nutricional en menores de 5 anos,clasificacion a y b,2002-12-01,2,0,2,0,2
50404,OCURI,estado nutricional en menores de 5 anos,clasificacion a y b,2002-12-01,9,22,9,22,31
70202,OKINAWA,estado nutricional en menores de 5 anos,clasificacion a y b,2002-12-01,22,5,22,5,27
30203,OMEREQUE,estado nutricional en menores de 5 anos,clasificacion a y b,2002-12-01,3,6,3,6,9
40101,ORURO,estado nutricional en menores de 5 anos,clasificacion a y b,2002-12-01,239,57,239,57,296
60201,PADCAYA,estado nutricional en menores de 5 anos,clasificacion a y b,2002-12-01,25,26,25,26,51
10401,PADILLA,estado nutricional en menores de 5 anos,clasificacion a y b,2002-12-01,43,5,43,5,48
70502,PAILON,estado nutricional en menores de 5 anos,clasificacion a y b,2002-12-01,6,1,6,1,7
20102,PALCA,estado nutricional en menores de 5 anos,clasificacion a y b,2002-12-01,4,2,4,2,6
21104,PALOS BLANCOS,estado nutricional en menores de 5 anos,clasificacion a y b,2002-12-01,25,5,25,5,30
40802,PAMPA AULLAGAS,estado nutricional en menores de 5 anos,clasificacion a y b,2002-12-01,2,0,2,0,2
70902,PAMPA GRANDE,estado nutricional en menores de 5 anos,clasificacion a y b,2002-12-01,23,0,23,0,23
21802,PAPEL PAMPA,estado nutricional en menores de 5 anos,clasificacion a y b,2002-12-01,3,3,3,3,6
30202,PASORAPA,estado nutricional en menores de 5 anos,clasificacion a y b,2002-12-01,7,1,7,1,8
21305,PATACAMAYA,estado nutricional en menores de 5 anos,clasificacion a y b,2002-12-01,20,7,20,7,27
40602,PAZÑA,estado nutricional en menores de 5 anos,clasificacion a y b,2002-12-01,3,0,3,0,3
20702,PELECHUCO,estado nutricional en menores de 5 anos,clasificacion a y b,2002-12-01,2,1,2,1,3
50403,POCOATA,estado nutricional en menores de 5 anos,clasificacion a y b,2002-12-01,12,11,12,11,23
31203,POCONA,estado nutricional en menores de 5 anos,clasificacion a y b,2002-12-01,14,0,14,0,14
31202,POJO (CBBA),estado nutricional en menores de 5 anos,clasificacion a y b,2002-12-01,70,4,70,4,74
40601,POOPO,estado nutricional en menores de 5 anos,clasificacion a y b,2002-12-01,1,0,1,0,1
51203,PORCO,estado nutricional en menores de 5 anos,clasificacion a y b,2002-12-01,6,3,6,3,9
10103,POROMA,estado nutricional en menores de 5 anos,clasificacion a y b,2002-12-01,23,7,23,7,30
70601,PORTACHUELO,estado nutricional en menores de 5 anos,clasificacion a y b,2002-12-01,75,26,75,26,101
90102,PORVENIR,estado nutricional en menores de 5 anos,clasificacion a y b,2002-12-01,6,0,6,0,6
70804,POSTRER VALLE,estado nutricional en menores de 5 anos,clasificacion a y b,2002-12-01,2,3,2,3,5
50101,POTOSI,estado nutricional en menores de 5 anos,clasificacion a y b,2002-12-01,95,8,95,8,103
10302,PRESTO,estado nutricional en menores de 5 anos,clasificacion a y b,2002-12-01,20,2,20,2,22
21201,PUCARANI,estado nutricional en menores de 5 anos,clasificacion a y b,2002-12-01,5,7,5,7,12
20401,PUERTO ACOSTA,estado nutricional en menores de 5 anos,clasificacion a y b,2002-12-01,43,52,43,52,95
20403,PUERTO CARABUCO,estado nutricional en menores de 5 anos,clasificacion a y b,2002-12-01,20,3,20,3,23
90301,PUERTO GONZALO MORENO,estado nutricional en menores de 5 anos,clasificacion a y b,2002-12-01,1,0,1,0,1
21204,PUERTO PEREZ,estado nutricional en menores de 5 anos,clasificacion a y b,2002-12-01,1,3,1,3,4
71402,PUERTO QUIJARRO,estado nutricional en menores de 5 anos,clasificacion a y b,2002-12-01,48,1,48,1,49
90201,PUERTO RICO,estado nutricional en menores de 5 anos,clasificacion a y b,2002-12-01,12,7,12,7,19
71401,PUERTO SUAREZ,estado nutricional en menores de 5 anos,clasificacion a y b,2002-12-01,35,5,35,5,40
31205,PUERTO VILLARROEL,estado nutricional en menores de 5 anos,clasificacion a y b,2002-12-01,121,21,121,21,142
51101,PUNA,estado nutricional en menores de 5 anos,clasificacion a y b,2002-12-01,21,3,21,3,24
31401,PUNATA,estado nutricional en menores de 5 anos,clasificacion a y b,2002-12-01,46,7,46,7,53
30901,QUILLACOLLO,estado nutricional en menores de 5 anos,clasificacion a y b,2002-12-01,58,32,58,32,90
21002,QUIME,estado nutricional en menores de 5 anos,clasificacion a y b,2002-12-01,12,0,12,0,12
70904,QUIRUSILLAS,estado nutricional en menores de 5 anos,clasificacion a y b,2002-12-01,8,4,8,4,12
50402,RAVELO,estado nutricional en menores de 5 anos,clasificacion a y b,2002-12-01,17,12,17,12,29
80301,REYES,estado nutricional en menores de 5 anos,clasificacion a y b,2002-12-01,25,5,25,5,30
80201,RIBERALTA,estado nutricional en menores de 5 anos,clasificacion a y b,2002-12-01,148,14,148,14,162
70503,ROBORE,estado nutricional en menores de 5 anos,clasificacion a y b,2002-12-01,36,5,36,5,41
80304,RURRENABAQUE,estado nutricional en menores de 5 anos,clasificacion a y b,2002-12-01,12,16,12,16,28
40901,SABAYA,estado nutricional en menores de 5 anos,clasificacion a y b,2002-12-01,3,1,3,1,4
31001,SACABA,estado nutricional en menores de 5 anos,clasificacion a y b,2002-12-01,56,26,56,26,82
50701,SACACA,estado nutricional en menores de 5 anos,clasificacion a y b,2002-12-01,14,4,14,4,18
71302,SAIPINA,estado nutricional en menores de 5 anos,clasificacion a y b,2002-12-01,39,8,39,8,47
40801,SALINAS DE GARCI MENDOZA,estado nutricional en menores de 5 anos,clasificacion a y b,2002-12-01,0,3,0,3,3
70901,SAMAIPATA,estado nutricional en menores de 5 anos,clasificacion a y b,2002-12-01,31,10,31,10,41
51601,SAN AGUSTIN,estado nutricional en menores de 5 anos,clasificacion a y b,2002-12-01,1,3,1,3,4
80602,SAN ANDRES,estado nutricional en menores de 5 anos,clasificacion a y b,2002-12-01,3,0,3,0,3
71105,SAN ANTONIO DE LOMERIO,estado nutricional en menores de 5 anos,clasificacion a y b,2002-12-01,14,9,14,9,23
31403,SAN BENITO,estado nutricional en menores de 5 anos,clasificacion a y b,2002-12-01,2,5,2,5,7
80302,SAN BORJA,estado nutricional en menores de 5 anos,clasificacion a y b,2002-12-01,66,25,66,25,91
21502,SAN BUENA VENTURA,estado nutricional en menores de 5 anos,clasificacion a y b,2002-12-01,21,4,21,4,25
70402,SAN CARLOS,estado nutricional en menores de 5 anos,clasificacion a y b,2002-12-01,27,3,27,3,30
80501,SAN IGNACIO,estado nutricional en menores de 5 anos,clasificacion a y b,2002-12-01,48,6,48,6,54
70301,SAN IGNACIO DE VELASCO,estado nutricional en menores de 5 anos,clasificacion a y b,2002-12-01,159,14,159,14,173
71102,SAN JAVIER(STC),estado nutricional en menores de 5 anos,clasificacion a y b,2002-12-01,59,2,59,2,61
80701,SAN JOAQUIN,estado nutricional en menores de 5 anos,clasificacion a y b,2002-12-01,4,1,4,1,5
70501,SAN JOSE DE CHIQUITOS,estado nutricional en menores de 5 anos,clasificacion a y b,2002-12-01,13,0,13,0,13
71104,SAN JULIAN,estado nutricional en menores de 5 anos,clasificacion a y b,2002-12-01,109,45,109,45,154
60501,SAN LORENZO(TJA),estado nutricional en menores de 5 anos,clasificacion a y b,2002-12-01,39,14,39,14,53
10702,SAN LUCAS,estado nutricional en menores de 5 anos,clasificacion a y b,2002-12-01,24,5,24,5,29
70302,SAN MIGUEL DE VELASCO,estado nutricional en menores de 5 anos,clasificacion a y b,2002-12-01,21,2,21,2,23
51001,SAN PABLO DE LIPEZ,estado nutricional en menores de 5 anos,clasificacion a y b,2002-12-01,3,1,3,1,4
50501,SAN PEDRO DE BUENA VISTA,estado nutricional en menores de 5 anos,clasificacion a y b,2002-12-01,5,6,5,6,11
21801,SAN PEDRO DE CURAHUARA,estado nutricional en menores de 5 anos,clasificacion a y b,2002-12-01,6,0,6,0,6
21702,SAN PEDRO DE TIQUINA,estado nutricional en menores de 5 anos,clasificacion a y b,2002-12-01,8,0,8,0,8
70303,SAN RAFAEL,estado nutricional en menores de 5 anos,clasificacion a y b,2002-12-01,10,1,10,1,11
80702,SAN RAMON,estado nutricional en menores de 5 anos,clasificacion a y b,2002-12-01,3,0,3,0,3
80702,SAN RAMON,estado nutricional en menores de 5 anos,clasificacion a y b,2002-12-01,14,10,14,10,24
80401,SANTA ANA,estado nutricional en menores de 5 anos,clasificacion a y b,2002-12-01,11,11,11,11,22
70101,SANTA CRUZ DE LA SIERRA,estado nutricional en menores de 5 anos,clasificacion a y b,2002-12-01,1342,587,1342,587,1929
80303,SANTA ROSA,estado nutricional en menores de 5 anos,clasificacion a y b,2002-12-01,10,8,10,8,18
70602,SANTA ROSA DEL SARA,estado nutricional en menores de 5 anos,clasificacion a y b,2002-12-01,10,20,10,20,30
20308,SANTIAGO DE CALLAPA,estado nutricional en menores de 5 anos,clasificacion a y b,2002-12-01,3,0,3,0,3
41401,SANTIAGO DE HUARI,estado nutricional en menores de 5 anos,clasificacion a y b,2002-12-01,6,1,6,1,7
21901,SANTIAGO DE MACHACA,estado nutricional en menores de 5 anos,clasificacion a y b,2002-12-01,2,0,2,0,2
30702,SANTIVAÑES,estado nutricional en menores de 5 anos,clasificacion a y b,2002-12-01,1,0,1,0,1
40202,SANTUARIO DE QUILLACAS,estado nutricional en menores de 5 anos,clasificacion a y b,2002-12-01,2,0,2,0,2
20902,SAPAHAQUI,estado nutricional en menores de 5 anos,clasificacion a y b,2002-12-01,7,0,7,0,7
90303,SENA,estado nutricional en menores de 5 anos,clasificacion a y b,2002-12-01,1,0,1,0,1
21301,SICA SICA (VILLA AROMA),estado nutricional en menores de 5 anos,clasificacion a y b,2002-12-01,13,5,13,5,18
30703,SICAYA,estado nutricional en menores de 5 anos,clasificacion a y b,2002-12-01,0,1,0,1,1
30902,SIPE SIPE,estado nutricional en menores de 5 anos,clasificacion a y b,2002-12-01,113,16,113,16,129
10403,SOPACHUY,estado nutricional en menores de 5 anos,clasificacion a y b,2002-12-01,17,5,17,5,22
20601,SORATA,estado nutricional en menores de 5 anos,clasificacion a y b,2002-12-01,19,3,19,3,22
10101,SUCRE,estado nutricional en menores de 5 anos,clasificacion a y b,2002-12-01,270,49,270,49,319
31404,TACACHI,estado nutricional en menores de 5 anos,clasificacion a y b,2002-12-01,1,0,1,0,1
20603,TACACOMA,estado nutricional en menores de 5 anos,clasificacion a y b,2002-12-01,14,9,14,9,23
50303,TACOBAMBA,estado nutricional en menores de 5 anos,clasificacion a y b,2002-12-01,22,9,22,9,31
30602,TACOPAYA,estado nutricional en menores de 5 anos,clasificacion a y b,2002-12-01,2,0,2,0,2
51402,TAHUA,estado nutricional en menores de 5 anos,clasificacion a y b,2002-12-01,2,0,2,0,2
31101,TAPACARI,estado nutricional en menores de 5 anos,clasificacion a y b,2002-12-01,5,14,5,14,19
10601,TARABUCO,estado nutricional en menores de 5 anos,clasificacion a y b,2002-12-01,45,6,45,6,51
30401,TARATA,estado nutricional en menores de 5 anos,clasificacion a y b,2002-12-01,9,14,9,14,23
60101,TARIJA,estado nutricional en menores de 5 anos,clasificacion a y b,2002-12-01,287,236,287,236,523
10202,TARVITA,estado nutricional en menores de 5 anos,clasificacion a y b,2002-12-01,20,13,20,13,33
20803,TIAWANACU,estado nutricional en menores de 5 anos,clasificacion a y b,2002-12-01,18,7,18,7,25
50102,TINGUIPAYA,estado nutricional en menores de 5 anos,clasificacion a y b,2002-12-01,3,5,3,5,8
20606,TIPUANI,estado nutricional en menores de 5 anos,clasificacion a y b,2002-12-01,24,4,24,4,28
30903,TIQUIPAYA,estado nutricional en menores de 5 anos,clasificacion a y b,2002-12-01,14,18,14,18,32
31601,TIRAQUE (CBBA),estado nutricional en menores de 5 anos,clasificacion a y b,2002-12-01,94,40,94,40,134
30802,TOCO,estado nutricional en menores de 5 anos,clasificacion a y b,2002-12-01,2,4,2,4,6
41001,TOLEDO,estado nutricional en menores de 5 anos,clasificacion a y b,2002-12-01,7,0,7,0,7
51202,TOMAVE,estado nutricional en menores de 5 anos,clasificacion a y b,2002-12-01,11,1,11,1,12
10402,TOMINA,estado nutricional en menores de 5 anos,clasificacion a y b,2002-12-01,36,7,36,7,43
50502,TORO TORO,estado nutricional en menores de 5 anos,clasificacion a y b,2002-12-01,7,3,7,3,10
31201,TOTORA(CBBA),estado nutricional en menores de 5 anos,clasificacion a y b,2002-12-01,10,1,10,1,11
41301,TOTORA(ORR),estado nutricional en menores de 5 anos,clasificacion a y b,2002-12-01,3,2,3,2,5
70802,TRIGAL,estado nutricional en menores de 5 anos,clasificacion a y b,2002-12-01,6,1,6,1,7
80101,TRINIDAD,estado nutricional en menores de 5 anos,clasificacion a y b,2002-12-01,152,144,152,144,296
50801,TUPIZA,estado nutricional en menores de 5 anos,clasificacion a y b,2002-12-01,47,45,47,45,92
40402,TURCO,estado nutricional en menores de 5 anos,clasificacion a y b,2002-12-01,2,0,2,0,2
21302,UMALA,estado nutricional en menores de 5 anos,clasificacion a y b,2002-12-01,3,1,3,1,4
50201,UNCIA,estado nutricional en menores de 5 anos,clasificacion a y b,2002-12-01,3,0,3,0,3
60401,URIONDO (A. CONCEPCION),estado nutricional en menores de 5 anos,clasificacion a y b,2002-12-01,53,20,53,20,73
71502,URUBICHA,estado nutricional en menores de 5 anos,clasificacion a y b,2002-12-01,25,6,25,6,31
51201,UYUNI,estado nutricional en menores de 5 anos,clasificacion a y b,2002-12-01,46,11,46,11,57
30502,VACAS,estado nutricional en menores de 5 anos,clasificacion a y b,2002-12-01,1,7,1,7,8
70801,VALLEGRANDE,estado nutricional en menores de 5 anos,clasificacion a y b,2002-12-01,50,21,50,21,71
20801,VIACHA,estado nutricional en menores de 5 anos,clasificacion a y b,2002-12-01,60,33,60,33,93
31302,VILA VILA,estado nutricional en menores de 5 anos,clasificacion a y b,2002-12-01,0,1,0,1,1
60303,VILLA MONTES,estado nutricional en menores de 5 anos,clasificacion a y b,2002-12-01,34,17,34,17,51
31402,VILLA RIVERO,estado nutricional en menores de 5 anos,clasificacion a y b,2002-12-01,0,6,0,6,6
10801,VILLA SERRANO,estado nutricional en menores de 5 anos,clasificacion a y b,2002-12-01,28,3,28,3,31
31003,VILLA TUNARI,estado nutricional en menores de 5 anos,clasificacion a y b,2002-12-01,34,20,34,20,54
11001,VILLA VACA GUZMAN (MUYUPAMPA),estado nutricional en menores de 5 anos,clasificacion a y b,2002-12-01,61,11,61,11,72
51501,VILLAZON,estado nutricional en menores de 5 anos,clasificacion a y b,2002-12-01,71,11,71,11,82
30904,VINTO,estado nutricional en menores de 5 anos,clasificacion a y b,2002-12-01,47,10,47,10,57
50602,VITICHI,estado nutricional en menores de 5 anos,clasificacion a y b,2002-12-01,14,2,14,2,16
70201,WARNES,estado nutricional en menores de 5 anos,clasificacion a y b,2002-12-01,116,24,116,24,140
20903,YACO,estado nutricional en menores de 5 anos,clasificacion a y b,2002-12-01,3,2,3,2,5
60301,YACUIBA,estado nutricional en menores de 5 anos,clasificacion a y b,2002-12-01,169,44,169,44,213
10602,YAMPARAEZ,estado nutricional en menores de 5 anos,clasificacion a y b,2002-12-01,28,3,28,3,31
21103,YANACACHI,estado nutricional en menores de 5 anos,clasificacion a y b,2002-12-01,8,0,8,0,8
50103,YOCALLA,estado nutricional en menores de 5 anos,clasificacion a y b,2002-12-01,3,0,3,0,3
10102,YOTALA,estado nutricional en menores de 5 anos,clasificacion a y b,2002-12-01,36,12,36,12,48
60402,YUNCHARA,estado nutricional en menores de 5 anos,clasificacion a y b,2002-12-01,3,2,3,2,5
10301,ZUDAÑEZ,estado nutricional en menores de 5 anos,clasificacion a y b,2002-12-01,18,3,18,3,21
