codigo_municipio,municipio,grupo,variable,mes,total-H,total-M,TOTAL-H1,TOTAL-M1,TOTAL
51302,ACACIO,estado nutricional en menores de 5 anos,clasificacion d,2003-01-01,57,112,57,112,169
20201,ACHACACHI,estado nutricional en menores de 5 anos,clasificacion d,2003-01-01,143,152,143,152,295
20104,ACHOCALLA,estado nutricional en menores de 5 anos,clasificacion d,2003-01-01,16,10,16,10,26
30201,AIQUILE,estado nutricional en menores de 5 anos,clasificacion d,2003-01-01,42,28,42,28,70
31303,ALALAY,estado nutricional en menores de 5 anos,clasificacion d,2003-01-01,19,4,19,4,23
10404,ALCALA,estado nutricional en menores de 5 anos,clasificacion d,2003-01-01,29,56,29,56,85
20202,ANCORAIMES,estado nutricional en menores de 5 anos,clasificacion d,2003-01-01,72,125,72,125,197
41201,ANDAMARCA,estado nutricional en menores de 5 anos,clasificacion d,2003-01-01,4,3,4,3,7
40603,ANTEQUERA,estado nutricional en menores de 5 anos,clasificacion d,2003-01-01,7,4,7,4,11
30402,ANZALDO,estado nutricional en menores de 5 anos,clasificacion d,2003-01-01,15,27,15,27,42
20701,APOLO,estado nutricional en menores de 5 anos,clasificacion d,2003-01-01,39,38,39,38,77
51301,ARAMPAMPA,estado nutricional en menores de 5 anos,clasificacion d,2003-01-01,28,85,28,85,113
30501,ARANI,estado nutricional en menores de 5 anos,clasificacion d,2003-01-01,7,11,7,11,18
30403,ARBIETO,estado nutricional en menores de 5 anos,clasificacion d,2003-01-01,16,10,16,10,26
30601,ARQUE,estado nutricional en menores de 5 anos,clasificacion d,2003-01-01,19,19,19,19,38
50802,ATOCHA,estado nutricional en menores de 5 anos,clasificacion d,2003-01-01,18,108,18,108,126
20503,AUCAPATA,estado nutricional en menores de 5 anos,clasificacion d,2003-01-01,5,9,5,9,14
20502,AYATA,estado nutricional en menores de 5 anos,clasificacion d,2003-01-01,17,5,17,5,22
21303,AYO AYO,estado nutricional en menores de 5 anos,clasificacion d,2003-01-01,20,1,20,1,21
30301,AYOPAYA (V. DE INDEPENDENCIA),estado nutricional en menores de 5 anos,clasificacion d,2003-01-01,68,56,68,56,124
10201,AZURDUY,estado nutricional en menores de 5 anos,clasificacion d,2003-01-01,118,167,118,167,285
21203,BATALLAS,estado nutricional en menores de 5 anos,clasificacion d,2003-01-01,36,20,36,20,56
80802,BAURES,estado nutricional en menores de 5 anos,clasificacion d,2003-01-01,16,27,16,27,43
50104,BELEN DE URMIRI,estado nutricional en menores de 5 anos,clasificacion d,2003-01-01,8,17,8,17,25
90104,BELLA FLOR,estado nutricional en menores de 5 anos,clasificacion d,2003-01-01,1,11,1,11,12
60202,BERMEJO,estado nutricional en menores de 5 anos,clasificacion d,2003-01-01,5,12,5,12,17
50301,BETANZOS,estado nutricional en menores de 5 anos,clasificacion d,2003-01-01,329,315,329,315,644
31501,BOLIVAR,estado nutricional en menores de 5 anos,clasificacion d,2003-01-01,58,45,58,45,103
90103,BOLPEBRA,estado nutricional en menores de 5 anos,clasificacion d,2003-01-01,4,6,4,6,10
70707,BOYUIBE,estado nutricional en menores de 5 anos,clasificacion d,2003-01-01,4,11,4,11,15
70401,BUENA VISTA,estado nutricional en menores de 5 anos,clasificacion d,2003-01-01,49,39,49,39,88
70703,CABEZAS,estado nutricional en menores de 5 anos,clasificacion d,2003-01-01,32,71,32,71,103
20905,CAIROMA,estado nutricional en menores de 5 anos,clasificacion d,2003-01-01,26,17,26,17,43
51102,"CAIZA ""D""",estado nutricional en menores de 5 anos,clasificacion d,2003-01-01,104,91,104,91,195
21003,CAJUATA,estado nutricional en menores de 5 anos,clasificacion d,2003-01-01,39,35,39,35,74
20303,CALACOTO,estado nutricional en menores de 5 anos,clasificacion d,2003-01-01,15,8,15,8,23
21304,CALAMARCA,estado nutricional en menores de 5 anos,clasificacion d,2003-01-01,93,68,93,68,161
10701,CAMARGO,estado nutricional en menores de 5 anos,clasificacion d,2003-01-01,81,116,81,116,197
10901,CAMATAQUI (C. VILLA ABECIA),estado nutricional en menores de 5 anos,clasificacion d,2003-01-01,13,25,13,25,38
70706,CAMIRI,estado nutricional en menores de 5 anos,clasificacion d,2003-01-01,218,172,218,172,390
30701,CAPINOTA,estado nutricional en menores de 5 anos,clasificacion d,2003-01-01,28,35,28,35,63
20302,CAQUIAVIRI,estado nutricional en menores de 5 anos,clasificacion d,2003-01-01,19,28,19,28,47
40102,CARACOLLO,estado nutricional en menores de 5 anos,clasificacion d,2003-01-01,44,65,44,65,109
22001,CARANAVI,estado nutricional en menores de 5 anos,clasificacion d,2003-01-01,107,89,107,89,196
41503,CARANGAS,estado nutricional en menores de 5 anos,clasificacion d,2003-01-01,2,0,2,0,2
60302,CARAPARI,estado nutricional en menores de 5 anos,clasificacion d,2003-01-01,52,54,52,54,106
50702,CARIPUYO,estado nutricional en menores de 5 anos,clasificacion d,2003-01-01,66,124,66,124,190
21902,CATACORA,estado nutricional en menores de 5 anos,clasificacion d,2003-01-01,4,7,4,7,11
40201,CHALLAPATA,estado nutricional en menores de 5 anos,clasificacion d,2003-01-01,44,125,44,125,169
50302,CHAQUI,estado nutricional en menores de 5 anos,clasificacion d,2003-01-01,80,65,80,65,145
70702,CHARAGUA,estado nutricional en menores de 5 anos,clasificacion d,2003-01-01,66,157,66,157,223
20305,CHARAÃ‘A,estado nutricional en menores de 5 anos,clasificacion d,2003-01-01,5,12,5,12,17
50202,CHAYANTA,estado nutricional en menores de 5 anos,clasificacion d,2003-01-01,67,76,67,76,143
31204,CHIMORE,estado nutricional en menores de 5 anos,clasificacion d,2003-01-01,16,18,16,18,34
40903,CHIPAYA,estado nutricional en menores de 5 anos,clasificacion d,2003-01-01,7,1,7,1,8
40302,CHOQUE COTA,estado nutricional en menores de 5 anos,clasificacion d,2003-01-01,10,10,10,10,20
21101,CHULUMANI (V. DE LA LIBERTAD),estado nutricional en menores de 5 anos,clasificacion d,2003-01-01,3,18,3,18,21
20501,CHUMA,estado nutricional en menores de 5 anos,clasificacion d,2003-01-01,14,16,14,16,30
30801,CLIZA,estado nutricional en menores de 5 anos,clasificacion d,2003-01-01,19,7,19,7,26
90101,COBIJA,estado nutricional en menores de 5 anos,clasificacion d,2003-01-01,86,92,86,92,178
30101,COCHABAMBA,estado nutricional en menores de 5 anos,clasificacion d,2003-01-01,455,341,455,341,796
30905,COLCAPIRHUA,estado nutricional en menores de 5 anos,clasificacion d,2003-01-01,68,29,68,29,97
50901,"COLCHA ""K""",estado nutricional en menores de 5 anos,clasificacion d,2003-01-01,33,57,33,57,90
21307,COLLANA,estado nutricional en menores de 5 anos,clasificacion d,2003-01-01,0,8,0,8,8
31002,COLOMI,estado nutricional en menores de 5 anos,clasificacion d,2003-01-01,54,41,54,41,95
50401,COLQUECHACA,estado nutricional en menores de 5 anos,clasificacion d,2003-01-01,112,91,112,91,203
21306,COLQUENCHA,estado nutricional en menores de 5 anos,clasificacion d,2003-01-01,12,7,12,7,19
21004,COLQUIRI,estado nutricional en menores de 5 anos,clasificacion d,2003-01-01,89,72,89,72,161
20304,COMANCHE,estado nutricional en menores de 5 anos,clasificacion d,2003-01-01,4,3,4,3,7
71301,COMARAPA,estado nutricional en menores de 5 anos,clasificacion d,2003-01-01,76,46,76,46,122
20605,COMBAYA,estado nutricional en menores de 5 anos,clasificacion d,2003-01-01,9,8,9,8,17
71101,CONCEPCION,estado nutricional en menores de 5 anos,clasificacion d,2003-01-01,12,6,12,6,18
21701,COPACABANA,estado nutricional en menores de 5 anos,clasificacion d,2003-01-01,11,12,11,12,23
21402,CORIPATA,estado nutricional en menores de 5 anos,clasificacion d,2003-01-01,3,5,3,5,8
20301,CORO CORO,estado nutricional en menores de 5 anos,clasificacion d,2003-01-01,36,41,36,41,77
21401,COROICO,estado nutricional en menores de 5 anos,clasificacion d,2003-01-01,29,31,29,31,60
40301,CORQUE,estado nutricional en menores de 5 anos,clasificacion d,2003-01-01,15,5,15,5,20
50601,COTAGAITA,estado nutricional en menores de 5 anos,clasificacion d,2003-01-01,96,163,96,163,259
70102,COTOCA,estado nutricional en menores de 5 anos,clasificacion d,2003-01-01,80,41,80,41,121
31405,CUCHUMUELA (V. G. VILLARROEL),estado nutricional en menores de 5 anos,clasificacion d,2003-01-01,7,8,7,8,15
70704,CUEVO,estado nutricional en menores de 5 anos,clasificacion d,2003-01-01,21,15,21,15,36
10902,CULPINA,estado nutricional en menores de 5 anos,clasificacion d,2003-01-01,125,158,125,158,283
40401,CURAHUARA DE CARANGAS,estado nutricional en menores de 5 anos,clasificacion d,2003-01-01,10,13,10,13,23
21602,CURVA,estado nutricional en menores de 5 anos,clasificacion d,2003-01-01,16,16,16,16,32
20804,DESAGUADERO,estado nutricional en menores de 5 anos,clasificacion d,2003-01-01,10,3,10,3,13
20105,EL ALTO,estado nutricional en menores de 5 anos,clasificacion d,2003-01-01,1800,1079,1800,1079,2879
40103,EL CHORO,estado nutricional en menores de 5 anos,clasificacion d,2003-01-01,5,6,5,6,11
71503,EL PUENTE(STC),estado nutricional en menores de 5 anos,clasificacion d,2003-01-01,5,110,5,110,115
60502,EL PUENTE(TJA),estado nutricional en menores de 5 anos,clasificacion d,2003-01-01,26,75,26,75,101
70105,EL TORNO,estado nutricional en menores de 5 anos,clasificacion d,2003-01-01,76,107,76,107,183
10405,EL VILLAR,estado nutricional en menores de 5 anos,clasificacion d,2003-01-01,40,107,40,107,147
60601,ENTRE RIOS,estado nutricional en menores de 5 anos,clasificacion d,2003-01-01,46,39,46,39,85
40502,ESCARA,estado nutricional en menores de 5 anos,clasificacion d,2003-01-01,1,2,1,2,3
41101,EUCALIPTUS,estado nutricional en menores de 5 anos,clasificacion d,2003-01-01,8,9,8,9,17
80402,EXALTACION,estado nutricional en menores de 5 anos,clasificacion d,2003-01-01,6,12,6,12,18
90203,FILADELFIA,estado nutricional en menores de 5 anos,clasificacion d,2003-01-01,5,6,5,6,11
71002,GENERAL SAAVEDRA,estado nutricional en menores de 5 anos,clasificacion d,2003-01-01,98,121,98,121,219
21601,GRAL. J.J. PEREZ (CHARAZANI),estado nutricional en menores de 5 anos,clasificacion d,2003-01-01,5,0,5,0,5
20602,GUANAY,estado nutricional en menores de 5 anos,clasificacion d,2003-01-01,56,100,56,100,156
20802,GUAQUI,estado nutricional en menores de 5 anos,clasificacion d,2003-01-01,8,6,8,6,14
80202,GUAYARAMERIN,estado nutricional en menores de 5 anos,clasificacion d,2003-01-01,145,136,145,136,281
70705,GUTIERREZ,estado nutricional en menores de 5 anos,clasificacion d,2003-01-01,115,170,115,170,285
10502,HUACARETA,estado nutricional en menores de 5 anos,clasificacion d,2003-01-01,45,98,45,98,143
11002,HUACAYA (VILLA DE HUACAYA),estado nutricional en menores de 5 anos,clasificacion d,2003-01-01,12,21,12,21,33
40501,HUACHACALLA,estado nutricional en menores de 5 anos,clasificacion d,2003-01-01,2,4,2,4,6
40701,HUANUNI,estado nutricional en menores de 5 anos,clasificacion d,2003-01-01,86,56,86,56,142
80803,HUARACAJE,estado nutricional en menores de 5 anos,clasificacion d,2003-01-01,17,9,17,9,26
41601,HUAYLLAMARCA,estado nutricional en menores de 5 anos,clasificacion d,2003-01-01,15,24,15,24,39
21005,ICHOCA,estado nutricional en menores de 5 anos,clasificacion d,2003-01-01,21,37,21,37,58
10304,ICLA,estado nutricional en menores de 5 anos,clasificacion d,2003-01-01,53,111,53,111,164
10703,INCAHUASI,estado nutricional en menores de 5 anos,clasificacion d,2003-01-01,161,180,161,180,341
21001,INQUISIVI,estado nutricional en menores de 5 anos,clasificacion d,2003-01-01,79,121,79,121,200
21102,IRUPANA (VILLA DE LANZA),estado nutricional en menores de 5 anos,clasificacion d,2003-01-01,29,45,29,45,74
21501,IXIAMAS,estado nutricional en menores de 5 anos,clasificacion d,2003-01-01,23,47,23,47,70
21105,LA ASUNTA,estado nutricional en menores de 5 anos,clasificacion d,2003-01-01,17,36,17,36,53
70104,LA GUARDIA,estado nutricional en menores de 5 anos,clasificacion d,2003-01-01,99,77,99,77,176
20101,LA PAZ,estado nutricional en menores de 5 anos,clasificacion d,2003-01-01,1221,995,1221,995,2216
70701,LAGUNILLAS,estado nutricional en menores de 5 anos,clasificacion d,2003-01-01,43,62,43,62,105
21202,LAJA,estado nutricional en menores de 5 anos,clasificacion d,2003-01-01,12,18,12,18,30
10903,LAS CARRERAS,estado nutricional en menores de 5 anos,clasificacion d,2003-01-01,19,61,19,61,80
21006,LICOMA PAMPA,estado nutricional en menores de 5 anos,clasificacion d,2003-01-01,12,2,12,2,14
50203,LLALLAGUA,estado nutricional en menores de 5 anos,clasificacion d,2003-01-01,23,352,23,352,375
51401,LLICA,estado nutricional en menores de 5 anos,clasificacion d,2003-01-01,18,16,18,16,34
80601,LORETO,estado nutricional en menores de 5 anos,clasificacion d,2003-01-01,15,8,15,8,23
20901,LURIBAY,estado nutricional en menores de 5 anos,clasificacion d,2003-01-01,45,19,45,19,64
40702,MACHACAMARCA,estado nutricional en menores de 5 anos,clasificacion d,2003-01-01,7,6,7,6,13
11003,MACHARETI,estado nutricional en menores de 5 anos,clasificacion d,2003-01-01,54,80,54,80,134
80801,MAGDALENA,estado nutricional en menores de 5 anos,clasificacion d,2003-01-01,32,48,32,48,80
70903,MAIRANA,estado nutricional en menores de 5 anos,clasificacion d,2003-01-01,28,24,28,24,52
20904,MALLA,estado nutricional en menores de 5 anos,clasificacion d,2003-01-01,3,3,3,3,6
20103,MECAPACA,estado nutricional en menores de 5 anos,clasificacion d,2003-01-01,13,14,13,14,27
71003,MINEROS,estado nutricional en menores de 5 anos,clasificacion d,2003-01-01,151,141,151,141,292
31301,MIZQUE,estado nutricional en menores de 5 anos,clasificacion d,2003-01-01,15,6,15,6,21
20402,MOCOMOCO,estado nutricional en menores de 5 anos,clasificacion d,2003-01-01,29,23,29,23,52
51002,MOJINETE,estado nutricional en menores de 5 anos,clasificacion d,2003-01-01,2,15,2,15,17
10303,MOJOCOYA,estado nutricional en menores de 5 anos,clasificacion d,2003-01-01,63,110,63,110,173
10501,MONTEAGUDO,estado nutricional en menores de 5 anos,clasificacion d,2003-01-01,131,178,131,178,309
71001,MONTERO,estado nutricional en menores de 5 anos,clasificacion d,2003-01-01,480,255,480,255,735
70803,MORO MORO,estado nutricional en menores de 5 anos,clasificacion d,2003-01-01,7,13,7,13,20
30302,MOROCHATA,estado nutricional en menores de 5 anos,clasificacion d,2003-01-01,88,156,88,156,244
90401,NACEBE (SANTA ROSA DEL ABUNA),estado nutricional en menores de 5 anos,clasificacion d,2003-01-01,0,4,0,4,4
20307,NAZACARA DE PACAJES,estado nutricional en menores de 5 anos,clasificacion d,2003-01-01,3,2,3,2,5
90501,NUEVO MANOA (NUEVA ESPERANZA),estado nutricional en menores de 5 anos,clasificacion d,2003-01-01,0,5,0,5,5
50404,OCURI,estado nutricional en menores de 5 anos,clasificacion d,2003-01-01,41,158,41,158,199
70202,OKINAWA,estado nutricional en menores de 5 anos,clasificacion d,2003-01-01,16,25,16,25,41
30203,OMEREQUE,estado nutricional en menores de 5 anos,clasificacion d,2003-01-01,1,15,1,15,16
40101,ORURO,estado nutricional en menores de 5 anos,clasificacion d,2003-01-01,744,621,744,621,1365
60201,PADCAYA,estado nutricional en menores de 5 anos,clasificacion d,2003-01-01,29,23,29,23,52
10401,PADILLA,estado nutricional en menores de 5 anos,clasificacion d,2003-01-01,106,200,106,200,306
70502,PAILON,estado nutricional en menores de 5 anos,clasificacion d,2003-01-01,55,33,55,33,88
20102,PALCA,estado nutricional en menores de 5 anos,clasificacion d,2003-01-01,35,39,35,39,74
21104,PALOS BLANCOS,estado nutricional en menores de 5 anos,clasificacion d,2003-01-01,64,67,64,67,131
40802,PAMPA AULLAGAS,estado nutricional en menores de 5 anos,clasificacion d,2003-01-01,10,12,10,12,22
70902,PAMPA GRANDE,estado nutricional en menores de 5 anos,clasificacion d,2003-01-01,21,14,21,14,35
21802,PAPEL PAMPA,estado nutricional en menores de 5 anos,clasificacion d,2003-01-01,4,3,4,3,7
30202,PASORAPA,estado nutricional en menores de 5 anos,clasificacion d,2003-01-01,9,17,9,17,26
21305,PATACAMAYA,estado nutricional en menores de 5 anos,clasificacion d,2003-01-01,80,70,80,70,150
40602,PAZÃ‘A,estado nutricional en menores de 5 anos,clasificacion d,2003-01-01,9,12,9,12,21
20702,PELECHUCO,estado nutricional en menores de 5 anos,clasificacion d,2003-01-01,27,22,27,22,49
50403,POCOATA,estado nutricional en menores de 5 anos,clasificacion d,2003-01-01,151,167,151,167,318
31203,POCONA,estado nutricional en menores de 5 anos,clasificacion d,2003-01-01,18,15,18,15,33
31202,POJO (CBBA),estado nutricional en menores de 5 anos,clasificacion d,2003-01-01,66,70,66,70,136
40601,POOPO,estado nutricional en menores de 5 anos,clasificacion d,2003-01-01,3,16,3,16,19
51203,PORCO,estado nutricional en menores de 5 anos,clasificacion d,2003-01-01,21,8,21,8,29
10103,POROMA,estado nutricional en menores de 5 anos,clasificacion d,2003-01-01,97,124,97,124,221
70103,PORONGO,estado nutricional en menores de 5 anos,clasificacion d,2003-01-01,18,21,18,21,39
70601,PORTACHUELO,estado nutricional en menores de 5 anos,clasificacion d,2003-01-01,76,65,76,65,141
90102,PORVENIR,estado nutricional en menores de 5 anos,clasificacion d,2003-01-01,14,9,14,9,23
70804,POSTRER VALLE,estado nutricional en menores de 5 anos,clasificacion d,2003-01-01,9,4,9,4,13
50101,POTOSI,estado nutricional en menores de 5 anos,clasificacion d,2003-01-01,619,452,619,452,1071
10302,PRESTO,estado nutricional en menores de 5 anos,clasificacion d,2003-01-01,59,84,59,84,143
70805,PUCARA,estado nutricional en menores de 5 anos,clasificacion d,2003-01-01,1,1,1,1,2
21201,PUCARANI,estado nutricional en menores de 5 anos,clasificacion d,2003-01-01,18,21,18,21,39
20401,PUERTO ACOSTA,estado nutricional en menores de 5 anos,clasificacion d,2003-01-01,71,127,71,127,198
20403,PUERTO CARABUCO,estado nutricional en menores de 5 anos,clasificacion d,2003-01-01,48,97,48,97,145
90301,PUERTO GONZALO MORENO,estado nutricional en menores de 5 anos,clasificacion d,2003-01-01,6,38,6,38,44
21204,PUERTO PEREZ,estado nutricional en menores de 5 anos,clasificacion d,2003-01-01,10,5,10,5,15
71402,PUERTO QUIJARRO,estado nutricional en menores de 5 anos,clasificacion d,2003-01-01,60,14,60,14,74
90201,PUERTO RICO,estado nutricional en menores de 5 anos,clasificacion d,2003-01-01,4,10,4,10,14
80703,PUERTO SILES,estado nutricional en menores de 5 anos,clasificacion d,2003-01-01,0,1,0,1,1
71401,PUERTO SUAREZ,estado nutricional en menores de 5 anos,clasificacion d,2003-01-01,66,20,66,20,86
31205,PUERTO VILLARROEL,estado nutricional en menores de 5 anos,clasificacion d,2003-01-01,157,123,157,123,280
51101,PUNA,estado nutricional en menores de 5 anos,clasificacion d,2003-01-01,255,340,255,340,595
31401,PUNATA,estado nutricional en menores de 5 anos,clasificacion d,2003-01-01,115,14,115,14,129
20604,QUIABAYA,estado nutricional en menores de 5 anos,clasificacion d,2003-01-01,17,42,17,42,59
30901,QUILLACOLLO,estado nutricional en menores de 5 anos,clasificacion d,2003-01-01,49,48,49,48,97
21002,QUIME,estado nutricional en menores de 5 anos,clasificacion d,2003-01-01,63,48,63,48,111
70904,QUIRUSILLAS,estado nutricional en menores de 5 anos,clasificacion d,2003-01-01,3,2,3,2,5
50402,RAVELO,estado nutricional en menores de 5 anos,clasificacion d,2003-01-01,156,174,156,174,330
80301,REYES,estado nutricional en menores de 5 anos,clasificacion d,2003-01-01,26,30,26,30,56
80201,RIBERALTA,estado nutricional en menores de 5 anos,clasificacion d,2003-01-01,311,245,311,245,556
70503,ROBORE,estado nutricional en menores de 5 anos,clasificacion d,2003-01-01,51,49,51,49,100
40901,SABAYA,estado nutricional en menores de 5 anos,clasificacion d,2003-01-01,1,6,1,6,7
31001,SACABA,estado nutricional en menores de 5 anos,clasificacion d,2003-01-01,143,105,143,105,248
50701,SACACA,estado nutricional en menores de 5 anos,clasificacion d,2003-01-01,140,261,140,261,401
71302,SAIPINA,estado nutricional en menores de 5 anos,clasificacion d,2003-01-01,20,29,20,29,49
40801,SALINAS DE GARCI MENDOZA,estado nutricional en menores de 5 anos,clasificacion d,2003-01-01,17,15,17,15,32
70901,SAMAIPATA,estado nutricional en menores de 5 anos,clasificacion d,2003-01-01,30,18,30,18,48
51601,SAN AGUSTIN,estado nutricional en menores de 5 anos,clasificacion d,2003-01-01,2,1,2,1,3
80602,SAN ANDRES,estado nutricional en menores de 5 anos,clasificacion d,2003-01-01,3,16,3,16,19
51003,SAN ANTONIO DE ESMORUCO,estado nutricional en menores de 5 anos,clasificacion d,2003-01-01,3,11,3,11,14
71105,SAN ANTONIO DE LOMERIO,estado nutricional en menores de 5 anos,clasificacion d,2003-01-01,108,145,108,145,253
31403,SAN BENITO,estado nutricional en menores de 5 anos,clasificacion d,2003-01-01,12,29,12,29,41
80302,SAN BORJA,estado nutricional en menores de 5 anos,clasificacion d,2003-01-01,111,58,111,58,169
21502,SAN BUENA VENTURA,estado nutricional en menores de 5 anos,clasificacion d,2003-01-01,52,63,52,63,115
70402,SAN CARLOS,estado nutricional en menores de 5 anos,clasificacion d,2003-01-01,72,66,72,66,138
80501,SAN IGNACIO,estado nutricional en menores de 5 anos,clasificacion d,2003-01-01,79,71,79,71,150
70301,SAN IGNACIO DE VELASCO,estado nutricional en menores de 5 anos,clasificacion d,2003-01-01,205,177,205,177,382
80102,SAN JAVIER(BNI),estado nutricional en menores de 5 anos,clasificacion d,2003-01-01,3,5,3,5,8
71102,SAN JAVIER(STC),estado nutricional en menores de 5 anos,clasificacion d,2003-01-01,40,29,40,29,69
80701,SAN JOAQUIN,estado nutricional en menores de 5 anos,clasificacion d,2003-01-01,5,17,5,17,22
70501,SAN JOSE DE CHIQUITOS,estado nutricional en menores de 5 anos,clasificacion d,2003-01-01,57,29,57,29,86
71104,SAN JULIAN,estado nutricional en menores de 5 anos,clasificacion d,2003-01-01,131,127,131,127,258
90302,SAN LORENZO(PND),estado nutricional en menores de 5 anos,clasificacion d,2003-01-01,5,14,5,14,19
60501,SAN LORENZO(TJA),estado nutricional en menores de 5 anos,clasificacion d,2003-01-01,49,49,49,49,98
10702,SAN LUCAS,estado nutricional en menores de 5 anos,clasificacion d,2003-01-01,311,336,311,336,647
71201,SAN MATIAS,estado nutricional en menores de 5 anos,clasificacion d,2003-01-01,73,41,73,41,114
70302,SAN MIGUEL DE VELASCO,estado nutricional en menores de 5 anos,clasificacion d,2003-01-01,48,56,48,56,104
51001,SAN PABLO DE LIPEZ,estado nutricional en menores de 5 anos,clasificacion d,2003-01-01,6,24,6,24,30
50501,SAN PEDRO DE BUENA VISTA,estado nutricional en menores de 5 anos,clasificacion d,2003-01-01,80,156,80,156,236
21801,SAN PEDRO DE CURAHUARA,estado nutricional en menores de 5 anos,clasificacion d,2003-01-01,22,28,22,28,50
50902,SAN PEDRO DE QUEMES,estado nutricional en menores de 5 anos,clasificacion d,2003-01-01,3,2,3,2,5
21702,SAN PEDRO DE TIQUINA,estado nutricional en menores de 5 anos,clasificacion d,2003-01-01,3,8,3,8,11
90202,SAN PEDRO(PND),estado nutricional en menores de 5 anos,clasificacion d,2003-01-01,6,8,6,8,14
70303,SAN RAFAEL,estado nutricional en menores de 5 anos,clasificacion d,2003-01-01,32,43,32,43,75
80702,SAN RAMON,estado nutricional en menores de 5 anos,clasificacion d,2003-01-01,5,2,5,2,7
80702,SAN RAMON,estado nutricional en menores de 5 anos,clasificacion d,2003-01-01,4,16,4,16,20
80401,SANTA ANA,estado nutricional en menores de 5 anos,clasificacion d,2003-01-01,3,1,3,1,4
70101,SANTA CRUZ DE LA SIERRA,estado nutricional en menores de 5 anos,clasificacion d,2003-01-01,1147,637,1147,637,1784
80303,SANTA ROSA,estado nutricional en menores de 5 anos,clasificacion d,2003-01-01,8,4,8,4,12
70602,SANTA ROSA DEL SARA,estado nutricional en menores de 5 anos,clasificacion d,2003-01-01,10,16,10,16,26
20308,SANTIAGO DE CALLAPA,estado nutricional en menores de 5 anos,clasificacion d,2003-01-01,24,22,24,22,46
41401,SANTIAGO DE HUARI,estado nutricional en menores de 5 anos,clasificacion d,2003-01-01,20,48,20,48,68
21901,SANTIAGO DE MACHACA,estado nutricional en menores de 5 anos,clasificacion d,2003-01-01,5,8,5,8,13
30702,SANTIVAÃ‘ES,estado nutricional en menores de 5 anos,clasificacion d,2003-01-01,10,8,10,8,18
40202,SANTUARIO DE QUILLACAS,estado nutricional en menores de 5 anos,clasificacion d,2003-01-01,10,2,10,2,12
20902,SAPAHAQUI,estado nutricional en menores de 5 anos,clasificacion d,2003-01-01,11,8,11,8,19
90303,SENA,estado nutricional en menores de 5 anos,clasificacion d,2003-01-01,1,10,1,10,11
21301,SICA SICA (VILLA AROMA),estado nutricional en menores de 5 anos,clasificacion d,2003-01-01,85,82,85,82,167
30703,SICAYA,estado nutricional en menores de 5 anos,clasificacion d,2003-01-01,15,2,15,2,17
30902,SIPE SIPE,estado nutricional en menores de 5 anos,clasificacion d,2003-01-01,129,77,129,77,206
10403,SOPACHUY,estado nutricional en menores de 5 anos,clasificacion d,2003-01-01,39,48,39,48,87
20601,SORATA,estado nutricional en menores de 5 anos,clasificacion d,2003-01-01,25,78,25,78,103
10101,SUCRE,estado nutricional en menores de 5 anos,clasificacion d,2003-01-01,448,447,448,447,895
31404,TACACHI,estado nutricional en menores de 5 anos,clasificacion d,2003-01-01,11,4,11,4,15
20603,TACACOMA,estado nutricional en menores de 5 anos,clasificacion d,2003-01-01,9,15,9,15,24
50303,TACOBAMBA,estado nutricional en menores de 5 anos,clasificacion d,2003-01-01,18,36,18,36,54
30602,TACOPAYA,estado nutricional en menores de 5 anos,clasificacion d,2003-01-01,66,111,66,111,177
51402,TAHUA,estado nutricional en menores de 5 anos,clasificacion d,2003-01-01,4,0,4,0,4
31101,TAPACARI,estado nutricional en menores de 5 anos,clasificacion d,2003-01-01,53,80,53,80,133
10601,TARABUCO,estado nutricional en menores de 5 anos,clasificacion d,2003-01-01,268,450,268,450,718
30401,TARATA,estado nutricional en menores de 5 anos,clasificacion d,2003-01-01,20,23,20,23,43
60101,TARIJA,estado nutricional en menores de 5 anos,clasificacion d,2003-01-01,330,212,330,212,542
10202,TARVITA,estado nutricional en menores de 5 anos,clasificacion d,2003-01-01,95,181,95,181,276
20803,TIAWANACU,estado nutricional en menores de 5 anos,clasificacion d,2003-01-01,26,22,26,22,48
50102,TINGUIPAYA,estado nutricional en menores de 5 anos,clasificacion d,2003-01-01,64,85,64,85,149
20606,TIPUANI,estado nutricional en menores de 5 anos,clasificacion d,2003-01-01,15,9,15,9,24
30903,TIQUIPAYA,estado nutricional en menores de 5 anos,clasificacion d,2003-01-01,55,31,55,31,86
31601,TIRAQUE (CBBA),estado nutricional en menores de 5 anos,clasificacion d,2003-01-01,67,134,67,134,201
21703,TITO YUPANQUI (PARQUIPUJIO),estado nutricional en menores de 5 anos,clasificacion d,2003-01-01,3,1,3,1,4
30802,TOCO,estado nutricional en menores de 5 anos,clasificacion d,2003-01-01,6,2,6,2,8
30803,TOLATA,estado nutricional en menores de 5 anos,clasificacion d,2003-01-01,19,20,19,20,39
41001,TOLEDO,estado nutricional en menores de 5 anos,clasificacion d,2003-01-01,13,4,13,4,17
51202,TOMAVE,estado nutricional en menores de 5 anos,clasificacion d,2003-01-01,63,59,63,59,122
10402,TOMINA,estado nutricional en menores de 5 anos,clasificacion d,2003-01-01,83,150,83,150,233
50502,TORO TORO,estado nutricional en menores de 5 anos,clasificacion d,2003-01-01,47,40,47,40,87
31201,TOTORA(CBBA),estado nutricional en menores de 5 anos,clasificacion d,2003-01-01,22,29,22,29,51
41301,TOTORA(ORR),estado nutricional en menores de 5 anos,clasificacion d,2003-01-01,8,6,8,6,14
70802,TRIGAL,estado nutricional en menores de 5 anos,clasificacion d,2003-01-01,1,9,1,9,10
80101,TRINIDAD,estado nutricional en menores de 5 anos,clasificacion d,2003-01-01,200,263,200,263,463
50801,TUPIZA,estado nutricional en menores de 5 anos,clasificacion d,2003-01-01,114,312,114,312,426
40402,TURCO,estado nutricional en menores de 5 anos,clasificacion d,2003-01-01,10,13,10,13,23
21302,UMALA,estado nutricional en menores de 5 anos,clasificacion d,2003-01-01,22,18,22,18,40
50201,UNCIA,estado nutricional en menores de 5 anos,clasificacion d,2003-01-01,9,43,9,43,52
60401,URIONDO (A. CONCEPCION),estado nutricional en menores de 5 anos,clasificacion d,2003-01-01,27,22,27,22,49
71502,URUBICHA,estado nutricional en menores de 5 anos,clasificacion d,2003-01-01,16,22,16,22,38
51201,UYUNI,estado nutricional en menores de 5 anos,clasificacion d,2003-01-01,65,56,65,56,121
30502,VACAS,estado nutricional en menores de 5 anos,clasificacion d,2003-01-01,27,27,27,27,54
70801,VALLEGRANDE,estado nutricional en menores de 5 anos,clasificacion d,2003-01-01,72,71,72,71,143
20801,VIACHA,estado nutricional en menores de 5 anos,clasificacion d,2003-01-01,79,111,79,111,190
31302,VILA VILA,estado nutricional en menores de 5 anos,clasificacion d,2003-01-01,13,15,13,15,28
60303,VILLA MONTES,estado nutricional en menores de 5 anos,clasificacion d,2003-01-01,93,78,93,78,171
31402,VILLA RIVERO,estado nutricional en menores de 5 anos,clasificacion d,2003-01-01,32,10,32,10,42
10801,VILLA SERRANO,estado nutricional en menores de 5 anos,clasificacion d,2003-01-01,81,160,81,160,241
31003,VILLA TUNARI,estado nutricional en menores de 5 anos,clasificacion d,2003-01-01,99,135,99,135,234
11001,VILLA VACA GUZMAN (MUYUPAMPA),estado nutricional en menores de 5 anos,clasificacion d,2003-01-01,55,116,55,116,171
51501,VILLAZON,estado nutricional en menores de 5 anos,clasificacion d,2003-01-01,143,176,143,176,319
30904,VINTO,estado nutricional en menores de 5 anos,clasificacion d,2003-01-01,1,4,1,4,5
50602,VITICHI,estado nutricional en menores de 5 anos,clasificacion d,2003-01-01,81,97,81,97,178
20306,WALDO BALLIVIAN,estado nutricional en menores de 5 anos,clasificacion d,2003-01-01,1,1,1,1,2
70201,WARNES,estado nutricional en menores de 5 anos,clasificacion d,2003-01-01,122,96,122,96,218
20903,YACO,estado nutricional en menores de 5 anos,clasificacion d,2003-01-01,19,15,19,15,34
60301,YACUIBA,estado nutricional en menores de 5 anos,clasificacion d,2003-01-01,152,92,152,92,244
10602,YAMPARAEZ,estado nutricional en menores de 5 anos,clasificacion d,2003-01-01,140,280,140,280,420
21103,YANACACHI,estado nutricional en menores de 5 anos,clasificacion d,2003-01-01,7,10,7,10,17
70403,YAPACANI,estado nutricional en menores de 5 anos,clasificacion d,2003-01-01,140,117,140,117,257
50103,YOCALLA,estado nutricional en menores de 5 anos,clasificacion d,2003-01-01,30,66,30,66,96
10102,YOTALA,estado nutricional en menores de 5 anos,clasificacion d,2003-01-01,47,111,47,111,158
60402,YUNCHARA,estado nutricional en menores de 5 anos,clasificacion d,2003-01-01,20,22,20,22,42
10301,ZUDAÃ‘EZ,estado nutricional en menores de 5 anos,clasificacion d,2003-01-01,46,101,46,101,147
51302,ACACIO,estado nutricional en menores de 5 anos,clasificacion d,2003-02-01,49,83,49,83,132
20201,ACHACACHI,estado nutricional en menores de 5 anos,clasificacion d,2003-02-01,117,140,117,140,257
20104,ACHOCALLA,estado nutricional en menores de 5 anos,clasificacion d,2003-02-01,25,17,25,17,42
30201,AIQUILE,estado nutricional en menores de 5 anos,clasificacion d,2003-02-01,55,49,55,49,104
31303,ALALAY,estado nutricional en menores de 5 anos,clasificacion d,2003-02-01,11,17,11,17,28
10404,ALCALA,estado nutricional en menores de 5 anos,clasificacion d,2003-02-01,31,64,31,64,95
20202,ANCORAIMES,estado nutricional en menores de 5 anos,clasificacion d,2003-02-01,54,96,54,96,150
41201,ANDAMARCA,estado nutricional en menores de 5 anos,clasificacion d,2003-02-01,3,8,3,8,11
40603,ANTEQUERA,estado nutricional en menores de 5 anos,clasificacion d,2003-02-01,5,8,5,8,13
30402,ANZALDO,estado nutricional en menores de 5 anos,clasificacion d,2003-02-01,23,61,23,61,84
20701,APOLO,estado nutricional en menores de 5 anos,clasificacion d,2003-02-01,30,29,30,29,59
51301,ARAMPAMPA,estado nutricional en menores de 5 anos,clasificacion d,2003-02-01,44,102,44,102,146
30501,ARANI,estado nutricional en menores de 5 anos,clasificacion d,2003-02-01,8,15,8,15,23
30403,ARBIETO,estado nutricional en menores de 5 anos,clasificacion d,2003-02-01,16,13,16,13,29
30601,ARQUE,estado nutricional en menores de 5 anos,clasificacion d,2003-02-01,35,43,35,43,78
71501,ASCENCION DE GUARAYOS,estado nutricional en menores de 5 anos,clasificacion d,2003-02-01,190,253,190,253,443
50802,ATOCHA,estado nutricional en menores de 5 anos,clasificacion d,2003-02-01,23,144,23,144,167
20503,AUCAPATA,estado nutricional en menores de 5 anos,clasificacion d,2003-02-01,20,24,20,24,44
20502,AYATA,estado nutricional en menores de 5 anos,clasificacion d,2003-02-01,27,14,27,14,41
21303,AYO AYO,estado nutricional en menores de 5 anos,clasificacion d,2003-02-01,3,0,3,0,3
30301,AYOPAYA (V. DE INDEPENDENCIA),estado nutricional en menores de 5 anos,clasificacion d,2003-02-01,97,118,97,118,215
10201,AZURDUY,estado nutricional en menores de 5 anos,clasificacion d,2003-02-01,124,190,124,190,314
21203,BATALLAS,estado nutricional en menores de 5 anos,clasificacion d,2003-02-01,22,28,22,28,50
80802,BAURES,estado nutricional en menores de 5 anos,clasificacion d,2003-02-01,14,26,14,26,40
41202,BELEN DE ANDAMARCA,estado nutricional en menores de 5 anos,clasificacion d,2003-02-01,1,1,1,1,2
50104,BELEN DE URMIRI,estado nutricional en menores de 5 anos,clasificacion d,2003-02-01,5,15,5,15,20
90104,BELLA FLOR,estado nutricional en menores de 5 anos,clasificacion d,2003-02-01,1,0,1,0,1
60202,BERMEJO,estado nutricional en menores de 5 anos,clasificacion d,2003-02-01,10,23,10,23,33
50301,BETANZOS,estado nutricional en menores de 5 anos,clasificacion d,2003-02-01,168,199,168,199,367
31501,BOLIVAR,estado nutricional en menores de 5 anos,clasificacion d,2003-02-01,43,55,43,55,98
90103,BOLPEBRA,estado nutricional en menores de 5 anos,clasificacion d,2003-02-01,5,9,5,9,14
70707,BOYUIBE,estado nutricional en menores de 5 anos,clasificacion d,2003-02-01,11,16,11,16,27
70401,BUENA VISTA,estado nutricional en menores de 5 anos,clasificacion d,2003-02-01,38,31,38,31,69
70703,CABEZAS,estado nutricional en menores de 5 anos,clasificacion d,2003-02-01,42,53,42,53,95
20905,CAIROMA,estado nutricional en menores de 5 anos,clasificacion d,2003-02-01,61,52,61,52,113
51102,"CAIZA ""D""",estado nutricional en menores de 5 anos,clasificacion d,2003-02-01,71,83,71,83,154
21003,CAJUATA,estado nutricional en menores de 5 anos,clasificacion d,2003-02-01,26,20,26,20,46
20303,CALACOTO,estado nutricional en menores de 5 anos,clasificacion d,2003-02-01,8,4,8,4,12
21304,CALAMARCA,estado nutricional en menores de 5 anos,clasificacion d,2003-02-01,100,96,100,96,196
10701,CAMARGO,estado nutricional en menores de 5 anos,clasificacion d,2003-02-01,77,82,77,82,159
10901,CAMATAQUI (C. VILLA ABECIA),estado nutricional en menores de 5 anos,clasificacion d,2003-02-01,14,17,14,17,31
70706,CAMIRI,estado nutricional en menores de 5 anos,clasificacion d,2003-02-01,123,93,123,93,216
30701,CAPINOTA,estado nutricional en menores de 5 anos,clasificacion d,2003-02-01,13,25,13,25,38
20302,CAQUIAVIRI,estado nutricional en menores de 5 anos,clasificacion d,2003-02-01,18,25,18,25,43
40102,CARACOLLO,estado nutricional en menores de 5 anos,clasificacion d,2003-02-01,59,32,59,32,91
22001,CARANAVI,estado nutricional en menores de 5 anos,clasificacion d,2003-02-01,78,84,78,84,162
41503,CARANGAS,estado nutricional en menores de 5 anos,clasificacion d,2003-02-01,0,1,0,1,1
60302,CARAPARI,estado nutricional en menores de 5 anos,clasificacion d,2003-02-01,36,47,36,47,83
50702,CARIPUYO,estado nutricional en menores de 5 anos,clasificacion d,2003-02-01,72,64,72,64,136
21902,CATACORA,estado nutricional en menores de 5 anos,clasificacion d,2003-02-01,1,4,1,4,5
40201,CHALLAPATA,estado nutricional en menores de 5 anos,clasificacion d,2003-02-01,56,112,56,112,168
50302,CHAQUI,estado nutricional en menores de 5 anos,clasificacion d,2003-02-01,72,66,72,66,138
70702,CHARAGUA,estado nutricional en menores de 5 anos,clasificacion d,2003-02-01,85,147,85,147,232
20305,CHARAÃ‘A,estado nutricional en menores de 5 anos,clasificacion d,2003-02-01,4,4,4,4,8
50202,CHAYANTA,estado nutricional en menores de 5 anos,clasificacion d,2003-02-01,65,60,65,60,125
31204,CHIMORE,estado nutricional en menores de 5 anos,clasificacion d,2003-02-01,14,26,14,26,40
40302,CHOQUE COTA,estado nutricional en menores de 5 anos,clasificacion d,2003-02-01,8,11,8,11,19
21101,CHULUMANI (V. DE LA LIBERTAD),estado nutricional en menores de 5 anos,clasificacion d,2003-02-01,14,21,14,21,35
20501,CHUMA,estado nutricional en menores de 5 anos,clasificacion d,2003-02-01,16,24,16,24,40
30801,CLIZA,estado nutricional en menores de 5 anos,clasificacion d,2003-02-01,22,7,22,7,29
90101,COBIJA,estado nutricional en menores de 5 anos,clasificacion d,2003-02-01,42,72,42,72,114
30101,COCHABAMBA,estado nutricional en menores de 5 anos,clasificacion d,2003-02-01,464,412,464,412,876
30905,COLCAPIRHUA,estado nutricional en menores de 5 anos,clasificacion d,2003-02-01,19,12,19,12,31
50901,"COLCHA ""K""",estado nutricional en menores de 5 anos,clasificacion d,2003-02-01,34,48,34,48,82
21307,COLLANA,estado nutricional en menores de 5 anos,clasificacion d,2003-02-01,3,3,3,3,6
31002,COLOMI,estado nutricional en menores de 5 anos,clasificacion d,2003-02-01,66,59,66,59,125
50401,COLQUECHACA,estado nutricional en menores de 5 anos,clasificacion d,2003-02-01,80,34,80,34,114
21306,COLQUENCHA,estado nutricional en menores de 5 anos,clasificacion d,2003-02-01,19,4,19,4,23
21004,COLQUIRI,estado nutricional en menores de 5 anos,clasificacion d,2003-02-01,61,47,61,47,108
20304,COMANCHE,estado nutricional en menores de 5 anos,clasificacion d,2003-02-01,3,3,3,3,6
71301,COMARAPA,estado nutricional en menores de 5 anos,clasificacion d,2003-02-01,72,58,72,58,130
71101,CONCEPCION,estado nutricional en menores de 5 anos,clasificacion d,2003-02-01,34,16,34,16,50
21701,COPACABANA,estado nutricional en menores de 5 anos,clasificacion d,2003-02-01,44,42,44,42,86
21402,CORIPATA,estado nutricional en menores de 5 anos,clasificacion d,2003-02-01,15,3,15,3,18
20301,CORO CORO,estado nutricional en menores de 5 anos,clasificacion d,2003-02-01,27,21,27,21,48
21401,COROICO,estado nutricional en menores de 5 anos,clasificacion d,2003-02-01,17,14,17,14,31
40301,CORQUE,estado nutricional en menores de 5 anos,clasificacion d,2003-02-01,20,9,20,9,29
50601,COTAGAITA,estado nutricional en menores de 5 anos,clasificacion d,2003-02-01,75,158,75,158,233
70102,COTOCA,estado nutricional en menores de 5 anos,clasificacion d,2003-02-01,37,30,37,30,67
31405,CUCHUMUELA (V. G. VILLARROEL),estado nutricional en menores de 5 anos,clasificacion d,2003-02-01,3,2,3,2,5
70704,CUEVO,estado nutricional en menores de 5 anos,clasificacion d,2003-02-01,22,38,22,38,60
10902,CULPINA,estado nutricional en menores de 5 anos,clasificacion d,2003-02-01,155,192,155,192,347
40401,CURAHUARA DE CARANGAS,estado nutricional en menores de 5 anos,clasificacion d,2003-02-01,16,25,16,25,41
21602,CURVA,estado nutricional en menores de 5 anos,clasificacion d,2003-02-01,15,13,15,13,28
20804,DESAGUADERO,estado nutricional en menores de 5 anos,clasificacion d,2003-02-01,18,23,18,23,41
20105,EL ALTO,estado nutricional en menores de 5 anos,clasificacion d,2003-02-01,1470,901,1470,901,2371
40103,EL CHORO,estado nutricional en menores de 5 anos,clasificacion d,2003-02-01,5,8,5,8,13
71503,EL PUENTE(STC),estado nutricional en menores de 5 anos,clasificacion d,2003-02-01,30,85,30,85,115
60502,EL PUENTE(TJA),estado nutricional en menores de 5 anos,clasificacion d,2003-02-01,79,141,79,141,220
70105,EL TORNO,estado nutricional en menores de 5 anos,clasificacion d,2003-02-01,54,62,54,62,116
10405,EL VILLAR,estado nutricional en menores de 5 anos,clasificacion d,2003-02-01,38,135,38,135,173
60601,ENTRE RIOS,estado nutricional en menores de 5 anos,clasificacion d,2003-02-01,38,58,38,58,96
41101,EUCALIPTUS,estado nutricional en menores de 5 anos,clasificacion d,2003-02-01,29,36,29,36,65
80402,EXALTACION,estado nutricional en menores de 5 anos,clasificacion d,2003-02-01,4,7,4,7,11
90203,FILADELFIA,estado nutricional en menores de 5 anos,clasificacion d,2003-02-01,3,1,3,1,4
71002,GENERAL SAAVEDRA,estado nutricional en menores de 5 anos,clasificacion d,2003-02-01,64,89,64,89,153
21601,GRAL. J.J. PEREZ (CHARAZANI),estado nutricional en menores de 5 anos,clasificacion d,2003-02-01,9,15,9,15,24
20602,GUANAY,estado nutricional en menores de 5 anos,clasificacion d,2003-02-01,74,79,74,79,153
20802,GUAQUI,estado nutricional en menores de 5 anos,clasificacion d,2003-02-01,8,1,8,1,9
80202,GUAYARAMERIN,estado nutricional en menores de 5 anos,clasificacion d,2003-02-01,126,89,126,89,215
70705,GUTIERREZ,estado nutricional en menores de 5 anos,clasificacion d,2003-02-01,95,189,95,189,284
10502,HUACARETA,estado nutricional en menores de 5 anos,clasificacion d,2003-02-01,56,97,56,97,153
11002,HUACAYA (VILLA DE HUACAYA),estado nutricional en menores de 5 anos,clasificacion d,2003-02-01,12,25,12,25,37
40501,HUACHACALLA,estado nutricional en menores de 5 anos,clasificacion d,2003-02-01,3,1,3,1,4
40701,HUANUNI,estado nutricional en menores de 5 anos,clasificacion d,2003-02-01,43,34,43,34,77
80803,HUARACAJE,estado nutricional en menores de 5 anos,clasificacion d,2003-02-01,8,6,8,6,14
41601,HUAYLLAMARCA,estado nutricional en menores de 5 anos,clasificacion d,2003-02-01,9,20,9,20,29
21005,ICHOCA,estado nutricional en menores de 5 anos,clasificacion d,2003-02-01,15,19,15,19,34
10304,ICLA,estado nutricional en menores de 5 anos,clasificacion d,2003-02-01,64,95,64,95,159
10703,INCAHUASI,estado nutricional en menores de 5 anos,clasificacion d,2003-02-01,144,114,144,114,258
21001,INQUISIVI,estado nutricional en menores de 5 anos,clasificacion d,2003-02-01,54,55,54,55,109
21102,IRUPANA (VILLA DE LANZA),estado nutricional en menores de 5 anos,clasificacion d,2003-02-01,17,30,17,30,47
21501,IXIAMAS,estado nutricional en menores de 5 anos,clasificacion d,2003-02-01,22,28,22,28,50
21105,LA ASUNTA,estado nutricional en menores de 5 anos,clasificacion d,2003-02-01,22,16,22,16,38
70104,LA GUARDIA,estado nutricional en menores de 5 anos,clasificacion d,2003-02-01,53,33,53,33,86
20101,LA PAZ,estado nutricional en menores de 5 anos,clasificacion d,2003-02-01,968,789,968,789,1757
70701,LAGUNILLAS,estado nutricional en menores de 5 anos,clasificacion d,2003-02-01,42,49,42,49,91
21202,LAJA,estado nutricional en menores de 5 anos,clasificacion d,2003-02-01,12,11,12,11,23
10903,LAS CARRERAS,estado nutricional en menores de 5 anos,clasificacion d,2003-02-01,26,47,26,47,73
21006,LICOMA PAMPA,estado nutricional en menores de 5 anos,clasificacion d,2003-02-01,4,5,4,5,9
50203,LLALLAGUA,estado nutricional en menores de 5 anos,clasificacion d,2003-02-01,15,412,15,412,427
51401,LLICA,estado nutricional en menores de 5 anos,clasificacion d,2003-02-01,14,14,14,14,28
80601,LORETO,estado nutricional en menores de 5 anos,clasificacion d,2003-02-01,14,20,14,20,34
20901,LURIBAY,estado nutricional en menores de 5 anos,clasificacion d,2003-02-01,31,19,31,19,50
40702,MACHACAMARCA,estado nutricional en menores de 5 anos,clasificacion d,2003-02-01,11,16,11,16,27
11003,MACHARETI,estado nutricional en menores de 5 anos,clasificacion d,2003-02-01,42,92,42,92,134
80801,MAGDALENA,estado nutricional en menores de 5 anos,clasificacion d,2003-02-01,29,35,29,35,64
70903,MAIRANA,estado nutricional en menores de 5 anos,clasificacion d,2003-02-01,43,20,43,20,63
20904,MALLA,estado nutricional en menores de 5 anos,clasificacion d,2003-02-01,1,5,1,5,6
20103,MECAPACA,estado nutricional en menores de 5 anos,clasificacion d,2003-02-01,11,16,11,16,27
71003,MINEROS,estado nutricional en menores de 5 anos,clasificacion d,2003-02-01,130,83,130,83,213
31301,MIZQUE,estado nutricional en menores de 5 anos,clasificacion d,2003-02-01,51,45,51,45,96
20402,MOCOMOCO,estado nutricional en menores de 5 anos,clasificacion d,2003-02-01,52,50,52,50,102
51002,MOJINETE,estado nutricional en menores de 5 anos,clasificacion d,2003-02-01,4,16,4,16,20
10303,MOJOCOYA,estado nutricional en menores de 5 anos,clasificacion d,2003-02-01,55,106,55,106,161
10501,MONTEAGUDO,estado nutricional en menores de 5 anos,clasificacion d,2003-02-01,145,184,145,184,329
71001,MONTERO,estado nutricional en menores de 5 anos,clasificacion d,2003-02-01,314,157,314,157,471
70803,MORO MORO,estado nutricional en menores de 5 anos,clasificacion d,2003-02-01,7,12,7,12,19
30302,MOROCHATA,estado nutricional en menores de 5 anos,clasificacion d,2003-02-01,69,128,69,128,197
90401,NACEBE (SANTA ROSA DEL ABUNA),estado nutricional en menores de 5 anos,clasificacion d,2003-02-01,5,7,5,7,12
20307,NAZACARA DE PACAJES,estado nutricional en menores de 5 anos,clasificacion d,2003-02-01,5,0,5,0,5
50404,OCURI,estado nutricional en menores de 5 anos,clasificacion d,2003-02-01,32,71,32,71,103
70202,OKINAWA,estado nutricional en menores de 5 anos,clasificacion d,2003-02-01,7,22,7,22,29
30203,OMEREQUE,estado nutricional en menores de 5 anos,clasificacion d,2003-02-01,0,10,0,10,10
40101,ORURO,estado nutricional en menores de 5 anos,clasificacion d,2003-02-01,349,429,349,429,778
60201,PADCAYA,estado nutricional en menores de 5 anos,clasificacion d,2003-02-01,40,68,40,68,108
10401,PADILLA,estado nutricional en menores de 5 anos,clasificacion d,2003-02-01,97,210,97,210,307
70502,PAILON,estado nutricional en menores de 5 anos,clasificacion d,2003-02-01,34,24,34,24,58
20102,PALCA,estado nutricional en menores de 5 anos,clasificacion d,2003-02-01,47,22,47,22,69
21104,PALOS BLANCOS,estado nutricional en menores de 5 anos,clasificacion d,2003-02-01,77,81,77,81,158
40802,PAMPA AULLAGAS,estado nutricional en menores de 5 anos,clasificacion d,2003-02-01,9,18,9,18,27
70902,PAMPA GRANDE,estado nutricional en menores de 5 anos,clasificacion d,2003-02-01,10,16,10,16,26
21802,PAPEL PAMPA,estado nutricional en menores de 5 anos,clasificacion d,2003-02-01,4,2,4,2,6
30202,PASORAPA,estado nutricional en menores de 5 anos,clasificacion d,2003-02-01,15,32,15,32,47
21305,PATACAMAYA,estado nutricional en menores de 5 anos,clasificacion d,2003-02-01,121,86,121,86,207
40602,PAZÃ‘A,estado nutricional en menores de 5 anos,clasificacion d,2003-02-01,4,21,4,21,25
20702,PELECHUCO,estado nutricional en menores de 5 anos,clasificacion d,2003-02-01,37,32,37,32,69
50403,POCOATA,estado nutricional en menores de 5 anos,clasificacion d,2003-02-01,186,195,186,195,381
31203,POCONA,estado nutricional en menores de 5 anos,clasificacion d,2003-02-01,36,20,36,20,56
31202,POJO (CBBA),estado nutricional en menores de 5 anos,clasificacion d,2003-02-01,98,94,98,94,192
40601,POOPO,estado nutricional en menores de 5 anos,clasificacion d,2003-02-01,6,10,6,10,16
51203,PORCO,estado nutricional en menores de 5 anos,clasificacion d,2003-02-01,20,13,20,13,33
10103,POROMA,estado nutricional en menores de 5 anos,clasificacion d,2003-02-01,118,174,118,174,292
70103,PORONGO,estado nutricional en menores de 5 anos,clasificacion d,2003-02-01,9,7,9,7,16
70601,PORTACHUELO,estado nutricional en menores de 5 anos,clasificacion d,2003-02-01,50,35,50,35,85
90102,PORVENIR,estado nutricional en menores de 5 anos,clasificacion d,2003-02-01,14,18,14,18,32
70804,POSTRER VALLE,estado nutricional en menores de 5 anos,clasificacion d,2003-02-01,12,15,12,15,27
50101,POTOSI,estado nutricional en menores de 5 anos,clasificacion d,2003-02-01,474,352,474,352,826
10302,PRESTO,estado nutricional en menores de 5 anos,clasificacion d,2003-02-01,67,107,67,107,174
21201,PUCARANI,estado nutricional en menores de 5 anos,clasificacion d,2003-02-01,30,27,30,27,57
20401,PUERTO ACOSTA,estado nutricional en menores de 5 anos,clasificacion d,2003-02-01,66,118,66,118,184
20403,PUERTO CARABUCO,estado nutricional en menores de 5 anos,clasificacion d,2003-02-01,57,96,57,96,153
90301,PUERTO GONZALO MORENO,estado nutricional en menores de 5 anos,clasificacion d,2003-02-01,13,3,13,3,16
21204,PUERTO PEREZ,estado nutricional en menores de 5 anos,clasificacion d,2003-02-01,17,9,17,9,26
71402,PUERTO QUIJARRO,estado nutricional en menores de 5 anos,clasificacion d,2003-02-01,47,15,47,15,62
90201,PUERTO RICO,estado nutricional en menores de 5 anos,clasificacion d,2003-02-01,15,22,15,22,37
80703,PUERTO SILES,estado nutricional en menores de 5 anos,clasificacion d,2003-02-01,0,3,0,3,3
71401,PUERTO SUAREZ,estado nutricional en menores de 5 anos,clasificacion d,2003-02-01,44,22,44,22,66
31205,PUERTO VILLARROEL,estado nutricional en menores de 5 anos,clasificacion d,2003-02-01,150,127,150,127,277
51101,PUNA,estado nutricional en menores de 5 anos,clasificacion d,2003-02-01,42,67,42,67,109
31401,PUNATA,estado nutricional en menores de 5 anos,clasificacion d,2003-02-01,77,11,77,11,88
30901,QUILLACOLLO,estado nutricional en menores de 5 anos,clasificacion d,2003-02-01,81,83,81,83,164
21002,QUIME,estado nutricional en menores de 5 anos,clasificacion d,2003-02-01,82,48,82,48,130
70904,QUIRUSILLAS,estado nutricional en menores de 5 anos,clasificacion d,2003-02-01,4,5,4,5,9
50402,RAVELO,estado nutricional en menores de 5 anos,clasificacion d,2003-02-01,155,190,155,190,345
80301,REYES,estado nutricional en menores de 5 anos,clasificacion d,2003-02-01,31,43,31,43,74
80201,RIBERALTA,estado nutricional en menores de 5 anos,clasificacion d,2003-02-01,261,189,261,189,450
70503,ROBORE,estado nutricional en menores de 5 anos,clasificacion d,2003-02-01,27,63,27,63,90
80304,RURRENABAQUE,estado nutricional en menores de 5 anos,clasificacion d,2003-02-01,1,3,1,3,4
40901,SABAYA,estado nutricional en menores de 5 anos,clasificacion d,2003-02-01,1,4,1,4,5
31001,SACABA,estado nutricional en menores de 5 anos,clasificacion d,2003-02-01,98,93,98,93,191
30404,SACABAMBA,estado nutricional en menores de 5 anos,clasificacion d,2003-02-01,9,39,9,39,48
50701,SACACA,estado nutricional en menores de 5 anos,clasificacion d,2003-02-01,189,340,189,340,529
71302,SAIPINA,estado nutricional en menores de 5 anos,clasificacion d,2003-02-01,10,18,10,18,28
40801,SALINAS DE GARCI MENDOZA,estado nutricional en menores de 5 anos,clasificacion d,2003-02-01,5,18,5,18,23
70901,SAMAIPATA,estado nutricional en menores de 5 anos,clasificacion d,2003-02-01,26,18,26,18,44
51601,SAN AGUSTIN,estado nutricional en menores de 5 anos,clasificacion d,2003-02-01,4,5,4,5,9
80602,SAN ANDRES,estado nutricional en menores de 5 anos,clasificacion d,2003-02-01,27,44,27,44,71
51003,SAN ANTONIO DE ESMORUCO,estado nutricional en menores de 5 anos,clasificacion d,2003-02-01,4,13,4,13,17
71105,SAN ANTONIO DE LOMERIO,estado nutricional en menores de 5 anos,clasificacion d,2003-02-01,89,150,89,150,239
31403,SAN BENITO,estado nutricional en menores de 5 anos,clasificacion d,2003-02-01,46,19,46,19,65
80302,SAN BORJA,estado nutricional en menores de 5 anos,clasificacion d,2003-02-01,89,45,89,45,134
21502,SAN BUENA VENTURA,estado nutricional en menores de 5 anos,clasificacion d,2003-02-01,40,30,40,30,70
70402,SAN CARLOS,estado nutricional en menores de 5 anos,clasificacion d,2003-02-01,69,67,69,67,136
80501,SAN IGNACIO,estado nutricional en menores de 5 anos,clasificacion d,2003-02-01,74,91,74,91,165
70301,SAN IGNACIO DE VELASCO,estado nutricional en menores de 5 anos,clasificacion d,2003-02-01,215,185,215,185,400
80102,SAN JAVIER(BNI),estado nutricional en menores de 5 anos,clasificacion d,2003-02-01,5,9,5,9,14
71102,SAN JAVIER(STC),estado nutricional en menores de 5 anos,clasificacion d,2003-02-01,29,42,29,42,71
80701,SAN JOAQUIN,estado nutricional en menores de 5 anos,clasificacion d,2003-02-01,7,11,7,11,18
70501,SAN JOSE DE CHIQUITOS,estado nutricional en menores de 5 anos,clasificacion d,2003-02-01,44,19,44,19,63
71104,SAN JULIAN,estado nutricional en menores de 5 anos,clasificacion d,2003-02-01,196,249,196,249,445
90302,SAN LORENZO(PND),estado nutricional en menores de 5 anos,clasificacion d,2003-02-01,6,27,6,27,33
60501,SAN LORENZO(TJA),estado nutricional en menores de 5 anos,clasificacion d,2003-02-01,30,93,30,93,123
10702,SAN LUCAS,estado nutricional en menores de 5 anos,clasificacion d,2003-02-01,348,401,348,401,749
71201,SAN MATIAS,estado nutricional en menores de 5 anos,clasificacion d,2003-02-01,10,10,10,10,20
70302,SAN MIGUEL DE VELASCO,estado nutricional en menores de 5 anos,clasificacion d,2003-02-01,71,111,71,111,182
51001,SAN PABLO DE LIPEZ,estado nutricional en menores de 5 anos,clasificacion d,2003-02-01,4,13,4,13,17
50501,SAN PEDRO DE BUENA VISTA,estado nutricional en menores de 5 anos,clasificacion d,2003-02-01,122,259,122,259,381
21801,SAN PEDRO DE CURAHUARA,estado nutricional en menores de 5 anos,clasificacion d,2003-02-01,9,6,9,6,15
50902,SAN PEDRO DE QUEMES,estado nutricional en menores de 5 anos,clasificacion d,2003-02-01,6,5,6,5,11
21702,SAN PEDRO DE TIQUINA,estado nutricional en menores de 5 anos,clasificacion d,2003-02-01,2,10,2,10,12
70303,SAN RAFAEL,estado nutricional en menores de 5 anos,clasificacion d,2003-02-01,25,38,25,38,63
80702,SAN RAMON,estado nutricional en menores de 5 anos,clasificacion d,2003-02-01,5,3,5,3,8
80702,SAN RAMON,estado nutricional en menores de 5 anos,clasificacion d,2003-02-01,6,12,6,12,18
80401,SANTA ANA,estado nutricional en menores de 5 anos,clasificacion d,2003-02-01,1,1,1,1,2
70101,SANTA CRUZ DE LA SIERRA,estado nutricional en menores de 5 anos,clasificacion d,2003-02-01,767,418,767,418,1185
80303,SANTA ROSA,estado nutricional en menores de 5 anos,clasificacion d,2003-02-01,8,3,8,3,11
70602,SANTA ROSA DEL SARA,estado nutricional en menores de 5 anos,clasificacion d,2003-02-01,11,27,11,27,38
20308,SANTIAGO DE CALLAPA,estado nutricional en menores de 5 anos,clasificacion d,2003-02-01,12,17,12,17,29
41401,SANTIAGO DE HUARI,estado nutricional en menores de 5 anos,clasificacion d,2003-02-01,7,18,7,18,25
21901,SANTIAGO DE MACHACA,estado nutricional en menores de 5 anos,clasificacion d,2003-02-01,2,2,2,2,4
30702,SANTIVAÃ‘ES,estado nutricional en menores de 5 anos,clasificacion d,2003-02-01,19,17,19,17,36
40202,SANTUARIO DE QUILLACAS,estado nutricional en menores de 5 anos,clasificacion d,2003-02-01,12,17,12,17,29
20902,SAPAHAQUI,estado nutricional en menores de 5 anos,clasificacion d,2003-02-01,23,18,23,18,41
90303,SENA,estado nutricional en menores de 5 anos,clasificacion d,2003-02-01,5,3,5,3,8
21301,SICA SICA (VILLA AROMA),estado nutricional en menores de 5 anos,clasificacion d,2003-02-01,34,33,34,33,67
30703,SICAYA,estado nutricional en menores de 5 anos,clasificacion d,2003-02-01,1,13,1,13,14
30902,SIPE SIPE,estado nutricional en menores de 5 anos,clasificacion d,2003-02-01,84,54,84,54,138
10403,SOPACHUY,estado nutricional en menores de 5 anos,clasificacion d,2003-02-01,51,59,51,59,110
20601,SORATA,estado nutricional en menores de 5 anos,clasificacion d,2003-02-01,43,91,43,91,134
10101,SUCRE,estado nutricional en menores de 5 anos,clasificacion d,2003-02-01,513,668,513,668,1181
31404,TACACHI,estado nutricional en menores de 5 anos,clasificacion d,2003-02-01,8,2,8,2,10
50303,TACOBAMBA,estado nutricional en menores de 5 anos,clasificacion d,2003-02-01,37,49,37,49,86
30602,TACOPAYA,estado nutricional en menores de 5 anos,clasificacion d,2003-02-01,38,62,38,62,100
51402,TAHUA,estado nutricional en menores de 5 anos,clasificacion d,2003-02-01,7,10,7,10,17
31101,TAPACARI,estado nutricional en menores de 5 anos,clasificacion d,2003-02-01,64,82,64,82,146
10601,TARABUCO,estado nutricional en menores de 5 anos,clasificacion d,2003-02-01,228,399,228,399,627
30401,TARATA,estado nutricional en menores de 5 anos,clasificacion d,2003-02-01,18,19,18,19,37
60101,TARIJA,estado nutricional en menores de 5 anos,clasificacion d,2003-02-01,288,246,288,246,534
10202,TARVITA,estado nutricional en menores de 5 anos,clasificacion d,2003-02-01,120,191,120,191,311
20803,TIAWANACU,estado nutricional en menores de 5 anos,clasificacion d,2003-02-01,24,14,24,14,38
50102,TINGUIPAYA,estado nutricional en menores de 5 anos,clasificacion d,2003-02-01,17,11,17,11,28
20606,TIPUANI,estado nutricional en menores de 5 anos,clasificacion d,2003-02-01,1,0,1,0,1
30903,TIQUIPAYA,estado nutricional en menores de 5 anos,clasificacion d,2003-02-01,30,23,30,23,53
31601,TIRAQUE (CBBA),estado nutricional en menores de 5 anos,clasificacion d,2003-02-01,84,92,84,92,176
21703,TITO YUPANQUI (PARQUIPUJIO),estado nutricional en menores de 5 anos,clasificacion d,2003-02-01,7,1,7,1,8
30802,TOCO,estado nutricional en menores de 5 anos,clasificacion d,2003-02-01,1,6,1,6,7
30803,TOLATA,estado nutricional en menores de 5 anos,clasificacion d,2003-02-01,8,17,8,17,25
41001,TOLEDO,estado nutricional en menores de 5 anos,clasificacion d,2003-02-01,8,9,8,9,17
51202,TOMAVE,estado nutricional en menores de 5 anos,clasificacion d,2003-02-01,58,90,58,90,148
10402,TOMINA,estado nutricional en menores de 5 anos,clasificacion d,2003-02-01,91,168,91,168,259
50502,TORO TORO,estado nutricional en menores de 5 anos,clasificacion d,2003-02-01,94,85,94,85,179
31201,TOTORA(CBBA),estado nutricional en menores de 5 anos,clasificacion d,2003-02-01,36,29,36,29,65
41301,TOTORA(ORR),estado nutricional en menores de 5 anos,clasificacion d,2003-02-01,17,14,17,14,31
70802,TRIGAL,estado nutricional en menores de 5 anos,clasificacion d,2003-02-01,3,4,3,4,7
80101,TRINIDAD,estado nutricional en menores de 5 anos,clasificacion d,2003-02-01,150,166,150,166,316
50801,TUPIZA,estado nutricional en menores de 5 anos,clasificacion d,2003-02-01,87,386,87,386,473
40402,TURCO,estado nutricional en menores de 5 anos,clasificacion d,2003-02-01,10,16,10,16,26
21302,UMALA,estado nutricional en menores de 5 anos,clasificacion d,2003-02-01,22,31,22,31,53
50201,UNCIA,estado nutricional en menores de 5 anos,clasificacion d,2003-02-01,6,15,6,15,21
60401,URIONDO (A. CONCEPCION),estado nutricional en menores de 5 anos,clasificacion d,2003-02-01,30,26,30,26,56
71502,URUBICHA,estado nutricional en menores de 5 anos,clasificacion d,2003-02-01,55,102,55,102,157
51201,UYUNI,estado nutricional en menores de 5 anos,clasificacion d,2003-02-01,66,94,66,94,160
30502,VACAS,estado nutricional en menores de 5 anos,clasificacion d,2003-02-01,35,11,35,11,46
70801,VALLEGRANDE,estado nutricional en menores de 5 anos,clasificacion d,2003-02-01,48,49,48,49,97
20801,VIACHA,estado nutricional en menores de 5 anos,clasificacion d,2003-02-01,68,125,68,125,193
31302,VILA VILA,estado nutricional en menores de 5 anos,clasificacion d,2003-02-01,9,19,9,19,28
60303,VILLA MONTES,estado nutricional en menores de 5 anos,clasificacion d,2003-02-01,95,90,95,90,185
90502,VILLA NUEVA (LOMA ALTA),estado nutricional en menores de 5 anos,clasificacion d,2003-02-01,1,0,1,0,1
31402,VILLA RIVERO,estado nutricional en menores de 5 anos,clasificacion d,2003-02-01,24,4,24,4,28
10801,VILLA SERRANO,estado nutricional en menores de 5 anos,clasificacion d,2003-02-01,110,193,110,193,303
31003,VILLA TUNARI,estado nutricional en menores de 5 anos,clasificacion d,2003-02-01,128,91,128,91,219
11001,VILLA VACA GUZMAN (MUYUPAMPA),estado nutricional en menores de 5 anos,clasificacion d,2003-02-01,60,115,60,115,175
51501,VILLAZON,estado nutricional en menores de 5 anos,clasificacion d,2003-02-01,112,155,112,155,267
50602,VITICHI,estado nutricional en menores de 5 anos,clasificacion d,2003-02-01,98,147,98,147,245
20306,WALDO BALLIVIAN,estado nutricional en menores de 5 anos,clasificacion d,2003-02-01,6,4,6,4,10
70201,WARNES,estado nutricional en menores de 5 anos,clasificacion d,2003-02-01,88,63,88,63,151
20903,YACO,estado nutricional en menores de 5 anos,clasificacion d,2003-02-01,31,21,31,21,52
60301,YACUIBA,estado nutricional en menores de 5 anos,clasificacion d,2003-02-01,123,97,123,97,220
10602,YAMPARAEZ,estado nutricional en menores de 5 anos,clasificacion d,2003-02-01,149,280,149,280,429
21103,YANACACHI,estado nutricional en menores de 5 anos,clasificacion d,2003-02-01,6,4,6,4,10
70403,YAPACANI,estado nutricional en menores de 5 anos,clasificacion d,2003-02-01,141,91,141,91,232
50103,YOCALLA,estado nutricional en menores de 5 anos,clasificacion d,2003-02-01,39,66,39,66,105
10102,YOTALA,estado nutricional en menores de 5 anos,clasificacion d,2003-02-01,81,171,81,171,252
60402,YUNCHARA,estado nutricional en menores de 5 anos,clasificacion d,2003-02-01,19,25,19,25,44
10301,ZUDAÃ‘EZ,estado nutricional en menores de 5 anos,clasificacion d,2003-02-01,50,86,50,86,136
51302,ACACIO,estado nutricional en menores de 5 anos,clasificacion d,2003-03-01,52,68,52,68,120
20201,ACHACACHI,estado nutricional en menores de 5 anos,clasificacion d,2003-03-01,112,133,112,133,245
20104,ACHOCALLA,estado nutricional en menores de 5 anos,clasificacion d,2003-03-01,21,16,21,16,37
30201,AIQUILE,estado nutricional en menores de 5 anos,clasificacion d,2003-03-01,29,45,29,45,74
31303,ALALAY,estado nutricional en menores de 5 anos,clasificacion d,2003-03-01,9,13,9,13,22
10404,ALCALA,estado nutricional en menores de 5 anos,clasificacion d,2003-03-01,26,56,26,56,82
20202,ANCORAIMES,estado nutricional en menores de 5 anos,clasificacion d,2003-03-01,57,91,57,91,148
41201,ANDAMARCA,estado nutricional en menores de 5 anos,clasificacion d,2003-03-01,15,27,15,27,42
40603,ANTEQUERA,estado nutricional en menores de 5 anos,clasificacion d,2003-03-01,2,2,2,2,4
30402,ANZALDO,estado nutricional en menores de 5 anos,clasificacion d,2003-03-01,1,28,1,28,29
20701,APOLO,estado nutricional en menores de 5 anos,clasificacion d,2003-03-01,32,30,32,30,62
51301,ARAMPAMPA,estado nutricional en menores de 5 anos,clasificacion d,2003-03-01,37,83,37,83,120
30501,ARANI,estado nutricional en menores de 5 anos,clasificacion d,2003-03-01,7,25,7,25,32
30403,ARBIETO,estado nutricional en menores de 5 anos,clasificacion d,2003-03-01,3,6,3,6,9
30601,ARQUE,estado nutricional en menores de 5 anos,clasificacion d,2003-03-01,49,71,49,71,120
71501,ASCENCION DE GUARAYOS,estado nutricional en menores de 5 anos,clasificacion d,2003-03-01,1,1,1,1,2
50802,ATOCHA,estado nutricional en menores de 5 anos,clasificacion d,2003-03-01,18,135,18,135,153
20503,AUCAPATA,estado nutricional en menores de 5 anos,clasificacion d,2003-03-01,24,28,24,28,52
20502,AYATA,estado nutricional en menores de 5 anos,clasificacion d,2003-03-01,23,19,23,19,42
21303,AYO AYO,estado nutricional en menores de 5 anos,clasificacion d,2003-03-01,11,2,11,2,13
30301,AYOPAYA (V. DE INDEPENDENCIA),estado nutricional en menores de 5 anos,clasificacion d,2003-03-01,95,114,95,114,209
10201,AZURDUY,estado nutricional en menores de 5 anos,clasificacion d,2003-03-01,95,187,95,187,282
21203,BATALLAS,estado nutricional en menores de 5 anos,clasificacion d,2003-03-01,46,31,46,31,77
80802,BAURES,estado nutricional en menores de 5 anos,clasificacion d,2003-03-01,15,8,15,8,23
41202,BELEN DE ANDAMARCA,estado nutricional en menores de 5 anos,clasificacion d,2003-03-01,2,3,2,3,5
50104,BELEN DE URMIRI,estado nutricional en menores de 5 anos,clasificacion d,2003-03-01,3,8,3,8,11
90104,BELLA FLOR,estado nutricional en menores de 5 anos,clasificacion d,2003-03-01,7,12,7,12,19
60202,BERMEJO,estado nutricional en menores de 5 anos,clasificacion d,2003-03-01,7,13,7,13,20
50301,BETANZOS,estado nutricional en menores de 5 anos,clasificacion d,2003-03-01,248,313,248,313,561
31501,BOLIVAR,estado nutricional en menores de 5 anos,clasificacion d,2003-03-01,57,77,57,77,134
90103,BOLPEBRA,estado nutricional en menores de 5 anos,clasificacion d,2003-03-01,5,5,5,5,10
70707,BOYUIBE,estado nutricional en menores de 5 anos,clasificacion d,2003-03-01,10,8,10,8,18
70401,BUENA VISTA,estado nutricional en menores de 5 anos,clasificacion d,2003-03-01,35,43,35,43,78
70703,CABEZAS,estado nutricional en menores de 5 anos,clasificacion d,2003-03-01,15,9,15,9,24
20905,CAIROMA,estado nutricional en menores de 5 anos,clasificacion d,2003-03-01,18,20,18,20,38
51102,"CAIZA ""D""",estado nutricional en menores de 5 anos,clasificacion d,2003-03-01,126,118,126,118,244
21003,CAJUATA,estado nutricional en menores de 5 anos,clasificacion d,2003-03-01,16,11,16,11,27
20303,CALACOTO,estado nutricional en menores de 5 anos,clasificacion d,2003-03-01,8,7,8,7,15
21304,CALAMARCA,estado nutricional en menores de 5 anos,clasificacion d,2003-03-01,132,107,132,107,239
10701,CAMARGO,estado nutricional en menores de 5 anos,clasificacion d,2003-03-01,72,110,72,110,182
10901,CAMATAQUI (C. VILLA ABECIA),estado nutricional en menores de 5 anos,clasificacion d,2003-03-01,13,31,13,31,44
70706,CAMIRI,estado nutricional en menores de 5 anos,clasificacion d,2003-03-01,101,87,101,87,188
30701,CAPINOTA,estado nutricional en menores de 5 anos,clasificacion d,2003-03-01,26,76,26,76,102
20302,CAQUIAVIRI,estado nutricional en menores de 5 anos,clasificacion d,2003-03-01,21,33,21,33,54
40102,CARACOLLO,estado nutricional en menores de 5 anos,clasificacion d,2003-03-01,38,58,38,58,96
22001,CARANAVI,estado nutricional en menores de 5 anos,clasificacion d,2003-03-01,118,125,118,125,243
60302,CARAPARI,estado nutricional en menores de 5 anos,clasificacion d,2003-03-01,33,47,33,47,80
50702,CARIPUYO,estado nutricional en menores de 5 anos,clasificacion d,2003-03-01,45,57,45,57,102
40201,CHALLAPATA,estado nutricional en menores de 5 anos,clasificacion d,2003-03-01,41,80,41,80,121
50302,CHAQUI,estado nutricional en menores de 5 anos,clasificacion d,2003-03-01,77,74,77,74,151
70702,CHARAGUA,estado nutricional en menores de 5 anos,clasificacion d,2003-03-01,119,106,119,106,225
20305,CHARAÃ‘A,estado nutricional en menores de 5 anos,clasificacion d,2003-03-01,1,1,1,1,2
50202,CHAYANTA,estado nutricional en menores de 5 anos,clasificacion d,2003-03-01,44,35,44,35,79
31204,CHIMORE,estado nutricional en menores de 5 anos,clasificacion d,2003-03-01,17,21,17,21,38
40302,CHOQUE COTA,estado nutricional en menores de 5 anos,clasificacion d,2003-03-01,12,0,12,0,12
21101,CHULUMANI (V. DE LA LIBERTAD),estado nutricional en menores de 5 anos,clasificacion d,2003-03-01,17,19,17,19,36
20501,CHUMA,estado nutricional en menores de 5 anos,clasificacion d,2003-03-01,25,21,25,21,46
30801,CLIZA,estado nutricional en menores de 5 anos,clasificacion d,2003-03-01,7,13,7,13,20
90101,COBIJA,estado nutricional en menores de 5 anos,clasificacion d,2003-03-01,41,57,41,57,98
30101,COCHABAMBA,estado nutricional en menores de 5 anos,clasificacion d,2003-03-01,463,347,463,347,810
40902,COIPASA,estado nutricional en menores de 5 anos,clasificacion d,2003-03-01,0,3,0,3,3
30905,COLCAPIRHUA,estado nutricional en menores de 5 anos,clasificacion d,2003-03-01,15,16,15,16,31
50901,"COLCHA ""K""",estado nutricional en menores de 5 anos,clasificacion d,2003-03-01,38,50,38,50,88
21307,COLLANA,estado nutricional en menores de 5 anos,clasificacion d,2003-03-01,4,2,4,2,6
31002,COLOMI,estado nutricional en menores de 5 anos,clasificacion d,2003-03-01,49,55,49,55,104
50401,COLQUECHACA,estado nutricional en menores de 5 anos,clasificacion d,2003-03-01,134,56,134,56,190
21306,COLQUENCHA,estado nutricional en menores de 5 anos,clasificacion d,2003-03-01,26,12,26,12,38
21004,COLQUIRI,estado nutricional en menores de 5 anos,clasificacion d,2003-03-01,82,80,82,80,162
20304,COMANCHE,estado nutricional en menores de 5 anos,clasificacion d,2003-03-01,6,6,6,6,12
71301,COMARAPA,estado nutricional en menores de 5 anos,clasificacion d,2003-03-01,70,43,70,43,113
71101,CONCEPCION,estado nutricional en menores de 5 anos,clasificacion d,2003-03-01,6,5,6,5,11
21701,COPACABANA,estado nutricional en menores de 5 anos,clasificacion d,2003-03-01,34,30,34,30,64
21402,CORIPATA,estado nutricional en menores de 5 anos,clasificacion d,2003-03-01,6,7,6,7,13
20301,CORO CORO,estado nutricional en menores de 5 anos,clasificacion d,2003-03-01,36,31,36,31,67
21401,COROICO,estado nutricional en menores de 5 anos,clasificacion d,2003-03-01,19,20,19,20,39
40301,CORQUE,estado nutricional en menores de 5 anos,clasificacion d,2003-03-01,19,33,19,33,52
50601,COTAGAITA,estado nutricional en menores de 5 anos,clasificacion d,2003-03-01,84,98,84,98,182
70102,COTOCA,estado nutricional en menores de 5 anos,clasificacion d,2003-03-01,22,21,22,21,43
31405,CUCHUMUELA (V. G. VILLARROEL),estado nutricional en menores de 5 anos,clasificacion d,2003-03-01,1,3,1,3,4
70704,CUEVO,estado nutricional en menores de 5 anos,clasificacion d,2003-03-01,16,18,16,18,34
10902,CULPINA,estado nutricional en menores de 5 anos,clasificacion d,2003-03-01,154,159,154,159,313
40401,CURAHUARA DE CARANGAS,estado nutricional en menores de 5 anos,clasificacion d,2003-03-01,31,23,31,23,54
21602,CURVA,estado nutricional en menores de 5 anos,clasificacion d,2003-03-01,24,15,24,15,39
20804,DESAGUADERO,estado nutricional en menores de 5 anos,clasificacion d,2003-03-01,5,8,5,8,13
20105,EL ALTO,estado nutricional en menores de 5 anos,clasificacion d,2003-03-01,1407,850,1407,850,2257
40103,EL CHORO,estado nutricional en menores de 5 anos,clasificacion d,2003-03-01,7,6,7,6,13
71503,EL PUENTE(STC),estado nutricional en menores de 5 anos,clasificacion d,2003-03-01,26,128,26,128,154
60502,EL PUENTE(TJA),estado nutricional en menores de 5 anos,clasificacion d,2003-03-01,14,35,14,35,49
70105,EL TORNO,estado nutricional en menores de 5 anos,clasificacion d,2003-03-01,70,86,70,86,156
10405,EL VILLAR,estado nutricional en menores de 5 anos,clasificacion d,2003-03-01,47,133,47,133,180
60601,ENTRE RIOS,estado nutricional en menores de 5 anos,clasificacion d,2003-03-01,47,63,47,63,110
41101,EUCALIPTUS,estado nutricional en menores de 5 anos,clasificacion d,2003-03-01,11,13,11,13,24
90503,EUREKA (SANTOS MERCADO),estado nutricional en menores de 5 anos,clasificacion d,2003-03-01,1,0,1,0,1
80402,EXALTACION,estado nutricional en menores de 5 anos,clasificacion d,2003-03-01,0,13,0,13,13
90203,FILADELFIA,estado nutricional en menores de 5 anos,clasificacion d,2003-03-01,3,4,3,4,7
71002,GENERAL SAAVEDRA,estado nutricional en menores de 5 anos,clasificacion d,2003-03-01,76,123,76,123,199
21601,GRAL. J.J. PEREZ (CHARAZANI),estado nutricional en menores de 5 anos,clasificacion d,2003-03-01,18,26,18,26,44
20602,GUANAY,estado nutricional en menores de 5 anos,clasificacion d,2003-03-01,82,93,82,93,175
20802,GUAQUI,estado nutricional en menores de 5 anos,clasificacion d,2003-03-01,13,9,13,9,22
80202,GUAYARAMERIN,estado nutricional en menores de 5 anos,clasificacion d,2003-03-01,149,144,149,144,293
70705,GUTIERREZ,estado nutricional en menores de 5 anos,clasificacion d,2003-03-01,107,151,107,151,258
10502,HUACARETA,estado nutricional en menores de 5 anos,clasificacion d,2003-03-01,55,111,55,111,166
11002,HUACAYA (VILLA DE HUACAYA),estado nutricional en menores de 5 anos,clasificacion d,2003-03-01,11,16,11,16,27
40701,HUANUNI,estado nutricional en menores de 5 anos,clasificacion d,2003-03-01,80,76,80,76,156
80803,HUARACAJE,estado nutricional en menores de 5 anos,clasificacion d,2003-03-01,8,1,8,1,9
41601,HUAYLLAMARCA,estado nutricional en menores de 5 anos,clasificacion d,2003-03-01,10,11,10,11,21
21005,ICHOCA,estado nutricional en menores de 5 anos,clasificacion d,2003-03-01,20,29,20,29,49
10304,ICLA,estado nutricional en menores de 5 anos,clasificacion d,2003-03-01,115,167,115,167,282
10703,INCAHUASI,estado nutricional en menores de 5 anos,clasificacion d,2003-03-01,119,113,119,113,232
21001,INQUISIVI,estado nutricional en menores de 5 anos,clasificacion d,2003-03-01,67,92,67,92,159
21102,IRUPANA (VILLA DE LANZA),estado nutricional en menores de 5 anos,clasificacion d,2003-03-01,32,52,32,52,84
21501,IXIAMAS,estado nutricional en menores de 5 anos,clasificacion d,2003-03-01,21,24,21,24,45
21105,LA ASUNTA,estado nutricional en menores de 5 anos,clasificacion d,2003-03-01,52,32,52,32,84
70104,LA GUARDIA,estado nutricional en menores de 5 anos,clasificacion d,2003-03-01,55,32,55,32,87
20101,LA PAZ,estado nutricional en menores de 5 anos,clasificacion d,2003-03-01,1001,868,1001,868,1869
41501,LA RIVERA,estado nutricional en menores de 5 anos,clasificacion d,2003-03-01,0,3,0,3,3
70701,LAGUNILLAS,estado nutricional en menores de 5 anos,clasificacion d,2003-03-01,49,72,49,72,121
21202,LAJA,estado nutricional en menores de 5 anos,clasificacion d,2003-03-01,18,6,18,6,24
10903,LAS CARRERAS,estado nutricional en menores de 5 anos,clasificacion d,2003-03-01,23,34,23,34,57
21006,LICOMA PAMPA,estado nutricional en menores de 5 anos,clasificacion d,2003-03-01,11,5,11,5,16
50203,LLALLAGUA,estado nutricional en menores de 5 anos,clasificacion d,2003-03-01,16,219,16,219,235
51401,LLICA,estado nutricional en menores de 5 anos,clasificacion d,2003-03-01,17,9,17,9,26
80601,LORETO,estado nutricional en menores de 5 anos,clasificacion d,2003-03-01,13,9,13,9,22
20901,LURIBAY,estado nutricional en menores de 5 anos,clasificacion d,2003-03-01,29,11,29,11,40
40702,MACHACAMARCA,estado nutricional en menores de 5 anos,clasificacion d,2003-03-01,20,8,20,8,28
11003,MACHARETI,estado nutricional en menores de 5 anos,clasificacion d,2003-03-01,29,60,29,60,89
80801,MAGDALENA,estado nutricional en menores de 5 anos,clasificacion d,2003-03-01,26,31,26,31,57
70903,MAIRANA,estado nutricional en menores de 5 anos,clasificacion d,2003-03-01,24,24,24,24,48
20904,MALLA,estado nutricional en menores de 5 anos,clasificacion d,2003-03-01,1,5,1,5,6
20103,MECAPACA,estado nutricional en menores de 5 anos,clasificacion d,2003-03-01,10,31,10,31,41
71003,MINEROS,estado nutricional en menores de 5 anos,clasificacion d,2003-03-01,145,111,145,111,256
31301,MIZQUE,estado nutricional en menores de 5 anos,clasificacion d,2003-03-01,81,62,81,62,143
20402,MOCOMOCO,estado nutricional en menores de 5 anos,clasificacion d,2003-03-01,48,63,48,63,111
51002,MOJINETE,estado nutricional en menores de 5 anos,clasificacion d,2003-03-01,6,11,6,11,17
10303,MOJOCOYA,estado nutricional en menores de 5 anos,clasificacion d,2003-03-01,46,99,46,99,145
10501,MONTEAGUDO,estado nutricional en menores de 5 anos,clasificacion d,2003-03-01,129,165,129,165,294
71001,MONTERO,estado nutricional en menores de 5 anos,clasificacion d,2003-03-01,301,175,301,175,476
70803,MORO MORO,estado nutricional en menores de 5 anos,clasificacion d,2003-03-01,11,13,11,13,24
30302,MOROCHATA,estado nutricional en menores de 5 anos,clasificacion d,2003-03-01,97,106,97,106,203
90401,NACEBE (SANTA ROSA DEL ABUNA),estado nutricional en menores de 5 anos,clasificacion d,2003-03-01,4,2,4,2,6
20307,NAZACARA DE PACAJES,estado nutricional en menores de 5 anos,clasificacion d,2003-03-01,2,0,2,0,2
90501,NUEVO MANOA (NUEVA ESPERANZA),estado nutricional en menores de 5 anos,clasificacion d,2003-03-01,1,1,1,1,2
50404,OCURI,estado nutricional en menores de 5 anos,clasificacion d,2003-03-01,59,119,59,119,178
70202,OKINAWA,estado nutricional en menores de 5 anos,clasificacion d,2003-03-01,9,23,9,23,32
30203,OMEREQUE,estado nutricional en menores de 5 anos,clasificacion d,2003-03-01,0,26,0,26,26
40101,ORURO,estado nutricional en menores de 5 anos,clasificacion d,2003-03-01,503,514,503,514,1017
60201,PADCAYA,estado nutricional en menores de 5 anos,clasificacion d,2003-03-01,45,58,45,58,103
10401,PADILLA,estado nutricional en menores de 5 anos,clasificacion d,2003-03-01,103,215,103,215,318
70502,PAILON,estado nutricional en menores de 5 anos,clasificacion d,2003-03-01,29,24,29,24,53
20102,PALCA,estado nutricional en menores de 5 anos,clasificacion d,2003-03-01,35,24,35,24,59
21104,PALOS BLANCOS,estado nutricional en menores de 5 anos,clasificacion d,2003-03-01,69,108,69,108,177
40802,PAMPA AULLAGAS,estado nutricional en menores de 5 anos,clasificacion d,2003-03-01,11,24,11,24,35
70902,PAMPA GRANDE,estado nutricional en menores de 5 anos,clasificacion d,2003-03-01,11,10,11,10,21
21802,PAPEL PAMPA,estado nutricional en menores de 5 anos,clasificacion d,2003-03-01,7,8,7,8,15
30202,PASORAPA,estado nutricional en menores de 5 anos,clasificacion d,2003-03-01,4,11,4,11,15
21305,PATACAMAYA,estado nutricional en menores de 5 anos,clasificacion d,2003-03-01,52,44,52,44,96
40602,PAZÃ‘A,estado nutricional en menores de 5 anos,clasificacion d,2003-03-01,8,24,8,24,32
20702,PELECHUCO,estado nutricional en menores de 5 anos,clasificacion d,2003-03-01,16,19,16,19,35
50403,POCOATA,estado nutricional en menores de 5 anos,clasificacion d,2003-03-01,164,161,164,161,325
31203,POCONA,estado nutricional en menores de 5 anos,clasificacion d,2003-03-01,58,61,58,61,119
31202,POJO (CBBA),estado nutricional en menores de 5 anos,clasificacion d,2003-03-01,109,115,109,115,224
40601,POOPO,estado nutricional en menores de 5 anos,clasificacion d,2003-03-01,1,24,1,24,25
51203,PORCO,estado nutricional en menores de 5 anos,clasificacion d,2003-03-01,36,33,36,33,69
10103,POROMA,estado nutricional en menores de 5 anos,clasificacion d,2003-03-01,117,187,117,187,304
70103,PORONGO,estado nutricional en menores de 5 anos,clasificacion d,2003-03-01,15,15,15,15,30
70601,PORTACHUELO,estado nutricional en menores de 5 anos,clasificacion d,2003-03-01,54,46,54,46,100
90102,PORVENIR,estado nutricional en menores de 5 anos,clasificacion d,2003-03-01,4,2,4,2,6
70804,POSTRER VALLE,estado nutricional en menores de 5 anos,clasificacion d,2003-03-01,5,15,5,15,20
50101,POTOSI,estado nutricional en menores de 5 anos,clasificacion d,2003-03-01,504,363,504,363,867
10302,PRESTO,estado nutricional en menores de 5 anos,clasificacion d,2003-03-01,49,81,49,81,130
70805,PUCARA,estado nutricional en menores de 5 anos,clasificacion d,2003-03-01,2,6,2,6,8
21201,PUCARANI,estado nutricional en menores de 5 anos,clasificacion d,2003-03-01,20,31,20,31,51
20401,PUERTO ACOSTA,estado nutricional en menores de 5 anos,clasificacion d,2003-03-01,69,53,69,53,122
20403,PUERTO CARABUCO,estado nutricional en menores de 5 anos,clasificacion d,2003-03-01,47,63,47,63,110
90301,PUERTO GONZALO MORENO,estado nutricional en menores de 5 anos,clasificacion d,2003-03-01,9,6,9,6,15
21204,PUERTO PEREZ,estado nutricional en menores de 5 anos,clasificacion d,2003-03-01,11,2,11,2,13
71402,PUERTO QUIJARRO,estado nutricional en menores de 5 anos,clasificacion d,2003-03-01,36,24,36,24,60
90201,PUERTO RICO,estado nutricional en menores de 5 anos,clasificacion d,2003-03-01,2,19,2,19,21
71401,PUERTO SUAREZ,estado nutricional en menores de 5 anos,clasificacion d,2003-03-01,45,19,45,19,64
31205,PUERTO VILLARROEL,estado nutricional en menores de 5 anos,clasificacion d,2003-03-01,169,164,169,164,333
51101,PUNA,estado nutricional en menores de 5 anos,clasificacion d,2003-03-01,194,178,194,178,372
31401,PUNATA,estado nutricional en menores de 5 anos,clasificacion d,2003-03-01,112,37,112,37,149
30901,QUILLACOLLO,estado nutricional en menores de 5 anos,clasificacion d,2003-03-01,200,314,200,314,514
21002,QUIME,estado nutricional en menores de 5 anos,clasificacion d,2003-03-01,62,75,62,75,137
70904,QUIRUSILLAS,estado nutricional en menores de 5 anos,clasificacion d,2003-03-01,5,5,5,5,10
50402,RAVELO,estado nutricional en menores de 5 anos,clasificacion d,2003-03-01,175,166,175,166,341
80301,REYES,estado nutricional en menores de 5 anos,clasificacion d,2003-03-01,24,21,24,21,45
80201,RIBERALTA,estado nutricional en menores de 5 anos,clasificacion d,2003-03-01,288,236,288,236,524
70503,ROBORE,estado nutricional en menores de 5 anos,clasificacion d,2003-03-01,55,78,55,78,133
80304,RURRENABAQUE,estado nutricional en menores de 5 anos,clasificacion d,2003-03-01,13,10,13,10,23
40901,SABAYA,estado nutricional en menores de 5 anos,clasificacion d,2003-03-01,3,4,3,4,7
31001,SACABA,estado nutricional en menores de 5 anos,clasificacion d,2003-03-01,153,154,153,154,307
30404,SACABAMBA,estado nutricional en menores de 5 anos,clasificacion d,2003-03-01,12,29,12,29,41
50701,SACACA,estado nutricional en menores de 5 anos,clasificacion d,2003-03-01,173,286,173,286,459
71302,SAIPINA,estado nutricional en menores de 5 anos,clasificacion d,2003-03-01,15,15,15,15,30
40801,SALINAS DE GARCI MENDOZA,estado nutricional en menores de 5 anos,clasificacion d,2003-03-01,16,9,16,9,25
70901,SAMAIPATA,estado nutricional en menores de 5 anos,clasificacion d,2003-03-01,29,16,29,16,45
51601,SAN AGUSTIN,estado nutricional en menores de 5 anos,clasificacion d,2003-03-01,4,5,4,5,9
80602,SAN ANDRES,estado nutricional en menores de 5 anos,clasificacion d,2003-03-01,7,16,7,16,23
51003,SAN ANTONIO DE ESMORUCO,estado nutricional en menores de 5 anos,clasificacion d,2003-03-01,5,14,5,14,19
71105,SAN ANTONIO DE LOMERIO,estado nutricional en menores de 5 anos,clasificacion d,2003-03-01,82,115,82,115,197
31403,SAN BENITO,estado nutricional en menores de 5 anos,clasificacion d,2003-03-01,21,12,21,12,33
80302,SAN BORJA,estado nutricional en menores de 5 anos,clasificacion d,2003-03-01,114,55,114,55,169
21502,SAN BUENA VENTURA,estado nutricional en menores de 5 anos,clasificacion d,2003-03-01,27,23,27,23,50
70402,SAN CARLOS,estado nutricional en menores de 5 anos,clasificacion d,2003-03-01,75,57,75,57,132
80501,SAN IGNACIO,estado nutricional en menores de 5 anos,clasificacion d,2003-03-01,83,123,83,123,206
70301,SAN IGNACIO DE VELASCO,estado nutricional en menores de 5 anos,clasificacion d,2003-03-01,202,146,202,146,348
80102,SAN JAVIER(BNI),estado nutricional en menores de 5 anos,clasificacion d,2003-03-01,6,15,6,15,21
71102,SAN JAVIER(STC),estado nutricional en menores de 5 anos,clasificacion d,2003-03-01,31,48,31,48,79
80701,SAN JOAQUIN,estado nutricional en menores de 5 anos,clasificacion d,2003-03-01,5,11,5,11,16
70501,SAN JOSE DE CHIQUITOS,estado nutricional en menores de 5 anos,clasificacion d,2003-03-01,27,15,27,15,42
71104,SAN JULIAN,estado nutricional en menores de 5 anos,clasificacion d,2003-03-01,213,241,213,241,454
90302,SAN LORENZO(PND),estado nutricional en menores de 5 anos,clasificacion d,2003-03-01,29,44,29,44,73
60501,SAN LORENZO(TJA),estado nutricional en menores de 5 anos,clasificacion d,2003-03-01,42,67,42,67,109
10702,SAN LUCAS,estado nutricional en menores de 5 anos,clasificacion d,2003-03-01,393,429,393,429,822
70302,SAN MIGUEL DE VELASCO,estado nutricional en menores de 5 anos,clasificacion d,2003-03-01,59,58,59,58,117
51001,SAN PABLO DE LIPEZ,estado nutricional en menores de 5 anos,clasificacion d,2003-03-01,11,32,11,32,43
50501,SAN PEDRO DE BUENA VISTA,estado nutricional en menores de 5 anos,clasificacion d,2003-03-01,136,189,136,189,325
21801,SAN PEDRO DE CURAHUARA,estado nutricional en menores de 5 anos,clasificacion d,2003-03-01,14,19,14,19,33
50902,SAN PEDRO DE QUEMES,estado nutricional en menores de 5 anos,clasificacion d,2003-03-01,3,1,3,1,4
21702,SAN PEDRO DE TIQUINA,estado nutricional en menores de 5 anos,clasificacion d,2003-03-01,7,6,7,6,13
70303,SAN RAFAEL,estado nutricional en menores de 5 anos,clasificacion d,2003-03-01,41,53,41,53,94
80702,SAN RAMON,estado nutricional en menores de 5 anos,clasificacion d,2003-03-01,33,31,33,31,64
80702,SAN RAMON,estado nutricional en menores de 5 anos,clasificacion d,2003-03-01,1,4,1,4,5
80401,SANTA ANA,estado nutricional en menores de 5 anos,clasificacion d,2003-03-01,0,2,0,2,2
70101,SANTA CRUZ DE LA SIERRA,estado nutricional en menores de 5 anos,clasificacion d,2003-03-01,624,394,624,394,1018
80303,SANTA ROSA,estado nutricional en menores de 5 anos,clasificacion d,2003-03-01,13,3,13,3,16
70602,SANTA ROSA DEL SARA,estado nutricional en menores de 5 anos,clasificacion d,2003-03-01,12,16,12,16,28
20308,SANTIAGO DE CALLAPA,estado nutricional en menores de 5 anos,clasificacion d,2003-03-01,17,20,17,20,37
21901,SANTIAGO DE MACHACA,estado nutricional en menores de 5 anos,clasificacion d,2003-03-01,8,2,8,2,10
30702,SANTIVAÃ‘ES,estado nutricional en menores de 5 anos,clasificacion d,2003-03-01,21,19,21,19,40
40202,SANTUARIO DE QUILLACAS,estado nutricional en menores de 5 anos,clasificacion d,2003-03-01,11,9,11,9,20
20902,SAPAHAQUI,estado nutricional en menores de 5 anos,clasificacion d,2003-03-01,30,17,30,17,47
90303,SENA,estado nutricional en menores de 5 anos,clasificacion d,2003-03-01,1,14,1,14,15
21301,SICA SICA (VILLA AROMA),estado nutricional en menores de 5 anos,clasificacion d,2003-03-01,67,45,67,45,112
30703,SICAYA,estado nutricional en menores de 5 anos,clasificacion d,2003-03-01,8,2,8,2,10
30902,SIPE SIPE,estado nutricional en menores de 5 anos,clasificacion d,2003-03-01,125,66,125,66,191
10403,SOPACHUY,estado nutricional en menores de 5 anos,clasificacion d,2003-03-01,27,48,27,48,75
20601,SORATA,estado nutricional en menores de 5 anos,clasificacion d,2003-03-01,60,81,60,81,141
10101,SUCRE,estado nutricional en menores de 5 anos,clasificacion d,2003-03-01,485,569,485,569,1054
31404,TACACHI,estado nutricional en menores de 5 anos,clasificacion d,2003-03-01,9,4,9,4,13
50303,TACOBAMBA,estado nutricional en menores de 5 anos,clasificacion d,2003-03-01,71,61,71,61,132
30602,TACOPAYA,estado nutricional en menores de 5 anos,clasificacion d,2003-03-01,47,82,47,82,129
51402,TAHUA,estado nutricional en menores de 5 anos,clasificacion d,2003-03-01,6,6,6,6,12
31101,TAPACARI,estado nutricional en menores de 5 anos,clasificacion d,2003-03-01,79,74,79,74,153
10601,TARABUCO,estado nutricional en menores de 5 anos,clasificacion d,2003-03-01,247,390,247,390,637
30401,TARATA,estado nutricional en menores de 5 anos,clasificacion d,2003-03-01,32,15,32,15,47
60101,TARIJA,estado nutricional en menores de 5 anos,clasificacion d,2003-03-01,194,171,194,171,365
10202,TARVITA,estado nutricional en menores de 5 anos,clasificacion d,2003-03-01,114,145,114,145,259
20803,TIAWANACU,estado nutricional en menores de 5 anos,clasificacion d,2003-03-01,18,11,18,11,29
50102,TINGUIPAYA,estado nutricional en menores de 5 anos,clasificacion d,2003-03-01,48,89,48,89,137
20606,TIPUANI,estado nutricional en menores de 5 anos,clasificacion d,2003-03-01,9,9,9,9,18
30903,TIQUIPAYA,estado nutricional en menores de 5 anos,clasificacion d,2003-03-01,15,10,15,10,25
31601,TIRAQUE (CBBA),estado nutricional en menores de 5 anos,clasificacion d,2003-03-01,101,217,101,217,318
21703,TITO YUPANQUI (PARQUIPUJIO),estado nutricional en menores de 5 anos,clasificacion d,2003-03-01,6,10,6,10,16
30802,TOCO,estado nutricional en menores de 5 anos,clasificacion d,2003-03-01,6,9,6,9,15
41502,TODOS SANTOS,estado nutricional en menores de 5 anos,clasificacion d,2003-03-01,1,0,1,0,1
30803,TOLATA,estado nutricional en menores de 5 anos,clasificacion d,2003-03-01,7,8,7,8,15
41001,TOLEDO,estado nutricional en menores de 5 anos,clasificacion d,2003-03-01,12,8,12,8,20
51202,TOMAVE,estado nutricional en menores de 5 anos,clasificacion d,2003-03-01,57,104,57,104,161
10402,TOMINA,estado nutricional en menores de 5 anos,clasificacion d,2003-03-01,85,177,85,177,262
50502,TORO TORO,estado nutricional en menores de 5 anos,clasificacion d,2003-03-01,53,69,53,69,122
31201,TOTORA(CBBA),estado nutricional en menores de 5 anos,clasificacion d,2003-03-01,49,34,49,34,83
41301,TOTORA(ORR),estado nutricional en menores de 5 anos,clasificacion d,2003-03-01,13,24,13,24,37
70802,TRIGAL,estado nutricional en menores de 5 anos,clasificacion d,2003-03-01,7,6,7,6,13
80101,TRINIDAD,estado nutricional en menores de 5 anos,clasificacion d,2003-03-01,126,205,126,205,331
50801,TUPIZA,estado nutricional en menores de 5 anos,clasificacion d,2003-03-01,68,299,68,299,367
40402,TURCO,estado nutricional en menores de 5 anos,clasificacion d,2003-03-01,10,10,10,10,20
21302,UMALA,estado nutricional en menores de 5 anos,clasificacion d,2003-03-01,32,20,32,20,52
50201,UNCIA,estado nutricional en menores de 5 anos,clasificacion d,2003-03-01,7,38,7,38,45
60401,URIONDO (A. CONCEPCION),estado nutricional en menores de 5 anos,clasificacion d,2003-03-01,32,26,32,26,58
71502,URUBICHA,estado nutricional en menores de 5 anos,clasificacion d,2003-03-01,3,20,3,20,23
51201,UYUNI,estado nutricional en menores de 5 anos,clasificacion d,2003-03-01,94,85,94,85,179
30502,VACAS,estado nutricional en menores de 5 anos,clasificacion d,2003-03-01,16,6,16,6,22
70801,VALLEGRANDE,estado nutricional en menores de 5 anos,clasificacion d,2003-03-01,70,88,70,88,158
20801,VIACHA,estado nutricional en menores de 5 anos,clasificacion d,2003-03-01,78,74,78,74,152
31302,VILA VILA,estado nutricional en menores de 5 anos,clasificacion d,2003-03-01,12,20,12,20,32
60303,VILLA MONTES,estado nutricional en menores de 5 anos,clasificacion d,2003-03-01,73,76,73,76,149
90502,VILLA NUEVA (LOMA ALTA),estado nutricional en menores de 5 anos,clasificacion d,2003-03-01,1,0,1,0,1
31402,VILLA RIVERO,estado nutricional en menores de 5 anos,clasificacion d,2003-03-01,16,13,16,13,29
10801,VILLA SERRANO,estado nutricional en menores de 5 anos,clasificacion d,2003-03-01,98,178,98,178,276
31003,VILLA TUNARI,estado nutricional en menores de 5 anos,clasificacion d,2003-03-01,97,77,97,77,174
11001,VILLA VACA GUZMAN (MUYUPAMPA),estado nutricional en menores de 5 anos,clasificacion d,2003-03-01,54,81,54,81,135
51501,VILLAZON,estado nutricional en menores de 5 anos,clasificacion d,2003-03-01,81,142,81,142,223
50602,VITICHI,estado nutricional en menores de 5 anos,clasificacion d,2003-03-01,85,101,85,101,186
20306,WALDO BALLIVIAN,estado nutricional en menores de 5 anos,clasificacion d,2003-03-01,6,1,6,1,7
70201,WARNES,estado nutricional en menores de 5 anos,clasificacion d,2003-03-01,92,113,92,113,205
20903,YACO,estado nutricional en menores de 5 anos,clasificacion d,2003-03-01,13,7,13,7,20
60301,YACUIBA,estado nutricional en menores de 5 anos,clasificacion d,2003-03-01,110,84,110,84,194
10602,YAMPARAEZ,estado nutricional en menores de 5 anos,clasificacion d,2003-03-01,134,273,134,273,407
21103,YANACACHI,estado nutricional en menores de 5 anos,clasificacion d,2003-03-01,14,17,14,17,31
70403,YAPACANI,estado nutricional en menores de 5 anos,clasificacion d,2003-03-01,146,108,146,108,254
50103,YOCALLA,estado nutricional en menores de 5 anos,clasificacion d,2003-03-01,40,33,40,33,73
10102,YOTALA,estado nutricional en menores de 5 anos,clasificacion d,2003-03-01,86,151,86,151,237
60402,YUNCHARA,estado nutricional en menores de 5 anos,clasificacion d,2003-03-01,5,14,5,14,19
10301,ZUDAÃ‘EZ,estado nutricional en menores de 5 anos,clasificacion d,2003-03-01,49,94,49,94,143
51302,ACACIO,estado nutricional en menores de 5 anos,clasificacion d,2003-04-01,57,96,57,96,153
20201,ACHACACHI,estado nutricional en menores de 5 anos,clasificacion d,2003-04-01,108,86,108,86,194
20104,ACHOCALLA,estado nutricional en menores de 5 anos,clasificacion d,2003-04-01,23,17,23,17,40
30201,AIQUILE,estado nutricional en menores de 5 anos,clasificacion d,2003-04-01,68,56,68,56,124
31303,ALALAY,estado nutricional en menores de 5 anos,clasificacion d,2003-04-01,11,14,11,14,25
10404,ALCALA,estado nutricional en menores de 5 anos,clasificacion d,2003-04-01,35,83,35,83,118
20202,ANCORAIMES,estado nutricional en menores de 5 anos,clasificacion d,2003-04-01,39,46,39,46,85
41201,ANDAMARCA,estado nutricional en menores de 5 anos,clasificacion d,2003-04-01,4,11,4,11,15
40603,ANTEQUERA,estado nutricional en menores de 5 anos,clasificacion d,2003-04-01,2,5,2,5,7
30402,ANZALDO,estado nutricional en menores de 5 anos,clasificacion d,2003-04-01,25,64,25,64,89
20701,APOLO,estado nutricional en menores de 5 anos,clasificacion d,2003-04-01,29,25,29,25,54
51301,ARAMPAMPA,estado nutricional en menores de 5 anos,clasificacion d,2003-04-01,36,66,36,66,102
30501,ARANI,estado nutricional en menores de 5 anos,clasificacion d,2003-04-01,8,86,8,86,94
30403,ARBIETO,estado nutricional en menores de 5 anos,clasificacion d,2003-04-01,18,10,18,10,28
30601,ARQUE,estado nutricional en menores de 5 anos,clasificacion d,2003-04-01,35,43,35,43,78
71501,ASCENCION DE GUARAYOS,estado nutricional en menores de 5 anos,clasificacion d,2003-04-01,154,274,154,274,428
50802,ATOCHA,estado nutricional en menores de 5 anos,clasificacion d,2003-04-01,33,210,33,210,243
20503,AUCAPATA,estado nutricional en menores de 5 anos,clasificacion d,2003-04-01,25,41,25,41,66
20502,AYATA,estado nutricional en menores de 5 anos,clasificacion d,2003-04-01,40,17,40,17,57
21303,AYO AYO,estado nutricional en menores de 5 anos,clasificacion d,2003-04-01,9,10,9,10,19
30301,AYOPAYA (V. DE INDEPENDENCIA),estado nutricional en menores de 5 anos,clasificacion d,2003-04-01,70,126,70,126,196
10201,AZURDUY,estado nutricional en menores de 5 anos,clasificacion d,2003-04-01,128,169,128,169,297
21203,BATALLAS,estado nutricional en menores de 5 anos,clasificacion d,2003-04-01,38,25,38,25,63
80802,BAURES,estado nutricional en menores de 5 anos,clasificacion d,2003-04-01,31,26,31,26,57
41202,BELEN DE ANDAMARCA,estado nutricional en menores de 5 anos,clasificacion d,2003-04-01,1,3,1,3,4
50104,BELEN DE URMIRI,estado nutricional en menores de 5 anos,clasificacion d,2003-04-01,5,14,5,14,19
90104,BELLA FLOR,estado nutricional en menores de 5 anos,clasificacion d,2003-04-01,15,26,15,26,41
60202,BERMEJO,estado nutricional en menores de 5 anos,clasificacion d,2003-04-01,8,3,8,3,11
50301,BETANZOS,estado nutricional en menores de 5 anos,clasificacion d,2003-04-01,253,221,253,221,474
31501,BOLIVAR,estado nutricional en menores de 5 anos,clasificacion d,2003-04-01,67,111,67,111,178
90103,BOLPEBRA,estado nutricional en menores de 5 anos,clasificacion d,2003-04-01,3,13,3,13,16
70707,BOYUIBE,estado nutricional en menores de 5 anos,clasificacion d,2003-04-01,10,17,10,17,27
70401,BUENA VISTA,estado nutricional en menores de 5 anos,clasificacion d,2003-04-01,63,61,63,61,124
70703,CABEZAS,estado nutricional en menores de 5 anos,clasificacion d,2003-04-01,37,18,37,18,55
20905,CAIROMA,estado nutricional en menores de 5 anos,clasificacion d,2003-04-01,41,37,41,37,78
51102,"CAIZA ""D""",estado nutricional en menores de 5 anos,clasificacion d,2003-04-01,65,74,65,74,139
21003,CAJUATA,estado nutricional en menores de 5 anos,clasificacion d,2003-04-01,36,23,36,23,59
20303,CALACOTO,estado nutricional en menores de 5 anos,clasificacion d,2003-04-01,11,10,11,10,21
21304,CALAMARCA,estado nutricional en menores de 5 anos,clasificacion d,2003-04-01,152,109,152,109,261
10701,CAMARGO,estado nutricional en menores de 5 anos,clasificacion d,2003-04-01,70,101,70,101,171
10901,CAMATAQUI (C. VILLA ABECIA),estado nutricional en menores de 5 anos,clasificacion d,2003-04-01,23,53,23,53,76
70706,CAMIRI,estado nutricional en menores de 5 anos,clasificacion d,2003-04-01,183,165,183,165,348
30701,CAPINOTA,estado nutricional en menores de 5 anos,clasificacion d,2003-04-01,32,31,32,31,63
20302,CAQUIAVIRI,estado nutricional en menores de 5 anos,clasificacion d,2003-04-01,19,36,19,36,55
40102,CARACOLLO,estado nutricional en menores de 5 anos,clasificacion d,2003-04-01,78,74,78,74,152
22001,CARANAVI,estado nutricional en menores de 5 anos,clasificacion d,2003-04-01,128,94,128,94,222
41503,CARANGAS,estado nutricional en menores de 5 anos,clasificacion d,2003-04-01,0,2,0,2,2
60302,CARAPARI,estado nutricional en menores de 5 anos,clasificacion d,2003-04-01,27,41,27,41,68
50702,CARIPUYO,estado nutricional en menores de 5 anos,clasificacion d,2003-04-01,62,125,62,125,187
21902,CATACORA,estado nutricional en menores de 5 anos,clasificacion d,2003-04-01,1,1,1,1,2
40201,CHALLAPATA,estado nutricional en menores de 5 anos,clasificacion d,2003-04-01,63,110,63,110,173
50302,CHAQUI,estado nutricional en menores de 5 anos,clasificacion d,2003-04-01,51,73,51,73,124
70702,CHARAGUA,estado nutricional en menores de 5 anos,clasificacion d,2003-04-01,116,137,116,137,253
20305,CHARAÃ‘A,estado nutricional en menores de 5 anos,clasificacion d,2003-04-01,8,22,8,22,30
50202,CHAYANTA,estado nutricional en menores de 5 anos,clasificacion d,2003-04-01,56,32,56,32,88
31204,CHIMORE,estado nutricional en menores de 5 anos,clasificacion d,2003-04-01,35,31,35,31,66
40903,CHIPAYA,estado nutricional en menores de 5 anos,clasificacion d,2003-04-01,0,9,0,9,9
40302,CHOQUE COTA,estado nutricional en menores de 5 anos,clasificacion d,2003-04-01,9,13,9,13,22
21101,CHULUMANI (V. DE LA LIBERTAD),estado nutricional en menores de 5 anos,clasificacion d,2003-04-01,31,8,31,8,39
20501,CHUMA,estado nutricional en menores de 5 anos,clasificacion d,2003-04-01,46,37,46,37,83
30801,CLIZA,estado nutricional en menores de 5 anos,clasificacion d,2003-04-01,23,21,23,21,44
90101,COBIJA,estado nutricional en menores de 5 anos,clasificacion d,2003-04-01,45,21,45,21,66
30101,COCHABAMBA,estado nutricional en menores de 5 anos,clasificacion d,2003-04-01,673,480,673,480,1153
40902,COIPASA,estado nutricional en menores de 5 anos,clasificacion d,2003-04-01,0,1,0,1,1
30905,COLCAPIRHUA,estado nutricional en menores de 5 anos,clasificacion d,2003-04-01,5,8,5,8,13
50901,"COLCHA ""K""",estado nutricional en menores de 5 anos,clasificacion d,2003-04-01,49,66,49,66,115
21307,COLLANA,estado nutricional en menores de 5 anos,clasificacion d,2003-04-01,1,0,1,0,1
31002,COLOMI,estado nutricional en menores de 5 anos,clasificacion d,2003-04-01,76,75,76,75,151
50401,COLQUECHACA,estado nutricional en menores de 5 anos,clasificacion d,2003-04-01,152,87,152,87,239
21306,COLQUENCHA,estado nutricional en menores de 5 anos,clasificacion d,2003-04-01,22,16,22,16,38
21004,COLQUIRI,estado nutricional en menores de 5 anos,clasificacion d,2003-04-01,96,82,96,82,178
20304,COMANCHE,estado nutricional en menores de 5 anos,clasificacion d,2003-04-01,2,11,2,11,13
71301,COMARAPA,estado nutricional en menores de 5 anos,clasificacion d,2003-04-01,61,44,61,44,105
20605,COMBAYA,estado nutricional en menores de 5 anos,clasificacion d,2003-04-01,9,11,9,11,20
71101,CONCEPCION,estado nutricional en menores de 5 anos,clasificacion d,2003-04-01,8,55,8,55,63
21701,COPACABANA,estado nutricional en menores de 5 anos,clasificacion d,2003-04-01,30,37,30,37,67
21402,CORIPATA,estado nutricional en menores de 5 anos,clasificacion d,2003-04-01,4,0,4,0,4
20301,CORO CORO,estado nutricional en menores de 5 anos,clasificacion d,2003-04-01,32,33,32,33,65
21401,COROICO,estado nutricional en menores de 5 anos,clasificacion d,2003-04-01,29,21,29,21,50
40301,CORQUE,estado nutricional en menores de 5 anos,clasificacion d,2003-04-01,31,19,31,19,50
50601,COTAGAITA,estado nutricional en menores de 5 anos,clasificacion d,2003-04-01,118,201,118,201,319
70102,COTOCA,estado nutricional en menores de 5 anos,clasificacion d,2003-04-01,48,23,48,23,71
31405,CUCHUMUELA (V. G. VILLARROEL),estado nutricional en menores de 5 anos,clasificacion d,2003-04-01,5,4,5,4,9
70704,CUEVO,estado nutricional en menores de 5 anos,clasificacion d,2003-04-01,12,7,12,7,19
10902,CULPINA,estado nutricional en menores de 5 anos,clasificacion d,2003-04-01,220,185,220,185,405
40401,CURAHUARA DE CARANGAS,estado nutricional en menores de 5 anos,clasificacion d,2003-04-01,17,9,17,9,26
21602,CURVA,estado nutricional en menores de 5 anos,clasificacion d,2003-04-01,16,13,16,13,29
20804,DESAGUADERO,estado nutricional en menores de 5 anos,clasificacion d,2003-04-01,15,15,15,15,30
20105,EL ALTO,estado nutricional en menores de 5 anos,clasificacion d,2003-04-01,2238,1542,2238,1542,3780
40103,EL CHORO,estado nutricional en menores de 5 anos,clasificacion d,2003-04-01,9,2,9,2,11
71503,EL PUENTE(STC),estado nutricional en menores de 5 anos,clasificacion d,2003-04-01,12,77,12,77,89
60502,EL PUENTE(TJA),estado nutricional en menores de 5 anos,clasificacion d,2003-04-01,27,55,27,55,82
70105,EL TORNO,estado nutricional en menores de 5 anos,clasificacion d,2003-04-01,57,39,57,39,96
10405,EL VILLAR,estado nutricional en menores de 5 anos,clasificacion d,2003-04-01,45,133,45,133,178
60601,ENTRE RIOS,estado nutricional en menores de 5 anos,clasificacion d,2003-04-01,25,57,25,57,82
41101,EUCALIPTUS,estado nutricional en menores de 5 anos,clasificacion d,2003-04-01,26,28,26,28,54
80402,EXALTACION,estado nutricional en menores de 5 anos,clasificacion d,2003-04-01,11,25,11,25,36
90203,FILADELFIA,estado nutricional en menores de 5 anos,clasificacion d,2003-04-01,4,9,4,9,13
71002,GENERAL SAAVEDRA,estado nutricional en menores de 5 anos,clasificacion d,2003-04-01,90,106,90,106,196
21601,GRAL. J.J. PEREZ (CHARAZANI),estado nutricional en menores de 5 anos,clasificacion d,2003-04-01,23,32,23,32,55
20602,GUANAY,estado nutricional en menores de 5 anos,clasificacion d,2003-04-01,82,83,82,83,165
20802,GUAQUI,estado nutricional en menores de 5 anos,clasificacion d,2003-04-01,14,3,14,3,17
80202,GUAYARAMERIN,estado nutricional en menores de 5 anos,clasificacion d,2003-04-01,146,89,146,89,235
70705,GUTIERREZ,estado nutricional en menores de 5 anos,clasificacion d,2003-04-01,92,148,92,148,240
10502,HUACARETA,estado nutricional en menores de 5 anos,clasificacion d,2003-04-01,59,74,59,74,133
11002,HUACAYA (VILLA DE HUACAYA),estado nutricional en menores de 5 anos,clasificacion d,2003-04-01,8,15,8,15,23
40501,HUACHACALLA,estado nutricional en menores de 5 anos,clasificacion d,2003-04-01,0,3,0,3,3
40701,HUANUNI,estado nutricional en menores de 5 anos,clasificacion d,2003-04-01,61,48,61,48,109
80803,HUARACAJE,estado nutricional en menores de 5 anos,clasificacion d,2003-04-01,9,8,9,8,17
41601,HUAYLLAMARCA,estado nutricional en menores de 5 anos,clasificacion d,2003-04-01,13,16,13,16,29
21005,ICHOCA,estado nutricional en menores de 5 anos,clasificacion d,2003-04-01,15,15,15,15,30
10304,ICLA,estado nutricional en menores de 5 anos,clasificacion d,2003-04-01,107,199,107,199,306
10703,INCAHUASI,estado nutricional en menores de 5 anos,clasificacion d,2003-04-01,210,201,210,201,411
21001,INQUISIVI,estado nutricional en menores de 5 anos,clasificacion d,2003-04-01,67,81,67,81,148
21102,IRUPANA (VILLA DE LANZA),estado nutricional en menores de 5 anos,clasificacion d,2003-04-01,20,71,20,71,91
21501,IXIAMAS,estado nutricional en menores de 5 anos,clasificacion d,2003-04-01,30,38,30,38,68
21105,LA ASUNTA,estado nutricional en menores de 5 anos,clasificacion d,2003-04-01,36,26,36,26,62
70104,LA GUARDIA,estado nutricional en menores de 5 anos,clasificacion d,2003-04-01,78,58,78,58,136
20101,LA PAZ,estado nutricional en menores de 5 anos,clasificacion d,2003-04-01,1404,1286,1404,1286,2690
41501,LA RIVERA,estado nutricional en menores de 5 anos,clasificacion d,2003-04-01,0,2,0,2,2
70701,LAGUNILLAS,estado nutricional en menores de 5 anos,clasificacion d,2003-04-01,45,64,45,64,109
21202,LAJA,estado nutricional en menores de 5 anos,clasificacion d,2003-04-01,19,13,19,13,32
10903,LAS CARRERAS,estado nutricional en menores de 5 anos,clasificacion d,2003-04-01,20,61,20,61,81
21006,LICOMA PAMPA,estado nutricional en menores de 5 anos,clasificacion d,2003-04-01,9,18,9,18,27
50203,LLALLAGUA,estado nutricional en menores de 5 anos,clasificacion d,2003-04-01,6,224,6,224,230
51401,LLICA,estado nutricional en menores de 5 anos,clasificacion d,2003-04-01,19,17,19,17,36
80601,LORETO,estado nutricional en menores de 5 anos,clasificacion d,2003-04-01,9,10,9,10,19
20901,LURIBAY,estado nutricional en menores de 5 anos,clasificacion d,2003-04-01,83,52,83,52,135
40702,MACHACAMARCA,estado nutricional en menores de 5 anos,clasificacion d,2003-04-01,16,26,16,26,42
11003,MACHARETI,estado nutricional en menores de 5 anos,clasificacion d,2003-04-01,36,106,36,106,142
80801,MAGDALENA,estado nutricional en menores de 5 anos,clasificacion d,2003-04-01,27,22,27,22,49
70903,MAIRANA,estado nutricional en menores de 5 anos,clasificacion d,2003-04-01,26,22,26,22,48
20904,MALLA,estado nutricional en menores de 5 anos,clasificacion d,2003-04-01,1,2,1,2,3
20103,MECAPACA,estado nutricional en menores de 5 anos,clasificacion d,2003-04-01,13,29,13,29,42
71003,MINEROS,estado nutricional en menores de 5 anos,clasificacion d,2003-04-01,144,88,144,88,232
31301,MIZQUE,estado nutricional en menores de 5 anos,clasificacion d,2003-04-01,39,58,39,58,97
20402,MOCOMOCO,estado nutricional en menores de 5 anos,clasificacion d,2003-04-01,69,57,69,57,126
51002,MOJINETE,estado nutricional en menores de 5 anos,clasificacion d,2003-04-01,2,31,2,31,33
10303,MOJOCOYA,estado nutricional en menores de 5 anos,clasificacion d,2003-04-01,58,97,58,97,155
10501,MONTEAGUDO,estado nutricional en menores de 5 anos,clasificacion d,2003-04-01,132,200,132,200,332
71001,MONTERO,estado nutricional en menores de 5 anos,clasificacion d,2003-04-01,361,222,361,222,583
70803,MORO MORO,estado nutricional en menores de 5 anos,clasificacion d,2003-04-01,22,29,22,29,51
30302,MOROCHATA,estado nutricional en menores de 5 anos,clasificacion d,2003-04-01,156,174,156,174,330
90401,NACEBE (SANTA ROSA DEL ABUNA),estado nutricional en menores de 5 anos,clasificacion d,2003-04-01,3,7,3,7,10
20307,NAZACARA DE PACAJES,estado nutricional en menores de 5 anos,clasificacion d,2003-04-01,3,2,3,2,5
90501,NUEVO MANOA (NUEVA ESPERANZA),estado nutricional en menores de 5 anos,clasificacion d,2003-04-01,2,3,2,3,5
50404,OCURI,estado nutricional en menores de 5 anos,clasificacion d,2003-04-01,76,116,76,116,192
70202,OKINAWA,estado nutricional en menores de 5 anos,clasificacion d,2003-04-01,15,30,15,30,45
30203,OMEREQUE,estado nutricional en menores de 5 anos,clasificacion d,2003-04-01,15,17,15,17,32
40101,ORURO,estado nutricional en menores de 5 anos,clasificacion d,2003-04-01,563,702,563,702,1265
60201,PADCAYA,estado nutricional en menores de 5 anos,clasificacion d,2003-04-01,60,56,60,56,116
10401,PADILLA,estado nutricional en menores de 5 anos,clasificacion d,2003-04-01,126,221,126,221,347
70502,PAILON,estado nutricional en menores de 5 anos,clasificacion d,2003-04-01,26,28,26,28,54
20102,PALCA,estado nutricional en menores de 5 anos,clasificacion d,2003-04-01,44,49,44,49,93
21104,PALOS BLANCOS,estado nutricional en menores de 5 anos,clasificacion d,2003-04-01,68,113,68,113,181
40802,PAMPA AULLAGAS,estado nutricional en menores de 5 anos,clasificacion d,2003-04-01,11,19,11,19,30
70902,PAMPA GRANDE,estado nutricional en menores de 5 anos,clasificacion d,2003-04-01,14,12,14,12,26
21802,PAPEL PAMPA,estado nutricional en menores de 5 anos,clasificacion d,2003-04-01,14,13,14,13,27
30202,PASORAPA,estado nutricional en menores de 5 anos,clasificacion d,2003-04-01,15,26,15,26,41
21305,PATACAMAYA,estado nutricional en menores de 5 anos,clasificacion d,2003-04-01,107,52,107,52,159
40602,PAZÃ‘A,estado nutricional en menores de 5 anos,clasificacion d,2003-04-01,3,24,3,24,27
20702,PELECHUCO,estado nutricional en menores de 5 anos,clasificacion d,2003-04-01,34,37,34,37,71
50403,POCOATA,estado nutricional en menores de 5 anos,clasificacion d,2003-04-01,211,186,211,186,397
31203,POCONA,estado nutricional en menores de 5 anos,clasificacion d,2003-04-01,26,34,26,34,60
31202,POJO (CBBA),estado nutricional en menores de 5 anos,clasificacion d,2003-04-01,156,129,156,129,285
40601,POOPO,estado nutricional en menores de 5 anos,clasificacion d,2003-04-01,7,17,7,17,24
51203,PORCO,estado nutricional en menores de 5 anos,clasificacion d,2003-04-01,19,12,19,12,31
10103,POROMA,estado nutricional en menores de 5 anos,clasificacion d,2003-04-01,135,188,135,188,323
70103,PORONGO,estado nutricional en menores de 5 anos,clasificacion d,2003-04-01,18,20,18,20,38
70601,PORTACHUELO,estado nutricional en menores de 5 anos,clasificacion d,2003-04-01,62,47,62,47,109
90102,PORVENIR,estado nutricional en menores de 5 anos,clasificacion d,2003-04-01,15,10,15,10,25
70804,POSTRER VALLE,estado nutricional en menores de 5 anos,clasificacion d,2003-04-01,4,9,4,9,13
50101,POTOSI,estado nutricional en menores de 5 anos,clasificacion d,2003-04-01,728,482,728,482,1210
10302,PRESTO,estado nutricional en menores de 5 anos,clasificacion d,2003-04-01,67,105,67,105,172
70805,PUCARA,estado nutricional en menores de 5 anos,clasificacion d,2003-04-01,2,3,2,3,5
21201,PUCARANI,estado nutricional en menores de 5 anos,clasificacion d,2003-04-01,26,31,26,31,57
20401,PUERTO ACOSTA,estado nutricional en menores de 5 anos,clasificacion d,2003-04-01,74,58,74,58,132
20403,PUERTO CARABUCO,estado nutricional en menores de 5 anos,clasificacion d,2003-04-01,38,61,38,61,99
90301,PUERTO GONZALO MORENO,estado nutricional en menores de 5 anos,clasificacion d,2003-04-01,26,65,26,65,91
21204,PUERTO PEREZ,estado nutricional en menores de 5 anos,clasificacion d,2003-04-01,21,8,21,8,29
71402,PUERTO QUIJARRO,estado nutricional en menores de 5 anos,clasificacion d,2003-04-01,36,16,36,16,52
90201,PUERTO RICO,estado nutricional en menores de 5 anos,clasificacion d,2003-04-01,0,48,0,48,48
80703,PUERTO SILES,estado nutricional en menores de 5 anos,clasificacion d,2003-04-01,1,1,1,1,2
71401,PUERTO SUAREZ,estado nutricional en menores de 5 anos,clasificacion d,2003-04-01,39,26,39,26,65
31205,PUERTO VILLARROEL,estado nutricional en menores de 5 anos,clasificacion d,2003-04-01,248,183,248,183,431
51101,PUNA,estado nutricional en menores de 5 anos,clasificacion d,2003-04-01,75,109,75,109,184
31401,PUNATA,estado nutricional en menores de 5 anos,clasificacion d,2003-04-01,114,47,114,47,161
20604,QUIABAYA,estado nutricional en menores de 5 anos,clasificacion d,2003-04-01,13,26,13,26,39
30901,QUILLACOLLO,estado nutricional en menores de 5 anos,clasificacion d,2003-04-01,112,130,112,130,242
21002,QUIME,estado nutricional en menores de 5 anos,clasificacion d,2003-04-01,88,87,88,87,175
70904,QUIRUSILLAS,estado nutricional en menores de 5 anos,clasificacion d,2003-04-01,6,6,6,6,12
50402,RAVELO,estado nutricional en menores de 5 anos,clasificacion d,2003-04-01,163,197,163,197,360
80301,REYES,estado nutricional en menores de 5 anos,clasificacion d,2003-04-01,29,48,29,48,77
80201,RIBERALTA,estado nutricional en menores de 5 anos,clasificacion d,2003-04-01,340,276,340,276,616
70503,ROBORE,estado nutricional en menores de 5 anos,clasificacion d,2003-04-01,36,43,36,43,79
80304,RURRENABAQUE,estado nutricional en menores de 5 anos,clasificacion d,2003-04-01,14,5,14,5,19
40901,SABAYA,estado nutricional en menores de 5 anos,clasificacion d,2003-04-01,4,6,4,6,10
31001,SACABA,estado nutricional en menores de 5 anos,clasificacion d,2003-04-01,114,155,114,155,269
30404,SACABAMBA,estado nutricional en menores de 5 anos,clasificacion d,2003-04-01,1,17,1,17,18
50701,SACACA,estado nutricional en menores de 5 anos,clasificacion d,2003-04-01,170,349,170,349,519
71302,SAIPINA,estado nutricional en menores de 5 anos,clasificacion d,2003-04-01,6,17,6,17,23
40801,SALINAS DE GARCI MENDOZA,estado nutricional en menores de 5 anos,clasificacion d,2003-04-01,16,13,16,13,29
70901,SAMAIPATA,estado nutricional en menores de 5 anos,clasificacion d,2003-04-01,27,23,27,23,50
51601,SAN AGUSTIN,estado nutricional en menores de 5 anos,clasificacion d,2003-04-01,10,2,10,2,12
80602,SAN ANDRES,estado nutricional en menores de 5 anos,clasificacion d,2003-04-01,27,36,27,36,63
51003,SAN ANTONIO DE ESMORUCO,estado nutricional en menores de 5 anos,clasificacion d,2003-04-01,1,10,1,10,11
71105,SAN ANTONIO DE LOMERIO,estado nutricional en menores de 5 anos,clasificacion d,2003-04-01,69,95,69,95,164
31403,SAN BENITO,estado nutricional en menores de 5 anos,clasificacion d,2003-04-01,11,37,11,37,48
80302,SAN BORJA,estado nutricional en menores de 5 anos,clasificacion d,2003-04-01,154,110,154,110,264
21502,SAN BUENA VENTURA,estado nutricional en menores de 5 anos,clasificacion d,2003-04-01,37,32,37,32,69
70402,SAN CARLOS,estado nutricional en menores de 5 anos,clasificacion d,2003-04-01,48,80,48,80,128
80501,SAN IGNACIO,estado nutricional en menores de 5 anos,clasificacion d,2003-04-01,111,107,111,107,218
70301,SAN IGNACIO DE VELASCO,estado nutricional en menores de 5 anos,clasificacion d,2003-04-01,193,162,193,162,355
80102,SAN JAVIER(BNI),estado nutricional en menores de 5 anos,clasificacion d,2003-04-01,7,10,7,10,17
71102,SAN JAVIER(STC),estado nutricional en menores de 5 anos,clasificacion d,2003-04-01,35,51,35,51,86
80701,SAN JOAQUIN,estado nutricional en menores de 5 anos,clasificacion d,2003-04-01,4,9,4,9,13
70501,SAN JOSE DE CHIQUITOS,estado nutricional en menores de 5 anos,clasificacion d,2003-04-01,46,24,46,24,70
71104,SAN JULIAN,estado nutricional en menores de 5 anos,clasificacion d,2003-04-01,108,206,108,206,314
90302,SAN LORENZO(PND),estado nutricional en menores de 5 anos,clasificacion d,2003-04-01,7,6,7,6,13
60501,SAN LORENZO(TJA),estado nutricional en menores de 5 anos,clasificacion d,2003-04-01,60,101,60,101,161
10702,SAN LUCAS,estado nutricional en menores de 5 anos,clasificacion d,2003-04-01,351,375,351,375,726
70302,SAN MIGUEL DE VELASCO,estado nutricional en menores de 5 anos,clasificacion d,2003-04-01,58,77,58,77,135
51001,SAN PABLO DE LIPEZ,estado nutricional en menores de 5 anos,clasificacion d,2003-04-01,18,15,18,15,33
50501,SAN PEDRO DE BUENA VISTA,estado nutricional en menores de 5 anos,clasificacion d,2003-04-01,138,188,138,188,326
21801,SAN PEDRO DE CURAHUARA,estado nutricional en menores de 5 anos,clasificacion d,2003-04-01,13,11,13,11,24
50902,SAN PEDRO DE QUEMES,estado nutricional en menores de 5 anos,clasificacion d,2003-04-01,6,2,6,2,8
21702,SAN PEDRO DE TIQUINA,estado nutricional en menores de 5 anos,clasificacion d,2003-04-01,1,9,1,9,10
70303,SAN RAFAEL,estado nutricional en menores de 5 anos,clasificacion d,2003-04-01,18,32,18,32,50
80702,SAN RAMON,estado nutricional en menores de 5 anos,clasificacion d,2003-04-01,4,8,4,8,12
80401,SANTA ANA,estado nutricional en menores de 5 anos,clasificacion d,2003-04-01,1,5,1,5,6
70101,SANTA CRUZ DE LA SIERRA,estado nutricional en menores de 5 anos,clasificacion d,2003-04-01,993,636,993,636,1629
80303,SANTA ROSA,estado nutricional en menores de 5 anos,clasificacion d,2003-04-01,17,8,17,8,25
70602,SANTA ROSA DEL SARA,estado nutricional en menores de 5 anos,clasificacion d,2003-04-01,14,13,14,13,27
20308,SANTIAGO DE CALLAPA,estado nutricional en menores de 5 anos,clasificacion d,2003-04-01,15,19,15,19,34
41401,SANTIAGO DE HUARI,estado nutricional en menores de 5 anos,clasificacion d,2003-04-01,10,34,10,34,44
21901,SANTIAGO DE MACHACA,estado nutricional en menores de 5 anos,clasificacion d,2003-04-01,2,2,2,2,4
30702,SANTIVAÃ‘ES,estado nutricional en menores de 5 anos,clasificacion d,2003-04-01,16,11,16,11,27
40202,SANTUARIO DE QUILLACAS,estado nutricional en menores de 5 anos,clasificacion d,2003-04-01,10,14,10,14,24
20902,SAPAHAQUI,estado nutricional en menores de 5 anos,clasificacion d,2003-04-01,31,51,31,51,82
90303,SENA,estado nutricional en menores de 5 anos,clasificacion d,2003-04-01,7,6,7,6,13
21301,SICA SICA (VILLA AROMA),estado nutricional en menores de 5 anos,clasificacion d,2003-04-01,104,46,104,46,150
30703,SICAYA,estado nutricional en menores de 5 anos,clasificacion d,2003-04-01,24,14,24,14,38
30902,SIPE SIPE,estado nutricional en menores de 5 anos,clasificacion d,2003-04-01,123,114,123,114,237
10403,SOPACHUY,estado nutricional en menores de 5 anos,clasificacion d,2003-04-01,54,48,54,48,102
20601,SORATA,estado nutricional en menores de 5 anos,clasificacion d,2003-04-01,42,63,42,63,105
10101,SUCRE,estado nutricional en menores de 5 anos,clasificacion d,2003-04-01,558,673,558,673,1231
31404,TACACHI,estado nutricional en menores de 5 anos,clasificacion d,2003-04-01,7,3,7,3,10
20603,TACACOMA,estado nutricional en menores de 5 anos,clasificacion d,2003-04-01,16,26,16,26,42
50303,TACOBAMBA,estado nutricional en menores de 5 anos,clasificacion d,2003-04-01,51,77,51,77,128
30602,TACOPAYA,estado nutricional en menores de 5 anos,clasificacion d,2003-04-01,116,170,116,170,286
51402,TAHUA,estado nutricional en menores de 5 anos,clasificacion d,2003-04-01,2,0,2,0,2
31101,TAPACARI,estado nutricional en menores de 5 anos,clasificacion d,2003-04-01,96,137,96,137,233
10601,TARABUCO,estado nutricional en menores de 5 anos,clasificacion d,2003-04-01,288,465,288,465,753
30401,TARATA,estado nutricional en menores de 5 anos,clasificacion d,2003-04-01,31,168,31,168,199
60101,TARIJA,estado nutricional en menores de 5 anos,clasificacion d,2003-04-01,227,228,227,228,455
10202,TARVITA,estado nutricional en menores de 5 anos,clasificacion d,2003-04-01,116,213,116,213,329
20803,TIAWANACU,estado nutricional en menores de 5 anos,clasificacion d,2003-04-01,23,15,23,15,38
50102,TINGUIPAYA,estado nutricional en menores de 5 anos,clasificacion d,2003-04-01,28,32,28,32,60
20606,TIPUANI,estado nutricional en menores de 5 anos,clasificacion d,2003-04-01,14,13,14,13,27
30903,TIQUIPAYA,estado nutricional en menores de 5 anos,clasificacion d,2003-04-01,89,31,89,31,120
31601,TIRAQUE (CBBA),estado nutricional en menores de 5 anos,clasificacion d,2003-04-01,121,142,121,142,263
21703,TITO YUPANQUI (PARQUIPUJIO),estado nutricional en menores de 5 anos,clasificacion d,2003-04-01,7,0,7,0,7
30802,TOCO,estado nutricional en menores de 5 anos,clasificacion d,2003-04-01,9,11,9,11,20
30803,TOLATA,estado nutricional en menores de 5 anos,clasificacion d,2003-04-01,17,28,17,28,45
41001,TOLEDO,estado nutricional en menores de 5 anos,clasificacion d,2003-04-01,13,17,13,17,30
51202,TOMAVE,estado nutricional en menores de 5 anos,clasificacion d,2003-04-01,68,113,68,113,181
10402,TOMINA,estado nutricional en menores de 5 anos,clasificacion d,2003-04-01,116,222,116,222,338
50502,TORO TORO,estado nutricional en menores de 5 anos,clasificacion d,2003-04-01,74,70,74,70,144
31201,TOTORA(CBBA),estado nutricional en menores de 5 anos,clasificacion d,2003-04-01,52,38,52,38,90
41301,TOTORA(ORR),estado nutricional en menores de 5 anos,clasificacion d,2003-04-01,11,16,11,16,27
70802,TRIGAL,estado nutricional en menores de 5 anos,clasificacion d,2003-04-01,2,6,2,6,8
80101,TRINIDAD,estado nutricional en menores de 5 anos,clasificacion d,2003-04-01,145,252,145,252,397
50801,TUPIZA,estado nutricional en menores de 5 anos,clasificacion d,2003-04-01,129,430,129,430,559
40402,TURCO,estado nutricional en menores de 5 anos,clasificacion d,2003-04-01,9,16,9,16,25
21302,UMALA,estado nutricional en menores de 5 anos,clasificacion d,2003-04-01,4,4,4,4,8
50201,UNCIA,estado nutricional en menores de 5 anos,clasificacion d,2003-04-01,24,79,24,79,103
60401,URIONDO (A. CONCEPCION),estado nutricional en menores de 5 anos,clasificacion d,2003-04-01,30,29,30,29,59
71502,URUBICHA,estado nutricional en menores de 5 anos,clasificacion d,2003-04-01,98,176,98,176,274
51201,UYUNI,estado nutricional en menores de 5 anos,clasificacion d,2003-04-01,97,185,97,185,282
30502,VACAS,estado nutricional en menores de 5 anos,clasificacion d,2003-04-01,18,4,18,4,22
70801,VALLEGRANDE,estado nutricional en menores de 5 anos,clasificacion d,2003-04-01,67,69,67,69,136
20801,VIACHA,estado nutricional en menores de 5 anos,clasificacion d,2003-04-01,124,88,124,88,212
31302,VILA VILA,estado nutricional en menores de 5 anos,clasificacion d,2003-04-01,10,28,10,28,38
60303,VILLA MONTES,estado nutricional en menores de 5 anos,clasificacion d,2003-04-01,97,91,97,91,188
90502,VILLA NUEVA (LOMA ALTA),estado nutricional en menores de 5 anos,clasificacion d,2003-04-01,1,5,1,5,6
31402,VILLA RIVERO,estado nutricional en menores de 5 anos,clasificacion d,2003-04-01,17,12,17,12,29
10801,VILLA SERRANO,estado nutricional en menores de 5 anos,clasificacion d,2003-04-01,115,235,115,235,350
31003,VILLA TUNARI,estado nutricional en menores de 5 anos,clasificacion d,2003-04-01,126,109,126,109,235
11001,VILLA VACA GUZMAN (MUYUPAMPA),estado nutricional en menores de 5 anos,clasificacion d,2003-04-01,60,112,60,112,172
51501,VILLAZON,estado nutricional en menores de 5 anos,clasificacion d,2003-04-01,140,164,140,164,304
30904,VINTO,estado nutricional en menores de 5 anos,clasificacion d,2003-04-01,25,17,25,17,42
50602,VITICHI,estado nutricional en menores de 5 anos,clasificacion d,2003-04-01,93,152,93,152,245
20306,WALDO BALLIVIAN,estado nutricional en menores de 5 anos,clasificacion d,2003-04-01,5,3,5,3,8
70201,WARNES,estado nutricional en menores de 5 anos,clasificacion d,2003-04-01,92,68,92,68,160
20903,YACO,estado nutricional en menores de 5 anos,clasificacion d,2003-04-01,21,28,21,28,49
60301,YACUIBA,estado nutricional en menores de 5 anos,clasificacion d,2003-04-01,113,68,113,68,181
10602,YAMPARAEZ,estado nutricional en menores de 5 anos,clasificacion d,2003-04-01,149,274,149,274,423
21103,YANACACHI,estado nutricional en menores de 5 anos,clasificacion d,2003-04-01,6,14,6,14,20
70403,YAPACANI,estado nutricional en menores de 5 anos,clasificacion d,2003-04-01,161,141,161,141,302
50103,YOCALLA,estado nutricional en menores de 5 anos,clasificacion d,2003-04-01,19,27,19,27,46
10102,YOTALA,estado nutricional en menores de 5 anos,clasificacion d,2003-04-01,77,188,77,188,265
60402,YUNCHARA,estado nutricional en menores de 5 anos,clasificacion d,2003-04-01,35,60,35,60,95
10301,ZUDAÃ‘EZ,estado nutricional en menores de 5 anos,clasificacion d,2003-04-01,54,98,54,98,152
51302,ACACIO,estado nutricional en menores de 5 anos,clasificacion d,2003-05-01,62,126,62,126,188
20201,ACHACACHI,estado nutricional en menores de 5 anos,clasificacion d,2003-05-01,156,227,156,227,383
20104,ACHOCALLA,estado nutricional en menores de 5 anos,clasificacion d,2003-05-01,48,63,48,63,111
30201,AIQUILE,estado nutricional en menores de 5 anos,clasificacion d,2003-05-01,61,119,61,119,180
31303,ALALAY,estado nutricional en menores de 5 anos,clasificacion d,2003-05-01,15,12,15,12,27
10404,ALCALA,estado nutricional en menores de 5 anos,clasificacion d,2003-05-01,35,75,35,75,110
20202,ANCORAIMES,estado nutricional en menores de 5 anos,clasificacion d,2003-05-01,80,138,80,138,218
41201,ANDAMARCA,estado nutricional en menores de 5 anos,clasificacion d,2003-05-01,3,8,3,8,11
30402,ANZALDO,estado nutricional en menores de 5 anos,clasificacion d,2003-05-01,21,43,21,43,64
20701,APOLO,estado nutricional en menores de 5 anos,clasificacion d,2003-05-01,14,16,14,16,30
51301,ARAMPAMPA,estado nutricional en menores de 5 anos,clasificacion d,2003-05-01,39,111,39,111,150
30403,ARBIETO,estado nutricional en menores de 5 anos,clasificacion d,2003-05-01,7,5,7,5,12
30601,ARQUE,estado nutricional en menores de 5 anos,clasificacion d,2003-05-01,57,68,57,68,125
50802,ATOCHA,estado nutricional en menores de 5 anos,clasificacion d,2003-05-01,33,143,33,143,176
20503,AUCAPATA,estado nutricional en menores de 5 anos,clasificacion d,2003-05-01,32,45,32,45,77
20502,AYATA,estado nutricional en menores de 5 anos,clasificacion d,2003-05-01,31,12,31,12,43
21303,AYO AYO,estado nutricional en menores de 5 anos,clasificacion d,2003-05-01,8,22,8,22,30
30301,AYOPAYA (V. DE INDEPENDENCIA),estado nutricional en menores de 5 anos,clasificacion d,2003-05-01,83,140,83,140,223
10201,AZURDUY,estado nutricional en menores de 5 anos,clasificacion d,2003-05-01,130,206,130,206,336
21203,BATALLAS,estado nutricional en menores de 5 anos,clasificacion d,2003-05-01,30,48,30,48,78
80802,BAURES,estado nutricional en menores de 5 anos,clasificacion d,2003-05-01,16,37,16,37,53
41202,BELEN DE ANDAMARCA,estado nutricional en menores de 5 anos,clasificacion d,2003-05-01,2,4,2,4,6
50104,BELEN DE URMIRI,estado nutricional en menores de 5 anos,clasificacion d,2003-05-01,12,23,12,23,35
90104,BELLA FLOR,estado nutricional en menores de 5 anos,clasificacion d,2003-05-01,11,17,11,17,28
60202,BERMEJO,estado nutricional en menores de 5 anos,clasificacion d,2003-05-01,15,11,15,11,26
50301,BETANZOS,estado nutricional en menores de 5 anos,clasificacion d,2003-05-01,316,551,316,551,867
31501,BOLIVAR,estado nutricional en menores de 5 anos,clasificacion d,2003-05-01,86,153,86,153,239
90103,BOLPEBRA,estado nutricional en menores de 5 anos,clasificacion d,2003-05-01,12,7,12,7,19
70707,BOYUIBE,estado nutricional en menores de 5 anos,clasificacion d,2003-05-01,18,14,18,14,32
70401,BUENA VISTA,estado nutricional en menores de 5 anos,clasificacion d,2003-05-01,15,50,15,50,65
70703,CABEZAS,estado nutricional en menores de 5 anos,clasificacion d,2003-05-01,35,43,35,43,78
20905,CAIROMA,estado nutricional en menores de 5 anos,clasificacion d,2003-05-01,65,81,65,81,146
51102,"CAIZA ""D""",estado nutricional en menores de 5 anos,clasificacion d,2003-05-01,97,106,97,106,203
21003,CAJUATA,estado nutricional en menores de 5 anos,clasificacion d,2003-05-01,34,27,34,27,61
20303,CALACOTO,estado nutricional en menores de 5 anos,clasificacion d,2003-05-01,27,7,27,7,34
21304,CALAMARCA,estado nutricional en menores de 5 anos,clasificacion d,2003-05-01,100,77,100,77,177
10701,CAMARGO,estado nutricional en menores de 5 anos,clasificacion d,2003-05-01,111,157,111,157,268
10901,CAMATAQUI (C. VILLA ABECIA),estado nutricional en menores de 5 anos,clasificacion d,2003-05-01,17,37,17,37,54
70706,CAMIRI,estado nutricional en menores de 5 anos,clasificacion d,2003-05-01,120,103,120,103,223
30701,CAPINOTA,estado nutricional en menores de 5 anos,clasificacion d,2003-05-01,25,39,25,39,64
20302,CAQUIAVIRI,estado nutricional en menores de 5 anos,clasificacion d,2003-05-01,41,72,41,72,113
40102,CARACOLLO,estado nutricional en menores de 5 anos,clasificacion d,2003-05-01,43,54,43,54,97
22001,CARANAVI,estado nutricional en menores de 5 anos,clasificacion d,2003-05-01,189,176,189,176,365
60302,CARAPARI,estado nutricional en menores de 5 anos,clasificacion d,2003-05-01,22,38,22,38,60
50702,CARIPUYO,estado nutricional en menores de 5 anos,clasificacion d,2003-05-01,75,103,75,103,178
21902,CATACORA,estado nutricional en menores de 5 anos,clasificacion d,2003-05-01,8,12,8,12,20
40201,CHALLAPATA,estado nutricional en menores de 5 anos,clasificacion d,2003-05-01,84,144,84,144,228
50302,CHAQUI,estado nutricional en menores de 5 anos,clasificacion d,2003-05-01,67,85,67,85,152
70702,CHARAGUA,estado nutricional en menores de 5 anos,clasificacion d,2003-05-01,72,104,72,104,176
20305,CHARAÃ‘A,estado nutricional en menores de 5 anos,clasificacion d,2003-05-01,3,10,3,10,13
50202,CHAYANTA,estado nutricional en menores de 5 anos,clasificacion d,2003-05-01,58,89,58,89,147
31204,CHIMORE,estado nutricional en menores de 5 anos,clasificacion d,2003-05-01,11,18,11,18,29
40302,CHOQUE COTA,estado nutricional en menores de 5 anos,clasificacion d,2003-05-01,15,0,15,0,15
21101,CHULUMANI (V. DE LA LIBERTAD),estado nutricional en menores de 5 anos,clasificacion d,2003-05-01,7,17,7,17,24
20501,CHUMA,estado nutricional en menores de 5 anos,clasificacion d,2003-05-01,44,23,44,23,67
30801,CLIZA,estado nutricional en menores de 5 anos,clasificacion d,2003-05-01,16,10,16,10,26
90101,COBIJA,estado nutricional en menores de 5 anos,clasificacion d,2003-05-01,61,91,61,91,152
30101,COCHABAMBA,estado nutricional en menores de 5 anos,clasificacion d,2003-05-01,571,490,571,490,1061
30905,COLCAPIRHUA,estado nutricional en menores de 5 anos,clasificacion d,2003-05-01,2,8,2,8,10
50901,"COLCHA ""K""",estado nutricional en menores de 5 anos,clasificacion d,2003-05-01,59,98,59,98,157
21307,COLLANA,estado nutricional en menores de 5 anos,clasificacion d,2003-05-01,3,2,3,2,5
31002,COLOMI,estado nutricional en menores de 5 anos,clasificacion d,2003-05-01,116,62,116,62,178
50401,COLQUECHACA,estado nutricional en menores de 5 anos,clasificacion d,2003-05-01,133,80,133,80,213
21306,COLQUENCHA,estado nutricional en menores de 5 anos,clasificacion d,2003-05-01,20,22,20,22,42
21004,COLQUIRI,estado nutricional en menores de 5 anos,clasificacion d,2003-05-01,106,109,106,109,215
20304,COMANCHE,estado nutricional en menores de 5 anos,clasificacion d,2003-05-01,8,18,8,18,26
71301,COMARAPA,estado nutricional en menores de 5 anos,clasificacion d,2003-05-01,70,48,70,48,118
20605,COMBAYA,estado nutricional en menores de 5 anos,clasificacion d,2003-05-01,4,6,4,6,10
71101,CONCEPCION,estado nutricional en menores de 5 anos,clasificacion d,2003-05-01,27,9,27,9,36
21701,COPACABANA,estado nutricional en menores de 5 anos,clasificacion d,2003-05-01,29,29,29,29,58
21402,CORIPATA,estado nutricional en menores de 5 anos,clasificacion d,2003-05-01,9,2,9,2,11
20301,CORO CORO,estado nutricional en menores de 5 anos,clasificacion d,2003-05-01,29,35,29,35,64
21401,COROICO,estado nutricional en menores de 5 anos,clasificacion d,2003-05-01,33,29,33,29,62
40301,CORQUE,estado nutricional en menores de 5 anos,clasificacion d,2003-05-01,29,19,29,19,48
50601,COTAGAITA,estado nutricional en menores de 5 anos,clasificacion d,2003-05-01,156,299,156,299,455
70102,COTOCA,estado nutricional en menores de 5 anos,clasificacion d,2003-05-01,8,12,8,12,20
70704,CUEVO,estado nutricional en menores de 5 anos,clasificacion d,2003-05-01,7,22,7,22,29
10902,CULPINA,estado nutricional en menores de 5 anos,clasificacion d,2003-05-01,160,273,160,273,433
40401,CURAHUARA DE CARANGAS,estado nutricional en menores de 5 anos,clasificacion d,2003-05-01,7,40,7,40,47
21602,CURVA,estado nutricional en menores de 5 anos,clasificacion d,2003-05-01,37,28,37,28,65
20804,DESAGUADERO,estado nutricional en menores de 5 anos,clasificacion d,2003-05-01,4,9,4,9,13
20105,EL ALTO,estado nutricional en menores de 5 anos,clasificacion d,2003-05-01,2066,1540,2066,1540,3606
40103,EL CHORO,estado nutricional en menores de 5 anos,clasificacion d,2003-05-01,8,4,8,4,12
71503,EL PUENTE(STC),estado nutricional en menores de 5 anos,clasificacion d,2003-05-01,2,166,2,166,168
60502,EL PUENTE(TJA),estado nutricional en menores de 5 anos,clasificacion d,2003-05-01,82,192,82,192,274
70105,EL TORNO,estado nutricional en menores de 5 anos,clasificacion d,2003-05-01,58,64,58,64,122
10405,EL VILLAR,estado nutricional en menores de 5 anos,clasificacion d,2003-05-01,62,131,62,131,193
60601,ENTRE RIOS,estado nutricional en menores de 5 anos,clasificacion d,2003-05-01,17,46,17,46,63
40502,ESCARA,estado nutricional en menores de 5 anos,clasificacion d,2003-05-01,0,2,0,2,2
41101,EUCALIPTUS,estado nutricional en menores de 5 anos,clasificacion d,2003-05-01,3,8,3,8,11
80402,EXALTACION,estado nutricional en menores de 5 anos,clasificacion d,2003-05-01,0,75,0,75,75
90203,FILADELFIA,estado nutricional en menores de 5 anos,clasificacion d,2003-05-01,9,16,9,16,25
71002,GENERAL SAAVEDRA,estado nutricional en menores de 5 anos,clasificacion d,2003-05-01,102,118,102,118,220
21601,GRAL. J.J. PEREZ (CHARAZANI),estado nutricional en menores de 5 anos,clasificacion d,2003-05-01,34,36,34,36,70
20602,GUANAY,estado nutricional en menores de 5 anos,clasificacion d,2003-05-01,113,143,113,143,256
20802,GUAQUI,estado nutricional en menores de 5 anos,clasificacion d,2003-05-01,7,5,7,5,12
80202,GUAYARAMERIN,estado nutricional en menores de 5 anos,clasificacion d,2003-05-01,134,107,134,107,241
70705,GUTIERREZ,estado nutricional en menores de 5 anos,clasificacion d,2003-05-01,80,151,80,151,231
10502,HUACARETA,estado nutricional en menores de 5 anos,clasificacion d,2003-05-01,59,130,59,130,189
11002,HUACAYA (VILLA DE HUACAYA),estado nutricional en menores de 5 anos,clasificacion d,2003-05-01,21,24,21,24,45
40501,HUACHACALLA,estado nutricional en menores de 5 anos,clasificacion d,2003-05-01,1,0,1,0,1
40701,HUANUNI,estado nutricional en menores de 5 anos,clasificacion d,2003-05-01,68,50,68,50,118
80803,HUARACAJE,estado nutricional en menores de 5 anos,clasificacion d,2003-05-01,4,7,4,7,11
41601,HUAYLLAMARCA,estado nutricional en menores de 5 anos,clasificacion d,2003-05-01,15,23,15,23,38
21005,ICHOCA,estado nutricional en menores de 5 anos,clasificacion d,2003-05-01,27,53,27,53,80
10304,ICLA,estado nutricional en menores de 5 anos,clasificacion d,2003-05-01,125,252,125,252,377
10703,INCAHUASI,estado nutricional en menores de 5 anos,clasificacion d,2003-05-01,167,186,167,186,353
21001,INQUISIVI,estado nutricional en menores de 5 anos,clasificacion d,2003-05-01,111,175,111,175,286
21102,IRUPANA (VILLA DE LANZA),estado nutricional en menores de 5 anos,clasificacion d,2003-05-01,48,94,48,94,142
21501,IXIAMAS,estado nutricional en menores de 5 anos,clasificacion d,2003-05-01,40,24,40,24,64
21105,LA ASUNTA,estado nutricional en menores de 5 anos,clasificacion d,2003-05-01,32,42,32,42,74
70104,LA GUARDIA,estado nutricional en menores de 5 anos,clasificacion d,2003-05-01,59,33,59,33,92
20101,LA PAZ,estado nutricional en menores de 5 anos,clasificacion d,2003-05-01,1290,1114,1290,1114,2404
41501,LA RIVERA,estado nutricional en menores de 5 anos,clasificacion d,2003-05-01,0,1,0,1,1
70701,LAGUNILLAS,estado nutricional en menores de 5 anos,clasificacion d,2003-05-01,30,52,30,52,82
21202,LAJA,estado nutricional en menores de 5 anos,clasificacion d,2003-05-01,29,73,29,73,102
10903,LAS CARRERAS,estado nutricional en menores de 5 anos,clasificacion d,2003-05-01,19,61,19,61,80
21006,LICOMA PAMPA,estado nutricional en menores de 5 anos,clasificacion d,2003-05-01,28,82,28,82,110
50203,LLALLAGUA,estado nutricional en menores de 5 anos,clasificacion d,2003-05-01,12,345,12,345,357
51401,LLICA,estado nutricional en menores de 5 anos,clasificacion d,2003-05-01,11,23,11,23,34
80601,LORETO,estado nutricional en menores de 5 anos,clasificacion d,2003-05-01,7,16,7,16,23
20901,LURIBAY,estado nutricional en menores de 5 anos,clasificacion d,2003-05-01,50,38,50,38,88
40702,MACHACAMARCA,estado nutricional en menores de 5 anos,clasificacion d,2003-05-01,9,9,9,9,18
11003,MACHARETI,estado nutricional en menores de 5 anos,clasificacion d,2003-05-01,37,93,37,93,130
80801,MAGDALENA,estado nutricional en menores de 5 anos,clasificacion d,2003-05-01,40,77,40,77,117
70903,MAIRANA,estado nutricional en menores de 5 anos,clasificacion d,2003-05-01,28,22,28,22,50
20904,MALLA,estado nutricional en menores de 5 anos,clasificacion d,2003-05-01,2,3,2,3,5
20103,MECAPACA,estado nutricional en menores de 5 anos,clasificacion d,2003-05-01,20,21,20,21,41
71003,MINEROS,estado nutricional en menores de 5 anos,clasificacion d,2003-05-01,101,81,101,81,182
31301,MIZQUE,estado nutricional en menores de 5 anos,clasificacion d,2003-05-01,56,102,56,102,158
20402,MOCOMOCO,estado nutricional en menores de 5 anos,clasificacion d,2003-05-01,71,101,71,101,172
51002,MOJINETE,estado nutricional en menores de 5 anos,clasificacion d,2003-05-01,7,21,7,21,28
10303,MOJOCOYA,estado nutricional en menores de 5 anos,clasificacion d,2003-05-01,58,142,58,142,200
10501,MONTEAGUDO,estado nutricional en menores de 5 anos,clasificacion d,2003-05-01,136,241,136,241,377
71001,MONTERO,estado nutricional en menores de 5 anos,clasificacion d,2003-05-01,311,209,311,209,520
70803,MORO MORO,estado nutricional en menores de 5 anos,clasificacion d,2003-05-01,16,23,16,23,39
30302,MOROCHATA,estado nutricional en menores de 5 anos,clasificacion d,2003-05-01,195,247,195,247,442
90401,NACEBE (SANTA ROSA DEL ABUNA),estado nutricional en menores de 5 anos,clasificacion d,2003-05-01,4,8,4,8,12
20307,NAZACARA DE PACAJES,estado nutricional en menores de 5 anos,clasificacion d,2003-05-01,5,2,5,2,7
90501,NUEVO MANOA (NUEVA ESPERANZA),estado nutricional en menores de 5 anos,clasificacion d,2003-05-01,1,4,1,4,5
50404,OCURI,estado nutricional en menores de 5 anos,clasificacion d,2003-05-01,67,147,67,147,214
70202,OKINAWA,estado nutricional en menores de 5 anos,clasificacion d,2003-05-01,4,2,4,2,6
30203,OMEREQUE,estado nutricional en menores de 5 anos,clasificacion d,2003-05-01,11,23,11,23,34
40101,ORURO,estado nutricional en menores de 5 anos,clasificacion d,2003-05-01,523,623,523,623,1146
60201,PADCAYA,estado nutricional en menores de 5 anos,clasificacion d,2003-05-01,75,118,75,118,193
10401,PADILLA,estado nutricional en menores de 5 anos,clasificacion d,2003-05-01,110,252,110,252,362
70502,PAILON,estado nutricional en menores de 5 anos,clasificacion d,2003-05-01,20,11,20,11,31
20102,PALCA,estado nutricional en menores de 5 anos,clasificacion d,2003-05-01,64,94,64,94,158
21104,PALOS BLANCOS,estado nutricional en menores de 5 anos,clasificacion d,2003-05-01,97,204,97,204,301
40802,PAMPA AULLAGAS,estado nutricional en menores de 5 anos,clasificacion d,2003-05-01,10,15,10,15,25
70902,PAMPA GRANDE,estado nutricional en menores de 5 anos,clasificacion d,2003-05-01,18,20,18,20,38
21802,PAPEL PAMPA,estado nutricional en menores de 5 anos,clasificacion d,2003-05-01,9,21,9,21,30
30202,PASORAPA,estado nutricional en menores de 5 anos,clasificacion d,2003-05-01,18,37,18,37,55
21305,PATACAMAYA,estado nutricional en menores de 5 anos,clasificacion d,2003-05-01,73,19,73,19,92
40602,PAZÃ‘A,estado nutricional en menores de 5 anos,clasificacion d,2003-05-01,6,11,6,11,17
20702,PELECHUCO,estado nutricional en menores de 5 anos,clasificacion d,2003-05-01,46,47,46,47,93
50403,POCOATA,estado nutricional en menores de 5 anos,clasificacion d,2003-05-01,193,314,193,314,507
31203,POCONA,estado nutricional en menores de 5 anos,clasificacion d,2003-05-01,47,74,47,74,121
31202,POJO (CBBA),estado nutricional en menores de 5 anos,clasificacion d,2003-05-01,138,171,138,171,309
40601,POOPO,estado nutricional en menores de 5 anos,clasificacion d,2003-05-01,8,27,8,27,35
51203,PORCO,estado nutricional en menores de 5 anos,clasificacion d,2003-05-01,12,17,12,17,29
10103,POROMA,estado nutricional en menores de 5 anos,clasificacion d,2003-05-01,130,268,130,268,398
70103,PORONGO,estado nutricional en menores de 5 anos,clasificacion d,2003-05-01,23,23,23,23,46
70601,PORTACHUELO,estado nutricional en menores de 5 anos,clasificacion d,2003-05-01,43,26,43,26,69
90102,PORVENIR,estado nutricional en menores de 5 anos,clasificacion d,2003-05-01,11,13,11,13,24
70804,POSTRER VALLE,estado nutricional en menores de 5 anos,clasificacion d,2003-05-01,6,10,6,10,16
50101,POTOSI,estado nutricional en menores de 5 anos,clasificacion d,2003-05-01,638,552,638,552,1190
10302,PRESTO,estado nutricional en menores de 5 anos,clasificacion d,2003-05-01,105,168,105,168,273
70805,PUCARA,estado nutricional en menores de 5 anos,clasificacion d,2003-05-01,3,12,3,12,15
21201,PUCARANI,estado nutricional en menores de 5 anos,clasificacion d,2003-05-01,56,32,56,32,88
20401,PUERTO ACOSTA,estado nutricional en menores de 5 anos,clasificacion d,2003-05-01,104,187,104,187,291
20403,PUERTO CARABUCO,estado nutricional en menores de 5 anos,clasificacion d,2003-05-01,59,132,59,132,191
90301,PUERTO GONZALO MORENO,estado nutricional en menores de 5 anos,clasificacion d,2003-05-01,12,8,12,8,20
21204,PUERTO PEREZ,estado nutricional en menores de 5 anos,clasificacion d,2003-05-01,24,14,24,14,38
71402,PUERTO QUIJARRO,estado nutricional en menores de 5 anos,clasificacion d,2003-05-01,40,13,40,13,53
90201,PUERTO RICO,estado nutricional en menores de 5 anos,clasificacion d,2003-05-01,30,23,30,23,53
80703,PUERTO SILES,estado nutricional en menores de 5 anos,clasificacion d,2003-05-01,4,6,4,6,10
71401,PUERTO SUAREZ,estado nutricional en menores de 5 anos,clasificacion d,2003-05-01,31,9,31,9,40
31205,PUERTO VILLARROEL,estado nutricional en menores de 5 anos,clasificacion d,2003-05-01,167,154,167,154,321
51101,PUNA,estado nutricional en menores de 5 anos,clasificacion d,2003-05-01,237,391,237,391,628
20604,QUIABAYA,estado nutricional en menores de 5 anos,clasificacion d,2003-05-01,13,30,13,30,43
30901,QUILLACOLLO,estado nutricional en menores de 5 anos,clasificacion d,2003-05-01,116,137,116,137,253
21002,QUIME,estado nutricional en menores de 5 anos,clasificacion d,2003-05-01,91,131,91,131,222
70904,QUIRUSILLAS,estado nutricional en menores de 5 anos,clasificacion d,2003-05-01,4,0,4,0,4
50402,RAVELO,estado nutricional en menores de 5 anos,clasificacion d,2003-05-01,148,200,148,200,348
80301,REYES,estado nutricional en menores de 5 anos,clasificacion d,2003-05-01,51,82,51,82,133
80201,RIBERALTA,estado nutricional en menores de 5 anos,clasificacion d,2003-05-01,294,224,294,224,518
70503,ROBORE,estado nutricional en menores de 5 anos,clasificacion d,2003-05-01,40,37,40,37,77
80304,RURRENABAQUE,estado nutricional en menores de 5 anos,clasificacion d,2003-05-01,34,24,34,24,58
40901,SABAYA,estado nutricional en menores de 5 anos,clasificacion d,2003-05-01,2,9,2,9,11
31001,SACABA,estado nutricional en menores de 5 anos,clasificacion d,2003-05-01,148,193,148,193,341
30404,SACABAMBA,estado nutricional en menores de 5 anos,clasificacion d,2003-05-01,14,5,14,5,19
50701,SACACA,estado nutricional en menores de 5 anos,clasificacion d,2003-05-01,202,408,202,408,610
71302,SAIPINA,estado nutricional en menores de 5 anos,clasificacion d,2003-05-01,10,12,10,12,22
40801,SALINAS DE GARCI MENDOZA,estado nutricional en menores de 5 anos,clasificacion d,2003-05-01,11,18,11,18,29
70901,SAMAIPATA,estado nutricional en menores de 5 anos,clasificacion d,2003-05-01,27,15,27,15,42
51601,SAN AGUSTIN,estado nutricional en menores de 5 anos,clasificacion d,2003-05-01,10,13,10,13,23
80602,SAN ANDRES,estado nutricional en menores de 5 anos,clasificacion d,2003-05-01,12,8,12,8,20
51003,SAN ANTONIO DE ESMORUCO,estado nutricional en menores de 5 anos,clasificacion d,2003-05-01,5,15,5,15,20
71105,SAN ANTONIO DE LOMERIO,estado nutricional en menores de 5 anos,clasificacion d,2003-05-01,60,87,60,87,147
80302,SAN BORJA,estado nutricional en menores de 5 anos,clasificacion d,2003-05-01,188,202,188,202,390
21502,SAN BUENA VENTURA,estado nutricional en menores de 5 anos,clasificacion d,2003-05-01,32,22,32,22,54
70402,SAN CARLOS,estado nutricional en menores de 5 anos,clasificacion d,2003-05-01,82,48,82,48,130
80501,SAN IGNACIO,estado nutricional en menores de 5 anos,clasificacion d,2003-05-01,76,89,76,89,165
70301,SAN IGNACIO DE VELASCO,estado nutricional en menores de 5 anos,clasificacion d,2003-05-01,230,246,230,246,476
80102,SAN JAVIER(BNI),estado nutricional en menores de 5 anos,clasificacion d,2003-05-01,7,15,7,15,22
71102,SAN JAVIER(STC),estado nutricional en menores de 5 anos,clasificacion d,2003-05-01,17,42,17,42,59
80701,SAN JOAQUIN,estado nutricional en menores de 5 anos,clasificacion d,2003-05-01,7,11,7,11,18
70501,SAN JOSE DE CHIQUITOS,estado nutricional en menores de 5 anos,clasificacion d,2003-05-01,25,18,25,18,43
71104,SAN JULIAN,estado nutricional en menores de 5 anos,clasificacion d,2003-05-01,168,293,168,293,461
90302,SAN LORENZO(PND),estado nutricional en menores de 5 anos,clasificacion d,2003-05-01,12,5,12,5,17
60501,SAN LORENZO(TJA),estado nutricional en menores de 5 anos,clasificacion d,2003-05-01,41,87,41,87,128
10702,SAN LUCAS,estado nutricional en menores de 5 anos,clasificacion d,2003-05-01,411,597,411,597,1008
70302,SAN MIGUEL DE VELASCO,estado nutricional en menores de 5 anos,clasificacion d,2003-05-01,70,94,70,94,164
51001,SAN PABLO DE LIPEZ,estado nutricional en menores de 5 anos,clasificacion d,2003-05-01,15,37,15,37,52
50501,SAN PEDRO DE BUENA VISTA,estado nutricional en menores de 5 anos,clasificacion d,2003-05-01,161,279,161,279,440
21801,SAN PEDRO DE CURAHUARA,estado nutricional en menores de 5 anos,clasificacion d,2003-05-01,6,11,6,11,17
50902,SAN PEDRO DE QUEMES,estado nutricional en menores de 5 anos,clasificacion d,2003-05-01,2,4,2,4,6
21702,SAN PEDRO DE TIQUINA,estado nutricional en menores de 5 anos,clasificacion d,2003-05-01,7,17,7,17,24
70303,SAN RAFAEL,estado nutricional en menores de 5 anos,clasificacion d,2003-05-01,19,51,19,51,70
80702,SAN RAMON,estado nutricional en menores de 5 anos,clasificacion d,2003-05-01,4,5,4,5,9
80702,SAN RAMON,estado nutricional en menores de 5 anos,clasificacion d,2003-05-01,2,16,2,16,18
80401,SANTA ANA,estado nutricional en menores de 5 anos,clasificacion d,2003-05-01,0,19,0,19,19
70101,SANTA CRUZ DE LA SIERRA,estado nutricional en menores de 5 anos,clasificacion d,2003-05-01,294,163,294,163,457
80303,SANTA ROSA,estado nutricional en menores de 5 anos,clasificacion d,2003-05-01,8,18,8,18,26
70602,SANTA ROSA DEL SARA,estado nutricional en menores de 5 anos,clasificacion d,2003-05-01,6,9,6,9,15
20308,SANTIAGO DE CALLAPA,estado nutricional en menores de 5 anos,clasificacion d,2003-05-01,36,86,36,86,122
41401,SANTIAGO DE HUARI,estado nutricional en menores de 5 anos,clasificacion d,2003-05-01,10,21,10,21,31
21901,SANTIAGO DE MACHACA,estado nutricional en menores de 5 anos,clasificacion d,2003-05-01,17,24,17,24,41
30702,SANTIVAÃ‘ES,estado nutricional en menores de 5 anos,clasificacion d,2003-05-01,31,15,31,15,46
40202,SANTUARIO DE QUILLACAS,estado nutricional en menores de 5 anos,clasificacion d,2003-05-01,6,11,6,11,17
20902,SAPAHAQUI,estado nutricional en menores de 5 anos,clasificacion d,2003-05-01,29,41,29,41,70
90303,SENA,estado nutricional en menores de 5 anos,clasificacion d,2003-05-01,7,4,7,4,11
21301,SICA SICA (VILLA AROMA),estado nutricional en menores de 5 anos,clasificacion d,2003-05-01,86,73,86,73,159
30703,SICAYA,estado nutricional en menores de 5 anos,clasificacion d,2003-05-01,8,7,8,7,15
30902,SIPE SIPE,estado nutricional en menores de 5 anos,clasificacion d,2003-05-01,114,87,114,87,201
10403,SOPACHUY,estado nutricional en menores de 5 anos,clasificacion d,2003-05-01,43,98,43,98,141
20601,SORATA,estado nutricional en menores de 5 anos,clasificacion d,2003-05-01,59,114,59,114,173
10101,SUCRE,estado nutricional en menores de 5 anos,clasificacion d,2003-05-01,520,727,520,727,1247
20603,TACACOMA,estado nutricional en menores de 5 anos,clasificacion d,2003-05-01,14,28,14,28,42
50303,TACOBAMBA,estado nutricional en menores de 5 anos,clasificacion d,2003-05-01,84,112,84,112,196
30602,TACOPAYA,estado nutricional en menores de 5 anos,clasificacion d,2003-05-01,103,127,103,127,230
51402,TAHUA,estado nutricional en menores de 5 anos,clasificacion d,2003-05-01,10,6,10,6,16
31101,TAPACARI,estado nutricional en menores de 5 anos,clasificacion d,2003-05-01,173,184,173,184,357
10601,TARABUCO,estado nutricional en menores de 5 anos,clasificacion d,2003-05-01,331,513,331,513,844
30401,TARATA,estado nutricional en menores de 5 anos,clasificacion d,2003-05-01,10,263,10,263,273
60101,TARIJA,estado nutricional en menores de 5 anos,clasificacion d,2003-05-01,262,275,262,275,537
10202,TARVITA,estado nutricional en menores de 5 anos,clasificacion d,2003-05-01,140,227,140,227,367
20803,TIAWANACU,estado nutricional en menores de 5 anos,clasificacion d,2003-05-01,28,34,28,34,62
50102,TINGUIPAYA,estado nutricional en menores de 5 anos,clasificacion d,2003-05-01,81,215,81,215,296
20606,TIPUANI,estado nutricional en menores de 5 anos,clasificacion d,2003-05-01,18,13,18,13,31
30903,TIQUIPAYA,estado nutricional en menores de 5 anos,clasificacion d,2003-05-01,111,56,111,56,167
31601,TIRAQUE (CBBA),estado nutricional en menores de 5 anos,clasificacion d,2003-05-01,62,60,62,60,122
21703,TITO YUPANQUI (PARQUIPUJIO),estado nutricional en menores de 5 anos,clasificacion d,2003-05-01,4,18,4,18,22
30802,TOCO,estado nutricional en menores de 5 anos,clasificacion d,2003-05-01,12,11,12,11,23
41502,TODOS SANTOS,estado nutricional en menores de 5 anos,clasificacion d,2003-05-01,0,1,0,1,1
30803,TOLATA,estado nutricional en menores de 5 anos,clasificacion d,2003-05-01,16,22,16,22,38
41001,TOLEDO,estado nutricional en menores de 5 anos,clasificacion d,2003-05-01,5,6,5,6,11
51202,TOMAVE,estado nutricional en menores de 5 anos,clasificacion d,2003-05-01,65,130,65,130,195
10402,TOMINA,estado nutricional en menores de 5 anos,clasificacion d,2003-05-01,120,274,120,274,394
50502,TORO TORO,estado nutricional en menores de 5 anos,clasificacion d,2003-05-01,106,143,106,143,249
31201,TOTORA(CBBA),estado nutricional en menores de 5 anos,clasificacion d,2003-05-01,58,44,58,44,102
41301,TOTORA(ORR),estado nutricional en menores de 5 anos,clasificacion d,2003-05-01,28,39,28,39,67
70802,TRIGAL,estado nutricional en menores de 5 anos,clasificacion d,2003-05-01,6,3,6,3,9
80101,TRINIDAD,estado nutricional en menores de 5 anos,clasificacion d,2003-05-01,100,154,100,154,254
50801,TUPIZA,estado nutricional en menores de 5 anos,clasificacion d,2003-05-01,100,454,100,454,554
40402,TURCO,estado nutricional en menores de 5 anos,clasificacion d,2003-05-01,8,16,8,16,24
21302,UMALA,estado nutricional en menores de 5 anos,clasificacion d,2003-05-01,7,6,7,6,13
50201,UNCIA,estado nutricional en menores de 5 anos,clasificacion d,2003-05-01,52,44,52,44,96
60401,URIONDO (A. CONCEPCION),estado nutricional en menores de 5 anos,clasificacion d,2003-05-01,20,28,20,28,48
71502,URUBICHA,estado nutricional en menores de 5 anos,clasificacion d,2003-05-01,8,6,8,6,14
51201,UYUNI,estado nutricional en menores de 5 anos,clasificacion d,2003-05-01,86,145,86,145,231
70801,VALLEGRANDE,estado nutricional en menores de 5 anos,clasificacion d,2003-05-01,81,81,81,81,162
20801,VIACHA,estado nutricional en menores de 5 anos,clasificacion d,2003-05-01,145,190,145,190,335
31302,VILA VILA,estado nutricional en menores de 5 anos,clasificacion d,2003-05-01,43,73,43,73,116
60303,VILLA MONTES,estado nutricional en menores de 5 anos,clasificacion d,2003-05-01,65,61,65,61,126
10801,VILLA SERRANO,estado nutricional en menores de 5 anos,clasificacion d,2003-05-01,137,264,137,264,401
31003,VILLA TUNARI,estado nutricional en menores de 5 anos,clasificacion d,2003-05-01,118,131,118,131,249
11001,VILLA VACA GUZMAN (MUYUPAMPA),estado nutricional en menores de 5 anos,clasificacion d,2003-05-01,50,108,50,108,158
51501,VILLAZON,estado nutricional en menores de 5 anos,clasificacion d,2003-05-01,102,113,102,113,215
50602,VITICHI,estado nutricional en menores de 5 anos,clasificacion d,2003-05-01,110,219,110,219,329
20306,WALDO BALLIVIAN,estado nutricional en menores de 5 anos,clasificacion d,2003-05-01,3,1,3,1,4
70201,WARNES,estado nutricional en menores de 5 anos,clasificacion d,2003-05-01,7,5,7,5,12
20903,YACO,estado nutricional en menores de 5 anos,clasificacion d,2003-05-01,20,41,20,41,61
60301,YACUIBA,estado nutricional en menores de 5 anos,clasificacion d,2003-05-01,83,83,83,83,166
10602,YAMPARAEZ,estado nutricional en menores de 5 anos,clasificacion d,2003-05-01,153,301,153,301,454
21103,YANACACHI,estado nutricional en menores de 5 anos,clasificacion d,2003-05-01,17,29,17,29,46
70403,YAPACANI,estado nutricional en menores de 5 anos,clasificacion d,2003-05-01,102,172,102,172,274
50103,YOCALLA,estado nutricional en menores de 5 anos,clasificacion d,2003-05-01,28,69,28,69,97
10102,YOTALA,estado nutricional en menores de 5 anos,clasificacion d,2003-05-01,88,201,88,201,289
60402,YUNCHARA,estado nutricional en menores de 5 anos,clasificacion d,2003-05-01,23,30,23,30,53
10301,ZUDAÃ‘EZ,estado nutricional en menores de 5 anos,clasificacion d,2003-05-01,76,137,76,137,213
51302,ACACIO,estado nutricional en menores de 5 anos,clasificacion d,2003-06-01,54,130,54,130,184
20201,ACHACACHI,estado nutricional en menores de 5 anos,clasificacion d,2003-06-01,94,152,94,152,246
20104,ACHOCALLA,estado nutricional en menores de 5 anos,clasificacion d,2003-06-01,22,33,22,33,55
30201,AIQUILE,estado nutricional en menores de 5 anos,clasificacion d,2003-06-01,47,60,47,60,107
31303,ALALAY,estado nutricional en menores de 5 anos,clasificacion d,2003-06-01,9,15,9,15,24
10404,ALCALA,estado nutricional en menores de 5 anos,clasificacion d,2003-06-01,33,65,33,65,98
20202,ANCORAIMES,estado nutricional en menores de 5 anos,clasificacion d,2003-06-01,56,85,56,85,141
41201,ANDAMARCA,estado nutricional en menores de 5 anos,clasificacion d,2003-06-01,12,21,12,21,33
30402,ANZALDO,estado nutricional en menores de 5 anos,clasificacion d,2003-06-01,17,64,17,64,81
20701,APOLO,estado nutricional en menores de 5 anos,clasificacion d,2003-06-01,24,35,24,35,59
51301,ARAMPAMPA,estado nutricional en menores de 5 anos,clasificacion d,2003-06-01,47,121,47,121,168
30501,ARANI,estado nutricional en menores de 5 anos,clasificacion d,2003-06-01,10,33,10,33,43
30403,ARBIETO,estado nutricional en menores de 5 anos,clasificacion d,2003-06-01,10,6,10,6,16
30601,ARQUE,estado nutricional en menores de 5 anos,clasificacion d,2003-06-01,50,63,50,63,113
71501,ASCENCION DE GUARAYOS,estado nutricional en menores de 5 anos,clasificacion d,2003-06-01,179,266,179,266,445
50802,ATOCHA,estado nutricional en menores de 5 anos,clasificacion d,2003-06-01,12,103,12,103,115
20503,AUCAPATA,estado nutricional en menores de 5 anos,clasificacion d,2003-06-01,40,66,40,66,106
20502,AYATA,estado nutricional en menores de 5 anos,clasificacion d,2003-06-01,28,17,28,17,45
21303,AYO AYO,estado nutricional en menores de 5 anos,clasificacion d,2003-06-01,26,21,26,21,47
30301,AYOPAYA (V. DE INDEPENDENCIA),estado nutricional en menores de 5 anos,clasificacion d,2003-06-01,56,93,56,93,149
10201,AZURDUY,estado nutricional en menores de 5 anos,clasificacion d,2003-06-01,109,227,109,227,336
21203,BATALLAS,estado nutricional en menores de 5 anos,clasificacion d,2003-06-01,31,53,31,53,84
80802,BAURES,estado nutricional en menores de 5 anos,clasificacion d,2003-06-01,25,21,25,21,46
41202,BELEN DE ANDAMARCA,estado nutricional en menores de 5 anos,clasificacion d,2003-06-01,3,5,3,5,8
50104,BELEN DE URMIRI,estado nutricional en menores de 5 anos,clasificacion d,2003-06-01,10,19,10,19,29
90104,BELLA FLOR,estado nutricional en menores de 5 anos,clasificacion d,2003-06-01,23,30,23,30,53
60202,BERMEJO,estado nutricional en menores de 5 anos,clasificacion d,2003-06-01,11,14,11,14,25
50301,BETANZOS,estado nutricional en menores de 5 anos,clasificacion d,2003-06-01,197,215,197,215,412
31501,BOLIVAR,estado nutricional en menores de 5 anos,clasificacion d,2003-06-01,61,67,61,67,128
90103,BOLPEBRA,estado nutricional en menores de 5 anos,clasificacion d,2003-06-01,11,25,11,25,36
70707,BOYUIBE,estado nutricional en menores de 5 anos,clasificacion d,2003-06-01,13,20,13,20,33
70401,BUENA VISTA,estado nutricional en menores de 5 anos,clasificacion d,2003-06-01,38,54,38,54,92
70703,CABEZAS,estado nutricional en menores de 5 anos,clasificacion d,2003-06-01,27,43,27,43,70
20905,CAIROMA,estado nutricional en menores de 5 anos,clasificacion d,2003-06-01,67,77,67,77,144
51102,"CAIZA ""D""",estado nutricional en menores de 5 anos,clasificacion d,2003-06-01,50,70,50,70,120
21003,CAJUATA,estado nutricional en menores de 5 anos,clasificacion d,2003-06-01,19,26,19,26,45
20303,CALACOTO,estado nutricional en menores de 5 anos,clasificacion d,2003-06-01,12,8,12,8,20
21304,CALAMARCA,estado nutricional en menores de 5 anos,clasificacion d,2003-06-01,158,138,158,138,296
10701,CAMARGO,estado nutricional en menores de 5 anos,clasificacion d,2003-06-01,95,130,95,130,225
10901,CAMATAQUI (C. VILLA ABECIA),estado nutricional en menores de 5 anos,clasificacion d,2003-06-01,20,24,20,24,44
70706,CAMIRI,estado nutricional en menores de 5 anos,clasificacion d,2003-06-01,97,78,97,78,175
30701,CAPINOTA,estado nutricional en menores de 5 anos,clasificacion d,2003-06-01,21,37,21,37,58
20302,CAQUIAVIRI,estado nutricional en menores de 5 anos,clasificacion d,2003-06-01,27,48,27,48,75
40102,CARACOLLO,estado nutricional en menores de 5 anos,clasificacion d,2003-06-01,53,55,53,55,108
22001,CARANAVI,estado nutricional en menores de 5 anos,clasificacion d,2003-06-01,118,135,118,135,253
41503,CARANGAS,estado nutricional en menores de 5 anos,clasificacion d,2003-06-01,0,2,0,2,2
60302,CARAPARI,estado nutricional en menores de 5 anos,clasificacion d,2003-06-01,18,39,18,39,57
50702,CARIPUYO,estado nutricional en menores de 5 anos,clasificacion d,2003-06-01,82,166,82,166,248
40201,CHALLAPATA,estado nutricional en menores de 5 anos,clasificacion d,2003-06-01,71,99,71,99,170
50302,CHAQUI,estado nutricional en menores de 5 anos,clasificacion d,2003-06-01,50,65,50,65,115
70702,CHARAGUA,estado nutricional en menores de 5 anos,clasificacion d,2003-06-01,66,96,66,96,162
20305,CHARAÃ‘A,estado nutricional en menores de 5 anos,clasificacion d,2003-06-01,4,2,4,2,6
50202,CHAYANTA,estado nutricional en menores de 5 anos,clasificacion d,2003-06-01,53,92,53,92,145
31204,CHIMORE,estado nutricional en menores de 5 anos,clasificacion d,2003-06-01,23,17,23,17,40
40302,CHOQUE COTA,estado nutricional en menores de 5 anos,clasificacion d,2003-06-01,9,11,9,11,20
21101,CHULUMANI (V. DE LA LIBERTAD),estado nutricional en menores de 5 anos,clasificacion d,2003-06-01,3,17,3,17,20
20501,CHUMA,estado nutricional en menores de 5 anos,clasificacion d,2003-06-01,26,48,26,48,74
30801,CLIZA,estado nutricional en menores de 5 anos,clasificacion d,2003-06-01,12,18,12,18,30
90101,COBIJA,estado nutricional en menores de 5 anos,clasificacion d,2003-06-01,67,68,67,68,135
30101,COCHABAMBA,estado nutricional en menores de 5 anos,clasificacion d,2003-06-01,516,422,516,422,938
40902,COIPASA,estado nutricional en menores de 5 anos,clasificacion d,2003-06-01,0,1,0,1,1
30905,COLCAPIRHUA,estado nutricional en menores de 5 anos,clasificacion d,2003-06-01,20,18,20,18,38
50901,"COLCHA ""K""",estado nutricional en menores de 5 anos,clasificacion d,2003-06-01,45,53,45,53,98
21307,COLLANA,estado nutricional en menores de 5 anos,clasificacion d,2003-06-01,2,1,2,1,3
31002,COLOMI,estado nutricional en menores de 5 anos,clasificacion d,2003-06-01,58,58,58,58,116
50401,COLQUECHACA,estado nutricional en menores de 5 anos,clasificacion d,2003-06-01,218,131,218,131,349
21306,COLQUENCHA,estado nutricional en menores de 5 anos,clasificacion d,2003-06-01,19,18,19,18,37
21004,COLQUIRI,estado nutricional en menores de 5 anos,clasificacion d,2003-06-01,81,86,81,86,167
20304,COMANCHE,estado nutricional en menores de 5 anos,clasificacion d,2003-06-01,5,5,5,5,10
71301,COMARAPA,estado nutricional en menores de 5 anos,clasificacion d,2003-06-01,36,33,36,33,69
20605,COMBAYA,estado nutricional en menores de 5 anos,clasificacion d,2003-06-01,11,18,11,18,29
71101,CONCEPCION,estado nutricional en menores de 5 anos,clasificacion d,2003-06-01,1,28,1,28,29
21701,COPACABANA,estado nutricional en menores de 5 anos,clasificacion d,2003-06-01,50,25,50,25,75
21402,CORIPATA,estado nutricional en menores de 5 anos,clasificacion d,2003-06-01,5,0,5,0,5
20301,CORO CORO,estado nutricional en menores de 5 anos,clasificacion d,2003-06-01,25,29,25,29,54
21401,COROICO,estado nutricional en menores de 5 anos,clasificacion d,2003-06-01,26,34,26,34,60
40301,CORQUE,estado nutricional en menores de 5 anos,clasificacion d,2003-06-01,21,19,21,19,40
50601,COTAGAITA,estado nutricional en menores de 5 anos,clasificacion d,2003-06-01,154,288,154,288,442
70102,COTOCA,estado nutricional en menores de 5 anos,clasificacion d,2003-06-01,17,0,17,0,17
31405,CUCHUMUELA (V. G. VILLARROEL),estado nutricional en menores de 5 anos,clasificacion d,2003-06-01,5,9,5,9,14
70704,CUEVO,estado nutricional en menores de 5 anos,clasificacion d,2003-06-01,16,22,16,22,38
10902,CULPINA,estado nutricional en menores de 5 anos,clasificacion d,2003-06-01,183,203,183,203,386
40401,CURAHUARA DE CARANGAS,estado nutricional en menores de 5 anos,clasificacion d,2003-06-01,6,21,6,21,27
21602,CURVA,estado nutricional en menores de 5 anos,clasificacion d,2003-06-01,16,19,16,19,35
20804,DESAGUADERO,estado nutricional en menores de 5 anos,clasificacion d,2003-06-01,10,10,10,10,20
20105,EL ALTO,estado nutricional en menores de 5 anos,clasificacion d,2003-06-01,1760,1262,1760,1262,3022
40103,EL CHORO,estado nutricional en menores de 5 anos,clasificacion d,2003-06-01,2,7,2,7,9
71503,EL PUENTE(STC),estado nutricional en menores de 5 anos,clasificacion d,2003-06-01,13,98,13,98,111
60502,EL PUENTE(TJA),estado nutricional en menores de 5 anos,clasificacion d,2003-06-01,29,41,29,41,70
70105,EL TORNO,estado nutricional en menores de 5 anos,clasificacion d,2003-06-01,55,43,55,43,98
10405,EL VILLAR,estado nutricional en menores de 5 anos,clasificacion d,2003-06-01,36,122,36,122,158
60601,ENTRE RIOS,estado nutricional en menores de 5 anos,clasificacion d,2003-06-01,36,81,36,81,117
41101,EUCALIPTUS,estado nutricional en menores de 5 anos,clasificacion d,2003-06-01,27,40,27,40,67
90503,EUREKA (SANTOS MERCADO),estado nutricional en menores de 5 anos,clasificacion d,2003-06-01,0,2,0,2,2
80402,EXALTACION,estado nutricional en menores de 5 anos,clasificacion d,2003-06-01,0,31,0,31,31
90203,FILADELFIA,estado nutricional en menores de 5 anos,clasificacion d,2003-06-01,5,12,5,12,17
71002,GENERAL SAAVEDRA,estado nutricional en menores de 5 anos,clasificacion d,2003-06-01,86,134,86,134,220
21601,GRAL. J.J. PEREZ (CHARAZANI),estado nutricional en menores de 5 anos,clasificacion d,2003-06-01,42,92,42,92,134
20602,GUANAY,estado nutricional en menores de 5 anos,clasificacion d,2003-06-01,119,123,119,123,242
20802,GUAQUI,estado nutricional en menores de 5 anos,clasificacion d,2003-06-01,13,7,13,7,20
80202,GUAYARAMERIN,estado nutricional en menores de 5 anos,clasificacion d,2003-06-01,146,114,146,114,260
70705,GUTIERREZ,estado nutricional en menores de 5 anos,clasificacion d,2003-06-01,108,187,108,187,295
10502,HUACARETA,estado nutricional en menores de 5 anos,clasificacion d,2003-06-01,35,46,35,46,81
11002,HUACAYA (VILLA DE HUACAYA),estado nutricional en menores de 5 anos,clasificacion d,2003-06-01,5,10,5,10,15
40501,HUACHACALLA,estado nutricional en menores de 5 anos,clasificacion d,2003-06-01,6,3,6,3,9
40701,HUANUNI,estado nutricional en menores de 5 anos,clasificacion d,2003-06-01,80,84,80,84,164
80803,HUARACAJE,estado nutricional en menores de 5 anos,clasificacion d,2003-06-01,2,2,2,2,4
41601,HUAYLLAMARCA,estado nutricional en menores de 5 anos,clasificacion d,2003-06-01,21,21,21,21,42
21005,ICHOCA,estado nutricional en menores de 5 anos,clasificacion d,2003-06-01,17,30,17,30,47
10304,ICLA,estado nutricional en menores de 5 anos,clasificacion d,2003-06-01,114,208,114,208,322
10703,INCAHUASI,estado nutricional en menores de 5 anos,clasificacion d,2003-06-01,125,131,125,131,256
90402,INGAVI (HUMAITA),estado nutricional en menores de 5 anos,clasificacion d,2003-06-01,0,2,0,2,2
21001,INQUISIVI,estado nutricional en menores de 5 anos,clasificacion d,2003-06-01,78,116,78,116,194
21102,IRUPANA (VILLA DE LANZA),estado nutricional en menores de 5 anos,clasificacion d,2003-06-01,43,63,43,63,106
21501,IXIAMAS,estado nutricional en menores de 5 anos,clasificacion d,2003-06-01,33,30,33,30,63
21105,LA ASUNTA,estado nutricional en menores de 5 anos,clasificacion d,2003-06-01,54,48,54,48,102
70104,LA GUARDIA,estado nutricional en menores de 5 anos,clasificacion d,2003-06-01,47,47,47,47,94
20101,LA PAZ,estado nutricional en menores de 5 anos,clasificacion d,2003-06-01,1350,1162,1350,1162,2512
41501,LA RIVERA,estado nutricional en menores de 5 anos,clasificacion d,2003-06-01,1,0,1,0,1
70701,LAGUNILLAS,estado nutricional en menores de 5 anos,clasificacion d,2003-06-01,23,24,23,24,47
21202,LAJA,estado nutricional en menores de 5 anos,clasificacion d,2003-06-01,27,37,27,37,64
10903,LAS CARRERAS,estado nutricional en menores de 5 anos,clasificacion d,2003-06-01,11,38,11,38,49
21006,LICOMA PAMPA,estado nutricional en menores de 5 anos,clasificacion d,2003-06-01,2,47,2,47,49
50203,LLALLAGUA,estado nutricional en menores de 5 anos,clasificacion d,2003-06-01,16,370,16,370,386
51401,LLICA,estado nutricional en menores de 5 anos,clasificacion d,2003-06-01,12,7,12,7,19
80601,LORETO,estado nutricional en menores de 5 anos,clasificacion d,2003-06-01,3,11,3,11,14
20901,LURIBAY,estado nutricional en menores de 5 anos,clasificacion d,2003-06-01,60,53,60,53,113
40702,MACHACAMARCA,estado nutricional en menores de 5 anos,clasificacion d,2003-06-01,23,21,23,21,44
11003,MACHARETI,estado nutricional en menores de 5 anos,clasificacion d,2003-06-01,30,65,30,65,95
80801,MAGDALENA,estado nutricional en menores de 5 anos,clasificacion d,2003-06-01,26,38,26,38,64
70903,MAIRANA,estado nutricional en menores de 5 anos,clasificacion d,2003-06-01,28,19,28,19,47
20904,MALLA,estado nutricional en menores de 5 anos,clasificacion d,2003-06-01,11,12,11,12,23
20103,MECAPACA,estado nutricional en menores de 5 anos,clasificacion d,2003-06-01,15,28,15,28,43
71003,MINEROS,estado nutricional en menores de 5 anos,clasificacion d,2003-06-01,135,72,135,72,207
31301,MIZQUE,estado nutricional en menores de 5 anos,clasificacion d,2003-06-01,21,50,21,50,71
20402,MOCOMOCO,estado nutricional en menores de 5 anos,clasificacion d,2003-06-01,41,91,41,91,132
51002,MOJINETE,estado nutricional en menores de 5 anos,clasificacion d,2003-06-01,5,11,5,11,16
10303,MOJOCOYA,estado nutricional en menores de 5 anos,clasificacion d,2003-06-01,65,102,65,102,167
10501,MONTEAGUDO,estado nutricional en menores de 5 anos,clasificacion d,2003-06-01,111,155,111,155,266
71001,MONTERO,estado nutricional en menores de 5 anos,clasificacion d,2003-06-01,327,206,327,206,533
70803,MORO MORO,estado nutricional en menores de 5 anos,clasificacion d,2003-06-01,11,10,11,10,21
30302,MOROCHATA,estado nutricional en menores de 5 anos,clasificacion d,2003-06-01,100,144,100,144,244
90401,NACEBE (SANTA ROSA DEL ABUNA),estado nutricional en menores de 5 anos,clasificacion d,2003-06-01,3,7,3,7,10
50404,OCURI,estado nutricional en menores de 5 anos,clasificacion d,2003-06-01,67,119,67,119,186
30203,OMEREQUE,estado nutricional en menores de 5 anos,clasificacion d,2003-06-01,11,32,11,32,43
40101,ORURO,estado nutricional en menores de 5 anos,clasificacion d,2003-06-01,590,644,590,644,1234
60201,PADCAYA,estado nutricional en menores de 5 anos,clasificacion d,2003-06-01,69,130,69,130,199
10401,PADILLA,estado nutricional en menores de 5 anos,clasificacion d,2003-06-01,115,215,115,215,330
70502,PAILON,estado nutricional en menores de 5 anos,clasificacion d,2003-06-01,9,22,9,22,31
20102,PALCA,estado nutricional en menores de 5 anos,clasificacion d,2003-06-01,33,41,33,41,74
21104,PALOS BLANCOS,estado nutricional en menores de 5 anos,clasificacion d,2003-06-01,79,106,79,106,185
40802,PAMPA AULLAGAS,estado nutricional en menores de 5 anos,clasificacion d,2003-06-01,12,13,12,13,25
70902,PAMPA GRANDE,estado nutricional en menores de 5 anos,clasificacion d,2003-06-01,14,10,14,10,24
21802,PAPEL PAMPA,estado nutricional en menores de 5 anos,clasificacion d,2003-06-01,8,15,8,15,23
30202,PASORAPA,estado nutricional en menores de 5 anos,clasificacion d,2003-06-01,20,28,20,28,48
21305,PATACAMAYA,estado nutricional en menores de 5 anos,clasificacion d,2003-06-01,132,81,132,81,213
40602,PAZÃ‘A,estado nutricional en menores de 5 anos,clasificacion d,2003-06-01,16,8,16,8,24
20702,PELECHUCO,estado nutricional en menores de 5 anos,clasificacion d,2003-06-01,31,50,31,50,81
50403,POCOATA,estado nutricional en menores de 5 anos,clasificacion d,2003-06-01,175,242,175,242,417
31203,POCONA,estado nutricional en menores de 5 anos,clasificacion d,2003-06-01,40,32,40,32,72
31202,POJO (CBBA),estado nutricional en menores de 5 anos,clasificacion d,2003-06-01,82,100,82,100,182
40601,POOPO,estado nutricional en menores de 5 anos,clasificacion d,2003-06-01,6,25,6,25,31
51203,PORCO,estado nutricional en menores de 5 anos,clasificacion d,2003-06-01,19,20,19,20,39
10103,POROMA,estado nutricional en menores de 5 anos,clasificacion d,2003-06-01,282,299,282,299,581
70103,PORONGO,estado nutricional en menores de 5 anos,clasificacion d,2003-06-01,17,19,17,19,36
70601,PORTACHUELO,estado nutricional en menores de 5 anos,clasificacion d,2003-06-01,41,55,41,55,96
90102,PORVENIR,estado nutricional en menores de 5 anos,clasificacion d,2003-06-01,10,12,10,12,22
70804,POSTRER VALLE,estado nutricional en menores de 5 anos,clasificacion d,2003-06-01,5,8,5,8,13
50101,POTOSI,estado nutricional en menores de 5 anos,clasificacion d,2003-06-01,644,510,644,510,1154
10302,PRESTO,estado nutricional en menores de 5 anos,clasificacion d,2003-06-01,62,91,62,91,153
70805,PUCARA,estado nutricional en menores de 5 anos,clasificacion d,2003-06-01,1,0,1,0,1
21201,PUCARANI,estado nutricional en menores de 5 anos,clasificacion d,2003-06-01,64,84,64,84,148
20401,PUERTO ACOSTA,estado nutricional en menores de 5 anos,clasificacion d,2003-06-01,70,61,70,61,131
20403,PUERTO CARABUCO,estado nutricional en menores de 5 anos,clasificacion d,2003-06-01,28,59,28,59,87
90301,PUERTO GONZALO MORENO,estado nutricional en menores de 5 anos,clasificacion d,2003-06-01,10,7,10,7,17
21204,PUERTO PEREZ,estado nutricional en menores de 5 anos,clasificacion d,2003-06-01,25,23,25,23,48
71402,PUERTO QUIJARRO,estado nutricional en menores de 5 anos,clasificacion d,2003-06-01,42,17,42,17,59
90201,PUERTO RICO,estado nutricional en menores de 5 anos,clasificacion d,2003-06-01,0,16,0,16,16
80703,PUERTO SILES,estado nutricional en menores de 5 anos,clasificacion d,2003-06-01,14,66,14,66,80
71401,PUERTO SUAREZ,estado nutricional en menores de 5 anos,clasificacion d,2003-06-01,39,13,39,13,52
31205,PUERTO VILLARROEL,estado nutricional en menores de 5 anos,clasificacion d,2003-06-01,148,140,148,140,288
51101,PUNA,estado nutricional en menores de 5 anos,clasificacion d,2003-06-01,81,53,81,53,134
31401,PUNATA,estado nutricional en menores de 5 anos,clasificacion d,2003-06-01,40,20,40,20,60
20604,QUIABAYA,estado nutricional en menores de 5 anos,clasificacion d,2003-06-01,8,27,8,27,35
30901,QUILLACOLLO,estado nutricional en menores de 5 anos,clasificacion d,2003-06-01,87,96,87,96,183
21002,QUIME,estado nutricional en menores de 5 anos,clasificacion d,2003-06-01,82,97,82,97,179
70904,QUIRUSILLAS,estado nutricional en menores de 5 anos,clasificacion d,2003-06-01,3,2,3,2,5
50402,RAVELO,estado nutricional en menores de 5 anos,clasificacion d,2003-06-01,222,259,222,259,481
80301,REYES,estado nutricional en menores de 5 anos,clasificacion d,2003-06-01,2,16,2,16,18
80201,RIBERALTA,estado nutricional en menores de 5 anos,clasificacion d,2003-06-01,391,332,391,332,723
70503,ROBORE,estado nutricional en menores de 5 anos,clasificacion d,2003-06-01,27,22,27,22,49
80304,RURRENABAQUE,estado nutricional en menores de 5 anos,clasificacion d,2003-06-01,36,37,36,37,73
40901,SABAYA,estado nutricional en menores de 5 anos,clasificacion d,2003-06-01,4,7,4,7,11
31001,SACABA,estado nutricional en menores de 5 anos,clasificacion d,2003-06-01,61,36,61,36,97
30404,SACABAMBA,estado nutricional en menores de 5 anos,clasificacion d,2003-06-01,7,21,7,21,28
50701,SACACA,estado nutricional en menores de 5 anos,clasificacion d,2003-06-01,296,593,296,593,889
71302,SAIPINA,estado nutricional en menores de 5 anos,clasificacion d,2003-06-01,15,29,15,29,44
40801,SALINAS DE GARCI MENDOZA,estado nutricional en menores de 5 anos,clasificacion d,2003-06-01,11,11,11,11,22
70901,SAMAIPATA,estado nutricional en menores de 5 anos,clasificacion d,2003-06-01,14,15,14,15,29
51601,SAN AGUSTIN,estado nutricional en menores de 5 anos,clasificacion d,2003-06-01,5,3,5,3,8
80602,SAN ANDRES,estado nutricional en menores de 5 anos,clasificacion d,2003-06-01,9,5,9,5,14
51003,SAN ANTONIO DE ESMORUCO,estado nutricional en menores de 5 anos,clasificacion d,2003-06-01,0,4,0,4,4
71105,SAN ANTONIO DE LOMERIO,estado nutricional en menores de 5 anos,clasificacion d,2003-06-01,67,114,67,114,181
31403,SAN BENITO,estado nutricional en menores de 5 anos,clasificacion d,2003-06-01,19,27,19,27,46
80302,SAN BORJA,estado nutricional en menores de 5 anos,clasificacion d,2003-06-01,164,144,164,144,308
21502,SAN BUENA VENTURA,estado nutricional en menores de 5 anos,clasificacion d,2003-06-01,34,37,34,37,71
70402,SAN CARLOS,estado nutricional en menores de 5 anos,clasificacion d,2003-06-01,70,98,70,98,168
80501,SAN IGNACIO,estado nutricional en menores de 5 anos,clasificacion d,2003-06-01,67,74,67,74,141
70301,SAN IGNACIO DE VELASCO,estado nutricional en menores de 5 anos,clasificacion d,2003-06-01,213,153,213,153,366
80102,SAN JAVIER(BNI),estado nutricional en menores de 5 anos,clasificacion d,2003-06-01,6,12,6,12,18
71102,SAN JAVIER(STC),estado nutricional en menores de 5 anos,clasificacion d,2003-06-01,40,50,40,50,90
80701,SAN JOAQUIN,estado nutricional en menores de 5 anos,clasificacion d,2003-06-01,7,15,7,15,22
70501,SAN JOSE DE CHIQUITOS,estado nutricional en menores de 5 anos,clasificacion d,2003-06-01,47,15,47,15,62
71104,SAN JULIAN,estado nutricional en menores de 5 anos,clasificacion d,2003-06-01,135,139,135,139,274
90302,SAN LORENZO(PND),estado nutricional en menores de 5 anos,clasificacion d,2003-06-01,4,9,4,9,13
60501,SAN LORENZO(TJA),estado nutricional en menores de 5 anos,clasificacion d,2003-06-01,31,102,31,102,133
10702,SAN LUCAS,estado nutricional en menores de 5 anos,clasificacion d,2003-06-01,327,342,327,342,669
71201,SAN MATIAS,estado nutricional en menores de 5 anos,clasificacion d,2003-06-01,56,33,56,33,89
70302,SAN MIGUEL DE VELASCO,estado nutricional en menores de 5 anos,clasificacion d,2003-06-01,34,42,34,42,76
51001,SAN PABLO DE LIPEZ,estado nutricional en menores de 5 anos,clasificacion d,2003-06-01,4,8,4,8,12
50501,SAN PEDRO DE BUENA VISTA,estado nutricional en menores de 5 anos,clasificacion d,2003-06-01,133,331,133,331,464
21801,SAN PEDRO DE CURAHUARA,estado nutricional en menores de 5 anos,clasificacion d,2003-06-01,18,39,18,39,57
50902,SAN PEDRO DE QUEMES,estado nutricional en menores de 5 anos,clasificacion d,2003-06-01,1,4,1,4,5
21702,SAN PEDRO DE TIQUINA,estado nutricional en menores de 5 anos,clasificacion d,2003-06-01,5,12,5,12,17
70303,SAN RAFAEL,estado nutricional en menores de 5 anos,clasificacion d,2003-06-01,35,39,35,39,74
80702,SAN RAMON,estado nutricional en menores de 5 anos,clasificacion d,2003-06-01,7,10,7,10,17
70101,SANTA CRUZ DE LA SIERRA,estado nutricional en menores de 5 anos,clasificacion d,2003-06-01,674,440,674,440,1114
80303,SANTA ROSA,estado nutricional en menores de 5 anos,clasificacion d,2003-06-01,12,3,12,3,15
70602,SANTA ROSA DEL SARA,estado nutricional en menores de 5 anos,clasificacion d,2003-06-01,8,21,8,21,29
20308,SANTIAGO DE CALLAPA,estado nutricional en menores de 5 anos,clasificacion d,2003-06-01,19,27,19,27,46
41401,SANTIAGO DE HUARI,estado nutricional en menores de 5 anos,clasificacion d,2003-06-01,19,34,19,34,53
21901,SANTIAGO DE MACHACA,estado nutricional en menores de 5 anos,clasificacion d,2003-06-01,5,7,5,7,12
30702,SANTIVAÃ‘ES,estado nutricional en menores de 5 anos,clasificacion d,2003-06-01,18,19,18,19,37
40202,SANTUARIO DE QUILLACAS,estado nutricional en menores de 5 anos,clasificacion d,2003-06-01,9,13,9,13,22
20902,SAPAHAQUI,estado nutricional en menores de 5 anos,clasificacion d,2003-06-01,40,66,40,66,106
90303,SENA,estado nutricional en menores de 5 anos,clasificacion d,2003-06-01,12,3,12,3,15
21301,SICA SICA (VILLA AROMA),estado nutricional en menores de 5 anos,clasificacion d,2003-06-01,136,77,136,77,213
30703,SICAYA,estado nutricional en menores de 5 anos,clasificacion d,2003-06-01,13,6,13,6,19
30902,SIPE SIPE,estado nutricional en menores de 5 anos,clasificacion d,2003-06-01,126,103,126,103,229
10403,SOPACHUY,estado nutricional en menores de 5 anos,clasificacion d,2003-06-01,70,87,70,87,157
20601,SORATA,estado nutricional en menores de 5 anos,clasificacion d,2003-06-01,58,94,58,94,152
10101,SUCRE,estado nutricional en menores de 5 anos,clasificacion d,2003-06-01,580,740,580,740,1320
31404,TACACHI,estado nutricional en menores de 5 anos,clasificacion d,2003-06-01,1,6,1,6,7
20603,TACACOMA,estado nutricional en menores de 5 anos,clasificacion d,2003-06-01,40,100,40,100,140
50303,TACOBAMBA,estado nutricional en menores de 5 anos,clasificacion d,2003-06-01,67,113,67,113,180
30602,TACOPAYA,estado nutricional en menores de 5 anos,clasificacion d,2003-06-01,75,133,75,133,208
51402,TAHUA,estado nutricional en menores de 5 anos,clasificacion d,2003-06-01,6,3,6,3,9
31101,TAPACARI,estado nutricional en menores de 5 anos,clasificacion d,2003-06-01,104,193,104,193,297
10601,TARABUCO,estado nutricional en menores de 5 anos,clasificacion d,2003-06-01,346,550,346,550,896
30401,TARATA,estado nutricional en menores de 5 anos,clasificacion d,2003-06-01,34,26,34,26,60
60101,TARIJA,estado nutricional en menores de 5 anos,clasificacion d,2003-06-01,224,284,224,284,508
10202,TARVITA,estado nutricional en menores de 5 anos,clasificacion d,2003-06-01,71,169,71,169,240
20803,TIAWANACU,estado nutricional en menores de 5 anos,clasificacion d,2003-06-01,44,27,44,27,71
50102,TINGUIPAYA,estado nutricional en menores de 5 anos,clasificacion d,2003-06-01,91,280,91,280,371
20606,TIPUANI,estado nutricional en menores de 5 anos,clasificacion d,2003-06-01,18,8,18,8,26
30903,TIQUIPAYA,estado nutricional en menores de 5 anos,clasificacion d,2003-06-01,73,47,73,47,120
31601,TIRAQUE (CBBA),estado nutricional en menores de 5 anos,clasificacion d,2003-06-01,131,160,131,160,291
21703,TITO YUPANQUI (PARQUIPUJIO),estado nutricional en menores de 5 anos,clasificacion d,2003-06-01,11,6,11,6,17
30802,TOCO,estado nutricional en menores de 5 anos,clasificacion d,2003-06-01,0,5,0,5,5
30803,TOLATA,estado nutricional en menores de 5 anos,clasificacion d,2003-06-01,0,7,0,7,7
41001,TOLEDO,estado nutricional en menores de 5 anos,clasificacion d,2003-06-01,2,1,2,1,3
51202,TOMAVE,estado nutricional en menores de 5 anos,clasificacion d,2003-06-01,45,124,45,124,169
10402,TOMINA,estado nutricional en menores de 5 anos,clasificacion d,2003-06-01,109,207,109,207,316
50502,TORO TORO,estado nutricional en menores de 5 anos,clasificacion d,2003-06-01,102,121,102,121,223
31201,TOTORA(CBBA),estado nutricional en menores de 5 anos,clasificacion d,2003-06-01,68,57,68,57,125
41301,TOTORA(ORR),estado nutricional en menores de 5 anos,clasificacion d,2003-06-01,28,49,28,49,77
70802,TRIGAL,estado nutricional en menores de 5 anos,clasificacion d,2003-06-01,4,5,4,5,9
80101,TRINIDAD,estado nutricional en menores de 5 anos,clasificacion d,2003-06-01,148,175,148,175,323
50801,TUPIZA,estado nutricional en menores de 5 anos,clasificacion d,2003-06-01,111,185,111,185,296
40402,TURCO,estado nutricional en menores de 5 anos,clasificacion d,2003-06-01,15,33,15,33,48
21302,UMALA,estado nutricional en menores de 5 anos,clasificacion d,2003-06-01,13,2,13,2,15
50201,UNCIA,estado nutricional en menores de 5 anos,clasificacion d,2003-06-01,12,14,12,14,26
60401,URIONDO (A. CONCEPCION),estado nutricional en menores de 5 anos,clasificacion d,2003-06-01,47,59,47,59,106
71502,URUBICHA,estado nutricional en menores de 5 anos,clasificacion d,2003-06-01,91,164,91,164,255
51201,UYUNI,estado nutricional en menores de 5 anos,clasificacion d,2003-06-01,67,96,67,96,163
30502,VACAS,estado nutricional en menores de 5 anos,clasificacion d,2003-06-01,40,26,40,26,66
70801,VALLEGRANDE,estado nutricional en menores de 5 anos,clasificacion d,2003-06-01,71,61,71,61,132
20801,VIACHA,estado nutricional en menores de 5 anos,clasificacion d,2003-06-01,100,121,100,121,221
31302,VILA VILA,estado nutricional en menores de 5 anos,clasificacion d,2003-06-01,24,52,24,52,76
60303,VILLA MONTES,estado nutricional en menores de 5 anos,clasificacion d,2003-06-01,30,34,30,34,64
31402,VILLA RIVERO,estado nutricional en menores de 5 anos,clasificacion d,2003-06-01,16,16,16,16,32
10801,VILLA SERRANO,estado nutricional en menores de 5 anos,clasificacion d,2003-06-01,108,188,108,188,296
31003,VILLA TUNARI,estado nutricional en menores de 5 anos,clasificacion d,2003-06-01,142,147,142,147,289
11001,VILLA VACA GUZMAN (MUYUPAMPA),estado nutricional en menores de 5 anos,clasificacion d,2003-06-01,50,72,50,72,122
51501,VILLAZON,estado nutricional en menores de 5 anos,clasificacion d,2003-06-01,177,203,177,203,380
30904,VINTO,estado nutricional en menores de 5 anos,clasificacion d,2003-06-01,8,3,8,3,11
50602,VITICHI,estado nutricional en menores de 5 anos,clasificacion d,2003-06-01,109,150,109,150,259
20306,WALDO BALLIVIAN,estado nutricional en menores de 5 anos,clasificacion d,2003-06-01,1,2,1,2,3
20903,YACO,estado nutricional en menores de 5 anos,clasificacion d,2003-06-01,23,28,23,28,51
60301,YACUIBA,estado nutricional en menores de 5 anos,clasificacion d,2003-06-01,63,86,63,86,149
10602,YAMPARAEZ,estado nutricional en menores de 5 anos,clasificacion d,2003-06-01,150,301,150,301,451
21103,YANACACHI,estado nutricional en menores de 5 anos,clasificacion d,2003-06-01,15,21,15,21,36
70403,YAPACANI,estado nutricional en menores de 5 anos,clasificacion d,2003-06-01,107,155,107,155,262
50103,YOCALLA,estado nutricional en menores de 5 anos,clasificacion d,2003-06-01,27,50,27,50,77
10102,YOTALA,estado nutricional en menores de 5 anos,clasificacion d,2003-06-01,73,173,73,173,246
60402,YUNCHARA,estado nutricional en menores de 5 anos,clasificacion d,2003-06-01,13,29,13,29,42
10301,ZUDAÃ‘EZ,estado nutricional en menores de 5 anos,clasificacion d,2003-06-01,55,100,55,100,155
51302,ACACIO,estado nutricional en menores de 5 anos,clasificacion d,2003-07-01,72,115,72,115,187
20201,ACHACACHI,estado nutricional en menores de 5 anos,clasificacion d,2003-07-01,105,106,105,106,211
20104,ACHOCALLA,estado nutricional en menores de 5 anos,clasificacion d,2003-07-01,17,19,17,19,36
30201,AIQUILE,estado nutricional en menores de 5 anos,clasificacion d,2003-07-01,48,29,48,29,77
31303,ALALAY,estado nutricional en menores de 5 anos,clasificacion d,2003-07-01,12,22,12,22,34
10404,ALCALA,estado nutricional en menores de 5 anos,clasificacion d,2003-07-01,39,69,39,69,108
20202,ANCORAIMES,estado nutricional en menores de 5 anos,clasificacion d,2003-07-01,66,98,66,98,164
41201,ANDAMARCA,estado nutricional en menores de 5 anos,clasificacion d,2003-07-01,3,3,3,3,6
30402,ANZALDO,estado nutricional en menores de 5 anos,clasificacion d,2003-07-01,17,32,17,32,49
20701,APOLO,estado nutricional en menores de 5 anos,clasificacion d,2003-07-01,31,17,31,17,48
51301,ARAMPAMPA,estado nutricional en menores de 5 anos,clasificacion d,2003-07-01,29,85,29,85,114
30501,ARANI,estado nutricional en menores de 5 anos,clasificacion d,2003-07-01,10,27,10,27,37
30403,ARBIETO,estado nutricional en menores de 5 anos,clasificacion d,2003-07-01,10,3,10,3,13
30601,ARQUE,estado nutricional en menores de 5 anos,clasificacion d,2003-07-01,102,125,102,125,227
71501,ASCENCION DE GUARAYOS,estado nutricional en menores de 5 anos,clasificacion d,2003-07-01,4,5,4,5,9
50802,ATOCHA,estado nutricional en menores de 5 anos,clasificacion d,2003-07-01,5,199,5,199,204
20503,AUCAPATA,estado nutricional en menores de 5 anos,clasificacion d,2003-07-01,10,3,10,3,13
20502,AYATA,estado nutricional en menores de 5 anos,clasificacion d,2003-07-01,31,32,31,32,63
21303,AYO AYO,estado nutricional en menores de 5 anos,clasificacion d,2003-07-01,4,0,4,0,4
30301,AYOPAYA (V. DE INDEPENDENCIA),estado nutricional en menores de 5 anos,clasificacion d,2003-07-01,93,122,93,122,215
10201,AZURDUY,estado nutricional en menores de 5 anos,clasificacion d,2003-07-01,87,170,87,170,257
21203,BATALLAS,estado nutricional en menores de 5 anos,clasificacion d,2003-07-01,29,14,29,14,43
80802,BAURES,estado nutricional en menores de 5 anos,clasificacion d,2003-07-01,18,25,18,25,43
50104,BELEN DE URMIRI,estado nutricional en menores de 5 anos,clasificacion d,2003-07-01,8,23,8,23,31
90104,BELLA FLOR,estado nutricional en menores de 5 anos,clasificacion d,2003-07-01,20,25,20,25,45
60202,BERMEJO,estado nutricional en menores de 5 anos,clasificacion d,2003-07-01,21,31,21,31,52
50301,BETANZOS,estado nutricional en menores de 5 anos,clasificacion d,2003-07-01,246,304,246,304,550
31501,BOLIVAR,estado nutricional en menores de 5 anos,clasificacion d,2003-07-01,47,42,47,42,89
90103,BOLPEBRA,estado nutricional en menores de 5 anos,clasificacion d,2003-07-01,9,13,9,13,22
70707,BOYUIBE,estado nutricional en menores de 5 anos,clasificacion d,2003-07-01,5,11,5,11,16
70401,BUENA VISTA,estado nutricional en menores de 5 anos,clasificacion d,2003-07-01,32,57,32,57,89
70703,CABEZAS,estado nutricional en menores de 5 anos,clasificacion d,2003-07-01,12,5,12,5,17
20905,CAIROMA,estado nutricional en menores de 5 anos,clasificacion d,2003-07-01,45,34,45,34,79
51102,"CAIZA ""D""",estado nutricional en menores de 5 anos,clasificacion d,2003-07-01,99,123,99,123,222
21003,CAJUATA,estado nutricional en menores de 5 anos,clasificacion d,2003-07-01,16,12,16,12,28
20303,CALACOTO,estado nutricional en menores de 5 anos,clasificacion d,2003-07-01,15,18,15,18,33
21304,CALAMARCA,estado nutricional en menores de 5 anos,clasificacion d,2003-07-01,81,51,81,51,132
10701,CAMARGO,estado nutricional en menores de 5 anos,clasificacion d,2003-07-01,107,107,107,107,214
10901,CAMATAQUI (C. VILLA ABECIA),estado nutricional en menores de 5 anos,clasificacion d,2003-07-01,13,36,13,36,49
70706,CAMIRI,estado nutricional en menores de 5 anos,clasificacion d,2003-07-01,144,137,144,137,281
30701,CAPINOTA,estado nutricional en menores de 5 anos,clasificacion d,2003-07-01,26,24,26,24,50
20302,CAQUIAVIRI,estado nutricional en menores de 5 anos,clasificacion d,2003-07-01,49,46,49,46,95
40102,CARACOLLO,estado nutricional en menores de 5 anos,clasificacion d,2003-07-01,76,82,76,82,158
22001,CARANAVI,estado nutricional en menores de 5 anos,clasificacion d,2003-07-01,164,124,164,124,288
60302,CARAPARI,estado nutricional en menores de 5 anos,clasificacion d,2003-07-01,42,54,42,54,96
50702,CARIPUYO,estado nutricional en menores de 5 anos,clasificacion d,2003-07-01,69,122,69,122,191
21902,CATACORA,estado nutricional en menores de 5 anos,clasificacion d,2003-07-01,0,6,0,6,6
40201,CHALLAPATA,estado nutricional en menores de 5 anos,clasificacion d,2003-07-01,90,83,90,83,173
50302,CHAQUI,estado nutricional en menores de 5 anos,clasificacion d,2003-07-01,64,67,64,67,131
70702,CHARAGUA,estado nutricional en menores de 5 anos,clasificacion d,2003-07-01,99,111,99,111,210
20305,CHARAÃ‘A,estado nutricional en menores de 5 anos,clasificacion d,2003-07-01,7,13,7,13,20
50202,CHAYANTA,estado nutricional en menores de 5 anos,clasificacion d,2003-07-01,32,16,32,16,48
31204,CHIMORE,estado nutricional en menores de 5 anos,clasificacion d,2003-07-01,18,21,18,21,39
40903,CHIPAYA,estado nutricional en menores de 5 anos,clasificacion d,2003-07-01,1,0,1,0,1
21101,CHULUMANI (V. DE LA LIBERTAD),estado nutricional en menores de 5 anos,clasificacion d,2003-07-01,12,18,12,18,30
20501,CHUMA,estado nutricional en menores de 5 anos,clasificacion d,2003-07-01,27,30,27,30,57
30801,CLIZA,estado nutricional en menores de 5 anos,clasificacion d,2003-07-01,9,14,9,14,23
90101,COBIJA,estado nutricional en menores de 5 anos,clasificacion d,2003-07-01,108,118,108,118,226
30101,COCHABAMBA,estado nutricional en menores de 5 anos,clasificacion d,2003-07-01,525,371,525,371,896
30905,COLCAPIRHUA,estado nutricional en menores de 5 anos,clasificacion d,2003-07-01,25,25,25,25,50
50901,"COLCHA ""K""",estado nutricional en menores de 5 anos,clasificacion d,2003-07-01,55,53,55,53,108
21307,COLLANA,estado nutricional en menores de 5 anos,clasificacion d,2003-07-01,2,0,2,0,2
31002,COLOMI,estado nutricional en menores de 5 anos,clasificacion d,2003-07-01,69,74,69,74,143
50401,COLQUECHACA,estado nutricional en menores de 5 anos,clasificacion d,2003-07-01,224,147,224,147,371
21306,COLQUENCHA,estado nutricional en menores de 5 anos,clasificacion d,2003-07-01,19,12,19,12,31
21004,COLQUIRI,estado nutricional en menores de 5 anos,clasificacion d,2003-07-01,81,51,81,51,132
20304,COMANCHE,estado nutricional en menores de 5 anos,clasificacion d,2003-07-01,4,5,4,5,9
71301,COMARAPA,estado nutricional en menores de 5 anos,clasificacion d,2003-07-01,64,50,64,50,114
20605,COMBAYA,estado nutricional en menores de 5 anos,clasificacion d,2003-07-01,9,17,9,17,26
71101,CONCEPCION,estado nutricional en menores de 5 anos,clasificacion d,2003-07-01,12,9,12,9,21
21701,COPACABANA,estado nutricional en menores de 5 anos,clasificacion d,2003-07-01,17,20,17,20,37
20301,CORO CORO,estado nutricional en menores de 5 anos,clasificacion d,2003-07-01,34,34,34,34,68
21401,COROICO,estado nutricional en menores de 5 anos,clasificacion d,2003-07-01,18,8,18,8,26
40301,CORQUE,estado nutricional en menores de 5 anos,clasificacion d,2003-07-01,6,5,6,5,11
50601,COTAGAITA,estado nutricional en menores de 5 anos,clasificacion d,2003-07-01,72,143,72,143,215
70102,COTOCA,estado nutricional en menores de 5 anos,clasificacion d,2003-07-01,24,19,24,19,43
31405,CUCHUMUELA (V. G. VILLARROEL),estado nutricional en menores de 5 anos,clasificacion d,2003-07-01,8,9,8,9,17
70704,CUEVO,estado nutricional en menores de 5 anos,clasificacion d,2003-07-01,5,14,5,14,19
10902,CULPINA,estado nutricional en menores de 5 anos,clasificacion d,2003-07-01,163,170,163,170,333
40401,CURAHUARA DE CARANGAS,estado nutricional en menores de 5 anos,clasificacion d,2003-07-01,13,7,13,7,20
21602,CURVA,estado nutricional en menores de 5 anos,clasificacion d,2003-07-01,18,16,18,16,34
20804,DESAGUADERO,estado nutricional en menores de 5 anos,clasificacion d,2003-07-01,5,3,5,3,8
20105,EL ALTO,estado nutricional en menores de 5 anos,clasificacion d,2003-07-01,1913,1137,1913,1137,3050
40103,EL CHORO,estado nutricional en menores de 5 anos,clasificacion d,2003-07-01,1,1,1,1,2
71503,EL PUENTE(STC),estado nutricional en menores de 5 anos,clasificacion d,2003-07-01,25,147,25,147,172
60502,EL PUENTE(TJA),estado nutricional en menores de 5 anos,clasificacion d,2003-07-01,55,98,55,98,153
70105,EL TORNO,estado nutricional en menores de 5 anos,clasificacion d,2003-07-01,57,85,57,85,142
10405,EL VILLAR,estado nutricional en menores de 5 anos,clasificacion d,2003-07-01,43,121,43,121,164
60601,ENTRE RIOS,estado nutricional en menores de 5 anos,clasificacion d,2003-07-01,38,46,38,46,84
41101,EUCALIPTUS,estado nutricional en menores de 5 anos,clasificacion d,2003-07-01,14,11,14,11,25
80402,EXALTACION,estado nutricional en menores de 5 anos,clasificacion d,2003-07-01,9,14,9,14,23
90203,FILADELFIA,estado nutricional en menores de 5 anos,clasificacion d,2003-07-01,7,19,7,19,26
71002,GENERAL SAAVEDRA,estado nutricional en menores de 5 anos,clasificacion d,2003-07-01,81,141,81,141,222
21601,GRAL. J.J. PEREZ (CHARAZANI),estado nutricional en menores de 5 anos,clasificacion d,2003-07-01,39,40,39,40,79
20602,GUANAY,estado nutricional en menores de 5 anos,clasificacion d,2003-07-01,74,111,74,111,185
20802,GUAQUI,estado nutricional en menores de 5 anos,clasificacion d,2003-07-01,3,5,3,5,8
80202,GUAYARAMERIN,estado nutricional en menores de 5 anos,clasificacion d,2003-07-01,135,89,135,89,224
70705,GUTIERREZ,estado nutricional en menores de 5 anos,clasificacion d,2003-07-01,80,162,80,162,242
10502,HUACARETA,estado nutricional en menores de 5 anos,clasificacion d,2003-07-01,52,90,52,90,142
11002,HUACAYA (VILLA DE HUACAYA),estado nutricional en menores de 5 anos,clasificacion d,2003-07-01,7,18,7,18,25
40501,HUACHACALLA,estado nutricional en menores de 5 anos,clasificacion d,2003-07-01,2,1,2,1,3
40701,HUANUNI,estado nutricional en menores de 5 anos,clasificacion d,2003-07-01,40,52,40,52,92
80803,HUARACAJE,estado nutricional en menores de 5 anos,clasificacion d,2003-07-01,6,4,6,4,10
41601,HUAYLLAMARCA,estado nutricional en menores de 5 anos,clasificacion d,2003-07-01,4,16,4,16,20
21005,ICHOCA,estado nutricional en menores de 5 anos,clasificacion d,2003-07-01,23,39,23,39,62
10304,ICLA,estado nutricional en menores de 5 anos,clasificacion d,2003-07-01,122,188,122,188,310
10703,INCAHUASI,estado nutricional en menores de 5 anos,clasificacion d,2003-07-01,124,225,124,225,349
21001,INQUISIVI,estado nutricional en menores de 5 anos,clasificacion d,2003-07-01,82,80,82,80,162
21102,IRUPANA (VILLA DE LANZA),estado nutricional en menores de 5 anos,clasificacion d,2003-07-01,22,50,22,50,72
21501,IXIAMAS,estado nutricional en menores de 5 anos,clasificacion d,2003-07-01,22,20,22,20,42
21105,LA ASUNTA,estado nutricional en menores de 5 anos,clasificacion d,2003-07-01,46,62,46,62,108
70104,LA GUARDIA,estado nutricional en menores de 5 anos,clasificacion d,2003-07-01,55,38,55,38,93
20101,LA PAZ,estado nutricional en menores de 5 anos,clasificacion d,2003-07-01,1178,1088,1178,1088,2266
41501,LA RIVERA,estado nutricional en menores de 5 anos,clasificacion d,2003-07-01,2,1,2,1,3
70701,LAGUNILLAS,estado nutricional en menores de 5 anos,clasificacion d,2003-07-01,28,49,28,49,77
21202,LAJA,estado nutricional en menores de 5 anos,clasificacion d,2003-07-01,41,34,41,34,75
10903,LAS CARRERAS,estado nutricional en menores de 5 anos,clasificacion d,2003-07-01,11,51,11,51,62
21006,LICOMA PAMPA,estado nutricional en menores de 5 anos,clasificacion d,2003-07-01,8,10,8,10,18
50203,LLALLAGUA,estado nutricional en menores de 5 anos,clasificacion d,2003-07-01,54,259,54,259,313
51401,LLICA,estado nutricional en menores de 5 anos,clasificacion d,2003-07-01,5,12,5,12,17
80601,LORETO,estado nutricional en menores de 5 anos,clasificacion d,2003-07-01,8,20,8,20,28
20901,LURIBAY,estado nutricional en menores de 5 anos,clasificacion d,2003-07-01,15,23,15,23,38
40702,MACHACAMARCA,estado nutricional en menores de 5 anos,clasificacion d,2003-07-01,17,9,17,9,26
11003,MACHARETI,estado nutricional en menores de 5 anos,clasificacion d,2003-07-01,35,100,35,100,135
80801,MAGDALENA,estado nutricional en menores de 5 anos,clasificacion d,2003-07-01,15,17,15,17,32
70903,MAIRANA,estado nutricional en menores de 5 anos,clasificacion d,2003-07-01,28,26,28,26,54
20904,MALLA,estado nutricional en menores de 5 anos,clasificacion d,2003-07-01,7,4,7,4,11
20103,MECAPACA,estado nutricional en menores de 5 anos,clasificacion d,2003-07-01,17,23,17,23,40
71003,MINEROS,estado nutricional en menores de 5 anos,clasificacion d,2003-07-01,112,81,112,81,193
31301,MIZQUE,estado nutricional en menores de 5 anos,clasificacion d,2003-07-01,43,17,43,17,60
20402,MOCOMOCO,estado nutricional en menores de 5 anos,clasificacion d,2003-07-01,66,92,66,92,158
51002,MOJINETE,estado nutricional en menores de 5 anos,clasificacion d,2003-07-01,6,11,6,11,17
10303,MOJOCOYA,estado nutricional en menores de 5 anos,clasificacion d,2003-07-01,58,137,58,137,195
10501,MONTEAGUDO,estado nutricional en menores de 5 anos,clasificacion d,2003-07-01,106,158,106,158,264
71001,MONTERO,estado nutricional en menores de 5 anos,clasificacion d,2003-07-01,348,179,348,179,527
70803,MORO MORO,estado nutricional en menores de 5 anos,clasificacion d,2003-07-01,10,12,10,12,22
30302,MOROCHATA,estado nutricional en menores de 5 anos,clasificacion d,2003-07-01,132,138,132,138,270
20307,NAZACARA DE PACAJES,estado nutricional en menores de 5 anos,clasificacion d,2003-07-01,4,1,4,1,5
90501,NUEVO MANOA (NUEVA ESPERANZA),estado nutricional en menores de 5 anos,clasificacion d,2003-07-01,1,1,1,1,2
50404,OCURI,estado nutricional en menores de 5 anos,clasificacion d,2003-07-01,77,122,77,122,199
70202,OKINAWA,estado nutricional en menores de 5 anos,clasificacion d,2003-07-01,3,1,3,1,4
30203,OMEREQUE,estado nutricional en menores de 5 anos,clasificacion d,2003-07-01,17,41,17,41,58
40101,ORURO,estado nutricional en menores de 5 anos,clasificacion d,2003-07-01,572,567,572,567,1139
60201,PADCAYA,estado nutricional en menores de 5 anos,clasificacion d,2003-07-01,57,110,57,110,167
10401,PADILLA,estado nutricional en menores de 5 anos,clasificacion d,2003-07-01,100,220,100,220,320
70502,PAILON,estado nutricional en menores de 5 anos,clasificacion d,2003-07-01,36,22,36,22,58
20102,PALCA,estado nutricional en menores de 5 anos,clasificacion d,2003-07-01,24,33,24,33,57
21104,PALOS BLANCOS,estado nutricional en menores de 5 anos,clasificacion d,2003-07-01,41,73,41,73,114
40802,PAMPA AULLAGAS,estado nutricional en menores de 5 anos,clasificacion d,2003-07-01,17,24,17,24,41
70902,PAMPA GRANDE,estado nutricional en menores de 5 anos,clasificacion d,2003-07-01,16,20,16,20,36
21802,PAPEL PAMPA,estado nutricional en menores de 5 anos,clasificacion d,2003-07-01,4,11,4,11,15
30202,PASORAPA,estado nutricional en menores de 5 anos,clasificacion d,2003-07-01,19,29,19,29,48
21305,PATACAMAYA,estado nutricional en menores de 5 anos,clasificacion d,2003-07-01,49,25,49,25,74
40602,PAZÃ‘A,estado nutricional en menores de 5 anos,clasificacion d,2003-07-01,4,21,4,21,25
20702,PELECHUCO,estado nutricional en menores de 5 anos,clasificacion d,2003-07-01,27,19,27,19,46
50403,POCOATA,estado nutricional en menores de 5 anos,clasificacion d,2003-07-01,185,134,185,134,319
31203,POCONA,estado nutricional en menores de 5 anos,clasificacion d,2003-07-01,47,46,47,46,93
31202,POJO (CBBA),estado nutricional en menores de 5 anos,clasificacion d,2003-07-01,150,127,150,127,277
40601,POOPO,estado nutricional en menores de 5 anos,clasificacion d,2003-07-01,6,25,6,25,31
51203,PORCO,estado nutricional en menores de 5 anos,clasificacion d,2003-07-01,17,17,17,17,34
10103,POROMA,estado nutricional en menores de 5 anos,clasificacion d,2003-07-01,125,252,125,252,377
70103,PORONGO,estado nutricional en menores de 5 anos,clasificacion d,2003-07-01,11,10,11,10,21
70601,PORTACHUELO,estado nutricional en menores de 5 anos,clasificacion d,2003-07-01,65,53,65,53,118
90102,PORVENIR,estado nutricional en menores de 5 anos,clasificacion d,2003-07-01,12,18,12,18,30
70804,POSTRER VALLE,estado nutricional en menores de 5 anos,clasificacion d,2003-07-01,6,8,6,8,14
50101,POTOSI,estado nutricional en menores de 5 anos,clasificacion d,2003-07-01,778,546,778,546,1324
10302,PRESTO,estado nutricional en menores de 5 anos,clasificacion d,2003-07-01,70,97,70,97,167
70805,PUCARA,estado nutricional en menores de 5 anos,clasificacion d,2003-07-01,7,7,7,7,14
21201,PUCARANI,estado nutricional en menores de 5 anos,clasificacion d,2003-07-01,36,32,36,32,68
20401,PUERTO ACOSTA,estado nutricional en menores de 5 anos,clasificacion d,2003-07-01,62,69,62,69,131
20403,PUERTO CARABUCO,estado nutricional en menores de 5 anos,clasificacion d,2003-07-01,42,67,42,67,109
90301,PUERTO GONZALO MORENO,estado nutricional en menores de 5 anos,clasificacion d,2003-07-01,4,4,4,4,8
21204,PUERTO PEREZ,estado nutricional en menores de 5 anos,clasificacion d,2003-07-01,13,0,13,0,13
71402,PUERTO QUIJARRO,estado nutricional en menores de 5 anos,clasificacion d,2003-07-01,51,22,51,22,73
90201,PUERTO RICO,estado nutricional en menores de 5 anos,clasificacion d,2003-07-01,3,53,3,53,56
80703,PUERTO SILES,estado nutricional en menores de 5 anos,clasificacion d,2003-07-01,8,24,8,24,32
71401,PUERTO SUAREZ,estado nutricional en menores de 5 anos,clasificacion d,2003-07-01,23,20,23,20,43
31205,PUERTO VILLARROEL,estado nutricional en menores de 5 anos,clasificacion d,2003-07-01,181,176,181,176,357
51101,PUNA,estado nutricional en menores de 5 anos,clasificacion d,2003-07-01,170,219,170,219,389
31401,PUNATA,estado nutricional en menores de 5 anos,clasificacion d,2003-07-01,70,124,70,124,194
20604,QUIABAYA,estado nutricional en menores de 5 anos,clasificacion d,2003-07-01,5,20,5,20,25
30901,QUILLACOLLO,estado nutricional en menores de 5 anos,clasificacion d,2003-07-01,89,114,89,114,203
21002,QUIME,estado nutricional en menores de 5 anos,clasificacion d,2003-07-01,52,55,52,55,107
70904,QUIRUSILLAS,estado nutricional en menores de 5 anos,clasificacion d,2003-07-01,2,7,2,7,9
50402,RAVELO,estado nutricional en menores de 5 anos,clasificacion d,2003-07-01,115,141,115,141,256
80301,REYES,estado nutricional en menores de 5 anos,clasificacion d,2003-07-01,30,34,30,34,64
80201,RIBERALTA,estado nutricional en menores de 5 anos,clasificacion d,2003-07-01,383,275,383,275,658
70503,ROBORE,estado nutricional en menores de 5 anos,clasificacion d,2003-07-01,44,32,44,32,76
80304,RURRENABAQUE,estado nutricional en menores de 5 anos,clasificacion d,2003-07-01,32,21,32,21,53
40901,SABAYA,estado nutricional en menores de 5 anos,clasificacion d,2003-07-01,1,14,1,14,15
31001,SACABA,estado nutricional en menores de 5 anos,clasificacion d,2003-07-01,143,140,143,140,283
30404,SACABAMBA,estado nutricional en menores de 5 anos,clasificacion d,2003-07-01,12,30,12,30,42
50701,SACACA,estado nutricional en menores de 5 anos,clasificacion d,2003-07-01,218,460,218,460,678
71302,SAIPINA,estado nutricional en menores de 5 anos,clasificacion d,2003-07-01,11,27,11,27,38
40801,SALINAS DE GARCI MENDOZA,estado nutricional en menores de 5 anos,clasificacion d,2003-07-01,15,28,15,28,43
70901,SAMAIPATA,estado nutricional en menores de 5 anos,clasificacion d,2003-07-01,21,19,21,19,40
51601,SAN AGUSTIN,estado nutricional en menores de 5 anos,clasificacion d,2003-07-01,6,3,6,3,9
80602,SAN ANDRES,estado nutricional en menores de 5 anos,clasificacion d,2003-07-01,32,25,32,25,57
51003,SAN ANTONIO DE ESMORUCO,estado nutricional en menores de 5 anos,clasificacion d,2003-07-01,0,3,0,3,3
71105,SAN ANTONIO DE LOMERIO,estado nutricional en menores de 5 anos,clasificacion d,2003-07-01,81,108,81,108,189
31403,SAN BENITO,estado nutricional en menores de 5 anos,clasificacion d,2003-07-01,31,16,31,16,47
80302,SAN BORJA,estado nutricional en menores de 5 anos,clasificacion d,2003-07-01,113,118,113,118,231
21502,SAN BUENA VENTURA,estado nutricional en menores de 5 anos,clasificacion d,2003-07-01,49,46,49,46,95
70402,SAN CARLOS,estado nutricional en menores de 5 anos,clasificacion d,2003-07-01,90,100,90,100,190
80501,SAN IGNACIO,estado nutricional en menores de 5 anos,clasificacion d,2003-07-01,78,62,78,62,140
70301,SAN IGNACIO DE VELASCO,estado nutricional en menores de 5 anos,clasificacion d,2003-07-01,243,171,243,171,414
80102,SAN JAVIER(BNI),estado nutricional en menores de 5 anos,clasificacion d,2003-07-01,15,22,15,22,37
71102,SAN JAVIER(STC),estado nutricional en menores de 5 anos,clasificacion d,2003-07-01,43,63,43,63,106
80701,SAN JOAQUIN,estado nutricional en menores de 5 anos,clasificacion d,2003-07-01,7,17,7,17,24
70501,SAN JOSE DE CHIQUITOS,estado nutricional en menores de 5 anos,clasificacion d,2003-07-01,38,26,38,26,64
71104,SAN JULIAN,estado nutricional en menores de 5 anos,clasificacion d,2003-07-01,96,157,96,157,253
90302,SAN LORENZO(PND),estado nutricional en menores de 5 anos,clasificacion d,2003-07-01,5,8,5,8,13
60501,SAN LORENZO(TJA),estado nutricional en menores de 5 anos,clasificacion d,2003-07-01,44,51,44,51,95
10702,SAN LUCAS,estado nutricional en menores de 5 anos,clasificacion d,2003-07-01,312,372,312,372,684
70302,SAN MIGUEL DE VELASCO,estado nutricional en menores de 5 anos,clasificacion d,2003-07-01,43,50,43,50,93
51001,SAN PABLO DE LIPEZ,estado nutricional en menores de 5 anos,clasificacion d,2003-07-01,7,13,7,13,20
50501,SAN PEDRO DE BUENA VISTA,estado nutricional en menores de 5 anos,clasificacion d,2003-07-01,130,196,130,196,326
21801,SAN PEDRO DE CURAHUARA,estado nutricional en menores de 5 anos,clasificacion d,2003-07-01,19,17,19,17,36
50902,SAN PEDRO DE QUEMES,estado nutricional en menores de 5 anos,clasificacion d,2003-07-01,1,1,1,1,2
21702,SAN PEDRO DE TIQUINA,estado nutricional en menores de 5 anos,clasificacion d,2003-07-01,8,17,8,17,25
70303,SAN RAFAEL,estado nutricional en menores de 5 anos,clasificacion d,2003-07-01,36,34,36,34,70
80702,SAN RAMON,estado nutricional en menores de 5 anos,clasificacion d,2003-07-01,0,16,0,16,16
80702,SAN RAMON,estado nutricional en menores de 5 anos,clasificacion d,2003-07-01,11,29,11,29,40
80401,SANTA ANA,estado nutricional en menores de 5 anos,clasificacion d,2003-07-01,24,24,24,24,48
70101,SANTA CRUZ DE LA SIERRA,estado nutricional en menores de 5 anos,clasificacion d,2003-07-01,837,406,837,406,1243
80303,SANTA ROSA,estado nutricional en menores de 5 anos,clasificacion d,2003-07-01,12,4,12,4,16
70602,SANTA ROSA DEL SARA,estado nutricional en menores de 5 anos,clasificacion d,2003-07-01,15,18,15,18,33
20308,SANTIAGO DE CALLAPA,estado nutricional en menores de 5 anos,clasificacion d,2003-07-01,22,69,22,69,91
41401,SANTIAGO DE HUARI,estado nutricional en menores de 5 anos,clasificacion d,2003-07-01,11,23,11,23,34
21901,SANTIAGO DE MACHACA,estado nutricional en menores de 5 anos,clasificacion d,2003-07-01,5,8,5,8,13
30702,SANTIVAÃ‘ES,estado nutricional en menores de 5 anos,clasificacion d,2003-07-01,32,16,32,16,48
40202,SANTUARIO DE QUILLACAS,estado nutricional en menores de 5 anos,clasificacion d,2003-07-01,7,13,7,13,20
20902,SAPAHAQUI,estado nutricional en menores de 5 anos,clasificacion d,2003-07-01,31,33,31,33,64
90303,SENA,estado nutricional en menores de 5 anos,clasificacion d,2003-07-01,13,7,13,7,20
21301,SICA SICA (VILLA AROMA),estado nutricional en menores de 5 anos,clasificacion d,2003-07-01,87,62,87,62,149
30703,SICAYA,estado nutricional en menores de 5 anos,clasificacion d,2003-07-01,21,20,21,20,41
30902,SIPE SIPE,estado nutricional en menores de 5 anos,clasificacion d,2003-07-01,124,121,124,121,245
10403,SOPACHUY,estado nutricional en menores de 5 anos,clasificacion d,2003-07-01,58,80,58,80,138
20601,SORATA,estado nutricional en menores de 5 anos,clasificacion d,2003-07-01,63,87,63,87,150
10101,SUCRE,estado nutricional en menores de 5 anos,clasificacion d,2003-07-01,650,709,650,709,1359
31404,TACACHI,estado nutricional en menores de 5 anos,clasificacion d,2003-07-01,8,5,8,5,13
20603,TACACOMA,estado nutricional en menores de 5 anos,clasificacion d,2003-07-01,21,24,21,24,45
50303,TACOBAMBA,estado nutricional en menores de 5 anos,clasificacion d,2003-07-01,61,53,61,53,114
30602,TACOPAYA,estado nutricional en menores de 5 anos,clasificacion d,2003-07-01,55,96,55,96,151
51402,TAHUA,estado nutricional en menores de 5 anos,clasificacion d,2003-07-01,4,4,4,4,8
31101,TAPACARI,estado nutricional en menores de 5 anos,clasificacion d,2003-07-01,103,70,103,70,173
10601,TARABUCO,estado nutricional en menores de 5 anos,clasificacion d,2003-07-01,302,498,302,498,800
30401,TARATA,estado nutricional en menores de 5 anos,clasificacion d,2003-07-01,24,33,24,33,57
60101,TARIJA,estado nutricional en menores de 5 anos,clasificacion d,2003-07-01,394,342,394,342,736
10202,TARVITA,estado nutricional en menores de 5 anos,clasificacion d,2003-07-01,126,220,126,220,346
20803,TIAWANACU,estado nutricional en menores de 5 anos,clasificacion d,2003-07-01,20,17,20,17,37
50102,TINGUIPAYA,estado nutricional en menores de 5 anos,clasificacion d,2003-07-01,63,60,63,60,123
20606,TIPUANI,estado nutricional en menores de 5 anos,clasificacion d,2003-07-01,8,3,8,3,11
30903,TIQUIPAYA,estado nutricional en menores de 5 anos,clasificacion d,2003-07-01,21,11,21,11,32
31601,TIRAQUE (CBBA),estado nutricional en menores de 5 anos,clasificacion d,2003-07-01,131,137,131,137,268
21703,TITO YUPANQUI (PARQUIPUJIO),estado nutricional en menores de 5 anos,clasificacion d,2003-07-01,2,6,2,6,8
30802,TOCO,estado nutricional en menores de 5 anos,clasificacion d,2003-07-01,0,12,0,12,12
30803,TOLATA,estado nutricional en menores de 5 anos,clasificacion d,2003-07-01,7,4,7,4,11
41001,TOLEDO,estado nutricional en menores de 5 anos,clasificacion d,2003-07-01,10,13,10,13,23
51202,TOMAVE,estado nutricional en menores de 5 anos,clasificacion d,2003-07-01,39,61,39,61,100
10402,TOMINA,estado nutricional en menores de 5 anos,clasificacion d,2003-07-01,101,214,101,214,315
50502,TORO TORO,estado nutricional en menores de 5 anos,clasificacion d,2003-07-01,96,97,96,97,193
31201,TOTORA(CBBA),estado nutricional en menores de 5 anos,clasificacion d,2003-07-01,49,50,49,50,99
41301,TOTORA(ORR),estado nutricional en menores de 5 anos,clasificacion d,2003-07-01,22,21,22,21,43
70802,TRIGAL,estado nutricional en menores de 5 anos,clasificacion d,2003-07-01,4,4,4,4,8
80101,TRINIDAD,estado nutricional en menores de 5 anos,clasificacion d,2003-07-01,164,130,164,130,294
50801,TUPIZA,estado nutricional en menores de 5 anos,clasificacion d,2003-07-01,99,226,99,226,325
40402,TURCO,estado nutricional en menores de 5 anos,clasificacion d,2003-07-01,4,5,4,5,9
21302,UMALA,estado nutricional en menores de 5 anos,clasificacion d,2003-07-01,4,4,4,4,8
50201,UNCIA,estado nutricional en menores de 5 anos,clasificacion d,2003-07-01,21,15,21,15,36
60401,URIONDO (A. CONCEPCION),estado nutricional en menores de 5 anos,clasificacion d,2003-07-01,30,56,30,56,86
71502,URUBICHA,estado nutricional en menores de 5 anos,clasificacion d,2003-07-01,11,25,11,25,36
51201,UYUNI,estado nutricional en menores de 5 anos,clasificacion d,2003-07-01,80,114,80,114,194
30502,VACAS,estado nutricional en menores de 5 anos,clasificacion d,2003-07-01,48,11,48,11,59
70801,VALLEGRANDE,estado nutricional en menores de 5 anos,clasificacion d,2003-07-01,51,51,51,51,102
20801,VIACHA,estado nutricional en menores de 5 anos,clasificacion d,2003-07-01,105,60,105,60,165
31302,VILA VILA,estado nutricional en menores de 5 anos,clasificacion d,2003-07-01,8,7,8,7,15
60303,VILLA MONTES,estado nutricional en menores de 5 anos,clasificacion d,2003-07-01,80,86,80,86,166
31402,VILLA RIVERO,estado nutricional en menores de 5 anos,clasificacion d,2003-07-01,10,10,10,10,20
10801,VILLA SERRANO,estado nutricional en menores de 5 anos,clasificacion d,2003-07-01,112,253,112,253,365
31003,VILLA TUNARI,estado nutricional en menores de 5 anos,clasificacion d,2003-07-01,176,147,176,147,323
11001,VILLA VACA GUZMAN (MUYUPAMPA),estado nutricional en menores de 5 anos,clasificacion d,2003-07-01,49,74,49,74,123
51501,VILLAZON,estado nutricional en menores de 5 anos,clasificacion d,2003-07-01,107,140,107,140,247
30904,VINTO,estado nutricional en menores de 5 anos,clasificacion d,2003-07-01,66,21,66,21,87
50602,VITICHI,estado nutricional en menores de 5 anos,clasificacion d,2003-07-01,56,79,56,79,135
20306,WALDO BALLIVIAN,estado nutricional en menores de 5 anos,clasificacion d,2003-07-01,1,1,1,1,2
20903,YACO,estado nutricional en menores de 5 anos,clasificacion d,2003-07-01,23,29,23,29,52
60301,YACUIBA,estado nutricional en menores de 5 anos,clasificacion d,2003-07-01,77,63,77,63,140
10602,YAMPARAEZ,estado nutricional en menores de 5 anos,clasificacion d,2003-07-01,142,282,142,282,424
21103,YANACACHI,estado nutricional en menores de 5 anos,clasificacion d,2003-07-01,7,12,7,12,19
70403,YAPACANI,estado nutricional en menores de 5 anos,clasificacion d,2003-07-01,109,151,109,151,260
50103,YOCALLA,estado nutricional en menores de 5 anos,clasificacion d,2003-07-01,22,36,22,36,58
10102,YOTALA,estado nutricional en menores de 5 anos,clasificacion d,2003-07-01,61,208,61,208,269
60402,YUNCHARA,estado nutricional en menores de 5 anos,clasificacion d,2003-07-01,24,34,24,34,58
10301,ZUDAÃ‘EZ,estado nutricional en menores de 5 anos,clasificacion d,2003-07-01,62,125,62,125,187
51302,ACACIO,estado nutricional en menores de 5 anos,clasificacion d,2003-08-01,67,108,67,108,175
20201,ACHACACHI,estado nutricional en menores de 5 anos,clasificacion d,2003-08-01,100,105,100,105,205
20104,ACHOCALLA,estado nutricional en menores de 5 anos,clasificacion d,2003-08-01,21,16,21,16,37
30201,AIQUILE,estado nutricional en menores de 5 anos,clasificacion d,2003-08-01,42,54,42,54,96
31303,ALALAY,estado nutricional en menores de 5 anos,clasificacion d,2003-08-01,12,8,12,8,20
10404,ALCALA,estado nutricional en menores de 5 anos,clasificacion d,2003-08-01,32,70,32,70,102
20202,ANCORAIMES,estado nutricional en menores de 5 anos,clasificacion d,2003-08-01,51,89,51,89,140
41201,ANDAMARCA,estado nutricional en menores de 5 anos,clasificacion d,2003-08-01,7,4,7,4,11
30402,ANZALDO,estado nutricional en menores de 5 anos,clasificacion d,2003-08-01,9,46,9,46,55
20701,APOLO,estado nutricional en menores de 5 anos,clasificacion d,2003-08-01,46,53,46,53,99
51301,ARAMPAMPA,estado nutricional en menores de 5 anos,clasificacion d,2003-08-01,38,98,38,98,136
30501,ARANI,estado nutricional en menores de 5 anos,clasificacion d,2003-08-01,21,34,21,34,55
30403,ARBIETO,estado nutricional en menores de 5 anos,clasificacion d,2003-08-01,5,13,5,13,18
30601,ARQUE,estado nutricional en menores de 5 anos,clasificacion d,2003-08-01,35,38,35,38,73
71501,ASCENCION DE GUARAYOS,estado nutricional en menores de 5 anos,clasificacion d,2003-08-01,211,270,211,270,481
50802,ATOCHA,estado nutricional en menores de 5 anos,clasificacion d,2003-08-01,46,117,46,117,163
20503,AUCAPATA,estado nutricional en menores de 5 anos,clasificacion d,2003-08-01,39,51,39,51,90
20502,AYATA,estado nutricional en menores de 5 anos,clasificacion d,2003-08-01,22,12,22,12,34
21303,AYO AYO,estado nutricional en menores de 5 anos,clasificacion d,2003-08-01,16,4,16,4,20
30301,AYOPAYA (V. DE INDEPENDENCIA),estado nutricional en menores de 5 anos,clasificacion d,2003-08-01,109,127,109,127,236
10201,AZURDUY,estado nutricional en menores de 5 anos,clasificacion d,2003-08-01,170,326,170,326,496
21203,BATALLAS,estado nutricional en menores de 5 anos,clasificacion d,2003-08-01,32,22,32,22,54
80802,BAURES,estado nutricional en menores de 5 anos,clasificacion d,2003-08-01,16,16,16,16,32
41202,BELEN DE ANDAMARCA,estado nutricional en menores de 5 anos,clasificacion d,2003-08-01,1,0,1,0,1
50104,BELEN DE URMIRI,estado nutricional en menores de 5 anos,clasificacion d,2003-08-01,14,22,14,22,36
90104,BELLA FLOR,estado nutricional en menores de 5 anos,clasificacion d,2003-08-01,24,22,24,22,46
60202,BERMEJO,estado nutricional en menores de 5 anos,clasificacion d,2003-08-01,14,19,14,19,33
50301,BETANZOS,estado nutricional en menores de 5 anos,clasificacion d,2003-08-01,232,309,232,309,541
31501,BOLIVAR,estado nutricional en menores de 5 anos,clasificacion d,2003-08-01,66,77,66,77,143
90103,BOLPEBRA,estado nutricional en menores de 5 anos,clasificacion d,2003-08-01,0,6,0,6,6
70707,BOYUIBE,estado nutricional en menores de 5 anos,clasificacion d,2003-08-01,11,25,11,25,36
70401,BUENA VISTA,estado nutricional en menores de 5 anos,clasificacion d,2003-08-01,21,34,21,34,55
70703,CABEZAS,estado nutricional en menores de 5 anos,clasificacion d,2003-08-01,6,5,6,5,11
20905,CAIROMA,estado nutricional en menores de 5 anos,clasificacion d,2003-08-01,74,60,74,60,134
51102,"CAIZA ""D""",estado nutricional en menores de 5 anos,clasificacion d,2003-08-01,71,66,71,66,137
21003,CAJUATA,estado nutricional en menores de 5 anos,clasificacion d,2003-08-01,42,30,42,30,72
20303,CALACOTO,estado nutricional en menores de 5 anos,clasificacion d,2003-08-01,21,20,21,20,41
21304,CALAMARCA,estado nutricional en menores de 5 anos,clasificacion d,2003-08-01,185,146,185,146,331
10701,CAMARGO,estado nutricional en menores de 5 anos,clasificacion d,2003-08-01,60,67,60,67,127
10901,CAMATAQUI (C. VILLA ABECIA),estado nutricional en menores de 5 anos,clasificacion d,2003-08-01,21,17,21,17,38
70706,CAMIRI,estado nutricional en menores de 5 anos,clasificacion d,2003-08-01,95,94,95,94,189
30701,CAPINOTA,estado nutricional en menores de 5 anos,clasificacion d,2003-08-01,25,40,25,40,65
20302,CAQUIAVIRI,estado nutricional en menores de 5 anos,clasificacion d,2003-08-01,29,30,29,30,59
40102,CARACOLLO,estado nutricional en menores de 5 anos,clasificacion d,2003-08-01,47,42,47,42,89
22001,CARANAVI,estado nutricional en menores de 5 anos,clasificacion d,2003-08-01,153,128,153,128,281
41503,CARANGAS,estado nutricional en menores de 5 anos,clasificacion d,2003-08-01,0,3,0,3,3
60302,CARAPARI,estado nutricional en menores de 5 anos,clasificacion d,2003-08-01,33,22,33,22,55
50702,CARIPUYO,estado nutricional en menores de 5 anos,clasificacion d,2003-08-01,102,135,102,135,237
21902,CATACORA,estado nutricional en menores de 5 anos,clasificacion d,2003-08-01,4,6,4,6,10
40201,CHALLAPATA,estado nutricional en menores de 5 anos,clasificacion d,2003-08-01,92,108,92,108,200
50302,CHAQUI,estado nutricional en menores de 5 anos,clasificacion d,2003-08-01,34,48,34,48,82
70702,CHARAGUA,estado nutricional en menores de 5 anos,clasificacion d,2003-08-01,107,117,107,117,224
20305,CHARAÃ‘A,estado nutricional en menores de 5 anos,clasificacion d,2003-08-01,3,5,3,5,8
50202,CHAYANTA,estado nutricional en menores de 5 anos,clasificacion d,2003-08-01,36,45,36,45,81
31204,CHIMORE,estado nutricional en menores de 5 anos,clasificacion d,2003-08-01,19,9,19,9,28
40903,CHIPAYA,estado nutricional en menores de 5 anos,clasificacion d,2003-08-01,1,1,1,1,2
40302,CHOQUE COTA,estado nutricional en menores de 5 anos,clasificacion d,2003-08-01,9,10,9,10,19
21101,CHULUMANI (V. DE LA LIBERTAD),estado nutricional en menores de 5 anos,clasificacion d,2003-08-01,11,20,11,20,31
20501,CHUMA,estado nutricional en menores de 5 anos,clasificacion d,2003-08-01,30,4,30,4,34
30801,CLIZA,estado nutricional en menores de 5 anos,clasificacion d,2003-08-01,7,7,7,7,14
90101,COBIJA,estado nutricional en menores de 5 anos,clasificacion d,2003-08-01,78,90,78,90,168
30101,COCHABAMBA,estado nutricional en menores de 5 anos,clasificacion d,2003-08-01,441,362,441,362,803
40902,COIPASA,estado nutricional en menores de 5 anos,clasificacion d,2003-08-01,0,1,0,1,1
30905,COLCAPIRHUA,estado nutricional en menores de 5 anos,clasificacion d,2003-08-01,55,38,55,38,93
50901,"COLCHA ""K""",estado nutricional en menores de 5 anos,clasificacion d,2003-08-01,44,62,44,62,106
21307,COLLANA,estado nutricional en menores de 5 anos,clasificacion d,2003-08-01,5,1,5,1,6
31002,COLOMI,estado nutricional en menores de 5 anos,clasificacion d,2003-08-01,51,65,51,65,116
50401,COLQUECHACA,estado nutricional en menores de 5 anos,clasificacion d,2003-08-01,207,131,207,131,338
21306,COLQUENCHA,estado nutricional en menores de 5 anos,clasificacion d,2003-08-01,25,11,25,11,36
21004,COLQUIRI,estado nutricional en menores de 5 anos,clasificacion d,2003-08-01,90,63,90,63,153
20304,COMANCHE,estado nutricional en menores de 5 anos,clasificacion d,2003-08-01,5,3,5,3,8
71301,COMARAPA,estado nutricional en menores de 5 anos,clasificacion d,2003-08-01,66,47,66,47,113
20605,COMBAYA,estado nutricional en menores de 5 anos,clasificacion d,2003-08-01,13,9,13,9,22
71101,CONCEPCION,estado nutricional en menores de 5 anos,clasificacion d,2003-08-01,11,72,11,72,83
21701,COPACABANA,estado nutricional en menores de 5 anos,clasificacion d,2003-08-01,22,25,22,25,47
21402,CORIPATA,estado nutricional en menores de 5 anos,clasificacion d,2003-08-01,2,0,2,0,2
20301,CORO CORO,estado nutricional en menores de 5 anos,clasificacion d,2003-08-01,37,40,37,40,77
21401,COROICO,estado nutricional en menores de 5 anos,clasificacion d,2003-08-01,19,27,19,27,46
40301,CORQUE,estado nutricional en menores de 5 anos,clasificacion d,2003-08-01,18,3,18,3,21
50601,COTAGAITA,estado nutricional en menores de 5 anos,clasificacion d,2003-08-01,197,315,197,315,512
31405,CUCHUMUELA (V. G. VILLARROEL),estado nutricional en menores de 5 anos,clasificacion d,2003-08-01,4,6,4,6,10
70704,CUEVO,estado nutricional en menores de 5 anos,clasificacion d,2003-08-01,6,10,6,10,16
10902,CULPINA,estado nutricional en menores de 5 anos,clasificacion d,2003-08-01,148,185,148,185,333
40401,CURAHUARA DE CARANGAS,estado nutricional en menores de 5 anos,clasificacion d,2003-08-01,26,25,26,25,51
21602,CURVA,estado nutricional en menores de 5 anos,clasificacion d,2003-08-01,11,12,11,12,23
20804,DESAGUADERO,estado nutricional en menores de 5 anos,clasificacion d,2003-08-01,14,8,14,8,22
20105,EL ALTO,estado nutricional en menores de 5 anos,clasificacion d,2003-08-01,1742,1124,1742,1124,2866
40103,EL CHORO,estado nutricional en menores de 5 anos,clasificacion d,2003-08-01,4,3,4,3,7
71503,EL PUENTE(STC),estado nutricional en menores de 5 anos,clasificacion d,2003-08-01,8,73,8,73,81
60502,EL PUENTE(TJA),estado nutricional en menores de 5 anos,clasificacion d,2003-08-01,60,168,60,168,228
70105,EL TORNO,estado nutricional en menores de 5 anos,clasificacion d,2003-08-01,56,60,56,60,116
10405,EL VILLAR,estado nutricional en menores de 5 anos,clasificacion d,2003-08-01,51,124,51,124,175
60601,ENTRE RIOS,estado nutricional en menores de 5 anos,clasificacion d,2003-08-01,57,105,57,105,162
41101,EUCALIPTUS,estado nutricional en menores de 5 anos,clasificacion d,2003-08-01,21,30,21,30,51
80402,EXALTACION,estado nutricional en menores de 5 anos,clasificacion d,2003-08-01,17,23,17,23,40
90203,FILADELFIA,estado nutricional en menores de 5 anos,clasificacion d,2003-08-01,3,7,3,7,10
71002,GENERAL SAAVEDRA,estado nutricional en menores de 5 anos,clasificacion d,2003-08-01,67,69,67,69,136
21601,GRAL. J.J. PEREZ (CHARAZANI),estado nutricional en menores de 5 anos,clasificacion d,2003-08-01,38,62,38,62,100
20602,GUANAY,estado nutricional en menores de 5 anos,clasificacion d,2003-08-01,94,131,94,131,225
20802,GUAQUI,estado nutricional en menores de 5 anos,clasificacion d,2003-08-01,13,8,13,8,21
80202,GUAYARAMERIN,estado nutricional en menores de 5 anos,clasificacion d,2003-08-01,90,65,90,65,155
70705,GUTIERREZ,estado nutricional en menores de 5 anos,clasificacion d,2003-08-01,83,157,83,157,240
10502,HUACARETA,estado nutricional en menores de 5 anos,clasificacion d,2003-08-01,70,112,70,112,182
11002,HUACAYA (VILLA DE HUACAYA),estado nutricional en menores de 5 anos,clasificacion d,2003-08-01,16,41,16,41,57
40501,HUACHACALLA,estado nutricional en menores de 5 anos,clasificacion d,2003-08-01,5,0,5,0,5
40701,HUANUNI,estado nutricional en menores de 5 anos,clasificacion d,2003-08-01,39,36,39,36,75
80803,HUARACAJE,estado nutricional en menores de 5 anos,clasificacion d,2003-08-01,2,5,2,5,7
41601,HUAYLLAMARCA,estado nutricional en menores de 5 anos,clasificacion d,2003-08-01,6,15,6,15,21
21005,ICHOCA,estado nutricional en menores de 5 anos,clasificacion d,2003-08-01,18,16,18,16,34
10304,ICLA,estado nutricional en menores de 5 anos,clasificacion d,2003-08-01,103,170,103,170,273
10703,INCAHUASI,estado nutricional en menores de 5 anos,clasificacion d,2003-08-01,166,174,166,174,340
21001,INQUISIVI,estado nutricional en menores de 5 anos,clasificacion d,2003-08-01,97,95,97,95,192
21102,IRUPANA (VILLA DE LANZA),estado nutricional en menores de 5 anos,clasificacion d,2003-08-01,30,65,30,65,95
21501,IXIAMAS,estado nutricional en menores de 5 anos,clasificacion d,2003-08-01,24,40,24,40,64
21105,LA ASUNTA,estado nutricional en menores de 5 anos,clasificacion d,2003-08-01,44,31,44,31,75
70104,LA GUARDIA,estado nutricional en menores de 5 anos,clasificacion d,2003-08-01,45,35,45,35,80
20101,LA PAZ,estado nutricional en menores de 5 anos,clasificacion d,2003-08-01,1266,929,1266,929,2195
70701,LAGUNILLAS,estado nutricional en menores de 5 anos,clasificacion d,2003-08-01,23,41,23,41,64
21202,LAJA,estado nutricional en menores de 5 anos,clasificacion d,2003-08-01,9,7,9,7,16
10903,LAS CARRERAS,estado nutricional en menores de 5 anos,clasificacion d,2003-08-01,13,28,13,28,41
21006,LICOMA PAMPA,estado nutricional en menores de 5 anos,clasificacion d,2003-08-01,7,5,7,5,12
50203,LLALLAGUA,estado nutricional en menores de 5 anos,clasificacion d,2003-08-01,11,279,11,279,290
51401,LLICA,estado nutricional en menores de 5 anos,clasificacion d,2003-08-01,8,5,8,5,13
80601,LORETO,estado nutricional en menores de 5 anos,clasificacion d,2003-08-01,3,17,3,17,20
20901,LURIBAY,estado nutricional en menores de 5 anos,clasificacion d,2003-08-01,51,37,51,37,88
40702,MACHACAMARCA,estado nutricional en menores de 5 anos,clasificacion d,2003-08-01,14,7,14,7,21
11003,MACHARETI,estado nutricional en menores de 5 anos,clasificacion d,2003-08-01,29,81,29,81,110
80801,MAGDALENA,estado nutricional en menores de 5 anos,clasificacion d,2003-08-01,30,19,30,19,49
70903,MAIRANA,estado nutricional en menores de 5 anos,clasificacion d,2003-08-01,13,16,13,16,29
20904,MALLA,estado nutricional en menores de 5 anos,clasificacion d,2003-08-01,8,13,8,13,21
20103,MECAPACA,estado nutricional en menores de 5 anos,clasificacion d,2003-08-01,5,7,5,7,12
71003,MINEROS,estado nutricional en menores de 5 anos,clasificacion d,2003-08-01,127,78,127,78,205
31301,MIZQUE,estado nutricional en menores de 5 anos,clasificacion d,2003-08-01,37,36,37,36,73
20402,MOCOMOCO,estado nutricional en menores de 5 anos,clasificacion d,2003-08-01,36,58,36,58,94
51002,MOJINETE,estado nutricional en menores de 5 anos,clasificacion d,2003-08-01,2,4,2,4,6
10303,MOJOCOYA,estado nutricional en menores de 5 anos,clasificacion d,2003-08-01,59,129,59,129,188
10501,MONTEAGUDO,estado nutricional en menores de 5 anos,clasificacion d,2003-08-01,134,237,134,237,371
71001,MONTERO,estado nutricional en menores de 5 anos,clasificacion d,2003-08-01,196,160,196,160,356
70803,MORO MORO,estado nutricional en menores de 5 anos,clasificacion d,2003-08-01,8,19,8,19,27
30302,MOROCHATA,estado nutricional en menores de 5 anos,clasificacion d,2003-08-01,117,136,117,136,253
20307,NAZACARA DE PACAJES,estado nutricional en menores de 5 anos,clasificacion d,2003-08-01,2,4,2,4,6
50404,OCURI,estado nutricional en menores de 5 anos,clasificacion d,2003-08-01,106,113,106,113,219
30203,OMEREQUE,estado nutricional en menores de 5 anos,clasificacion d,2003-08-01,3,8,3,8,11
40101,ORURO,estado nutricional en menores de 5 anos,clasificacion d,2003-08-01,515,407,515,407,922
60201,PADCAYA,estado nutricional en menores de 5 anos,clasificacion d,2003-08-01,53,97,53,97,150
10401,PADILLA,estado nutricional en menores de 5 anos,clasificacion d,2003-08-01,101,235,101,235,336
70502,PAILON,estado nutricional en menores de 5 anos,clasificacion d,2003-08-01,17,13,17,13,30
20102,PALCA,estado nutricional en menores de 5 anos,clasificacion d,2003-08-01,24,48,24,48,72
21104,PALOS BLANCOS,estado nutricional en menores de 5 anos,clasificacion d,2003-08-01,53,51,53,51,104
40802,PAMPA AULLAGAS,estado nutricional en menores de 5 anos,clasificacion d,2003-08-01,10,20,10,20,30
70902,PAMPA GRANDE,estado nutricional en menores de 5 anos,clasificacion d,2003-08-01,11,8,11,8,19
21802,PAPEL PAMPA,estado nutricional en menores de 5 anos,clasificacion d,2003-08-01,6,7,6,7,13
30202,PASORAPA,estado nutricional en menores de 5 anos,clasificacion d,2003-08-01,9,25,9,25,34
21305,PATACAMAYA,estado nutricional en menores de 5 anos,clasificacion d,2003-08-01,119,86,119,86,205
40602,PAZÃ‘A,estado nutricional en menores de 5 anos,clasificacion d,2003-08-01,15,22,15,22,37
20702,PELECHUCO,estado nutricional en menores de 5 anos,clasificacion d,2003-08-01,26,14,26,14,40
50403,POCOATA,estado nutricional en menores de 5 anos,clasificacion d,2003-08-01,206,228,206,228,434
31203,POCONA,estado nutricional en menores de 5 anos,clasificacion d,2003-08-01,57,52,57,52,109
31202,POJO (CBBA),estado nutricional en menores de 5 anos,clasificacion d,2003-08-01,122,120,122,120,242
40601,POOPO,estado nutricional en menores de 5 anos,clasificacion d,2003-08-01,3,38,3,38,41
51203,PORCO,estado nutricional en menores de 5 anos,clasificacion d,2003-08-01,31,19,31,19,50
10103,POROMA,estado nutricional en menores de 5 anos,clasificacion d,2003-08-01,129,235,129,235,364
70103,PORONGO,estado nutricional en menores de 5 anos,clasificacion d,2003-08-01,22,14,22,14,36
70601,PORTACHUELO,estado nutricional en menores de 5 anos,clasificacion d,2003-08-01,51,64,51,64,115
90102,PORVENIR,estado nutricional en menores de 5 anos,clasificacion d,2003-08-01,9,22,9,22,31
70804,POSTRER VALLE,estado nutricional en menores de 5 anos,clasificacion d,2003-08-01,3,6,3,6,9
50101,POTOSI,estado nutricional en menores de 5 anos,clasificacion d,2003-08-01,608,410,608,410,1018
10302,PRESTO,estado nutricional en menores de 5 anos,clasificacion d,2003-08-01,68,84,68,84,152
70805,PUCARA,estado nutricional en menores de 5 anos,clasificacion d,2003-08-01,2,9,2,9,11
21201,PUCARANI,estado nutricional en menores de 5 anos,clasificacion d,2003-08-01,37,33,37,33,70
20401,PUERTO ACOSTA,estado nutricional en menores de 5 anos,clasificacion d,2003-08-01,68,76,68,76,144
20403,PUERTO CARABUCO,estado nutricional en menores de 5 anos,clasificacion d,2003-08-01,52,100,52,100,152
90301,PUERTO GONZALO MORENO,estado nutricional en menores de 5 anos,clasificacion d,2003-08-01,3,10,3,10,13
21204,PUERTO PEREZ,estado nutricional en menores de 5 anos,clasificacion d,2003-08-01,16,4,16,4,20
71402,PUERTO QUIJARRO,estado nutricional en menores de 5 anos,clasificacion d,2003-08-01,32,11,32,11,43
90201,PUERTO RICO,estado nutricional en menores de 5 anos,clasificacion d,2003-08-01,22,25,22,25,47
80703,PUERTO SILES,estado nutricional en menores de 5 anos,clasificacion d,2003-08-01,2,1,2,1,3
71401,PUERTO SUAREZ,estado nutricional en menores de 5 anos,clasificacion d,2003-08-01,15,16,15,16,31
31205,PUERTO VILLARROEL,estado nutricional en menores de 5 anos,clasificacion d,2003-08-01,139,123,139,123,262
51101,PUNA,estado nutricional en menores de 5 anos,clasificacion d,2003-08-01,3,1,3,1,4
31401,PUNATA,estado nutricional en menores de 5 anos,clasificacion d,2003-08-01,97,55,97,55,152
20604,QUIABAYA,estado nutricional en menores de 5 anos,clasificacion d,2003-08-01,9,16,9,16,25
30901,QUILLACOLLO,estado nutricional en menores de 5 anos,clasificacion d,2003-08-01,133,69,133,69,202
21002,QUIME,estado nutricional en menores de 5 anos,clasificacion d,2003-08-01,41,44,41,44,85
70904,QUIRUSILLAS,estado nutricional en menores de 5 anos,clasificacion d,2003-08-01,2,11,2,11,13
50402,RAVELO,estado nutricional en menores de 5 anos,clasificacion d,2003-08-01,157,165,157,165,322
80301,REYES,estado nutricional en menores de 5 anos,clasificacion d,2003-08-01,13,22,13,22,35
80201,RIBERALTA,estado nutricional en menores de 5 anos,clasificacion d,2003-08-01,313,218,313,218,531
70503,ROBORE,estado nutricional en menores de 5 anos,clasificacion d,2003-08-01,18,23,18,23,41
80304,RURRENABAQUE,estado nutricional en menores de 5 anos,clasificacion d,2003-08-01,29,18,29,18,47
40901,SABAYA,estado nutricional en menores de 5 anos,clasificacion d,2003-08-01,6,5,6,5,11
31001,SACABA,estado nutricional en menores de 5 anos,clasificacion d,2003-08-01,58,45,58,45,103
30404,SACABAMBA,estado nutricional en menores de 5 anos,clasificacion d,2003-08-01,20,72,20,72,92
50701,SACACA,estado nutricional en menores de 5 anos,clasificacion d,2003-08-01,197,347,197,347,544
71302,SAIPINA,estado nutricional en menores de 5 anos,clasificacion d,2003-08-01,18,38,18,38,56
40801,SALINAS DE GARCI MENDOZA,estado nutricional en menores de 5 anos,clasificacion d,2003-08-01,24,25,24,25,49
70901,SAMAIPATA,estado nutricional en menores de 5 anos,clasificacion d,2003-08-01,31,19,31,19,50
51601,SAN AGUSTIN,estado nutricional en menores de 5 anos,clasificacion d,2003-08-01,6,7,6,7,13
80602,SAN ANDRES,estado nutricional en menores de 5 anos,clasificacion d,2003-08-01,10,11,10,11,21
51003,SAN ANTONIO DE ESMORUCO,estado nutricional en menores de 5 anos,clasificacion d,2003-08-01,0,3,0,3,3
71105,SAN ANTONIO DE LOMERIO,estado nutricional en menores de 5 anos,clasificacion d,2003-08-01,82,118,82,118,200
31403,SAN BENITO,estado nutricional en menores de 5 anos,clasificacion d,2003-08-01,18,9,18,9,27
80302,SAN BORJA,estado nutricional en menores de 5 anos,clasificacion d,2003-08-01,122,119,122,119,241
21502,SAN BUENA VENTURA,estado nutricional en menores de 5 anos,clasificacion d,2003-08-01,37,22,37,22,59
70402,SAN CARLOS,estado nutricional en menores de 5 anos,clasificacion d,2003-08-01,88,59,88,59,147
80501,SAN IGNACIO,estado nutricional en menores de 5 anos,clasificacion d,2003-08-01,84,83,84,83,167
70301,SAN IGNACIO DE VELASCO,estado nutricional en menores de 5 anos,clasificacion d,2003-08-01,253,281,253,281,534
80102,SAN JAVIER(BNI),estado nutricional en menores de 5 anos,clasificacion d,2003-08-01,12,4,12,4,16
71102,SAN JAVIER(STC),estado nutricional en menores de 5 anos,clasificacion d,2003-08-01,27,32,27,32,59
80701,SAN JOAQUIN,estado nutricional en menores de 5 anos,clasificacion d,2003-08-01,15,14,15,14,29
70501,SAN JOSE DE CHIQUITOS,estado nutricional en menores de 5 anos,clasificacion d,2003-08-01,34,15,34,15,49
71104,SAN JULIAN,estado nutricional en menores de 5 anos,clasificacion d,2003-08-01,131,192,131,192,323
90302,SAN LORENZO(PND),estado nutricional en menores de 5 anos,clasificacion d,2003-08-01,17,4,17,4,21
60501,SAN LORENZO(TJA),estado nutricional en menores de 5 anos,clasificacion d,2003-08-01,64,74,64,74,138
10702,SAN LUCAS,estado nutricional en menores de 5 anos,clasificacion d,2003-08-01,395,441,395,441,836
71201,SAN MATIAS,estado nutricional en menores de 5 anos,clasificacion d,2003-08-01,42,23,42,23,65
70302,SAN MIGUEL DE VELASCO,estado nutricional en menores de 5 anos,clasificacion d,2003-08-01,59,56,59,56,115
51001,SAN PABLO DE LIPEZ,estado nutricional en menores de 5 anos,clasificacion d,2003-08-01,17,24,17,24,41
50501,SAN PEDRO DE BUENA VISTA,estado nutricional en menores de 5 anos,clasificacion d,2003-08-01,105,174,105,174,279
21801,SAN PEDRO DE CURAHUARA,estado nutricional en menores de 5 anos,clasificacion d,2003-08-01,18,32,18,32,50
50902,SAN PEDRO DE QUEMES,estado nutricional en menores de 5 anos,clasificacion d,2003-08-01,4,3,4,3,7
21702,SAN PEDRO DE TIQUINA,estado nutricional en menores de 5 anos,clasificacion d,2003-08-01,11,5,11,5,16
70303,SAN RAFAEL,estado nutricional en menores de 5 anos,clasificacion d,2003-08-01,28,22,28,22,50
80702,SAN RAMON,estado nutricional en menores de 5 anos,clasificacion d,2003-08-01,9,11,9,11,20
80401,SANTA ANA,estado nutricional en menores de 5 anos,clasificacion d,2003-08-01,38,23,38,23,61
70101,SANTA CRUZ DE LA SIERRA,estado nutricional en menores de 5 anos,clasificacion d,2003-08-01,484,265,484,265,749
80303,SANTA ROSA,estado nutricional en menores de 5 anos,clasificacion d,2003-08-01,25,23,25,23,48
70602,SANTA ROSA DEL SARA,estado nutricional en menores de 5 anos,clasificacion d,2003-08-01,9,28,9,28,37
20308,SANTIAGO DE CALLAPA,estado nutricional en menores de 5 anos,clasificacion d,2003-08-01,21,29,21,29,50
41401,SANTIAGO DE HUARI,estado nutricional en menores de 5 anos,clasificacion d,2003-08-01,33,45,33,45,78
21901,SANTIAGO DE MACHACA,estado nutricional en menores de 5 anos,clasificacion d,2003-08-01,8,8,8,8,16
30702,SANTIVAÃ‘ES,estado nutricional en menores de 5 anos,clasificacion d,2003-08-01,22,21,22,21,43
40202,SANTUARIO DE QUILLACAS,estado nutricional en menores de 5 anos,clasificacion d,2003-08-01,7,8,7,8,15
20902,SAPAHAQUI,estado nutricional en menores de 5 anos,clasificacion d,2003-08-01,59,66,59,66,125
90303,SENA,estado nutricional en menores de 5 anos,clasificacion d,2003-08-01,30,16,30,16,46
21301,SICA SICA (VILLA AROMA),estado nutricional en menores de 5 anos,clasificacion d,2003-08-01,109,72,109,72,181
30703,SICAYA,estado nutricional en menores de 5 anos,clasificacion d,2003-08-01,7,5,7,5,12
30902,SIPE SIPE,estado nutricional en menores de 5 anos,clasificacion d,2003-08-01,121,102,121,102,223
10403,SOPACHUY,estado nutricional en menores de 5 anos,clasificacion d,2003-08-01,60,88,60,88,148
20601,SORATA,estado nutricional en menores de 5 anos,clasificacion d,2003-08-01,52,66,52,66,118
10101,SUCRE,estado nutricional en menores de 5 anos,clasificacion d,2003-08-01,583,646,583,646,1229
31404,TACACHI,estado nutricional en menores de 5 anos,clasificacion d,2003-08-01,9,7,9,7,16
20603,TACACOMA,estado nutricional en menores de 5 anos,clasificacion d,2003-08-01,28,37,28,37,65
50303,TACOBAMBA,estado nutricional en menores de 5 anos,clasificacion d,2003-08-01,56,63,56,63,119
30602,TACOPAYA,estado nutricional en menores de 5 anos,clasificacion d,2003-08-01,111,127,111,127,238
51402,TAHUA,estado nutricional en menores de 5 anos,clasificacion d,2003-08-01,2,2,2,2,4
31101,TAPACARI,estado nutricional en menores de 5 anos,clasificacion d,2003-08-01,133,134,133,134,267
10601,TARABUCO,estado nutricional en menores de 5 anos,clasificacion d,2003-08-01,302,475,302,475,777
30401,TARATA,estado nutricional en menores de 5 anos,clasificacion d,2003-08-01,13,37,13,37,50
60101,TARIJA,estado nutricional en menores de 5 anos,clasificacion d,2003-08-01,263,286,263,286,549
10202,TARVITA,estado nutricional en menores de 5 anos,clasificacion d,2003-08-01,176,353,176,353,529
20803,TIAWANACU,estado nutricional en menores de 5 anos,clasificacion d,2003-08-01,10,12,10,12,22
50102,TINGUIPAYA,estado nutricional en menores de 5 anos,clasificacion d,2003-08-01,123,156,123,156,279
20606,TIPUANI,estado nutricional en menores de 5 anos,clasificacion d,2003-08-01,14,7,14,7,21
30903,TIQUIPAYA,estado nutricional en menores de 5 anos,clasificacion d,2003-08-01,64,38,64,38,102
31601,TIRAQUE (CBBA),estado nutricional en menores de 5 anos,clasificacion d,2003-08-01,137,132,137,132,269
21703,TITO YUPANQUI (PARQUIPUJIO),estado nutricional en menores de 5 anos,clasificacion d,2003-08-01,4,3,4,3,7
30802,TOCO,estado nutricional en menores de 5 anos,clasificacion d,2003-08-01,0,7,0,7,7
30803,TOLATA,estado nutricional en menores de 5 anos,clasificacion d,2003-08-01,10,29,10,29,39
41001,TOLEDO,estado nutricional en menores de 5 anos,clasificacion d,2003-08-01,13,15,13,15,28
51202,TOMAVE,estado nutricional en menores de 5 anos,clasificacion d,2003-08-01,52,73,52,73,125
10402,TOMINA,estado nutricional en menores de 5 anos,clasificacion d,2003-08-01,109,235,109,235,344
50502,TORO TORO,estado nutricional en menores de 5 anos,clasificacion d,2003-08-01,104,118,104,118,222
31201,TOTORA(CBBA),estado nutricional en menores de 5 anos,clasificacion d,2003-08-01,58,51,58,51,109
41301,TOTORA(ORR),estado nutricional en menores de 5 anos,clasificacion d,2003-08-01,21,26,21,26,47
70802,TRIGAL,estado nutricional en menores de 5 anos,clasificacion d,2003-08-01,2,3,2,3,5
80101,TRINIDAD,estado nutricional en menores de 5 anos,clasificacion d,2003-08-01,157,138,157,138,295
50801,TUPIZA,estado nutricional en menores de 5 anos,clasificacion d,2003-08-01,96,267,96,267,363
40402,TURCO,estado nutricional en menores de 5 anos,clasificacion d,2003-08-01,8,15,8,15,23
21302,UMALA,estado nutricional en menores de 5 anos,clasificacion d,2003-08-01,29,51,29,51,80
50201,UNCIA,estado nutricional en menores de 5 anos,clasificacion d,2003-08-01,19,9,19,9,28
60401,URIONDO (A. CONCEPCION),estado nutricional en menores de 5 anos,clasificacion d,2003-08-01,51,99,51,99,150
71502,URUBICHA,estado nutricional en menores de 5 anos,clasificacion d,2003-08-01,104,178,104,178,282
51201,UYUNI,estado nutricional en menores de 5 anos,clasificacion d,2003-08-01,63,88,63,88,151
30502,VACAS,estado nutricional en menores de 5 anos,clasificacion d,2003-08-01,51,26,51,26,77
70801,VALLEGRANDE,estado nutricional en menores de 5 anos,clasificacion d,2003-08-01,26,36,26,36,62
20801,VIACHA,estado nutricional en menores de 5 anos,clasificacion d,2003-08-01,84,52,84,52,136
31302,VILA VILA,estado nutricional en menores de 5 anos,clasificacion d,2003-08-01,22,35,22,35,57
60303,VILLA MONTES,estado nutricional en menores de 5 anos,clasificacion d,2003-08-01,44,33,44,33,77
31402,VILLA RIVERO,estado nutricional en menores de 5 anos,clasificacion d,2003-08-01,21,21,21,21,42
10801,VILLA SERRANO,estado nutricional en menores de 5 anos,clasificacion d,2003-08-01,133,266,133,266,399
31003,VILLA TUNARI,estado nutricional en menores de 5 anos,clasificacion d,2003-08-01,143,121,143,121,264
11001,VILLA VACA GUZMAN (MUYUPAMPA),estado nutricional en menores de 5 anos,clasificacion d,2003-08-01,41,60,41,60,101
51501,VILLAZON,estado nutricional en menores de 5 anos,clasificacion d,2003-08-01,127,182,127,182,309
30904,VINTO,estado nutricional en menores de 5 anos,clasificacion d,2003-08-01,35,25,35,25,60
50602,VITICHI,estado nutricional en menores de 5 anos,clasificacion d,2003-08-01,116,215,116,215,331
20306,WALDO BALLIVIAN,estado nutricional en menores de 5 anos,clasificacion d,2003-08-01,6,4,6,4,10
20903,YACO,estado nutricional en menores de 5 anos,clasificacion d,2003-08-01,33,17,33,17,50
60301,YACUIBA,estado nutricional en menores de 5 anos,clasificacion d,2003-08-01,77,68,77,68,145
10602,YAMPARAEZ,estado nutricional en menores de 5 anos,clasificacion d,2003-08-01,156,298,156,298,454
21103,YANACACHI,estado nutricional en menores de 5 anos,clasificacion d,2003-08-01,9,6,9,6,15
70403,YAPACANI,estado nutricional en menores de 5 anos,clasificacion d,2003-08-01,122,128,122,128,250
50103,YOCALLA,estado nutricional en menores de 5 anos,clasificacion d,2003-08-01,21,32,21,32,53
10102,YOTALA,estado nutricional en menores de 5 anos,clasificacion d,2003-08-01,99,187,99,187,286
60402,YUNCHARA,estado nutricional en menores de 5 anos,clasificacion d,2003-08-01,32,69,32,69,101
10301,ZUDAÃ‘EZ,estado nutricional en menores de 5 anos,clasificacion d,2003-08-01,59,128,59,128,187
51302,ACACIO,estado nutricional en menores de 5 anos,clasificacion d,2003-09-01,41,86,41,86,127
20201,ACHACACHI,estado nutricional en menores de 5 anos,clasificacion d,2003-09-01,135,142,135,142,277
20104,ACHOCALLA,estado nutricional en menores de 5 anos,clasificacion d,2003-09-01,13,23,13,23,36
30201,AIQUILE,estado nutricional en menores de 5 anos,clasificacion d,2003-09-01,62,46,62,46,108
31303,ALALAY,estado nutricional en menores de 5 anos,clasificacion d,2003-09-01,9,6,9,6,15
10404,ALCALA,estado nutricional en menores de 5 anos,clasificacion d,2003-09-01,32,78,32,78,110
20202,ANCORAIMES,estado nutricional en menores de 5 anos,clasificacion d,2003-09-01,69,103,69,103,172
41201,ANDAMARCA,estado nutricional en menores de 5 anos,clasificacion d,2003-09-01,13,17,13,17,30
30402,ANZALDO,estado nutricional en menores de 5 anos,clasificacion d,2003-09-01,19,49,19,49,68
20701,APOLO,estado nutricional en menores de 5 anos,clasificacion d,2003-09-01,54,42,54,42,96
51301,ARAMPAMPA,estado nutricional en menores de 5 anos,clasificacion d,2003-09-01,37,110,37,110,147
30501,ARANI,estado nutricional en menores de 5 anos,clasificacion d,2003-09-01,13,45,13,45,58
30403,ARBIETO,estado nutricional en menores de 5 anos,clasificacion d,2003-09-01,4,4,4,4,8
30601,ARQUE,estado nutricional en menores de 5 anos,clasificacion d,2003-09-01,72,77,72,77,149
71501,ASCENCION DE GUARAYOS,estado nutricional en menores de 5 anos,clasificacion d,2003-09-01,2,12,2,12,14
50802,ATOCHA,estado nutricional en menores de 5 anos,clasificacion d,2003-09-01,27,133,27,133,160
20503,AUCAPATA,estado nutricional en menores de 5 anos,clasificacion d,2003-09-01,10,7,10,7,17
20502,AYATA,estado nutricional en menores de 5 anos,clasificacion d,2003-09-01,10,3,10,3,13
21303,AYO AYO,estado nutricional en menores de 5 anos,clasificacion d,2003-09-01,16,3,16,3,19
30301,AYOPAYA (V. DE INDEPENDENCIA),estado nutricional en menores de 5 anos,clasificacion d,2003-09-01,87,101,87,101,188
10201,AZURDUY,estado nutricional en menores de 5 anos,clasificacion d,2003-09-01,160,278,160,278,438
21203,BATALLAS,estado nutricional en menores de 5 anos,clasificacion d,2003-09-01,20,20,20,20,40
80802,BAURES,estado nutricional en menores de 5 anos,clasificacion d,2003-09-01,18,14,18,14,32
41202,BELEN DE ANDAMARCA,estado nutricional en menores de 5 anos,clasificacion d,2003-09-01,3,0,3,0,3
50104,BELEN DE URMIRI,estado nutricional en menores de 5 anos,clasificacion d,2003-09-01,13,21,13,21,34
90104,BELLA FLOR,estado nutricional en menores de 5 anos,clasificacion d,2003-09-01,24,36,24,36,60
60202,BERMEJO,estado nutricional en menores de 5 anos,clasificacion d,2003-09-01,21,15,21,15,36
50301,BETANZOS,estado nutricional en menores de 5 anos,clasificacion d,2003-09-01,219,357,219,357,576
31501,BOLIVAR,estado nutricional en menores de 5 anos,clasificacion d,2003-09-01,98,105,98,105,203
90103,BOLPEBRA,estado nutricional en menores de 5 anos,clasificacion d,2003-09-01,9,12,9,12,21
70707,BOYUIBE,estado nutricional en menores de 5 anos,clasificacion d,2003-09-01,9,10,9,10,19
70401,BUENA VISTA,estado nutricional en menores de 5 anos,clasificacion d,2003-09-01,30,54,30,54,84
70703,CABEZAS,estado nutricional en menores de 5 anos,clasificacion d,2003-09-01,2,0,2,0,2
20905,CAIROMA,estado nutricional en menores de 5 anos,clasificacion d,2003-09-01,43,48,43,48,91
51102,"CAIZA ""D""",estado nutricional en menores de 5 anos,clasificacion d,2003-09-01,80,101,80,101,181
21003,CAJUATA,estado nutricional en menores de 5 anos,clasificacion d,2003-09-01,32,27,32,27,59
20303,CALACOTO,estado nutricional en menores de 5 anos,clasificacion d,2003-09-01,5,8,5,8,13
21304,CALAMARCA,estado nutricional en menores de 5 anos,clasificacion d,2003-09-01,102,108,102,108,210
10701,CAMARGO,estado nutricional en menores de 5 anos,clasificacion d,2003-09-01,110,125,110,125,235
10901,CAMATAQUI (C. VILLA ABECIA),estado nutricional en menores de 5 anos,clasificacion d,2003-09-01,6,24,6,24,30
70706,CAMIRI,estado nutricional en menores de 5 anos,clasificacion d,2003-09-01,151,155,151,155,306
30701,CAPINOTA,estado nutricional en menores de 5 anos,clasificacion d,2003-09-01,29,53,29,53,82
20302,CAQUIAVIRI,estado nutricional en menores de 5 anos,clasificacion d,2003-09-01,29,30,29,30,59
40102,CARACOLLO,estado nutricional en menores de 5 anos,clasificacion d,2003-09-01,28,42,28,42,70
22001,CARANAVI,estado nutricional en menores de 5 anos,clasificacion d,2003-09-01,121,77,121,77,198
41503,CARANGAS,estado nutricional en menores de 5 anos,clasificacion d,2003-09-01,0,2,0,2,2
60302,CARAPARI,estado nutricional en menores de 5 anos,clasificacion d,2003-09-01,23,34,23,34,57
50702,CARIPUYO,estado nutricional en menores de 5 anos,clasificacion d,2003-09-01,81,85,81,85,166
21902,CATACORA,estado nutricional en menores de 5 anos,clasificacion d,2003-09-01,0,1,0,1,1
40201,CHALLAPATA,estado nutricional en menores de 5 anos,clasificacion d,2003-09-01,71,63,71,63,134
50302,CHAQUI,estado nutricional en menores de 5 anos,clasificacion d,2003-09-01,43,58,43,58,101
70702,CHARAGUA,estado nutricional en menores de 5 anos,clasificacion d,2003-09-01,97,106,97,106,203
20305,CHARAÃ‘A,estado nutricional en menores de 5 anos,clasificacion d,2003-09-01,3,9,3,9,12
50202,CHAYANTA,estado nutricional en menores de 5 anos,clasificacion d,2003-09-01,48,68,48,68,116
31204,CHIMORE,estado nutricional en menores de 5 anos,clasificacion d,2003-09-01,16,18,16,18,34
40903,CHIPAYA,estado nutricional en menores de 5 anos,clasificacion d,2003-09-01,3,4,3,4,7
21101,CHULUMANI (V. DE LA LIBERTAD),estado nutricional en menores de 5 anos,clasificacion d,2003-09-01,28,20,28,20,48
20501,CHUMA,estado nutricional en menores de 5 anos,clasificacion d,2003-09-01,50,30,50,30,80
30801,CLIZA,estado nutricional en menores de 5 anos,clasificacion d,2003-09-01,12,11,12,11,23
90101,COBIJA,estado nutricional en menores de 5 anos,clasificacion d,2003-09-01,82,89,82,89,171
30101,COCHABAMBA,estado nutricional en menores de 5 anos,clasificacion d,2003-09-01,521,465,521,465,986
40902,COIPASA,estado nutricional en menores de 5 anos,clasificacion d,2003-09-01,3,1,3,1,4
30905,COLCAPIRHUA,estado nutricional en menores de 5 anos,clasificacion d,2003-09-01,60,43,60,43,103
50901,"COLCHA ""K""",estado nutricional en menores de 5 anos,clasificacion d,2003-09-01,40,36,40,36,76
21307,COLLANA,estado nutricional en menores de 5 anos,clasificacion d,2003-09-01,4,4,4,4,8
31002,COLOMI,estado nutricional en menores de 5 anos,clasificacion d,2003-09-01,81,105,81,105,186
50401,COLQUECHACA,estado nutricional en menores de 5 anos,clasificacion d,2003-09-01,186,164,186,164,350
21306,COLQUENCHA,estado nutricional en menores de 5 anos,clasificacion d,2003-09-01,29,16,29,16,45
21004,COLQUIRI,estado nutricional en menores de 5 anos,clasificacion d,2003-09-01,76,38,76,38,114
20304,COMANCHE,estado nutricional en menores de 5 anos,clasificacion d,2003-09-01,3,2,3,2,5
71301,COMARAPA,estado nutricional en menores de 5 anos,clasificacion d,2003-09-01,53,48,53,48,101
20605,COMBAYA,estado nutricional en menores de 5 anos,clasificacion d,2003-09-01,11,20,11,20,31
71101,CONCEPCION,estado nutricional en menores de 5 anos,clasificacion d,2003-09-01,12,44,12,44,56
21701,COPACABANA,estado nutricional en menores de 5 anos,clasificacion d,2003-09-01,26,22,26,22,48
21402,CORIPATA,estado nutricional en menores de 5 anos,clasificacion d,2003-09-01,3,0,3,0,3
20301,CORO CORO,estado nutricional en menores de 5 anos,clasificacion d,2003-09-01,31,28,31,28,59
21401,COROICO,estado nutricional en menores de 5 anos,clasificacion d,2003-09-01,36,20,36,20,56
40301,CORQUE,estado nutricional en menores de 5 anos,clasificacion d,2003-09-01,24,24,24,24,48
50601,COTAGAITA,estado nutricional en menores de 5 anos,clasificacion d,2003-09-01,99,112,99,112,211
31405,CUCHUMUELA (V. G. VILLARROEL),estado nutricional en menores de 5 anos,clasificacion d,2003-09-01,2,1,2,1,3
70704,CUEVO,estado nutricional en menores de 5 anos,clasificacion d,2003-09-01,18,9,18,9,27
10902,CULPINA,estado nutricional en menores de 5 anos,clasificacion d,2003-09-01,163,208,163,208,371
40401,CURAHUARA DE CARANGAS,estado nutricional en menores de 5 anos,clasificacion d,2003-09-01,13,11,13,11,24
21602,CURVA,estado nutricional en menores de 5 anos,clasificacion d,2003-09-01,12,14,12,14,26
20804,DESAGUADERO,estado nutricional en menores de 5 anos,clasificacion d,2003-09-01,10,8,10,8,18
20105,EL ALTO,estado nutricional en menores de 5 anos,clasificacion d,2003-09-01,1678,1019,1678,1019,2697
40103,EL CHORO,estado nutricional en menores de 5 anos,clasificacion d,2003-09-01,17,6,17,6,23
71503,EL PUENTE(STC),estado nutricional en menores de 5 anos,clasificacion d,2003-09-01,38,90,38,90,128
60502,EL PUENTE(TJA),estado nutricional en menores de 5 anos,clasificacion d,2003-09-01,76,149,76,149,225
70105,EL TORNO,estado nutricional en menores de 5 anos,clasificacion d,2003-09-01,67,74,67,74,141
10405,EL VILLAR,estado nutricional en menores de 5 anos,clasificacion d,2003-09-01,56,126,56,126,182
60601,ENTRE RIOS,estado nutricional en menores de 5 anos,clasificacion d,2003-09-01,45,65,45,65,110
41101,EUCALIPTUS,estado nutricional en menores de 5 anos,clasificacion d,2003-09-01,9,10,9,10,19
90503,EUREKA (SANTOS MERCADO),estado nutricional en menores de 5 anos,clasificacion d,2003-09-01,2,2,2,2,4
80402,EXALTACION,estado nutricional en menores de 5 anos,clasificacion d,2003-09-01,4,9,4,9,13
90203,FILADELFIA,estado nutricional en menores de 5 anos,clasificacion d,2003-09-01,7,8,7,8,15
71002,GENERAL SAAVEDRA,estado nutricional en menores de 5 anos,clasificacion d,2003-09-01,73,144,73,144,217
21601,GRAL. J.J. PEREZ (CHARAZANI),estado nutricional en menores de 5 anos,clasificacion d,2003-09-01,34,36,34,36,70
20602,GUANAY,estado nutricional en menores de 5 anos,clasificacion d,2003-09-01,140,91,140,91,231
20802,GUAQUI,estado nutricional en menores de 5 anos,clasificacion d,2003-09-01,15,6,15,6,21
80202,GUAYARAMERIN,estado nutricional en menores de 5 anos,clasificacion d,2003-09-01,114,88,114,88,202
70705,GUTIERREZ,estado nutricional en menores de 5 anos,clasificacion d,2003-09-01,80,156,80,156,236
10502,HUACARETA,estado nutricional en menores de 5 anos,clasificacion d,2003-09-01,57,88,57,88,145
11002,HUACAYA (VILLA DE HUACAYA),estado nutricional en menores de 5 anos,clasificacion d,2003-09-01,17,30,17,30,47
40501,HUACHACALLA,estado nutricional en menores de 5 anos,clasificacion d,2003-09-01,1,1,1,1,2
40701,HUANUNI,estado nutricional en menores de 5 anos,clasificacion d,2003-09-01,38,54,38,54,92
80803,HUARACAJE,estado nutricional en menores de 5 anos,clasificacion d,2003-09-01,3,3,3,3,6
41601,HUAYLLAMARCA,estado nutricional en menores de 5 anos,clasificacion d,2003-09-01,11,11,11,11,22
21005,ICHOCA,estado nutricional en menores de 5 anos,clasificacion d,2003-09-01,26,25,26,25,51
10304,ICLA,estado nutricional en menores de 5 anos,clasificacion d,2003-09-01,105,213,105,213,318
10703,INCAHUASI,estado nutricional en menores de 5 anos,clasificacion d,2003-09-01,155,127,155,127,282
21001,INQUISIVI,estado nutricional en menores de 5 anos,clasificacion d,2003-09-01,86,107,86,107,193
21102,IRUPANA (VILLA DE LANZA),estado nutricional en menores de 5 anos,clasificacion d,2003-09-01,25,48,25,48,73
21501,IXIAMAS,estado nutricional en menores de 5 anos,clasificacion d,2003-09-01,19,24,19,24,43
21105,LA ASUNTA,estado nutricional en menores de 5 anos,clasificacion d,2003-09-01,48,53,48,53,101
70104,LA GUARDIA,estado nutricional en menores de 5 anos,clasificacion d,2003-09-01,53,34,53,34,87
20101,LA PAZ,estado nutricional en menores de 5 anos,clasificacion d,2003-09-01,1146,861,1146,861,2007
41501,LA RIVERA,estado nutricional en menores de 5 anos,clasificacion d,2003-09-01,2,0,2,0,2
70701,LAGUNILLAS,estado nutricional en menores de 5 anos,clasificacion d,2003-09-01,20,38,20,38,58
21202,LAJA,estado nutricional en menores de 5 anos,clasificacion d,2003-09-01,28,12,28,12,40
10903,LAS CARRERAS,estado nutricional en menores de 5 anos,clasificacion d,2003-09-01,13,39,13,39,52
21006,LICOMA PAMPA,estado nutricional en menores de 5 anos,clasificacion d,2003-09-01,3,4,3,4,7
50203,LLALLAGUA,estado nutricional en menores de 5 anos,clasificacion d,2003-09-01,50,192,50,192,242
51401,LLICA,estado nutricional en menores de 5 anos,clasificacion d,2003-09-01,6,11,6,11,17
80601,LORETO,estado nutricional en menores de 5 anos,clasificacion d,2003-09-01,8,14,8,14,22
20901,LURIBAY,estado nutricional en menores de 5 anos,clasificacion d,2003-09-01,53,56,53,56,109
40702,MACHACAMARCA,estado nutricional en menores de 5 anos,clasificacion d,2003-09-01,2,5,2,5,7
11003,MACHARETI,estado nutricional en menores de 5 anos,clasificacion d,2003-09-01,24,72,24,72,96
80801,MAGDALENA,estado nutricional en menores de 5 anos,clasificacion d,2003-09-01,21,16,21,16,37
70903,MAIRANA,estado nutricional en menores de 5 anos,clasificacion d,2003-09-01,25,22,25,22,47
20904,MALLA,estado nutricional en menores de 5 anos,clasificacion d,2003-09-01,1,14,1,14,15
20103,MECAPACA,estado nutricional en menores de 5 anos,clasificacion d,2003-09-01,24,31,24,31,55
71003,MINEROS,estado nutricional en menores de 5 anos,clasificacion d,2003-09-01,113,84,113,84,197
31301,MIZQUE,estado nutricional en menores de 5 anos,clasificacion d,2003-09-01,10,13,10,13,23
20402,MOCOMOCO,estado nutricional en menores de 5 anos,clasificacion d,2003-09-01,62,60,62,60,122
51002,MOJINETE,estado nutricional en menores de 5 anos,clasificacion d,2003-09-01,4,3,4,3,7
10303,MOJOCOYA,estado nutricional en menores de 5 anos,clasificacion d,2003-09-01,66,133,66,133,199
10501,MONTEAGUDO,estado nutricional en menores de 5 anos,clasificacion d,2003-09-01,121,229,121,229,350
71001,MONTERO,estado nutricional en menores de 5 anos,clasificacion d,2003-09-01,210,143,210,143,353
70803,MORO MORO,estado nutricional en menores de 5 anos,clasificacion d,2003-09-01,6,19,6,19,25
30302,MOROCHATA,estado nutricional en menores de 5 anos,clasificacion d,2003-09-01,72,90,72,90,162
20307,NAZACARA DE PACAJES,estado nutricional en menores de 5 anos,clasificacion d,2003-09-01,1,0,1,0,1
90501,NUEVO MANOA (NUEVA ESPERANZA),estado nutricional en menores de 5 anos,clasificacion d,2003-09-01,0,1,0,1,1
50404,OCURI,estado nutricional en menores de 5 anos,clasificacion d,2003-09-01,110,122,110,122,232
30203,OMEREQUE,estado nutricional en menores de 5 anos,clasificacion d,2003-09-01,24,27,24,27,51
40101,ORURO,estado nutricional en menores de 5 anos,clasificacion d,2003-09-01,526,481,526,481,1007
60201,PADCAYA,estado nutricional en menores de 5 anos,clasificacion d,2003-09-01,43,63,43,63,106
10401,PADILLA,estado nutricional en menores de 5 anos,clasificacion d,2003-09-01,115,245,115,245,360
70502,PAILON,estado nutricional en menores de 5 anos,clasificacion d,2003-09-01,21,13,21,13,34
20102,PALCA,estado nutricional en menores de 5 anos,clasificacion d,2003-09-01,41,39,41,39,80
21104,PALOS BLANCOS,estado nutricional en menores de 5 anos,clasificacion d,2003-09-01,97,132,97,132,229
40802,PAMPA AULLAGAS,estado nutricional en menores de 5 anos,clasificacion d,2003-09-01,18,21,18,21,39
70902,PAMPA GRANDE,estado nutricional en menores de 5 anos,clasificacion d,2003-09-01,15,20,15,20,35
21802,PAPEL PAMPA,estado nutricional en menores de 5 anos,clasificacion d,2003-09-01,5,5,5,5,10
30202,PASORAPA,estado nutricional en menores de 5 anos,clasificacion d,2003-09-01,11,25,11,25,36
21305,PATACAMAYA,estado nutricional en menores de 5 anos,clasificacion d,2003-09-01,54,38,54,38,92
40602,PAZÃ‘A,estado nutricional en menores de 5 anos,clasificacion d,2003-09-01,13,20,13,20,33
20702,PELECHUCO,estado nutricional en menores de 5 anos,clasificacion d,2003-09-01,19,34,19,34,53
50403,POCOATA,estado nutricional en menores de 5 anos,clasificacion d,2003-09-01,165,184,165,184,349
31203,POCONA,estado nutricional en menores de 5 anos,clasificacion d,2003-09-01,37,48,37,48,85
31202,POJO (CBBA),estado nutricional en menores de 5 anos,clasificacion d,2003-09-01,111,128,111,128,239
40601,POOPO,estado nutricional en menores de 5 anos,clasificacion d,2003-09-01,9,35,9,35,44
51203,PORCO,estado nutricional en menores de 5 anos,clasificacion d,2003-09-01,22,17,22,17,39
10103,POROMA,estado nutricional en menores de 5 anos,clasificacion d,2003-09-01,126,249,126,249,375
70103,PORONGO,estado nutricional en menores de 5 anos,clasificacion d,2003-09-01,18,19,18,19,37
70601,PORTACHUELO,estado nutricional en menores de 5 anos,clasificacion d,2003-09-01,42,45,42,45,87
90102,PORVENIR,estado nutricional en menores de 5 anos,clasificacion d,2003-09-01,9,14,9,14,23
70804,POSTRER VALLE,estado nutricional en menores de 5 anos,clasificacion d,2003-09-01,9,23,9,23,32
50101,POTOSI,estado nutricional en menores de 5 anos,clasificacion d,2003-09-01,592,387,592,387,979
10302,PRESTO,estado nutricional en menores de 5 anos,clasificacion d,2003-09-01,70,100,70,100,170
70805,PUCARA,estado nutricional en menores de 5 anos,clasificacion d,2003-09-01,6,3,6,3,9
21201,PUCARANI,estado nutricional en menores de 5 anos,clasificacion d,2003-09-01,18,14,18,14,32
20401,PUERTO ACOSTA,estado nutricional en menores de 5 anos,clasificacion d,2003-09-01,76,105,76,105,181
20403,PUERTO CARABUCO,estado nutricional en menores de 5 anos,clasificacion d,2003-09-01,55,90,55,90,145
90301,PUERTO GONZALO MORENO,estado nutricional en menores de 5 anos,clasificacion d,2003-09-01,39,86,39,86,125
21204,PUERTO PEREZ,estado nutricional en menores de 5 anos,clasificacion d,2003-09-01,13,20,13,20,33
71402,PUERTO QUIJARRO,estado nutricional en menores de 5 anos,clasificacion d,2003-09-01,23,11,23,11,34
90201,PUERTO RICO,estado nutricional en menores de 5 anos,clasificacion d,2003-09-01,5,15,5,15,20
80703,PUERTO SILES,estado nutricional en menores de 5 anos,clasificacion d,2003-09-01,2,3,2,3,5
71401,PUERTO SUAREZ,estado nutricional en menores de 5 anos,clasificacion d,2003-09-01,30,24,30,24,54
31205,PUERTO VILLARROEL,estado nutricional en menores de 5 anos,clasificacion d,2003-09-01,170,144,170,144,314
51101,PUNA,estado nutricional en menores de 5 anos,clasificacion d,2003-09-01,204,225,204,225,429
31401,PUNATA,estado nutricional en menores de 5 anos,clasificacion d,2003-09-01,33,41,33,41,74
20604,QUIABAYA,estado nutricional en menores de 5 anos,clasificacion d,2003-09-01,10,22,10,22,32
30901,QUILLACOLLO,estado nutricional en menores de 5 anos,clasificacion d,2003-09-01,189,79,189,79,268
21002,QUIME,estado nutricional en menores de 5 anos,clasificacion d,2003-09-01,74,46,74,46,120
70904,QUIRUSILLAS,estado nutricional en menores de 5 anos,clasificacion d,2003-09-01,6,2,6,2,8
50402,RAVELO,estado nutricional en menores de 5 anos,clasificacion d,2003-09-01,209,230,209,230,439
80301,REYES,estado nutricional en menores de 5 anos,clasificacion d,2003-09-01,17,16,17,16,33
80201,RIBERALTA,estado nutricional en menores de 5 anos,clasificacion d,2003-09-01,378,283,378,283,661
70503,ROBORE,estado nutricional en menores de 5 anos,clasificacion d,2003-09-01,34,33,34,33,67
80304,RURRENABAQUE,estado nutricional en menores de 5 anos,clasificacion d,2003-09-01,35,21,35,21,56
40901,SABAYA,estado nutricional en menores de 5 anos,clasificacion d,2003-09-01,9,3,9,3,12
31001,SACABA,estado nutricional en menores de 5 anos,clasificacion d,2003-09-01,141,145,141,145,286
30404,SACABAMBA,estado nutricional en menores de 5 anos,clasificacion d,2003-09-01,22,25,22,25,47
50701,SACACA,estado nutricional en menores de 5 anos,clasificacion d,2003-09-01,210,464,210,464,674
71302,SAIPINA,estado nutricional en menores de 5 anos,clasificacion d,2003-09-01,9,15,9,15,24
40801,SALINAS DE GARCI MENDOZA,estado nutricional en menores de 5 anos,clasificacion d,2003-09-01,12,38,12,38,50
70901,SAMAIPATA,estado nutricional en menores de 5 anos,clasificacion d,2003-09-01,20,9,20,9,29
51601,SAN AGUSTIN,estado nutricional en menores de 5 anos,clasificacion d,2003-09-01,4,5,4,5,9
80602,SAN ANDRES,estado nutricional en menores de 5 anos,clasificacion d,2003-09-01,20,41,20,41,61
51003,SAN ANTONIO DE ESMORUCO,estado nutricional en menores de 5 anos,clasificacion d,2003-09-01,6,4,6,4,10
71105,SAN ANTONIO DE LOMERIO,estado nutricional en menores de 5 anos,clasificacion d,2003-09-01,69,115,69,115,184
31403,SAN BENITO,estado nutricional en menores de 5 anos,clasificacion d,2003-09-01,39,6,39,6,45
80302,SAN BORJA,estado nutricional en menores de 5 anos,clasificacion d,2003-09-01,138,135,138,135,273
21502,SAN BUENA VENTURA,estado nutricional en menores de 5 anos,clasificacion d,2003-09-01,29,39,29,39,68
70402,SAN CARLOS,estado nutricional en menores de 5 anos,clasificacion d,2003-09-01,78,76,78,76,154
80501,SAN IGNACIO,estado nutricional en menores de 5 anos,clasificacion d,2003-09-01,118,107,118,107,225
70301,SAN IGNACIO DE VELASCO,estado nutricional en menores de 5 anos,clasificacion d,2003-09-01,224,168,224,168,392
80102,SAN JAVIER(BNI),estado nutricional en menores de 5 anos,clasificacion d,2003-09-01,13,15,13,15,28
71102,SAN JAVIER(STC),estado nutricional en menores de 5 anos,clasificacion d,2003-09-01,31,42,31,42,73
80701,SAN JOAQUIN,estado nutricional en menores de 5 anos,clasificacion d,2003-09-01,8,4,8,4,12
70501,SAN JOSE DE CHIQUITOS,estado nutricional en menores de 5 anos,clasificacion d,2003-09-01,29,13,29,13,42
71104,SAN JULIAN,estado nutricional en menores de 5 anos,clasificacion d,2003-09-01,105,188,105,188,293
90302,SAN LORENZO(PND),estado nutricional en menores de 5 anos,clasificacion d,2003-09-01,4,9,4,9,13
60501,SAN LORENZO(TJA),estado nutricional en menores de 5 anos,clasificacion d,2003-09-01,45,42,45,42,87
10702,SAN LUCAS,estado nutricional en menores de 5 anos,clasificacion d,2003-09-01,456,569,456,569,1025
70302,SAN MIGUEL DE VELASCO,estado nutricional en menores de 5 anos,clasificacion d,2003-09-01,52,67,52,67,119
51001,SAN PABLO DE LIPEZ,estado nutricional en menores de 5 anos,clasificacion d,2003-09-01,13,20,13,20,33
50501,SAN PEDRO DE BUENA VISTA,estado nutricional en menores de 5 anos,clasificacion d,2003-09-01,141,202,141,202,343
21801,SAN PEDRO DE CURAHUARA,estado nutricional en menores de 5 anos,clasificacion d,2003-09-01,16,33,16,33,49
50902,SAN PEDRO DE QUEMES,estado nutricional en menores de 5 anos,clasificacion d,2003-09-01,2,3,2,3,5
21702,SAN PEDRO DE TIQUINA,estado nutricional en menores de 5 anos,clasificacion d,2003-09-01,7,8,7,8,15
70303,SAN RAFAEL,estado nutricional en menores de 5 anos,clasificacion d,2003-09-01,19,15,19,15,34
80702,SAN RAMON,estado nutricional en menores de 5 anos,clasificacion d,2003-09-01,4,15,4,15,19
80401,SANTA ANA,estado nutricional en menores de 5 anos,clasificacion d,2003-09-01,14,6,14,6,20
70101,SANTA CRUZ DE LA SIERRA,estado nutricional en menores de 5 anos,clasificacion d,2003-09-01,860,460,860,460,1320
80303,SANTA ROSA,estado nutricional en menores de 5 anos,clasificacion d,2003-09-01,11,15,11,15,26
70602,SANTA ROSA DEL SARA,estado nutricional en menores de 5 anos,clasificacion d,2003-09-01,12,7,12,7,19
20308,SANTIAGO DE CALLAPA,estado nutricional en menores de 5 anos,clasificacion d,2003-09-01,14,20,14,20,34
41401,SANTIAGO DE HUARI,estado nutricional en menores de 5 anos,clasificacion d,2003-09-01,16,33,16,33,49
21901,SANTIAGO DE MACHACA,estado nutricional en menores de 5 anos,clasificacion d,2003-09-01,7,8,7,8,15
30702,SANTIVAÃ‘ES,estado nutricional en menores de 5 anos,clasificacion d,2003-09-01,20,14,20,14,34
40202,SANTUARIO DE QUILLACAS,estado nutricional en menores de 5 anos,clasificacion d,2003-09-01,7,14,7,14,21
20902,SAPAHAQUI,estado nutricional en menores de 5 anos,clasificacion d,2003-09-01,25,19,25,19,44
90303,SENA,estado nutricional en menores de 5 anos,clasificacion d,2003-09-01,5,7,5,7,12
21301,SICA SICA (VILLA AROMA),estado nutricional en menores de 5 anos,clasificacion d,2003-09-01,97,101,97,101,198
30703,SICAYA,estado nutricional en menores de 5 anos,clasificacion d,2003-09-01,9,9,9,9,18
30902,SIPE SIPE,estado nutricional en menores de 5 anos,clasificacion d,2003-09-01,171,149,171,149,320
10403,SOPACHUY,estado nutricional en menores de 5 anos,clasificacion d,2003-09-01,75,116,75,116,191
20601,SORATA,estado nutricional en menores de 5 anos,clasificacion d,2003-09-01,30,75,30,75,105
10101,SUCRE,estado nutricional en menores de 5 anos,clasificacion d,2003-09-01,560,639,560,639,1199
31404,TACACHI,estado nutricional en menores de 5 anos,clasificacion d,2003-09-01,5,2,5,2,7
20603,TACACOMA,estado nutricional en menores de 5 anos,clasificacion d,2003-09-01,19,7,19,7,26
50303,TACOBAMBA,estado nutricional en menores de 5 anos,clasificacion d,2003-09-01,75,84,75,84,159
30602,TACOPAYA,estado nutricional en menores de 5 anos,clasificacion d,2003-09-01,79,119,79,119,198
51402,TAHUA,estado nutricional en menores de 5 anos,clasificacion d,2003-09-01,4,7,4,7,11
31101,TAPACARI,estado nutricional en menores de 5 anos,clasificacion d,2003-09-01,206,194,206,194,400
10601,TARABUCO,estado nutricional en menores de 5 anos,clasificacion d,2003-09-01,273,485,273,485,758
30401,TARATA,estado nutricional en menores de 5 anos,clasificacion d,2003-09-01,33,64,33,64,97
60101,TARIJA,estado nutricional en menores de 5 anos,clasificacion d,2003-09-01,174,174,174,174,348
10202,TARVITA,estado nutricional en menores de 5 anos,clasificacion d,2003-09-01,111,265,111,265,376
20803,TIAWANACU,estado nutricional en menores de 5 anos,clasificacion d,2003-09-01,26,13,26,13,39
50102,TINGUIPAYA,estado nutricional en menores de 5 anos,clasificacion d,2003-09-01,135,233,135,233,368
20606,TIPUANI,estado nutricional en menores de 5 anos,clasificacion d,2003-09-01,25,23,25,23,48
30903,TIQUIPAYA,estado nutricional en menores de 5 anos,clasificacion d,2003-09-01,54,52,54,52,106
31601,TIRAQUE (CBBA),estado nutricional en menores de 5 anos,clasificacion d,2003-09-01,126,150,126,150,276
21703,TITO YUPANQUI (PARQUIPUJIO),estado nutricional en menores de 5 anos,clasificacion d,2003-09-01,4,10,4,10,14
30802,TOCO,estado nutricional en menores de 5 anos,clasificacion d,2003-09-01,1,26,1,26,27
30803,TOLATA,estado nutricional en menores de 5 anos,clasificacion d,2003-09-01,18,12,18,12,30
41001,TOLEDO,estado nutricional en menores de 5 anos,clasificacion d,2003-09-01,10,6,10,6,16
51202,TOMAVE,estado nutricional en menores de 5 anos,clasificacion d,2003-09-01,79,82,79,82,161
10402,TOMINA,estado nutricional en menores de 5 anos,clasificacion d,2003-09-01,110,206,110,206,316
50502,TORO TORO,estado nutricional en menores de 5 anos,clasificacion d,2003-09-01,107,120,107,120,227
31201,TOTORA(CBBA),estado nutricional en menores de 5 anos,clasificacion d,2003-09-01,69,61,69,61,130
41301,TOTORA(ORR),estado nutricional en menores de 5 anos,clasificacion d,2003-09-01,14,34,14,34,48
80101,TRINIDAD,estado nutricional en menores de 5 anos,clasificacion d,2003-09-01,130,162,130,162,292
50801,TUPIZA,estado nutricional en menores de 5 anos,clasificacion d,2003-09-01,129,233,129,233,362
40402,TURCO,estado nutricional en menores de 5 anos,clasificacion d,2003-09-01,19,17,19,17,36
21302,UMALA,estado nutricional en menores de 5 anos,clasificacion d,2003-09-01,27,19,27,19,46
50201,UNCIA,estado nutricional en menores de 5 anos,clasificacion d,2003-09-01,35,13,35,13,48
60401,URIONDO (A. CONCEPCION),estado nutricional en menores de 5 anos,clasificacion d,2003-09-01,64,100,64,100,164
51201,UYUNI,estado nutricional en menores de 5 anos,clasificacion d,2003-09-01,51,62,51,62,113
30502,VACAS,estado nutricional en menores de 5 anos,clasificacion d,2003-09-01,31,24,31,24,55
70801,VALLEGRANDE,estado nutricional en menores de 5 anos,clasificacion d,2003-09-01,20,27,20,27,47
20801,VIACHA,estado nutricional en menores de 5 anos,clasificacion d,2003-09-01,95,87,95,87,182
31302,VILA VILA,estado nutricional en menores de 5 anos,clasificacion d,2003-09-01,11,17,11,17,28
60303,VILLA MONTES,estado nutricional en menores de 5 anos,clasificacion d,2003-09-01,74,75,74,75,149
31402,VILLA RIVERO,estado nutricional en menores de 5 anos,clasificacion d,2003-09-01,23,8,23,8,31
10801,VILLA SERRANO,estado nutricional en menores de 5 anos,clasificacion d,2003-09-01,112,247,112,247,359
31003,VILLA TUNARI,estado nutricional en menores de 5 anos,clasificacion d,2003-09-01,141,115,141,115,256
11001,VILLA VACA GUZMAN (MUYUPAMPA),estado nutricional en menores de 5 anos,clasificacion d,2003-09-01,41,48,41,48,89
51501,VILLAZON,estado nutricional en menores de 5 anos,clasificacion d,2003-09-01,121,140,121,140,261
30904,VINTO,estado nutricional en menores de 5 anos,clasificacion d,2003-09-01,55,37,55,37,92
50602,VITICHI,estado nutricional en menores de 5 anos,clasificacion d,2003-09-01,56,69,56,69,125
20306,WALDO BALLIVIAN,estado nutricional en menores de 5 anos,clasificacion d,2003-09-01,11,8,11,8,19
20903,YACO,estado nutricional en menores de 5 anos,clasificacion d,2003-09-01,22,20,22,20,42
60301,YACUIBA,estado nutricional en menores de 5 anos,clasificacion d,2003-09-01,0,66,0,66,66
10602,YAMPARAEZ,estado nutricional en menores de 5 anos,clasificacion d,2003-09-01,151,286,151,286,437
21103,YANACACHI,estado nutricional en menores de 5 anos,clasificacion d,2003-09-01,11,7,11,7,18
70403,YAPACANI,estado nutricional en menores de 5 anos,clasificacion d,2003-09-01,90,133,90,133,223
50103,YOCALLA,estado nutricional en menores de 5 anos,clasificacion d,2003-09-01,22,28,22,28,50
10102,YOTALA,estado nutricional en menores de 5 anos,clasificacion d,2003-09-01,102,174,102,174,276
60402,YUNCHARA,estado nutricional en menores de 5 anos,clasificacion d,2003-09-01,31,49,31,49,80
10301,ZUDAÃ‘EZ,estado nutricional en menores de 5 anos,clasificacion d,2003-09-01,61,113,61,113,174
51302,ACACIO,estado nutricional en menores de 5 anos,clasificacion d,2003-10-01,50,109,50,109,159
20201,ACHACACHI,estado nutricional en menores de 5 anos,clasificacion d,2003-10-01,112,106,112,106,218
20104,ACHOCALLA,estado nutricional en menores de 5 anos,clasificacion d,2003-10-01,14,17,14,17,31
30201,AIQUILE,estado nutricional en menores de 5 anos,clasificacion d,2003-10-01,52,86,52,86,138
31303,ALALAY,estado nutricional en menores de 5 anos,clasificacion d,2003-10-01,18,17,18,17,35
10404,ALCALA,estado nutricional en menores de 5 anos,clasificacion d,2003-10-01,30,82,30,82,112
20202,ANCORAIMES,estado nutricional en menores de 5 anos,clasificacion d,2003-10-01,56,74,56,74,130
41201,ANDAMARCA,estado nutricional en menores de 5 anos,clasificacion d,2003-10-01,6,7,6,7,13
30402,ANZALDO,estado nutricional en menores de 5 anos,clasificacion d,2003-10-01,22,57,22,57,79
20701,APOLO,estado nutricional en menores de 5 anos,clasificacion d,2003-10-01,16,18,16,18,34
51301,ARAMPAMPA,estado nutricional en menores de 5 anos,clasificacion d,2003-10-01,31,90,31,90,121
30501,ARANI,estado nutricional en menores de 5 anos,clasificacion d,2003-10-01,27,33,27,33,60
30403,ARBIETO,estado nutricional en menores de 5 anos,clasificacion d,2003-10-01,10,2,10,2,12
30601,ARQUE,estado nutricional en menores de 5 anos,clasificacion d,2003-10-01,68,99,68,99,167
71501,ASCENCION DE GUARAYOS,estado nutricional en menores de 5 anos,clasificacion d,2003-10-01,29,36,29,36,65
50802,ATOCHA,estado nutricional en menores de 5 anos,clasificacion d,2003-10-01,38,148,38,148,186
20503,AUCAPATA,estado nutricional en menores de 5 anos,clasificacion d,2003-10-01,10,14,10,14,24
20502,AYATA,estado nutricional en menores de 5 anos,clasificacion d,2003-10-01,16,22,16,22,38
21303,AYO AYO,estado nutricional en menores de 5 anos,clasificacion d,2003-10-01,14,17,14,17,31
30301,AYOPAYA (V. DE INDEPENDENCIA),estado nutricional en menores de 5 anos,clasificacion d,2003-10-01,103,142,103,142,245
10201,AZURDUY,estado nutricional en menores de 5 anos,clasificacion d,2003-10-01,145,316,145,316,461
21203,BATALLAS,estado nutricional en menores de 5 anos,clasificacion d,2003-10-01,29,27,29,27,56
80802,BAURES,estado nutricional en menores de 5 anos,clasificacion d,2003-10-01,18,17,18,17,35
41202,BELEN DE ANDAMARCA,estado nutricional en menores de 5 anos,clasificacion d,2003-10-01,4,2,4,2,6
50104,BELEN DE URMIRI,estado nutricional en menores de 5 anos,clasificacion d,2003-10-01,6,16,6,16,22
90104,BELLA FLOR,estado nutricional en menores de 5 anos,clasificacion d,2003-10-01,13,12,13,12,25
60202,BERMEJO,estado nutricional en menores de 5 anos,clasificacion d,2003-10-01,20,23,20,23,43
50301,BETANZOS,estado nutricional en menores de 5 anos,clasificacion d,2003-10-01,191,250,191,250,441
31501,BOLIVAR,estado nutricional en menores de 5 anos,clasificacion d,2003-10-01,87,81,87,81,168
90103,BOLPEBRA,estado nutricional en menores de 5 anos,clasificacion d,2003-10-01,9,16,9,16,25
70707,BOYUIBE,estado nutricional en menores de 5 anos,clasificacion d,2003-10-01,18,22,18,22,40
70401,BUENA VISTA,estado nutricional en menores de 5 anos,clasificacion d,2003-10-01,57,51,57,51,108
70703,CABEZAS,estado nutricional en menores de 5 anos,clasificacion d,2003-10-01,49,65,49,65,114
20905,CAIROMA,estado nutricional en menores de 5 anos,clasificacion d,2003-10-01,77,94,77,94,171
51102,"CAIZA ""D""",estado nutricional en menores de 5 anos,clasificacion d,2003-10-01,61,70,61,70,131
21003,CAJUATA,estado nutricional en menores de 5 anos,clasificacion d,2003-10-01,40,33,40,33,73
20303,CALACOTO,estado nutricional en menores de 5 anos,clasificacion d,2003-10-01,26,21,26,21,47
21304,CALAMARCA,estado nutricional en menores de 5 anos,clasificacion d,2003-10-01,197,183,197,183,380
10701,CAMARGO,estado nutricional en menores de 5 anos,clasificacion d,2003-10-01,97,130,97,130,227
10901,CAMATAQUI (C. VILLA ABECIA),estado nutricional en menores de 5 anos,clasificacion d,2003-10-01,17,27,17,27,44
70706,CAMIRI,estado nutricional en menores de 5 anos,clasificacion d,2003-10-01,135,137,135,137,272
30701,CAPINOTA,estado nutricional en menores de 5 anos,clasificacion d,2003-10-01,23,41,23,41,64
20302,CAQUIAVIRI,estado nutricional en menores de 5 anos,clasificacion d,2003-10-01,43,37,43,37,80
40102,CARACOLLO,estado nutricional en menores de 5 anos,clasificacion d,2003-10-01,54,77,54,77,131
22001,CARANAVI,estado nutricional en menores de 5 anos,clasificacion d,2003-10-01,100,138,100,138,238
60302,CARAPARI,estado nutricional en menores de 5 anos,clasificacion d,2003-10-01,25,30,25,30,55
50702,CARIPUYO,estado nutricional en menores de 5 anos,clasificacion d,2003-10-01,90,147,90,147,237
21902,CATACORA,estado nutricional en menores de 5 anos,clasificacion d,2003-10-01,4,8,4,8,12
40201,CHALLAPATA,estado nutricional en menores de 5 anos,clasificacion d,2003-10-01,107,145,107,145,252
50302,CHAQUI,estado nutricional en menores de 5 anos,clasificacion d,2003-10-01,17,46,17,46,63
70702,CHARAGUA,estado nutricional en menores de 5 anos,clasificacion d,2003-10-01,104,109,104,109,213
20305,CHARAÃ‘A,estado nutricional en menores de 5 anos,clasificacion d,2003-10-01,1,2,1,2,3
50202,CHAYANTA,estado nutricional en menores de 5 anos,clasificacion d,2003-10-01,99,204,99,204,303
31204,CHIMORE,estado nutricional en menores de 5 anos,clasificacion d,2003-10-01,21,16,21,16,37
40903,CHIPAYA,estado nutricional en menores de 5 anos,clasificacion d,2003-10-01,4,11,4,11,15
21101,CHULUMANI (V. DE LA LIBERTAD),estado nutricional en menores de 5 anos,clasificacion d,2003-10-01,14,14,14,14,28
20501,CHUMA,estado nutricional en menores de 5 anos,clasificacion d,2003-10-01,27,32,27,32,59
30801,CLIZA,estado nutricional en menores de 5 anos,clasificacion d,2003-10-01,11,8,11,8,19
90101,COBIJA,estado nutricional en menores de 5 anos,clasificacion d,2003-10-01,44,50,44,50,94
30101,COCHABAMBA,estado nutricional en menores de 5 anos,clasificacion d,2003-10-01,604,513,604,513,1117
40902,COIPASA,estado nutricional en menores de 5 anos,clasificacion d,2003-10-01,2,0,2,0,2
30905,COLCAPIRHUA,estado nutricional en menores de 5 anos,clasificacion d,2003-10-01,52,60,52,60,112
50901,"COLCHA ""K""",estado nutricional en menores de 5 anos,clasificacion d,2003-10-01,62,80,62,80,142
21307,COLLANA,estado nutricional en menores de 5 anos,clasificacion d,2003-10-01,7,1,7,1,8
31002,COLOMI,estado nutricional en menores de 5 anos,clasificacion d,2003-10-01,95,91,95,91,186
50401,COLQUECHACA,estado nutricional en menores de 5 anos,clasificacion d,2003-10-01,166,131,166,131,297
21306,COLQUENCHA,estado nutricional en menores de 5 anos,clasificacion d,2003-10-01,37,21,37,21,58
21004,COLQUIRI,estado nutricional en menores de 5 anos,clasificacion d,2003-10-01,84,45,84,45,129
20304,COMANCHE,estado nutricional en menores de 5 anos,clasificacion d,2003-10-01,5,2,5,2,7
71301,COMARAPA,estado nutricional en menores de 5 anos,clasificacion d,2003-10-01,69,42,69,42,111
20605,COMBAYA,estado nutricional en menores de 5 anos,clasificacion d,2003-10-01,1,10,1,10,11
71101,CONCEPCION,estado nutricional en menores de 5 anos,clasificacion d,2003-10-01,16,0,16,0,16
21701,COPACABANA,estado nutricional en menores de 5 anos,clasificacion d,2003-10-01,14,20,14,20,34
21402,CORIPATA,estado nutricional en menores de 5 anos,clasificacion d,2003-10-01,8,0,8,0,8
20301,CORO CORO,estado nutricional en menores de 5 anos,clasificacion d,2003-10-01,24,18,24,18,42
21401,COROICO,estado nutricional en menores de 5 anos,clasificacion d,2003-10-01,25,20,25,20,45
40301,CORQUE,estado nutricional en menores de 5 anos,clasificacion d,2003-10-01,43,13,43,13,56
50601,COTAGAITA,estado nutricional en menores de 5 anos,clasificacion d,2003-10-01,232,343,232,343,575
31405,CUCHUMUELA (V. G. VILLARROEL),estado nutricional en menores de 5 anos,clasificacion d,2003-10-01,9,13,9,13,22
70704,CUEVO,estado nutricional en menores de 5 anos,clasificacion d,2003-10-01,14,29,14,29,43
10902,CULPINA,estado nutricional en menores de 5 anos,clasificacion d,2003-10-01,199,242,199,242,441
40401,CURAHUARA DE CARANGAS,estado nutricional en menores de 5 anos,clasificacion d,2003-10-01,35,25,35,25,60
21602,CURVA,estado nutricional en menores de 5 anos,clasificacion d,2003-10-01,12,11,12,11,23
20804,DESAGUADERO,estado nutricional en menores de 5 anos,clasificacion d,2003-10-01,8,5,8,5,13
20105,EL ALTO,estado nutricional en menores de 5 anos,clasificacion d,2003-10-01,1578,916,1578,916,2494
40103,EL CHORO,estado nutricional en menores de 5 anos,clasificacion d,2003-10-01,8,4,8,4,12
71503,EL PUENTE(STC),estado nutricional en menores de 5 anos,clasificacion d,2003-10-01,23,72,23,72,95
60502,EL PUENTE(TJA),estado nutricional en menores de 5 anos,clasificacion d,2003-10-01,72,140,72,140,212
70105,EL TORNO,estado nutricional en menores de 5 anos,clasificacion d,2003-10-01,65,59,65,59,124
10405,EL VILLAR,estado nutricional en menores de 5 anos,clasificacion d,2003-10-01,54,137,54,137,191
60601,ENTRE RIOS,estado nutricional en menores de 5 anos,clasificacion d,2003-10-01,85,186,85,186,271
41101,EUCALIPTUS,estado nutricional en menores de 5 anos,clasificacion d,2003-10-01,17,17,17,17,34
80402,EXALTACION,estado nutricional en menores de 5 anos,clasificacion d,2003-10-01,27,39,27,39,66
90203,FILADELFIA,estado nutricional en menores de 5 anos,clasificacion d,2003-10-01,16,25,16,25,41
71002,GENERAL SAAVEDRA,estado nutricional en menores de 5 anos,clasificacion d,2003-10-01,102,119,102,119,221
21601,GRAL. J.J. PEREZ (CHARAZANI),estado nutricional en menores de 5 anos,clasificacion d,2003-10-01,52,89,52,89,141
20602,GUANAY,estado nutricional en menores de 5 anos,clasificacion d,2003-10-01,140,113,140,113,253
20802,GUAQUI,estado nutricional en menores de 5 anos,clasificacion d,2003-10-01,14,7,14,7,21
80202,GUAYARAMERIN,estado nutricional en menores de 5 anos,clasificacion d,2003-10-01,126,120,126,120,246
70705,GUTIERREZ,estado nutricional en menores de 5 anos,clasificacion d,2003-10-01,117,194,117,194,311
10502,HUACARETA,estado nutricional en menores de 5 anos,clasificacion d,2003-10-01,52,124,52,124,176
11002,HUACAYA (VILLA DE HUACAYA),estado nutricional en menores de 5 anos,clasificacion d,2003-10-01,11,30,11,30,41
40501,HUACHACALLA,estado nutricional en menores de 5 anos,clasificacion d,2003-10-01,1,1,1,1,2
40701,HUANUNI,estado nutricional en menores de 5 anos,clasificacion d,2003-10-01,55,52,55,52,107
80803,HUARACAJE,estado nutricional en menores de 5 anos,clasificacion d,2003-10-01,6,0,6,0,6
41601,HUAYLLAMARCA,estado nutricional en menores de 5 anos,clasificacion d,2003-10-01,12,16,12,16,28
21005,ICHOCA,estado nutricional en menores de 5 anos,clasificacion d,2003-10-01,31,20,31,20,51
10304,ICLA,estado nutricional en menores de 5 anos,clasificacion d,2003-10-01,84,152,84,152,236
10703,INCAHUASI,estado nutricional en menores de 5 anos,clasificacion d,2003-10-01,192,207,192,207,399
21001,INQUISIVI,estado nutricional en menores de 5 anos,clasificacion d,2003-10-01,66,56,66,56,122
21501,IXIAMAS,estado nutricional en menores de 5 anos,clasificacion d,2003-10-01,21,41,21,41,62
21105,LA ASUNTA,estado nutricional en menores de 5 anos,clasificacion d,2003-10-01,67,41,67,41,108
70104,LA GUARDIA,estado nutricional en menores de 5 anos,clasificacion d,2003-10-01,86,77,86,77,163
20101,LA PAZ,estado nutricional en menores de 5 anos,clasificacion d,2003-10-01,1254,1055,1254,1055,2309
41501,LA RIVERA,estado nutricional en menores de 5 anos,clasificacion d,2003-10-01,2,1,2,1,3
70701,LAGUNILLAS,estado nutricional en menores de 5 anos,clasificacion d,2003-10-01,35,61,35,61,96
21202,LAJA,estado nutricional en menores de 5 anos,clasificacion d,2003-10-01,28,23,28,23,51
10903,LAS CARRERAS,estado nutricional en menores de 5 anos,clasificacion d,2003-10-01,17,43,17,43,60
21006,LICOMA PAMPA,estado nutricional en menores de 5 anos,clasificacion d,2003-10-01,6,6,6,6,12
50203,LLALLAGUA,estado nutricional en menores de 5 anos,clasificacion d,2003-10-01,117,287,117,287,404
51401,LLICA,estado nutricional en menores de 5 anos,clasificacion d,2003-10-01,22,37,22,37,59
80601,LORETO,estado nutricional en menores de 5 anos,clasificacion d,2003-10-01,3,10,3,10,13
20901,LURIBAY,estado nutricional en menores de 5 anos,clasificacion d,2003-10-01,56,49,56,49,105
40702,MACHACAMARCA,estado nutricional en menores de 5 anos,clasificacion d,2003-10-01,11,16,11,16,27
11003,MACHARETI,estado nutricional en menores de 5 anos,clasificacion d,2003-10-01,40,123,40,123,163
80801,MAGDALENA,estado nutricional en menores de 5 anos,clasificacion d,2003-10-01,15,19,15,19,34
70903,MAIRANA,estado nutricional en menores de 5 anos,clasificacion d,2003-10-01,7,20,7,20,27
20904,MALLA,estado nutricional en menores de 5 anos,clasificacion d,2003-10-01,15,19,15,19,34
20103,MECAPACA,estado nutricional en menores de 5 anos,clasificacion d,2003-10-01,21,21,21,21,42
71003,MINEROS,estado nutricional en menores de 5 anos,clasificacion d,2003-10-01,137,110,137,110,247
31301,MIZQUE,estado nutricional en menores de 5 anos,clasificacion d,2003-10-01,62,45,62,45,107
20402,MOCOMOCO,estado nutricional en menores de 5 anos,clasificacion d,2003-10-01,50,56,50,56,106
51002,MOJINETE,estado nutricional en menores de 5 anos,clasificacion d,2003-10-01,3,6,3,6,9
10303,MOJOCOYA,estado nutricional en menores de 5 anos,clasificacion d,2003-10-01,62,137,62,137,199
10501,MONTEAGUDO,estado nutricional en menores de 5 anos,clasificacion d,2003-10-01,139,242,139,242,381
71001,MONTERO,estado nutricional en menores de 5 anos,clasificacion d,2003-10-01,310,238,310,238,548
70803,MORO MORO,estado nutricional en menores de 5 anos,clasificacion d,2003-10-01,14,23,14,23,37
30302,MOROCHATA,estado nutricional en menores de 5 anos,clasificacion d,2003-10-01,113,84,113,84,197
20307,NAZACARA DE PACAJES,estado nutricional en menores de 5 anos,clasificacion d,2003-10-01,3,0,3,0,3
90501,NUEVO MANOA (NUEVA ESPERANZA),estado nutricional en menores de 5 anos,clasificacion d,2003-10-01,2,2,2,2,4
50404,OCURI,estado nutricional en menores de 5 anos,clasificacion d,2003-10-01,86,103,86,103,189
30203,OMEREQUE,estado nutricional en menores de 5 anos,clasificacion d,2003-10-01,8,7,8,7,15
40101,ORURO,estado nutricional en menores de 5 anos,clasificacion d,2003-10-01,612,524,612,524,1136
60201,PADCAYA,estado nutricional en menores de 5 anos,clasificacion d,2003-10-01,52,105,52,105,157
10401,PADILLA,estado nutricional en menores de 5 anos,clasificacion d,2003-10-01,134,230,134,230,364
70502,PAILON,estado nutricional en menores de 5 anos,clasificacion d,2003-10-01,18,32,18,32,50
20102,PALCA,estado nutricional en menores de 5 anos,clasificacion d,2003-10-01,42,52,42,52,94
21104,PALOS BLANCOS,estado nutricional en menores de 5 anos,clasificacion d,2003-10-01,78,86,78,86,164
40802,PAMPA AULLAGAS,estado nutricional en menores de 5 anos,clasificacion d,2003-10-01,10,5,10,5,15
70902,PAMPA GRANDE,estado nutricional en menores de 5 anos,clasificacion d,2003-10-01,24,24,24,24,48
21802,PAPEL PAMPA,estado nutricional en menores de 5 anos,clasificacion d,2003-10-01,6,7,6,7,13
30202,PASORAPA,estado nutricional en menores de 5 anos,clasificacion d,2003-10-01,5,15,5,15,20
21305,PATACAMAYA,estado nutricional en menores de 5 anos,clasificacion d,2003-10-01,70,39,70,39,109
40602,PAZÃ‘A,estado nutricional en menores de 5 anos,clasificacion d,2003-10-01,12,10,12,10,22
20702,PELECHUCO,estado nutricional en menores de 5 anos,clasificacion d,2003-10-01,25,22,25,22,47
50403,POCOATA,estado nutricional en menores de 5 anos,clasificacion d,2003-10-01,162,219,162,219,381
31203,POCONA,estado nutricional en menores de 5 anos,clasificacion d,2003-10-01,57,66,57,66,123
31202,POJO (CBBA),estado nutricional en menores de 5 anos,clasificacion d,2003-10-01,125,140,125,140,265
40601,POOPO,estado nutricional en menores de 5 anos,clasificacion d,2003-10-01,8,21,8,21,29
51203,PORCO,estado nutricional en menores de 5 anos,clasificacion d,2003-10-01,3,3,3,3,6
10103,POROMA,estado nutricional en menores de 5 anos,clasificacion d,2003-10-01,134,213,134,213,347
70103,PORONGO,estado nutricional en menores de 5 anos,clasificacion d,2003-10-01,14,8,14,8,22
70601,PORTACHUELO,estado nutricional en menores de 5 anos,clasificacion d,2003-10-01,51,50,51,50,101
90102,PORVENIR,estado nutricional en menores de 5 anos,clasificacion d,2003-10-01,2,5,2,5,7
70804,POSTRER VALLE,estado nutricional en menores de 5 anos,clasificacion d,2003-10-01,9,17,9,17,26
50101,POTOSI,estado nutricional en menores de 5 anos,clasificacion d,2003-10-01,678,431,678,431,1109
10302,PRESTO,estado nutricional en menores de 5 anos,clasificacion d,2003-10-01,74,88,74,88,162
70805,PUCARA,estado nutricional en menores de 5 anos,clasificacion d,2003-10-01,22,35,22,35,57
21201,PUCARANI,estado nutricional en menores de 5 anos,clasificacion d,2003-10-01,25,26,25,26,51
20401,PUERTO ACOSTA,estado nutricional en menores de 5 anos,clasificacion d,2003-10-01,77,112,77,112,189
20403,PUERTO CARABUCO,estado nutricional en menores de 5 anos,clasificacion d,2003-10-01,43,89,43,89,132
90301,PUERTO GONZALO MORENO,estado nutricional en menores de 5 anos,clasificacion d,2003-10-01,24,48,24,48,72
21204,PUERTO PEREZ,estado nutricional en menores de 5 anos,clasificacion d,2003-10-01,7,23,7,23,30
71402,PUERTO QUIJARRO,estado nutricional en menores de 5 anos,clasificacion d,2003-10-01,35,9,35,9,44
90201,PUERTO RICO,estado nutricional en menores de 5 anos,clasificacion d,2003-10-01,0,18,0,18,18
71401,PUERTO SUAREZ,estado nutricional en menores de 5 anos,clasificacion d,2003-10-01,57,31,57,31,88
31205,PUERTO VILLARROEL,estado nutricional en menores de 5 anos,clasificacion d,2003-10-01,214,177,214,177,391
51101,PUNA,estado nutricional en menores de 5 anos,clasificacion d,2003-10-01,129,150,129,150,279
31401,PUNATA,estado nutricional en menores de 5 anos,clasificacion d,2003-10-01,96,87,96,87,183
20604,QUIABAYA,estado nutricional en menores de 5 anos,clasificacion d,2003-10-01,5,34,5,34,39
30901,QUILLACOLLO,estado nutricional en menores de 5 anos,clasificacion d,2003-10-01,177,118,177,118,295
21002,QUIME,estado nutricional en menores de 5 anos,clasificacion d,2003-10-01,72,79,72,79,151
70904,QUIRUSILLAS,estado nutricional en menores de 5 anos,clasificacion d,2003-10-01,6,6,6,6,12
50402,RAVELO,estado nutricional en menores de 5 anos,clasificacion d,2003-10-01,185,204,185,204,389
80301,REYES,estado nutricional en menores de 5 anos,clasificacion d,2003-10-01,52,81,52,81,133
80201,RIBERALTA,estado nutricional en menores de 5 anos,clasificacion d,2003-10-01,426,278,426,278,704
70503,ROBORE,estado nutricional en menores de 5 anos,clasificacion d,2003-10-01,35,18,35,18,53
80304,RURRENABAQUE,estado nutricional en menores de 5 anos,clasificacion d,2003-10-01,33,13,33,13,46
40901,SABAYA,estado nutricional en menores de 5 anos,clasificacion d,2003-10-01,9,5,9,5,14
31001,SACABA,estado nutricional en menores de 5 anos,clasificacion d,2003-10-01,92,34,92,34,126
30404,SACABAMBA,estado nutricional en menores de 5 anos,clasificacion d,2003-10-01,20,28,20,28,48
50701,SACACA,estado nutricional en menores de 5 anos,clasificacion d,2003-10-01,273,503,273,503,776
71302,SAIPINA,estado nutricional en menores de 5 anos,clasificacion d,2003-10-01,6,15,6,15,21
40801,SALINAS DE GARCI MENDOZA,estado nutricional en menores de 5 anos,clasificacion d,2003-10-01,16,15,16,15,31
70901,SAMAIPATA,estado nutricional en menores de 5 anos,clasificacion d,2003-10-01,37,36,37,36,73
51601,SAN AGUSTIN,estado nutricional en menores de 5 anos,clasificacion d,2003-10-01,12,12,12,12,24
80602,SAN ANDRES,estado nutricional en menores de 5 anos,clasificacion d,2003-10-01,8,10,8,10,18
51003,SAN ANTONIO DE ESMORUCO,estado nutricional en menores de 5 anos,clasificacion d,2003-10-01,4,23,4,23,27
71105,SAN ANTONIO DE LOMERIO,estado nutricional en menores de 5 anos,clasificacion d,2003-10-01,74,113,74,113,187
31403,SAN BENITO,estado nutricional en menores de 5 anos,clasificacion d,2003-10-01,17,18,17,18,35
80302,SAN BORJA,estado nutricional en menores de 5 anos,clasificacion d,2003-10-01,159,105,159,105,264
21502,SAN BUENA VENTURA,estado nutricional en menores de 5 anos,clasificacion d,2003-10-01,46,25,46,25,71
70402,SAN CARLOS,estado nutricional en menores de 5 anos,clasificacion d,2003-10-01,57,61,57,61,118
80501,SAN IGNACIO,estado nutricional en menores de 5 anos,clasificacion d,2003-10-01,103,127,103,127,230
70301,SAN IGNACIO DE VELASCO,estado nutricional en menores de 5 anos,clasificacion d,2003-10-01,250,188,250,188,438
80102,SAN JAVIER(BNI),estado nutricional en menores de 5 anos,clasificacion d,2003-10-01,8,11,8,11,19
71102,SAN JAVIER(STC),estado nutricional en menores de 5 anos,clasificacion d,2003-10-01,53,47,53,47,100
80701,SAN JOAQUIN,estado nutricional en menores de 5 anos,clasificacion d,2003-10-01,7,24,7,24,31
70501,SAN JOSE DE CHIQUITOS,estado nutricional en menores de 5 anos,clasificacion d,2003-10-01,37,22,37,22,59
71104,SAN JULIAN,estado nutricional en menores de 5 anos,clasificacion d,2003-10-01,89,152,89,152,241
90302,SAN LORENZO(PND),estado nutricional en menores de 5 anos,clasificacion d,2003-10-01,1,1,1,1,2
60501,SAN LORENZO(TJA),estado nutricional en menores de 5 anos,clasificacion d,2003-10-01,47,68,47,68,115
10702,SAN LUCAS,estado nutricional en menores de 5 anos,clasificacion d,2003-10-01,366,459,366,459,825
71201,SAN MATIAS,estado nutricional en menores de 5 anos,clasificacion d,2003-10-01,55,30,55,30,85
70302,SAN MIGUEL DE VELASCO,estado nutricional en menores de 5 anos,clasificacion d,2003-10-01,59,71,59,71,130
51001,SAN PABLO DE LIPEZ,estado nutricional en menores de 5 anos,clasificacion d,2003-10-01,20,17,20,17,37
50501,SAN PEDRO DE BUENA VISTA,estado nutricional en menores de 5 anos,clasificacion d,2003-10-01,157,253,157,253,410
21801,SAN PEDRO DE CURAHUARA,estado nutricional en menores de 5 anos,clasificacion d,2003-10-01,15,21,15,21,36
50902,SAN PEDRO DE QUEMES,estado nutricional en menores de 5 anos,clasificacion d,2003-10-01,3,1,3,1,4
21702,SAN PEDRO DE TIQUINA,estado nutricional en menores de 5 anos,clasificacion d,2003-10-01,3,4,3,4,7
90202,SAN PEDRO(PND),estado nutricional en menores de 5 anos,clasificacion d,2003-10-01,8,9,8,9,17
70303,SAN RAFAEL,estado nutricional en menores de 5 anos,clasificacion d,2003-10-01,31,38,31,38,69
80702,SAN RAMON,estado nutricional en menores de 5 anos,clasificacion d,2003-10-01,8,10,8,10,18
80401,SANTA ANA,estado nutricional en menores de 5 anos,clasificacion d,2003-10-01,32,24,32,24,56
70101,SANTA CRUZ DE LA SIERRA,estado nutricional en menores de 5 anos,clasificacion d,2003-10-01,1092,549,1092,549,1641
80303,SANTA ROSA,estado nutricional en menores de 5 anos,clasificacion d,2003-10-01,12,11,12,11,23
70602,SANTA ROSA DEL SARA,estado nutricional en menores de 5 anos,clasificacion d,2003-10-01,16,15,16,15,31
20308,SANTIAGO DE CALLAPA,estado nutricional en menores de 5 anos,clasificacion d,2003-10-01,29,42,29,42,71
41401,SANTIAGO DE HUARI,estado nutricional en menores de 5 anos,clasificacion d,2003-10-01,22,39,22,39,61
21901,SANTIAGO DE MACHACA,estado nutricional en menores de 5 anos,clasificacion d,2003-10-01,12,9,12,9,21
30702,SANTIVAÃ‘ES,estado nutricional en menores de 5 anos,clasificacion d,2003-10-01,21,20,21,20,41
40202,SANTUARIO DE QUILLACAS,estado nutricional en menores de 5 anos,clasificacion d,2003-10-01,5,8,5,8,13
20902,SAPAHAQUI,estado nutricional en menores de 5 anos,clasificacion d,2003-10-01,39,49,39,49,88
90303,SENA,estado nutricional en menores de 5 anos,clasificacion d,2003-10-01,5,6,5,6,11
21301,SICA SICA (VILLA AROMA),estado nutricional en menores de 5 anos,clasificacion d,2003-10-01,135,114,135,114,249
30703,SICAYA,estado nutricional en menores de 5 anos,clasificacion d,2003-10-01,10,14,10,14,24
30902,SIPE SIPE,estado nutricional en menores de 5 anos,clasificacion d,2003-10-01,145,117,145,117,262
10403,SOPACHUY,estado nutricional en menores de 5 anos,clasificacion d,2003-10-01,81,152,81,152,233
20601,SORATA,estado nutricional en menores de 5 anos,clasificacion d,2003-10-01,46,55,46,55,101
10101,SUCRE,estado nutricional en menores de 5 anos,clasificacion d,2003-10-01,446,597,446,597,1043
31404,TACACHI,estado nutricional en menores de 5 anos,clasificacion d,2003-10-01,11,0,11,0,11
20603,TACACOMA,estado nutricional en menores de 5 anos,clasificacion d,2003-10-01,13,2,13,2,15
50303,TACOBAMBA,estado nutricional en menores de 5 anos,clasificacion d,2003-10-01,68,117,68,117,185
30602,TACOPAYA,estado nutricional en menores de 5 anos,clasificacion d,2003-10-01,71,135,71,135,206
51402,TAHUA,estado nutricional en menores de 5 anos,clasificacion d,2003-10-01,8,5,8,5,13
31101,TAPACARI,estado nutricional en menores de 5 anos,clasificacion d,2003-10-01,138,130,138,130,268
10601,TARABUCO,estado nutricional en menores de 5 anos,clasificacion d,2003-10-01,262,490,262,490,752
30401,TARATA,estado nutricional en menores de 5 anos,clasificacion d,2003-10-01,40,27,40,27,67
60101,TARIJA,estado nutricional en menores de 5 anos,clasificacion d,2003-10-01,316,301,316,301,617
10202,TARVITA,estado nutricional en menores de 5 anos,clasificacion d,2003-10-01,109,163,109,163,272
20803,TIAWANACU,estado nutricional en menores de 5 anos,clasificacion d,2003-10-01,25,15,25,15,40
50102,TINGUIPAYA,estado nutricional en menores de 5 anos,clasificacion d,2003-10-01,170,286,170,286,456
20606,TIPUANI,estado nutricional en menores de 5 anos,clasificacion d,2003-10-01,9,20,9,20,29
30903,TIQUIPAYA,estado nutricional en menores de 5 anos,clasificacion d,2003-10-01,85,67,85,67,152
31601,TIRAQUE (CBBA),estado nutricional en menores de 5 anos,clasificacion d,2003-10-01,198,124,198,124,322
21703,TITO YUPANQUI (PARQUIPUJIO),estado nutricional en menores de 5 anos,clasificacion d,2003-10-01,13,11,13,11,24
30802,TOCO,estado nutricional en menores de 5 anos,clasificacion d,2003-10-01,1,11,1,11,12
30803,TOLATA,estado nutricional en menores de 5 anos,clasificacion d,2003-10-01,13,9,13,9,22
41001,TOLEDO,estado nutricional en menores de 5 anos,clasificacion d,2003-10-01,17,10,17,10,27
51202,TOMAVE,estado nutricional en menores de 5 anos,clasificacion d,2003-10-01,66,84,66,84,150
10402,TOMINA,estado nutricional en menores de 5 anos,clasificacion d,2003-10-01,126,256,126,256,382
50502,TORO TORO,estado nutricional en menores de 5 anos,clasificacion d,2003-10-01,95,106,95,106,201
31201,TOTORA(CBBA),estado nutricional en menores de 5 anos,clasificacion d,2003-10-01,50,40,50,40,90
41301,TOTORA(ORR),estado nutricional en menores de 5 anos,clasificacion d,2003-10-01,19,22,19,22,41
70802,TRIGAL,estado nutricional en menores de 5 anos,clasificacion d,2003-10-01,4,6,4,6,10
80101,TRINIDAD,estado nutricional en menores de 5 anos,clasificacion d,2003-10-01,177,185,177,185,362
50801,TUPIZA,estado nutricional en menores de 5 anos,clasificacion d,2003-10-01,167,255,167,255,422
40402,TURCO,estado nutricional en menores de 5 anos,clasificacion d,2003-10-01,15,18,15,18,33
21302,UMALA,estado nutricional en menores de 5 anos,clasificacion d,2003-10-01,6,40,6,40,46
50201,UNCIA,estado nutricional en menores de 5 anos,clasificacion d,2003-10-01,64,20,64,20,84
60401,URIONDO (A. CONCEPCION),estado nutricional en menores de 5 anos,clasificacion d,2003-10-01,93,143,93,143,236
71502,URUBICHA,estado nutricional en menores de 5 anos,clasificacion d,2003-10-01,96,192,96,192,288
51201,UYUNI,estado nutricional en menores de 5 anos,clasificacion d,2003-10-01,55,83,55,83,138
30502,VACAS,estado nutricional en menores de 5 anos,clasificacion d,2003-10-01,39,14,39,14,53
70801,VALLEGRANDE,estado nutricional en menores de 5 anos,clasificacion d,2003-10-01,65,105,65,105,170
20801,VIACHA,estado nutricional en menores de 5 anos,clasificacion d,2003-10-01,108,86,108,86,194
31302,VILA VILA,estado nutricional en menores de 5 anos,clasificacion d,2003-10-01,38,67,38,67,105
60303,VILLA MONTES,estado nutricional en menores de 5 anos,clasificacion d,2003-10-01,94,79,94,79,173
31402,VILLA RIVERO,estado nutricional en menores de 5 anos,clasificacion d,2003-10-01,22,19,22,19,41
10801,VILLA SERRANO,estado nutricional en menores de 5 anos,clasificacion d,2003-10-01,114,252,114,252,366
31003,VILLA TUNARI,estado nutricional en menores de 5 anos,clasificacion d,2003-10-01,219,275,219,275,494
11001,VILLA VACA GUZMAN (MUYUPAMPA),estado nutricional en menores de 5 anos,clasificacion d,2003-10-01,80,109,80,109,189
51501,VILLAZON,estado nutricional en menores de 5 anos,clasificacion d,2003-10-01,147,212,147,212,359
30904,VINTO,estado nutricional en menores de 5 anos,clasificacion d,2003-10-01,58,22,58,22,80
50602,VITICHI,estado nutricional en menores de 5 anos,clasificacion d,2003-10-01,132,226,132,226,358
20306,WALDO BALLIVIAN,estado nutricional en menores de 5 anos,clasificacion d,2003-10-01,13,9,13,9,22
20903,YACO,estado nutricional en menores de 5 anos,clasificacion d,2003-10-01,45,47,45,47,92
60301,YACUIBA,estado nutricional en menores de 5 anos,clasificacion d,2003-10-01,16,32,16,32,48
10602,YAMPARAEZ,estado nutricional en menores de 5 anos,clasificacion d,2003-10-01,154,288,154,288,442
21103,YANACACHI,estado nutricional en menores de 5 anos,clasificacion d,2003-10-01,13,10,13,10,23
70403,YAPACANI,estado nutricional en menores de 5 anos,clasificacion d,2003-10-01,153,136,153,136,289
50103,YOCALLA,estado nutricional en menores de 5 anos,clasificacion d,2003-10-01,28,62,28,62,90
10102,YOTALA,estado nutricional en menores de 5 anos,clasificacion d,2003-10-01,98,180,98,180,278
60402,YUNCHARA,estado nutricional en menores de 5 anos,clasificacion d,2003-10-01,69,95,69,95,164
10301,ZUDAÃ‘EZ,estado nutricional en menores de 5 anos,clasificacion d,2003-10-01,63,103,63,103,166
51302,ACACIO,estado nutricional en menores de 5 anos,clasificacion d,2003-11-01,48,80,48,80,128
20201,ACHACACHI,estado nutricional en menores de 5 anos,clasificacion d,2003-11-01,127,156,127,156,283
20104,ACHOCALLA,estado nutricional en menores de 5 anos,clasificacion d,2003-11-01,23,34,23,34,57
30201,AIQUILE,estado nutricional en menores de 5 anos,clasificacion d,2003-11-01,57,53,57,53,110
31303,ALALAY,estado nutricional en menores de 5 anos,clasificacion d,2003-11-01,12,9,12,9,21
10404,ALCALA,estado nutricional en menores de 5 anos,clasificacion d,2003-11-01,33,70,33,70,103
20202,ANCORAIMES,estado nutricional en menores de 5 anos,clasificacion d,2003-11-01,78,99,78,99,177
41201,ANDAMARCA,estado nutricional en menores de 5 anos,clasificacion d,2003-11-01,4,8,4,8,12
40603,ANTEQUERA,estado nutricional en menores de 5 anos,clasificacion d,2003-11-01,4,3,4,3,7
30402,ANZALDO,estado nutricional en menores de 5 anos,clasificacion d,2003-11-01,11,27,11,27,38
20701,APOLO,estado nutricional en menores de 5 anos,clasificacion d,2003-11-01,34,34,34,34,68
51301,ARAMPAMPA,estado nutricional en menores de 5 anos,clasificacion d,2003-11-01,30,84,30,84,114
30501,ARANI,estado nutricional en menores de 5 anos,clasificacion d,2003-11-01,32,23,32,23,55
30403,ARBIETO,estado nutricional en menores de 5 anos,clasificacion d,2003-11-01,7,2,7,2,9
30601,ARQUE,estado nutricional en menores de 5 anos,clasificacion d,2003-11-01,85,116,85,116,201
50802,ATOCHA,estado nutricional en menores de 5 anos,clasificacion d,2003-11-01,46,162,46,162,208
20503,AUCAPATA,estado nutricional en menores de 5 anos,clasificacion d,2003-11-01,34,37,34,37,71
20502,AYATA,estado nutricional en menores de 5 anos,clasificacion d,2003-11-01,64,54,64,54,118
21303,AYO AYO,estado nutricional en menores de 5 anos,clasificacion d,2003-11-01,11,5,11,5,16
30301,AYOPAYA (V. DE INDEPENDENCIA),estado nutricional en menores de 5 anos,clasificacion d,2003-11-01,43,55,43,55,98
10201,AZURDUY,estado nutricional en menores de 5 anos,clasificacion d,2003-11-01,157,340,157,340,497
21203,BATALLAS,estado nutricional en menores de 5 anos,clasificacion d,2003-11-01,35,26,35,26,61
80802,BAURES,estado nutricional en menores de 5 anos,clasificacion d,2003-11-01,12,10,12,10,22
41202,BELEN DE ANDAMARCA,estado nutricional en menores de 5 anos,clasificacion d,2003-11-01,2,0,2,0,2
50104,BELEN DE URMIRI,estado nutricional en menores de 5 anos,clasificacion d,2003-11-01,5,17,5,17,22
90104,BELLA FLOR,estado nutricional en menores de 5 anos,clasificacion d,2003-11-01,6,12,6,12,18
60202,BERMEJO,estado nutricional en menores de 5 anos,clasificacion d,2003-11-01,7,11,7,11,18
50301,BETANZOS,estado nutricional en menores de 5 anos,clasificacion d,2003-11-01,219,366,219,366,585
31501,BOLIVAR,estado nutricional en menores de 5 anos,clasificacion d,2003-11-01,47,71,47,71,118
90103,BOLPEBRA,estado nutricional en menores de 5 anos,clasificacion d,2003-11-01,5,11,5,11,16
70707,BOYUIBE,estado nutricional en menores de 5 anos,clasificacion d,2003-11-01,12,8,12,8,20
70401,BUENA VISTA,estado nutricional en menores de 5 anos,clasificacion d,2003-11-01,28,39,28,39,67
70703,CABEZAS,estado nutricional en menores de 5 anos,clasificacion d,2003-11-01,30,39,30,39,69
20905,CAIROMA,estado nutricional en menores de 5 anos,clasificacion d,2003-11-01,69,63,69,63,132
51102,"CAIZA ""D""",estado nutricional en menores de 5 anos,clasificacion d,2003-11-01,36,32,36,32,68
21003,CAJUATA,estado nutricional en menores de 5 anos,clasificacion d,2003-11-01,16,17,16,17,33
20303,CALACOTO,estado nutricional en menores de 5 anos,clasificacion d,2003-11-01,14,8,14,8,22
21304,CALAMARCA,estado nutricional en menores de 5 anos,clasificacion d,2003-11-01,102,85,102,85,187
10701,CAMARGO,estado nutricional en menores de 5 anos,clasificacion d,2003-11-01,125,146,125,146,271
10901,CAMATAQUI (C. VILLA ABECIA),estado nutricional en menores de 5 anos,clasificacion d,2003-11-01,18,16,18,16,34
70706,CAMIRI,estado nutricional en menores de 5 anos,clasificacion d,2003-11-01,144,115,144,115,259
30701,CAPINOTA,estado nutricional en menores de 5 anos,clasificacion d,2003-11-01,19,51,19,51,70
20302,CAQUIAVIRI,estado nutricional en menores de 5 anos,clasificacion d,2003-11-01,27,13,27,13,40
40102,CARACOLLO,estado nutricional en menores de 5 anos,clasificacion d,2003-11-01,50,64,50,64,114
22001,CARANAVI,estado nutricional en menores de 5 anos,clasificacion d,2003-11-01,199,207,199,207,406
60302,CARAPARI,estado nutricional en menores de 5 anos,clasificacion d,2003-11-01,30,40,30,40,70
50702,CARIPUYO,estado nutricional en menores de 5 anos,clasificacion d,2003-11-01,82,112,82,112,194
21902,CATACORA,estado nutricional en menores de 5 anos,clasificacion d,2003-11-01,1,4,1,4,5
21803,CHACARILLA,estado nutricional en menores de 5 anos,clasificacion d,2003-11-01,11,23,11,23,34
40201,CHALLAPATA,estado nutricional en menores de 5 anos,clasificacion d,2003-11-01,63,95,63,95,158
50302,CHAQUI,estado nutricional en menores de 5 anos,clasificacion d,2003-11-01,35,50,35,50,85
70702,CHARAGUA,estado nutricional en menores de 5 anos,clasificacion d,2003-11-01,119,117,119,117,236
20305,CHARAÃ‘A,estado nutricional en menores de 5 anos,clasificacion d,2003-11-01,3,3,3,3,6
50202,CHAYANTA,estado nutricional en menores de 5 anos,clasificacion d,2003-11-01,86,149,86,149,235
31204,CHIMORE,estado nutricional en menores de 5 anos,clasificacion d,2003-11-01,34,29,34,29,63
40903,CHIPAYA,estado nutricional en menores de 5 anos,clasificacion d,2003-11-01,1,5,1,5,6
40302,CHOQUE COTA,estado nutricional en menores de 5 anos,clasificacion d,2003-11-01,5,9,5,9,14
21101,CHULUMANI (V. DE LA LIBERTAD),estado nutricional en menores de 5 anos,clasificacion d,2003-11-01,26,65,26,65,91
20501,CHUMA,estado nutricional en menores de 5 anos,clasificacion d,2003-11-01,78,86,78,86,164
30801,CLIZA,estado nutricional en menores de 5 anos,clasificacion d,2003-11-01,14,2,14,2,16
90101,COBIJA,estado nutricional en menores de 5 anos,clasificacion d,2003-11-01,97,78,97,78,175
30101,COCHABAMBA,estado nutricional en menores de 5 anos,clasificacion d,2003-11-01,518,485,518,485,1003
40902,COIPASA,estado nutricional en menores de 5 anos,clasificacion d,2003-11-01,1,1,1,1,2
30905,COLCAPIRHUA,estado nutricional en menores de 5 anos,clasificacion d,2003-11-01,72,47,72,47,119
50901,"COLCHA ""K""",estado nutricional en menores de 5 anos,clasificacion d,2003-11-01,35,54,35,54,89
21307,COLLANA,estado nutricional en menores de 5 anos,clasificacion d,2003-11-01,3,3,3,3,6
31002,COLOMI,estado nutricional en menores de 5 anos,clasificacion d,2003-11-01,83,87,83,87,170
50401,COLQUECHACA,estado nutricional en menores de 5 anos,clasificacion d,2003-11-01,185,133,185,133,318
21306,COLQUENCHA,estado nutricional en menores de 5 anos,clasificacion d,2003-11-01,32,32,32,32,64
21004,COLQUIRI,estado nutricional en menores de 5 anos,clasificacion d,2003-11-01,85,74,85,74,159
20304,COMANCHE,estado nutricional en menores de 5 anos,clasificacion d,2003-11-01,12,16,12,16,28
71301,COMARAPA,estado nutricional en menores de 5 anos,clasificacion d,2003-11-01,54,57,54,57,111
20605,COMBAYA,estado nutricional en menores de 5 anos,clasificacion d,2003-11-01,4,12,4,12,16
71101,CONCEPCION,estado nutricional en menores de 5 anos,clasificacion d,2003-11-01,38,12,38,12,50
21701,COPACABANA,estado nutricional en menores de 5 anos,clasificacion d,2003-11-01,17,12,17,12,29
21402,CORIPATA,estado nutricional en menores de 5 anos,clasificacion d,2003-11-01,7,1,7,1,8
20301,CORO CORO,estado nutricional en menores de 5 anos,clasificacion d,2003-11-01,52,46,52,46,98
21401,COROICO,estado nutricional en menores de 5 anos,clasificacion d,2003-11-01,26,29,26,29,55
40301,CORQUE,estado nutricional en menores de 5 anos,clasificacion d,2003-11-01,21,32,21,32,53
50601,COTAGAITA,estado nutricional en menores de 5 anos,clasificacion d,2003-11-01,209,262,209,262,471
31405,CUCHUMUELA (V. G. VILLARROEL),estado nutricional en menores de 5 anos,clasificacion d,2003-11-01,8,3,8,3,11
70704,CUEVO,estado nutricional en menores de 5 anos,clasificacion d,2003-11-01,23,13,23,13,36
10902,CULPINA,estado nutricional en menores de 5 anos,clasificacion d,2003-11-01,227,296,227,296,523
40401,CURAHUARA DE CARANGAS,estado nutricional en menores de 5 anos,clasificacion d,2003-11-01,19,9,19,9,28
21602,CURVA,estado nutricional en menores de 5 anos,clasificacion d,2003-11-01,23,25,23,25,48
20804,DESAGUADERO,estado nutricional en menores de 5 anos,clasificacion d,2003-11-01,10,2,10,2,12
20105,EL ALTO,estado nutricional en menores de 5 anos,clasificacion d,2003-11-01,1699,1199,1699,1199,2898
40103,EL CHORO,estado nutricional en menores de 5 anos,clasificacion d,2003-11-01,8,7,8,7,15
71503,EL PUENTE(STC),estado nutricional en menores de 5 anos,clasificacion d,2003-11-01,60,58,60,58,118
60502,EL PUENTE(TJA),estado nutricional en menores de 5 anos,clasificacion d,2003-11-01,60,140,60,140,200
70105,EL TORNO,estado nutricional en menores de 5 anos,clasificacion d,2003-11-01,75,98,75,98,173
10405,EL VILLAR,estado nutricional en menores de 5 anos,clasificacion d,2003-11-01,65,157,65,157,222
60601,ENTRE RIOS,estado nutricional en menores de 5 anos,clasificacion d,2003-11-01,69,120,69,120,189
40502,ESCARA,estado nutricional en menores de 5 anos,clasificacion d,2003-11-01,1,3,1,3,4
41101,EUCALIPTUS,estado nutricional en menores de 5 anos,clasificacion d,2003-11-01,17,23,17,23,40
90503,EUREKA (SANTOS MERCADO),estado nutricional en menores de 5 anos,clasificacion d,2003-11-01,4,4,4,4,8
80402,EXALTACION,estado nutricional en menores de 5 anos,clasificacion d,2003-11-01,10,18,10,18,28
90203,FILADELFIA,estado nutricional en menores de 5 anos,clasificacion d,2003-11-01,6,25,6,25,31
71002,GENERAL SAAVEDRA,estado nutricional en menores de 5 anos,clasificacion d,2003-11-01,98,132,98,132,230
21601,GRAL. J.J. PEREZ (CHARAZANI),estado nutricional en menores de 5 anos,clasificacion d,2003-11-01,85,158,85,158,243
20602,GUANAY,estado nutricional en menores de 5 anos,clasificacion d,2003-11-01,108,158,108,158,266
20802,GUAQUI,estado nutricional en menores de 5 anos,clasificacion d,2003-11-01,17,6,17,6,23
80202,GUAYARAMERIN,estado nutricional en menores de 5 anos,clasificacion d,2003-11-01,80,92,80,92,172
70705,GUTIERREZ,estado nutricional en menores de 5 anos,clasificacion d,2003-11-01,90,170,90,170,260
10502,HUACARETA,estado nutricional en menores de 5 anos,clasificacion d,2003-11-01,64,123,64,123,187
11002,HUACAYA (VILLA DE HUACAYA),estado nutricional en menores de 5 anos,clasificacion d,2003-11-01,17,28,17,28,45
40501,HUACHACALLA,estado nutricional en menores de 5 anos,clasificacion d,2003-11-01,9,1,9,1,10
40701,HUANUNI,estado nutricional en menores de 5 anos,clasificacion d,2003-11-01,39,37,39,37,76
80803,HUARACAJE,estado nutricional en menores de 5 anos,clasificacion d,2003-11-01,8,12,8,12,20
41601,HUAYLLAMARCA,estado nutricional en menores de 5 anos,clasificacion d,2003-11-01,13,4,13,4,17
21005,ICHOCA,estado nutricional en menores de 5 anos,clasificacion d,2003-11-01,15,26,15,26,41
10304,ICLA,estado nutricional en menores de 5 anos,clasificacion d,2003-11-01,115,262,115,262,377
10703,INCAHUASI,estado nutricional en menores de 5 anos,clasificacion d,2003-11-01,237,273,237,273,510
21001,INQUISIVI,estado nutricional en menores de 5 anos,clasificacion d,2003-11-01,92,93,92,93,185
21102,IRUPANA (VILLA DE LANZA),estado nutricional en menores de 5 anos,clasificacion d,2003-11-01,41,72,41,72,113
21501,IXIAMAS,estado nutricional en menores de 5 anos,clasificacion d,2003-11-01,26,68,26,68,94
21105,LA ASUNTA,estado nutricional en menores de 5 anos,clasificacion d,2003-11-01,78,75,78,75,153
70104,LA GUARDIA,estado nutricional en menores de 5 anos,clasificacion d,2003-11-01,70,63,70,63,133
20101,LA PAZ,estado nutricional en menores de 5 anos,clasificacion d,2003-11-01,1146,1058,1146,1058,2204
41501,LA RIVERA,estado nutricional en menores de 5 anos,clasificacion d,2003-11-01,3,0,3,0,3
70701,LAGUNILLAS,estado nutricional en menores de 5 anos,clasificacion d,2003-11-01,31,24,31,24,55
21202,LAJA,estado nutricional en menores de 5 anos,clasificacion d,2003-11-01,27,29,27,29,56
10903,LAS CARRERAS,estado nutricional en menores de 5 anos,clasificacion d,2003-11-01,22,55,22,55,77
21006,LICOMA PAMPA,estado nutricional en menores de 5 anos,clasificacion d,2003-11-01,11,17,11,17,28
50203,LLALLAGUA,estado nutricional en menores de 5 anos,clasificacion d,2003-11-01,177,331,177,331,508
51401,LLICA,estado nutricional en menores de 5 anos,clasificacion d,2003-11-01,8,9,8,9,17
80601,LORETO,estado nutricional en menores de 5 anos,clasificacion d,2003-11-01,5,17,5,17,22
20901,LURIBAY,estado nutricional en menores de 5 anos,clasificacion d,2003-11-01,30,26,30,26,56
40702,MACHACAMARCA,estado nutricional en menores de 5 anos,clasificacion d,2003-11-01,5,2,5,2,7
11003,MACHARETI,estado nutricional en menores de 5 anos,clasificacion d,2003-11-01,28,78,28,78,106
80801,MAGDALENA,estado nutricional en menores de 5 anos,clasificacion d,2003-11-01,37,37,37,37,74
70903,MAIRANA,estado nutricional en menores de 5 anos,clasificacion d,2003-11-01,6,5,6,5,11
20103,MECAPACA,estado nutricional en menores de 5 anos,clasificacion d,2003-11-01,16,32,16,32,48
31301,MIZQUE,estado nutricional en menores de 5 anos,clasificacion d,2003-11-01,28,21,28,21,49
20402,MOCOMOCO,estado nutricional en menores de 5 anos,clasificacion d,2003-11-01,69,118,69,118,187
51002,MOJINETE,estado nutricional en menores de 5 anos,clasificacion d,2003-11-01,9,14,9,14,23
10303,MOJOCOYA,estado nutricional en menores de 5 anos,clasificacion d,2003-11-01,71,129,71,129,200
10501,MONTEAGUDO,estado nutricional en menores de 5 anos,clasificacion d,2003-11-01,137,247,137,247,384
70803,MORO MORO,estado nutricional en menores de 5 anos,clasificacion d,2003-11-01,6,11,6,11,17
30302,MOROCHATA,estado nutricional en menores de 5 anos,clasificacion d,2003-11-01,103,99,103,99,202
90401,NACEBE (SANTA ROSA DEL ABUNA),estado nutricional en menores de 5 anos,clasificacion d,2003-11-01,4,5,4,5,9
20307,NAZACARA DE PACAJES,estado nutricional en menores de 5 anos,clasificacion d,2003-11-01,1,5,1,5,6
50404,OCURI,estado nutricional en menores de 5 anos,clasificacion d,2003-11-01,103,106,103,106,209
30203,OMEREQUE,estado nutricional en menores de 5 anos,clasificacion d,2003-11-01,19,21,19,21,40
40101,ORURO,estado nutricional en menores de 5 anos,clasificacion d,2003-11-01,650,442,650,442,1092
60201,PADCAYA,estado nutricional en menores de 5 anos,clasificacion d,2003-11-01,44,51,44,51,95
10401,PADILLA,estado nutricional en menores de 5 anos,clasificacion d,2003-11-01,115,249,115,249,364
70502,PAILON,estado nutricional en menores de 5 anos,clasificacion d,2003-11-01,25,32,25,32,57
20102,PALCA,estado nutricional en menores de 5 anos,clasificacion d,2003-11-01,30,36,30,36,66
21104,PALOS BLANCOS,estado nutricional en menores de 5 anos,clasificacion d,2003-11-01,70,70,70,70,140
40802,PAMPA AULLAGAS,estado nutricional en menores de 5 anos,clasificacion d,2003-11-01,13,27,13,27,40
70902,PAMPA GRANDE,estado nutricional en menores de 5 anos,clasificacion d,2003-11-01,9,10,9,10,19
21802,PAPEL PAMPA,estado nutricional en menores de 5 anos,clasificacion d,2003-11-01,5,4,5,4,9
30202,PASORAPA,estado nutricional en menores de 5 anos,clasificacion d,2003-11-01,10,11,10,11,21
21305,PATACAMAYA,estado nutricional en menores de 5 anos,clasificacion d,2003-11-01,73,40,73,40,113
40602,PAZÃ‘A,estado nutricional en menores de 5 anos,clasificacion d,2003-11-01,11,14,11,14,25
20702,PELECHUCO,estado nutricional en menores de 5 anos,clasificacion d,2003-11-01,44,52,44,52,96
50403,POCOATA,estado nutricional en menores de 5 anos,clasificacion d,2003-11-01,168,240,168,240,408
31203,POCONA,estado nutricional en menores de 5 anos,clasificacion d,2003-11-01,53,46,53,46,99
31202,POJO (CBBA),estado nutricional en menores de 5 anos,clasificacion d,2003-11-01,145,154,145,154,299
40601,POOPO,estado nutricional en menores de 5 anos,clasificacion d,2003-11-01,16,18,16,18,34
51203,PORCO,estado nutricional en menores de 5 anos,clasificacion d,2003-11-01,24,43,24,43,67
10103,POROMA,estado nutricional en menores de 5 anos,clasificacion d,2003-11-01,179,203,179,203,382
70103,PORONGO,estado nutricional en menores de 5 anos,clasificacion d,2003-11-01,18,10,18,10,28
70601,PORTACHUELO,estado nutricional en menores de 5 anos,clasificacion d,2003-11-01,39,38,39,38,77
90102,PORVENIR,estado nutricional en menores de 5 anos,clasificacion d,2003-11-01,9,7,9,7,16
70804,POSTRER VALLE,estado nutricional en menores de 5 anos,clasificacion d,2003-11-01,4,9,4,9,13
50101,POTOSI,estado nutricional en menores de 5 anos,clasificacion d,2003-11-01,596,412,596,412,1008
10302,PRESTO,estado nutricional en menores de 5 anos,clasificacion d,2003-11-01,83,146,83,146,229
21201,PUCARANI,estado nutricional en menores de 5 anos,clasificacion d,2003-11-01,39,41,39,41,80
20401,PUERTO ACOSTA,estado nutricional en menores de 5 anos,clasificacion d,2003-11-01,83,82,83,82,165
20403,PUERTO CARABUCO,estado nutricional en menores de 5 anos,clasificacion d,2003-11-01,44,84,44,84,128
90301,PUERTO GONZALO MORENO,estado nutricional en menores de 5 anos,clasificacion d,2003-11-01,50,69,50,69,119
21204,PUERTO PEREZ,estado nutricional en menores de 5 anos,clasificacion d,2003-11-01,10,15,10,15,25
71402,PUERTO QUIJARRO,estado nutricional en menores de 5 anos,clasificacion d,2003-11-01,24,6,24,6,30
90201,PUERTO RICO,estado nutricional en menores de 5 anos,clasificacion d,2003-11-01,6,27,6,27,33
71401,PUERTO SUAREZ,estado nutricional en menores de 5 anos,clasificacion d,2003-11-01,47,40,47,40,87
31205,PUERTO VILLARROEL,estado nutricional en menores de 5 anos,clasificacion d,2003-11-01,140,173,140,173,313
51101,PUNA,estado nutricional en menores de 5 anos,clasificacion d,2003-11-01,179,217,179,217,396
31401,PUNATA,estado nutricional en menores de 5 anos,clasificacion d,2003-11-01,45,70,45,70,115
20604,QUIABAYA,estado nutricional en menores de 5 anos,clasificacion d,2003-11-01,11,13,11,13,24
30901,QUILLACOLLO,estado nutricional en menores de 5 anos,clasificacion d,2003-11-01,118,114,118,114,232
21002,QUIME,estado nutricional en menores de 5 anos,clasificacion d,2003-11-01,53,57,53,57,110
70904,QUIRUSILLAS,estado nutricional en menores de 5 anos,clasificacion d,2003-11-01,3,6,3,6,9
50402,RAVELO,estado nutricional en menores de 5 anos,clasificacion d,2003-11-01,147,189,147,189,336
80301,REYES,estado nutricional en menores de 5 anos,clasificacion d,2003-11-01,40,40,40,40,80
80201,RIBERALTA,estado nutricional en menores de 5 anos,clasificacion d,2003-11-01,351,249,351,249,600
70503,ROBORE,estado nutricional en menores de 5 anos,clasificacion d,2003-11-01,37,25,37,25,62
80304,RURRENABAQUE,estado nutricional en menores de 5 anos,clasificacion d,2003-11-01,32,21,32,21,53
40901,SABAYA,estado nutricional en menores de 5 anos,clasificacion d,2003-11-01,2,1,2,1,3
31001,SACABA,estado nutricional en menores de 5 anos,clasificacion d,2003-11-01,141,203,141,203,344
30404,SACABAMBA,estado nutricional en menores de 5 anos,clasificacion d,2003-11-01,22,31,22,31,53
50701,SACACA,estado nutricional en menores de 5 anos,clasificacion d,2003-11-01,279,433,279,433,712
71302,SAIPINA,estado nutricional en menores de 5 anos,clasificacion d,2003-11-01,12,27,12,27,39
40801,SALINAS DE GARCI MENDOZA,estado nutricional en menores de 5 anos,clasificacion d,2003-11-01,17,35,17,35,52
70901,SAMAIPATA,estado nutricional en menores de 5 anos,clasificacion d,2003-11-01,33,38,33,38,71
51601,SAN AGUSTIN,estado nutricional en menores de 5 anos,clasificacion d,2003-11-01,2,9,2,9,11
80602,SAN ANDRES,estado nutricional en menores de 5 anos,clasificacion d,2003-11-01,35,41,35,41,76
51003,SAN ANTONIO DE ESMORUCO,estado nutricional en menores de 5 anos,clasificacion d,2003-11-01,0,7,0,7,7
71105,SAN ANTONIO DE LOMERIO,estado nutricional en menores de 5 anos,clasificacion d,2003-11-01,69,102,69,102,171
31403,SAN BENITO,estado nutricional en menores de 5 anos,clasificacion d,2003-11-01,8,21,8,21,29
80302,SAN BORJA,estado nutricional en menores de 5 anos,clasificacion d,2003-11-01,135,132,135,132,267
21502,SAN BUENA VENTURA,estado nutricional en menores de 5 anos,clasificacion d,2003-11-01,45,28,45,28,73
70402,SAN CARLOS,estado nutricional en menores de 5 anos,clasificacion d,2003-11-01,52,60,52,60,112
80501,SAN IGNACIO,estado nutricional en menores de 5 anos,clasificacion d,2003-11-01,88,128,88,128,216
70301,SAN IGNACIO DE VELASCO,estado nutricional en menores de 5 anos,clasificacion d,2003-11-01,237,215,237,215,452
80102,SAN JAVIER(BNI),estado nutricional en menores de 5 anos,clasificacion d,2003-11-01,6,8,6,8,14
71102,SAN JAVIER(STC),estado nutricional en menores de 5 anos,clasificacion d,2003-11-01,59,75,59,75,134
80701,SAN JOAQUIN,estado nutricional en menores de 5 anos,clasificacion d,2003-11-01,3,1,3,1,4
70501,SAN JOSE DE CHIQUITOS,estado nutricional en menores de 5 anos,clasificacion d,2003-11-01,26,22,26,22,48
71104,SAN JULIAN,estado nutricional en menores de 5 anos,clasificacion d,2003-11-01,145,213,145,213,358
90302,SAN LORENZO(PND),estado nutricional en menores de 5 anos,clasificacion d,2003-11-01,11,7,11,7,18
60501,SAN LORENZO(TJA),estado nutricional en menores de 5 anos,clasificacion d,2003-11-01,59,98,59,98,157
10702,SAN LUCAS,estado nutricional en menores de 5 anos,clasificacion d,2003-11-01,473,614,473,614,1087
70302,SAN MIGUEL DE VELASCO,estado nutricional en menores de 5 anos,clasificacion d,2003-11-01,41,36,41,36,77
51001,SAN PABLO DE LIPEZ,estado nutricional en menores de 5 anos,clasificacion d,2003-11-01,18,35,18,35,53
50501,SAN PEDRO DE BUENA VISTA,estado nutricional en menores de 5 anos,clasificacion d,2003-11-01,151,220,151,220,371
21801,SAN PEDRO DE CURAHUARA,estado nutricional en menores de 5 anos,clasificacion d,2003-11-01,25,34,25,34,59
50902,SAN PEDRO DE QUEMES,estado nutricional en menores de 5 anos,clasificacion d,2003-11-01,1,1,1,1,2
21702,SAN PEDRO DE TIQUINA,estado nutricional en menores de 5 anos,clasificacion d,2003-11-01,11,20,11,20,31
70303,SAN RAFAEL,estado nutricional en menores de 5 anos,clasificacion d,2003-11-01,33,21,33,21,54
80702,SAN RAMON,estado nutricional en menores de 5 anos,clasificacion d,2003-11-01,2,0,2,0,2
80702,SAN RAMON,estado nutricional en menores de 5 anos,clasificacion d,2003-11-01,5,7,5,7,12
80401,SANTA ANA,estado nutricional en menores de 5 anos,clasificacion d,2003-11-01,29,18,29,18,47
70101,SANTA CRUZ DE LA SIERRA,estado nutricional en menores de 5 anos,clasificacion d,2003-11-01,379,180,379,180,559
80303,SANTA ROSA,estado nutricional en menores de 5 anos,clasificacion d,2003-11-01,13,6,13,6,19
70602,SANTA ROSA DEL SARA,estado nutricional en menores de 5 anos,clasificacion d,2003-11-01,5,13,5,13,18
20308,SANTIAGO DE CALLAPA,estado nutricional en menores de 5 anos,clasificacion d,2003-11-01,25,38,25,38,63
41401,SANTIAGO DE HUARI,estado nutricional en menores de 5 anos,clasificacion d,2003-11-01,28,35,28,35,63
21901,SANTIAGO DE MACHACA,estado nutricional en menores de 5 anos,clasificacion d,2003-11-01,18,32,18,32,50
30702,SANTIVAÃ‘ES,estado nutricional en menores de 5 anos,clasificacion d,2003-11-01,19,15,19,15,34
40202,SANTUARIO DE QUILLACAS,estado nutricional en menores de 5 anos,clasificacion d,2003-11-01,11,12,11,12,23
20902,SAPAHAQUI,estado nutricional en menores de 5 anos,clasificacion d,2003-11-01,56,54,56,54,110
90303,SENA,estado nutricional en menores de 5 anos,clasificacion d,2003-11-01,19,18,19,18,37
21301,SICA SICA (VILLA AROMA),estado nutricional en menores de 5 anos,clasificacion d,2003-11-01,141,84,141,84,225
30703,SICAYA,estado nutricional en menores de 5 anos,clasificacion d,2003-11-01,15,10,15,10,25
30902,SIPE SIPE,estado nutricional en menores de 5 anos,clasificacion d,2003-11-01,135,104,135,104,239
10403,SOPACHUY,estado nutricional en menores de 5 anos,clasificacion d,2003-11-01,88,164,88,164,252
20601,SORATA,estado nutricional en menores de 5 anos,clasificacion d,2003-11-01,47,98,47,98,145
10101,SUCRE,estado nutricional en menores de 5 anos,clasificacion d,2003-11-01,763,1328,763,1328,2091
31404,TACACHI,estado nutricional en menores de 5 anos,clasificacion d,2003-11-01,2,1,2,1,3
20603,TACACOMA,estado nutricional en menores de 5 anos,clasificacion d,2003-11-01,16,17,16,17,33
50303,TACOBAMBA,estado nutricional en menores de 5 anos,clasificacion d,2003-11-01,70,70,70,70,140
30602,TACOPAYA,estado nutricional en menores de 5 anos,clasificacion d,2003-11-01,76,126,76,126,202
51402,TAHUA,estado nutricional en menores de 5 anos,clasificacion d,2003-11-01,3,4,3,4,7
31101,TAPACARI,estado nutricional en menores de 5 anos,clasificacion d,2003-11-01,143,136,143,136,279
10601,TARABUCO,estado nutricional en menores de 5 anos,clasificacion d,2003-11-01,258,494,258,494,752
30401,TARATA,estado nutricional en menores de 5 anos,clasificacion d,2003-11-01,22,14,22,14,36
60101,TARIJA,estado nutricional en menores de 5 anos,clasificacion d,2003-11-01,190,236,190,236,426
10202,TARVITA,estado nutricional en menores de 5 anos,clasificacion d,2003-11-01,172,412,172,412,584
20803,TIAWANACU,estado nutricional en menores de 5 anos,clasificacion d,2003-11-01,36,15,36,15,51
50102,TINGUIPAYA,estado nutricional en menores de 5 anos,clasificacion d,2003-11-01,185,214,185,214,399
20606,TIPUANI,estado nutricional en menores de 5 anos,clasificacion d,2003-11-01,18,13,18,13,31
30903,TIQUIPAYA,estado nutricional en menores de 5 anos,clasificacion d,2003-11-01,22,9,22,9,31
31601,TIRAQUE (CBBA),estado nutricional en menores de 5 anos,clasificacion d,2003-11-01,125,101,125,101,226
21703,TITO YUPANQUI (PARQUIPUJIO),estado nutricional en menores de 5 anos,clasificacion d,2003-11-01,4,6,4,6,10
30802,TOCO,estado nutricional en menores de 5 anos,clasificacion d,2003-11-01,1,14,1,14,15
41502,TODOS SANTOS,estado nutricional en menores de 5 anos,clasificacion d,2003-11-01,0,1,0,1,1
30803,TOLATA,estado nutricional en menores de 5 anos,clasificacion d,2003-11-01,6,2,6,2,8
41001,TOLEDO,estado nutricional en menores de 5 anos,clasificacion d,2003-11-01,17,19,17,19,36
51202,TOMAVE,estado nutricional en menores de 5 anos,clasificacion d,2003-11-01,68,116,68,116,184
10402,TOMINA,estado nutricional en menores de 5 anos,clasificacion d,2003-11-01,121,245,121,245,366
50502,TORO TORO,estado nutricional en menores de 5 anos,clasificacion d,2003-11-01,118,143,118,143,261
31201,TOTORA(CBBA),estado nutricional en menores de 5 anos,clasificacion d,2003-11-01,48,50,48,50,98
41301,TOTORA(ORR),estado nutricional en menores de 5 anos,clasificacion d,2003-11-01,25,44,25,44,69
70802,TRIGAL,estado nutricional en menores de 5 anos,clasificacion d,2003-11-01,1,3,1,3,4
80101,TRINIDAD,estado nutricional en menores de 5 anos,clasificacion d,2003-11-01,202,185,202,185,387
50801,TUPIZA,estado nutricional en menores de 5 anos,clasificacion d,2003-11-01,107,204,107,204,311
40402,TURCO,estado nutricional en menores de 5 anos,clasificacion d,2003-11-01,27,22,27,22,49
21302,UMALA,estado nutricional en menores de 5 anos,clasificacion d,2003-11-01,30,20,30,20,50
50201,UNCIA,estado nutricional en menores de 5 anos,clasificacion d,2003-11-01,53,32,53,32,85
60401,URIONDO (A. CONCEPCION),estado nutricional en menores de 5 anos,clasificacion d,2003-11-01,71,102,71,102,173
71502,URUBICHA,estado nutricional en menores de 5 anos,clasificacion d,2003-11-01,16,14,16,14,30
51201,UYUNI,estado nutricional en menores de 5 anos,clasificacion d,2003-11-01,63,82,63,82,145
30502,VACAS,estado nutricional en menores de 5 anos,clasificacion d,2003-11-01,51,45,51,45,96
70801,VALLEGRANDE,estado nutricional en menores de 5 anos,clasificacion d,2003-11-01,9,15,9,15,24
20801,VIACHA,estado nutricional en menores de 5 anos,clasificacion d,2003-11-01,105,99,105,99,204
31302,VILA VILA,estado nutricional en menores de 5 anos,clasificacion d,2003-11-01,20,15,20,15,35
60303,VILLA MONTES,estado nutricional en menores de 5 anos,clasificacion d,2003-11-01,46,43,46,43,89
90502,VILLA NUEVA (LOMA ALTA),estado nutricional en menores de 5 anos,clasificacion d,2003-11-01,1,0,1,0,1
31402,VILLA RIVERO,estado nutricional en menores de 5 anos,clasificacion d,2003-11-01,21,9,21,9,30
10801,VILLA SERRANO,estado nutricional en menores de 5 anos,clasificacion d,2003-11-01,120,309,120,309,429
31003,VILLA TUNARI,estado nutricional en menores de 5 anos,clasificacion d,2003-11-01,179,189,179,189,368
11001,VILLA VACA GUZMAN (MUYUPAMPA),estado nutricional en menores de 5 anos,clasificacion d,2003-11-01,48,93,48,93,141
51501,VILLAZON,estado nutricional en menores de 5 anos,clasificacion d,2003-11-01,152,160,152,160,312
50602,VITICHI,estado nutricional en menores de 5 anos,clasificacion d,2003-11-01,124,202,124,202,326
20306,WALDO BALLIVIAN,estado nutricional en menores de 5 anos,clasificacion d,2003-11-01,11,12,11,12,23
20903,YACO,estado nutricional en menores de 5 anos,clasificacion d,2003-11-01,27,20,27,20,47
60301,YACUIBA,estado nutricional en menores de 5 anos,clasificacion d,2003-11-01,73,37,73,37,110
10602,YAMPARAEZ,estado nutricional en menores de 5 anos,clasificacion d,2003-11-01,152,307,152,307,459
21103,YANACACHI,estado nutricional en menores de 5 anos,clasificacion d,2003-11-01,24,21,24,21,45
70403,YAPACANI,estado nutricional en menores de 5 anos,clasificacion d,2003-11-01,90,136,90,136,226
50103,YOCALLA,estado nutricional en menores de 5 anos,clasificacion d,2003-11-01,40,81,40,81,121
10102,YOTALA,estado nutricional en menores de 5 anos,clasificacion d,2003-11-01,98,197,98,197,295
60402,YUNCHARA,estado nutricional en menores de 5 anos,clasificacion d,2003-11-01,68,125,68,125,193
10301,ZUDAÃ‘EZ,estado nutricional en menores de 5 anos,clasificacion d,2003-11-01,76,141,76,141,217
51302,ACACIO,estado nutricional en menores de 5 anos,clasificacion d,2003-12-01,62,116,62,116,178
20201,ACHACACHI,estado nutricional en menores de 5 anos,clasificacion d,2003-12-01,87,75,87,75,162
20104,ACHOCALLA,estado nutricional en menores de 5 anos,clasificacion d,2003-12-01,23,15,23,15,38
30201,AIQUILE,estado nutricional en menores de 5 anos,clasificacion d,2003-12-01,32,34,32,34,66
31303,ALALAY,estado nutricional en menores de 5 anos,clasificacion d,2003-12-01,14,24,14,24,38
10404,ALCALA,estado nutricional en menores de 5 anos,clasificacion d,2003-12-01,29,68,29,68,97
20202,ANCORAIMES,estado nutricional en menores de 5 anos,clasificacion d,2003-12-01,37,58,37,58,95
41201,ANDAMARCA,estado nutricional en menores de 5 anos,clasificacion d,2003-12-01,11,6,11,6,17
40603,ANTEQUERA,estado nutricional en menores de 5 anos,clasificacion d,2003-12-01,12,1,12,1,13
30402,ANZALDO,estado nutricional en menores de 5 anos,clasificacion d,2003-12-01,9,27,9,27,36
20701,APOLO,estado nutricional en menores de 5 anos,clasificacion d,2003-12-01,24,29,24,29,53
51301,ARAMPAMPA,estado nutricional en menores de 5 anos,clasificacion d,2003-12-01,23,38,23,38,61
30501,ARANI,estado nutricional en menores de 5 anos,clasificacion d,2003-12-01,23,21,23,21,44
30403,ARBIETO,estado nutricional en menores de 5 anos,clasificacion d,2003-12-01,4,0,4,0,4
30601,ARQUE,estado nutricional en menores de 5 anos,clasificacion d,2003-12-01,3,7,3,7,10
71501,ASCENCION DE GUARAYOS,estado nutricional en menores de 5 anos,clasificacion d,2003-12-01,174,279,174,279,453
50802,ATOCHA,estado nutricional en menores de 5 anos,clasificacion d,2003-12-01,57,146,57,146,203
20503,AUCAPATA,estado nutricional en menores de 5 anos,clasificacion d,2003-12-01,17,11,17,11,28
20502,AYATA,estado nutricional en menores de 5 anos,clasificacion d,2003-12-01,21,22,21,22,43
21303,AYO AYO,estado nutricional en menores de 5 anos,clasificacion d,2003-12-01,11,6,11,6,17
30301,AYOPAYA (V. DE INDEPENDENCIA),estado nutricional en menores de 5 anos,clasificacion d,2003-12-01,80,87,80,87,167
10201,AZURDUY,estado nutricional en menores de 5 anos,clasificacion d,2003-12-01,139,280,139,280,419
21203,BATALLAS,estado nutricional en menores de 5 anos,clasificacion d,2003-12-01,23,11,23,11,34
80802,BAURES,estado nutricional en menores de 5 anos,clasificacion d,2003-12-01,18,8,18,8,26
41202,BELEN DE ANDAMARCA,estado nutricional en menores de 5 anos,clasificacion d,2003-12-01,1,1,1,1,2
50104,BELEN DE URMIRI,estado nutricional en menores de 5 anos,clasificacion d,2003-12-01,7,14,7,14,21
90104,BELLA FLOR,estado nutricional en menores de 5 anos,clasificacion d,2003-12-01,9,31,9,31,40
60202,BERMEJO,estado nutricional en menores de 5 anos,clasificacion d,2003-12-01,4,6,4,6,10
50301,BETANZOS,estado nutricional en menores de 5 anos,clasificacion d,2003-12-01,186,300,186,300,486
90103,BOLPEBRA,estado nutricional en menores de 5 anos,clasificacion d,2003-12-01,4,7,4,7,11
70707,BOYUIBE,estado nutricional en menores de 5 anos,clasificacion d,2003-12-01,16,20,16,20,36
70401,BUENA VISTA,estado nutricional en menores de 5 anos,clasificacion d,2003-12-01,23,32,23,32,55
70703,CABEZAS,estado nutricional en menores de 5 anos,clasificacion d,2003-12-01,0,1,0,1,1
20905,CAIROMA,estado nutricional en menores de 5 anos,clasificacion d,2003-12-01,47,35,47,35,82
51102,"CAIZA ""D""",estado nutricional en menores de 5 anos,clasificacion d,2003-12-01,45,86,45,86,131
21003,CAJUATA,estado nutricional en menores de 5 anos,clasificacion d,2003-12-01,33,45,33,45,78
20303,CALACOTO,estado nutricional en menores de 5 anos,clasificacion d,2003-12-01,12,9,12,9,21
21304,CALAMARCA,estado nutricional en menores de 5 anos,clasificacion d,2003-12-01,174,162,174,162,336
10701,CAMARGO,estado nutricional en menores de 5 anos,clasificacion d,2003-12-01,91,160,91,160,251
10901,CAMATAQUI (C. VILLA ABECIA),estado nutricional en menores de 5 anos,clasificacion d,2003-12-01,8,14,8,14,22
70706,CAMIRI,estado nutricional en menores de 5 anos,clasificacion d,2003-12-01,121,110,121,110,231
30701,CAPINOTA,estado nutricional en menores de 5 anos,clasificacion d,2003-12-01,32,84,32,84,116
20302,CAQUIAVIRI,estado nutricional en menores de 5 anos,clasificacion d,2003-12-01,31,21,31,21,52
40102,CARACOLLO,estado nutricional en menores de 5 anos,clasificacion d,2003-12-01,73,37,73,37,110
22001,CARANAVI,estado nutricional en menores de 5 anos,clasificacion d,2003-12-01,178,162,178,162,340
60302,CARAPARI,estado nutricional en menores de 5 anos,clasificacion d,2003-12-01,12,40,12,40,52
50702,CARIPUYO,estado nutricional en menores de 5 anos,clasificacion d,2003-12-01,69,123,69,123,192
21803,CHACARILLA,estado nutricional en menores de 5 anos,clasificacion d,2003-12-01,10,25,10,25,35
40201,CHALLAPATA,estado nutricional en menores de 5 anos,clasificacion d,2003-12-01,65,166,65,166,231
50302,CHAQUI,estado nutricional en menores de 5 anos,clasificacion d,2003-12-01,18,47,18,47,65
70702,CHARAGUA,estado nutricional en menores de 5 anos,clasificacion d,2003-12-01,139,134,139,134,273
20305,CHARAÃ‘A,estado nutricional en menores de 5 anos,clasificacion d,2003-12-01,7,16,7,16,23
50202,CHAYANTA,estado nutricional en menores de 5 anos,clasificacion d,2003-12-01,101,169,101,169,270
31204,CHIMORE,estado nutricional en menores de 5 anos,clasificacion d,2003-12-01,28,27,28,27,55
40903,CHIPAYA,estado nutricional en menores de 5 anos,clasificacion d,2003-12-01,5,6,5,6,11
40302,CHOQUE COTA,estado nutricional en menores de 5 anos,clasificacion d,2003-12-01,3,4,3,4,7
21101,CHULUMANI (V. DE LA LIBERTAD),estado nutricional en menores de 5 anos,clasificacion d,2003-12-01,9,16,9,16,25
20501,CHUMA,estado nutricional en menores de 5 anos,clasificacion d,2003-12-01,21,15,21,15,36
30801,CLIZA,estado nutricional en menores de 5 anos,clasificacion d,2003-12-01,14,8,14,8,22
90101,COBIJA,estado nutricional en menores de 5 anos,clasificacion d,2003-12-01,57,74,57,74,131
30101,COCHABAMBA,estado nutricional en menores de 5 anos,clasificacion d,2003-12-01,570,499,570,499,1069
40902,COIPASA,estado nutricional en menores de 5 anos,clasificacion d,2003-12-01,1,2,1,2,3
30905,COLCAPIRHUA,estado nutricional en menores de 5 anos,clasificacion d,2003-12-01,60,44,60,44,104
50901,"COLCHA ""K""",estado nutricional en menores de 5 anos,clasificacion d,2003-12-01,32,29,32,29,61
21307,COLLANA,estado nutricional en menores de 5 anos,clasificacion d,2003-12-01,4,2,4,2,6
31002,COLOMI,estado nutricional en menores de 5 anos,clasificacion d,2003-12-01,60,50,60,50,110
50401,COLQUECHACA,estado nutricional en menores de 5 anos,clasificacion d,2003-12-01,130,94,130,94,224
21306,COLQUENCHA,estado nutricional en menores de 5 anos,clasificacion d,2003-12-01,28,8,28,8,36
21004,COLQUIRI,estado nutricional en menores de 5 anos,clasificacion d,2003-12-01,81,66,81,66,147
20304,COMANCHE,estado nutricional en menores de 5 anos,clasificacion d,2003-12-01,13,10,13,10,23
71301,COMARAPA,estado nutricional en menores de 5 anos,clasificacion d,2003-12-01,47,51,47,51,98
20605,COMBAYA,estado nutricional en menores de 5 anos,clasificacion d,2003-12-01,12,14,12,14,26
71101,CONCEPCION,estado nutricional en menores de 5 anos,clasificacion d,2003-12-01,21,3,21,3,24
21701,COPACABANA,estado nutricional en menores de 5 anos,clasificacion d,2003-12-01,9,12,9,12,21
21402,CORIPATA,estado nutricional en menores de 5 anos,clasificacion d,2003-12-01,1,2,1,2,3
20301,CORO CORO,estado nutricional en menores de 5 anos,clasificacion d,2003-12-01,23,21,23,21,44
21401,COROICO,estado nutricional en menores de 5 anos,clasificacion d,2003-12-01,25,28,25,28,53
40301,CORQUE,estado nutricional en menores de 5 anos,clasificacion d,2003-12-01,28,31,28,31,59
50601,COTAGAITA,estado nutricional en menores de 5 anos,clasificacion d,2003-12-01,95,134,95,134,229
31405,CUCHUMUELA (V. G. VILLARROEL),estado nutricional en menores de 5 anos,clasificacion d,2003-12-01,4,9,4,9,13
70704,CUEVO,estado nutricional en menores de 5 anos,clasificacion d,2003-12-01,13,11,13,11,24
10902,CULPINA,estado nutricional en menores de 5 anos,clasificacion d,2003-12-01,155,190,155,190,345
40401,CURAHUARA DE CARANGAS,estado nutricional en menores de 5 anos,clasificacion d,2003-12-01,32,28,32,28,60
21602,CURVA,estado nutricional en menores de 5 anos,clasificacion d,2003-12-01,8,13,8,13,21
20804,DESAGUADERO,estado nutricional en menores de 5 anos,clasificacion d,2003-12-01,7,1,7,1,8
20105,EL ALTO,estado nutricional en menores de 5 anos,clasificacion d,2003-12-01,1740,1062,1740,1062,2802
40103,EL CHORO,estado nutricional en menores de 5 anos,clasificacion d,2003-12-01,9,7,9,7,16
71503,EL PUENTE(STC),estado nutricional en menores de 5 anos,clasificacion d,2003-12-01,47,45,47,45,92
60502,EL PUENTE(TJA),estado nutricional en menores de 5 anos,clasificacion d,2003-12-01,34,78,34,78,112
70105,EL TORNO,estado nutricional en menores de 5 anos,clasificacion d,2003-12-01,64,52,64,52,116
10405,EL VILLAR,estado nutricional en menores de 5 anos,clasificacion d,2003-12-01,58,151,58,151,209
60601,ENTRE RIOS,estado nutricional en menores de 5 anos,clasificacion d,2003-12-01,52,43,52,43,95
41101,EUCALIPTUS,estado nutricional en menores de 5 anos,clasificacion d,2003-12-01,5,4,5,4,9
90503,EUREKA (SANTOS MERCADO),estado nutricional en menores de 5 anos,clasificacion d,2003-12-01,0,3,0,3,3
80402,EXALTACION,estado nutricional en menores de 5 anos,clasificacion d,2003-12-01,14,16,14,16,30
90203,FILADELFIA,estado nutricional en menores de 5 anos,clasificacion d,2003-12-01,0,8,0,8,8
71002,GENERAL SAAVEDRA,estado nutricional en menores de 5 anos,clasificacion d,2003-12-01,116,132,116,132,248
21601,GRAL. J.J. PEREZ (CHARAZANI),estado nutricional en menores de 5 anos,clasificacion d,2003-12-01,32,49,32,49,81
20602,GUANAY,estado nutricional en menores de 5 anos,clasificacion d,2003-12-01,104,101,104,101,205
20802,GUAQUI,estado nutricional en menores de 5 anos,clasificacion d,2003-12-01,13,6,13,6,19
80202,GUAYARAMERIN,estado nutricional en menores de 5 anos,clasificacion d,2003-12-01,102,57,102,57,159
70705,GUTIERREZ,estado nutricional en menores de 5 anos,clasificacion d,2003-12-01,85,158,85,158,243
10502,HUACARETA,estado nutricional en menores de 5 anos,clasificacion d,2003-12-01,41,78,41,78,119
11002,HUACAYA (VILLA DE HUACAYA),estado nutricional en menores de 5 anos,clasificacion d,2003-12-01,15,30,15,30,45
40501,HUACHACALLA,estado nutricional en menores de 5 anos,clasificacion d,2003-12-01,7,0,7,0,7
40701,HUANUNI,estado nutricional en menores de 5 anos,clasificacion d,2003-12-01,61,32,61,32,93
80803,HUARACAJE,estado nutricional en menores de 5 anos,clasificacion d,2003-12-01,3,4,3,4,7
41601,HUAYLLAMARCA,estado nutricional en menores de 5 anos,clasificacion d,2003-12-01,9,12,9,12,21
21005,ICHOCA,estado nutricional en menores de 5 anos,clasificacion d,2003-12-01,20,17,20,17,37
10304,ICLA,estado nutricional en menores de 5 anos,clasificacion d,2003-12-01,129,223,129,223,352
10703,INCAHUASI,estado nutricional en menores de 5 anos,clasificacion d,2003-12-01,83,103,83,103,186
21001,INQUISIVI,estado nutricional en menores de 5 anos,clasificacion d,2003-12-01,57,38,57,38,95
21102,IRUPANA (VILLA DE LANZA),estado nutricional en menores de 5 anos,clasificacion d,2003-12-01,21,35,21,35,56
21501,IXIAMAS,estado nutricional en menores de 5 anos,clasificacion d,2003-12-01,19,41,19,41,60
21105,LA ASUNTA,estado nutricional en menores de 5 anos,clasificacion d,2003-12-01,16,31,16,31,47
70104,LA GUARDIA,estado nutricional en menores de 5 anos,clasificacion d,2003-12-01,64,61,64,61,125
20101,LA PAZ,estado nutricional en menores de 5 anos,clasificacion d,2003-12-01,1057,897,1057,897,1954
41501,LA RIVERA,estado nutricional en menores de 5 anos,clasificacion d,2003-12-01,1,0,1,0,1
70701,LAGUNILLAS,estado nutricional en menores de 5 anos,clasificacion d,2003-12-01,17,33,17,33,50
21202,LAJA,estado nutricional en menores de 5 anos,clasificacion d,2003-12-01,25,27,25,27,52
10903,LAS CARRERAS,estado nutricional en menores de 5 anos,clasificacion d,2003-12-01,12,26,12,26,38
50203,LLALLAGUA,estado nutricional en menores de 5 anos,clasificacion d,2003-12-01,112,225,112,225,337
51401,LLICA,estado nutricional en menores de 5 anos,clasificacion d,2003-12-01,7,10,7,10,17
80601,LORETO,estado nutricional en menores de 5 anos,clasificacion d,2003-12-01,4,11,4,11,15
20901,LURIBAY,estado nutricional en menores de 5 anos,clasificacion d,2003-12-01,29,42,29,42,71
40702,MACHACAMARCA,estado nutricional en menores de 5 anos,clasificacion d,2003-12-01,3,9,3,9,12
11003,MACHARETI,estado nutricional en menores de 5 anos,clasificacion d,2003-12-01,40,106,40,106,146
80801,MAGDALENA,estado nutricional en menores de 5 anos,clasificacion d,2003-12-01,29,23,29,23,52
70903,MAIRANA,estado nutricional en menores de 5 anos,clasificacion d,2003-12-01,19,10,19,10,29
20904,MALLA,estado nutricional en menores de 5 anos,clasificacion d,2003-12-01,8,8,8,8,16
20103,MECAPACA,estado nutricional en menores de 5 anos,clasificacion d,2003-12-01,13,20,13,20,33
71003,MINEROS,estado nutricional en menores de 5 anos,clasificacion d,2003-12-01,88,59,88,59,147
31301,MIZQUE,estado nutricional en menores de 5 anos,clasificacion d,2003-12-01,2,16,2,16,18
20402,MOCOMOCO,estado nutricional en menores de 5 anos,clasificacion d,2003-12-01,30,35,30,35,65
51002,MOJINETE,estado nutricional en menores de 5 anos,clasificacion d,2003-12-01,4,10,4,10,14
10303,MOJOCOYA,estado nutricional en menores de 5 anos,clasificacion d,2003-12-01,57,114,57,114,171
10501,MONTEAGUDO,estado nutricional en menores de 5 anos,clasificacion d,2003-12-01,114,178,114,178,292
71001,MONTERO,estado nutricional en menores de 5 anos,clasificacion d,2003-12-01,188,155,188,155,343
70803,MORO MORO,estado nutricional en menores de 5 anos,clasificacion d,2003-12-01,3,4,3,4,7
30302,MOROCHATA,estado nutricional en menores de 5 anos,clasificacion d,2003-12-01,81,124,81,124,205
20307,NAZACARA DE PACAJES,estado nutricional en menores de 5 anos,clasificacion d,2003-12-01,1,3,1,3,4
90501,NUEVO MANOA (NUEVA ESPERANZA),estado nutricional en menores de 5 anos,clasificacion d,2003-12-01,0,1,0,1,1
50404,OCURI,estado nutricional en menores de 5 anos,clasificacion d,2003-12-01,61,133,61,133,194
30203,OMEREQUE,estado nutricional en menores de 5 anos,clasificacion d,2003-12-01,6,11,6,11,17
40101,ORURO,estado nutricional en menores de 5 anos,clasificacion d,2003-12-01,631,463,631,463,1094
60201,PADCAYA,estado nutricional en menores de 5 anos,clasificacion d,2003-12-01,48,73,48,73,121
10401,PADILLA,estado nutricional en menores de 5 anos,clasificacion d,2003-12-01,88,206,88,206,294
20102,PALCA,estado nutricional en menores de 5 anos,clasificacion d,2003-12-01,31,34,31,34,65
21104,PALOS BLANCOS,estado nutricional en menores de 5 anos,clasificacion d,2003-12-01,16,28,16,28,44
40802,PAMPA AULLAGAS,estado nutricional en menores de 5 anos,clasificacion d,2003-12-01,6,12,6,12,18
70902,PAMPA GRANDE,estado nutricional en menores de 5 anos,clasificacion d,2003-12-01,16,10,16,10,26
21802,PAPEL PAMPA,estado nutricional en menores de 5 anos,clasificacion d,2003-12-01,15,12,15,12,27
30202,PASORAPA,estado nutricional en menores de 5 anos,clasificacion d,2003-12-01,22,39,22,39,61
21305,PATACAMAYA,estado nutricional en menores de 5 anos,clasificacion d,2003-12-01,133,79,133,79,212
40602,PAZÃ‘A,estado nutricional en menores de 5 anos,clasificacion d,2003-12-01,7,9,7,9,16
20702,PELECHUCO,estado nutricional en menores de 5 anos,clasificacion d,2003-12-01,29,16,29,16,45
50403,POCOATA,estado nutricional en menores de 5 anos,clasificacion d,2003-12-01,107,205,107,205,312
31203,POCONA,estado nutricional en menores de 5 anos,clasificacion d,2003-12-01,25,28,25,28,53
31202,POJO (CBBA),estado nutricional en menores de 5 anos,clasificacion d,2003-12-01,76,90,76,90,166
40601,POOPO,estado nutricional en menores de 5 anos,clasificacion d,2003-12-01,10,12,10,12,22
51203,PORCO,estado nutricional en menores de 5 anos,clasificacion d,2003-12-01,22,46,22,46,68
10103,POROMA,estado nutricional en menores de 5 anos,clasificacion d,2003-12-01,91,137,91,137,228
70103,PORONGO,estado nutricional en menores de 5 anos,clasificacion d,2003-12-01,6,5,6,5,11
70601,PORTACHUELO,estado nutricional en menores de 5 anos,clasificacion d,2003-12-01,21,52,21,52,73
90102,PORVENIR,estado nutricional en menores de 5 anos,clasificacion d,2003-12-01,6,6,6,6,12
50101,POTOSI,estado nutricional en menores de 5 anos,clasificacion d,2003-12-01,561,383,561,383,944
10302,PRESTO,estado nutricional en menores de 5 anos,clasificacion d,2003-12-01,59,99,59,99,158
70805,PUCARA,estado nutricional en menores de 5 anos,clasificacion d,2003-12-01,13,14,13,14,27
21201,PUCARANI,estado nutricional en menores de 5 anos,clasificacion d,2003-12-01,39,43,39,43,82
20401,PUERTO ACOSTA,estado nutricional en menores de 5 anos,clasificacion d,2003-12-01,52,81,52,81,133
20403,PUERTO CARABUCO,estado nutricional en menores de 5 anos,clasificacion d,2003-12-01,39,67,39,67,106
90301,PUERTO GONZALO MORENO,estado nutricional en menores de 5 anos,clasificacion d,2003-12-01,7,4,7,4,11
21204,PUERTO PEREZ,estado nutricional en menores de 5 anos,clasificacion d,2003-12-01,13,15,13,15,28
90201,PUERTO RICO,estado nutricional en menores de 5 anos,clasificacion d,2003-12-01,0,7,0,7,7
80703,PUERTO SILES,estado nutricional en menores de 5 anos,clasificacion d,2003-12-01,8,11,8,11,19
31205,PUERTO VILLARROEL,estado nutricional en menores de 5 anos,clasificacion d,2003-12-01,139,129,139,129,268
51101,PUNA,estado nutricional en menores de 5 anos,clasificacion d,2003-12-01,119,137,119,137,256
31401,PUNATA,estado nutricional en menores de 5 anos,clasificacion d,2003-12-01,110,40,110,40,150
20604,QUIABAYA,estado nutricional en menores de 5 anos,clasificacion d,2003-12-01,6,8,6,8,14
30901,QUILLACOLLO,estado nutricional en menores de 5 anos,clasificacion d,2003-12-01,100,115,100,115,215
21002,QUIME,estado nutricional en menores de 5 anos,clasificacion d,2003-12-01,39,45,39,45,84
70904,QUIRUSILLAS,estado nutricional en menores de 5 anos,clasificacion d,2003-12-01,3,1,3,1,4
50402,RAVELO,estado nutricional en menores de 5 anos,clasificacion d,2003-12-01,96,113,96,113,209
80301,REYES,estado nutricional en menores de 5 anos,clasificacion d,2003-12-01,60,75,60,75,135
80201,RIBERALTA,estado nutricional en menores de 5 anos,clasificacion d,2003-12-01,396,261,396,261,657
80304,RURRENABAQUE,estado nutricional en menores de 5 anos,clasificacion d,2003-12-01,15,4,15,4,19
40901,SABAYA,estado nutricional en menores de 5 anos,clasificacion d,2003-12-01,8,6,8,6,14
31001,SACABA,estado nutricional en menores de 5 anos,clasificacion d,2003-12-01,97,23,97,23,120
30404,SACABAMBA,estado nutricional en menores de 5 anos,clasificacion d,2003-12-01,18,23,18,23,41
50701,SACACA,estado nutricional en menores de 5 anos,clasificacion d,2003-12-01,210,415,210,415,625
71302,SAIPINA,estado nutricional en menores de 5 anos,clasificacion d,2003-12-01,26,27,26,27,53
40801,SALINAS DE GARCI MENDOZA,estado nutricional en menores de 5 anos,clasificacion d,2003-12-01,23,43,23,43,66
70901,SAMAIPATA,estado nutricional en menores de 5 anos,clasificacion d,2003-12-01,24,24,24,24,48
51601,SAN AGUSTIN,estado nutricional en menores de 5 anos,clasificacion d,2003-12-01,10,5,10,5,15
80602,SAN ANDRES,estado nutricional en menores de 5 anos,clasificacion d,2003-12-01,32,28,32,28,60
51003,SAN ANTONIO DE ESMORUCO,estado nutricional en menores de 5 anos,clasificacion d,2003-12-01,0,2,0,2,2
31403,SAN BENITO,estado nutricional en menores de 5 anos,clasificacion d,2003-12-01,25,2,25,2,27
80302,SAN BORJA,estado nutricional en menores de 5 anos,clasificacion d,2003-12-01,143,150,143,150,293
21502,SAN BUENA VENTURA,estado nutricional en menores de 5 anos,clasificacion d,2003-12-01,58,43,58,43,101
70402,SAN CARLOS,estado nutricional en menores de 5 anos,clasificacion d,2003-12-01,68,71,68,71,139
80501,SAN IGNACIO,estado nutricional en menores de 5 anos,clasificacion d,2003-12-01,66,75,66,75,141
70301,SAN IGNACIO DE VELASCO,estado nutricional en menores de 5 anos,clasificacion d,2003-12-01,169,121,169,121,290
80102,SAN JAVIER(BNI),estado nutricional en menores de 5 anos,clasificacion d,2003-12-01,7,12,7,12,19
71102,SAN JAVIER(STC),estado nutricional en menores de 5 anos,clasificacion d,2003-12-01,32,26,32,26,58
80701,SAN JOAQUIN,estado nutricional en menores de 5 anos,clasificacion d,2003-12-01,8,14,8,14,22
71104,SAN JULIAN,estado nutricional en menores de 5 anos,clasificacion d,2003-12-01,101,121,101,121,222
90302,SAN LORENZO(PND),estado nutricional en menores de 5 anos,clasificacion d,2003-12-01,5,4,5,4,9
60501,SAN LORENZO(TJA),estado nutricional en menores de 5 anos,clasificacion d,2003-12-01,66,43,66,43,109
10702,SAN LUCAS,estado nutricional en menores de 5 anos,clasificacion d,2003-12-01,316,392,316,392,708
71201,SAN MATIAS,estado nutricional en menores de 5 anos,clasificacion d,2003-12-01,33,29,33,29,62
70302,SAN MIGUEL DE VELASCO,estado nutricional en menores de 5 anos,clasificacion d,2003-12-01,39,43,39,43,82
51001,SAN PABLO DE LIPEZ,estado nutricional en menores de 5 anos,clasificacion d,2003-12-01,8,6,8,6,14
50501,SAN PEDRO DE BUENA VISTA,estado nutricional en menores de 5 anos,clasificacion d,2003-12-01,140,255,140,255,395
21801,SAN PEDRO DE CURAHUARA,estado nutricional en menores de 5 anos,clasificacion d,2003-12-01,20,29,20,29,49
50902,SAN PEDRO DE QUEMES,estado nutricional en menores de 5 anos,clasificacion d,2003-12-01,1,4,1,4,5
21702,SAN PEDRO DE TIQUINA,estado nutricional en menores de 5 anos,clasificacion d,2003-12-01,3,4,3,4,7
70303,SAN RAFAEL,estado nutricional en menores de 5 anos,clasificacion d,2003-12-01,25,17,25,17,42
80702,SAN RAMON,estado nutricional en menores de 5 anos,clasificacion d,2003-12-01,2,0,2,0,2
80702,SAN RAMON,estado nutricional en menores de 5 anos,clasificacion d,2003-12-01,23,12,23,12,35
80401,SANTA ANA,estado nutricional en menores de 5 anos,clasificacion d,2003-12-01,44,42,44,42,86
70101,SANTA CRUZ DE LA SIERRA,estado nutricional en menores de 5 anos,clasificacion d,2003-12-01,456,202,456,202,658
80303,SANTA ROSA,estado nutricional en menores de 5 anos,clasificacion d,2003-12-01,36,31,36,31,67
70602,SANTA ROSA DEL SARA,estado nutricional en menores de 5 anos,clasificacion d,2003-12-01,12,28,12,28,40
20308,SANTIAGO DE CALLAPA,estado nutricional en menores de 5 anos,clasificacion d,2003-12-01,30,41,30,41,71
41401,SANTIAGO DE HUARI,estado nutricional en menores de 5 anos,clasificacion d,2003-12-01,13,23,13,23,36
21901,SANTIAGO DE MACHACA,estado nutricional en menores de 5 anos,clasificacion d,2003-12-01,20,22,20,22,42
30702,SANTIVAÃ‘ES,estado nutricional en menores de 5 anos,clasificacion d,2003-12-01,17,20,17,20,37
40202,SANTUARIO DE QUILLACAS,estado nutricional en menores de 5 anos,clasificacion d,2003-12-01,13,7,13,7,20
20902,SAPAHAQUI,estado nutricional en menores de 5 anos,clasificacion d,2003-12-01,37,44,37,44,81
90303,SENA,estado nutricional en menores de 5 anos,clasificacion d,2003-12-01,21,23,21,23,44
21301,SICA SICA (VILLA AROMA),estado nutricional en menores de 5 anos,clasificacion d,2003-12-01,107,59,107,59,166
30703,SICAYA,estado nutricional en menores de 5 anos,clasificacion d,2003-12-01,10,17,10,17,27
30902,SIPE SIPE,estado nutricional en menores de 5 anos,clasificacion d,2003-12-01,110,80,110,80,190
10403,SOPACHUY,estado nutricional en menores de 5 anos,clasificacion d,2003-12-01,31,65,31,65,96
20601,SORATA,estado nutricional en menores de 5 anos,clasificacion d,2003-12-01,42,69,42,69,111
10101,SUCRE,estado nutricional en menores de 5 anos,clasificacion d,2003-12-01,410,459,410,459,869
31404,TACACHI,estado nutricional en menores de 5 anos,clasificacion d,2003-12-01,5,0,5,0,5
20603,TACACOMA,estado nutricional en menores de 5 anos,clasificacion d,2003-12-01,21,25,21,25,46
50303,TACOBAMBA,estado nutricional en menores de 5 anos,clasificacion d,2003-12-01,74,101,74,101,175
30602,TACOPAYA,estado nutricional en menores de 5 anos,clasificacion d,2003-12-01,19,35,19,35,54
31101,TAPACARI,estado nutricional en menores de 5 anos,clasificacion d,2003-12-01,91,110,91,110,201
10601,TARABUCO,estado nutricional en menores de 5 anos,clasificacion d,2003-12-01,258,501,258,501,759
30401,TARATA,estado nutricional en menores de 5 anos,clasificacion d,2003-12-01,29,10,29,10,39
60101,TARIJA,estado nutricional en menores de 5 anos,clasificacion d,2003-12-01,478,421,478,421,899
10202,TARVITA,estado nutricional en menores de 5 anos,clasificacion d,2003-12-01,42,78,42,78,120
20803,TIAWANACU,estado nutricional en menores de 5 anos,clasificacion d,2003-12-01,11,11,11,11,22
50102,TINGUIPAYA,estado nutricional en menores de 5 anos,clasificacion d,2003-12-01,170,239,170,239,409
20606,TIPUANI,estado nutricional en menores de 5 anos,clasificacion d,2003-12-01,11,15,11,15,26
30903,TIQUIPAYA,estado nutricional en menores de 5 anos,clasificacion d,2003-12-01,34,26,34,26,60
31601,TIRAQUE (CBBA),estado nutricional en menores de 5 anos,clasificacion d,2003-12-01,179,132,179,132,311
21703,TITO YUPANQUI (PARQUIPUJIO),estado nutricional en menores de 5 anos,clasificacion d,2003-12-01,5,1,5,1,6
30802,TOCO,estado nutricional en menores de 5 anos,clasificacion d,2003-12-01,0,13,0,13,13
30803,TOLATA,estado nutricional en menores de 5 anos,clasificacion d,2003-12-01,6,4,6,4,10
41001,TOLEDO,estado nutricional en menores de 5 anos,clasificacion d,2003-12-01,5,2,5,2,7
51202,TOMAVE,estado nutricional en menores de 5 anos,clasificacion d,2003-12-01,50,67,50,67,117
10402,TOMINA,estado nutricional en menores de 5 anos,clasificacion d,2003-12-01,108,243,108,243,351
50502,TORO TORO,estado nutricional en menores de 5 anos,clasificacion d,2003-12-01,92,118,92,118,210
31201,TOTORA(CBBA),estado nutricional en menores de 5 anos,clasificacion d,2003-12-01,45,35,45,35,80
41301,TOTORA(ORR),estado nutricional en menores de 5 anos,clasificacion d,2003-12-01,22,11,22,11,33
70802,TRIGAL,estado nutricional en menores de 5 anos,clasificacion d,2003-12-01,2,1,2,1,3
80101,TRINIDAD,estado nutricional en menores de 5 anos,clasificacion d,2003-12-01,166,166,166,166,332
50801,TUPIZA,estado nutricional en menores de 5 anos,clasificacion d,2003-12-01,139,253,139,253,392
40402,TURCO,estado nutricional en menores de 5 anos,clasificacion d,2003-12-01,10,15,10,15,25
21302,UMALA,estado nutricional en menores de 5 anos,clasificacion d,2003-12-01,43,63,43,63,106
50201,UNCIA,estado nutricional en menores de 5 anos,clasificacion d,2003-12-01,19,16,19,16,35
60401,URIONDO (A. CONCEPCION),estado nutricional en menores de 5 anos,clasificacion d,2003-12-01,37,71,37,71,108
71502,URUBICHA,estado nutricional en menores de 5 anos,clasificacion d,2003-12-01,41,60,41,60,101
51201,UYUNI,estado nutricional en menores de 5 anos,clasificacion d,2003-12-01,39,55,39,55,94
30502,VACAS,estado nutricional en menores de 5 anos,clasificacion d,2003-12-01,30,17,30,17,47
70801,VALLEGRANDE,estado nutricional en menores de 5 anos,clasificacion d,2003-12-01,31,45,31,45,76
20801,VIACHA,estado nutricional en menores de 5 anos,clasificacion d,2003-12-01,115,83,115,83,198
31302,VILA VILA,estado nutricional en menores de 5 anos,clasificacion d,2003-12-01,6,22,6,22,28
60303,VILLA MONTES,estado nutricional en menores de 5 anos,clasificacion d,2003-12-01,59,46,59,46,105
31402,VILLA RIVERO,estado nutricional en menores de 5 anos,clasificacion d,2003-12-01,29,16,29,16,45
10801,VILLA SERRANO,estado nutricional en menores de 5 anos,clasificacion d,2003-12-01,107,206,107,206,313
31003,VILLA TUNARI,estado nutricional en menores de 5 anos,clasificacion d,2003-12-01,128,121,128,121,249
11001,VILLA VACA GUZMAN (MUYUPAMPA),estado nutricional en menores de 5 anos,clasificacion d,2003-12-01,67,135,67,135,202
51501,VILLAZON,estado nutricional en menores de 5 anos,clasificacion d,2003-12-01,156,194,156,194,350
30904,VINTO,estado nutricional en menores de 5 anos,clasificacion d,2003-12-01,18,10,18,10,28
50602,VITICHI,estado nutricional en menores de 5 anos,clasificacion d,2003-12-01,56,87,56,87,143
20306,WALDO BALLIVIAN,estado nutricional en menores de 5 anos,clasificacion d,2003-12-01,9,12,9,12,21
20903,YACO,estado nutricional en menores de 5 anos,clasificacion d,2003-12-01,58,40,58,40,98
60301,YACUIBA,estado nutricional en menores de 5 anos,clasificacion d,2003-12-01,62,73,62,73,135
10602,YAMPARAEZ,estado nutricional en menores de 5 anos,clasificacion d,2003-12-01,154,300,154,300,454
21103,YANACACHI,estado nutricional en menores de 5 anos,clasificacion d,2003-12-01,12,15,12,15,27
70403,YAPACANI,estado nutricional en menores de 5 anos,clasificacion d,2003-12-01,152,128,152,128,280
50103,YOCALLA,estado nutricional en menores de 5 anos,clasificacion d,2003-12-01,20,52,20,52,72
10102,YOTALA,estado nutricional en menores de 5 anos,clasificacion d,2003-12-01,52,114,52,114,166
60402,YUNCHARA,estado nutricional en menores de 5 anos,clasificacion d,2003-12-01,32,71,32,71,103
10301,ZUDAÃ‘EZ,estado nutricional en menores de 5 anos,clasificacion d,2003-12-01,59,139,59,139,198
