codigo_municipio,municipio,grupo,variable,mes,hombres total,mujeres total,hombres total.1,mujeres total.1,total
51302,ACACIO,estado nutricional en menores de 5 anos,clasificacion f,2003-01-01,10,5,10,5,15
20201,ACHACACHI,estado nutricional en menores de 5 anos,clasificacion f,2003-01-01,14,1,14,1,15
20104,ACHOCALLA,estado nutricional en menores de 5 anos,clasificacion f,2003-01-01,0,1,0,1,1
30201,AIQUILE,estado nutricional en menores de 5 anos,clasificacion f,2003-01-01,1,1,1,1,2
31303,ALALAY,estado nutricional en menores de 5 anos,clasificacion f,2003-01-01,1,0,1,0,1
10404,ALCALA,estado nutricional en menores de 5 anos,clasificacion f,2003-01-01,3,2,3,2,5
30402,ANZALDO,estado nutricional en menores de 5 anos,clasificacion f,2003-01-01,2,0,2,0,2
51301,ARAMPAMPA,estado nutricional en menores de 5 anos,clasificacion f,2003-01-01,2,0,2,0,2
30501,ARANI,estado nutricional en menores de 5 anos,clasificacion f,2003-01-01,2,1,2,1,3
30601,ARQUE,estado nutricional en menores de 5 anos,clasificacion f,2003-01-01,1,0,1,0,1
50802,ATOCHA,estado nutricional en menores de 5 anos,clasificacion f,2003-01-01,0,4,0,4,4
20502,AYATA,estado nutricional en menores de 5 anos,clasificacion f,2003-01-01,5,2,5,2,7
21303,AYO AYO,estado nutricional en menores de 5 anos,clasificacion f,2003-01-01,1,0,1,0,1
30301,AYOPAYA (V. DE INDEPENDENCIA),estado nutricional en menores de 5 anos,clasificacion f,2003-01-01,3,1,3,1,4
10201,AZURDUY,estado nutricional en menores de 5 anos,clasificacion f,2003-01-01,20,5,20,5,25
60202,BERMEJO,estado nutricional en menores de 5 anos,clasificacion f,2003-01-01,3,0,3,0,3
50301,BETANZOS,estado nutricional en menores de 5 anos,clasificacion f,2003-01-01,33,14,33,14,47
31501,BOLIVAR,estado nutricional en menores de 5 anos,clasificacion f,2003-01-01,5,1,5,1,6
90103,BOLPEBRA,estado nutricional en menores de 5 anos,clasificacion f,2003-01-01,1,0,1,0,1
70401,BUENA VISTA,estado nutricional en menores de 5 anos,clasificacion f,2003-01-01,2,1,2,1,3
70703,CABEZAS,estado nutricional en menores de 5 anos,clasificacion f,2003-01-01,1,3,1,3,4
20905,CAIROMA,estado nutricional en menores de 5 anos,clasificacion f,2003-01-01,2,1,2,1,3
51102,"CAIZA ""D""",estado nutricional en menores de 5 anos,clasificacion f,2003-01-01,5,0,5,0,5
21003,CAJUATA,estado nutricional en menores de 5 anos,clasificacion f,2003-01-01,4,7,4,7,11
21304,CALAMARCA,estado nutricional en menores de 5 anos,clasificacion f,2003-01-01,3,1,3,1,4
10701,CAMARGO,estado nutricional en menores de 5 anos,clasificacion f,2003-01-01,6,0,6,0,6
10901,CAMATAQUI (C. VILLA ABECIA),estado nutricional en menores de 5 anos,clasificacion f,2003-01-01,1,0,1,0,1
70706,CAMIRI,estado nutricional en menores de 5 anos,clasificacion f,2003-01-01,16,1,16,1,17
30701,CAPINOTA,estado nutricional en menores de 5 anos,clasificacion f,2003-01-01,9,4,9,4,13
20302,CAQUIAVIRI,estado nutricional en menores de 5 anos,clasificacion f,2003-01-01,0,1,0,1,1
22001,CARANAVI,estado nutricional en menores de 5 anos,clasificacion f,2003-01-01,4,3,4,3,7
60302,CARAPARI,estado nutricional en menores de 5 anos,clasificacion f,2003-01-01,4,1,4,1,5
50702,CARIPUYO,estado nutricional en menores de 5 anos,clasificacion f,2003-01-01,6,2,6,2,8
40201,CHALLAPATA,estado nutricional en menores de 5 anos,clasificacion f,2003-01-01,5,5,5,5,10
50302,CHAQUI,estado nutricional en menores de 5 anos,clasificacion f,2003-01-01,1,1,1,1,2
70702,CHARAGUA,estado nutricional en menores de 5 anos,clasificacion f,2003-01-01,10,10,10,10,20
50202,CHAYANTA,estado nutricional en menores de 5 anos,clasificacion f,2003-01-01,8,2,8,2,10
20501,CHUMA,estado nutricional en menores de 5 anos,clasificacion f,2003-01-01,3,0,3,0,3
90101,COBIJA,estado nutricional en menores de 5 anos,clasificacion f,2003-01-01,4,3,4,3,7
30101,COCHABAMBA,estado nutricional en menores de 5 anos,clasificacion f,2003-01-01,19,3,19,3,22
30905,COLCAPIRHUA,estado nutricional en menores de 5 anos,clasificacion f,2003-01-01,1,0,1,0,1
50901,"COLCHA ""K""",estado nutricional en menores de 5 anos,clasificacion f,2003-01-01,0,1,0,1,1
21307,COLLANA,estado nutricional en menores de 5 anos,clasificacion f,2003-01-01,0,1,0,1,1
31002,COLOMI,estado nutricional en menores de 5 anos,clasificacion f,2003-01-01,2,1,2,1,3
50401,COLQUECHACA,estado nutricional en menores de 5 anos,clasificacion f,2003-01-01,13,1,13,1,14
21306,COLQUENCHA,estado nutricional en menores de 5 anos,clasificacion f,2003-01-01,2,0,2,0,2
21004,COLQUIRI,estado nutricional en menores de 5 anos,clasificacion f,2003-01-01,6,3,6,3,9
71301,COMARAPA,estado nutricional en menores de 5 anos,clasificacion f,2003-01-01,10,1,10,1,11
71101,CONCEPCION,estado nutricional en menores de 5 anos,clasificacion f,2003-01-01,2,1,2,1,3
20301,CORO CORO,estado nutricional en menores de 5 anos,clasificacion f,2003-01-01,1,0,1,0,1
21401,COROICO,estado nutricional en menores de 5 anos,clasificacion f,2003-01-01,1,0,1,0,1
40301,CORQUE,estado nutricional en menores de 5 anos,clasificacion f,2003-01-01,1,0,1,0,1
50601,COTAGAITA,estado nutricional en menores de 5 anos,clasificacion f,2003-01-01,2,3,2,3,5
70102,COTOCA,estado nutricional en menores de 5 anos,clasificacion f,2003-01-01,1,0,1,0,1
70704,CUEVO,estado nutricional en menores de 5 anos,clasificacion f,2003-01-01,1,0,1,0,1
10902,CULPINA,estado nutricional en menores de 5 anos,clasificacion f,2003-01-01,5,4,5,4,9
40401,CURAHUARA DE CARANGAS,estado nutricional en menores de 5 anos,clasificacion f,2003-01-01,1,0,1,0,1
20804,DESAGUADERO,estado nutricional en menores de 5 anos,clasificacion f,2003-01-01,1,0,1,0,1
20105,EL ALTO,estado nutricional en menores de 5 anos,clasificacion f,2003-01-01,76,37,76,37,113
71503,EL PUENTE(STC),estado nutricional en menores de 5 anos,clasificacion f,2003-01-01,2,4,2,4,6
70105,EL TORNO,estado nutricional en menores de 5 anos,clasificacion f,2003-01-01,1,2,1,2,3
10405,EL VILLAR,estado nutricional en menores de 5 anos,clasificacion f,2003-01-01,1,2,1,2,3
60601,ENTRE RIOS,estado nutricional en menores de 5 anos,clasificacion f,2003-01-01,1,0,1,0,1
80402,EXALTACION,estado nutricional en menores de 5 anos,clasificacion f,2003-01-01,0,2,0,2,2
71002,GENERAL SAAVEDRA,estado nutricional en menores de 5 anos,clasificacion f,2003-01-01,9,4,9,4,13
21601,GRAL. J.J. PEREZ (CHARAZANI),estado nutricional en menores de 5 anos,clasificacion f,2003-01-01,1,0,1,0,1
20602,GUANAY,estado nutricional en menores de 5 anos,clasificacion f,2003-01-01,3,7,3,7,10
20802,GUAQUI,estado nutricional en menores de 5 anos,clasificacion f,2003-01-01,1,0,1,0,1
80202,GUAYARAMERIN,estado nutricional en menores de 5 anos,clasificacion f,2003-01-01,13,5,13,5,18
70705,GUTIERREZ,estado nutricional en menores de 5 anos,clasificacion f,2003-01-01,16,10,16,10,26
10502,HUACARETA,estado nutricional en menores de 5 anos,clasificacion f,2003-01-01,8,2,8,2,10
40701,HUANUNI,estado nutricional en menores de 5 anos,clasificacion f,2003-01-01,3,1,3,1,4
21005,ICHOCA,estado nutricional en menores de 5 anos,clasificacion f,2003-01-01,2,0,2,0,2
10304,ICLA,estado nutricional en menores de 5 anos,clasificacion f,2003-01-01,4,2,4,2,6
10703,INCAHUASI,estado nutricional en menores de 5 anos,clasificacion f,2003-01-01,11,4,11,4,15
21001,INQUISIVI,estado nutricional en menores de 5 anos,clasificacion f,2003-01-01,7,2,7,2,9
21501,IXIAMAS,estado nutricional en menores de 5 anos,clasificacion f,2003-01-01,1,4,1,4,5
21105,LA ASUNTA,estado nutricional en menores de 5 anos,clasificacion f,2003-01-01,1,0,1,0,1
70104,LA GUARDIA,estado nutricional en menores de 5 anos,clasificacion f,2003-01-01,4,2,4,2,6
20101,LA PAZ,estado nutricional en menores de 5 anos,clasificacion f,2003-01-01,32,10,32,10,42
70701,LAGUNILLAS,estado nutricional en menores de 5 anos,clasificacion f,2003-01-01,2,2,2,2,4
10903,LAS CARRERAS,estado nutricional en menores de 5 anos,clasificacion f,2003-01-01,1,0,1,0,1
21006,LICOMA PAMPA,estado nutricional en menores de 5 anos,clasificacion f,2003-01-01,2,0,2,0,2
50203,LLALLAGUA,estado nutricional en menores de 5 anos,clasificacion f,2003-01-01,1,20,1,20,21
11003,MACHARETI,estado nutricional en menores de 5 anos,clasificacion f,2003-01-01,5,4,5,4,9
80801,MAGDALENA,estado nutricional en menores de 5 anos,clasificacion f,2003-01-01,3,0,3,0,3
70903,MAIRANA,estado nutricional en menores de 5 anos,clasificacion f,2003-01-01,2,1,2,1,3
20103,MECAPACA,estado nutricional en menores de 5 anos,clasificacion f,2003-01-01,1,0,1,0,1
71003,MINEROS,estado nutricional en menores de 5 anos,clasificacion f,2003-01-01,12,15,12,15,27
31301,MIZQUE,estado nutricional en menores de 5 anos,clasificacion f,2003-01-01,2,1,2,1,3
10303,MOJOCOYA,estado nutricional en menores de 5 anos,clasificacion f,2003-01-01,3,2,3,2,5
10501,MONTEAGUDO,estado nutricional en menores de 5 anos,clasificacion f,2003-01-01,9,5,9,5,14
71001,MONTERO,estado nutricional en menores de 5 anos,clasificacion f,2003-01-01,17,9,17,9,26
30302,MOROCHATA,estado nutricional en menores de 5 anos,clasificacion f,2003-01-01,5,7,5,7,12
90501,NUEVO MANOA (NUEVA ESPERANZA),estado nutricional en menores de 5 anos,clasificacion f,2003-01-01,0,1,0,1,1
50404,OCURI,estado nutricional en menores de 5 anos,clasificacion f,2003-01-01,4,15,4,15,19
70202,OKINAWA,estado nutricional en menores de 5 anos,clasificacion f,2003-01-01,0,1,0,1,1
30203,OMEREQUE,estado nutricional en menores de 5 anos,clasificacion f,2003-01-01,0,1,0,1,1
40101,ORURO,estado nutricional en menores de 5 anos,clasificacion f,2003-01-01,25,13,25,13,38
60201,PADCAYA,estado nutricional en menores de 5 anos,clasificacion f,2003-01-01,1,1,1,1,2
10401,PADILLA,estado nutricional en menores de 5 anos,clasificacion f,2003-01-01,2,3,2,3,5
70502,PAILON,estado nutricional en menores de 5 anos,clasificacion f,2003-01-01,7,3,7,3,10
20102,PALCA,estado nutricional en menores de 5 anos,clasificacion f,2003-01-01,0,3,0,3,3
21104,PALOS BLANCOS,estado nutricional en menores de 5 anos,clasificacion f,2003-01-01,3,1,3,1,4
70902,PAMPA GRANDE,estado nutricional en menores de 5 anos,clasificacion f,2003-01-01,2,1,2,1,3
21305,PATACAMAYA,estado nutricional en menores de 5 anos,clasificacion f,2003-01-01,6,2,6,2,8
50403,POCOATA,estado nutricional en menores de 5 anos,clasificacion f,2003-01-01,8,9,8,9,17
31203,POCONA,estado nutricional en menores de 5 anos,clasificacion f,2003-01-01,2,5,2,5,7
10103,POROMA,estado nutricional en menores de 5 anos,clasificacion f,2003-01-01,7,4,7,4,11
70601,PORTACHUELO,estado nutricional en menores de 5 anos,clasificacion f,2003-01-01,2,3,2,3,5
50101,POTOSI,estado nutricional en menores de 5 anos,clasificacion f,2003-01-01,20,12,20,12,32
10302,PRESTO,estado nutricional en menores de 5 anos,clasificacion f,2003-01-01,7,3,7,3,10
21201,PUCARANI,estado nutricional en menores de 5 anos,clasificacion f,2003-01-01,1,0,1,0,1
20401,PUERTO ACOSTA,estado nutricional en menores de 5 anos,clasificacion f,2003-01-01,0,1,0,1,1
20403,PUERTO CARABUCO,estado nutricional en menores de 5 anos,clasificacion f,2003-01-01,4,0,4,0,4
90301,PUERTO GONZALO MORENO,estado nutricional en menores de 5 anos,clasificacion f,2003-01-01,2,0,2,0,2
71402,PUERTO QUIJARRO,estado nutricional en menores de 5 anos,clasificacion f,2003-01-01,3,0,3,0,3
80703,PUERTO SILES,estado nutricional en menores de 5 anos,clasificacion f,2003-01-01,1,0,1,0,1
71401,PUERTO SUAREZ,estado nutricional en menores de 5 anos,clasificacion f,2003-01-01,10,6,10,6,16
31205,PUERTO VILLARROEL,estado nutricional en menores de 5 anos,clasificacion f,2003-01-01,27,13,27,13,40
51101,PUNA,estado nutricional en menores de 5 anos,clasificacion f,2003-01-01,22,15,22,15,37
31401,PUNATA,estado nutricional en menores de 5 anos,clasificacion f,2003-01-01,7,2,7,2,9
20604,QUIABAYA,estado nutricional en menores de 5 anos,clasificacion f,2003-01-01,4,1,4,1,5
30901,QUILLACOLLO,estado nutricional en menores de 5 anos,clasificacion f,2003-01-01,6,5,6,5,11
21002,QUIME,estado nutricional en menores de 5 anos,clasificacion f,2003-01-01,2,0,2,0,2
50402,RAVELO,estado nutricional en menores de 5 anos,clasificacion f,2003-01-01,36,6,36,6,42
80301,REYES,estado nutricional en menores de 5 anos,clasificacion f,2003-01-01,1,0,1,0,1
80201,RIBERALTA,estado nutricional en menores de 5 anos,clasificacion f,2003-01-01,20,9,20,9,29
70503,ROBORE,estado nutricional en menores de 5 anos,clasificacion f,2003-01-01,4,6,4,6,10
80304,RURRENABAQUE,estado nutricional en menores de 5 anos,clasificacion f,2003-01-01,1,0,1,0,1
31001,SACABA,estado nutricional en menores de 5 anos,clasificacion f,2003-01-01,3,2,3,2,5
50701,SACACA,estado nutricional en menores de 5 anos,clasificacion f,2003-01-01,14,9,14,9,23
71302,SAIPINA,estado nutricional en menores de 5 anos,clasificacion f,2003-01-01,2,1,2,1,3
40801,SALINAS DE GARCI MENDOZA,estado nutricional en menores de 5 anos,clasificacion f,2003-01-01,1,0,1,0,1
51003,SAN ANTONIO DE ESMORUCO,estado nutricional en menores de 5 anos,clasificacion f,2003-01-01,0,1,0,1,1
71105,SAN ANTONIO DE LOMERIO,estado nutricional en menores de 5 anos,clasificacion f,2003-01-01,7,11,7,11,18
31403,SAN BENITO,estado nutricional en menores de 5 anos,clasificacion f,2003-01-01,0,2,0,2,2
80302,SAN BORJA,estado nutricional en menores de 5 anos,clasificacion f,2003-01-01,12,6,12,6,18
21502,SAN BUENA VENTURA,estado nutricional en menores de 5 anos,clasificacion f,2003-01-01,3,2,3,2,5
70402,SAN CARLOS,estado nutricional en menores de 5 anos,clasificacion f,2003-01-01,1,0,1,0,1
80501,SAN IGNACIO,estado nutricional en menores de 5 anos,clasificacion f,2003-01-01,12,6,12,6,18
70301,SAN IGNACIO DE VELASCO,estado nutricional en menores de 5 anos,clasificacion f,2003-01-01,19,10,19,10,29
71102,SAN JAVIER(STC),estado nutricional en menores de 5 anos,clasificacion f,2003-01-01,1,0,1,0,1
70501,SAN JOSE DE CHIQUITOS,estado nutricional en menores de 5 anos,clasificacion f,2003-01-01,5,0,5,0,5
71104,SAN JULIAN,estado nutricional en menores de 5 anos,clasificacion f,2003-01-01,9,5,9,5,14
60501,SAN LORENZO(TJA),estado nutricional en menores de 5 anos,clasificacion f,2003-01-01,2,5,2,5,7
10702,SAN LUCAS,estado nutricional en menores de 5 anos,clasificacion f,2003-01-01,13,6,13,6,19
71201,SAN MATIAS,estado nutricional en menores de 5 anos,clasificacion f,2003-01-01,5,3,5,3,8
70302,SAN MIGUEL DE VELASCO,estado nutricional en menores de 5 anos,clasificacion f,2003-01-01,3,0,3,0,3
51001,SAN PABLO DE LIPEZ,estado nutricional en menores de 5 anos,clasificacion f,2003-01-01,1,1,1,1,2
50501,SAN PEDRO DE BUENA VISTA,estado nutricional en menores de 5 anos,clasificacion f,2003-01-01,6,5,6,5,11
70303,SAN RAFAEL,estado nutricional en menores de 5 anos,clasificacion f,2003-01-01,3,1,3,1,4
70101,SANTA CRUZ DE LA SIERRA,estado nutricional en menores de 5 anos,clasificacion f,2003-01-01,59,21,59,21,80
80303,SANTA ROSA,estado nutricional en menores de 5 anos,clasificacion f,2003-01-01,1,0,1,0,1
20308,SANTIAGO DE CALLAPA,estado nutricional en menores de 5 anos,clasificacion f,2003-01-01,2,0,2,0,2
41401,SANTIAGO DE HUARI,estado nutricional en menores de 5 anos,clasificacion f,2003-01-01,0,2,0,2,2
30702,SANTIVAÑES,estado nutricional en menores de 5 anos,clasificacion f,2003-01-01,1,0,1,0,1
20902,SAPAHAQUI,estado nutricional en menores de 5 anos,clasificacion f,2003-01-01,0,1,0,1,1
90303,SENA,estado nutricional en menores de 5 anos,clasificacion f,2003-01-01,0,6,0,6,6
21301,SICA SICA (VILLA AROMA),estado nutricional en menores de 5 anos,clasificacion f,2003-01-01,6,2,6,2,8
30703,SICAYA,estado nutricional en menores de 5 anos,clasificacion f,2003-01-01,3,0,3,0,3
30902,SIPE SIPE,estado nutricional en menores de 5 anos,clasificacion f,2003-01-01,10,3,10,3,13
10403,SOPACHUY,estado nutricional en menores de 5 anos,clasificacion f,2003-01-01,5,7,5,7,12
20601,SORATA,estado nutricional en menores de 5 anos,clasificacion f,2003-01-01,0,2,0,2,2
10101,SUCRE,estado nutricional en menores de 5 anos,clasificacion f,2003-01-01,18,7,18,7,25
20603,TACACOMA,estado nutricional en menores de 5 anos,clasificacion f,2003-01-01,1,1,1,1,2
50303,TACOBAMBA,estado nutricional en menores de 5 anos,clasificacion f,2003-01-01,5,1,5,1,6
30602,TACOPAYA,estado nutricional en menores de 5 anos,clasificacion f,2003-01-01,16,2,16,2,18
31101,TAPACARI,estado nutricional en menores de 5 anos,clasificacion f,2003-01-01,3,3,3,3,6
10601,TARABUCO,estado nutricional en menores de 5 anos,clasificacion f,2003-01-01,36,16,36,16,52
60101,TARIJA,estado nutricional en menores de 5 anos,clasificacion f,2003-01-01,4,6,4,6,10
10202,TARVITA,estado nutricional en menores de 5 anos,clasificacion f,2003-01-01,9,3,9,3,12
20803,TIAWANACU,estado nutricional en menores de 5 anos,clasificacion f,2003-01-01,1,0,1,0,1
50102,TINGUIPAYA,estado nutricional en menores de 5 anos,clasificacion f,2003-01-01,0,4,0,4,4
31601,TIRAQUE (CBBA),estado nutricional en menores de 5 anos,clasificacion f,2003-01-01,18,7,18,7,25
30803,TOLATA,estado nutricional en menores de 5 anos,clasificacion f,2003-01-01,0,1,0,1,1
41001,TOLEDO,estado nutricional en menores de 5 anos,clasificacion f,2003-01-01,2,0,2,0,2
51202,TOMAVE,estado nutricional en menores de 5 anos,clasificacion f,2003-01-01,5,2,5,2,7
10402,TOMINA,estado nutricional en menores de 5 anos,clasificacion f,2003-01-01,6,5,6,5,11
50502,TORO TORO,estado nutricional en menores de 5 anos,clasificacion f,2003-01-01,0,2,0,2,2
31201,TOTORA(CBBA),estado nutricional en menores de 5 anos,clasificacion f,2003-01-01,2,1,2,1,3
41301,TOTORA(ORR),estado nutricional en menores de 5 anos,clasificacion f,2003-01-01,0,1,0,1,1
80101,TRINIDAD,estado nutricional en menores de 5 anos,clasificacion f,2003-01-01,9,13,9,13,22
50801,TUPIZA,estado nutricional en menores de 5 anos,clasificacion f,2003-01-01,2,9,2,9,11
21302,UMALA,estado nutricional en menores de 5 anos,clasificacion f,2003-01-01,11,0,11,0,11
50201,UNCIA,estado nutricional en menores de 5 anos,clasificacion f,2003-01-01,0,2,0,2,2
60401,URIONDO (A. CONCEPCION),estado nutricional en menores de 5 anos,clasificacion f,2003-01-01,1,0,1,0,1
51201,UYUNI,estado nutricional en menores de 5 anos,clasificacion f,2003-01-01,2,2,2,2,4
30502,VACAS,estado nutricional en menores de 5 anos,clasificacion f,2003-01-01,0,1,0,1,1
70801,VALLEGRANDE,estado nutricional en menores de 5 anos,clasificacion f,2003-01-01,1,1,1,1,2
20801,VIACHA,estado nutricional en menores de 5 anos,clasificacion f,2003-01-01,3,1,3,1,4
31302,VILA VILA,estado nutricional en menores de 5 anos,clasificacion f,2003-01-01,2,0,2,0,2
60303,VILLA MONTES,estado nutricional en menores de 5 anos,clasificacion f,2003-01-01,5,7,5,7,12
31402,VILLA RIVERO,estado nutricional en menores de 5 anos,clasificacion f,2003-01-01,2,2,2,2,4
10801,VILLA SERRANO,estado nutricional en menores de 5 anos,clasificacion f,2003-01-01,9,4,9,4,13
31003,VILLA TUNARI,estado nutricional en menores de 5 anos,clasificacion f,2003-01-01,2,15,2,15,17
11001,VILLA VACA GUZMAN (MUYUPAMPA),estado nutricional en menores de 5 anos,clasificacion f,2003-01-01,2,2,2,2,4
51501,VILLAZON,estado nutricional en menores de 5 anos,clasificacion f,2003-01-01,3,2,3,2,5
50602,VITICHI,estado nutricional en menores de 5 anos,clasificacion f,2003-01-01,7,1,7,1,8
70201,WARNES,estado nutricional en menores de 5 anos,clasificacion f,2003-01-01,6,2,6,2,8
20903,YACO,estado nutricional en menores de 5 anos,clasificacion f,2003-01-01,0,1,0,1,1
60301,YACUIBA,estado nutricional en menores de 5 anos,clasificacion f,2003-01-01,9,4,9,4,13
10602,YAMPARAEZ,estado nutricional en menores de 5 anos,clasificacion f,2003-01-01,13,2,13,2,15
70403,YAPACANI,estado nutricional en menores de 5 anos,clasificacion f,2003-01-01,9,3,9,3,12
50103,YOCALLA,estado nutricional en menores de 5 anos,clasificacion f,2003-01-01,2,0,2,0,2
10102,YOTALA,estado nutricional en menores de 5 anos,clasificacion f,2003-01-01,4,1,4,1,5
60402,YUNCHARA,estado nutricional en menores de 5 anos,clasificacion f,2003-01-01,0,1,0,1,1
10301,ZUDAÑEZ,estado nutricional en menores de 5 anos,clasificacion f,2003-01-01,2,1,2,1,3
51302,ACACIO,estado nutricional en menores de 5 anos,clasificacion f,2003-02-01,14,5,14,5,19
20201,ACHACACHI,estado nutricional en menores de 5 anos,clasificacion f,2003-02-01,1,1,1,1,2
30201,AIQUILE,estado nutricional en menores de 5 anos,clasificacion f,2003-02-01,2,2,2,2,4
10404,ALCALA,estado nutricional en menores de 5 anos,clasificacion f,2003-02-01,5,2,5,2,7
20202,ANCORAIMES,estado nutricional en menores de 5 anos,clasificacion f,2003-02-01,2,0,2,0,2
41201,ANDAMARCA,estado nutricional en menores de 5 anos,clasificacion f,2003-02-01,0,1,0,1,1
30402,ANZALDO,estado nutricional en menores de 5 anos,clasificacion f,2003-02-01,5,3,5,3,8
20701,APOLO,estado nutricional en menores de 5 anos,clasificacion f,2003-02-01,2,3,2,3,5
51301,ARAMPAMPA,estado nutricional en menores de 5 anos,clasificacion f,2003-02-01,2,2,2,2,4
30501,ARANI,estado nutricional en menores de 5 anos,clasificacion f,2003-02-01,1,1,1,1,2
30403,ARBIETO,estado nutricional en menores de 5 anos,clasificacion f,2003-02-01,1,0,1,0,1
30601,ARQUE,estado nutricional en menores de 5 anos,clasificacion f,2003-02-01,2,2,2,2,4
71501,ASCENCION DE GUARAYOS,estado nutricional en menores de 5 anos,clasificacion f,2003-02-01,17,7,17,7,24
50802,ATOCHA,estado nutricional en menores de 5 anos,clasificacion f,2003-02-01,1,8,1,8,9
20502,AYATA,estado nutricional en menores de 5 anos,clasificacion f,2003-02-01,2,0,2,0,2
21303,AYO AYO,estado nutricional en menores de 5 anos,clasificacion f,2003-02-01,1,0,1,0,1
30301,AYOPAYA (V. DE INDEPENDENCIA),estado nutricional en menores de 5 anos,clasificacion f,2003-02-01,7,1,7,1,8
10201,AZURDUY,estado nutricional en menores de 5 anos,clasificacion f,2003-02-01,29,7,29,7,36
21203,BATALLAS,estado nutricional en menores de 5 anos,clasificacion f,2003-02-01,1,0,1,0,1
60202,BERMEJO,estado nutricional en menores de 5 anos,clasificacion f,2003-02-01,2,0,2,0,2
50301,BETANZOS,estado nutricional en menores de 5 anos,clasificacion f,2003-02-01,14,9,14,9,23
31501,BOLIVAR,estado nutricional en menores de 5 anos,clasificacion f,2003-02-01,3,0,3,0,3
90103,BOLPEBRA,estado nutricional en menores de 5 anos,clasificacion f,2003-02-01,1,0,1,0,1
70707,BOYUIBE,estado nutricional en menores de 5 anos,clasificacion f,2003-02-01,1,2,1,2,3
70401,BUENA VISTA,estado nutricional en menores de 5 anos,clasificacion f,2003-02-01,3,0,3,0,3
70703,CABEZAS,estado nutricional en menores de 5 anos,clasificacion f,2003-02-01,3,0,3,0,3
20905,CAIROMA,estado nutricional en menores de 5 anos,clasificacion f,2003-02-01,2,1,2,1,3
51102,"CAIZA ""D""",estado nutricional en menores de 5 anos,clasificacion f,2003-02-01,9,1,9,1,10
21003,CAJUATA,estado nutricional en menores de 5 anos,clasificacion f,2003-02-01,1,2,1,2,3
20303,CALACOTO,estado nutricional en menores de 5 anos,clasificacion f,2003-02-01,0,1,0,1,1
21304,CALAMARCA,estado nutricional en menores de 5 anos,clasificacion f,2003-02-01,4,1,4,1,5
10701,CAMARGO,estado nutricional en menores de 5 anos,clasificacion f,2003-02-01,1,3,1,3,4
70706,CAMIRI,estado nutricional en menores de 5 anos,clasificacion f,2003-02-01,7,1,7,1,8
30701,CAPINOTA,estado nutricional en menores de 5 anos,clasificacion f,2003-02-01,2,0,2,0,2
20302,CAQUIAVIRI,estado nutricional en menores de 5 anos,clasificacion f,2003-02-01,0,1,0,1,1
22001,CARANAVI,estado nutricional en menores de 5 anos,clasificacion f,2003-02-01,3,2,3,2,5
60302,CARAPARI,estado nutricional en menores de 5 anos,clasificacion f,2003-02-01,1,0,1,0,1
50702,CARIPUYO,estado nutricional en menores de 5 anos,clasificacion f,2003-02-01,9,4,9,4,13
40201,CHALLAPATA,estado nutricional en menores de 5 anos,clasificacion f,2003-02-01,5,5,5,5,10
50302,CHAQUI,estado nutricional en menores de 5 anos,clasificacion f,2003-02-01,1,0,1,0,1
70702,CHARAGUA,estado nutricional en menores de 5 anos,clasificacion f,2003-02-01,13,7,13,7,20
50202,CHAYANTA,estado nutricional en menores de 5 anos,clasificacion f,2003-02-01,3,2,3,2,5
21101,CHULUMANI (V. DE LA LIBERTAD),estado nutricional en menores de 5 anos,clasificacion f,2003-02-01,0,1,0,1,1
20501,CHUMA,estado nutricional en menores de 5 anos,clasificacion f,2003-02-01,5,1,5,1,6
30801,CLIZA,estado nutricional en menores de 5 anos,clasificacion f,2003-02-01,4,4,4,4,8
90101,COBIJA,estado nutricional en menores de 5 anos,clasificacion f,2003-02-01,2,0,2,0,2
30101,COCHABAMBA,estado nutricional en menores de 5 anos,clasificacion f,2003-02-01,22,8,22,8,30
30905,COLCAPIRHUA,estado nutricional en menores de 5 anos,clasificacion f,2003-02-01,1,0,1,0,1
50901,"COLCHA ""K""",estado nutricional en menores de 5 anos,clasificacion f,2003-02-01,1,2,1,2,3
31002,COLOMI,estado nutricional en menores de 5 anos,clasificacion f,2003-02-01,2,3,2,3,5
50401,COLQUECHACA,estado nutricional en menores de 5 anos,clasificacion f,2003-02-01,7,2,7,2,9
21306,COLQUENCHA,estado nutricional en menores de 5 anos,clasificacion f,2003-02-01,0,1,0,1,1
21004,COLQUIRI,estado nutricional en menores de 5 anos,clasificacion f,2003-02-01,1,0,1,0,1
71301,COMARAPA,estado nutricional en menores de 5 anos,clasificacion f,2003-02-01,5,1,5,1,6
71101,CONCEPCION,estado nutricional en menores de 5 anos,clasificacion f,2003-02-01,0,1,0,1,1
21701,COPACABANA,estado nutricional en menores de 5 anos,clasificacion f,2003-02-01,0,1,0,1,1
21402,CORIPATA,estado nutricional en menores de 5 anos,clasificacion f,2003-02-01,0,1,0,1,1
20301,CORO CORO,estado nutricional en menores de 5 anos,clasificacion f,2003-02-01,1,0,1,0,1
40301,CORQUE,estado nutricional en menores de 5 anos,clasificacion f,2003-02-01,1,0,1,0,1
50601,COTAGAITA,estado nutricional en menores de 5 anos,clasificacion f,2003-02-01,4,1,4,1,5
70102,COTOCA,estado nutricional en menores de 5 anos,clasificacion f,2003-02-01,2,0,2,0,2
10902,CULPINA,estado nutricional en menores de 5 anos,clasificacion f,2003-02-01,11,4,11,4,15
21602,CURVA,estado nutricional en menores de 5 anos,clasificacion f,2003-02-01,1,0,1,0,1
20804,DESAGUADERO,estado nutricional en menores de 5 anos,clasificacion f,2003-02-01,2,0,2,0,2
20105,EL ALTO,estado nutricional en menores de 5 anos,clasificacion f,2003-02-01,71,16,71,16,87
71503,EL PUENTE(STC),estado nutricional en menores de 5 anos,clasificacion f,2003-02-01,3,4,3,4,7
60502,EL PUENTE(TJA),estado nutricional en menores de 5 anos,clasificacion f,2003-02-01,0,1,0,1,1
70105,EL TORNO,estado nutricional en menores de 5 anos,clasificacion f,2003-02-01,3,2,3,2,5
10405,EL VILLAR,estado nutricional en menores de 5 anos,clasificacion f,2003-02-01,5,2,5,2,7
60601,ENTRE RIOS,estado nutricional en menores de 5 anos,clasificacion f,2003-02-01,2,0,2,0,2
41101,EUCALIPTUS,estado nutricional en menores de 5 anos,clasificacion f,2003-02-01,2,2,2,2,4
71002,GENERAL SAAVEDRA,estado nutricional en menores de 5 anos,clasificacion f,2003-02-01,16,9,16,9,25
21601,GRAL. J.J. PEREZ (CHARAZANI),estado nutricional en menores de 5 anos,clasificacion f,2003-02-01,2,2,2,2,4
20602,GUANAY,estado nutricional en menores de 5 anos,clasificacion f,2003-02-01,4,6,4,6,10
80202,GUAYARAMERIN,estado nutricional en menores de 5 anos,clasificacion f,2003-02-01,4,3,4,3,7
70705,GUTIERREZ,estado nutricional en menores de 5 anos,clasificacion f,2003-02-01,18,15,18,15,33
10502,HUACARETA,estado nutricional en menores de 5 anos,clasificacion f,2003-02-01,9,2,9,2,11
11002,HUACAYA (VILLA DE HUACAYA),estado nutricional en menores de 5 anos,clasificacion f,2003-02-01,1,1,1,1,2
40701,HUANUNI,estado nutricional en menores de 5 anos,clasificacion f,2003-02-01,5,1,5,1,6
21005,ICHOCA,estado nutricional en menores de 5 anos,clasificacion f,2003-02-01,2,0,2,0,2
10304,ICLA,estado nutricional en menores de 5 anos,clasificacion f,2003-02-01,1,7,1,7,8
10703,INCAHUASI,estado nutricional en menores de 5 anos,clasificacion f,2003-02-01,11,2,11,2,13
21001,INQUISIVI,estado nutricional en menores de 5 anos,clasificacion f,2003-02-01,1,2,1,2,3
21501,IXIAMAS,estado nutricional en menores de 5 anos,clasificacion f,2003-02-01,1,1,1,1,2
21105,LA ASUNTA,estado nutricional en menores de 5 anos,clasificacion f,2003-02-01,2,1,2,1,3
70104,LA GUARDIA,estado nutricional en menores de 5 anos,clasificacion f,2003-02-01,3,0,3,0,3
20101,LA PAZ,estado nutricional en menores de 5 anos,clasificacion f,2003-02-01,21,13,21,13,34
70701,LAGUNILLAS,estado nutricional en menores de 5 anos,clasificacion f,2003-02-01,3,2,3,2,5
50203,LLALLAGUA,estado nutricional en menores de 5 anos,clasificacion f,2003-02-01,0,19,0,19,19
51401,LLICA,estado nutricional en menores de 5 anos,clasificacion f,2003-02-01,0,1,0,1,1
20901,LURIBAY,estado nutricional en menores de 5 anos,clasificacion f,2003-02-01,0,1,0,1,1
11003,MACHARETI,estado nutricional en menores de 5 anos,clasificacion f,2003-02-01,3,3,3,3,6
80801,MAGDALENA,estado nutricional en menores de 5 anos,clasificacion f,2003-02-01,1,1,1,1,2
70903,MAIRANA,estado nutricional en menores de 5 anos,clasificacion f,2003-02-01,3,1,3,1,4
20103,MECAPACA,estado nutricional en menores de 5 anos,clasificacion f,2003-02-01,0,1,0,1,1
71003,MINEROS,estado nutricional en menores de 5 anos,clasificacion f,2003-02-01,7,8,7,8,15
31301,MIZQUE,estado nutricional en menores de 5 anos,clasificacion f,2003-02-01,11,0,11,0,11
20402,MOCOMOCO,estado nutricional en menores de 5 anos,clasificacion f,2003-02-01,4,0,4,0,4
10303,MOJOCOYA,estado nutricional en menores de 5 anos,clasificacion f,2003-02-01,1,2,1,2,3
10501,MONTEAGUDO,estado nutricional en menores de 5 anos,clasificacion f,2003-02-01,19,9,19,9,28
71001,MONTERO,estado nutricional en menores de 5 anos,clasificacion f,2003-02-01,22,5,22,5,27
30302,MOROCHATA,estado nutricional en menores de 5 anos,clasificacion f,2003-02-01,3,6,3,6,9
90401,NACEBE (SANTA ROSA DEL ABUNA),estado nutricional en menores de 5 anos,clasificacion f,2003-02-01,1,0,1,0,1
50404,OCURI,estado nutricional en menores de 5 anos,clasificacion f,2003-02-01,7,4,7,4,11
40101,ORURO,estado nutricional en menores de 5 anos,clasificacion f,2003-02-01,21,4,21,4,25
10401,PADILLA,estado nutricional en menores de 5 anos,clasificacion f,2003-02-01,2,3,2,3,5
70502,PAILON,estado nutricional en menores de 5 anos,clasificacion f,2003-02-01,9,3,9,3,12
20102,PALCA,estado nutricional en menores de 5 anos,clasificacion f,2003-02-01,0,3,0,3,3
21104,PALOS BLANCOS,estado nutricional en menores de 5 anos,clasificacion f,2003-02-01,3,4,3,4,7
70902,PAMPA GRANDE,estado nutricional en menores de 5 anos,clasificacion f,2003-02-01,0,2,0,2,2
30202,PASORAPA,estado nutricional en menores de 5 anos,clasificacion f,2003-02-01,1,1,1,1,2
21305,PATACAMAYA,estado nutricional en menores de 5 anos,clasificacion f,2003-02-01,9,4,9,4,13
40602,PAZÑA,estado nutricional en menores de 5 anos,clasificacion f,2003-02-01,2,1,2,1,3
20702,PELECHUCO,estado nutricional en menores de 5 anos,clasificacion f,2003-02-01,1,0,1,0,1
50403,POCOATA,estado nutricional en menores de 5 anos,clasificacion f,2003-02-01,8,6,8,6,14
31202,POJO (CBBA),estado nutricional en menores de 5 anos,clasificacion f,2003-02-01,2,1,2,1,3
51203,PORCO,estado nutricional en menores de 5 anos,clasificacion f,2003-02-01,0,1,0,1,1
10103,POROMA,estado nutricional en menores de 5 anos,clasificacion f,2003-02-01,21,24,21,24,45
70103,PORONGO,estado nutricional en menores de 5 anos,clasificacion f,2003-02-01,2,0,2,0,2
70601,PORTACHUELO,estado nutricional en menores de 5 anos,clasificacion f,2003-02-01,2,2,2,2,4
50101,POTOSI,estado nutricional en menores de 5 anos,clasificacion f,2003-02-01,19,5,19,5,24
10302,PRESTO,estado nutricional en menores de 5 anos,clasificacion f,2003-02-01,4,3,4,3,7
20401,PUERTO ACOSTA,estado nutricional en menores de 5 anos,clasificacion f,2003-02-01,4,0,4,0,4
20403,PUERTO CARABUCO,estado nutricional en menores de 5 anos,clasificacion f,2003-02-01,2,2,2,2,4
90301,PUERTO GONZALO MORENO,estado nutricional en menores de 5 anos,clasificacion f,2003-02-01,1,0,1,0,1
71402,PUERTO QUIJARRO,estado nutricional en menores de 5 anos,clasificacion f,2003-02-01,2,0,2,0,2
90201,PUERTO RICO,estado nutricional en menores de 5 anos,clasificacion f,2003-02-01,1,0,1,0,1
71401,PUERTO SUAREZ,estado nutricional en menores de 5 anos,clasificacion f,2003-02-01,4,2,4,2,6
31205,PUERTO VILLARROEL,estado nutricional en menores de 5 anos,clasificacion f,2003-02-01,23,13,23,13,36
51101,PUNA,estado nutricional en menores de 5 anos,clasificacion f,2003-02-01,6,0,6,0,6
31401,PUNATA,estado nutricional en menores de 5 anos,clasificacion f,2003-02-01,6,1,6,1,7
30901,QUILLACOLLO,estado nutricional en menores de 5 anos,clasificacion f,2003-02-01,2,1,2,1,3
21002,QUIME,estado nutricional en menores de 5 anos,clasificacion f,2003-02-01,4,0,4,0,4
50402,RAVELO,estado nutricional en menores de 5 anos,clasificacion f,2003-02-01,29,17,29,17,46
80301,REYES,estado nutricional en menores de 5 anos,clasificacion f,2003-02-01,2,4,2,4,6
80201,RIBERALTA,estado nutricional en menores de 5 anos,clasificacion f,2003-02-01,15,7,15,7,22
70503,ROBORE,estado nutricional en menores de 5 anos,clasificacion f,2003-02-01,2,7,2,7,9
31001,SACABA,estado nutricional en menores de 5 anos,clasificacion f,2003-02-01,3,4,3,4,7
30404,SACABAMBA,estado nutricional en menores de 5 anos,clasificacion f,2003-02-01,0,1,0,1,1
50701,SACACA,estado nutricional en menores de 5 anos,clasificacion f,2003-02-01,18,19,18,19,37
71302,SAIPINA,estado nutricional en menores de 5 anos,clasificacion f,2003-02-01,1,0,1,0,1
70901,SAMAIPATA,estado nutricional en menores de 5 anos,clasificacion f,2003-02-01,1,0,1,0,1
51601,SAN AGUSTIN,estado nutricional en menores de 5 anos,clasificacion f,2003-02-01,1,0,1,0,1
80602,SAN ANDRES,estado nutricional en menores de 5 anos,clasificacion f,2003-02-01,2,3,2,3,5
71105,SAN ANTONIO DE LOMERIO,estado nutricional en menores de 5 anos,clasificacion f,2003-02-01,9,4,9,4,13
31403,SAN BENITO,estado nutricional en menores de 5 anos,clasificacion f,2003-02-01,2,0,2,0,2
80302,SAN BORJA,estado nutricional en menores de 5 anos,clasificacion f,2003-02-01,6,1,6,1,7
21502,SAN BUENA VENTURA,estado nutricional en menores de 5 anos,clasificacion f,2003-02-01,4,1,4,1,5
70402,SAN CARLOS,estado nutricional en menores de 5 anos,clasificacion f,2003-02-01,6,1,6,1,7
80501,SAN IGNACIO,estado nutricional en menores de 5 anos,clasificacion f,2003-02-01,11,4,11,4,15
70301,SAN IGNACIO DE VELASCO,estado nutricional en menores de 5 anos,clasificacion f,2003-02-01,17,11,17,11,28
71102,SAN JAVIER(STC),estado nutricional en menores de 5 anos,clasificacion f,2003-02-01,1,0,1,0,1
80701,SAN JOAQUIN,estado nutricional en menores de 5 anos,clasificacion f,2003-02-01,0,1,0,1,1
70501,SAN JOSE DE CHIQUITOS,estado nutricional en menores de 5 anos,clasificacion f,2003-02-01,6,2,6,2,8
71104,SAN JULIAN,estado nutricional en menores de 5 anos,clasificacion f,2003-02-01,22,8,22,8,30
10702,SAN LUCAS,estado nutricional en menores de 5 anos,clasificacion f,2003-02-01,19,10,19,10,29
71201,SAN MATIAS,estado nutricional en menores de 5 anos,clasificacion f,2003-02-01,2,0,2,0,2
70302,SAN MIGUEL DE VELASCO,estado nutricional en menores de 5 anos,clasificacion f,2003-02-01,0,7,0,7,7
50501,SAN PEDRO DE BUENA VISTA,estado nutricional en menores de 5 anos,clasificacion f,2003-02-01,4,4,4,4,8
70303,SAN RAFAEL,estado nutricional en menores de 5 anos,clasificacion f,2003-02-01,1,0,1,0,1
80401,SANTA ANA,estado nutricional en menores de 5 anos,clasificacion f,2003-02-01,0,1,0,1,1
70101,SANTA CRUZ DE LA SIERRA,estado nutricional en menores de 5 anos,clasificacion f,2003-02-01,34,12,34,12,46
80303,SANTA ROSA,estado nutricional en menores de 5 anos,clasificacion f,2003-02-01,0,1,0,1,1
20308,SANTIAGO DE CALLAPA,estado nutricional en menores de 5 anos,clasificacion f,2003-02-01,0,1,0,1,1
41401,SANTIAGO DE HUARI,estado nutricional en menores de 5 anos,clasificacion f,2003-02-01,1,0,1,0,1
30702,SANTIVAÑES,estado nutricional en menores de 5 anos,clasificacion f,2003-02-01,1,0,1,0,1
20902,SAPAHAQUI,estado nutricional en menores de 5 anos,clasificacion f,2003-02-01,3,2,3,2,5
21301,SICA SICA (VILLA AROMA),estado nutricional en menores de 5 anos,clasificacion f,2003-02-01,2,1,2,1,3
30902,SIPE SIPE,estado nutricional en menores de 5 anos,clasificacion f,2003-02-01,7,3,7,3,10
10403,SOPACHUY,estado nutricional en menores de 5 anos,clasificacion f,2003-02-01,16,8,16,8,24
20601,SORATA,estado nutricional en menores de 5 anos,clasificacion f,2003-02-01,1,2,1,2,3
10101,SUCRE,estado nutricional en menores de 5 anos,clasificacion f,2003-02-01,28,14,28,14,42
50303,TACOBAMBA,estado nutricional en menores de 5 anos,clasificacion f,2003-02-01,2,1,2,1,3
31101,TAPACARI,estado nutricional en menores de 5 anos,clasificacion f,2003-02-01,5,3,5,3,8
10601,TARABUCO,estado nutricional en menores de 5 anos,clasificacion f,2003-02-01,51,19,51,19,70
30401,TARATA,estado nutricional en menores de 5 anos,clasificacion f,2003-02-01,1,2,1,2,3
60101,TARIJA,estado nutricional en menores de 5 anos,clasificacion f,2003-02-01,12,4,12,4,16
10202,TARVITA,estado nutricional en menores de 5 anos,clasificacion f,2003-02-01,6,6,6,6,12
20803,TIAWANACU,estado nutricional en menores de 5 anos,clasificacion f,2003-02-01,2,0,2,0,2
50102,TINGUIPAYA,estado nutricional en menores de 5 anos,clasificacion f,2003-02-01,1,0,1,0,1
31601,TIRAQUE (CBBA),estado nutricional en menores de 5 anos,clasificacion f,2003-02-01,13,5,13,5,18
41001,TOLEDO,estado nutricional en menores de 5 anos,clasificacion f,2003-02-01,2,0,2,0,2
51202,TOMAVE,estado nutricional en menores de 5 anos,clasificacion f,2003-02-01,3,5,3,5,8
10402,TOMINA,estado nutricional en menores de 5 anos,clasificacion f,2003-02-01,4,3,4,3,7
50502,TORO TORO,estado nutricional en menores de 5 anos,clasificacion f,2003-02-01,9,4,9,4,13
31201,TOTORA(CBBA),estado nutricional en menores de 5 anos,clasificacion f,2003-02-01,1,0,1,0,1
41301,TOTORA(ORR),estado nutricional en menores de 5 anos,clasificacion f,2003-02-01,0,3,0,3,3
80101,TRINIDAD,estado nutricional en menores de 5 anos,clasificacion f,2003-02-01,16,8,16,8,24
50801,TUPIZA,estado nutricional en menores de 5 anos,clasificacion f,2003-02-01,3,11,3,11,14
40402,TURCO,estado nutricional en menores de 5 anos,clasificacion f,2003-02-01,0,1,0,1,1
21302,UMALA,estado nutricional en menores de 5 anos,clasificacion f,2003-02-01,1,1,1,1,2
50201,UNCIA,estado nutricional en menores de 5 anos,clasificacion f,2003-02-01,1,0,1,0,1
71502,URUBICHA,estado nutricional en menores de 5 anos,clasificacion f,2003-02-01,0,1,0,1,1
51201,UYUNI,estado nutricional en menores de 5 anos,clasificacion f,2003-02-01,1,3,1,3,4
30502,VACAS,estado nutricional en menores de 5 anos,clasificacion f,2003-02-01,4,0,4,0,4
70801,VALLEGRANDE,estado nutricional en menores de 5 anos,clasificacion f,2003-02-01,3,2,3,2,5
20801,VIACHA,estado nutricional en menores de 5 anos,clasificacion f,2003-02-01,3,5,3,5,8
31302,VILA VILA,estado nutricional en menores de 5 anos,clasificacion f,2003-02-01,4,0,4,0,4
60303,VILLA MONTES,estado nutricional en menores de 5 anos,clasificacion f,2003-02-01,16,4,16,4,20
31402,VILLA RIVERO,estado nutricional en menores de 5 anos,clasificacion f,2003-02-01,1,0,1,0,1
10801,VILLA SERRANO,estado nutricional en menores de 5 anos,clasificacion f,2003-02-01,4,2,4,2,6
31003,VILLA TUNARI,estado nutricional en menores de 5 anos,clasificacion f,2003-02-01,8,9,8,9,17
11001,VILLA VACA GUZMAN (MUYUPAMPA),estado nutricional en menores de 5 anos,clasificacion f,2003-02-01,4,2,4,2,6
51501,VILLAZON,estado nutricional en menores de 5 anos,clasificacion f,2003-02-01,2,4,2,4,6
50602,VITICHI,estado nutricional en menores de 5 anos,clasificacion f,2003-02-01,3,1,3,1,4
70201,WARNES,estado nutricional en menores de 5 anos,clasificacion f,2003-02-01,8,5,8,5,13
20903,YACO,estado nutricional en menores de 5 anos,clasificacion f,2003-02-01,6,3,6,3,9
60301,YACUIBA,estado nutricional en menores de 5 anos,clasificacion f,2003-02-01,5,2,5,2,7
10602,YAMPARAEZ,estado nutricional en menores de 5 anos,clasificacion f,2003-02-01,13,2,13,2,15
70403,YAPACANI,estado nutricional en menores de 5 anos,clasificacion f,2003-02-01,3,5,3,5,8
50103,YOCALLA,estado nutricional en menores de 5 anos,clasificacion f,2003-02-01,0,1,0,1,1
10102,YOTALA,estado nutricional en menores de 5 anos,clasificacion f,2003-02-01,6,1,6,1,7
60402,YUNCHARA,estado nutricional en menores de 5 anos,clasificacion f,2003-02-01,1,6,1,6,7
10301,ZUDAÑEZ,estado nutricional en menores de 5 anos,clasificacion f,2003-02-01,1,1,1,1,2
51302,ACACIO,estado nutricional en menores de 5 anos,clasificacion f,2003-03-01,7,8,7,8,15
20201,ACHACACHI,estado nutricional en menores de 5 anos,clasificacion f,2003-03-01,3,1,3,1,4
20104,ACHOCALLA,estado nutricional en menores de 5 anos,clasificacion f,2003-03-01,1,1,1,1,2
30201,AIQUILE,estado nutricional en menores de 5 anos,clasificacion f,2003-03-01,3,1,3,1,4
10404,ALCALA,estado nutricional en menores de 5 anos,clasificacion f,2003-03-01,4,3,4,3,7
20202,ANCORAIMES,estado nutricional en menores de 5 anos,clasificacion f,2003-03-01,4,0,4,0,4
30402,ANZALDO,estado nutricional en menores de 5 anos,clasificacion f,2003-03-01,0,4,0,4,4
20701,APOLO,estado nutricional en menores de 5 anos,clasificacion f,2003-03-01,3,0,3,0,3
51301,ARAMPAMPA,estado nutricional en menores de 5 anos,clasificacion f,2003-03-01,2,0,2,0,2
30501,ARANI,estado nutricional en menores de 5 anos,clasificacion f,2003-03-01,1,1,1,1,2
30403,ARBIETO,estado nutricional en menores de 5 anos,clasificacion f,2003-03-01,0,1,0,1,1
30601,ARQUE,estado nutricional en menores de 5 anos,clasificacion f,2003-03-01,11,2,11,2,13
71501,ASCENCION DE GUARAYOS,estado nutricional en menores de 5 anos,clasificacion f,2003-03-01,0,1,0,1,1
50802,ATOCHA,estado nutricional en menores de 5 anos,clasificacion f,2003-03-01,1,5,1,5,6
20503,AUCAPATA,estado nutricional en menores de 5 anos,clasificacion f,2003-03-01,2,0,2,0,2
20502,AYATA,estado nutricional en menores de 5 anos,clasificacion f,2003-03-01,10,4,10,4,14
21303,AYO AYO,estado nutricional en menores de 5 anos,clasificacion f,2003-03-01,0,1,0,1,1
30301,AYOPAYA (V. DE INDEPENDENCIA),estado nutricional en menores de 5 anos,clasificacion f,2003-03-01,10,9,10,9,19
10201,AZURDUY,estado nutricional en menores de 5 anos,clasificacion f,2003-03-01,10,3,10,3,13
80802,BAURES,estado nutricional en menores de 5 anos,clasificacion f,2003-03-01,1,0,1,0,1
50301,BETANZOS,estado nutricional en menores de 5 anos,clasificacion f,2003-03-01,25,10,25,10,35
31501,BOLIVAR,estado nutricional en menores de 5 anos,clasificacion f,2003-03-01,6,2,6,2,8
70707,BOYUIBE,estado nutricional en menores de 5 anos,clasificacion f,2003-03-01,1,0,1,0,1
70401,BUENA VISTA,estado nutricional en menores de 5 anos,clasificacion f,2003-03-01,0,1,0,1,1
20905,CAIROMA,estado nutricional en menores de 5 anos,clasificacion f,2003-03-01,3,2,3,2,5
51102,"CAIZA ""D""",estado nutricional en menores de 5 anos,clasificacion f,2003-03-01,12,3,12,3,15
21003,CAJUATA,estado nutricional en menores de 5 anos,clasificacion f,2003-03-01,2,1,2,1,3
21304,CALAMARCA,estado nutricional en menores de 5 anos,clasificacion f,2003-03-01,2,1,2,1,3
10701,CAMARGO,estado nutricional en menores de 5 anos,clasificacion f,2003-03-01,2,2,2,2,4
70706,CAMIRI,estado nutricional en menores de 5 anos,clasificacion f,2003-03-01,1,5,1,5,6
30701,CAPINOTA,estado nutricional en menores de 5 anos,clasificacion f,2003-03-01,5,8,5,8,13
20302,CAQUIAVIRI,estado nutricional en menores de 5 anos,clasificacion f,2003-03-01,1,2,1,2,3
40102,CARACOLLO,estado nutricional en menores de 5 anos,clasificacion f,2003-03-01,1,0,1,0,1
22001,CARANAVI,estado nutricional en menores de 5 anos,clasificacion f,2003-03-01,6,4,6,4,10
60302,CARAPARI,estado nutricional en menores de 5 anos,clasificacion f,2003-03-01,3,7,3,7,10
50702,CARIPUYO,estado nutricional en menores de 5 anos,clasificacion f,2003-03-01,2,11,2,11,13
40201,CHALLAPATA,estado nutricional en menores de 5 anos,clasificacion f,2003-03-01,6,3,6,3,9
50302,CHAQUI,estado nutricional en menores de 5 anos,clasificacion f,2003-03-01,5,4,5,4,9
70702,CHARAGUA,estado nutricional en menores de 5 anos,clasificacion f,2003-03-01,27,7,27,7,34
50202,CHAYANTA,estado nutricional en menores de 5 anos,clasificacion f,2003-03-01,3,1,3,1,4
31204,CHIMORE,estado nutricional en menores de 5 anos,clasificacion f,2003-03-01,0,2,0,2,2
20501,CHUMA,estado nutricional en menores de 5 anos,clasificacion f,2003-03-01,1,1,1,1,2
30801,CLIZA,estado nutricional en menores de 5 anos,clasificacion f,2003-03-01,1,0,1,0,1
90101,COBIJA,estado nutricional en menores de 5 anos,clasificacion f,2003-03-01,2,2,2,2,4
30101,COCHABAMBA,estado nutricional en menores de 5 anos,clasificacion f,2003-03-01,19,7,19,7,26
30905,COLCAPIRHUA,estado nutricional en menores de 5 anos,clasificacion f,2003-03-01,2,0,2,0,2
50901,"COLCHA ""K""",estado nutricional en menores de 5 anos,clasificacion f,2003-03-01,2,0,2,0,2
31002,COLOMI,estado nutricional en menores de 5 anos,clasificacion f,2003-03-01,0,2,0,2,2
50401,COLQUECHACA,estado nutricional en menores de 5 anos,clasificacion f,2003-03-01,8,2,8,2,10
21306,COLQUENCHA,estado nutricional en menores de 5 anos,clasificacion f,2003-03-01,2,0,2,0,2
21004,COLQUIRI,estado nutricional en menores de 5 anos,clasificacion f,2003-03-01,5,2,5,2,7
71301,COMARAPA,estado nutricional en menores de 5 anos,clasificacion f,2003-03-01,7,2,7,2,9
21402,CORIPATA,estado nutricional en menores de 5 anos,clasificacion f,2003-03-01,0,1,0,1,1
40301,CORQUE,estado nutricional en menores de 5 anos,clasificacion f,2003-03-01,1,3,1,3,4
50601,COTAGAITA,estado nutricional en menores de 5 anos,clasificacion f,2003-03-01,2,2,2,2,4
70102,COTOCA,estado nutricional en menores de 5 anos,clasificacion f,2003-03-01,2,1,2,1,3
70704,CUEVO,estado nutricional en menores de 5 anos,clasificacion f,2003-03-01,3,0,3,0,3
10902,CULPINA,estado nutricional en menores de 5 anos,clasificacion f,2003-03-01,6,3,6,3,9
20105,EL ALTO,estado nutricional en menores de 5 anos,clasificacion f,2003-03-01,42,25,42,25,67
40103,EL CHORO,estado nutricional en menores de 5 anos,clasificacion f,2003-03-01,0,1,0,1,1
71503,EL PUENTE(STC),estado nutricional en menores de 5 anos,clasificacion f,2003-03-01,0,8,0,8,8
60502,EL PUENTE(TJA),estado nutricional en menores de 5 anos,clasificacion f,2003-03-01,0,1,0,1,1
70105,EL TORNO,estado nutricional en menores de 5 anos,clasificacion f,2003-03-01,8,0,8,0,8
10405,EL VILLAR,estado nutricional en menores de 5 anos,clasificacion f,2003-03-01,3,2,3,2,5
60601,ENTRE RIOS,estado nutricional en menores de 5 anos,clasificacion f,2003-03-01,1,1,1,1,2
80402,EXALTACION,estado nutricional en menores de 5 anos,clasificacion f,2003-03-01,0,2,0,2,2
71002,GENERAL SAAVEDRA,estado nutricional en menores de 5 anos,clasificacion f,2003-03-01,4,1,4,1,5
21601,GRAL. J.J. PEREZ (CHARAZANI),estado nutricional en menores de 5 anos,clasificacion f,2003-03-01,2,2,2,2,4
20602,GUANAY,estado nutricional en menores de 5 anos,clasificacion f,2003-03-01,0,3,0,3,3
20802,GUAQUI,estado nutricional en menores de 5 anos,clasificacion f,2003-03-01,0,1,0,1,1
80202,GUAYARAMERIN,estado nutricional en menores de 5 anos,clasificacion f,2003-03-01,7,4,7,4,11
70705,GUTIERREZ,estado nutricional en menores de 5 anos,clasificacion f,2003-03-01,14,17,14,17,31
10502,HUACARETA,estado nutricional en menores de 5 anos,clasificacion f,2003-03-01,3,0,3,0,3
11002,HUACAYA (VILLA DE HUACAYA),estado nutricional en menores de 5 anos,clasificacion f,2003-03-01,1,1,1,1,2
40701,HUANUNI,estado nutricional en menores de 5 anos,clasificacion f,2003-03-01,9,4,9,4,13
21005,ICHOCA,estado nutricional en menores de 5 anos,clasificacion f,2003-03-01,1,1,1,1,2
10304,ICLA,estado nutricional en menores de 5 anos,clasificacion f,2003-03-01,2,5,2,5,7
10703,INCAHUASI,estado nutricional en menores de 5 anos,clasificacion f,2003-03-01,4,6,4,6,10
21001,INQUISIVI,estado nutricional en menores de 5 anos,clasificacion f,2003-03-01,4,3,4,3,7
21501,IXIAMAS,estado nutricional en menores de 5 anos,clasificacion f,2003-03-01,3,2,3,2,5
21105,LA ASUNTA,estado nutricional en menores de 5 anos,clasificacion f,2003-03-01,8,1,8,1,9
70104,LA GUARDIA,estado nutricional en menores de 5 anos,clasificacion f,2003-03-01,2,1,2,1,3
20101,LA PAZ,estado nutricional en menores de 5 anos,clasificacion f,2003-03-01,26,11,26,11,37
70701,LAGUNILLAS,estado nutricional en menores de 5 anos,clasificacion f,2003-03-01,6,1,6,1,7
10903,LAS CARRERAS,estado nutricional en menores de 5 anos,clasificacion f,2003-03-01,1,1,1,1,2
50203,LLALLAGUA,estado nutricional en menores de 5 anos,clasificacion f,2003-03-01,1,20,1,20,21
51401,LLICA,estado nutricional en menores de 5 anos,clasificacion f,2003-03-01,0,1,0,1,1
40702,MACHACAMARCA,estado nutricional en menores de 5 anos,clasificacion f,2003-03-01,2,1,2,1,3
11003,MACHARETI,estado nutricional en menores de 5 anos,clasificacion f,2003-03-01,4,2,4,2,6
80801,MAGDALENA,estado nutricional en menores de 5 anos,clasificacion f,2003-03-01,2,1,2,1,3
70903,MAIRANA,estado nutricional en menores de 5 anos,clasificacion f,2003-03-01,3,2,3,2,5
20904,MALLA,estado nutricional en menores de 5 anos,clasificacion f,2003-03-01,4,0,4,0,4
20103,MECAPACA,estado nutricional en menores de 5 anos,clasificacion f,2003-03-01,1,0,1,0,1
71003,MINEROS,estado nutricional en menores de 5 anos,clasificacion f,2003-03-01,13,6,13,6,19
31301,MIZQUE,estado nutricional en menores de 5 anos,clasificacion f,2003-03-01,5,4,5,4,9
20402,MOCOMOCO,estado nutricional en menores de 5 anos,clasificacion f,2003-03-01,2,1,2,1,3
10501,MONTEAGUDO,estado nutricional en menores de 5 anos,clasificacion f,2003-03-01,9,4,9,4,13
71001,MONTERO,estado nutricional en menores de 5 anos,clasificacion f,2003-03-01,14,10,14,10,24
70803,MORO MORO,estado nutricional en menores de 5 anos,clasificacion f,2003-03-01,0,1,0,1,1
30302,MOROCHATA,estado nutricional en menores de 5 anos,clasificacion f,2003-03-01,12,5,12,5,17
90401,NACEBE (SANTA ROSA DEL ABUNA),estado nutricional en menores de 5 anos,clasificacion f,2003-03-01,1,0,1,0,1
50404,OCURI,estado nutricional en menores de 5 anos,clasificacion f,2003-03-01,8,8,8,8,16
70202,OKINAWA,estado nutricional en menores de 5 anos,clasificacion f,2003-03-01,1,2,1,2,3
40101,ORURO,estado nutricional en menores de 5 anos,clasificacion f,2003-03-01,12,4,12,4,16
60201,PADCAYA,estado nutricional en menores de 5 anos,clasificacion f,2003-03-01,1,1,1,1,2
10401,PADILLA,estado nutricional en menores de 5 anos,clasificacion f,2003-03-01,4,5,4,5,9
70502,PAILON,estado nutricional en menores de 5 anos,clasificacion f,2003-03-01,5,2,5,2,7
20102,PALCA,estado nutricional en menores de 5 anos,clasificacion f,2003-03-01,0,3,0,3,3
21104,PALOS BLANCOS,estado nutricional en menores de 5 anos,clasificacion f,2003-03-01,3,2,3,2,5
30202,PASORAPA,estado nutricional en menores de 5 anos,clasificacion f,2003-03-01,1,0,1,0,1
21305,PATACAMAYA,estado nutricional en menores de 5 anos,clasificacion f,2003-03-01,5,1,5,1,6
40602,PAZÑA,estado nutricional en menores de 5 anos,clasificacion f,2003-03-01,3,0,3,0,3
50403,POCOATA,estado nutricional en menores de 5 anos,clasificacion f,2003-03-01,2,3,2,3,5
31203,POCONA,estado nutricional en menores de 5 anos,clasificacion f,2003-03-01,4,1,4,1,5
31202,POJO (CBBA),estado nutricional en menores de 5 anos,clasificacion f,2003-03-01,4,2,4,2,6
51203,PORCO,estado nutricional en menores de 5 anos,clasificacion f,2003-03-01,1,1,1,1,2
10103,POROMA,estado nutricional en menores de 5 anos,clasificacion f,2003-03-01,17,11,17,11,28
70601,PORTACHUELO,estado nutricional en menores de 5 anos,clasificacion f,2003-03-01,3,1,3,1,4
70804,POSTRER VALLE,estado nutricional en menores de 5 anos,clasificacion f,2003-03-01,1,0,1,0,1
50101,POTOSI,estado nutricional en menores de 5 anos,clasificacion f,2003-03-01,21,8,21,8,29
10302,PRESTO,estado nutricional en menores de 5 anos,clasificacion f,2003-03-01,4,1,4,1,5
21201,PUCARANI,estado nutricional en menores de 5 anos,clasificacion f,2003-03-01,1,0,1,0,1
20403,PUERTO CARABUCO,estado nutricional en menores de 5 anos,clasificacion f,2003-03-01,5,0,5,0,5
90301,PUERTO GONZALO MORENO,estado nutricional en menores de 5 anos,clasificacion f,2003-03-01,4,0,4,0,4
90201,PUERTO RICO,estado nutricional en menores de 5 anos,clasificacion f,2003-03-01,0,3,0,3,3
71401,PUERTO SUAREZ,estado nutricional en menores de 5 anos,clasificacion f,2003-03-01,8,2,8,2,10
31205,PUERTO VILLARROEL,estado nutricional en menores de 5 anos,clasificacion f,2003-03-01,19,11,19,11,30
51101,PUNA,estado nutricional en menores de 5 anos,clasificacion f,2003-03-01,23,4,23,4,27
31401,PUNATA,estado nutricional en menores de 5 anos,clasificacion f,2003-03-01,5,2,5,2,7
30901,QUILLACOLLO,estado nutricional en menores de 5 anos,clasificacion f,2003-03-01,7,5,7,5,12
21002,QUIME,estado nutricional en menores de 5 anos,clasificacion f,2003-03-01,4,2,4,2,6
50402,RAVELO,estado nutricional en menores de 5 anos,clasificacion f,2003-03-01,18,9,18,9,27
80201,RIBERALTA,estado nutricional en menores de 5 anos,clasificacion f,2003-03-01,12,13,12,13,25
70503,ROBORE,estado nutricional en menores de 5 anos,clasificacion f,2003-03-01,5,2,5,2,7
31001,SACABA,estado nutricional en menores de 5 anos,clasificacion f,2003-03-01,10,3,10,3,13
30404,SACABAMBA,estado nutricional en menores de 5 anos,clasificacion f,2003-03-01,2,0,2,0,2
50701,SACACA,estado nutricional en menores de 5 anos,clasificacion f,2003-03-01,15,13,15,13,28
71302,SAIPINA,estado nutricional en menores de 5 anos,clasificacion f,2003-03-01,1,1,1,1,2
70901,SAMAIPATA,estado nutricional en menores de 5 anos,clasificacion f,2003-03-01,2,0,2,0,2
80602,SAN ANDRES,estado nutricional en menores de 5 anos,clasificacion f,2003-03-01,2,0,2,0,2
71105,SAN ANTONIO DE LOMERIO,estado nutricional en menores de 5 anos,clasificacion f,2003-03-01,8,9,8,9,17
31403,SAN BENITO,estado nutricional en menores de 5 anos,clasificacion f,2003-03-01,3,1,3,1,4
80302,SAN BORJA,estado nutricional en menores de 5 anos,clasificacion f,2003-03-01,16,2,16,2,18
70402,SAN CARLOS,estado nutricional en menores de 5 anos,clasificacion f,2003-03-01,1,0,1,0,1
80501,SAN IGNACIO,estado nutricional en menores de 5 anos,clasificacion f,2003-03-01,9,3,9,3,12
70301,SAN IGNACIO DE VELASCO,estado nutricional en menores de 5 anos,clasificacion f,2003-03-01,13,2,13,2,15
71102,SAN JAVIER(STC),estado nutricional en menores de 5 anos,clasificacion f,2003-03-01,4,0,4,0,4
70501,SAN JOSE DE CHIQUITOS,estado nutricional en menores de 5 anos,clasificacion f,2003-03-01,3,0,3,0,3
71104,SAN JULIAN,estado nutricional en menores de 5 anos,clasificacion f,2003-03-01,24,19,24,19,43
90302,SAN LORENZO(PND),estado nutricional en menores de 5 anos,clasificacion f,2003-03-01,7,1,7,1,8
60501,SAN LORENZO(TJA),estado nutricional en menores de 5 anos,clasificacion f,2003-03-01,1,0,1,0,1
10702,SAN LUCAS,estado nutricional en menores de 5 anos,clasificacion f,2003-03-01,21,13,21,13,34
70302,SAN MIGUEL DE VELASCO,estado nutricional en menores de 5 anos,clasificacion f,2003-03-01,4,1,4,1,5
51001,SAN PABLO DE LIPEZ,estado nutricional en menores de 5 anos,clasificacion f,2003-03-01,0,2,0,2,2
50501,SAN PEDRO DE BUENA VISTA,estado nutricional en menores de 5 anos,clasificacion f,2003-03-01,8,13,8,13,21
21801,SAN PEDRO DE CURAHUARA,estado nutricional en menores de 5 anos,clasificacion f,2003-03-01,1,1,1,1,2
70303,SAN RAFAEL,estado nutricional en menores de 5 anos,clasificacion f,2003-03-01,1,1,1,1,2
80702,SAN RAMON,estado nutricional en menores de 5 anos,clasificacion f,2003-03-01,0,1,0,1,1
70101,SANTA CRUZ DE LA SIERRA,estado nutricional en menores de 5 anos,clasificacion f,2003-03-01,22,7,22,7,29
80303,SANTA ROSA,estado nutricional en menores de 5 anos,clasificacion f,2003-03-01,1,1,1,1,2
70602,SANTA ROSA DEL SARA,estado nutricional en menores de 5 anos,clasificacion f,2003-03-01,0,1,0,1,1
20308,SANTIAGO DE CALLAPA,estado nutricional en menores de 5 anos,clasificacion f,2003-03-01,2,0,2,0,2
30702,SANTIVAÑES,estado nutricional en menores de 5 anos,clasificacion f,2003-03-01,6,1,6,1,7
20902,SAPAHAQUI,estado nutricional en menores de 5 anos,clasificacion f,2003-03-01,2,2,2,2,4
90303,SENA,estado nutricional en menores de 5 anos,clasificacion f,2003-03-01,0,4,0,4,4
21301,SICA SICA (VILLA AROMA),estado nutricional en menores de 5 anos,clasificacion f,2003-03-01,5,6,5,6,11
30902,SIPE SIPE,estado nutricional en menores de 5 anos,clasificacion f,2003-03-01,8,2,8,2,10
10403,SOPACHUY,estado nutricional en menores de 5 anos,clasificacion f,2003-03-01,5,2,5,2,7
20601,SORATA,estado nutricional en menores de 5 anos,clasificacion f,2003-03-01,2,2,2,2,4
10101,SUCRE,estado nutricional en menores de 5 anos,clasificacion f,2003-03-01,22,9,22,9,31
50303,TACOBAMBA,estado nutricional en menores de 5 anos,clasificacion f,2003-03-01,7,2,7,2,9
30602,TACOPAYA,estado nutricional en menores de 5 anos,clasificacion f,2003-03-01,5,1,5,1,6
31101,TAPACARI,estado nutricional en menores de 5 anos,clasificacion f,2003-03-01,3,2,3,2,5
10601,TARABUCO,estado nutricional en menores de 5 anos,clasificacion f,2003-03-01,35,16,35,16,51
30401,TARATA,estado nutricional en menores de 5 anos,clasificacion f,2003-03-01,2,1,2,1,3
60101,TARIJA,estado nutricional en menores de 5 anos,clasificacion f,2003-03-01,7,3,7,3,10
10202,TARVITA,estado nutricional en menores de 5 anos,clasificacion f,2003-03-01,4,3,4,3,7
20803,TIAWANACU,estado nutricional en menores de 5 anos,clasificacion f,2003-03-01,1,0,1,0,1
50102,TINGUIPAYA,estado nutricional en menores de 5 anos,clasificacion f,2003-03-01,7,0,7,0,7
31601,TIRAQUE (CBBA),estado nutricional en menores de 5 anos,clasificacion f,2003-03-01,9,12,9,12,21
51202,TOMAVE,estado nutricional en menores de 5 anos,clasificacion f,2003-03-01,7,6,7,6,13
10402,TOMINA,estado nutricional en menores de 5 anos,clasificacion f,2003-03-01,10,7,10,7,17
50502,TORO TORO,estado nutricional en menores de 5 anos,clasificacion f,2003-03-01,7,3,7,3,10
31201,TOTORA(CBBA),estado nutricional en menores de 5 anos,clasificacion f,2003-03-01,1,0,1,0,1
41301,TOTORA(ORR),estado nutricional en menores de 5 anos,clasificacion f,2003-03-01,1,2,1,2,3
80101,TRINIDAD,estado nutricional en menores de 5 anos,clasificacion f,2003-03-01,8,20,8,20,28
50801,TUPIZA,estado nutricional en menores de 5 anos,clasificacion f,2003-03-01,6,12,6,12,18
21302,UMALA,estado nutricional en menores de 5 anos,clasificacion f,2003-03-01,1,1,1,1,2
50201,UNCIA,estado nutricional en menores de 5 anos,clasificacion f,2003-03-01,0,2,0,2,2
51201,UYUNI,estado nutricional en menores de 5 anos,clasificacion f,2003-03-01,6,3,6,3,9
30502,VACAS,estado nutricional en menores de 5 anos,clasificacion f,2003-03-01,0,1,0,1,1
70801,VALLEGRANDE,estado nutricional en menores de 5 anos,clasificacion f,2003-03-01,1,0,1,0,1
20801,VIACHA,estado nutricional en menores de 5 anos,clasificacion f,2003-03-01,4,2,4,2,6
31302,VILA VILA,estado nutricional en menores de 5 anos,clasificacion f,2003-03-01,2,1,2,1,3
60303,VILLA MONTES,estado nutricional en menores de 5 anos,clasificacion f,2003-03-01,9,4,9,4,13
31402,VILLA RIVERO,estado nutricional en menores de 5 anos,clasificacion f,2003-03-01,1,4,1,4,5
10801,VILLA SERRANO,estado nutricional en menores de 5 anos,clasificacion f,2003-03-01,5,4,5,4,9
31003,VILLA TUNARI,estado nutricional en menores de 5 anos,clasificacion f,2003-03-01,8,10,8,10,18
11001,VILLA VACA GUZMAN (MUYUPAMPA),estado nutricional en menores de 5 anos,clasificacion f,2003-03-01,2,2,2,2,4
51501,VILLAZON,estado nutricional en menores de 5 anos,clasificacion f,2003-03-01,1,1,1,1,2
50602,VITICHI,estado nutricional en menores de 5 anos,clasificacion f,2003-03-01,1,0,1,0,1
70201,WARNES,estado nutricional en menores de 5 anos,clasificacion f,2003-03-01,13,6,13,6,19
20903,YACO,estado nutricional en menores de 5 anos,clasificacion f,2003-03-01,2,0,2,0,2
60301,YACUIBA,estado nutricional en menores de 5 anos,clasificacion f,2003-03-01,7,3,7,3,10
10602,YAMPARAEZ,estado nutricional en menores de 5 anos,clasificacion f,2003-03-01,17,3,17,3,20
70403,YAPACANI,estado nutricional en menores de 5 anos,clasificacion f,2003-03-01,9,3,9,3,12
10102,YOTALA,estado nutricional en menores de 5 anos,clasificacion f,2003-03-01,5,1,5,1,6
60402,YUNCHARA,estado nutricional en menores de 5 anos,clasificacion f,2003-03-01,0,1,0,1,1
10301,ZUDAÑEZ,estado nutricional en menores de 5 anos,clasificacion f,2003-03-01,5,2,5,2,7
51302,ACACIO,estado nutricional en menores de 5 anos,clasificacion f,2003-04-01,17,2,17,2,19
20201,ACHACACHI,estado nutricional en menores de 5 anos,clasificacion f,2003-04-01,1,4,1,4,5
30201,AIQUILE,estado nutricional en menores de 5 anos,clasificacion f,2003-04-01,9,9,9,9,18
10404,ALCALA,estado nutricional en menores de 5 anos,clasificacion f,2003-04-01,1,2,1,2,3
30402,ANZALDO,estado nutricional en menores de 5 anos,clasificacion f,2003-04-01,4,3,4,3,7
51301,ARAMPAMPA,estado nutricional en menores de 5 anos,clasificacion f,2003-04-01,4,1,4,1,5
30501,ARANI,estado nutricional en menores de 5 anos,clasificacion f,2003-04-01,2,3,2,3,5
30601,ARQUE,estado nutricional en menores de 5 anos,clasificacion f,2003-04-01,7,3,7,3,10
71501,ASCENCION DE GUARAYOS,estado nutricional en menores de 5 anos,clasificacion f,2003-04-01,25,9,25,9,34
50802,ATOCHA,estado nutricional en menores de 5 anos,clasificacion f,2003-04-01,1,5,1,5,6
20502,AYATA,estado nutricional en menores de 5 anos,clasificacion f,2003-04-01,3,0,3,0,3
21303,AYO AYO,estado nutricional en menores de 5 anos,clasificacion f,2003-04-01,0,1,0,1,1
30301,AYOPAYA (V. DE INDEPENDENCIA),estado nutricional en menores de 5 anos,clasificacion f,2003-04-01,7,6,7,6,13
10201,AZURDUY,estado nutricional en menores de 5 anos,clasificacion f,2003-04-01,19,2,19,2,21
80802,BAURES,estado nutricional en menores de 5 anos,clasificacion f,2003-04-01,0,1,0,1,1
50301,BETANZOS,estado nutricional en menores de 5 anos,clasificacion f,2003-04-01,31,13,31,13,44
31501,BOLIVAR,estado nutricional en menores de 5 anos,clasificacion f,2003-04-01,3,5,3,5,8
90103,BOLPEBRA,estado nutricional en menores de 5 anos,clasificacion f,2003-04-01,1,0,1,0,1
70707,BOYUIBE,estado nutricional en menores de 5 anos,clasificacion f,2003-04-01,1,1,1,1,2
70401,BUENA VISTA,estado nutricional en menores de 5 anos,clasificacion f,2003-04-01,2,0,2,0,2
70703,CABEZAS,estado nutricional en menores de 5 anos,clasificacion f,2003-04-01,4,1,4,1,5
20905,CAIROMA,estado nutricional en menores de 5 anos,clasificacion f,2003-04-01,3,4,3,4,7
51102,"CAIZA ""D""",estado nutricional en menores de 5 anos,clasificacion f,2003-04-01,8,1,8,1,9
21003,CAJUATA,estado nutricional en menores de 5 anos,clasificacion f,2003-04-01,2,2,2,2,4
21304,CALAMARCA,estado nutricional en menores de 5 anos,clasificacion f,2003-04-01,3,1,3,1,4
10701,CAMARGO,estado nutricional en menores de 5 anos,clasificacion f,2003-04-01,2,2,2,2,4
10901,CAMATAQUI (C. VILLA ABECIA),estado nutricional en menores de 5 anos,clasificacion f,2003-04-01,1,0,1,0,1
70706,CAMIRI,estado nutricional en menores de 5 anos,clasificacion f,2003-04-01,1,1,1,1,2
30701,CAPINOTA,estado nutricional en menores de 5 anos,clasificacion f,2003-04-01,7,3,7,3,10
20302,CAQUIAVIRI,estado nutricional en menores de 5 anos,clasificacion f,2003-04-01,2,1,2,1,3
40102,CARACOLLO,estado nutricional en menores de 5 anos,clasificacion f,2003-04-01,1,1,1,1,2
22001,CARANAVI,estado nutricional en menores de 5 anos,clasificacion f,2003-04-01,6,3,6,3,9
60302,CARAPARI,estado nutricional en menores de 5 anos,clasificacion f,2003-04-01,3,1,3,1,4
50702,CARIPUYO,estado nutricional en menores de 5 anos,clasificacion f,2003-04-01,3,5,3,5,8
40201,CHALLAPATA,estado nutricional en menores de 5 anos,clasificacion f,2003-04-01,8,10,8,10,18
50302,CHAQUI,estado nutricional en menores de 5 anos,clasificacion f,2003-04-01,9,2,9,2,11
70702,CHARAGUA,estado nutricional en menores de 5 anos,clasificacion f,2003-04-01,12,9,12,9,21
20305,CHARAÑA,estado nutricional en menores de 5 anos,clasificacion f,2003-04-01,1,1,1,1,2
50202,CHAYANTA,estado nutricional en menores de 5 anos,clasificacion f,2003-04-01,1,1,1,1,2
40903,CHIPAYA,estado nutricional en menores de 5 anos,clasificacion f,2003-04-01,0,1,0,1,1
20501,CHUMA,estado nutricional en menores de 5 anos,clasificacion f,2003-04-01,3,2,3,2,5
30801,CLIZA,estado nutricional en menores de 5 anos,clasificacion f,2003-04-01,3,0,3,0,3
30101,COCHABAMBA,estado nutricional en menores de 5 anos,clasificacion f,2003-04-01,17,7,17,7,24
50901,"COLCHA ""K""",estado nutricional en menores de 5 anos,clasificacion f,2003-04-01,2,0,2,0,2
31002,COLOMI,estado nutricional en menores de 5 anos,clasificacion f,2003-04-01,3,8,3,8,11
50401,COLQUECHACA,estado nutricional en menores de 5 anos,clasificacion f,2003-04-01,7,3,7,3,10
21306,COLQUENCHA,estado nutricional en menores de 5 anos,clasificacion f,2003-04-01,0,2,0,2,2
21004,COLQUIRI,estado nutricional en menores de 5 anos,clasificacion f,2003-04-01,5,6,5,6,11
71301,COMARAPA,estado nutricional en menores de 5 anos,clasificacion f,2003-04-01,4,5,4,5,9
20605,COMBAYA,estado nutricional en menores de 5 anos,clasificacion f,2003-04-01,1,1,1,1,2
20301,CORO CORO,estado nutricional en menores de 5 anos,clasificacion f,2003-04-01,2,0,2,0,2
21401,COROICO,estado nutricional en menores de 5 anos,clasificacion f,2003-04-01,1,0,1,0,1
40301,CORQUE,estado nutricional en menores de 5 anos,clasificacion f,2003-04-01,1,1,1,1,2
50601,COTAGAITA,estado nutricional en menores de 5 anos,clasificacion f,2003-04-01,5,1,5,1,6
70102,COTOCA,estado nutricional en menores de 5 anos,clasificacion f,2003-04-01,0,2,0,2,2
70704,CUEVO,estado nutricional en menores de 5 anos,clasificacion f,2003-04-01,4,0,4,0,4
10902,CULPINA,estado nutricional en menores de 5 anos,clasificacion f,2003-04-01,10,4,10,4,14
21602,CURVA,estado nutricional en menores de 5 anos,clasificacion f,2003-04-01,1,0,1,0,1
20804,DESAGUADERO,estado nutricional en menores de 5 anos,clasificacion f,2003-04-01,1,0,1,0,1
20105,EL ALTO,estado nutricional en menores de 5 anos,clasificacion f,2003-04-01,94,43,94,43,137
40103,EL CHORO,estado nutricional en menores de 5 anos,clasificacion f,2003-04-01,0,1,0,1,1
71503,EL PUENTE(STC),estado nutricional en menores de 5 anos,clasificacion f,2003-04-01,0,6,0,6,6
60502,EL PUENTE(TJA),estado nutricional en menores de 5 anos,clasificacion f,2003-04-01,1,0,1,0,1
70105,EL TORNO,estado nutricional en menores de 5 anos,clasificacion f,2003-04-01,3,1,3,1,4
10405,EL VILLAR,estado nutricional en menores de 5 anos,clasificacion f,2003-04-01,3,2,3,2,5
60601,ENTRE RIOS,estado nutricional en menores de 5 anos,clasificacion f,2003-04-01,1,2,1,2,3
80402,EXALTACION,estado nutricional en menores de 5 anos,clasificacion f,2003-04-01,3,1,3,1,4
90203,FILADELFIA,estado nutricional en menores de 5 anos,clasificacion f,2003-04-01,0,2,0,2,2
71002,GENERAL SAAVEDRA,estado nutricional en menores de 5 anos,clasificacion f,2003-04-01,5,1,5,1,6
21601,GRAL. J.J. PEREZ (CHARAZANI),estado nutricional en menores de 5 anos,clasificacion f,2003-04-01,2,3,2,3,5
20602,GUANAY,estado nutricional en menores de 5 anos,clasificacion f,2003-04-01,1,6,1,6,7
80202,GUAYARAMERIN,estado nutricional en menores de 5 anos,clasificacion f,2003-04-01,8,3,8,3,11
70705,GUTIERREZ,estado nutricional en menores de 5 anos,clasificacion f,2003-04-01,10,10,10,10,20
10502,HUACARETA,estado nutricional en menores de 5 anos,clasificacion f,2003-04-01,5,2,5,2,7
11002,HUACAYA (VILLA DE HUACAYA),estado nutricional en menores de 5 anos,clasificacion f,2003-04-01,1,0,1,0,1
40701,HUANUNI,estado nutricional en menores de 5 anos,clasificacion f,2003-04-01,5,0,5,0,5
21005,ICHOCA,estado nutricional en menores de 5 anos,clasificacion f,2003-04-01,0,2,0,2,2
10304,ICLA,estado nutricional en menores de 5 anos,clasificacion f,2003-04-01,4,2,4,2,6
10703,INCAHUASI,estado nutricional en menores de 5 anos,clasificacion f,2003-04-01,5,4,5,4,9
21001,INQUISIVI,estado nutricional en menores de 5 anos,clasificacion f,2003-04-01,5,3,5,3,8
21501,IXIAMAS,estado nutricional en menores de 5 anos,clasificacion f,2003-04-01,3,0,3,0,3
21105,LA ASUNTA,estado nutricional en menores de 5 anos,clasificacion f,2003-04-01,2,1,2,1,3
70104,LA GUARDIA,estado nutricional en menores de 5 anos,clasificacion f,2003-04-01,5,0,5,0,5
20101,LA PAZ,estado nutricional en menores de 5 anos,clasificacion f,2003-04-01,32,19,32,19,51
70701,LAGUNILLAS,estado nutricional en menores de 5 anos,clasificacion f,2003-04-01,5,1,5,1,6
10903,LAS CARRERAS,estado nutricional en menores de 5 anos,clasificacion f,2003-04-01,1,0,1,0,1
50203,LLALLAGUA,estado nutricional en menores de 5 anos,clasificacion f,2003-04-01,0,21,0,21,21
20901,LURIBAY,estado nutricional en menores de 5 anos,clasificacion f,2003-04-01,2,2,2,2,4
11003,MACHARETI,estado nutricional en menores de 5 anos,clasificacion f,2003-04-01,3,1,3,1,4
80801,MAGDALENA,estado nutricional en menores de 5 anos,clasificacion f,2003-04-01,2,0,2,0,2
70903,MAIRANA,estado nutricional en menores de 5 anos,clasificacion f,2003-04-01,3,1,3,1,4
71003,MINEROS,estado nutricional en menores de 5 anos,clasificacion f,2003-04-01,16,3,16,3,19
31301,MIZQUE,estado nutricional en menores de 5 anos,clasificacion f,2003-04-01,6,6,6,6,12
20402,MOCOMOCO,estado nutricional en menores de 5 anos,clasificacion f,2003-04-01,2,0,2,0,2
10303,MOJOCOYA,estado nutricional en menores de 5 anos,clasificacion f,2003-04-01,1,0,1,0,1
10501,MONTEAGUDO,estado nutricional en menores de 5 anos,clasificacion f,2003-04-01,8,3,8,3,11
71001,MONTERO,estado nutricional en menores de 5 anos,clasificacion f,2003-04-01,17,5,17,5,22
30302,MOROCHATA,estado nutricional en menores de 5 anos,clasificacion f,2003-04-01,10,13,10,13,23
50404,OCURI,estado nutricional en menores de 5 anos,clasificacion f,2003-04-01,5,1,5,1,6
70202,OKINAWA,estado nutricional en menores de 5 anos,clasificacion f,2003-04-01,6,0,6,0,6
30203,OMEREQUE,estado nutricional en menores de 5 anos,clasificacion f,2003-04-01,0,1,0,1,1
40101,ORURO,estado nutricional en menores de 5 anos,clasificacion f,2003-04-01,18,6,18,6,24
60201,PADCAYA,estado nutricional en menores de 5 anos,clasificacion f,2003-04-01,0,1,0,1,1
10401,PADILLA,estado nutricional en menores de 5 anos,clasificacion f,2003-04-01,5,4,5,4,9
70502,PAILON,estado nutricional en menores de 5 anos,clasificacion f,2003-04-01,4,2,4,2,6
20102,PALCA,estado nutricional en menores de 5 anos,clasificacion f,2003-04-01,3,3,3,3,6
21104,PALOS BLANCOS,estado nutricional en menores de 5 anos,clasificacion f,2003-04-01,6,0,6,0,6
21305,PATACAMAYA,estado nutricional en menores de 5 anos,clasificacion f,2003-04-01,7,2,7,2,9
40602,PAZÑA,estado nutricional en menores de 5 anos,clasificacion f,2003-04-01,4,1,4,1,5
20702,PELECHUCO,estado nutricional en menores de 5 anos,clasificacion f,2003-04-01,2,1,2,1,3
50403,POCOATA,estado nutricional en menores de 5 anos,clasificacion f,2003-04-01,4,6,4,6,10
31203,POCONA,estado nutricional en menores de 5 anos,clasificacion f,2003-04-01,3,1,3,1,4
31202,POJO (CBBA),estado nutricional en menores de 5 anos,clasificacion f,2003-04-01,5,1,5,1,6
51203,PORCO,estado nutricional en menores de 5 anos,clasificacion f,2003-04-01,0,1,0,1,1
10103,POROMA,estado nutricional en menores de 5 anos,clasificacion f,2003-04-01,24,12,24,12,36
70601,PORTACHUELO,estado nutricional en menores de 5 anos,clasificacion f,2003-04-01,2,1,2,1,3
90102,PORVENIR,estado nutricional en menores de 5 anos,clasificacion f,2003-04-01,0,1,0,1,1
50101,POTOSI,estado nutricional en menores de 5 anos,clasificacion f,2003-04-01,25,15,25,15,40
10302,PRESTO,estado nutricional en menores de 5 anos,clasificacion f,2003-04-01,4,2,4,2,6
20401,PUERTO ACOSTA,estado nutricional en menores de 5 anos,clasificacion f,2003-04-01,3,0,3,0,3
20403,PUERTO CARABUCO,estado nutricional en menores de 5 anos,clasificacion f,2003-04-01,0,5,0,5,5
90301,PUERTO GONZALO MORENO,estado nutricional en menores de 5 anos,clasificacion f,2003-04-01,16,7,16,7,23
80703,PUERTO SILES,estado nutricional en menores de 5 anos,clasificacion f,2003-04-01,1,0,1,0,1
71401,PUERTO SUAREZ,estado nutricional en menores de 5 anos,clasificacion f,2003-04-01,4,0,4,0,4
31205,PUERTO VILLARROEL,estado nutricional en menores de 5 anos,clasificacion f,2003-04-01,21,12,21,12,33
51101,PUNA,estado nutricional en menores de 5 anos,clasificacion f,2003-04-01,8,1,8,1,9
31401,PUNATA,estado nutricional en menores de 5 anos,clasificacion f,2003-04-01,5,1,5,1,6
20604,QUIABAYA,estado nutricional en menores de 5 anos,clasificacion f,2003-04-01,2,4,2,4,6
30901,QUILLACOLLO,estado nutricional en menores de 5 anos,clasificacion f,2003-04-01,9,2,9,2,11
21002,QUIME,estado nutricional en menores de 5 anos,clasificacion f,2003-04-01,3,2,3,2,5
50402,RAVELO,estado nutricional en menores de 5 anos,clasificacion f,2003-04-01,23,11,23,11,34
80301,REYES,estado nutricional en menores de 5 anos,clasificacion f,2003-04-01,2,0,2,0,2
80201,RIBERALTA,estado nutricional en menores de 5 anos,clasificacion f,2003-04-01,21,14,21,14,35
70503,ROBORE,estado nutricional en menores de 5 anos,clasificacion f,2003-04-01,3,1,3,1,4
31001,SACABA,estado nutricional en menores de 5 anos,clasificacion f,2003-04-01,8,2,8,2,10
30404,SACABAMBA,estado nutricional en menores de 5 anos,clasificacion f,2003-04-01,0,2,0,2,2
50701,SACACA,estado nutricional en menores de 5 anos,clasificacion f,2003-04-01,26,10,26,10,36
71302,SAIPINA,estado nutricional en menores de 5 anos,clasificacion f,2003-04-01,0,1,0,1,1
40801,SALINAS DE GARCI MENDOZA,estado nutricional en menores de 5 anos,clasificacion f,2003-04-01,0,3,0,3,3
70901,SAMAIPATA,estado nutricional en menores de 5 anos,clasificacion f,2003-04-01,0,2,0,2,2
80602,SAN ANDRES,estado nutricional en menores de 5 anos,clasificacion f,2003-04-01,1,4,1,4,5
71105,SAN ANTONIO DE LOMERIO,estado nutricional en menores de 5 anos,clasificacion f,2003-04-01,4,6,4,6,10
31403,SAN BENITO,estado nutricional en menores de 5 anos,clasificacion f,2003-04-01,1,0,1,0,1
80302,SAN BORJA,estado nutricional en menores de 5 anos,clasificacion f,2003-04-01,2,5,2,5,7
21502,SAN BUENA VENTURA,estado nutricional en menores de 5 anos,clasificacion f,2003-04-01,5,2,5,2,7
70402,SAN CARLOS,estado nutricional en menores de 5 anos,clasificacion f,2003-04-01,2,0,2,0,2
80501,SAN IGNACIO,estado nutricional en menores de 5 anos,clasificacion f,2003-04-01,8,9,8,9,17
70301,SAN IGNACIO DE VELASCO,estado nutricional en menores de 5 anos,clasificacion f,2003-04-01,17,4,17,4,21
80102,SAN JAVIER(BNI),estado nutricional en menores de 5 anos,clasificacion f,2003-04-01,1,2,1,2,3
71102,SAN JAVIER(STC),estado nutricional en menores de 5 anos,clasificacion f,2003-04-01,0,1,0,1,1
70501,SAN JOSE DE CHIQUITOS,estado nutricional en menores de 5 anos,clasificacion f,2003-04-01,3,3,3,3,6
71104,SAN JULIAN,estado nutricional en menores de 5 anos,clasificacion f,2003-04-01,7,4,7,4,11
90302,SAN LORENZO(PND),estado nutricional en menores de 5 anos,clasificacion f,2003-04-01,1,0,1,0,1
60501,SAN LORENZO(TJA),estado nutricional en menores de 5 anos,clasificacion f,2003-04-01,1,0,1,0,1
10702,SAN LUCAS,estado nutricional en menores de 5 anos,clasificacion f,2003-04-01,21,18,21,18,39
70302,SAN MIGUEL DE VELASCO,estado nutricional en menores de 5 anos,clasificacion f,2003-04-01,3,2,3,2,5
50501,SAN PEDRO DE BUENA VISTA,estado nutricional en menores de 5 anos,clasificacion f,2003-04-01,13,2,13,2,15
70303,SAN RAFAEL,estado nutricional en menores de 5 anos,clasificacion f,2003-04-01,3,0,3,0,3
70101,SANTA CRUZ DE LA SIERRA,estado nutricional en menores de 5 anos,clasificacion f,2003-04-01,38,24,38,24,62
80303,SANTA ROSA,estado nutricional en menores de 5 anos,clasificacion f,2003-04-01,2,0,2,0,2
30702,SANTIVAÑES,estado nutricional en menores de 5 anos,clasificacion f,2003-04-01,2,0,2,0,2
20902,SAPAHAQUI,estado nutricional en menores de 5 anos,clasificacion f,2003-04-01,2,3,2,3,5
21301,SICA SICA (VILLA AROMA),estado nutricional en menores de 5 anos,clasificacion f,2003-04-01,1,3,1,3,4
30703,SICAYA,estado nutricional en menores de 5 anos,clasificacion f,2003-04-01,1,0,1,0,1
30902,SIPE SIPE,estado nutricional en menores de 5 anos,clasificacion f,2003-04-01,8,5,8,5,13
10403,SOPACHUY,estado nutricional en menores de 5 anos,clasificacion f,2003-04-01,13,5,13,5,18
20601,SORATA,estado nutricional en menores de 5 anos,clasificacion f,2003-04-01,0,3,0,3,3
10101,SUCRE,estado nutricional en menores de 5 anos,clasificacion f,2003-04-01,25,13,25,13,38
20603,TACACOMA,estado nutricional en menores de 5 anos,clasificacion f,2003-04-01,2,0,2,0,2
50303,TACOBAMBA,estado nutricional en menores de 5 anos,clasificacion f,2003-04-01,6,2,6,2,8
30602,TACOPAYA,estado nutricional en menores de 5 anos,clasificacion f,2003-04-01,8,3,8,3,11
31101,TAPACARI,estado nutricional en menores de 5 anos,clasificacion f,2003-04-01,5,5,5,5,10
10601,TARABUCO,estado nutricional en menores de 5 anos,clasificacion f,2003-04-01,38,14,38,14,52
30401,TARATA,estado nutricional en menores de 5 anos,clasificacion f,2003-04-01,5,8,5,8,13
60101,TARIJA,estado nutricional en menores de 5 anos,clasificacion f,2003-04-01,12,2,12,2,14
10202,TARVITA,estado nutricional en menores de 5 anos,clasificacion f,2003-04-01,4,5,4,5,9
50102,TINGUIPAYA,estado nutricional en menores de 5 anos,clasificacion f,2003-04-01,1,0,1,0,1
20606,TIPUANI,estado nutricional en menores de 5 anos,clasificacion f,2003-04-01,1,0,1,0,1
30903,TIQUIPAYA,estado nutricional en menores de 5 anos,clasificacion f,2003-04-01,2,0,2,0,2
31601,TIRAQUE (CBBA),estado nutricional en menores de 5 anos,clasificacion f,2003-04-01,19,12,19,12,31
51202,TOMAVE,estado nutricional en menores de 5 anos,clasificacion f,2003-04-01,8,4,8,4,12
10402,TOMINA,estado nutricional en menores de 5 anos,clasificacion f,2003-04-01,9,5,9,5,14
50502,TORO TORO,estado nutricional en menores de 5 anos,clasificacion f,2003-04-01,4,5,4,5,9
31201,TOTORA(CBBA),estado nutricional en menores de 5 anos,clasificacion f,2003-04-01,5,1,5,1,6
80101,TRINIDAD,estado nutricional en menores de 5 anos,clasificacion f,2003-04-01,8,6,8,6,14
50801,TUPIZA,estado nutricional en menores de 5 anos,clasificacion f,2003-04-01,7,9,7,9,16
50201,UNCIA,estado nutricional en menores de 5 anos,clasificacion f,2003-04-01,1,0,1,0,1
60401,URIONDO (A. CONCEPCION),estado nutricional en menores de 5 anos,clasificacion f,2003-04-01,1,0,1,0,1
71502,URUBICHA,estado nutricional en menores de 5 anos,clasificacion f,2003-04-01,6,0,6,0,6
51201,UYUNI,estado nutricional en menores de 5 anos,clasificacion f,2003-04-01,5,4,5,4,9
30502,VACAS,estado nutricional en menores de 5 anos,clasificacion f,2003-04-01,0,1,0,1,1
70801,VALLEGRANDE,estado nutricional en menores de 5 anos,clasificacion f,2003-04-01,4,0,4,0,4
20801,VIACHA,estado nutricional en menores de 5 anos,clasificacion f,2003-04-01,2,1,2,1,3
31302,VILA VILA,estado nutricional en menores de 5 anos,clasificacion f,2003-04-01,3,4,3,4,7
60303,VILLA MONTES,estado nutricional en menores de 5 anos,clasificacion f,2003-04-01,8,5,8,5,13
31402,VILLA RIVERO,estado nutricional en menores de 5 anos,clasificacion f,2003-04-01,0,1,0,1,1
10801,VILLA SERRANO,estado nutricional en menores de 5 anos,clasificacion f,2003-04-01,4,3,4,3,7
31003,VILLA TUNARI,estado nutricional en menores de 5 anos,clasificacion f,2003-04-01,15,5,15,5,20
11001,VILLA VACA GUZMAN (MUYUPAMPA),estado nutricional en menores de 5 anos,clasificacion f,2003-04-01,2,1,2,1,3
51501,VILLAZON,estado nutricional en menores de 5 anos,clasificacion f,2003-04-01,3,1,3,1,4
30904,VINTO,estado nutricional en menores de 5 anos,clasificacion f,2003-04-01,6,3,6,3,9
50602,VITICHI,estado nutricional en menores de 5 anos,clasificacion f,2003-04-01,5,2,5,2,7
70201,WARNES,estado nutricional en menores de 5 anos,clasificacion f,2003-04-01,7,5,7,5,12
20903,YACO,estado nutricional en menores de 5 anos,clasificacion f,2003-04-01,2,7,2,7,9
60301,YACUIBA,estado nutricional en menores de 5 anos,clasificacion f,2003-04-01,6,5,6,5,11
10602,YAMPARAEZ,estado nutricional en menores de 5 anos,clasificacion f,2003-04-01,19,5,19,5,24
21103,YANACACHI,estado nutricional en menores de 5 anos,clasificacion f,2003-04-01,0,1,0,1,1
70403,YAPACANI,estado nutricional en menores de 5 anos,clasificacion f,2003-04-01,10,14,10,14,24
10102,YOTALA,estado nutricional en menores de 5 anos,clasificacion f,2003-04-01,6,0,6,0,6
60402,YUNCHARA,estado nutricional en menores de 5 anos,clasificacion f,2003-04-01,0,3,0,3,3
10301,ZUDAÑEZ,estado nutricional en menores de 5 anos,clasificacion f,2003-04-01,5,1,5,1,6
51302,ACACIO,estado nutricional en menores de 5 anos,clasificacion f,2003-05-01,15,8,15,8,23
20201,ACHACACHI,estado nutricional en menores de 5 anos,clasificacion f,2003-05-01,12,0,12,0,12
20104,ACHOCALLA,estado nutricional en menores de 5 anos,clasificacion f,2003-05-01,1,0,1,0,1
30201,AIQUILE,estado nutricional en menores de 5 anos,clasificacion f,2003-05-01,9,6,9,6,15
31303,ALALAY,estado nutricional en menores de 5 anos,clasificacion f,2003-05-01,2,1,2,1,3
10404,ALCALA,estado nutricional en menores de 5 anos,clasificacion f,2003-05-01,3,2,3,2,5
30402,ANZALDO,estado nutricional en menores de 5 anos,clasificacion f,2003-05-01,2,0,2,0,2
51301,ARAMPAMPA,estado nutricional en menores de 5 anos,clasificacion f,2003-05-01,2,3,2,3,5
30403,ARBIETO,estado nutricional en menores de 5 anos,clasificacion f,2003-05-01,1,2,1,2,3
30601,ARQUE,estado nutricional en menores de 5 anos,clasificacion f,2003-05-01,4,2,4,2,6
50802,ATOCHA,estado nutricional en menores de 5 anos,clasificacion f,2003-05-01,0,4,0,4,4
20503,AUCAPATA,estado nutricional en menores de 5 anos,clasificacion f,2003-05-01,1,1,1,1,2
20502,AYATA,estado nutricional en menores de 5 anos,clasificacion f,2003-05-01,1,1,1,1,2
21303,AYO AYO,estado nutricional en menores de 5 anos,clasificacion f,2003-05-01,0,2,0,2,2
30301,AYOPAYA (V. DE INDEPENDENCIA),estado nutricional en menores de 5 anos,clasificacion f,2003-05-01,4,2,4,2,6
10201,AZURDUY,estado nutricional en menores de 5 anos,clasificacion f,2003-05-01,13,9,13,9,22
21203,BATALLAS,estado nutricional en menores de 5 anos,clasificacion f,2003-05-01,1,2,1,2,3
80802,BAURES,estado nutricional en menores de 5 anos,clasificacion f,2003-05-01,0,1,0,1,1
60202,BERMEJO,estado nutricional en menores de 5 anos,clasificacion f,2003-05-01,1,0,1,0,1
50301,BETANZOS,estado nutricional en menores de 5 anos,clasificacion f,2003-05-01,24,14,24,14,38
31501,BOLIVAR,estado nutricional en menores de 5 anos,clasificacion f,2003-05-01,9,5,9,5,14
90103,BOLPEBRA,estado nutricional en menores de 5 anos,clasificacion f,2003-05-01,0,3,0,3,3
70401,BUENA VISTA,estado nutricional en menores de 5 anos,clasificacion f,2003-05-01,1,3,1,3,4
70703,CABEZAS,estado nutricional en menores de 5 anos,clasificacion f,2003-05-01,1,0,1,0,1
20905,CAIROMA,estado nutricional en menores de 5 anos,clasificacion f,2003-05-01,3,0,3,0,3
51102,"CAIZA ""D""",estado nutricional en menores de 5 anos,clasificacion f,2003-05-01,7,3,7,3,10
21003,CAJUATA,estado nutricional en menores de 5 anos,clasificacion f,2003-05-01,1,5,1,5,6
20303,CALACOTO,estado nutricional en menores de 5 anos,clasificacion f,2003-05-01,1,1,1,1,2
21304,CALAMARCA,estado nutricional en menores de 5 anos,clasificacion f,2003-05-01,1,2,1,2,3
10701,CAMARGO,estado nutricional en menores de 5 anos,clasificacion f,2003-05-01,2,4,2,4,6
10901,CAMATAQUI (C. VILLA ABECIA),estado nutricional en menores de 5 anos,clasificacion f,2003-05-01,1,0,1,0,1
70706,CAMIRI,estado nutricional en menores de 5 anos,clasificacion f,2003-05-01,3,1,3,1,4
30701,CAPINOTA,estado nutricional en menores de 5 anos,clasificacion f,2003-05-01,4,2,4,2,6
20302,CAQUIAVIRI,estado nutricional en menores de 5 anos,clasificacion f,2003-05-01,1,1,1,1,2
40102,CARACOLLO,estado nutricional en menores de 5 anos,clasificacion f,2003-05-01,2,0,2,0,2
22001,CARANAVI,estado nutricional en menores de 5 anos,clasificacion f,2003-05-01,13,4,13,4,17
60302,CARAPARI,estado nutricional en menores de 5 anos,clasificacion f,2003-05-01,1,1,1,1,2
50702,CARIPUYO,estado nutricional en menores de 5 anos,clasificacion f,2003-05-01,5,4,5,4,9
21902,CATACORA,estado nutricional en menores de 5 anos,clasificacion f,2003-05-01,1,0,1,0,1
40201,CHALLAPATA,estado nutricional en menores de 5 anos,clasificacion f,2003-05-01,10,2,10,2,12
50302,CHAQUI,estado nutricional en menores de 5 anos,clasificacion f,2003-05-01,8,1,8,1,9
70702,CHARAGUA,estado nutricional en menores de 5 anos,clasificacion f,2003-05-01,3,4,3,4,7
50202,CHAYANTA,estado nutricional en menores de 5 anos,clasificacion f,2003-05-01,1,0,1,0,1
31204,CHIMORE,estado nutricional en menores de 5 anos,clasificacion f,2003-05-01,0,3,0,3,3
20501,CHUMA,estado nutricional en menores de 5 anos,clasificacion f,2003-05-01,5,3,5,3,8
30801,CLIZA,estado nutricional en menores de 5 anos,clasificacion f,2003-05-01,1,0,1,0,1
90101,COBIJA,estado nutricional en menores de 5 anos,clasificacion f,2003-05-01,2,1,2,1,3
30101,COCHABAMBA,estado nutricional en menores de 5 anos,clasificacion f,2003-05-01,12,6,12,6,18
50901,"COLCHA ""K""",estado nutricional en menores de 5 anos,clasificacion f,2003-05-01,0,3,0,3,3
31002,COLOMI,estado nutricional en menores de 5 anos,clasificacion f,2003-05-01,8,2,8,2,10
50401,COLQUECHACA,estado nutricional en menores de 5 anos,clasificacion f,2003-05-01,7,4,7,4,11
21306,COLQUENCHA,estado nutricional en menores de 5 anos,clasificacion f,2003-05-01,1,1,1,1,2
21004,COLQUIRI,estado nutricional en menores de 5 anos,clasificacion f,2003-05-01,4,4,4,4,8
71301,COMARAPA,estado nutricional en menores de 5 anos,clasificacion f,2003-05-01,3,4,3,4,7
20605,COMBAYA,estado nutricional en menores de 5 anos,clasificacion f,2003-05-01,0,1,0,1,1
71101,CONCEPCION,estado nutricional en menores de 5 anos,clasificacion f,2003-05-01,3,1,3,1,4
20301,CORO CORO,estado nutricional en menores de 5 anos,clasificacion f,2003-05-01,2,1,2,1,3
21401,COROICO,estado nutricional en menores de 5 anos,clasificacion f,2003-05-01,2,1,2,1,3
40301,CORQUE,estado nutricional en menores de 5 anos,clasificacion f,2003-05-01,2,1,2,1,3
50601,COTAGAITA,estado nutricional en menores de 5 anos,clasificacion f,2003-05-01,6,1,6,1,7
10902,CULPINA,estado nutricional en menores de 5 anos,clasificacion f,2003-05-01,7,4,7,4,11
40401,CURAHUARA DE CARANGAS,estado nutricional en menores de 5 anos,clasificacion f,2003-05-01,1,0,1,0,1
21602,CURVA,estado nutricional en menores de 5 anos,clasificacion f,2003-05-01,1,0,1,0,1
20105,EL ALTO,estado nutricional en menores de 5 anos,clasificacion f,2003-05-01,85,44,85,44,129
71503,EL PUENTE(STC),estado nutricional en menores de 5 anos,clasificacion f,2003-05-01,0,7,0,7,7
60502,EL PUENTE(TJA),estado nutricional en menores de 5 anos,clasificacion f,2003-05-01,1,1,1,1,2
10405,EL VILLAR,estado nutricional en menores de 5 anos,clasificacion f,2003-05-01,4,5,4,5,9
60601,ENTRE RIOS,estado nutricional en menores de 5 anos,clasificacion f,2003-05-01,1,0,1,0,1
80402,EXALTACION,estado nutricional en menores de 5 anos,clasificacion f,2003-05-01,0,4,0,4,4
90203,FILADELFIA,estado nutricional en menores de 5 anos,clasificacion f,2003-05-01,0,1,0,1,1
71002,GENERAL SAAVEDRA,estado nutricional en menores de 5 anos,clasificacion f,2003-05-01,5,1,5,1,6
21601,GRAL. J.J. PEREZ (CHARAZANI),estado nutricional en menores de 5 anos,clasificacion f,2003-05-01,0,1,0,1,1
20602,GUANAY,estado nutricional en menores de 5 anos,clasificacion f,2003-05-01,8,7,8,7,15
20802,GUAQUI,estado nutricional en menores de 5 anos,clasificacion f,2003-05-01,1,1,1,1,2
80202,GUAYARAMERIN,estado nutricional en menores de 5 anos,clasificacion f,2003-05-01,7,2,7,2,9
70705,GUTIERREZ,estado nutricional en menores de 5 anos,clasificacion f,2003-05-01,8,5,8,5,13
10502,HUACARETA,estado nutricional en menores de 5 anos,clasificacion f,2003-05-01,4,0,4,0,4
11002,HUACAYA (VILLA DE HUACAYA),estado nutricional en menores de 5 anos,clasificacion f,2003-05-01,0,2,0,2,2
80803,HUARACAJE,estado nutricional en menores de 5 anos,clasificacion f,2003-05-01,1,1,1,1,2
21005,ICHOCA,estado nutricional en menores de 5 anos,clasificacion f,2003-05-01,2,0,2,0,2
10304,ICLA,estado nutricional en menores de 5 anos,clasificacion f,2003-05-01,12,4,12,4,16
10703,INCAHUASI,estado nutricional en menores de 5 anos,clasificacion f,2003-05-01,2,1,2,1,3
21001,INQUISIVI,estado nutricional en menores de 5 anos,clasificacion f,2003-05-01,5,14,5,14,19
21501,IXIAMAS,estado nutricional en menores de 5 anos,clasificacion f,2003-05-01,0,2,0,2,2
21105,LA ASUNTA,estado nutricional en menores de 5 anos,clasificacion f,2003-05-01,3,1,3,1,4
70104,LA GUARDIA,estado nutricional en menores de 5 anos,clasificacion f,2003-05-01,2,2,2,2,4
20101,LA PAZ,estado nutricional en menores de 5 anos,clasificacion f,2003-05-01,34,20,34,20,54
70701,LAGUNILLAS,estado nutricional en menores de 5 anos,clasificacion f,2003-05-01,6,2,6,2,8
10903,LAS CARRERAS,estado nutricional en menores de 5 anos,clasificacion f,2003-05-01,2,0,2,0,2
21006,LICOMA PAMPA,estado nutricional en menores de 5 anos,clasificacion f,2003-05-01,1,0,1,0,1
50203,LLALLAGUA,estado nutricional en menores de 5 anos,clasificacion f,2003-05-01,1,44,1,44,45
51401,LLICA,estado nutricional en menores de 5 anos,clasificacion f,2003-05-01,1,0,1,0,1
20901,LURIBAY,estado nutricional en menores de 5 anos,clasificacion f,2003-05-01,0,3,0,3,3
40702,MACHACAMARCA,estado nutricional en menores de 5 anos,clasificacion f,2003-05-01,1,0,1,0,1
11003,MACHARETI,estado nutricional en menores de 5 anos,clasificacion f,2003-05-01,2,0,2,0,2
80801,MAGDALENA,estado nutricional en menores de 5 anos,clasificacion f,2003-05-01,0,2,0,2,2
70903,MAIRANA,estado nutricional en menores de 5 anos,clasificacion f,2003-05-01,1,1,1,1,2
71003,MINEROS,estado nutricional en menores de 5 anos,clasificacion f,2003-05-01,12,2,12,2,14
31301,MIZQUE,estado nutricional en menores de 5 anos,clasificacion f,2003-05-01,9,14,9,14,23
20402,MOCOMOCO,estado nutricional en menores de 5 anos,clasificacion f,2003-05-01,0,1,0,1,1
10303,MOJOCOYA,estado nutricional en menores de 5 anos,clasificacion f,2003-05-01,5,0,5,0,5
10501,MONTEAGUDO,estado nutricional en menores de 5 anos,clasificacion f,2003-05-01,13,6,13,6,19
71001,MONTERO,estado nutricional en menores de 5 anos,clasificacion f,2003-05-01,18,4,18,4,22
70803,MORO MORO,estado nutricional en menores de 5 anos,clasificacion f,2003-05-01,2,1,2,1,3
30302,MOROCHATA,estado nutricional en menores de 5 anos,clasificacion f,2003-05-01,6,8,6,8,14
50404,OCURI,estado nutricional en menores de 5 anos,clasificacion f,2003-05-01,8,3,8,3,11
40101,ORURO,estado nutricional en menores de 5 anos,clasificacion f,2003-05-01,16,6,16,6,22
60201,PADCAYA,estado nutricional en menores de 5 anos,clasificacion f,2003-05-01,1,1,1,1,2
10401,PADILLA,estado nutricional en menores de 5 anos,clasificacion f,2003-05-01,6,5,6,5,11
70502,PAILON,estado nutricional en menores de 5 anos,clasificacion f,2003-05-01,1,0,1,0,1
20102,PALCA,estado nutricional en menores de 5 anos,clasificacion f,2003-05-01,3,2,3,2,5
21104,PALOS BLANCOS,estado nutricional en menores de 5 anos,clasificacion f,2003-05-01,6,1,6,1,7
70902,PAMPA GRANDE,estado nutricional en menores de 5 anos,clasificacion f,2003-05-01,0,1,0,1,1
21305,PATACAMAYA,estado nutricional en menores de 5 anos,clasificacion f,2003-05-01,3,0,3,0,3
50403,POCOATA,estado nutricional en menores de 5 anos,clasificacion f,2003-05-01,5,7,5,7,12
31203,POCONA,estado nutricional en menores de 5 anos,clasificacion f,2003-05-01,3,0,3,0,3
31202,POJO (CBBA),estado nutricional en menores de 5 anos,clasificacion f,2003-05-01,5,7,5,7,12
51203,PORCO,estado nutricional en menores de 5 anos,clasificacion f,2003-05-01,0,1,0,1,1
10103,POROMA,estado nutricional en menores de 5 anos,clasificacion f,2003-05-01,18,22,18,22,40
70601,PORTACHUELO,estado nutricional en menores de 5 anos,clasificacion f,2003-05-01,2,0,2,0,2
70804,POSTRER VALLE,estado nutricional en menores de 5 anos,clasificacion f,2003-05-01,1,0,1,0,1
50101,POTOSI,estado nutricional en menores de 5 anos,clasificacion f,2003-05-01,25,9,25,9,34
10302,PRESTO,estado nutricional en menores de 5 anos,clasificacion f,2003-05-01,3,10,3,10,13
21201,PUCARANI,estado nutricional en menores de 5 anos,clasificacion f,2003-05-01,1,4,1,4,5
20401,PUERTO ACOSTA,estado nutricional en menores de 5 anos,clasificacion f,2003-05-01,2,0,2,0,2
20403,PUERTO CARABUCO,estado nutricional en menores de 5 anos,clasificacion f,2003-05-01,1,3,1,3,4
71402,PUERTO QUIJARRO,estado nutricional en menores de 5 anos,clasificacion f,2003-05-01,2,0,2,0,2
80703,PUERTO SILES,estado nutricional en menores de 5 anos,clasificacion f,2003-05-01,0,1,0,1,1
71401,PUERTO SUAREZ,estado nutricional en menores de 5 anos,clasificacion f,2003-05-01,2,1,2,1,3
31205,PUERTO VILLARROEL,estado nutricional en menores de 5 anos,clasificacion f,2003-05-01,21,14,21,14,35
51101,PUNA,estado nutricional en menores de 5 anos,clasificacion f,2003-05-01,14,11,14,11,25
20604,QUIABAYA,estado nutricional en menores de 5 anos,clasificacion f,2003-05-01,3,0,3,0,3
30901,QUILLACOLLO,estado nutricional en menores de 5 anos,clasificacion f,2003-05-01,7,6,7,6,13
21002,QUIME,estado nutricional en menores de 5 anos,clasificacion f,2003-05-01,4,2,4,2,6
50402,RAVELO,estado nutricional en menores de 5 anos,clasificacion f,2003-05-01,23,12,23,12,35
80301,REYES,estado nutricional en menores de 5 anos,clasificacion f,2003-05-01,4,1,4,1,5
80201,RIBERALTA,estado nutricional en menores de 5 anos,clasificacion f,2003-05-01,27,5,27,5,32
70503,ROBORE,estado nutricional en menores de 5 anos,clasificacion f,2003-05-01,2,6,2,6,8
31001,SACABA,estado nutricional en menores de 5 anos,clasificacion f,2003-05-01,9,5,9,5,14
30404,SACABAMBA,estado nutricional en menores de 5 anos,clasificacion f,2003-05-01,1,1,1,1,2
50701,SACACA,estado nutricional en menores de 5 anos,clasificacion f,2003-05-01,21,11,21,11,32
71302,SAIPINA,estado nutricional en menores de 5 anos,clasificacion f,2003-05-01,1,0,1,0,1
40801,SALINAS DE GARCI MENDOZA,estado nutricional en menores de 5 anos,clasificacion f,2003-05-01,0,1,0,1,1
51601,SAN AGUSTIN,estado nutricional en menores de 5 anos,clasificacion f,2003-05-01,0,1,0,1,1
71105,SAN ANTONIO DE LOMERIO,estado nutricional en menores de 5 anos,clasificacion f,2003-05-01,1,8,1,8,9
80302,SAN BORJA,estado nutricional en menores de 5 anos,clasificacion f,2003-05-01,45,38,45,38,83
21502,SAN BUENA VENTURA,estado nutricional en menores de 5 anos,clasificacion f,2003-05-01,2,1,2,1,3
80501,SAN IGNACIO,estado nutricional en menores de 5 anos,clasificacion f,2003-05-01,1,5,1,5,6
70301,SAN IGNACIO DE VELASCO,estado nutricional en menores de 5 anos,clasificacion f,2003-05-01,15,8,15,8,23
71102,SAN JAVIER(STC),estado nutricional en menores de 5 anos,clasificacion f,2003-05-01,1,0,1,0,1
70501,SAN JOSE DE CHIQUITOS,estado nutricional en menores de 5 anos,clasificacion f,2003-05-01,1,2,1,2,3
71104,SAN JULIAN,estado nutricional en menores de 5 anos,clasificacion f,2003-05-01,17,8,17,8,25
60501,SAN LORENZO(TJA),estado nutricional en menores de 5 anos,clasificacion f,2003-05-01,4,2,4,2,6
10702,SAN LUCAS,estado nutricional en menores de 5 anos,clasificacion f,2003-05-01,22,14,22,14,36
70302,SAN MIGUEL DE VELASCO,estado nutricional en menores de 5 anos,clasificacion f,2003-05-01,2,1,2,1,3
50501,SAN PEDRO DE BUENA VISTA,estado nutricional en menores de 5 anos,clasificacion f,2003-05-01,5,12,5,12,17
70303,SAN RAFAEL,estado nutricional en menores de 5 anos,clasificacion f,2003-05-01,2,3,2,3,5
80702,SAN RAMON,estado nutricional en menores de 5 anos,clasificacion f,2003-05-01,1,1,1,1,2
80401,SANTA ANA,estado nutricional en menores de 5 anos,clasificacion f,2003-05-01,0,2,0,2,2
70101,SANTA CRUZ DE LA SIERRA,estado nutricional en menores de 5 anos,clasificacion f,2003-05-01,8,15,8,15,23
20308,SANTIAGO DE CALLAPA,estado nutricional en menores de 5 anos,clasificacion f,2003-05-01,6,0,6,0,6
30702,SANTIVAÑES,estado nutricional en menores de 5 anos,clasificacion f,2003-05-01,2,0,2,0,2
20902,SAPAHAQUI,estado nutricional en menores de 5 anos,clasificacion f,2003-05-01,2,2,2,2,4
21301,SICA SICA (VILLA AROMA),estado nutricional en menores de 5 anos,clasificacion f,2003-05-01,8,4,8,4,12
30703,SICAYA,estado nutricional en menores de 5 anos,clasificacion f,2003-05-01,4,0,4,0,4
30902,SIPE SIPE,estado nutricional en menores de 5 anos,clasificacion f,2003-05-01,7,3,7,3,10
10403,SOPACHUY,estado nutricional en menores de 5 anos,clasificacion f,2003-05-01,9,3,9,3,12
20601,SORATA,estado nutricional en menores de 5 anos,clasificacion f,2003-05-01,0,1,0,1,1
10101,SUCRE,estado nutricional en menores de 5 anos,clasificacion f,2003-05-01,27,8,27,8,35
20603,TACACOMA,estado nutricional en menores de 5 anos,clasificacion f,2003-05-01,1,0,1,0,1
50303,TACOBAMBA,estado nutricional en menores de 5 anos,clasificacion f,2003-05-01,5,4,5,4,9
30602,TACOPAYA,estado nutricional en menores de 5 anos,clasificacion f,2003-05-01,13,2,13,2,15
31101,TAPACARI,estado nutricional en menores de 5 anos,clasificacion f,2003-05-01,8,1,8,1,9
10601,TARABUCO,estado nutricional en menores de 5 anos,clasificacion f,2003-05-01,49,17,49,17,66
30401,TARATA,estado nutricional en menores de 5 anos,clasificacion f,2003-05-01,1,0,1,0,1
60101,TARIJA,estado nutricional en menores de 5 anos,clasificacion f,2003-05-01,6,11,6,11,17
10202,TARVITA,estado nutricional en menores de 5 anos,clasificacion f,2003-05-01,7,7,7,7,14
20803,TIAWANACU,estado nutricional en menores de 5 anos,clasificacion f,2003-05-01,1,0,1,0,1
50102,TINGUIPAYA,estado nutricional en menores de 5 anos,clasificacion f,2003-05-01,4,2,4,2,6
20606,TIPUANI,estado nutricional en menores de 5 anos,clasificacion f,2003-05-01,2,1,2,1,3
30903,TIQUIPAYA,estado nutricional en menores de 5 anos,clasificacion f,2003-05-01,2,0,2,0,2
31601,TIRAQUE (CBBA),estado nutricional en menores de 5 anos,clasificacion f,2003-05-01,11,1,11,1,12
30803,TOLATA,estado nutricional en menores de 5 anos,clasificacion f,2003-05-01,1,0,1,0,1
51202,TOMAVE,estado nutricional en menores de 5 anos,clasificacion f,2003-05-01,5,1,5,1,6
10402,TOMINA,estado nutricional en menores de 5 anos,clasificacion f,2003-05-01,19,7,19,7,26
50502,TORO TORO,estado nutricional en menores de 5 anos,clasificacion f,2003-05-01,10,4,10,4,14
31201,TOTORA(CBBA),estado nutricional en menores de 5 anos,clasificacion f,2003-05-01,1,0,1,0,1
41301,TOTORA(ORR),estado nutricional en menores de 5 anos,clasificacion f,2003-05-01,1,0,1,0,1
80101,TRINIDAD,estado nutricional en menores de 5 anos,clasificacion f,2003-05-01,4,3,4,3,7
50801,TUPIZA,estado nutricional en menores de 5 anos,clasificacion f,2003-05-01,2,10,2,10,12
60401,URIONDO (A. CONCEPCION),estado nutricional en menores de 5 anos,clasificacion f,2003-05-01,1,0,1,0,1
71502,URUBICHA,estado nutricional en menores de 5 anos,clasificacion f,2003-05-01,1,0,1,0,1
51201,UYUNI,estado nutricional en menores de 5 anos,clasificacion f,2003-05-01,8,1,8,1,9
70801,VALLEGRANDE,estado nutricional en menores de 5 anos,clasificacion f,2003-05-01,2,4,2,4,6
20801,VIACHA,estado nutricional en menores de 5 anos,clasificacion f,2003-05-01,4,0,4,0,4
31302,VILA VILA,estado nutricional en menores de 5 anos,clasificacion f,2003-05-01,5,1,5,1,6
60303,VILLA MONTES,estado nutricional en menores de 5 anos,clasificacion f,2003-05-01,4,0,4,0,4
10801,VILLA SERRANO,estado nutricional en menores de 5 anos,clasificacion f,2003-05-01,6,6,6,6,12
31003,VILLA TUNARI,estado nutricional en menores de 5 anos,clasificacion f,2003-05-01,11,1,11,1,12
11001,VILLA VACA GUZMAN (MUYUPAMPA),estado nutricional en menores de 5 anos,clasificacion f,2003-05-01,2,2,2,2,4
51501,VILLAZON,estado nutricional en menores de 5 anos,clasificacion f,2003-05-01,2,2,2,2,4
50602,VITICHI,estado nutricional en menores de 5 anos,clasificacion f,2003-05-01,3,6,3,6,9
20903,YACO,estado nutricional en menores de 5 anos,clasificacion f,2003-05-01,0,2,0,2,2
60301,YACUIBA,estado nutricional en menores de 5 anos,clasificacion f,2003-05-01,6,3,6,3,9
10602,YAMPARAEZ,estado nutricional en menores de 5 anos,clasificacion f,2003-05-01,16,1,16,1,17
21103,YANACACHI,estado nutricional en menores de 5 anos,clasificacion f,2003-05-01,0,1,0,1,1
70403,YAPACANI,estado nutricional en menores de 5 anos,clasificacion f,2003-05-01,10,7,10,7,17
50103,YOCALLA,estado nutricional en menores de 5 anos,clasificacion f,2003-05-01,0,1,0,1,1
10102,YOTALA,estado nutricional en menores de 5 anos,clasificacion f,2003-05-01,9,1,9,1,10
60402,YUNCHARA,estado nutricional en menores de 5 anos,clasificacion f,2003-05-01,0,3,0,3,3
10301,ZUDAÑEZ,estado nutricional en menores de 5 anos,clasificacion f,2003-05-01,4,1,4,1,5
51302,ACACIO,estado nutricional en menores de 5 anos,clasificacion f,2003-06-01,13,5,13,5,18
20201,ACHACACHI,estado nutricional en menores de 5 anos,clasificacion f,2003-06-01,4,5,4,5,9
30201,AIQUILE,estado nutricional en menores de 5 anos,clasificacion f,2003-06-01,2,1,2,1,3
10404,ALCALA,estado nutricional en menores de 5 anos,clasificacion f,2003-06-01,2,7,2,7,9
30402,ANZALDO,estado nutricional en menores de 5 anos,clasificacion f,2003-06-01,0,3,0,3,3
20701,APOLO,estado nutricional en menores de 5 anos,clasificacion f,2003-06-01,1,0,1,0,1
51301,ARAMPAMPA,estado nutricional en menores de 5 anos,clasificacion f,2003-06-01,3,3,3,3,6
30601,ARQUE,estado nutricional en menores de 5 anos,clasificacion f,2003-06-01,2,2,2,2,4
71501,ASCENCION DE GUARAYOS,estado nutricional en menores de 5 anos,clasificacion f,2003-06-01,21,5,21,5,26
50802,ATOCHA,estado nutricional en menores de 5 anos,clasificacion f,2003-06-01,0,5,0,5,5
20503,AUCAPATA,estado nutricional en menores de 5 anos,clasificacion f,2003-06-01,2,1,2,1,3
20502,AYATA,estado nutricional en menores de 5 anos,clasificacion f,2003-06-01,1,0,1,0,1
21303,AYO AYO,estado nutricional en menores de 5 anos,clasificacion f,2003-06-01,1,0,1,0,1
30301,AYOPAYA (V. DE INDEPENDENCIA),estado nutricional en menores de 5 anos,clasificacion f,2003-06-01,4,2,4,2,6
10201,AZURDUY,estado nutricional en menores de 5 anos,clasificacion f,2003-06-01,19,7,19,7,26
80802,BAURES,estado nutricional en menores de 5 anos,clasificacion f,2003-06-01,0,1,0,1,1
50301,BETANZOS,estado nutricional en menores de 5 anos,clasificacion f,2003-06-01,31,15,31,15,46
31501,BOLIVAR,estado nutricional en menores de 5 anos,clasificacion f,2003-06-01,10,2,10,2,12
90103,BOLPEBRA,estado nutricional en menores de 5 anos,clasificacion f,2003-06-01,2,1,2,1,3
70707,BOYUIBE,estado nutricional en menores de 5 anos,clasificacion f,2003-06-01,1,0,1,0,1
70401,BUENA VISTA,estado nutricional en menores de 5 anos,clasificacion f,2003-06-01,0,1,0,1,1
70703,CABEZAS,estado nutricional en menores de 5 anos,clasificacion f,2003-06-01,0,1,0,1,1
20905,CAIROMA,estado nutricional en menores de 5 anos,clasificacion f,2003-06-01,5,2,5,2,7
51102,"CAIZA ""D""",estado nutricional en menores de 5 anos,clasificacion f,2003-06-01,4,0,4,0,4
21003,CAJUATA,estado nutricional en menores de 5 anos,clasificacion f,2003-06-01,2,4,2,4,6
21304,CALAMARCA,estado nutricional en menores de 5 anos,clasificacion f,2003-06-01,1,1,1,1,2
10701,CAMARGO,estado nutricional en menores de 5 anos,clasificacion f,2003-06-01,3,3,3,3,6
70706,CAMIRI,estado nutricional en menores de 5 anos,clasificacion f,2003-06-01,5,5,5,5,10
30701,CAPINOTA,estado nutricional en menores de 5 anos,clasificacion f,2003-06-01,6,1,6,1,7
20302,CAQUIAVIRI,estado nutricional en menores de 5 anos,clasificacion f,2003-06-01,1,0,1,0,1
40102,CARACOLLO,estado nutricional en menores de 5 anos,clasificacion f,2003-06-01,1,0,1,0,1
22001,CARANAVI,estado nutricional en menores de 5 anos,clasificacion f,2003-06-01,4,6,4,6,10
60302,CARAPARI,estado nutricional en menores de 5 anos,clasificacion f,2003-06-01,1,0,1,0,1
50702,CARIPUYO,estado nutricional en menores de 5 anos,clasificacion f,2003-06-01,7,11,7,11,18
40201,CHALLAPATA,estado nutricional en menores de 5 anos,clasificacion f,2003-06-01,5,6,5,6,11
50302,CHAQUI,estado nutricional en menores de 5 anos,clasificacion f,2003-06-01,0,1,0,1,1
70702,CHARAGUA,estado nutricional en menores de 5 anos,clasificacion f,2003-06-01,9,2,9,2,11
50202,CHAYANTA,estado nutricional en menores de 5 anos,clasificacion f,2003-06-01,2,2,2,2,4
31204,CHIMORE,estado nutricional en menores de 5 anos,clasificacion f,2003-06-01,1,1,1,1,2
40302,CHOQUE COTA,estado nutricional en menores de 5 anos,clasificacion f,2003-06-01,1,0,1,0,1
20501,CHUMA,estado nutricional en menores de 5 anos,clasificacion f,2003-06-01,4,2,4,2,6
30801,CLIZA,estado nutricional en menores de 5 anos,clasificacion f,2003-06-01,1,0,1,0,1
90101,COBIJA,estado nutricional en menores de 5 anos,clasificacion f,2003-06-01,3,24,3,24,27
30101,COCHABAMBA,estado nutricional en menores de 5 anos,clasificacion f,2003-06-01,15,4,15,4,19
30905,COLCAPIRHUA,estado nutricional en menores de 5 anos,clasificacion f,2003-06-01,1,0,1,0,1
31002,COLOMI,estado nutricional en menores de 5 anos,clasificacion f,2003-06-01,1,6,1,6,7
50401,COLQUECHACA,estado nutricional en menores de 5 anos,clasificacion f,2003-06-01,26,7,26,7,33
21306,COLQUENCHA,estado nutricional en menores de 5 anos,clasificacion f,2003-06-01,1,1,1,1,2
21004,COLQUIRI,estado nutricional en menores de 5 anos,clasificacion f,2003-06-01,8,3,8,3,11
71301,COMARAPA,estado nutricional en menores de 5 anos,clasificacion f,2003-06-01,3,3,3,3,6
21701,COPACABANA,estado nutricional en menores de 5 anos,clasificacion f,2003-06-01,3,0,3,0,3
20301,CORO CORO,estado nutricional en menores de 5 anos,clasificacion f,2003-06-01,1,0,1,0,1
21401,COROICO,estado nutricional en menores de 5 anos,clasificacion f,2003-06-01,1,0,1,0,1
50601,COTAGAITA,estado nutricional en menores de 5 anos,clasificacion f,2003-06-01,10,4,10,4,14
70102,COTOCA,estado nutricional en menores de 5 anos,clasificacion f,2003-06-01,1,0,1,0,1
10902,CULPINA,estado nutricional en menores de 5 anos,clasificacion f,2003-06-01,11,5,11,5,16
20105,EL ALTO,estado nutricional en menores de 5 anos,clasificacion f,2003-06-01,63,22,63,22,85
71503,EL PUENTE(STC),estado nutricional en menores de 5 anos,clasificacion f,2003-06-01,0,3,0,3,3
60502,EL PUENTE(TJA),estado nutricional en menores de 5 anos,clasificacion f,2003-06-01,1,0,1,0,1
70105,EL TORNO,estado nutricional en menores de 5 anos,clasificacion f,2003-06-01,1,1,1,1,2
10405,EL VILLAR,estado nutricional en menores de 5 anos,clasificacion f,2003-06-01,5,2,5,2,7
60601,ENTRE RIOS,estado nutricional en menores de 5 anos,clasificacion f,2003-06-01,2,3,2,3,5
41101,EUCALIPTUS,estado nutricional en menores de 5 anos,clasificacion f,2003-06-01,2,0,2,0,2
80402,EXALTACION,estado nutricional en menores de 5 anos,clasificacion f,2003-06-01,0,3,0,3,3
71002,GENERAL SAAVEDRA,estado nutricional en menores de 5 anos,clasificacion f,2003-06-01,6,6,6,6,12
21601,GRAL. J.J. PEREZ (CHARAZANI),estado nutricional en menores de 5 anos,clasificacion f,2003-06-01,4,1,4,1,5
20602,GUANAY,estado nutricional en menores de 5 anos,clasificacion f,2003-06-01,7,1,7,1,8
20802,GUAQUI,estado nutricional en menores de 5 anos,clasificacion f,2003-06-01,0,1,0,1,1
80202,GUAYARAMERIN,estado nutricional en menores de 5 anos,clasificacion f,2003-06-01,13,8,13,8,21
70705,GUTIERREZ,estado nutricional en menores de 5 anos,clasificacion f,2003-06-01,12,6,12,6,18
10502,HUACARETA,estado nutricional en menores de 5 anos,clasificacion f,2003-06-01,1,1,1,1,2
11002,HUACAYA (VILLA DE HUACAYA),estado nutricional en menores de 5 anos,clasificacion f,2003-06-01,1,2,1,2,3
40701,HUANUNI,estado nutricional en menores de 5 anos,clasificacion f,2003-06-01,0,1,0,1,1
21005,ICHOCA,estado nutricional en menores de 5 anos,clasificacion f,2003-06-01,2,1,2,1,3
10304,ICLA,estado nutricional en menores de 5 anos,clasificacion f,2003-06-01,4,2,4,2,6
10703,INCAHUASI,estado nutricional en menores de 5 anos,clasificacion f,2003-06-01,3,3,3,3,6
21001,INQUISIVI,estado nutricional en menores de 5 anos,clasificacion f,2003-06-01,2,1,2,1,3
21501,IXIAMAS,estado nutricional en menores de 5 anos,clasificacion f,2003-06-01,1,1,1,1,2
21105,LA ASUNTA,estado nutricional en menores de 5 anos,clasificacion f,2003-06-01,4,4,4,4,8
70104,LA GUARDIA,estado nutricional en menores de 5 anos,clasificacion f,2003-06-01,2,0,2,0,2
20101,LA PAZ,estado nutricional en menores de 5 anos,clasificacion f,2003-06-01,35,12,35,12,47
70701,LAGUNILLAS,estado nutricional en menores de 5 anos,clasificacion f,2003-06-01,1,2,1,2,3
10903,LAS CARRERAS,estado nutricional en menores de 5 anos,clasificacion f,2003-06-01,1,0,1,0,1
50203,LLALLAGUA,estado nutricional en menores de 5 anos,clasificacion f,2003-06-01,1,15,1,15,16
51401,LLICA,estado nutricional en menores de 5 anos,clasificacion f,2003-06-01,1,0,1,0,1
20901,LURIBAY,estado nutricional en menores de 5 anos,clasificacion f,2003-06-01,2,9,2,9,11
40702,MACHACAMARCA,estado nutricional en menores de 5 anos,clasificacion f,2003-06-01,2,0,2,0,2
11003,MACHARETI,estado nutricional en menores de 5 anos,clasificacion f,2003-06-01,3,0,3,0,3
80801,MAGDALENA,estado nutricional en menores de 5 anos,clasificacion f,2003-06-01,2,0,2,0,2
70903,MAIRANA,estado nutricional en menores de 5 anos,clasificacion f,2003-06-01,1,0,1,0,1
20103,MECAPACA,estado nutricional en menores de 5 anos,clasificacion f,2003-06-01,1,4,1,4,5
71003,MINEROS,estado nutricional en menores de 5 anos,clasificacion f,2003-06-01,14,0,14,0,14
31301,MIZQUE,estado nutricional en menores de 5 anos,clasificacion f,2003-06-01,0,1,0,1,1
20402,MOCOMOCO,estado nutricional en menores de 5 anos,clasificacion f,2003-06-01,3,2,3,2,5
10303,MOJOCOYA,estado nutricional en menores de 5 anos,clasificacion f,2003-06-01,1,0,1,0,1
10501,MONTEAGUDO,estado nutricional en menores de 5 anos,clasificacion f,2003-06-01,8,1,8,1,9
71001,MONTERO,estado nutricional en menores de 5 anos,clasificacion f,2003-06-01,14,2,14,2,16
70803,MORO MORO,estado nutricional en menores de 5 anos,clasificacion f,2003-06-01,1,0,1,0,1
30302,MOROCHATA,estado nutricional en menores de 5 anos,clasificacion f,2003-06-01,6,2,6,2,8
50404,OCURI,estado nutricional en menores de 5 anos,clasificacion f,2003-06-01,4,1,4,1,5
40101,ORURO,estado nutricional en menores de 5 anos,clasificacion f,2003-06-01,13,14,13,14,27
60201,PADCAYA,estado nutricional en menores de 5 anos,clasificacion f,2003-06-01,5,5,5,5,10
10401,PADILLA,estado nutricional en menores de 5 anos,clasificacion f,2003-06-01,2,4,2,4,6
70502,PAILON,estado nutricional en menores de 5 anos,clasificacion f,2003-06-01,1,0,1,0,1
20102,PALCA,estado nutricional en menores de 5 anos,clasificacion f,2003-06-01,1,0,1,0,1
21104,PALOS BLANCOS,estado nutricional en menores de 5 anos,clasificacion f,2003-06-01,8,2,8,2,10
70902,PAMPA GRANDE,estado nutricional en menores de 5 anos,clasificacion f,2003-06-01,1,0,1,0,1
21305,PATACAMAYA,estado nutricional en menores de 5 anos,clasificacion f,2003-06-01,7,2,7,2,9
20702,PELECHUCO,estado nutricional en menores de 5 anos,clasificacion f,2003-06-01,2,4,2,4,6
50403,POCOATA,estado nutricional en menores de 5 anos,clasificacion f,2003-06-01,1,6,1,6,7
31203,POCONA,estado nutricional en menores de 5 anos,clasificacion f,2003-06-01,2,1,2,1,3
31202,POJO (CBBA),estado nutricional en menores de 5 anos,clasificacion f,2003-06-01,3,1,3,1,4
51203,PORCO,estado nutricional en menores de 5 anos,clasificacion f,2003-06-01,0,2,0,2,2
10103,POROMA,estado nutricional en menores de 5 anos,clasificacion f,2003-06-01,25,17,25,17,42
70601,PORTACHUELO,estado nutricional en menores de 5 anos,clasificacion f,2003-06-01,0,1,0,1,1
70804,POSTRER VALLE,estado nutricional en menores de 5 anos,clasificacion f,2003-06-01,1,0,1,0,1
50101,POTOSI,estado nutricional en menores de 5 anos,clasificacion f,2003-06-01,26,8,26,8,34
10302,PRESTO,estado nutricional en menores de 5 anos,clasificacion f,2003-06-01,5,8,5,8,13
21201,PUCARANI,estado nutricional en menores de 5 anos,clasificacion f,2003-06-01,1,3,1,3,4
20403,PUERTO CARABUCO,estado nutricional en menores de 5 anos,clasificacion f,2003-06-01,0,2,0,2,2
71402,PUERTO QUIJARRO,estado nutricional en menores de 5 anos,clasificacion f,2003-06-01,1,1,1,1,2
80703,PUERTO SILES,estado nutricional en menores de 5 anos,clasificacion f,2003-06-01,0,2,0,2,2
71401,PUERTO SUAREZ,estado nutricional en menores de 5 anos,clasificacion f,2003-06-01,2,0,2,0,2
31205,PUERTO VILLARROEL,estado nutricional en menores de 5 anos,clasificacion f,2003-06-01,7,5,7,5,12
51101,PUNA,estado nutricional en menores de 5 anos,clasificacion f,2003-06-01,5,266,5,266,271
31401,PUNATA,estado nutricional en menores de 5 anos,clasificacion f,2003-06-01,6,0,6,0,6
20604,QUIABAYA,estado nutricional en menores de 5 anos,clasificacion f,2003-06-01,1,1,1,1,2
30901,QUILLACOLLO,estado nutricional en menores de 5 anos,clasificacion f,2003-06-01,12,4,12,4,16
21002,QUIME,estado nutricional en menores de 5 anos,clasificacion f,2003-06-01,7,0,7,0,7
50402,RAVELO,estado nutricional en menores de 5 anos,clasificacion f,2003-06-01,31,16,31,16,47
80201,RIBERALTA,estado nutricional en menores de 5 anos,clasificacion f,2003-06-01,33,16,33,16,49
70503,ROBORE,estado nutricional en menores de 5 anos,clasificacion f,2003-06-01,2,1,2,1,3
80304,RURRENABAQUE,estado nutricional en menores de 5 anos,clasificacion f,2003-06-01,3,1,3,1,4
31001,SACABA,estado nutricional en menores de 5 anos,clasificacion f,2003-06-01,4,1,4,1,5
50701,SACACA,estado nutricional en menores de 5 anos,clasificacion f,2003-06-01,31,13,31,13,44
71302,SAIPINA,estado nutricional en menores de 5 anos,clasificacion f,2003-06-01,0,1,0,1,1
71105,SAN ANTONIO DE LOMERIO,estado nutricional en menores de 5 anos,clasificacion f,2003-06-01,4,3,4,3,7
80302,SAN BORJA,estado nutricional en menores de 5 anos,clasificacion f,2003-06-01,12,5,12,5,17
21502,SAN BUENA VENTURA,estado nutricional en menores de 5 anos,clasificacion f,2003-06-01,2,0,2,0,2
70402,SAN CARLOS,estado nutricional en menores de 5 anos,clasificacion f,2003-06-01,2,1,2,1,3
80501,SAN IGNACIO,estado nutricional en menores de 5 anos,clasificacion f,2003-06-01,9,4,9,4,13
70301,SAN IGNACIO DE VELASCO,estado nutricional en menores de 5 anos,clasificacion f,2003-06-01,17,6,17,6,23
71102,SAN JAVIER(STC),estado nutricional en menores de 5 anos,clasificacion f,2003-06-01,2,0,2,0,2
70501,SAN JOSE DE CHIQUITOS,estado nutricional en menores de 5 anos,clasificacion f,2003-06-01,2,2,2,2,4
71104,SAN JULIAN,estado nutricional en menores de 5 anos,clasificacion f,2003-06-01,4,0,4,0,4
90302,SAN LORENZO(PND),estado nutricional en menores de 5 anos,clasificacion f,2003-06-01,0,1,0,1,1
60501,SAN LORENZO(TJA),estado nutricional en menores de 5 anos,clasificacion f,2003-06-01,1,0,1,0,1
10702,SAN LUCAS,estado nutricional en menores de 5 anos,clasificacion f,2003-06-01,15,15,15,15,30
71201,SAN MATIAS,estado nutricional en menores de 5 anos,clasificacion f,2003-06-01,6,1,6,1,7
70302,SAN MIGUEL DE VELASCO,estado nutricional en menores de 5 anos,clasificacion f,2003-06-01,1,1,1,1,2
50501,SAN PEDRO DE BUENA VISTA,estado nutricional en menores de 5 anos,clasificacion f,2003-06-01,7,8,7,8,15
70303,SAN RAFAEL,estado nutricional en menores de 5 anos,clasificacion f,2003-06-01,1,1,1,1,2
70101,SANTA CRUZ DE LA SIERRA,estado nutricional en menores de 5 anos,clasificacion f,2003-06-01,19,10,19,10,29
20308,SANTIAGO DE CALLAPA,estado nutricional en menores de 5 anos,clasificacion f,2003-06-01,4,4,4,4,8
41401,SANTIAGO DE HUARI,estado nutricional en menores de 5 anos,clasificacion f,2003-06-01,1,1,1,1,2
30702,SANTIVAÑES,estado nutricional en menores de 5 anos,clasificacion f,2003-06-01,1,1,1,1,2
20902,SAPAHAQUI,estado nutricional en menores de 5 anos,clasificacion f,2003-06-01,3,1,3,1,4
21301,SICA SICA (VILLA AROMA),estado nutricional en menores de 5 anos,clasificacion f,2003-06-01,1,0,1,0,1
30902,SIPE SIPE,estado nutricional en menores de 5 anos,clasificacion f,2003-06-01,12,2,12,2,14
10403,SOPACHUY,estado nutricional en menores de 5 anos,clasificacion f,2003-06-01,15,9,15,9,24
20601,SORATA,estado nutricional en menores de 5 anos,clasificacion f,2003-06-01,1,1,1,1,2
10101,SUCRE,estado nutricional en menores de 5 anos,clasificacion f,2003-06-01,32,8,32,8,40
50303,TACOBAMBA,estado nutricional en menores de 5 anos,clasificacion f,2003-06-01,6,1,6,1,7
30602,TACOPAYA,estado nutricional en menores de 5 anos,clasificacion f,2003-06-01,6,1,6,1,7
31101,TAPACARI,estado nutricional en menores de 5 anos,clasificacion f,2003-06-01,8,12,8,12,20
10601,TARABUCO,estado nutricional en menores de 5 anos,clasificacion f,2003-06-01,38,16,38,16,54
30401,TARATA,estado nutricional en menores de 5 anos,clasificacion f,2003-06-01,0,9,0,9,9
60101,TARIJA,estado nutricional en menores de 5 anos,clasificacion f,2003-06-01,4,5,4,5,9
10202,TARVITA,estado nutricional en menores de 5 anos,clasificacion f,2003-06-01,2,5,2,5,7
50102,TINGUIPAYA,estado nutricional en menores de 5 anos,clasificacion f,2003-06-01,6,4,6,4,10
20606,TIPUANI,estado nutricional en menores de 5 anos,clasificacion f,2003-06-01,0,1,0,1,1
30903,TIQUIPAYA,estado nutricional en menores de 5 anos,clasificacion f,2003-06-01,2,0,2,0,2
31601,TIRAQUE (CBBA),estado nutricional en menores de 5 anos,clasificacion f,2003-06-01,9,17,9,17,26
51202,TOMAVE,estado nutricional en menores de 5 anos,clasificacion f,2003-06-01,3,1,3,1,4
10402,TOMINA,estado nutricional en menores de 5 anos,clasificacion f,2003-06-01,16,7,16,7,23
50502,TORO TORO,estado nutricional en menores de 5 anos,clasificacion f,2003-06-01,9,2,9,2,11
31201,TOTORA(CBBA),estado nutricional en menores de 5 anos,clasificacion f,2003-06-01,3,1,3,1,4
70802,TRIGAL,estado nutricional en menores de 5 anos,clasificacion f,2003-06-01,1,0,1,0,1
80101,TRINIDAD,estado nutricional en menores de 5 anos,clasificacion f,2003-06-01,11,14,11,14,25
50801,TUPIZA,estado nutricional en menores de 5 anos,clasificacion f,2003-06-01,2,3,2,3,5
40402,TURCO,estado nutricional en menores de 5 anos,clasificacion f,2003-06-01,0,1,0,1,1
71502,URUBICHA,estado nutricional en menores de 5 anos,clasificacion f,2003-06-01,4,2,4,2,6
51201,UYUNI,estado nutricional en menores de 5 anos,clasificacion f,2003-06-01,0,2,0,2,2
30502,VACAS,estado nutricional en menores de 5 anos,clasificacion f,2003-06-01,1,0,1,0,1
70801,VALLEGRANDE,estado nutricional en menores de 5 anos,clasificacion f,2003-06-01,5,2,5,2,7
20801,VIACHA,estado nutricional en menores de 5 anos,clasificacion f,2003-06-01,4,3,4,3,7
31302,VILA VILA,estado nutricional en menores de 5 anos,clasificacion f,2003-06-01,4,3,4,3,7
60303,VILLA MONTES,estado nutricional en menores de 5 anos,clasificacion f,2003-06-01,4,2,4,2,6
10801,VILLA SERRANO,estado nutricional en menores de 5 anos,clasificacion f,2003-06-01,3,2,3,2,5
31003,VILLA TUNARI,estado nutricional en menores de 5 anos,clasificacion f,2003-06-01,7,12,7,12,19
51501,VILLAZON,estado nutricional en menores de 5 anos,clasificacion f,2003-06-01,1,1,1,1,2
30904,VINTO,estado nutricional en menores de 5 anos,clasificacion f,2003-06-01,0,1,0,1,1
50602,VITICHI,estado nutricional en menores de 5 anos,clasificacion f,2003-06-01,7,1,7,1,8
20903,YACO,estado nutricional en menores de 5 anos,clasificacion f,2003-06-01,3,0,3,0,3
60301,YACUIBA,estado nutricional en menores de 5 anos,clasificacion f,2003-06-01,5,1,5,1,6
10602,YAMPARAEZ,estado nutricional en menores de 5 anos,clasificacion f,2003-06-01,20,1,20,1,21
70403,YAPACANI,estado nutricional en menores de 5 anos,clasificacion f,2003-06-01,7,6,7,6,13
10102,YOTALA,estado nutricional en menores de 5 anos,clasificacion f,2003-06-01,6,0,6,0,6
10301,ZUDAÑEZ,estado nutricional en menores de 5 anos,clasificacion f,2003-06-01,8,1,8,1,9
51302,ACACIO,estado nutricional en menores de 5 anos,clasificacion f,2003-07-01,11,4,11,4,15
20201,ACHACACHI,estado nutricional en menores de 5 anos,clasificacion f,2003-07-01,1,0,1,0,1
20104,ACHOCALLA,estado nutricional en menores de 5 anos,clasificacion f,2003-07-01,2,0,2,0,2
30201,AIQUILE,estado nutricional en menores de 5 anos,clasificacion f,2003-07-01,6,1,6,1,7
31303,ALALAY,estado nutricional en menores de 5 anos,clasificacion f,2003-07-01,1,1,1,1,2
10404,ALCALA,estado nutricional en menores de 5 anos,clasificacion f,2003-07-01,1,7,1,7,8
20202,ANCORAIMES,estado nutricional en menores de 5 anos,clasificacion f,2003-07-01,2,0,2,0,2
30402,ANZALDO,estado nutricional en menores de 5 anos,clasificacion f,2003-07-01,1,1,1,1,2
20701,APOLO,estado nutricional en menores de 5 anos,clasificacion f,2003-07-01,2,0,2,0,2
51301,ARAMPAMPA,estado nutricional en menores de 5 anos,clasificacion f,2003-07-01,2,1,2,1,3
30501,ARANI,estado nutricional en menores de 5 anos,clasificacion f,2003-07-01,2,3,2,3,5
30601,ARQUE,estado nutricional en menores de 5 anos,clasificacion f,2003-07-01,3,1,3,1,4
50802,ATOCHA,estado nutricional en menores de 5 anos,clasificacion f,2003-07-01,0,14,0,14,14
20502,AYATA,estado nutricional en menores de 5 anos,clasificacion f,2003-07-01,2,0,2,0,2
30301,AYOPAYA (V. DE INDEPENDENCIA),estado nutricional en menores de 5 anos,clasificacion f,2003-07-01,5,3,5,3,8
10201,AZURDUY,estado nutricional en menores de 5 anos,clasificacion f,2003-07-01,13,7,13,7,20
80802,BAURES,estado nutricional en menores de 5 anos,clasificacion f,2003-07-01,1,0,1,0,1
60202,BERMEJO,estado nutricional en menores de 5 anos,clasificacion f,2003-07-01,0,1,0,1,1
50301,BETANZOS,estado nutricional en menores de 5 anos,clasificacion f,2003-07-01,21,6,21,6,27
31501,BOLIVAR,estado nutricional en menores de 5 anos,clasificacion f,2003-07-01,9,3,9,3,12
90103,BOLPEBRA,estado nutricional en menores de 5 anos,clasificacion f,2003-07-01,1,0,1,0,1
70707,BOYUIBE,estado nutricional en menores de 5 anos,clasificacion f,2003-07-01,1,0,1,0,1
70401,BUENA VISTA,estado nutricional en menores de 5 anos,clasificacion f,2003-07-01,2,0,2,0,2
70703,CABEZAS,estado nutricional en menores de 5 anos,clasificacion f,2003-07-01,1,0,1,0,1
20905,CAIROMA,estado nutricional en menores de 5 anos,clasificacion f,2003-07-01,2,1,2,1,3
51102,"CAIZA ""D""",estado nutricional en menores de 5 anos,clasificacion f,2003-07-01,5,0,5,0,5
21003,CAJUATA,estado nutricional en menores de 5 anos,clasificacion f,2003-07-01,1,4,1,4,5
21304,CALAMARCA,estado nutricional en menores de 5 anos,clasificacion f,2003-07-01,1,0,1,0,1
10701,CAMARGO,estado nutricional en menores de 5 anos,clasificacion f,2003-07-01,4,0,4,0,4
70706,CAMIRI,estado nutricional en menores de 5 anos,clasificacion f,2003-07-01,1,1,1,1,2
30701,CAPINOTA,estado nutricional en menores de 5 anos,clasificacion f,2003-07-01,6,2,6,2,8
20302,CAQUIAVIRI,estado nutricional en menores de 5 anos,clasificacion f,2003-07-01,1,0,1,0,1
22001,CARANAVI,estado nutricional en menores de 5 anos,clasificacion f,2003-07-01,10,2,10,2,12
60302,CARAPARI,estado nutricional en menores de 5 anos,clasificacion f,2003-07-01,0,3,0,3,3
50702,CARIPUYO,estado nutricional en menores de 5 anos,clasificacion f,2003-07-01,12,9,12,9,21
21902,CATACORA,estado nutricional en menores de 5 anos,clasificacion f,2003-07-01,0,1,0,1,1
40201,CHALLAPATA,estado nutricional en menores de 5 anos,clasificacion f,2003-07-01,7,0,7,0,7
50302,CHAQUI,estado nutricional en menores de 5 anos,clasificacion f,2003-07-01,3,1,3,1,4
70702,CHARAGUA,estado nutricional en menores de 5 anos,clasificacion f,2003-07-01,9,4,9,4,13
50202,CHAYANTA,estado nutricional en menores de 5 anos,clasificacion f,2003-07-01,1,1,1,1,2
21101,CHULUMANI (V. DE LA LIBERTAD),estado nutricional en menores de 5 anos,clasificacion f,2003-07-01,1,0,1,0,1
20501,CHUMA,estado nutricional en menores de 5 anos,clasificacion f,2003-07-01,3,2,3,2,5
90101,COBIJA,estado nutricional en menores de 5 anos,clasificacion f,2003-07-01,4,3,4,3,7
30101,COCHABAMBA,estado nutricional en menores de 5 anos,clasificacion f,2003-07-01,12,5,12,5,17
50901,"COLCHA ""K""",estado nutricional en menores de 5 anos,clasificacion f,2003-07-01,0,1,0,1,1
31002,COLOMI,estado nutricional en menores de 5 anos,clasificacion f,2003-07-01,3,0,3,0,3
50401,COLQUECHACA,estado nutricional en menores de 5 anos,clasificacion f,2003-07-01,20,5,20,5,25
21306,COLQUENCHA,estado nutricional en menores de 5 anos,clasificacion f,2003-07-01,0,1,0,1,1
21004,COLQUIRI,estado nutricional en menores de 5 anos,clasificacion f,2003-07-01,3,4,3,4,7
71301,COMARAPA,estado nutricional en menores de 5 anos,clasificacion f,2003-07-01,3,1,3,1,4
20605,COMBAYA,estado nutricional en menores de 5 anos,clasificacion f,2003-07-01,1,0,1,0,1
21701,COPACABANA,estado nutricional en menores de 5 anos,clasificacion f,2003-07-01,4,1,4,1,5
20301,CORO CORO,estado nutricional en menores de 5 anos,clasificacion f,2003-07-01,4,0,4,0,4
21401,COROICO,estado nutricional en menores de 5 anos,clasificacion f,2003-07-01,1,0,1,0,1
50601,COTAGAITA,estado nutricional en menores de 5 anos,clasificacion f,2003-07-01,4,1,4,1,5
70102,COTOCA,estado nutricional en menores de 5 anos,clasificacion f,2003-07-01,4,0,4,0,4
70704,CUEVO,estado nutricional en menores de 5 anos,clasificacion f,2003-07-01,1,0,1,0,1
10902,CULPINA,estado nutricional en menores de 5 anos,clasificacion f,2003-07-01,10,3,10,3,13
21602,CURVA,estado nutricional en menores de 5 anos,clasificacion f,2003-07-01,0,3,0,3,3
20105,EL ALTO,estado nutricional en menores de 5 anos,clasificacion f,2003-07-01,71,26,71,26,97
71503,EL PUENTE(STC),estado nutricional en menores de 5 anos,clasificacion f,2003-07-01,0,4,0,4,4
60502,EL PUENTE(TJA),estado nutricional en menores de 5 anos,clasificacion f,2003-07-01,3,0,3,0,3
70105,EL TORNO,estado nutricional en menores de 5 anos,clasificacion f,2003-07-01,2,0,2,0,2
10405,EL VILLAR,estado nutricional en menores de 5 anos,clasificacion f,2003-07-01,3,3,3,3,6
60601,ENTRE RIOS,estado nutricional en menores de 5 anos,clasificacion f,2003-07-01,4,0,4,0,4
80402,EXALTACION,estado nutricional en menores de 5 anos,clasificacion f,2003-07-01,0,2,0,2,2
90203,FILADELFIA,estado nutricional en menores de 5 anos,clasificacion f,2003-07-01,1,2,1,2,3
71002,GENERAL SAAVEDRA,estado nutricional en menores de 5 anos,clasificacion f,2003-07-01,4,3,4,3,7
21601,GRAL. J.J. PEREZ (CHARAZANI),estado nutricional en menores de 5 anos,clasificacion f,2003-07-01,4,5,4,5,9
20602,GUANAY,estado nutricional en menores de 5 anos,clasificacion f,2003-07-01,5,1,5,1,6
20802,GUAQUI,estado nutricional en menores de 5 anos,clasificacion f,2003-07-01,1,1,1,1,2
80202,GUAYARAMERIN,estado nutricional en menores de 5 anos,clasificacion f,2003-07-01,7,1,7,1,8
70705,GUTIERREZ,estado nutricional en menores de 5 anos,clasificacion f,2003-07-01,7,3,7,3,10
10502,HUACARETA,estado nutricional en menores de 5 anos,clasificacion f,2003-07-01,3,0,3,0,3
11002,HUACAYA (VILLA DE HUACAYA),estado nutricional en menores de 5 anos,clasificacion f,2003-07-01,0,1,0,1,1
40701,HUANUNI,estado nutricional en menores de 5 anos,clasificacion f,2003-07-01,1,0,1,0,1
41601,HUAYLLAMARCA,estado nutricional en menores de 5 anos,clasificacion f,2003-07-01,1,0,1,0,1
21005,ICHOCA,estado nutricional en menores de 5 anos,clasificacion f,2003-07-01,2,0,2,0,2
10304,ICLA,estado nutricional en menores de 5 anos,clasificacion f,2003-07-01,6,3,6,3,9
10703,INCAHUASI,estado nutricional en menores de 5 anos,clasificacion f,2003-07-01,10,3,10,3,13
21001,INQUISIVI,estado nutricional en menores de 5 anos,clasificacion f,2003-07-01,8,3,8,3,11
21501,IXIAMAS,estado nutricional en menores de 5 anos,clasificacion f,2003-07-01,2,0,2,0,2
21105,LA ASUNTA,estado nutricional en menores de 5 anos,clasificacion f,2003-07-01,2,1,2,1,3
70104,LA GUARDIA,estado nutricional en menores de 5 anos,clasificacion f,2003-07-01,5,3,5,3,8
20101,LA PAZ,estado nutricional en menores de 5 anos,clasificacion f,2003-07-01,30,16,30,16,46
70701,LAGUNILLAS,estado nutricional en menores de 5 anos,clasificacion f,2003-07-01,1,2,1,2,3
10903,LAS CARRERAS,estado nutricional en menores de 5 anos,clasificacion f,2003-07-01,5,1,5,1,6
50203,LLALLAGUA,estado nutricional en menores de 5 anos,clasificacion f,2003-07-01,1,3,1,3,4
80601,LORETO,estado nutricional en menores de 5 anos,clasificacion f,2003-07-01,2,0,2,0,2
20901,LURIBAY,estado nutricional en menores de 5 anos,clasificacion f,2003-07-01,2,0,2,0,2
40702,MACHACAMARCA,estado nutricional en menores de 5 anos,clasificacion f,2003-07-01,1,0,1,0,1
11003,MACHARETI,estado nutricional en menores de 5 anos,clasificacion f,2003-07-01,4,4,4,4,8
80801,MAGDALENA,estado nutricional en menores de 5 anos,clasificacion f,2003-07-01,6,0,6,0,6
70903,MAIRANA,estado nutricional en menores de 5 anos,clasificacion f,2003-07-01,2,0,2,0,2
71003,MINEROS,estado nutricional en menores de 5 anos,clasificacion f,2003-07-01,8,2,8,2,10
31301,MIZQUE,estado nutricional en menores de 5 anos,clasificacion f,2003-07-01,3,0,3,0,3
20402,MOCOMOCO,estado nutricional en menores de 5 anos,clasificacion f,2003-07-01,4,1,4,1,5
10303,MOJOCOYA,estado nutricional en menores de 5 anos,clasificacion f,2003-07-01,2,1,2,1,3
10501,MONTEAGUDO,estado nutricional en menores de 5 anos,clasificacion f,2003-07-01,6,1,6,1,7
71001,MONTERO,estado nutricional en menores de 5 anos,clasificacion f,2003-07-01,6,4,6,4,10
70803,MORO MORO,estado nutricional en menores de 5 anos,clasificacion f,2003-07-01,1,0,1,0,1
30302,MOROCHATA,estado nutricional en menores de 5 anos,clasificacion f,2003-07-01,22,8,22,8,30
50404,OCURI,estado nutricional en menores de 5 anos,clasificacion f,2003-07-01,12,5,12,5,17
70202,OKINAWA,estado nutricional en menores de 5 anos,clasificacion f,2003-07-01,0,1,0,1,1
40101,ORURO,estado nutricional en menores de 5 anos,clasificacion f,2003-07-01,9,6,9,6,15
60201,PADCAYA,estado nutricional en menores de 5 anos,clasificacion f,2003-07-01,0,1,0,1,1
10401,PADILLA,estado nutricional en menores de 5 anos,clasificacion f,2003-07-01,2,1,2,1,3
20102,PALCA,estado nutricional en menores de 5 anos,clasificacion f,2003-07-01,0,1,0,1,1
21104,PALOS BLANCOS,estado nutricional en menores de 5 anos,clasificacion f,2003-07-01,3,2,3,2,5
70902,PAMPA GRANDE,estado nutricional en menores de 5 anos,clasificacion f,2003-07-01,2,1,2,1,3
30202,PASORAPA,estado nutricional en menores de 5 anos,clasificacion f,2003-07-01,2,0,2,0,2
21305,PATACAMAYA,estado nutricional en menores de 5 anos,clasificacion f,2003-07-01,6,2,6,2,8
20702,PELECHUCO,estado nutricional en menores de 5 anos,clasificacion f,2003-07-01,1,0,1,0,1
50403,POCOATA,estado nutricional en menores de 5 anos,clasificacion f,2003-07-01,6,4,6,4,10
31203,POCONA,estado nutricional en menores de 5 anos,clasificacion f,2003-07-01,3,2,3,2,5
31202,POJO (CBBA),estado nutricional en menores de 5 anos,clasificacion f,2003-07-01,3,1,3,1,4
51203,PORCO,estado nutricional en menores de 5 anos,clasificacion f,2003-07-01,0,1,0,1,1
10103,POROMA,estado nutricional en menores de 5 anos,clasificacion f,2003-07-01,13,9,13,9,22
70601,PORTACHUELO,estado nutricional en menores de 5 anos,clasificacion f,2003-07-01,3,0,3,0,3
90102,PORVENIR,estado nutricional en menores de 5 anos,clasificacion f,2003-07-01,1,0,1,0,1
70804,POSTRER VALLE,estado nutricional en menores de 5 anos,clasificacion f,2003-07-01,2,1,2,1,3
50101,POTOSI,estado nutricional en menores de 5 anos,clasificacion f,2003-07-01,36,16,36,16,52
10302,PRESTO,estado nutricional en menores de 5 anos,clasificacion f,2003-07-01,3,5,3,5,8
20401,PUERTO ACOSTA,estado nutricional en menores de 5 anos,clasificacion f,2003-07-01,0,1,0,1,1
20403,PUERTO CARABUCO,estado nutricional en menores de 5 anos,clasificacion f,2003-07-01,2,2,2,2,4
90301,PUERTO GONZALO MORENO,estado nutricional en menores de 5 anos,clasificacion f,2003-07-01,1,0,1,0,1
71402,PUERTO QUIJARRO,estado nutricional en menores de 5 anos,clasificacion f,2003-07-01,1,0,1,0,1
71401,PUERTO SUAREZ,estado nutricional en menores de 5 anos,clasificacion f,2003-07-01,1,2,1,2,3
31205,PUERTO VILLARROEL,estado nutricional en menores de 5 anos,clasificacion f,2003-07-01,10,13,10,13,23
51101,PUNA,estado nutricional en menores de 5 anos,clasificacion f,2003-07-01,14,13,14,13,27
31401,PUNATA,estado nutricional en menores de 5 anos,clasificacion f,2003-07-01,4,5,4,5,9
20604,QUIABAYA,estado nutricional en menores de 5 anos,clasificacion f,2003-07-01,1,0,1,0,1
30901,QUILLACOLLO,estado nutricional en menores de 5 anos,clasificacion f,2003-07-01,5,1,5,1,6
21002,QUIME,estado nutricional en menores de 5 anos,clasificacion f,2003-07-01,4,0,4,0,4
50402,RAVELO,estado nutricional en menores de 5 anos,clasificacion f,2003-07-01,16,6,16,6,22
80301,REYES,estado nutricional en menores de 5 anos,clasificacion f,2003-07-01,0,1,0,1,1
80201,RIBERALTA,estado nutricional en menores de 5 anos,clasificacion f,2003-07-01,39,31,39,31,70
70503,ROBORE,estado nutricional en menores de 5 anos,clasificacion f,2003-07-01,3,1,3,1,4
31001,SACABA,estado nutricional en menores de 5 anos,clasificacion f,2003-07-01,4,2,4,2,6
30404,SACABAMBA,estado nutricional en menores de 5 anos,clasificacion f,2003-07-01,2,2,2,2,4
50701,SACACA,estado nutricional en menores de 5 anos,clasificacion f,2003-07-01,29,20,29,20,49
71302,SAIPINA,estado nutricional en menores de 5 anos,clasificacion f,2003-07-01,1,0,1,0,1
40801,SALINAS DE GARCI MENDOZA,estado nutricional en menores de 5 anos,clasificacion f,2003-07-01,0,3,0,3,3
80602,SAN ANDRES,estado nutricional en menores de 5 anos,clasificacion f,2003-07-01,1,2,1,2,3
71105,SAN ANTONIO DE LOMERIO,estado nutricional en menores de 5 anos,clasificacion f,2003-07-01,9,7,9,7,16
80302,SAN BORJA,estado nutricional en menores de 5 anos,clasificacion f,2003-07-01,8,4,8,4,12
21502,SAN BUENA VENTURA,estado nutricional en menores de 5 anos,clasificacion f,2003-07-01,3,0,3,0,3
70402,SAN CARLOS,estado nutricional en menores de 5 anos,clasificacion f,2003-07-01,2,1,2,1,3
80501,SAN IGNACIO,estado nutricional en menores de 5 anos,clasificacion f,2003-07-01,9,2,9,2,11
70301,SAN IGNACIO DE VELASCO,estado nutricional en menores de 5 anos,clasificacion f,2003-07-01,14,7,14,7,21
71102,SAN JAVIER(STC),estado nutricional en menores de 5 anos,clasificacion f,2003-07-01,2,1,2,1,3
70501,SAN JOSE DE CHIQUITOS,estado nutricional en menores de 5 anos,clasificacion f,2003-07-01,0,2,0,2,2
71104,SAN JULIAN,estado nutricional en menores de 5 anos,clasificacion f,2003-07-01,0,9,0,9,9
90302,SAN LORENZO(PND),estado nutricional en menores de 5 anos,clasificacion f,2003-07-01,0,1,0,1,1
60501,SAN LORENZO(TJA),estado nutricional en menores de 5 anos,clasificacion f,2003-07-01,1,1,1,1,2
10702,SAN LUCAS,estado nutricional en menores de 5 anos,clasificacion f,2003-07-01,24,7,24,7,31
70302,SAN MIGUEL DE VELASCO,estado nutricional en menores de 5 anos,clasificacion f,2003-07-01,1,1,1,1,2
50501,SAN PEDRO DE BUENA VISTA,estado nutricional en menores de 5 anos,clasificacion f,2003-07-01,17,10,17,10,27
70303,SAN RAFAEL,estado nutricional en menores de 5 anos,clasificacion f,2003-07-01,1,1,1,1,2
80401,SANTA ANA,estado nutricional en menores de 5 anos,clasificacion f,2003-07-01,2,2,2,2,4
70101,SANTA CRUZ DE LA SIERRA,estado nutricional en menores de 5 anos,clasificacion f,2003-07-01,15,9,15,9,24
20308,SANTIAGO DE CALLAPA,estado nutricional en menores de 5 anos,clasificacion f,2003-07-01,0,1,0,1,1
41401,SANTIAGO DE HUARI,estado nutricional en menores de 5 anos,clasificacion f,2003-07-01,0,2,0,2,2
30702,SANTIVAÑES,estado nutricional en menores de 5 anos,clasificacion f,2003-07-01,0,2,0,2,2
20902,SAPAHAQUI,estado nutricional en menores de 5 anos,clasificacion f,2003-07-01,0,3,0,3,3
90303,SENA,estado nutricional en menores de 5 anos,clasificacion f,2003-07-01,1,0,1,0,1
21301,SICA SICA (VILLA AROMA),estado nutricional en menores de 5 anos,clasificacion f,2003-07-01,6,2,6,2,8
30703,SICAYA,estado nutricional en menores de 5 anos,clasificacion f,2003-07-01,1,1,1,1,2
30902,SIPE SIPE,estado nutricional en menores de 5 anos,clasificacion f,2003-07-01,7,4,7,4,11
10403,SOPACHUY,estado nutricional en menores de 5 anos,clasificacion f,2003-07-01,18,7,18,7,25
20601,SORATA,estado nutricional en menores de 5 anos,clasificacion f,2003-07-01,3,1,3,1,4
10101,SUCRE,estado nutricional en menores de 5 anos,clasificacion f,2003-07-01,29,9,29,9,38
50303,TACOBAMBA,estado nutricional en menores de 5 anos,clasificacion f,2003-07-01,3,0,3,0,3
30602,TACOPAYA,estado nutricional en menores de 5 anos,clasificacion f,2003-07-01,7,2,7,2,9
31101,TAPACARI,estado nutricional en menores de 5 anos,clasificacion f,2003-07-01,7,5,7,5,12
10601,TARABUCO,estado nutricional en menores de 5 anos,clasificacion f,2003-07-01,33,19,33,19,52
30401,TARATA,estado nutricional en menores de 5 anos,clasificacion f,2003-07-01,4,1,4,1,5
60101,TARIJA,estado nutricional en menores de 5 anos,clasificacion f,2003-07-01,8,2,8,2,10
10202,TARVITA,estado nutricional en menores de 5 anos,clasificacion f,2003-07-01,20,16,20,16,36
50102,TINGUIPAYA,estado nutricional en menores de 5 anos,clasificacion f,2003-07-01,2,0,2,0,2
20606,TIPUANI,estado nutricional en menores de 5 anos,clasificacion f,2003-07-01,0,1,0,1,1
30903,TIQUIPAYA,estado nutricional en menores de 5 anos,clasificacion f,2003-07-01,1,0,1,0,1
31601,TIRAQUE (CBBA),estado nutricional en menores de 5 anos,clasificacion f,2003-07-01,13,5,13,5,18
30803,TOLATA,estado nutricional en menores de 5 anos,clasificacion f,2003-07-01,0,1,0,1,1
51202,TOMAVE,estado nutricional en menores de 5 anos,clasificacion f,2003-07-01,4,0,4,0,4
10402,TOMINA,estado nutricional en menores de 5 anos,clasificacion f,2003-07-01,15,6,15,6,21
50502,TORO TORO,estado nutricional en menores de 5 anos,clasificacion f,2003-07-01,8,4,8,4,12
31201,TOTORA(CBBA),estado nutricional en menores de 5 anos,clasificacion f,2003-07-01,4,2,4,2,6
41301,TOTORA(ORR),estado nutricional en menores de 5 anos,clasificacion f,2003-07-01,0,1,0,1,1
80101,TRINIDAD,estado nutricional en menores de 5 anos,clasificacion f,2003-07-01,16,3,16,3,19
50801,TUPIZA,estado nutricional en menores de 5 anos,clasificacion f,2003-07-01,2,2,2,2,4
21302,UMALA,estado nutricional en menores de 5 anos,clasificacion f,2003-07-01,0,1,0,1,1
50201,UNCIA,estado nutricional en menores de 5 anos,clasificacion f,2003-07-01,0,1,0,1,1
60401,URIONDO (A. CONCEPCION),estado nutricional en menores de 5 anos,clasificacion f,2003-07-01,0,1,0,1,1
51201,UYUNI,estado nutricional en menores de 5 anos,clasificacion f,2003-07-01,1,3,1,3,4
30502,VACAS,estado nutricional en menores de 5 anos,clasificacion f,2003-07-01,1,0,1,0,1
70801,VALLEGRANDE,estado nutricional en menores de 5 anos,clasificacion f,2003-07-01,2,0,2,0,2
20801,VIACHA,estado nutricional en menores de 5 anos,clasificacion f,2003-07-01,1,0,1,0,1
31302,VILA VILA,estado nutricional en menores de 5 anos,clasificacion f,2003-07-01,1,0,1,0,1
60303,VILLA MONTES,estado nutricional en menores de 5 anos,clasificacion f,2003-07-01,7,3,7,3,10
31402,VILLA RIVERO,estado nutricional en menores de 5 anos,clasificacion f,2003-07-01,2,0,2,0,2
10801,VILLA SERRANO,estado nutricional en menores de 5 anos,clasificacion f,2003-07-01,13,8,13,8,21
31003,VILLA TUNARI,estado nutricional en menores de 5 anos,clasificacion f,2003-07-01,18,10,18,10,28
11001,VILLA VACA GUZMAN (MUYUPAMPA),estado nutricional en menores de 5 anos,clasificacion f,2003-07-01,3,0,3,0,3
51501,VILLAZON,estado nutricional en menores de 5 anos,clasificacion f,2003-07-01,2,0,2,0,2
30904,VINTO,estado nutricional en menores de 5 anos,clasificacion f,2003-07-01,11,3,11,3,14
50602,VITICHI,estado nutricional en menores de 5 anos,clasificacion f,2003-07-01,4,1,4,1,5
20903,YACO,estado nutricional en menores de 5 anos,clasificacion f,2003-07-01,4,6,4,6,10
60301,YACUIBA,estado nutricional en menores de 5 anos,clasificacion f,2003-07-01,3,3,3,3,6
10602,YAMPARAEZ,estado nutricional en menores de 5 anos,clasificacion f,2003-07-01,14,5,14,5,19
21103,YANACACHI,estado nutricional en menores de 5 anos,clasificacion f,2003-07-01,1,0,1,0,1
70403,YAPACANI,estado nutricional en menores de 5 anos,clasificacion f,2003-07-01,7,8,7,8,15
10102,YOTALA,estado nutricional en menores de 5 anos,clasificacion f,2003-07-01,6,0,6,0,6
60402,YUNCHARA,estado nutricional en menores de 5 anos,clasificacion f,2003-07-01,1,1,1,1,2
10301,ZUDAÑEZ,estado nutricional en menores de 5 anos,clasificacion f,2003-07-01,9,2,9,2,11
51302,ACACIO,estado nutricional en menores de 5 anos,clasificacion f,2003-08-01,15,6,15,6,21
20201,ACHACACHI,estado nutricional en menores de 5 anos,clasificacion f,2003-08-01,2,1,2,1,3
30201,AIQUILE,estado nutricional en menores de 5 anos,clasificacion f,2003-08-01,3,2,3,2,5
31303,ALALAY,estado nutricional en menores de 5 anos,clasificacion f,2003-08-01,0,1,0,1,1
10404,ALCALA,estado nutricional en menores de 5 anos,clasificacion f,2003-08-01,2,7,2,7,9
20202,ANCORAIMES,estado nutricional en menores de 5 anos,clasificacion f,2003-08-01,0,1,0,1,1
20701,APOLO,estado nutricional en menores de 5 anos,clasificacion f,2003-08-01,1,0,1,0,1
51301,ARAMPAMPA,estado nutricional en menores de 5 anos,clasificacion f,2003-08-01,4,1,4,1,5
30501,ARANI,estado nutricional en menores de 5 anos,clasificacion f,2003-08-01,2,2,2,2,4
30601,ARQUE,estado nutricional en menores de 5 anos,clasificacion f,2003-08-01,1,2,1,2,3
71501,ASCENCION DE GUARAYOS,estado nutricional en menores de 5 anos,clasificacion f,2003-08-01,14,8,14,8,22
50802,ATOCHA,estado nutricional en menores de 5 anos,clasificacion f,2003-08-01,4,3,4,3,7
20503,AUCAPATA,estado nutricional en menores de 5 anos,clasificacion f,2003-08-01,2,4,2,4,6
20502,AYATA,estado nutricional en menores de 5 anos,clasificacion f,2003-08-01,5,0,5,0,5
30301,AYOPAYA (V. DE INDEPENDENCIA),estado nutricional en menores de 5 anos,clasificacion f,2003-08-01,7,4,7,4,11
10201,AZURDUY,estado nutricional en menores de 5 anos,clasificacion f,2003-08-01,19,12,19,12,31
50104,BELEN DE URMIRI,estado nutricional en menores de 5 anos,clasificacion f,2003-08-01,1,0,1,0,1
60202,BERMEJO,estado nutricional en menores de 5 anos,clasificacion f,2003-08-01,2,0,2,0,2
50301,BETANZOS,estado nutricional en menores de 5 anos,clasificacion f,2003-08-01,26,11,26,11,37
31501,BOLIVAR,estado nutricional en menores de 5 anos,clasificacion f,2003-08-01,9,0,9,0,9
70707,BOYUIBE,estado nutricional en menores de 5 anos,clasificacion f,2003-08-01,1,0,1,0,1
70401,BUENA VISTA,estado nutricional en menores de 5 anos,clasificacion f,2003-08-01,0,1,0,1,1
70703,CABEZAS,estado nutricional en menores de 5 anos,clasificacion f,2003-08-01,1,0,1,0,1
20905,CAIROMA,estado nutricional en menores de 5 anos,clasificacion f,2003-08-01,5,2,5,2,7
51102,"CAIZA ""D""",estado nutricional en menores de 5 anos,clasificacion f,2003-08-01,5,1,5,1,6
21003,CAJUATA,estado nutricional en menores de 5 anos,clasificacion f,2003-08-01,3,2,3,2,5
20303,CALACOTO,estado nutricional en menores de 5 anos,clasificacion f,2003-08-01,0,1,0,1,1
21304,CALAMARCA,estado nutricional en menores de 5 anos,clasificacion f,2003-08-01,9,3,9,3,12
10701,CAMARGO,estado nutricional en menores de 5 anos,clasificacion f,2003-08-01,1,0,1,0,1
70706,CAMIRI,estado nutricional en menores de 5 anos,clasificacion f,2003-08-01,4,3,4,3,7
30701,CAPINOTA,estado nutricional en menores de 5 anos,clasificacion f,2003-08-01,3,3,3,3,6
22001,CARANAVI,estado nutricional en menores de 5 anos,clasificacion f,2003-08-01,11,7,11,7,18
60302,CARAPARI,estado nutricional en menores de 5 anos,clasificacion f,2003-08-01,3,2,3,2,5
50702,CARIPUYO,estado nutricional en menores de 5 anos,clasificacion f,2003-08-01,7,1,7,1,8
40201,CHALLAPATA,estado nutricional en menores de 5 anos,clasificacion f,2003-08-01,8,3,8,3,11
50302,CHAQUI,estado nutricional en menores de 5 anos,clasificacion f,2003-08-01,2,2,2,2,4
70702,CHARAGUA,estado nutricional en menores de 5 anos,clasificacion f,2003-08-01,6,9,6,9,15
50202,CHAYANTA,estado nutricional en menores de 5 anos,clasificacion f,2003-08-01,3,1,3,1,4
20501,CHUMA,estado nutricional en menores de 5 anos,clasificacion f,2003-08-01,5,1,5,1,6
90101,COBIJA,estado nutricional en menores de 5 anos,clasificacion f,2003-08-01,4,5,4,5,9
30101,COCHABAMBA,estado nutricional en menores de 5 anos,clasificacion f,2003-08-01,6,4,6,4,10
50901,"COLCHA ""K""",estado nutricional en menores de 5 anos,clasificacion f,2003-08-01,0,1,0,1,1
50401,COLQUECHACA,estado nutricional en menores de 5 anos,clasificacion f,2003-08-01,19,8,19,8,27
21306,COLQUENCHA,estado nutricional en menores de 5 anos,clasificacion f,2003-08-01,0,2,0,2,2
21004,COLQUIRI,estado nutricional en menores de 5 anos,clasificacion f,2003-08-01,3,0,3,0,3
71301,COMARAPA,estado nutricional en menores de 5 anos,clasificacion f,2003-08-01,1,2,1,2,3
21701,COPACABANA,estado nutricional en menores de 5 anos,clasificacion f,2003-08-01,1,0,1,0,1
21401,COROICO,estado nutricional en menores de 5 anos,clasificacion f,2003-08-01,1,0,1,0,1
50601,COTAGAITA,estado nutricional en menores de 5 anos,clasificacion f,2003-08-01,13,8,13,8,21
10902,CULPINA,estado nutricional en menores de 5 anos,clasificacion f,2003-08-01,4,0,4,0,4
21602,CURVA,estado nutricional en menores de 5 anos,clasificacion f,2003-08-01,0,1,0,1,1
20105,EL ALTO,estado nutricional en menores de 5 anos,clasificacion f,2003-08-01,59,28,59,28,87
71503,EL PUENTE(STC),estado nutricional en menores de 5 anos,clasificacion f,2003-08-01,0,2,0,2,2
60502,EL PUENTE(TJA),estado nutricional en menores de 5 anos,clasificacion f,2003-08-01,1,0,1,0,1
70105,EL TORNO,estado nutricional en menores de 5 anos,clasificacion f,2003-08-01,1,0,1,0,1
10405,EL VILLAR,estado nutricional en menores de 5 anos,clasificacion f,2003-08-01,4,2,4,2,6
60601,ENTRE RIOS,estado nutricional en menores de 5 anos,clasificacion f,2003-08-01,4,2,4,2,6
80402,EXALTACION,estado nutricional en menores de 5 anos,clasificacion f,2003-08-01,0,2,0,2,2
71002,GENERAL SAAVEDRA,estado nutricional en menores de 5 anos,clasificacion f,2003-08-01,10,7,10,7,17
21601,GRAL. J.J. PEREZ (CHARAZANI),estado nutricional en menores de 5 anos,clasificacion f,2003-08-01,3,4,3,4,7
20602,GUANAY,estado nutricional en menores de 5 anos,clasificacion f,2003-08-01,5,3,5,3,8
20802,GUAQUI,estado nutricional en menores de 5 anos,clasificacion f,2003-08-01,0,1,0,1,1
80202,GUAYARAMERIN,estado nutricional en menores de 5 anos,clasificacion f,2003-08-01,4,2,4,2,6
70705,GUTIERREZ,estado nutricional en menores de 5 anos,clasificacion f,2003-08-01,6,1,6,1,7
10502,HUACARETA,estado nutricional en menores de 5 anos,clasificacion f,2003-08-01,1,0,1,0,1
11002,HUACAYA (VILLA DE HUACAYA),estado nutricional en menores de 5 anos,clasificacion f,2003-08-01,2,1,2,1,3
40701,HUANUNI,estado nutricional en menores de 5 anos,clasificacion f,2003-08-01,0,1,0,1,1
10304,ICLA,estado nutricional en menores de 5 anos,clasificacion f,2003-08-01,2,3,2,3,5
10703,INCAHUASI,estado nutricional en menores de 5 anos,clasificacion f,2003-08-01,14,8,14,8,22
21001,INQUISIVI,estado nutricional en menores de 5 anos,clasificacion f,2003-08-01,6,1,6,1,7
21501,IXIAMAS,estado nutricional en menores de 5 anos,clasificacion f,2003-08-01,2,2,2,2,4
21105,LA ASUNTA,estado nutricional en menores de 5 anos,clasificacion f,2003-08-01,1,4,1,4,5
70104,LA GUARDIA,estado nutricional en menores de 5 anos,clasificacion f,2003-08-01,2,2,2,2,4
20101,LA PAZ,estado nutricional en menores de 5 anos,clasificacion f,2003-08-01,25,11,25,11,36
21202,LAJA,estado nutricional en menores de 5 anos,clasificacion f,2003-08-01,1,0,1,0,1
10903,LAS CARRERAS,estado nutricional en menores de 5 anos,clasificacion f,2003-08-01,0,1,0,1,1
50203,LLALLAGUA,estado nutricional en menores de 5 anos,clasificacion f,2003-08-01,0,9,0,9,9
20901,LURIBAY,estado nutricional en menores de 5 anos,clasificacion f,2003-08-01,1,0,1,0,1
11003,MACHARETI,estado nutricional en menores de 5 anos,clasificacion f,2003-08-01,3,5,3,5,8
80801,MAGDALENA,estado nutricional en menores de 5 anos,clasificacion f,2003-08-01,0,2,0,2,2
71003,MINEROS,estado nutricional en menores de 5 anos,clasificacion f,2003-08-01,6,1,6,1,7
31301,MIZQUE,estado nutricional en menores de 5 anos,clasificacion f,2003-08-01,3,0,3,0,3
20402,MOCOMOCO,estado nutricional en menores de 5 anos,clasificacion f,2003-08-01,2,4,2,4,6
10303,MOJOCOYA,estado nutricional en menores de 5 anos,clasificacion f,2003-08-01,4,2,4,2,6
10501,MONTEAGUDO,estado nutricional en menores de 5 anos,clasificacion f,2003-08-01,9,5,9,5,14
71001,MONTERO,estado nutricional en menores de 5 anos,clasificacion f,2003-08-01,13,6,13,6,19
30302,MOROCHATA,estado nutricional en menores de 5 anos,clasificacion f,2003-08-01,9,4,9,4,13
50404,OCURI,estado nutricional en menores de 5 anos,clasificacion f,2003-08-01,14,8,14,8,22
40101,ORURO,estado nutricional en menores de 5 anos,clasificacion f,2003-08-01,17,10,17,10,27
10401,PADILLA,estado nutricional en menores de 5 anos,clasificacion f,2003-08-01,5,3,5,3,8
70502,PAILON,estado nutricional en menores de 5 anos,clasificacion f,2003-08-01,2,0,2,0,2
20102,PALCA,estado nutricional en menores de 5 anos,clasificacion f,2003-08-01,1,2,1,2,3
21104,PALOS BLANCOS,estado nutricional en menores de 5 anos,clasificacion f,2003-08-01,1,0,1,0,1
40802,PAMPA AULLAGAS,estado nutricional en menores de 5 anos,clasificacion f,2003-08-01,1,0,1,0,1
30202,PASORAPA,estado nutricional en menores de 5 anos,clasificacion f,2003-08-01,2,0,2,0,2
21305,PATACAMAYA,estado nutricional en menores de 5 anos,clasificacion f,2003-08-01,4,2,4,2,6
40602,PAZÑA,estado nutricional en menores de 5 anos,clasificacion f,2003-08-01,2,0,2,0,2
50403,POCOATA,estado nutricional en menores de 5 anos,clasificacion f,2003-08-01,7,3,7,3,10
31203,POCONA,estado nutricional en menores de 5 anos,clasificacion f,2003-08-01,7,3,7,3,10
31202,POJO (CBBA),estado nutricional en menores de 5 anos,clasificacion f,2003-08-01,7,1,7,1,8
51203,PORCO,estado nutricional en menores de 5 anos,clasificacion f,2003-08-01,2,2,2,2,4
10103,POROMA,estado nutricional en menores de 5 anos,clasificacion f,2003-08-01,13,7,13,7,20
70601,PORTACHUELO,estado nutricional en menores de 5 anos,clasificacion f,2003-08-01,1,1,1,1,2
90102,PORVENIR,estado nutricional en menores de 5 anos,clasificacion f,2003-08-01,1,0,1,0,1
50101,POTOSI,estado nutricional en menores de 5 anos,clasificacion f,2003-08-01,20,7,20,7,27
10302,PRESTO,estado nutricional en menores de 5 anos,clasificacion f,2003-08-01,4,5,4,5,9
20401,PUERTO ACOSTA,estado nutricional en menores de 5 anos,clasificacion f,2003-08-01,1,0,1,0,1
20403,PUERTO CARABUCO,estado nutricional en menores de 5 anos,clasificacion f,2003-08-01,3,1,3,1,4
71401,PUERTO SUAREZ,estado nutricional en menores de 5 anos,clasificacion f,2003-08-01,0,2,0,2,2
31205,PUERTO VILLARROEL,estado nutricional en menores de 5 anos,clasificacion f,2003-08-01,16,10,16,10,26
51101,PUNA,estado nutricional en menores de 5 anos,clasificacion f,2003-08-01,2,0,2,0,2
31401,PUNATA,estado nutricional en menores de 5 anos,clasificacion f,2003-08-01,5,4,5,4,9
20604,QUIABAYA,estado nutricional en menores de 5 anos,clasificacion f,2003-08-01,1,0,1,0,1
30901,QUILLACOLLO,estado nutricional en menores de 5 anos,clasificacion f,2003-08-01,4,1,4,1,5
21002,QUIME,estado nutricional en menores de 5 anos,clasificacion f,2003-08-01,2,0,2,0,2
50402,RAVELO,estado nutricional en menores de 5 anos,clasificacion f,2003-08-01,18,10,18,10,28
80201,RIBERALTA,estado nutricional en menores de 5 anos,clasificacion f,2003-08-01,24,13,24,13,37
70503,ROBORE,estado nutricional en menores de 5 anos,clasificacion f,2003-08-01,3,0,3,0,3
80304,RURRENABAQUE,estado nutricional en menores de 5 anos,clasificacion f,2003-08-01,1,1,1,1,2
31001,SACABA,estado nutricional en menores de 5 anos,clasificacion f,2003-08-01,8,1,8,1,9
30404,SACABAMBA,estado nutricional en menores de 5 anos,clasificacion f,2003-08-01,2,4,2,4,6
50701,SACACA,estado nutricional en menores de 5 anos,clasificacion f,2003-08-01,23,14,23,14,37
71302,SAIPINA,estado nutricional en menores de 5 anos,clasificacion f,2003-08-01,1,0,1,0,1
70901,SAMAIPATA,estado nutricional en menores de 5 anos,clasificacion f,2003-08-01,2,0,2,0,2
71105,SAN ANTONIO DE LOMERIO,estado nutricional en menores de 5 anos,clasificacion f,2003-08-01,3,6,3,6,9
80302,SAN BORJA,estado nutricional en menores de 5 anos,clasificacion f,2003-08-01,6,2,6,2,8
70402,SAN CARLOS,estado nutricional en menores de 5 anos,clasificacion f,2003-08-01,2,0,2,0,2
80501,SAN IGNACIO,estado nutricional en menores de 5 anos,clasificacion f,2003-08-01,8,4,8,4,12
70301,SAN IGNACIO DE VELASCO,estado nutricional en menores de 5 anos,clasificacion f,2003-08-01,18,17,18,17,35
71102,SAN JAVIER(STC),estado nutricional en menores de 5 anos,clasificacion f,2003-08-01,1,1,1,1,2
70501,SAN JOSE DE CHIQUITOS,estado nutricional en menores de 5 anos,clasificacion f,2003-08-01,1,1,1,1,2
71104,SAN JULIAN,estado nutricional en menores de 5 anos,clasificacion f,2003-08-01,8,1,8,1,9
60501,SAN LORENZO(TJA),estado nutricional en menores de 5 anos,clasificacion f,2003-08-01,6,2,6,2,8
10702,SAN LUCAS,estado nutricional en menores de 5 anos,clasificacion f,2003-08-01,25,8,25,8,33
71201,SAN MATIAS,estado nutricional en menores de 5 anos,clasificacion f,2003-08-01,6,3,6,3,9
70302,SAN MIGUEL DE VELASCO,estado nutricional en menores de 5 anos,clasificacion f,2003-08-01,2,2,2,2,4
50501,SAN PEDRO DE BUENA VISTA,estado nutricional en menores de 5 anos,clasificacion f,2003-08-01,11,10,11,10,21
21801,SAN PEDRO DE CURAHUARA,estado nutricional en menores de 5 anos,clasificacion f,2003-08-01,1,1,1,1,2
70303,SAN RAFAEL,estado nutricional en menores de 5 anos,clasificacion f,2003-08-01,1,0,1,0,1
80401,SANTA ANA,estado nutricional en menores de 5 anos,clasificacion f,2003-08-01,6,2,6,2,8
70101,SANTA CRUZ DE LA SIERRA,estado nutricional en menores de 5 anos,clasificacion f,2003-08-01,19,8,19,8,27
20308,SANTIAGO DE CALLAPA,estado nutricional en menores de 5 anos,clasificacion f,2003-08-01,1,1,1,1,2
41401,SANTIAGO DE HUARI,estado nutricional en menores de 5 anos,clasificacion f,2003-08-01,0,3,0,3,3
20902,SAPAHAQUI,estado nutricional en menores de 5 anos,clasificacion f,2003-08-01,2,0,2,0,2
90303,SENA,estado nutricional en menores de 5 anos,clasificacion f,2003-08-01,3,0,3,0,3
21301,SICA SICA (VILLA AROMA),estado nutricional en menores de 5 anos,clasificacion f,2003-08-01,5,1,5,1,6
30703,SICAYA,estado nutricional en menores de 5 anos,clasificacion f,2003-08-01,2,0,2,0,2
30902,SIPE SIPE,estado nutricional en menores de 5 anos,clasificacion f,2003-08-01,6,4,6,4,10
10403,SOPACHUY,estado nutricional en menores de 5 anos,clasificacion f,2003-08-01,11,7,11,7,18
20601,SORATA,estado nutricional en menores de 5 anos,clasificacion f,2003-08-01,1,1,1,1,2
10101,SUCRE,estado nutricional en menores de 5 anos,clasificacion f,2003-08-01,18,10,18,10,28
50303,TACOBAMBA,estado nutricional en menores de 5 anos,clasificacion f,2003-08-01,5,0,5,0,5
30602,TACOPAYA,estado nutricional en menores de 5 anos,clasificacion f,2003-08-01,8,0,8,0,8
51402,TAHUA,estado nutricional en menores de 5 anos,clasificacion f,2003-08-01,1,0,1,0,1
31101,TAPACARI,estado nutricional en menores de 5 anos,clasificacion f,2003-08-01,4,2,4,2,6
10601,TARABUCO,estado nutricional en menores de 5 anos,clasificacion f,2003-08-01,34,15,34,15,49
30401,TARATA,estado nutricional en menores de 5 anos,clasificacion f,2003-08-01,1,1,1,1,2
60101,TARIJA,estado nutricional en menores de 5 anos,clasificacion f,2003-08-01,3,1,3,1,4
10202,TARVITA,estado nutricional en menores de 5 anos,clasificacion f,2003-08-01,21,14,21,14,35
50102,TINGUIPAYA,estado nutricional en menores de 5 anos,clasificacion f,2003-08-01,9,2,9,2,11
20606,TIPUANI,estado nutricional en menores de 5 anos,clasificacion f,2003-08-01,0,1,0,1,1
31601,TIRAQUE (CBBA),estado nutricional en menores de 5 anos,clasificacion f,2003-08-01,10,4,10,4,14
21703,TITO YUPANQUI (PARQUIPUJIO),estado nutricional en menores de 5 anos,clasificacion f,2003-08-01,1,0,1,0,1
30803,TOLATA,estado nutricional en menores de 5 anos,clasificacion f,2003-08-01,1,0,1,0,1
51202,TOMAVE,estado nutricional en menores de 5 anos,clasificacion f,2003-08-01,4,2,4,2,6
10402,TOMINA,estado nutricional en menores de 5 anos,clasificacion f,2003-08-01,16,10,16,10,26
50502,TORO TORO,estado nutricional en menores de 5 anos,clasificacion f,2003-08-01,13,6,13,6,19
31201,TOTORA(CBBA),estado nutricional en menores de 5 anos,clasificacion f,2003-08-01,2,1,2,1,3
41301,TOTORA(ORR),estado nutricional en menores de 5 anos,clasificacion f,2003-08-01,0,1,0,1,1
80101,TRINIDAD,estado nutricional en menores de 5 anos,clasificacion f,2003-08-01,2,3,2,3,5
50801,TUPIZA,estado nutricional en menores de 5 anos,clasificacion f,2003-08-01,2,2,2,2,4
50201,UNCIA,estado nutricional en menores de 5 anos,clasificacion f,2003-08-01,4,0,4,0,4
71502,URUBICHA,estado nutricional en menores de 5 anos,clasificacion f,2003-08-01,7,7,7,7,14
51201,UYUNI,estado nutricional en menores de 5 anos,clasificacion f,2003-08-01,2,1,2,1,3
30502,VACAS,estado nutricional en menores de 5 anos,clasificacion f,2003-08-01,1,1,1,1,2
70801,VALLEGRANDE,estado nutricional en menores de 5 anos,clasificacion f,2003-08-01,0,2,0,2,2
20801,VIACHA,estado nutricional en menores de 5 anos,clasificacion f,2003-08-01,2,0,2,0,2
31302,VILA VILA,estado nutricional en menores de 5 anos,clasificacion f,2003-08-01,5,1,5,1,6
60303,VILLA MONTES,estado nutricional en menores de 5 anos,clasificacion f,2003-08-01,2,2,2,2,4
31402,VILLA RIVERO,estado nutricional en menores de 5 anos,clasificacion f,2003-08-01,4,2,4,2,6
10801,VILLA SERRANO,estado nutricional en menores de 5 anos,clasificacion f,2003-08-01,20,10,20,10,30
31003,VILLA TUNARI,estado nutricional en menores de 5 anos,clasificacion f,2003-08-01,8,5,8,5,13
11001,VILLA VACA GUZMAN (MUYUPAMPA),estado nutricional en menores de 5 anos,clasificacion f,2003-08-01,1,1,1,1,2
51501,VILLAZON,estado nutricional en menores de 5 anos,clasificacion f,2003-08-01,0,2,0,2,2
30904,VINTO,estado nutricional en menores de 5 anos,clasificacion f,2003-08-01,10,6,10,6,16
50602,VITICHI,estado nutricional en menores de 5 anos,clasificacion f,2003-08-01,8,7,8,7,15
20903,YACO,estado nutricional en menores de 5 anos,clasificacion f,2003-08-01,4,1,4,1,5
60301,YACUIBA,estado nutricional en menores de 5 anos,clasificacion f,2003-08-01,2,1,2,1,3
10602,YAMPARAEZ,estado nutricional en menores de 5 anos,clasificacion f,2003-08-01,12,3,12,3,15
70403,YAPACANI,estado nutricional en menores de 5 anos,clasificacion f,2003-08-01,10,2,10,2,12
50103,YOCALLA,estado nutricional en menores de 5 anos,clasificacion f,2003-08-01,1,0,1,0,1
10102,YOTALA,estado nutricional en menores de 5 anos,clasificacion f,2003-08-01,4,2,4,2,6
60402,YUNCHARA,estado nutricional en menores de 5 anos,clasificacion f,2003-08-01,1,5,1,5,6
10301,ZUDAÑEZ,estado nutricional en menores de 5 anos,clasificacion f,2003-08-01,2,3,2,3,5
51302,ACACIO,estado nutricional en menores de 5 anos,clasificacion f,2003-09-01,12,5,12,5,17
20201,ACHACACHI,estado nutricional en menores de 5 anos,clasificacion f,2003-09-01,1,2,1,2,3
30201,AIQUILE,estado nutricional en menores de 5 anos,clasificacion f,2003-09-01,3,2,3,2,5
31303,ALALAY,estado nutricional en menores de 5 anos,clasificacion f,2003-09-01,0,1,0,1,1
10404,ALCALA,estado nutricional en menores de 5 anos,clasificacion f,2003-09-01,1,2,1,2,3
20202,ANCORAIMES,estado nutricional en menores de 5 anos,clasificacion f,2003-09-01,1,0,1,0,1
20701,APOLO,estado nutricional en menores de 5 anos,clasificacion f,2003-09-01,3,4,3,4,7
51301,ARAMPAMPA,estado nutricional en menores de 5 anos,clasificacion f,2003-09-01,6,1,6,1,7
30501,ARANI,estado nutricional en menores de 5 anos,clasificacion f,2003-09-01,1,1,1,1,2
30601,ARQUE,estado nutricional en menores de 5 anos,clasificacion f,2003-09-01,3,2,3,2,5
50802,ATOCHA,estado nutricional en menores de 5 anos,clasificacion f,2003-09-01,1,8,1,8,9
20503,AUCAPATA,estado nutricional en menores de 5 anos,clasificacion f,2003-09-01,5,1,5,1,6
20502,AYATA,estado nutricional en menores de 5 anos,clasificacion f,2003-09-01,2,0,2,0,2
21303,AYO AYO,estado nutricional en menores de 5 anos,clasificacion f,2003-09-01,1,0,1,0,1
30301,AYOPAYA (V. DE INDEPENDENCIA),estado nutricional en menores de 5 anos,clasificacion f,2003-09-01,8,1,8,1,9
10201,AZURDUY,estado nutricional en menores de 5 anos,clasificacion f,2003-09-01,12,10,12,10,22
21203,BATALLAS,estado nutricional en menores de 5 anos,clasificacion f,2003-09-01,1,0,1,0,1
90104,BELLA FLOR,estado nutricional en menores de 5 anos,clasificacion f,2003-09-01,0,1,0,1,1
60202,BERMEJO,estado nutricional en menores de 5 anos,clasificacion f,2003-09-01,2,0,2,0,2
50301,BETANZOS,estado nutricional en menores de 5 anos,clasificacion f,2003-09-01,24,3,24,3,27
31501,BOLIVAR,estado nutricional en menores de 5 anos,clasificacion f,2003-09-01,10,4,10,4,14
70401,BUENA VISTA,estado nutricional en menores de 5 anos,clasificacion f,2003-09-01,0,2,0,2,2
70703,CABEZAS,estado nutricional en menores de 5 anos,clasificacion f,2003-09-01,1,0,1,0,1
20905,CAIROMA,estado nutricional en menores de 5 anos,clasificacion f,2003-09-01,4,2,4,2,6
51102,"CAIZA ""D""",estado nutricional en menores de 5 anos,clasificacion f,2003-09-01,6,0,6,0,6
21003,CAJUATA,estado nutricional en menores de 5 anos,clasificacion f,2003-09-01,2,2,2,2,4
21304,CALAMARCA,estado nutricional en menores de 5 anos,clasificacion f,2003-09-01,6,1,6,1,7
10701,CAMARGO,estado nutricional en menores de 5 anos,clasificacion f,2003-09-01,1,1,1,1,2
70706,CAMIRI,estado nutricional en menores de 5 anos,clasificacion f,2003-09-01,3,2,3,2,5
30701,CAPINOTA,estado nutricional en menores de 5 anos,clasificacion f,2003-09-01,3,1,3,1,4
40102,CARACOLLO,estado nutricional en menores de 5 anos,clasificacion f,2003-09-01,0,1,0,1,1
22001,CARANAVI,estado nutricional en menores de 5 anos,clasificacion f,2003-09-01,5,9,5,9,14
60302,CARAPARI,estado nutricional en menores de 5 anos,clasificacion f,2003-09-01,2,2,2,2,4
50702,CARIPUYO,estado nutricional en menores de 5 anos,clasificacion f,2003-09-01,7,2,7,2,9
40201,CHALLAPATA,estado nutricional en menores de 5 anos,clasificacion f,2003-09-01,4,3,4,3,7
50302,CHAQUI,estado nutricional en menores de 5 anos,clasificacion f,2003-09-01,3,0,3,0,3
70702,CHARAGUA,estado nutricional en menores de 5 anos,clasificacion f,2003-09-01,3,1,3,1,4
50202,CHAYANTA,estado nutricional en menores de 5 anos,clasificacion f,2003-09-01,4,1,4,1,5
20501,CHUMA,estado nutricional en menores de 5 anos,clasificacion f,2003-09-01,4,1,4,1,5
90101,COBIJA,estado nutricional en menores de 5 anos,clasificacion f,2003-09-01,4,4,4,4,8
30101,COCHABAMBA,estado nutricional en menores de 5 anos,clasificacion f,2003-09-01,17,13,17,13,30
30905,COLCAPIRHUA,estado nutricional en menores de 5 anos,clasificacion f,2003-09-01,1,1,1,1,2
31002,COLOMI,estado nutricional en menores de 5 anos,clasificacion f,2003-09-01,4,4,4,4,8
50401,COLQUECHACA,estado nutricional en menores de 5 anos,clasificacion f,2003-09-01,30,9,30,9,39
21306,COLQUENCHA,estado nutricional en menores de 5 anos,clasificacion f,2003-09-01,0,1,0,1,1
21004,COLQUIRI,estado nutricional en menores de 5 anos,clasificacion f,2003-09-01,6,0,6,0,6
71301,COMARAPA,estado nutricional en menores de 5 anos,clasificacion f,2003-09-01,3,5,3,5,8
20605,COMBAYA,estado nutricional en menores de 5 anos,clasificacion f,2003-09-01,1,0,1,0,1
71101,CONCEPCION,estado nutricional en menores de 5 anos,clasificacion f,2003-09-01,1,0,1,0,1
21701,COPACABANA,estado nutricional en menores de 5 anos,clasificacion f,2003-09-01,2,0,2,0,2
40301,CORQUE,estado nutricional en menores de 5 anos,clasificacion f,2003-09-01,1,1,1,1,2
50601,COTAGAITA,estado nutricional en menores de 5 anos,clasificacion f,2003-09-01,3,4,3,4,7
10902,CULPINA,estado nutricional en menores de 5 anos,clasificacion f,2003-09-01,9,11,9,11,20
40401,CURAHUARA DE CARANGAS,estado nutricional en menores de 5 anos,clasificacion f,2003-09-01,1,0,1,0,1
20105,EL ALTO,estado nutricional en menores de 5 anos,clasificacion f,2003-09-01,44,28,44,28,72
71503,EL PUENTE(STC),estado nutricional en menores de 5 anos,clasificacion f,2003-09-01,1,4,1,4,5
60502,EL PUENTE(TJA),estado nutricional en menores de 5 anos,clasificacion f,2003-09-01,2,1,2,1,3
70105,EL TORNO,estado nutricional en menores de 5 anos,clasificacion f,2003-09-01,0,2,0,2,2
10405,EL VILLAR,estado nutricional en menores de 5 anos,clasificacion f,2003-09-01,5,5,5,5,10
80402,EXALTACION,estado nutricional en menores de 5 anos,clasificacion f,2003-09-01,0,1,0,1,1
71002,GENERAL SAAVEDRA,estado nutricional en menores de 5 anos,clasificacion f,2003-09-01,4,0,4,0,4
21601,GRAL. J.J. PEREZ (CHARAZANI),estado nutricional en menores de 5 anos,clasificacion f,2003-09-01,1,2,1,2,3
20602,GUANAY,estado nutricional en menores de 5 anos,clasificacion f,2003-09-01,3,2,3,2,5
20802,GUAQUI,estado nutricional en menores de 5 anos,clasificacion f,2003-09-01,1,0,1,0,1
80202,GUAYARAMERIN,estado nutricional en menores de 5 anos,clasificacion f,2003-09-01,3,2,3,2,5
70705,GUTIERREZ,estado nutricional en menores de 5 anos,clasificacion f,2003-09-01,7,3,7,3,10
10502,HUACARETA,estado nutricional en menores de 5 anos,clasificacion f,2003-09-01,8,1,8,1,9
11002,HUACAYA (VILLA DE HUACAYA),estado nutricional en menores de 5 anos,clasificacion f,2003-09-01,1,0,1,0,1
40701,HUANUNI,estado nutricional en menores de 5 anos,clasificacion f,2003-09-01,2,3,2,3,5
21005,ICHOCA,estado nutricional en menores de 5 anos,clasificacion f,2003-09-01,2,2,2,2,4
10304,ICLA,estado nutricional en menores de 5 anos,clasificacion f,2003-09-01,7,3,7,3,10
10703,INCAHUASI,estado nutricional en menores de 5 anos,clasificacion f,2003-09-01,11,1,11,1,12
21001,INQUISIVI,estado nutricional en menores de 5 anos,clasificacion f,2003-09-01,3,2,3,2,5
21501,IXIAMAS,estado nutricional en menores de 5 anos,clasificacion f,2003-09-01,0,2,0,2,2
21105,LA ASUNTA,estado nutricional en menores de 5 anos,clasificacion f,2003-09-01,0,3,0,3,3
70104,LA GUARDIA,estado nutricional en menores de 5 anos,clasificacion f,2003-09-01,8,2,8,2,10
20101,LA PAZ,estado nutricional en menores de 5 anos,clasificacion f,2003-09-01,27,13,27,13,40
70701,LAGUNILLAS,estado nutricional en menores de 5 anos,clasificacion f,2003-09-01,1,1,1,1,2
50203,LLALLAGUA,estado nutricional en menores de 5 anos,clasificacion f,2003-09-01,2,7,2,7,9
20901,LURIBAY,estado nutricional en menores de 5 anos,clasificacion f,2003-09-01,3,3,3,3,6
40702,MACHACAMARCA,estado nutricional en menores de 5 anos,clasificacion f,2003-09-01,2,0,2,0,2
11003,MACHARETI,estado nutricional en menores de 5 anos,clasificacion f,2003-09-01,2,3,2,3,5
80801,MAGDALENA,estado nutricional en menores de 5 anos,clasificacion f,2003-09-01,0,2,0,2,2
70903,MAIRANA,estado nutricional en menores de 5 anos,clasificacion f,2003-09-01,0,2,0,2,2
20103,MECAPACA,estado nutricional en menores de 5 anos,clasificacion f,2003-09-01,1,2,1,2,3
71003,MINEROS,estado nutricional en menores de 5 anos,clasificacion f,2003-09-01,17,3,17,3,20
20402,MOCOMOCO,estado nutricional en menores de 5 anos,clasificacion f,2003-09-01,2,1,2,1,3
10303,MOJOCOYA,estado nutricional en menores de 5 anos,clasificacion f,2003-09-01,4,2,4,2,6
10501,MONTEAGUDO,estado nutricional en menores de 5 anos,clasificacion f,2003-09-01,8,9,8,9,17
71001,MONTERO,estado nutricional en menores de 5 anos,clasificacion f,2003-09-01,7,3,7,3,10
70803,MORO MORO,estado nutricional en menores de 5 anos,clasificacion f,2003-09-01,1,0,1,0,1
30302,MOROCHATA,estado nutricional en menores de 5 anos,clasificacion f,2003-09-01,6,6,6,6,12
50404,OCURI,estado nutricional en menores de 5 anos,clasificacion f,2003-09-01,14,6,14,6,20
40101,ORURO,estado nutricional en menores de 5 anos,clasificacion f,2003-09-01,10,8,10,8,18
10401,PADILLA,estado nutricional en menores de 5 anos,clasificacion f,2003-09-01,7,3,7,3,10
70502,PAILON,estado nutricional en menores de 5 anos,clasificacion f,2003-09-01,3,1,3,1,4
21104,PALOS BLANCOS,estado nutricional en menores de 5 anos,clasificacion f,2003-09-01,3,0,3,0,3
40802,PAMPA AULLAGAS,estado nutricional en menores de 5 anos,clasificacion f,2003-09-01,0,1,0,1,1
30202,PASORAPA,estado nutricional en menores de 5 anos,clasificacion f,2003-09-01,1,1,1,1,2
21305,PATACAMAYA,estado nutricional en menores de 5 anos,clasificacion f,2003-09-01,3,1,3,1,4
40602,PAZÑA,estado nutricional en menores de 5 anos,clasificacion f,2003-09-01,0,1,0,1,1
20702,PELECHUCO,estado nutricional en menores de 5 anos,clasificacion f,2003-09-01,0,2,0,2,2
50403,POCOATA,estado nutricional en menores de 5 anos,clasificacion f,2003-09-01,5,5,5,5,10
31203,POCONA,estado nutricional en menores de 5 anos,clasificacion f,2003-09-01,4,4,4,4,8
31202,POJO (CBBA),estado nutricional en menores de 5 anos,clasificacion f,2003-09-01,4,2,4,2,6
40601,POOPO,estado nutricional en menores de 5 anos,clasificacion f,2003-09-01,0,1,0,1,1
51203,PORCO,estado nutricional en menores de 5 anos,clasificacion f,2003-09-01,1,1,1,1,2
10103,POROMA,estado nutricional en menores de 5 anos,clasificacion f,2003-09-01,11,11,11,11,22
70601,PORTACHUELO,estado nutricional en menores de 5 anos,clasificacion f,2003-09-01,1,1,1,1,2
70804,POSTRER VALLE,estado nutricional en menores de 5 anos,clasificacion f,2003-09-01,1,0,1,0,1
50101,POTOSI,estado nutricional en menores de 5 anos,clasificacion f,2003-09-01,12,13,12,13,25
10302,PRESTO,estado nutricional en menores de 5 anos,clasificacion f,2003-09-01,3,9,3,9,12
20401,PUERTO ACOSTA,estado nutricional en menores de 5 anos,clasificacion f,2003-09-01,1,2,1,2,3
20403,PUERTO CARABUCO,estado nutricional en menores de 5 anos,clasificacion f,2003-09-01,1,0,1,0,1
90301,PUERTO GONZALO MORENO,estado nutricional en menores de 5 anos,clasificacion f,2003-09-01,3,4,3,4,7
21204,PUERTO PEREZ,estado nutricional en menores de 5 anos,clasificacion f,2003-09-01,3,0,3,0,3
71402,PUERTO QUIJARRO,estado nutricional en menores de 5 anos,clasificacion f,2003-09-01,1,0,1,0,1
31205,PUERTO VILLARROEL,estado nutricional en menores de 5 anos,clasificacion f,2003-09-01,16,10,16,10,26
51101,PUNA,estado nutricional en menores de 5 anos,clasificacion f,2003-09-01,9,8,9,8,17
20604,QUIABAYA,estado nutricional en menores de 5 anos,clasificacion f,2003-09-01,2,0,2,0,2
30901,QUILLACOLLO,estado nutricional en menores de 5 anos,clasificacion f,2003-09-01,2,3,2,3,5
21002,QUIME,estado nutricional en menores de 5 anos,clasificacion f,2003-09-01,5,1,5,1,6
50402,RAVELO,estado nutricional en menores de 5 anos,clasificacion f,2003-09-01,23,16,23,16,39
80201,RIBERALTA,estado nutricional en menores de 5 anos,clasificacion f,2003-09-01,35,18,35,18,53
70503,ROBORE,estado nutricional en menores de 5 anos,clasificacion f,2003-09-01,4,2,4,2,6
80304,RURRENABAQUE,estado nutricional en menores de 5 anos,clasificacion f,2003-09-01,2,1,2,1,3
40901,SABAYA,estado nutricional en menores de 5 anos,clasificacion f,2003-09-01,1,0,1,0,1
31001,SACABA,estado nutricional en menores de 5 anos,clasificacion f,2003-09-01,6,5,6,5,11
30404,SACABAMBA,estado nutricional en menores de 5 anos,clasificacion f,2003-09-01,2,1,2,1,3
50701,SACACA,estado nutricional en menores de 5 anos,clasificacion f,2003-09-01,20,12,20,12,32
71302,SAIPINA,estado nutricional en menores de 5 anos,clasificacion f,2003-09-01,1,1,1,1,2
40801,SALINAS DE GARCI MENDOZA,estado nutricional en menores de 5 anos,clasificacion f,2003-09-01,1,0,1,0,1
70901,SAMAIPATA,estado nutricional en menores de 5 anos,clasificacion f,2003-09-01,1,0,1,0,1
71105,SAN ANTONIO DE LOMERIO,estado nutricional en menores de 5 anos,clasificacion f,2003-09-01,3,3,3,3,6
80302,SAN BORJA,estado nutricional en menores de 5 anos,clasificacion f,2003-09-01,15,10,15,10,25
21502,SAN BUENA VENTURA,estado nutricional en menores de 5 anos,clasificacion f,2003-09-01,1,0,1,0,1
70402,SAN CARLOS,estado nutricional en menores de 5 anos,clasificacion f,2003-09-01,3,0,3,0,3
80501,SAN IGNACIO,estado nutricional en menores de 5 anos,clasificacion f,2003-09-01,7,2,7,2,9
70301,SAN IGNACIO DE VELASCO,estado nutricional en menores de 5 anos,clasificacion f,2003-09-01,6,2,6,2,8
71102,SAN JAVIER(STC),estado nutricional en menores de 5 anos,clasificacion f,2003-09-01,1,1,1,1,2
70501,SAN JOSE DE CHIQUITOS,estado nutricional en menores de 5 anos,clasificacion f,2003-09-01,1,1,1,1,2
71104,SAN JULIAN,estado nutricional en menores de 5 anos,clasificacion f,2003-09-01,9,0,9,0,9
60501,SAN LORENZO(TJA),estado nutricional en menores de 5 anos,clasificacion f,2003-09-01,0,2,0,2,2
10702,SAN LUCAS,estado nutricional en menores de 5 anos,clasificacion f,2003-09-01,34,17,34,17,51
70302,SAN MIGUEL DE VELASCO,estado nutricional en menores de 5 anos,clasificacion f,2003-09-01,1,3,1,3,4
50501,SAN PEDRO DE BUENA VISTA,estado nutricional en menores de 5 anos,clasificacion f,2003-09-01,16,8,16,8,24
70303,SAN RAFAEL,estado nutricional en menores de 5 anos,clasificacion f,2003-09-01,1,1,1,1,2
70101,SANTA CRUZ DE LA SIERRA,estado nutricional en menores de 5 anos,clasificacion f,2003-09-01,32,9,32,9,41
80303,SANTA ROSA,estado nutricional en menores de 5 anos,clasificacion f,2003-09-01,0,2,0,2,2
20308,SANTIAGO DE CALLAPA,estado nutricional en menores de 5 anos,clasificacion f,2003-09-01,1,0,1,0,1
41401,SANTIAGO DE HUARI,estado nutricional en menores de 5 anos,clasificacion f,2003-09-01,0,1,0,1,1
30702,SANTIVAÑES,estado nutricional en menores de 5 anos,clasificacion f,2003-09-01,2,0,2,0,2
20902,SAPAHAQUI,estado nutricional en menores de 5 anos,clasificacion f,2003-09-01,2,0,2,0,2
90303,SENA,estado nutricional en menores de 5 anos,clasificacion f,2003-09-01,4,0,4,0,4
21301,SICA SICA (VILLA AROMA),estado nutricional en menores de 5 anos,clasificacion f,2003-09-01,2,2,2,2,4
30703,SICAYA,estado nutricional en menores de 5 anos,clasificacion f,2003-09-01,1,0,1,0,1
30902,SIPE SIPE,estado nutricional en menores de 5 anos,clasificacion f,2003-09-01,2,2,2,2,4
10403,SOPACHUY,estado nutricional en menores de 5 anos,clasificacion f,2003-09-01,11,9,11,9,20
10101,SUCRE,estado nutricional en menores de 5 anos,clasificacion f,2003-09-01,17,11,17,11,28
31404,TACACHI,estado nutricional en menores de 5 anos,clasificacion f,2003-09-01,1,0,1,0,1
50303,TACOBAMBA,estado nutricional en menores de 5 anos,clasificacion f,2003-09-01,11,2,11,2,13
30602,TACOPAYA,estado nutricional en menores de 5 anos,clasificacion f,2003-09-01,4,1,4,1,5
31101,TAPACARI,estado nutricional en menores de 5 anos,clasificacion f,2003-09-01,11,13,11,13,24
10601,TARABUCO,estado nutricional en menores de 5 anos,clasificacion f,2003-09-01,30,15,30,15,45
30401,TARATA,estado nutricional en menores de 5 anos,clasificacion f,2003-09-01,1,2,1,2,3
60101,TARIJA,estado nutricional en menores de 5 anos,clasificacion f,2003-09-01,5,2,5,2,7
10202,TARVITA,estado nutricional en menores de 5 anos,clasificacion f,2003-09-01,18,12,18,12,30
20803,TIAWANACU,estado nutricional en menores de 5 anos,clasificacion f,2003-09-01,1,0,1,0,1
50102,TINGUIPAYA,estado nutricional en menores de 5 anos,clasificacion f,2003-09-01,9,7,9,7,16
30903,TIQUIPAYA,estado nutricional en menores de 5 anos,clasificacion f,2003-09-01,2,0,2,0,2
31601,TIRAQUE (CBBA),estado nutricional en menores de 5 anos,clasificacion f,2003-09-01,18,2,18,2,20
30802,TOCO,estado nutricional en menores de 5 anos,clasificacion f,2003-09-01,1,2,1,2,3
30803,TOLATA,estado nutricional en menores de 5 anos,clasificacion f,2003-09-01,2,2,2,2,4
51202,TOMAVE,estado nutricional en menores de 5 anos,clasificacion f,2003-09-01,6,1,6,1,7
10402,TOMINA,estado nutricional en menores de 5 anos,clasificacion f,2003-09-01,10,13,10,13,23
50502,TORO TORO,estado nutricional en menores de 5 anos,clasificacion f,2003-09-01,12,6,12,6,18
31201,TOTORA(CBBA),estado nutricional en menores de 5 anos,clasificacion f,2003-09-01,4,1,4,1,5
41301,TOTORA(ORR),estado nutricional en menores de 5 anos,clasificacion f,2003-09-01,1,0,1,0,1
80101,TRINIDAD,estado nutricional en menores de 5 anos,clasificacion f,2003-09-01,2,9,2,9,11
50801,TUPIZA,estado nutricional en menores de 5 anos,clasificacion f,2003-09-01,6,3,6,3,9
50201,UNCIA,estado nutricional en menores de 5 anos,clasificacion f,2003-09-01,1,0,1,0,1
60401,URIONDO (A. CONCEPCION),estado nutricional en menores de 5 anos,clasificacion f,2003-09-01,1,0,1,0,1
51201,UYUNI,estado nutricional en menores de 5 anos,clasificacion f,2003-09-01,3,2,3,2,5
30502,VACAS,estado nutricional en menores de 5 anos,clasificacion f,2003-09-01,2,0,2,0,2
70801,VALLEGRANDE,estado nutricional en menores de 5 anos,clasificacion f,2003-09-01,1,2,1,2,3
20801,VIACHA,estado nutricional en menores de 5 anos,clasificacion f,2003-09-01,2,1,2,1,3
60303,VILLA MONTES,estado nutricional en menores de 5 anos,clasificacion f,2003-09-01,7,5,7,5,12
31402,VILLA RIVERO,estado nutricional en menores de 5 anos,clasificacion f,2003-09-01,4,1,4,1,5
10801,VILLA SERRANO,estado nutricional en menores de 5 anos,clasificacion f,2003-09-01,7,6,7,6,13
31003,VILLA TUNARI,estado nutricional en menores de 5 anos,clasificacion f,2003-09-01,5,6,5,6,11
11001,VILLA VACA GUZMAN (MUYUPAMPA),estado nutricional en menores de 5 anos,clasificacion f,2003-09-01,2,1,2,1,3
51501,VILLAZON,estado nutricional en menores de 5 anos,clasificacion f,2003-09-01,1,2,1,2,3
30904,VINTO,estado nutricional en menores de 5 anos,clasificacion f,2003-09-01,6,1,6,1,7
50602,VITICHI,estado nutricional en menores de 5 anos,clasificacion f,2003-09-01,1,0,1,0,1
20903,YACO,estado nutricional en menores de 5 anos,clasificacion f,2003-09-01,4,1,4,1,5
60301,YACUIBA,estado nutricional en menores de 5 anos,clasificacion f,2003-09-01,0,2,0,2,2
10602,YAMPARAEZ,estado nutricional en menores de 5 anos,clasificacion f,2003-09-01,15,3,15,3,18
70403,YAPACANI,estado nutricional en menores de 5 anos,clasificacion f,2003-09-01,3,1,3,1,4
10102,YOTALA,estado nutricional en menores de 5 anos,clasificacion f,2003-09-01,3,0,3,0,3
60402,YUNCHARA,estado nutricional en menores de 5 anos,clasificacion f,2003-09-01,1,3,1,3,4
10301,ZUDAÑEZ,estado nutricional en menores de 5 anos,clasificacion f,2003-09-01,6,1,6,1,7
51302,ACACIO,estado nutricional en menores de 5 anos,clasificacion f,2003-10-01,5,4,5,4,9
20201,ACHACACHI,estado nutricional en menores de 5 anos,clasificacion f,2003-10-01,1,3,1,3,4
30201,AIQUILE,estado nutricional en menores de 5 anos,clasificacion f,2003-10-01,3,1,3,1,4
31303,ALALAY,estado nutricional en menores de 5 anos,clasificacion f,2003-10-01,2,0,2,0,2
10404,ALCALA,estado nutricional en menores de 5 anos,clasificacion f,2003-10-01,4,0,4,0,4
30402,ANZALDO,estado nutricional en menores de 5 anos,clasificacion f,2003-10-01,3,2,3,2,5
20701,APOLO,estado nutricional en menores de 5 anos,clasificacion f,2003-10-01,0,1,0,1,1
51301,ARAMPAMPA,estado nutricional en menores de 5 anos,clasificacion f,2003-10-01,6,1,6,1,7
30501,ARANI,estado nutricional en menores de 5 anos,clasificacion f,2003-10-01,2,2,2,2,4
30403,ARBIETO,estado nutricional en menores de 5 anos,clasificacion f,2003-10-01,3,1,3,1,4
30601,ARQUE,estado nutricional en menores de 5 anos,clasificacion f,2003-10-01,4,3,4,3,7
71501,ASCENCION DE GUARAYOS,estado nutricional en menores de 5 anos,clasificacion f,2003-10-01,1,1,1,1,2
50802,ATOCHA,estado nutricional en menores de 5 anos,clasificacion f,2003-10-01,1,4,1,4,5
20503,AUCAPATA,estado nutricional en menores de 5 anos,clasificacion f,2003-10-01,4,0,4,0,4
30301,AYOPAYA (V. DE INDEPENDENCIA),estado nutricional en menores de 5 anos,clasificacion f,2003-10-01,3,4,3,4,7
10201,AZURDUY,estado nutricional en menores de 5 anos,clasificacion f,2003-10-01,18,19,18,19,37
21203,BATALLAS,estado nutricional en menores de 5 anos,clasificacion f,2003-10-01,1,1,1,1,2
90104,BELLA FLOR,estado nutricional en menores de 5 anos,clasificacion f,2003-10-01,1,0,1,0,1
50301,BETANZOS,estado nutricional en menores de 5 anos,clasificacion f,2003-10-01,23,9,23,9,32
31501,BOLIVAR,estado nutricional en menores de 5 anos,clasificacion f,2003-10-01,4,2,4,2,6
90103,BOLPEBRA,estado nutricional en menores de 5 anos,clasificacion f,2003-10-01,0,1,0,1,1
70707,BOYUIBE,estado nutricional en menores de 5 anos,clasificacion f,2003-10-01,1,0,1,0,1
70401,BUENA VISTA,estado nutricional en menores de 5 anos,clasificacion f,2003-10-01,1,1,1,1,2
70703,CABEZAS,estado nutricional en menores de 5 anos,clasificacion f,2003-10-01,2,1,2,1,3
20905,CAIROMA,estado nutricional en menores de 5 anos,clasificacion f,2003-10-01,11,4,11,4,15
51102,"CAIZA ""D""",estado nutricional en menores de 5 anos,clasificacion f,2003-10-01,1,3,1,3,4
21003,CAJUATA,estado nutricional en menores de 5 anos,clasificacion f,2003-10-01,0,3,0,3,3
21304,CALAMARCA,estado nutricional en menores de 5 anos,clasificacion f,2003-10-01,4,0,4,0,4
10701,CAMARGO,estado nutricional en menores de 5 anos,clasificacion f,2003-10-01,0,2,0,2,2
70706,CAMIRI,estado nutricional en menores de 5 anos,clasificacion f,2003-10-01,3,2,3,2,5
30701,CAPINOTA,estado nutricional en menores de 5 anos,clasificacion f,2003-10-01,1,3,1,3,4
40102,CARACOLLO,estado nutricional en menores de 5 anos,clasificacion f,2003-10-01,1,2,1,2,3
22001,CARANAVI,estado nutricional en menores de 5 anos,clasificacion f,2003-10-01,8,1,8,1,9
60302,CARAPARI,estado nutricional en menores de 5 anos,clasificacion f,2003-10-01,1,1,1,1,2
50702,CARIPUYO,estado nutricional en menores de 5 anos,clasificacion f,2003-10-01,12,12,12,12,24
21902,CATACORA,estado nutricional en menores de 5 anos,clasificacion f,2003-10-01,0,1,0,1,1
40201,CHALLAPATA,estado nutricional en menores de 5 anos,clasificacion f,2003-10-01,3,1,3,1,4
50302,CHAQUI,estado nutricional en menores de 5 anos,clasificacion f,2003-10-01,2,0,2,0,2
70702,CHARAGUA,estado nutricional en menores de 5 anos,clasificacion f,2003-10-01,8,0,8,0,8
20305,CHARAÑA,estado nutricional en menores de 5 anos,clasificacion f,2003-10-01,1,0,1,0,1
50202,CHAYANTA,estado nutricional en menores de 5 anos,clasificacion f,2003-10-01,19,6,19,6,25
31204,CHIMORE,estado nutricional en menores de 5 anos,clasificacion f,2003-10-01,1,0,1,0,1
20501,CHUMA,estado nutricional en menores de 5 anos,clasificacion f,2003-10-01,5,1,5,1,6
90101,COBIJA,estado nutricional en menores de 5 anos,clasificacion f,2003-10-01,1,4,1,4,5
30101,COCHABAMBA,estado nutricional en menores de 5 anos,clasificacion f,2003-10-01,16,7,16,7,23
50901,"COLCHA ""K""",estado nutricional en menores de 5 anos,clasificacion f,2003-10-01,1,0,1,0,1
31002,COLOMI,estado nutricional en menores de 5 anos,clasificacion f,2003-10-01,4,1,4,1,5
50401,COLQUECHACA,estado nutricional en menores de 5 anos,clasificacion f,2003-10-01,20,12,20,12,32
21004,COLQUIRI,estado nutricional en menores de 5 anos,clasificacion f,2003-10-01,1,0,1,0,1
71301,COMARAPA,estado nutricional en menores de 5 anos,clasificacion f,2003-10-01,6,1,6,1,7
71101,CONCEPCION,estado nutricional en menores de 5 anos,clasificacion f,2003-10-01,0,1,0,1,1
21402,CORIPATA,estado nutricional en menores de 5 anos,clasificacion f,2003-10-01,1,0,1,0,1
21401,COROICO,estado nutricional en menores de 5 anos,clasificacion f,2003-10-01,3,3,3,3,6
50601,COTAGAITA,estado nutricional en menores de 5 anos,clasificacion f,2003-10-01,15,4,15,4,19
70704,CUEVO,estado nutricional en menores de 5 anos,clasificacion f,2003-10-01,2,0,2,0,2
10902,CULPINA,estado nutricional en menores de 5 anos,clasificacion f,2003-10-01,10,12,10,12,22
20105,EL ALTO,estado nutricional en menores de 5 anos,clasificacion f,2003-10-01,42,46,42,46,88
40103,EL CHORO,estado nutricional en menores de 5 anos,clasificacion f,2003-10-01,0,1,0,1,1
71503,EL PUENTE(STC),estado nutricional en menores de 5 anos,clasificacion f,2003-10-01,1,1,1,1,2
60502,EL PUENTE(TJA),estado nutricional en menores de 5 anos,clasificacion f,2003-10-01,2,0,2,0,2
70105,EL TORNO,estado nutricional en menores de 5 anos,clasificacion f,2003-10-01,3,2,3,2,5
10405,EL VILLAR,estado nutricional en menores de 5 anos,clasificacion f,2003-10-01,2,2,2,2,4
60601,ENTRE RIOS,estado nutricional en menores de 5 anos,clasificacion f,2003-10-01,3,2,3,2,5
80402,EXALTACION,estado nutricional en menores de 5 anos,clasificacion f,2003-10-01,2,2,2,2,4
71002,GENERAL SAAVEDRA,estado nutricional en menores de 5 anos,clasificacion f,2003-10-01,6,3,6,3,9
21601,GRAL. J.J. PEREZ (CHARAZANI),estado nutricional en menores de 5 anos,clasificacion f,2003-10-01,2,1,2,1,3
20602,GUANAY,estado nutricional en menores de 5 anos,clasificacion f,2003-10-01,2,2,2,2,4
20802,GUAQUI,estado nutricional en menores de 5 anos,clasificacion f,2003-10-01,1,0,1,0,1
80202,GUAYARAMERIN,estado nutricional en menores de 5 anos,clasificacion f,2003-10-01,6,6,6,6,12
70705,GUTIERREZ,estado nutricional en menores de 5 anos,clasificacion f,2003-10-01,4,2,4,2,6
10502,HUACARETA,estado nutricional en menores de 5 anos,clasificacion f,2003-10-01,7,4,7,4,11
11002,HUACAYA (VILLA DE HUACAYA),estado nutricional en menores de 5 anos,clasificacion f,2003-10-01,0,1,0,1,1
41601,HUAYLLAMARCA,estado nutricional en menores de 5 anos,clasificacion f,2003-10-01,1,0,1,0,1
21005,ICHOCA,estado nutricional en menores de 5 anos,clasificacion f,2003-10-01,1,2,1,2,3
10304,ICLA,estado nutricional en menores de 5 anos,clasificacion f,2003-10-01,6,3,6,3,9
10703,INCAHUASI,estado nutricional en menores de 5 anos,clasificacion f,2003-10-01,19,14,19,14,33
21001,INQUISIVI,estado nutricional en menores de 5 anos,clasificacion f,2003-10-01,1,2,1,2,3
21501,IXIAMAS,estado nutricional en menores de 5 anos,clasificacion f,2003-10-01,0,1,0,1,1
21105,LA ASUNTA,estado nutricional en menores de 5 anos,clasificacion f,2003-10-01,2,4,2,4,6
70104,LA GUARDIA,estado nutricional en menores de 5 anos,clasificacion f,2003-10-01,4,1,4,1,5
20101,LA PAZ,estado nutricional en menores de 5 anos,clasificacion f,2003-10-01,28,10,28,10,38
70701,LAGUNILLAS,estado nutricional en menores de 5 anos,clasificacion f,2003-10-01,1,2,1,2,3
21202,LAJA,estado nutricional en menores de 5 anos,clasificacion f,2003-10-01,2,0,2,0,2
10903,LAS CARRERAS,estado nutricional en menores de 5 anos,clasificacion f,2003-10-01,1,0,1,0,1
50203,LLALLAGUA,estado nutricional en menores de 5 anos,clasificacion f,2003-10-01,6,11,6,11,17
20901,LURIBAY,estado nutricional en menores de 5 anos,clasificacion f,2003-10-01,4,3,4,3,7
40702,MACHACAMARCA,estado nutricional en menores de 5 anos,clasificacion f,2003-10-01,0,1,0,1,1
11003,MACHARETI,estado nutricional en menores de 5 anos,clasificacion f,2003-10-01,4,4,4,4,8
71003,MINEROS,estado nutricional en menores de 5 anos,clasificacion f,2003-10-01,8,2,8,2,10
31301,MIZQUE,estado nutricional en menores de 5 anos,clasificacion f,2003-10-01,8,3,8,3,11
20402,MOCOMOCO,estado nutricional en menores de 5 anos,clasificacion f,2003-10-01,2,3,2,3,5
10303,MOJOCOYA,estado nutricional en menores de 5 anos,clasificacion f,2003-10-01,6,1,6,1,7
10501,MONTEAGUDO,estado nutricional en menores de 5 anos,clasificacion f,2003-10-01,9,1,9,1,10
71001,MONTERO,estado nutricional en menores de 5 anos,clasificacion f,2003-10-01,12,7,12,7,19
70803,MORO MORO,estado nutricional en menores de 5 anos,clasificacion f,2003-10-01,1,0,1,0,1
30302,MOROCHATA,estado nutricional en menores de 5 anos,clasificacion f,2003-10-01,5,2,5,2,7
50404,OCURI,estado nutricional en menores de 5 anos,clasificacion f,2003-10-01,8,8,8,8,16
30203,OMEREQUE,estado nutricional en menores de 5 anos,clasificacion f,2003-10-01,1,0,1,0,1
40101,ORURO,estado nutricional en menores de 5 anos,clasificacion f,2003-10-01,11,3,11,3,14
10401,PADILLA,estado nutricional en menores de 5 anos,clasificacion f,2003-10-01,6,7,6,7,13
70502,PAILON,estado nutricional en menores de 5 anos,clasificacion f,2003-10-01,3,0,3,0,3
20102,PALCA,estado nutricional en menores de 5 anos,clasificacion f,2003-10-01,2,1,2,1,3
21104,PALOS BLANCOS,estado nutricional en menores de 5 anos,clasificacion f,2003-10-01,2,4,2,4,6
70902,PAMPA GRANDE,estado nutricional en menores de 5 anos,clasificacion f,2003-10-01,0,1,0,1,1
30202,PASORAPA,estado nutricional en menores de 5 anos,clasificacion f,2003-10-01,0,2,0,2,2
21305,PATACAMAYA,estado nutricional en menores de 5 anos,clasificacion f,2003-10-01,3,1,3,1,4
20702,PELECHUCO,estado nutricional en menores de 5 anos,clasificacion f,2003-10-01,0,3,0,3,3
50403,POCOATA,estado nutricional en menores de 5 anos,clasificacion f,2003-10-01,6,4,6,4,10
31203,POCONA,estado nutricional en menores de 5 anos,clasificacion f,2003-10-01,0,3,0,3,3
31202,POJO (CBBA),estado nutricional en menores de 5 anos,clasificacion f,2003-10-01,8,1,8,1,9
10103,POROMA,estado nutricional en menores de 5 anos,clasificacion f,2003-10-01,11,8,11,8,19
70601,PORTACHUELO,estado nutricional en menores de 5 anos,clasificacion f,2003-10-01,1,6,1,6,7
50101,POTOSI,estado nutricional en menores de 5 anos,clasificacion f,2003-10-01,20,7,20,7,27
10302,PRESTO,estado nutricional en menores de 5 anos,clasificacion f,2003-10-01,2,2,2,2,4
20403,PUERTO CARABUCO,estado nutricional en menores de 5 anos,clasificacion f,2003-10-01,1,1,1,1,2
90301,PUERTO GONZALO MORENO,estado nutricional en menores de 5 anos,clasificacion f,2003-10-01,2,2,2,2,4
21204,PUERTO PEREZ,estado nutricional en menores de 5 anos,clasificacion f,2003-10-01,1,0,1,0,1
71401,PUERTO SUAREZ,estado nutricional en menores de 5 anos,clasificacion f,2003-10-01,0,2,0,2,2
31205,PUERTO VILLARROEL,estado nutricional en menores de 5 anos,clasificacion f,2003-10-01,4,7,4,7,11
51101,PUNA,estado nutricional en menores de 5 anos,clasificacion f,2003-10-01,8,2,8,2,10
31401,PUNATA,estado nutricional en menores de 5 anos,clasificacion f,2003-10-01,6,1,6,1,7
20604,QUIABAYA,estado nutricional en menores de 5 anos,clasificacion f,2003-10-01,1,1,1,1,2
30901,QUILLACOLLO,estado nutricional en menores de 5 anos,clasificacion f,2003-10-01,3,2,3,2,5
21002,QUIME,estado nutricional en menores de 5 anos,clasificacion f,2003-10-01,7,2,7,2,9
50402,RAVELO,estado nutricional en menores de 5 anos,clasificacion f,2003-10-01,28,8,28,8,36
80301,REYES,estado nutricional en menores de 5 anos,clasificacion f,2003-10-01,2,1,2,1,3
80201,RIBERALTA,estado nutricional en menores de 5 anos,clasificacion f,2003-10-01,25,14,25,14,39
70503,ROBORE,estado nutricional en menores de 5 anos,clasificacion f,2003-10-01,1,1,1,1,2
31001,SACABA,estado nutricional en menores de 5 anos,clasificacion f,2003-10-01,4,3,4,3,7
30404,SACABAMBA,estado nutricional en menores de 5 anos,clasificacion f,2003-10-01,3,0,3,0,3
50701,SACACA,estado nutricional en menores de 5 anos,clasificacion f,2003-10-01,23,22,23,22,45
40801,SALINAS DE GARCI MENDOZA,estado nutricional en menores de 5 anos,clasificacion f,2003-10-01,0,2,0,2,2
51601,SAN AGUSTIN,estado nutricional en menores de 5 anos,clasificacion f,2003-10-01,1,1,1,1,2
71105,SAN ANTONIO DE LOMERIO,estado nutricional en menores de 5 anos,clasificacion f,2003-10-01,7,3,7,3,10
31403,SAN BENITO,estado nutricional en menores de 5 anos,clasificacion f,2003-10-01,1,0,1,0,1
80302,SAN BORJA,estado nutricional en menores de 5 anos,clasificacion f,2003-10-01,10,6,10,6,16
21502,SAN BUENA VENTURA,estado nutricional en menores de 5 anos,clasificacion f,2003-10-01,3,1,3,1,4
70402,SAN CARLOS,estado nutricional en menores de 5 anos,clasificacion f,2003-10-01,0,1,0,1,1
80501,SAN IGNACIO,estado nutricional en menores de 5 anos,clasificacion f,2003-10-01,15,5,15,5,20
70301,SAN IGNACIO DE VELASCO,estado nutricional en menores de 5 anos,clasificacion f,2003-10-01,11,4,11,4,15
80102,SAN JAVIER(BNI),estado nutricional en menores de 5 anos,clasificacion f,2003-10-01,1,2,1,2,3
71102,SAN JAVIER(STC),estado nutricional en menores de 5 anos,clasificacion f,2003-10-01,2,1,2,1,3
70501,SAN JOSE DE CHIQUITOS,estado nutricional en menores de 5 anos,clasificacion f,2003-10-01,1,1,1,1,2
71104,SAN JULIAN,estado nutricional en menores de 5 anos,clasificacion f,2003-10-01,4,1,4,1,5
60501,SAN LORENZO(TJA),estado nutricional en menores de 5 anos,clasificacion f,2003-10-01,3,6,3,6,9
10702,SAN LUCAS,estado nutricional en menores de 5 anos,clasificacion f,2003-10-01,15,8,15,8,23
71201,SAN MATIAS,estado nutricional en menores de 5 anos,clasificacion f,2003-10-01,4,0,4,0,4
70302,SAN MIGUEL DE VELASCO,estado nutricional en menores de 5 anos,clasificacion f,2003-10-01,2,1,2,1,3
51001,SAN PABLO DE LIPEZ,estado nutricional en menores de 5 anos,clasificacion f,2003-10-01,0,1,0,1,1
50501,SAN PEDRO DE BUENA VISTA,estado nutricional en menores de 5 anos,clasificacion f,2003-10-01,14,16,14,16,30
21702,SAN PEDRO DE TIQUINA,estado nutricional en menores de 5 anos,clasificacion f,2003-10-01,1,0,1,0,1
90202,SAN PEDRO(PND),estado nutricional en menores de 5 anos,clasificacion f,2003-10-01,1,1,1,1,2
70303,SAN RAFAEL,estado nutricional en menores de 5 anos,clasificacion f,2003-10-01,2,2,2,2,4
80401,SANTA ANA,estado nutricional en menores de 5 anos,clasificacion f,2003-10-01,0,2,0,2,2
70101,SANTA CRUZ DE LA SIERRA,estado nutricional en menores de 5 anos,clasificacion f,2003-10-01,32,12,32,12,44
70602,SANTA ROSA DEL SARA,estado nutricional en menores de 5 anos,clasificacion f,2003-10-01,0,1,0,1,1
20308,SANTIAGO DE CALLAPA,estado nutricional en menores de 5 anos,clasificacion f,2003-10-01,1,1,1,1,2
41401,SANTIAGO DE HUARI,estado nutricional en menores de 5 anos,clasificacion f,2003-10-01,1,1,1,1,2
20902,SAPAHAQUI,estado nutricional en menores de 5 anos,clasificacion f,2003-10-01,3,0,3,0,3
90303,SENA,estado nutricional en menores de 5 anos,clasificacion f,2003-10-01,2,0,2,0,2
21301,SICA SICA (VILLA AROMA),estado nutricional en menores de 5 anos,clasificacion f,2003-10-01,9,4,9,4,13
30703,SICAYA,estado nutricional en menores de 5 anos,clasificacion f,2003-10-01,2,0,2,0,2
30902,SIPE SIPE,estado nutricional en menores de 5 anos,clasificacion f,2003-10-01,8,5,8,5,13
10403,SOPACHUY,estado nutricional en menores de 5 anos,clasificacion f,2003-10-01,12,5,12,5,17
20601,SORATA,estado nutricional en menores de 5 anos,clasificacion f,2003-10-01,0,2,0,2,2
10101,SUCRE,estado nutricional en menores de 5 anos,clasificacion f,2003-10-01,12,9,12,9,21
50303,TACOBAMBA,estado nutricional en menores de 5 anos,clasificacion f,2003-10-01,5,0,5,0,5
30602,TACOPAYA,estado nutricional en menores de 5 anos,clasificacion f,2003-10-01,6,2,6,2,8
31101,TAPACARI,estado nutricional en menores de 5 anos,clasificacion f,2003-10-01,8,5,8,5,13
10601,TARABUCO,estado nutricional en menores de 5 anos,clasificacion f,2003-10-01,27,14,27,14,41
30401,TARATA,estado nutricional en menores de 5 anos,clasificacion f,2003-10-01,5,1,5,1,6
60101,TARIJA,estado nutricional en menores de 5 anos,clasificacion f,2003-10-01,8,2,8,2,10
10202,TARVITA,estado nutricional en menores de 5 anos,clasificacion f,2003-10-01,10,2,10,2,12
20803,TIAWANACU,estado nutricional en menores de 5 anos,clasificacion f,2003-10-01,1,1,1,1,2
50102,TINGUIPAYA,estado nutricional en menores de 5 anos,clasificacion f,2003-10-01,18,7,18,7,25
20606,TIPUANI,estado nutricional en menores de 5 anos,clasificacion f,2003-10-01,1,0,1,0,1
31601,TIRAQUE (CBBA),estado nutricional en menores de 5 anos,clasificacion f,2003-10-01,16,5,16,5,21
21703,TITO YUPANQUI (PARQUIPUJIO),estado nutricional en menores de 5 anos,clasificacion f,2003-10-01,1,0,1,0,1
51202,TOMAVE,estado nutricional en menores de 5 anos,clasificacion f,2003-10-01,7,4,7,4,11
10402,TOMINA,estado nutricional en menores de 5 anos,clasificacion f,2003-10-01,18,17,18,17,35
50502,TORO TORO,estado nutricional en menores de 5 anos,clasificacion f,2003-10-01,9,6,9,6,15
41301,TOTORA(ORR),estado nutricional en menores de 5 anos,clasificacion f,2003-10-01,1,0,1,0,1
70802,TRIGAL,estado nutricional en menores de 5 anos,clasificacion f,2003-10-01,1,0,1,0,1
80101,TRINIDAD,estado nutricional en menores de 5 anos,clasificacion f,2003-10-01,3,9,3,9,12
50801,TUPIZA,estado nutricional en menores de 5 anos,clasificacion f,2003-10-01,5,2,5,2,7
40402,TURCO,estado nutricional en menores de 5 anos,clasificacion f,2003-10-01,0,1,0,1,1
21302,UMALA,estado nutricional en menores de 5 anos,clasificacion f,2003-10-01,0,1,0,1,1
50201,UNCIA,estado nutricional en menores de 5 anos,clasificacion f,2003-10-01,4,1,4,1,5
60401,URIONDO (A. CONCEPCION),estado nutricional en menores de 5 anos,clasificacion f,2003-10-01,1,0,1,0,1
71502,URUBICHA,estado nutricional en menores de 5 anos,clasificacion f,2003-10-01,3,5,3,5,8
51201,UYUNI,estado nutricional en menores de 5 anos,clasificacion f,2003-10-01,0,3,0,3,3
30502,VACAS,estado nutricional en menores de 5 anos,clasificacion f,2003-10-01,1,0,1,0,1
70801,VALLEGRANDE,estado nutricional en menores de 5 anos,clasificacion f,2003-10-01,5,7,5,7,12
20801,VIACHA,estado nutricional en menores de 5 anos,clasificacion f,2003-10-01,1,0,1,0,1
31302,VILA VILA,estado nutricional en menores de 5 anos,clasificacion f,2003-10-01,4,2,4,2,6
60303,VILLA MONTES,estado nutricional en menores de 5 anos,clasificacion f,2003-10-01,9,4,9,4,13
31402,VILLA RIVERO,estado nutricional en menores de 5 anos,clasificacion f,2003-10-01,5,0,5,0,5
10801,VILLA SERRANO,estado nutricional en menores de 5 anos,clasificacion f,2003-10-01,12,6,12,6,18
31003,VILLA TUNARI,estado nutricional en menores de 5 anos,clasificacion f,2003-10-01,15,11,15,11,26
11001,VILLA VACA GUZMAN (MUYUPAMPA),estado nutricional en menores de 5 anos,clasificacion f,2003-10-01,2,2,2,2,4
51501,VILLAZON,estado nutricional en menores de 5 anos,clasificacion f,2003-10-01,2,0,2,0,2
30904,VINTO,estado nutricional en menores de 5 anos,clasificacion f,2003-10-01,8,2,8,2,10
50602,VITICHI,estado nutricional en menores de 5 anos,clasificacion f,2003-10-01,14,2,14,2,16
20903,YACO,estado nutricional en menores de 5 anos,clasificacion f,2003-10-01,8,3,8,3,11
60301,YACUIBA,estado nutricional en menores de 5 anos,clasificacion f,2003-10-01,0,1,0,1,1
10602,YAMPARAEZ,estado nutricional en menores de 5 anos,clasificacion f,2003-10-01,16,5,16,5,21
70403,YAPACANI,estado nutricional en menores de 5 anos,clasificacion f,2003-10-01,5,2,5,2,7
10102,YOTALA,estado nutricional en menores de 5 anos,clasificacion f,2003-10-01,6,1,6,1,7
60402,YUNCHARA,estado nutricional en menores de 5 anos,clasificacion f,2003-10-01,1,5,1,5,6
10301,ZUDAÑEZ,estado nutricional en menores de 5 anos,clasificacion f,2003-10-01,3,0,3,0,3
51302,ACACIO,estado nutricional en menores de 5 anos,clasificacion f,2003-11-01,4,3,4,3,7
20201,ACHACACHI,estado nutricional en menores de 5 anos,clasificacion f,2003-11-01,5,1,5,1,6
20104,ACHOCALLA,estado nutricional en menores de 5 anos,clasificacion f,2003-11-01,0,3,0,3,3
30201,AIQUILE,estado nutricional en menores de 5 anos,clasificacion f,2003-11-01,5,2,5,2,7
31303,ALALAY,estado nutricional en menores de 5 anos,clasificacion f,2003-11-01,1,0,1,0,1
10404,ALCALA,estado nutricional en menores de 5 anos,clasificacion f,2003-11-01,0,6,0,6,6
20202,ANCORAIMES,estado nutricional en menores de 5 anos,clasificacion f,2003-11-01,2,0,2,0,2
20701,APOLO,estado nutricional en menores de 5 anos,clasificacion f,2003-11-01,0,1,0,1,1
51301,ARAMPAMPA,estado nutricional en menores de 5 anos,clasificacion f,2003-11-01,6,0,6,0,6
30501,ARANI,estado nutricional en menores de 5 anos,clasificacion f,2003-11-01,5,0,5,0,5
30403,ARBIETO,estado nutricional en menores de 5 anos,clasificacion f,2003-11-01,1,1,1,1,2
30601,ARQUE,estado nutricional en menores de 5 anos,clasificacion f,2003-11-01,1,1,1,1,2
50802,ATOCHA,estado nutricional en menores de 5 anos,clasificacion f,2003-11-01,4,2,4,2,6
20503,AUCAPATA,estado nutricional en menores de 5 anos,clasificacion f,2003-11-01,4,3,4,3,7
20502,AYATA,estado nutricional en menores de 5 anos,clasificacion f,2003-11-01,4,4,4,4,8
21303,AYO AYO,estado nutricional en menores de 5 anos,clasificacion f,2003-11-01,1,0,1,0,1
30301,AYOPAYA (V. DE INDEPENDENCIA),estado nutricional en menores de 5 anos,clasificacion f,2003-11-01,3,0,3,0,3
10201,AZURDUY,estado nutricional en menores de 5 anos,clasificacion f,2003-11-01,10,6,10,6,16
21203,BATALLAS,estado nutricional en menores de 5 anos,clasificacion f,2003-11-01,3,0,3,0,3
90104,BELLA FLOR,estado nutricional en menores de 5 anos,clasificacion f,2003-11-01,1,0,1,0,1
50301,BETANZOS,estado nutricional en menores de 5 anos,clasificacion f,2003-11-01,15,9,15,9,24
31501,BOLIVAR,estado nutricional en menores de 5 anos,clasificacion f,2003-11-01,8,4,8,4,12
70401,BUENA VISTA,estado nutricional en menores de 5 anos,clasificacion f,2003-11-01,1,2,1,2,3
70703,CABEZAS,estado nutricional en menores de 5 anos,clasificacion f,2003-11-01,1,0,1,0,1
20905,CAIROMA,estado nutricional en menores de 5 anos,clasificacion f,2003-11-01,5,3,5,3,8
51102,"CAIZA ""D""",estado nutricional en menores de 5 anos,clasificacion f,2003-11-01,0,1,0,1,1
21003,CAJUATA,estado nutricional en menores de 5 anos,clasificacion f,2003-11-01,1,4,1,4,5
21304,CALAMARCA,estado nutricional en menores de 5 anos,clasificacion f,2003-11-01,6,2,6,2,8
10701,CAMARGO,estado nutricional en menores de 5 anos,clasificacion f,2003-11-01,2,0,2,0,2
30701,CAPINOTA,estado nutricional en menores de 5 anos,clasificacion f,2003-11-01,8,12,8,12,20
20302,CAQUIAVIRI,estado nutricional en menores de 5 anos,clasificacion f,2003-11-01,1,0,1,0,1
40102,CARACOLLO,estado nutricional en menores de 5 anos,clasificacion f,2003-11-01,2,1,2,1,3
22001,CARANAVI,estado nutricional en menores de 5 anos,clasificacion f,2003-11-01,12,8,12,8,20
60302,CARAPARI,estado nutricional en menores de 5 anos,clasificacion f,2003-11-01,0,3,0,3,3
50702,CARIPUYO,estado nutricional en menores de 5 anos,clasificacion f,2003-11-01,10,2,10,2,12
21902,CATACORA,estado nutricional en menores de 5 anos,clasificacion f,2003-11-01,0,1,0,1,1
40201,CHALLAPATA,estado nutricional en menores de 5 anos,clasificacion f,2003-11-01,3,1,3,1,4
50302,CHAQUI,estado nutricional en menores de 5 anos,clasificacion f,2003-11-01,1,1,1,1,2
70702,CHARAGUA,estado nutricional en menores de 5 anos,clasificacion f,2003-11-01,4,4,4,4,8
50202,CHAYANTA,estado nutricional en menores de 5 anos,clasificacion f,2003-11-01,7,1,7,1,8
20501,CHUMA,estado nutricional en menores de 5 anos,clasificacion f,2003-11-01,6,3,6,3,9
30801,CLIZA,estado nutricional en menores de 5 anos,clasificacion f,2003-11-01,1,0,1,0,1
90101,COBIJA,estado nutricional en menores de 5 anos,clasificacion f,2003-11-01,7,3,7,3,10
30101,COCHABAMBA,estado nutricional en menores de 5 anos,clasificacion f,2003-11-01,12,4,12,4,16
50901,"COLCHA ""K""",estado nutricional en menores de 5 anos,clasificacion f,2003-11-01,1,0,1,0,1
31002,COLOMI,estado nutricional en menores de 5 anos,clasificacion f,2003-11-01,5,0,5,0,5
50401,COLQUECHACA,estado nutricional en menores de 5 anos,clasificacion f,2003-11-01,32,10,32,10,42
21306,COLQUENCHA,estado nutricional en menores de 5 anos,clasificacion f,2003-11-01,0,2,0,2,2
21004,COLQUIRI,estado nutricional en menores de 5 anos,clasificacion f,2003-11-01,3,0,3,0,3
20304,COMANCHE,estado nutricional en menores de 5 anos,clasificacion f,2003-11-01,1,0,1,0,1
71301,COMARAPA,estado nutricional en menores de 5 anos,clasificacion f,2003-11-01,4,3,4,3,7
71101,CONCEPCION,estado nutricional en menores de 5 anos,clasificacion f,2003-11-01,4,0,4,0,4
21401,COROICO,estado nutricional en menores de 5 anos,clasificacion f,2003-11-01,0,1,0,1,1
40301,CORQUE,estado nutricional en menores de 5 anos,clasificacion f,2003-11-01,1,0,1,0,1
50601,COTAGAITA,estado nutricional en menores de 5 anos,clasificacion f,2003-11-01,12,9,12,9,21
10902,CULPINA,estado nutricional en menores de 5 anos,clasificacion f,2003-11-01,11,9,11,9,20
20804,DESAGUADERO,estado nutricional en menores de 5 anos,clasificacion f,2003-11-01,1,0,1,0,1
20105,EL ALTO,estado nutricional en menores de 5 anos,clasificacion f,2003-11-01,48,22,48,22,70
71503,EL PUENTE(STC),estado nutricional en menores de 5 anos,clasificacion f,2003-11-01,2,1,2,1,3
60502,EL PUENTE(TJA),estado nutricional en menores de 5 anos,clasificacion f,2003-11-01,2,1,2,1,3
70105,EL TORNO,estado nutricional en menores de 5 anos,clasificacion f,2003-11-01,1,0,1,0,1
10405,EL VILLAR,estado nutricional en menores de 5 anos,clasificacion f,2003-11-01,5,2,5,2,7
60601,ENTRE RIOS,estado nutricional en menores de 5 anos,clasificacion f,2003-11-01,3,1,3,1,4
41101,EUCALIPTUS,estado nutricional en menores de 5 anos,clasificacion f,2003-11-01,1,0,1,0,1
80402,EXALTACION,estado nutricional en menores de 5 anos,clasificacion f,2003-11-01,4,3,4,3,7
90203,FILADELFIA,estado nutricional en menores de 5 anos,clasificacion f,2003-11-01,1,1,1,1,2
71002,GENERAL SAAVEDRA,estado nutricional en menores de 5 anos,clasificacion f,2003-11-01,10,5,10,5,15
21601,GRAL. J.J. PEREZ (CHARAZANI),estado nutricional en menores de 5 anos,clasificacion f,2003-11-01,7,11,7,11,18
20602,GUANAY,estado nutricional en menores de 5 anos,clasificacion f,2003-11-01,12,4,12,4,16
80202,GUAYARAMERIN,estado nutricional en menores de 5 anos,clasificacion f,2003-11-01,0,5,0,5,5
70705,GUTIERREZ,estado nutricional en menores de 5 anos,clasificacion f,2003-11-01,4,4,4,4,8
10502,HUACARETA,estado nutricional en menores de 5 anos,clasificacion f,2003-11-01,4,1,4,1,5
11002,HUACAYA (VILLA DE HUACAYA),estado nutricional en menores de 5 anos,clasificacion f,2003-11-01,1,0,1,0,1
40701,HUANUNI,estado nutricional en menores de 5 anos,clasificacion f,2003-11-01,4,1,4,1,5
41601,HUAYLLAMARCA,estado nutricional en menores de 5 anos,clasificacion f,2003-11-01,1,0,1,0,1
10304,ICLA,estado nutricional en menores de 5 anos,clasificacion f,2003-11-01,7,3,7,3,10
10703,INCAHUASI,estado nutricional en menores de 5 anos,clasificacion f,2003-11-01,29,10,29,10,39
21001,INQUISIVI,estado nutricional en menores de 5 anos,clasificacion f,2003-11-01,3,3,3,3,6
21501,IXIAMAS,estado nutricional en menores de 5 anos,clasificacion f,2003-11-01,3,4,3,4,7
21105,LA ASUNTA,estado nutricional en menores de 5 anos,clasificacion f,2003-11-01,2,0,2,0,2
70104,LA GUARDIA,estado nutricional en menores de 5 anos,clasificacion f,2003-11-01,0,1,0,1,1
20101,LA PAZ,estado nutricional en menores de 5 anos,clasificacion f,2003-11-01,24,14,24,14,38
10903,LAS CARRERAS,estado nutricional en menores de 5 anos,clasificacion f,2003-11-01,1,0,1,0,1
50203,LLALLAGUA,estado nutricional en menores de 5 anos,clasificacion f,2003-11-01,15,15,15,15,30
20901,LURIBAY,estado nutricional en menores de 5 anos,clasificacion f,2003-11-01,2,0,2,0,2
11003,MACHARETI,estado nutricional en menores de 5 anos,clasificacion f,2003-11-01,1,1,1,1,2
80801,MAGDALENA,estado nutricional en menores de 5 anos,clasificacion f,2003-11-01,0,3,0,3,3
20103,MECAPACA,estado nutricional en menores de 5 anos,clasificacion f,2003-11-01,0,2,0,2,2
31301,MIZQUE,estado nutricional en menores de 5 anos,clasificacion f,2003-11-01,5,1,5,1,6
20402,MOCOMOCO,estado nutricional en menores de 5 anos,clasificacion f,2003-11-01,5,3,5,3,8
10303,MOJOCOYA,estado nutricional en menores de 5 anos,clasificacion f,2003-11-01,4,1,4,1,5
10501,MONTEAGUDO,estado nutricional en menores de 5 anos,clasificacion f,2003-11-01,8,4,8,4,12
30302,MOROCHATA,estado nutricional en menores de 5 anos,clasificacion f,2003-11-01,0,7,0,7,7
50404,OCURI,estado nutricional en menores de 5 anos,clasificacion f,2003-11-01,13,8,13,8,21
30203,OMEREQUE,estado nutricional en menores de 5 anos,clasificacion f,2003-11-01,1,0,1,0,1
40101,ORURO,estado nutricional en menores de 5 anos,clasificacion f,2003-11-01,21,7,21,7,28
10401,PADILLA,estado nutricional en menores de 5 anos,clasificacion f,2003-11-01,6,6,6,6,12
70502,PAILON,estado nutricional en menores de 5 anos,clasificacion f,2003-11-01,0,1,0,1,1
21104,PALOS BLANCOS,estado nutricional en menores de 5 anos,clasificacion f,2003-11-01,1,0,1,0,1
30202,PASORAPA,estado nutricional en menores de 5 anos,clasificacion f,2003-11-01,1,0,1,0,1
21305,PATACAMAYA,estado nutricional en menores de 5 anos,clasificacion f,2003-11-01,2,3,2,3,5
20702,PELECHUCO,estado nutricional en menores de 5 anos,clasificacion f,2003-11-01,2,1,2,1,3
50403,POCOATA,estado nutricional en menores de 5 anos,clasificacion f,2003-11-01,4,5,4,5,9
31203,POCONA,estado nutricional en menores de 5 anos,clasificacion f,2003-11-01,3,2,3,2,5
31202,POJO (CBBA),estado nutricional en menores de 5 anos,clasificacion f,2003-11-01,9,4,9,4,13
51203,PORCO,estado nutricional en menores de 5 anos,clasificacion f,2003-11-01,0,2,0,2,2
10103,POROMA,estado nutricional en menores de 5 anos,clasificacion f,2003-11-01,7,8,7,8,15
70601,PORTACHUELO,estado nutricional en menores de 5 anos,clasificacion f,2003-11-01,2,0,2,0,2
50101,POTOSI,estado nutricional en menores de 5 anos,clasificacion f,2003-11-01,21,4,21,4,25
10302,PRESTO,estado nutricional en menores de 5 anos,clasificacion f,2003-11-01,2,1,2,1,3
21201,PUCARANI,estado nutricional en menores de 5 anos,clasificacion f,2003-11-01,1,1,1,1,2
20401,PUERTO ACOSTA,estado nutricional en menores de 5 anos,clasificacion f,2003-11-01,1,1,1,1,2
20403,PUERTO CARABUCO,estado nutricional en menores de 5 anos,clasificacion f,2003-11-01,1,0,1,0,1
90301,PUERTO GONZALO MORENO,estado nutricional en menores de 5 anos,clasificacion f,2003-11-01,1,1,1,1,2
21204,PUERTO PEREZ,estado nutricional en menores de 5 anos,clasificacion f,2003-11-01,1,0,1,0,1
90201,PUERTO RICO,estado nutricional en menores de 5 anos,clasificacion f,2003-11-01,0,1,0,1,1
31205,PUERTO VILLARROEL,estado nutricional en menores de 5 anos,clasificacion f,2003-11-01,18,26,18,26,44
51101,PUNA,estado nutricional en menores de 5 anos,clasificacion f,2003-11-01,9,3,9,3,12
31401,PUNATA,estado nutricional en menores de 5 anos,clasificacion f,2003-11-01,7,2,7,2,9
30901,QUILLACOLLO,estado nutricional en menores de 5 anos,clasificacion f,2003-11-01,6,2,6,2,8
21002,QUIME,estado nutricional en menores de 5 anos,clasificacion f,2003-11-01,3,1,3,1,4
50402,RAVELO,estado nutricional en menores de 5 anos,clasificacion f,2003-11-01,14,13,14,13,27
80301,REYES,estado nutricional en menores de 5 anos,clasificacion f,2003-11-01,4,0,4,0,4
80201,RIBERALTA,estado nutricional en menores de 5 anos,clasificacion f,2003-11-01,28,14,28,14,42
70503,ROBORE,estado nutricional en menores de 5 anos,clasificacion f,2003-11-01,4,1,4,1,5
80304,RURRENABAQUE,estado nutricional en menores de 5 anos,clasificacion f,2003-11-01,1,1,1,1,2
31001,SACABA,estado nutricional en menores de 5 anos,clasificacion f,2003-11-01,3,2,3,2,5
30404,SACABAMBA,estado nutricional en menores de 5 anos,clasificacion f,2003-11-01,0,2,0,2,2
50701,SACACA,estado nutricional en menores de 5 anos,clasificacion f,2003-11-01,19,13,19,13,32
80602,SAN ANDRES,estado nutricional en menores de 5 anos,clasificacion f,2003-11-01,1,0,1,0,1
71105,SAN ANTONIO DE LOMERIO,estado nutricional en menores de 5 anos,clasificacion f,2003-11-01,5,7,5,7,12
80302,SAN BORJA,estado nutricional en menores de 5 anos,clasificacion f,2003-11-01,14,8,14,8,22
21502,SAN BUENA VENTURA,estado nutricional en menores de 5 anos,clasificacion f,2003-11-01,1,1,1,1,2
70402,SAN CARLOS,estado nutricional en menores de 5 anos,clasificacion f,2003-11-01,2,0,2,0,2
80501,SAN IGNACIO,estado nutricional en menores de 5 anos,clasificacion f,2003-11-01,13,5,13,5,18
70301,SAN IGNACIO DE VELASCO,estado nutricional en menores de 5 anos,clasificacion f,2003-11-01,16,7,16,7,23
80102,SAN JAVIER(BNI),estado nutricional en menores de 5 anos,clasificacion f,2003-11-01,0,1,0,1,1
71102,SAN JAVIER(STC),estado nutricional en menores de 5 anos,clasificacion f,2003-11-01,3,1,3,1,4
70501,SAN JOSE DE CHIQUITOS,estado nutricional en menores de 5 anos,clasificacion f,2003-11-01,0,2,0,2,2
71104,SAN JULIAN,estado nutricional en menores de 5 anos,clasificacion f,2003-11-01,6,4,6,4,10
60501,SAN LORENZO(TJA),estado nutricional en menores de 5 anos,clasificacion f,2003-11-01,2,4,2,4,6
10702,SAN LUCAS,estado nutricional en menores de 5 anos,clasificacion f,2003-11-01,16,11,16,11,27
70302,SAN MIGUEL DE VELASCO,estado nutricional en menores de 5 anos,clasificacion f,2003-11-01,2,0,2,0,2
50501,SAN PEDRO DE BUENA VISTA,estado nutricional en menores de 5 anos,clasificacion f,2003-11-01,6,13,6,13,19
21801,SAN PEDRO DE CURAHUARA,estado nutricional en menores de 5 anos,clasificacion f,2003-11-01,1,0,1,0,1
70303,SAN RAFAEL,estado nutricional en menores de 5 anos,clasificacion f,2003-11-01,0,1,0,1,1
70101,SANTA CRUZ DE LA SIERRA,estado nutricional en menores de 5 anos,clasificacion f,2003-11-01,9,2,9,2,11
20308,SANTIAGO DE CALLAPA,estado nutricional en menores de 5 anos,clasificacion f,2003-11-01,1,2,1,2,3
30702,SANTIVAÑES,estado nutricional en menores de 5 anos,clasificacion f,2003-11-01,1,0,1,0,1
20902,SAPAHAQUI,estado nutricional en menores de 5 anos,clasificacion f,2003-11-01,3,1,3,1,4
90303,SENA,estado nutricional en menores de 5 anos,clasificacion f,2003-11-01,1,0,1,0,1
21301,SICA SICA (VILLA AROMA),estado nutricional en menores de 5 anos,clasificacion f,2003-11-01,4,3,4,3,7
30902,SIPE SIPE,estado nutricional en menores de 5 anos,clasificacion f,2003-11-01,7,2,7,2,9
10403,SOPACHUY,estado nutricional en menores de 5 anos,clasificacion f,2003-11-01,10,9,10,9,19
20601,SORATA,estado nutricional en menores de 5 anos,clasificacion f,2003-11-01,0,1,0,1,1
10101,SUCRE,estado nutricional en menores de 5 anos,clasificacion f,2003-11-01,17,10,17,10,27
50303,TACOBAMBA,estado nutricional en menores de 5 anos,clasificacion f,2003-11-01,9,3,9,3,12
30602,TACOPAYA,estado nutricional en menores de 5 anos,clasificacion f,2003-11-01,6,2,6,2,8
31101,TAPACARI,estado nutricional en menores de 5 anos,clasificacion f,2003-11-01,6,1,6,1,7
10601,TARABUCO,estado nutricional en menores de 5 anos,clasificacion f,2003-11-01,28,14,28,14,42
30401,TARATA,estado nutricional en menores de 5 anos,clasificacion f,2003-11-01,2,1,2,1,3
60101,TARIJA,estado nutricional en menores de 5 anos,clasificacion f,2003-11-01,1,1,1,1,2
10202,TARVITA,estado nutricional en menores de 5 anos,clasificacion f,2003-11-01,15,9,15,9,24
20803,TIAWANACU,estado nutricional en menores de 5 anos,clasificacion f,2003-11-01,2,0,2,0,2
50102,TINGUIPAYA,estado nutricional en menores de 5 anos,clasificacion f,2003-11-01,20,10,20,10,30
20606,TIPUANI,estado nutricional en menores de 5 anos,clasificacion f,2003-11-01,1,0,1,0,1
31601,TIRAQUE (CBBA),estado nutricional en menores de 5 anos,clasificacion f,2003-11-01,12,2,12,2,14
30803,TOLATA,estado nutricional en menores de 5 anos,clasificacion f,2003-11-01,2,1,2,1,3
51202,TOMAVE,estado nutricional en menores de 5 anos,clasificacion f,2003-11-01,5,1,5,1,6
10402,TOMINA,estado nutricional en menores de 5 anos,clasificacion f,2003-11-01,9,25,9,25,34
50502,TORO TORO,estado nutricional en menores de 5 anos,clasificacion f,2003-11-01,8,14,8,14,22
31201,TOTORA(CBBA),estado nutricional en menores de 5 anos,clasificacion f,2003-11-01,2,1,2,1,3
41301,TOTORA(ORR),estado nutricional en menores de 5 anos,clasificacion f,2003-11-01,0,1,0,1,1
70802,TRIGAL,estado nutricional en menores de 5 anos,clasificacion f,2003-11-01,1,0,1,0,1
80101,TRINIDAD,estado nutricional en menores de 5 anos,clasificacion f,2003-11-01,3,6,3,6,9
50801,TUPIZA,estado nutricional en menores de 5 anos,clasificacion f,2003-11-01,6,3,6,3,9
50201,UNCIA,estado nutricional en menores de 5 anos,clasificacion f,2003-11-01,2,1,2,1,3
60401,URIONDO (A. CONCEPCION),estado nutricional en menores de 5 anos,clasificacion f,2003-11-01,1,2,1,2,3
51201,UYUNI,estado nutricional en menores de 5 anos,clasificacion f,2003-11-01,0,2,0,2,2
30502,VACAS,estado nutricional en menores de 5 anos,clasificacion f,2003-11-01,9,5,9,5,14
70801,VALLEGRANDE,estado nutricional en menores de 5 anos,clasificacion f,2003-11-01,1,0,1,0,1
20801,VIACHA,estado nutricional en menores de 5 anos,clasificacion f,2003-11-01,2,1,2,1,3
31302,VILA VILA,estado nutricional en menores de 5 anos,clasificacion f,2003-11-01,3,0,3,0,3
60303,VILLA MONTES,estado nutricional en menores de 5 anos,clasificacion f,2003-11-01,4,0,4,0,4
10801,VILLA SERRANO,estado nutricional en menores de 5 anos,clasificacion f,2003-11-01,6,11,6,11,17
31003,VILLA TUNARI,estado nutricional en menores de 5 anos,clasificacion f,2003-11-01,17,14,17,14,31
11001,VILLA VACA GUZMAN (MUYUPAMPA),estado nutricional en menores de 5 anos,clasificacion f,2003-11-01,3,0,3,0,3
51501,VILLAZON,estado nutricional en menores de 5 anos,clasificacion f,2003-11-01,2,1,2,1,3
50602,VITICHI,estado nutricional en menores de 5 anos,clasificacion f,2003-11-01,7,5,7,5,12
20903,YACO,estado nutricional en menores de 5 anos,clasificacion f,2003-11-01,5,0,5,0,5
60301,YACUIBA,estado nutricional en menores de 5 anos,clasificacion f,2003-11-01,1,0,1,0,1
10602,YAMPARAEZ,estado nutricional en menores de 5 anos,clasificacion f,2003-11-01,13,6,13,6,19
21103,YANACACHI,estado nutricional en menores de 5 anos,clasificacion f,2003-11-01,1,0,1,0,1
70403,YAPACANI,estado nutricional en menores de 5 anos,clasificacion f,2003-11-01,7,2,7,2,9
10102,YOTALA,estado nutricional en menores de 5 anos,clasificacion f,2003-11-01,6,2,6,2,8
60402,YUNCHARA,estado nutricional en menores de 5 anos,clasificacion f,2003-11-01,0,1,0,1,1
10301,ZUDAÑEZ,estado nutricional en menores de 5 anos,clasificacion f,2003-11-01,4,2,4,2,6
51302,ACACIO,estado nutricional en menores de 5 anos,clasificacion f,2003-12-01,6,10,6,10,16
20104,ACHOCALLA,estado nutricional en menores de 5 anos,clasificacion f,2003-12-01,0,2,0,2,2
30201,AIQUILE,estado nutricional en menores de 5 anos,clasificacion f,2003-12-01,3,0,3,0,3
10404,ALCALA,estado nutricional en menores de 5 anos,clasificacion f,2003-12-01,1,1,1,1,2
20202,ANCORAIMES,estado nutricional en menores de 5 anos,clasificacion f,2003-12-01,0,1,0,1,1
20701,APOLO,estado nutricional en menores de 5 anos,clasificacion f,2003-12-01,1,0,1,0,1
51301,ARAMPAMPA,estado nutricional en menores de 5 anos,clasificacion f,2003-12-01,0,1,0,1,1
30501,ARANI,estado nutricional en menores de 5 anos,clasificacion f,2003-12-01,1,0,1,0,1
71501,ASCENCION DE GUARAYOS,estado nutricional en menores de 5 anos,clasificacion f,2003-12-01,7,12,7,12,19
50802,ATOCHA,estado nutricional en menores de 5 anos,clasificacion f,2003-12-01,0,3,0,3,3
20503,AUCAPATA,estado nutricional en menores de 5 anos,clasificacion f,2003-12-01,0,1,0,1,1
20502,AYATA,estado nutricional en menores de 5 anos,clasificacion f,2003-12-01,3,0,3,0,3
30301,AYOPAYA (V. DE INDEPENDENCIA),estado nutricional en menores de 5 anos,clasificacion f,2003-12-01,1,0,1,0,1
10201,AZURDUY,estado nutricional en menores de 5 anos,clasificacion f,2003-12-01,10,9,10,9,19
21203,BATALLAS,estado nutricional en menores de 5 anos,clasificacion f,2003-12-01,1,0,1,0,1
50301,BETANZOS,estado nutricional en menores de 5 anos,clasificacion f,2003-12-01,28,11,28,11,39
70707,BOYUIBE,estado nutricional en menores de 5 anos,clasificacion f,2003-12-01,2,0,2,0,2
70401,BUENA VISTA,estado nutricional en menores de 5 anos,clasificacion f,2003-12-01,1,2,1,2,3
20905,CAIROMA,estado nutricional en menores de 5 anos,clasificacion f,2003-12-01,5,1,5,1,6
51102,"CAIZA ""D""",estado nutricional en menores de 5 anos,clasificacion f,2003-12-01,1,2,1,2,3
21003,CAJUATA,estado nutricional en menores de 5 anos,clasificacion f,2003-12-01,2,0,2,0,2
21304,CALAMARCA,estado nutricional en menores de 5 anos,clasificacion f,2003-12-01,4,1,4,1,5
10701,CAMARGO,estado nutricional en menores de 5 anos,clasificacion f,2003-12-01,1,0,1,0,1
70706,CAMIRI,estado nutricional en menores de 5 anos,clasificacion f,2003-12-01,1,0,1,0,1
30701,CAPINOTA,estado nutricional en menores de 5 anos,clasificacion f,2003-12-01,8,2,8,2,10
20302,CAQUIAVIRI,estado nutricional en menores de 5 anos,clasificacion f,2003-12-01,1,1,1,1,2
40102,CARACOLLO,estado nutricional en menores de 5 anos,clasificacion f,2003-12-01,4,0,4,0,4
22001,CARANAVI,estado nutricional en menores de 5 anos,clasificacion f,2003-12-01,8,10,8,10,18
60302,CARAPARI,estado nutricional en menores de 5 anos,clasificacion f,2003-12-01,0,1,0,1,1
50702,CARIPUYO,estado nutricional en menores de 5 anos,clasificacion f,2003-12-01,3,5,3,5,8
40201,CHALLAPATA,estado nutricional en menores de 5 anos,clasificacion f,2003-12-01,4,3,4,3,7
50302,CHAQUI,estado nutricional en menores de 5 anos,clasificacion f,2003-12-01,2,1,2,1,3
70702,CHARAGUA,estado nutricional en menores de 5 anos,clasificacion f,2003-12-01,11,6,11,6,17
50202,CHAYANTA,estado nutricional en menores de 5 anos,clasificacion f,2003-12-01,7,5,7,5,12
20501,CHUMA,estado nutricional en menores de 5 anos,clasificacion f,2003-12-01,2,0,2,0,2
90101,COBIJA,estado nutricional en menores de 5 anos,clasificacion f,2003-12-01,2,0,2,0,2
30101,COCHABAMBA,estado nutricional en menores de 5 anos,clasificacion f,2003-12-01,20,8,20,8,28
30905,COLCAPIRHUA,estado nutricional en menores de 5 anos,clasificacion f,2003-12-01,0,1,0,1,1
21307,COLLANA,estado nutricional en menores de 5 anos,clasificacion f,2003-12-01,1,0,1,0,1
31002,COLOMI,estado nutricional en menores de 5 anos,clasificacion f,2003-12-01,5,1,5,1,6
50401,COLQUECHACA,estado nutricional en menores de 5 anos,clasificacion f,2003-12-01,22,7,22,7,29
21306,COLQUENCHA,estado nutricional en menores de 5 anos,clasificacion f,2003-12-01,1,0,1,0,1
21004,COLQUIRI,estado nutricional en menores de 5 anos,clasificacion f,2003-12-01,3,0,3,0,3
71301,COMARAPA,estado nutricional en menores de 5 anos,clasificacion f,2003-12-01,3,1,3,1,4
20605,COMBAYA,estado nutricional en menores de 5 anos,clasificacion f,2003-12-01,1,0,1,0,1
71101,CONCEPCION,estado nutricional en menores de 5 anos,clasificacion f,2003-12-01,1,0,1,0,1
50601,COTAGAITA,estado nutricional en menores de 5 anos,clasificacion f,2003-12-01,9,4,9,4,13
31405,CUCHUMUELA (V. G. VILLARROEL),estado nutricional en menores de 5 anos,clasificacion f,2003-12-01,1,0,1,0,1
70704,CUEVO,estado nutricional en menores de 5 anos,clasificacion f,2003-12-01,1,0,1,0,1
10902,CULPINA,estado nutricional en menores de 5 anos,clasificacion f,2003-12-01,0,5,0,5,5
21602,CURVA,estado nutricional en menores de 5 anos,clasificacion f,2003-12-01,2,0,2,0,2
20105,EL ALTO,estado nutricional en menores de 5 anos,clasificacion f,2003-12-01,50,32,50,32,82
71503,EL PUENTE(STC),estado nutricional en menores de 5 anos,clasificacion f,2003-12-01,4,0,4,0,4
60502,EL PUENTE(TJA),estado nutricional en menores de 5 anos,clasificacion f,2003-12-01,1,0,1,0,1
70105,EL TORNO,estado nutricional en menores de 5 anos,clasificacion f,2003-12-01,1,1,1,1,2
10405,EL VILLAR,estado nutricional en menores de 5 anos,clasificacion f,2003-12-01,4,2,4,2,6
60601,ENTRE RIOS,estado nutricional en menores de 5 anos,clasificacion f,2003-12-01,1,0,1,0,1
80402,EXALTACION,estado nutricional en menores de 5 anos,clasificacion f,2003-12-01,3,3,3,3,6
71002,GENERAL SAAVEDRA,estado nutricional en menores de 5 anos,clasificacion f,2003-12-01,7,5,7,5,12
21601,GRAL. J.J. PEREZ (CHARAZANI),estado nutricional en menores de 5 anos,clasificacion f,2003-12-01,1,0,1,0,1
20602,GUANAY,estado nutricional en menores de 5 anos,clasificacion f,2003-12-01,4,0,4,0,4
20802,GUAQUI,estado nutricional en menores de 5 anos,clasificacion f,2003-12-01,1,0,1,0,1
80202,GUAYARAMERIN,estado nutricional en menores de 5 anos,clasificacion f,2003-12-01,4,3,4,3,7
70705,GUTIERREZ,estado nutricional en menores de 5 anos,clasificacion f,2003-12-01,8,4,8,4,12
10502,HUACARETA,estado nutricional en menores de 5 anos,clasificacion f,2003-12-01,1,1,1,1,2
11002,HUACAYA (VILLA DE HUACAYA),estado nutricional en menores de 5 anos,clasificacion f,2003-12-01,2,1,2,1,3
40501,HUACHACALLA,estado nutricional en menores de 5 anos,clasificacion f,2003-12-01,1,0,1,0,1
40701,HUANUNI,estado nutricional en menores de 5 anos,clasificacion f,2003-12-01,1,1,1,1,2
41601,HUAYLLAMARCA,estado nutricional en menores de 5 anos,clasificacion f,2003-12-01,1,0,1,0,1
10304,ICLA,estado nutricional en menores de 5 anos,clasificacion f,2003-12-01,4,4,4,4,8
10703,INCAHUASI,estado nutricional en menores de 5 anos,clasificacion f,2003-12-01,3,2,3,2,5
21001,INQUISIVI,estado nutricional en menores de 5 anos,clasificacion f,2003-12-01,2,2,2,2,4
21501,IXIAMAS,estado nutricional en menores de 5 anos,clasificacion f,2003-12-01,1,2,1,2,3
70104,LA GUARDIA,estado nutricional en menores de 5 anos,clasificacion f,2003-12-01,4,1,4,1,5
20101,LA PAZ,estado nutricional en menores de 5 anos,clasificacion f,2003-12-01,19,7,19,7,26
21202,LAJA,estado nutricional en menores de 5 anos,clasificacion f,2003-12-01,1,0,1,0,1
10903,LAS CARRERAS,estado nutricional en menores de 5 anos,clasificacion f,2003-12-01,1,1,1,1,2
50203,LLALLAGUA,estado nutricional en menores de 5 anos,clasificacion f,2003-12-01,6,4,6,4,10
20901,LURIBAY,estado nutricional en menores de 5 anos,clasificacion f,2003-12-01,1,0,1,0,1
11003,MACHARETI,estado nutricional en menores de 5 anos,clasificacion f,2003-12-01,2,1,2,1,3
70903,MAIRANA,estado nutricional en menores de 5 anos,clasificacion f,2003-12-01,2,1,2,1,3
71003,MINEROS,estado nutricional en menores de 5 anos,clasificacion f,2003-12-01,13,2,13,2,15
20402,MOCOMOCO,estado nutricional en menores de 5 anos,clasificacion f,2003-12-01,3,4,3,4,7
10303,MOJOCOYA,estado nutricional en menores de 5 anos,clasificacion f,2003-12-01,3,0,3,0,3
10501,MONTEAGUDO,estado nutricional en menores de 5 anos,clasificacion f,2003-12-01,4,3,4,3,7
71001,MONTERO,estado nutricional en menores de 5 anos,clasificacion f,2003-12-01,11,8,11,8,19
30302,MOROCHATA,estado nutricional en menores de 5 anos,clasificacion f,2003-12-01,2,2,2,2,4
50404,OCURI,estado nutricional en menores de 5 anos,clasificacion f,2003-12-01,6,3,6,3,9
40101,ORURO,estado nutricional en menores de 5 anos,clasificacion f,2003-12-01,22,4,22,4,26
10401,PADILLA,estado nutricional en menores de 5 anos,clasificacion f,2003-12-01,10,4,10,4,14
20102,PALCA,estado nutricional en menores de 5 anos,clasificacion f,2003-12-01,2,1,2,1,3
21104,PALOS BLANCOS,estado nutricional en menores de 5 anos,clasificacion f,2003-12-01,1,2,1,2,3
70902,PAMPA GRANDE,estado nutricional en menores de 5 anos,clasificacion f,2003-12-01,3,0,3,0,3
30202,PASORAPA,estado nutricional en menores de 5 anos,clasificacion f,2003-12-01,0,4,0,4,4
21305,PATACAMAYA,estado nutricional en menores de 5 anos,clasificacion f,2003-12-01,4,4,4,4,8
40602,PAZÑA,estado nutricional en menores de 5 anos,clasificacion f,2003-12-01,0,1,0,1,1
20702,PELECHUCO,estado nutricional en menores de 5 anos,clasificacion f,2003-12-01,0,1,0,1,1
50403,POCOATA,estado nutricional en menores de 5 anos,clasificacion f,2003-12-01,8,12,8,12,20
31203,POCONA,estado nutricional en menores de 5 anos,clasificacion f,2003-12-01,1,3,1,3,4
31202,POJO (CBBA),estado nutricional en menores de 5 anos,clasificacion f,2003-12-01,8,0,8,0,8
51203,PORCO,estado nutricional en menores de 5 anos,clasificacion f,2003-12-01,0,1,0,1,1
10103,POROMA,estado nutricional en menores de 5 anos,clasificacion f,2003-12-01,7,5,7,5,12
50101,POTOSI,estado nutricional en menores de 5 anos,clasificacion f,2003-12-01,16,13,16,13,29
10302,PRESTO,estado nutricional en menores de 5 anos,clasificacion f,2003-12-01,5,4,5,4,9
21201,PUCARANI,estado nutricional en menores de 5 anos,clasificacion f,2003-12-01,2,0,2,0,2
20401,PUERTO ACOSTA,estado nutricional en menores de 5 anos,clasificacion f,2003-12-01,2,0,2,0,2
20403,PUERTO CARABUCO,estado nutricional en menores de 5 anos,clasificacion f,2003-12-01,1,0,1,0,1
90301,PUERTO GONZALO MORENO,estado nutricional en menores de 5 anos,clasificacion f,2003-12-01,1,2,1,2,3
80703,PUERTO SILES,estado nutricional en menores de 5 anos,clasificacion f,2003-12-01,0,1,0,1,1
31205,PUERTO VILLARROEL,estado nutricional en menores de 5 anos,clasificacion f,2003-12-01,27,19,27,19,46
51101,PUNA,estado nutricional en menores de 5 anos,clasificacion f,2003-12-01,11,2,11,2,13
31401,PUNATA,estado nutricional en menores de 5 anos,clasificacion f,2003-12-01,11,0,11,0,11
30901,QUILLACOLLO,estado nutricional en menores de 5 anos,clasificacion f,2003-12-01,3,1,3,1,4
21002,QUIME,estado nutricional en menores de 5 anos,clasificacion f,2003-12-01,2,0,2,0,2
50402,RAVELO,estado nutricional en menores de 5 anos,clasificacion f,2003-12-01,4,7,4,7,11
80301,REYES,estado nutricional en menores de 5 anos,clasificacion f,2003-12-01,1,2,1,2,3
80201,RIBERALTA,estado nutricional en menores de 5 anos,clasificacion f,2003-12-01,39,22,39,22,61
40901,SABAYA,estado nutricional en menores de 5 anos,clasificacion f,2003-12-01,0,2,0,2,2
31001,SACABA,estado nutricional en menores de 5 anos,clasificacion f,2003-12-01,1,0,1,0,1
50701,SACACA,estado nutricional en menores de 5 anos,clasificacion f,2003-12-01,27,16,27,16,43
40801,SALINAS DE GARCI MENDOZA,estado nutricional en menores de 5 anos,clasificacion f,2003-12-01,0,1,0,1,1
70901,SAMAIPATA,estado nutricional en menores de 5 anos,clasificacion f,2003-12-01,2,0,2,0,2
31403,SAN BENITO,estado nutricional en menores de 5 anos,clasificacion f,2003-12-01,3,0,3,0,3
80302,SAN BORJA,estado nutricional en menores de 5 anos,clasificacion f,2003-12-01,10,5,10,5,15
21502,SAN BUENA VENTURA,estado nutricional en menores de 5 anos,clasificacion f,2003-12-01,2,0,2,0,2
70402,SAN CARLOS,estado nutricional en menores de 5 anos,clasificacion f,2003-12-01,2,0,2,0,2
80501,SAN IGNACIO,estado nutricional en menores de 5 anos,clasificacion f,2003-12-01,3,5,3,5,8
70301,SAN IGNACIO DE VELASCO,estado nutricional en menores de 5 anos,clasificacion f,2003-12-01,4,0,4,0,4
71102,SAN JAVIER(STC),estado nutricional en menores de 5 anos,clasificacion f,2003-12-01,1,2,1,2,3
80701,SAN JOAQUIN,estado nutricional en menores de 5 anos,clasificacion f,2003-12-01,1,0,1,0,1
71104,SAN JULIAN,estado nutricional en menores de 5 anos,clasificacion f,2003-12-01,3,2,3,2,5
90302,SAN LORENZO(PND),estado nutricional en menores de 5 anos,clasificacion f,2003-12-01,0,1,0,1,1
60501,SAN LORENZO(TJA),estado nutricional en menores de 5 anos,clasificacion f,2003-12-01,3,3,3,3,6
10702,SAN LUCAS,estado nutricional en menores de 5 anos,clasificacion f,2003-12-01,13,16,13,16,29
71201,SAN MATIAS,estado nutricional en menores de 5 anos,clasificacion f,2003-12-01,4,0,4,0,4
70302,SAN MIGUEL DE VELASCO,estado nutricional en menores de 5 anos,clasificacion f,2003-12-01,0,1,0,1,1
50501,SAN PEDRO DE BUENA VISTA,estado nutricional en menores de 5 anos,clasificacion f,2003-12-01,7,14,7,14,21
70303,SAN RAFAEL,estado nutricional en menores de 5 anos,clasificacion f,2003-12-01,1,1,1,1,2
80401,SANTA ANA,estado nutricional en menores de 5 anos,clasificacion f,2003-12-01,5,2,5,2,7
70101,SANTA CRUZ DE LA SIERRA,estado nutricional en menores de 5 anos,clasificacion f,2003-12-01,15,4,15,4,19
80303,SANTA ROSA,estado nutricional en menores de 5 anos,clasificacion f,2003-12-01,3,1,3,1,4
41401,SANTIAGO DE HUARI,estado nutricional en menores de 5 anos,clasificacion f,2003-12-01,1,0,1,0,1
30702,SANTIVAÑES,estado nutricional en menores de 5 anos,clasificacion f,2003-12-01,2,1,2,1,3
20902,SAPAHAQUI,estado nutricional en menores de 5 anos,clasificacion f,2003-12-01,4,0,4,0,4
21301,SICA SICA (VILLA AROMA),estado nutricional en menores de 5 anos,clasificacion f,2003-12-01,9,3,9,3,12
30902,SIPE SIPE,estado nutricional en menores de 5 anos,clasificacion f,2003-12-01,7,0,7,0,7
10403,SOPACHUY,estado nutricional en menores de 5 anos,clasificacion f,2003-12-01,1,1,1,1,2
20601,SORATA,estado nutricional en menores de 5 anos,clasificacion f,2003-12-01,1,1,1,1,2
10101,SUCRE,estado nutricional en menores de 5 anos,clasificacion f,2003-12-01,13,7,13,7,20
50303,TACOBAMBA,estado nutricional en menores de 5 anos,clasificacion f,2003-12-01,4,1,4,1,5
30602,TACOPAYA,estado nutricional en menores de 5 anos,clasificacion f,2003-12-01,2,2,2,2,4
31101,TAPACARI,estado nutricional en menores de 5 anos,clasificacion f,2003-12-01,7,5,7,5,12
10601,TARABUCO,estado nutricional en menores de 5 anos,clasificacion f,2003-12-01,27,24,27,24,51
30401,TARATA,estado nutricional en menores de 5 anos,clasificacion f,2003-12-01,4,1,4,1,5
60101,TARIJA,estado nutricional en menores de 5 anos,clasificacion f,2003-12-01,18,5,18,5,23
10202,TARVITA,estado nutricional en menores de 5 anos,clasificacion f,2003-12-01,1,0,1,0,1
50102,TINGUIPAYA,estado nutricional en menores de 5 anos,clasificacion f,2003-12-01,2,14,2,14,16
31601,TIRAQUE (CBBA),estado nutricional en menores de 5 anos,clasificacion f,2003-12-01,14,4,14,4,18
30802,TOCO,estado nutricional en menores de 5 anos,clasificacion f,2003-12-01,0,1,0,1,1
30803,TOLATA,estado nutricional en menores de 5 anos,clasificacion f,2003-12-01,1,1,1,1,2
41001,TOLEDO,estado nutricional en menores de 5 anos,clasificacion f,2003-12-01,1,0,1,0,1
51202,TOMAVE,estado nutricional en menores de 5 anos,clasificacion f,2003-12-01,2,2,2,2,4
10402,TOMINA,estado nutricional en menores de 5 anos,clasificacion f,2003-12-01,11,20,11,20,31
50502,TORO TORO,estado nutricional en menores de 5 anos,clasificacion f,2003-12-01,10,1,10,1,11
31201,TOTORA(CBBA),estado nutricional en menores de 5 anos,clasificacion f,2003-12-01,2,4,2,4,6
70802,TRIGAL,estado nutricional en menores de 5 anos,clasificacion f,2003-12-01,0,1,0,1,1
80101,TRINIDAD,estado nutricional en menores de 5 anos,clasificacion f,2003-12-01,8,3,8,3,11
50801,TUPIZA,estado nutricional en menores de 5 anos,clasificacion f,2003-12-01,5,1,5,1,6
21302,UMALA,estado nutricional en menores de 5 anos,clasificacion f,2003-12-01,1,0,1,0,1
50201,UNCIA,estado nutricional en menores de 5 anos,clasificacion f,2003-12-01,2,1,2,1,3
71502,URUBICHA,estado nutricional en menores de 5 anos,clasificacion f,2003-12-01,0,1,0,1,1
51201,UYUNI,estado nutricional en menores de 5 anos,clasificacion f,2003-12-01,1,1,1,1,2
30502,VACAS,estado nutricional en menores de 5 anos,clasificacion f,2003-12-01,1,0,1,0,1
70801,VALLEGRANDE,estado nutricional en menores de 5 anos,clasificacion f,2003-12-01,4,5,4,5,9
20801,VIACHA,estado nutricional en menores de 5 anos,clasificacion f,2003-12-01,5,1,5,1,6
31302,VILA VILA,estado nutricional en menores de 5 anos,clasificacion f,2003-12-01,5,0,5,0,5
60303,VILLA MONTES,estado nutricional en menores de 5 anos,clasificacion f,2003-12-01,4,1,4,1,5
31402,VILLA RIVERO,estado nutricional en menores de 5 anos,clasificacion f,2003-12-01,5,0,5,0,5
10801,VILLA SERRANO,estado nutricional en menores de 5 anos,clasificacion f,2003-12-01,4,5,4,5,9
31003,VILLA TUNARI,estado nutricional en menores de 5 anos,clasificacion f,2003-12-01,16,5,16,5,21
11001,VILLA VACA GUZMAN (MUYUPAMPA),estado nutricional en menores de 5 anos,clasificacion f,2003-12-01,1,2,1,2,3
50602,VITICHI,estado nutricional en menores de 5 anos,clasificacion f,2003-12-01,4,2,4,2,6
20903,YACO,estado nutricional en menores de 5 anos,clasificacion f,2003-12-01,3,1,3,1,4
60301,YACUIBA,estado nutricional en menores de 5 anos,clasificacion f,2003-12-01,3,1,3,1,4
10602,YAMPARAEZ,estado nutricional en menores de 5 anos,clasificacion f,2003-12-01,18,4,18,4,22
70403,YAPACANI,estado nutricional en menores de 5 anos,clasificacion f,2003-12-01,8,1,8,1,9
60402,YUNCHARA,estado nutricional en menores de 5 anos,clasificacion f,2003-12-01,1,3,1,3,4
10301,ZUDAÑEZ,estado nutricional en menores de 5 anos,clasificacion f,2003-12-01,5,3,5,3,8
