codigo_municipio,municipio,grupo,variable,mes,total-H,total-M,TOTAL-H1,TOTAL-M1,TOTAL
51302,ACACIO,estado nutricional en menores de 5 anos,clasificacion e,2003-01-01,28,40,28,40,68
20201,ACHACACHI,estado nutricional en menores de 5 anos,clasificacion e,2003-01-01,34,29,34,29,63
20104,ACHOCALLA,estado nutricional en menores de 5 anos,clasificacion e,2003-01-01,9,2,9,2,11
30201,AIQUILE,estado nutricional en menores de 5 anos,clasificacion e,2003-01-01,11,9,11,9,20
31303,ALALAY,estado nutricional en menores de 5 anos,clasificacion e,2003-01-01,4,3,4,3,7
10404,ALCALA,estado nutricional en menores de 5 anos,clasificacion e,2003-01-01,9,15,9,15,24
20202,ANCORAIMES,estado nutricional en menores de 5 anos,clasificacion e,2003-01-01,29,12,29,12,41
40603,ANTEQUERA,estado nutricional en menores de 5 anos,clasificacion e,2003-01-01,1,2,1,2,3
30402,ANZALDO,estado nutricional en menores de 5 anos,clasificacion e,2003-01-01,1,4,1,4,5
20701,APOLO,estado nutricional en menores de 5 anos,clasificacion e,2003-01-01,11,15,11,15,26
51301,ARAMPAMPA,estado nutricional en menores de 5 anos,clasificacion e,2003-01-01,10,23,10,23,33
30501,ARANI,estado nutricional en menores de 5 anos,clasificacion e,2003-01-01,1,4,1,4,5
30403,ARBIETO,estado nutricional en menores de 5 anos,clasificacion e,2003-01-01,0,2,0,2,2
30601,ARQUE,estado nutricional en menores de 5 anos,clasificacion e,2003-01-01,10,12,10,12,22
50802,ATOCHA,estado nutricional en menores de 5 anos,clasificacion e,2003-01-01,3,18,3,18,21
20503,AUCAPATA,estado nutricional en menores de 5 anos,clasificacion e,2003-01-01,2,0,2,0,2
20502,AYATA,estado nutricional en menores de 5 anos,clasificacion e,2003-01-01,11,3,11,3,14
21303,AYO AYO,estado nutricional en menores de 5 anos,clasificacion e,2003-01-01,6,0,6,0,6
30301,AYOPAYA (V. DE INDEPENDENCIA),estado nutricional en menores de 5 anos,clasificacion e,2003-01-01,10,7,10,7,17
10201,AZURDUY,estado nutricional en menores de 5 anos,clasificacion e,2003-01-01,37,51,37,51,88
21203,BATALLAS,estado nutricional en menores de 5 anos,clasificacion e,2003-01-01,2,4,2,4,6
80802,BAURES,estado nutricional en menores de 5 anos,clasificacion e,2003-01-01,2,2,2,2,4
50104,BELEN DE URMIRI,estado nutricional en menores de 5 anos,clasificacion e,2003-01-01,1,0,1,0,1
90104,BELLA FLOR,estado nutricional en menores de 5 anos,clasificacion e,2003-01-01,1,1,1,1,2
60202,BERMEJO,estado nutricional en menores de 5 anos,clasificacion e,2003-01-01,1,2,1,2,3
50301,BETANZOS,estado nutricional en menores de 5 anos,clasificacion e,2003-01-01,123,88,123,88,211
31501,BOLIVAR,estado nutricional en menores de 5 anos,clasificacion e,2003-01-01,14,23,14,23,37
90103,BOLPEBRA,estado nutricional en menores de 5 anos,clasificacion e,2003-01-01,2,0,2,0,2
70707,BOYUIBE,estado nutricional en menores de 5 anos,clasificacion e,2003-01-01,0,1,0,1,1
70401,BUENA VISTA,estado nutricional en menores de 5 anos,clasificacion e,2003-01-01,7,7,7,7,14
70703,CABEZAS,estado nutricional en menores de 5 anos,clasificacion e,2003-01-01,9,14,9,14,23
20905,CAIROMA,estado nutricional en menores de 5 anos,clasificacion e,2003-01-01,15,5,15,5,20
51102,"CAIZA ""D""",estado nutricional en menores de 5 anos,clasificacion e,2003-01-01,42,22,42,22,64
21003,CAJUATA,estado nutricional en menores de 5 anos,clasificacion e,2003-01-01,16,8,16,8,24
20303,CALACOTO,estado nutricional en menores de 5 anos,clasificacion e,2003-01-01,1,0,1,0,1
21304,CALAMARCA,estado nutricional en menores de 5 anos,clasificacion e,2003-01-01,18,8,18,8,26
10701,CAMARGO,estado nutricional en menores de 5 anos,clasificacion e,2003-01-01,31,22,31,22,53
10901,CAMATAQUI (C. VILLA ABECIA),estado nutricional en menores de 5 anos,clasificacion e,2003-01-01,4,2,4,2,6
70706,CAMIRI,estado nutricional en menores de 5 anos,clasificacion e,2003-01-01,92,27,92,27,119
30701,CAPINOTA,estado nutricional en menores de 5 anos,clasificacion e,2003-01-01,15,23,15,23,38
20302,CAQUIAVIRI,estado nutricional en menores de 5 anos,clasificacion e,2003-01-01,7,10,7,10,17
40102,CARACOLLO,estado nutricional en menores de 5 anos,clasificacion e,2003-01-01,8,9,8,9,17
22001,CARANAVI,estado nutricional en menores de 5 anos,clasificacion e,2003-01-01,34,20,34,20,54
41503,CARANGAS,estado nutricional en menores de 5 anos,clasificacion e,2003-01-01,1,0,1,0,1
60302,CARAPARI,estado nutricional en menores de 5 anos,clasificacion e,2003-01-01,10,8,10,8,18
50702,CARIPUYO,estado nutricional en menores de 5 anos,clasificacion e,2003-01-01,25,41,25,41,66
21902,CATACORA,estado nutricional en menores de 5 anos,clasificacion e,2003-01-01,0,1,0,1,1
40201,CHALLAPATA,estado nutricional en menores de 5 anos,clasificacion e,2003-01-01,21,21,21,21,42
50302,CHAQUI,estado nutricional en menores de 5 anos,clasificacion e,2003-01-01,23,13,23,13,36
70702,CHARAGUA,estado nutricional en menores de 5 anos,clasificacion e,2003-01-01,16,25,16,25,41
20305,CHARAÃ‘A,estado nutricional en menores de 5 anos,clasificacion e,2003-01-01,4,3,4,3,7
50202,CHAYANTA,estado nutricional en menores de 5 anos,clasificacion e,2003-01-01,20,12,20,12,32
31204,CHIMORE,estado nutricional en menores de 5 anos,clasificacion e,2003-01-01,11,3,11,3,14
40903,CHIPAYA,estado nutricional en menores de 5 anos,clasificacion e,2003-01-01,1,0,1,0,1
40302,CHOQUE COTA,estado nutricional en menores de 5 anos,clasificacion e,2003-01-01,1,1,1,1,2
21101,CHULUMANI (V. DE LA LIBERTAD),estado nutricional en menores de 5 anos,clasificacion e,2003-01-01,0,1,0,1,1
20501,CHUMA,estado nutricional en menores de 5 anos,clasificacion e,2003-01-01,8,8,8,8,16
30801,CLIZA,estado nutricional en menores de 5 anos,clasificacion e,2003-01-01,3,0,3,0,3
90101,COBIJA,estado nutricional en menores de 5 anos,clasificacion e,2003-01-01,16,13,16,13,29
30101,COCHABAMBA,estado nutricional en menores de 5 anos,clasificacion e,2003-01-01,122,80,122,80,202
30905,COLCAPIRHUA,estado nutricional en menores de 5 anos,clasificacion e,2003-01-01,4,8,4,8,12
50901,"COLCHA ""K""",estado nutricional en menores de 5 anos,clasificacion e,2003-01-01,6,5,6,5,11
21307,COLLANA,estado nutricional en menores de 5 anos,clasificacion e,2003-01-01,0,4,0,4,4
31002,COLOMI,estado nutricional en menores de 5 anos,clasificacion e,2003-01-01,16,8,16,8,24
50401,COLQUECHACA,estado nutricional en menores de 5 anos,clasificacion e,2003-01-01,44,12,44,12,56
21306,COLQUENCHA,estado nutricional en menores de 5 anos,clasificacion e,2003-01-01,4,2,4,2,6
21004,COLQUIRI,estado nutricional en menores de 5 anos,clasificacion e,2003-01-01,9,5,9,5,14
20304,COMANCHE,estado nutricional en menores de 5 anos,clasificacion e,2003-01-01,2,0,2,0,2
71301,COMARAPA,estado nutricional en menores de 5 anos,clasificacion e,2003-01-01,25,16,25,16,41
20605,COMBAYA,estado nutricional en menores de 5 anos,clasificacion e,2003-01-01,3,3,3,3,6
71101,CONCEPCION,estado nutricional en menores de 5 anos,clasificacion e,2003-01-01,2,1,2,1,3
21701,COPACABANA,estado nutricional en menores de 5 anos,clasificacion e,2003-01-01,2,0,2,0,2
21402,CORIPATA,estado nutricional en menores de 5 anos,clasificacion e,2003-01-01,0,4,0,4,4
20301,CORO CORO,estado nutricional en menores de 5 anos,clasificacion e,2003-01-01,10,13,10,13,23
21401,COROICO,estado nutricional en menores de 5 anos,clasificacion e,2003-01-01,6,6,6,6,12
40301,CORQUE,estado nutricional en menores de 5 anos,clasificacion e,2003-01-01,1,0,1,0,1
50601,COTAGAITA,estado nutricional en menores de 5 anos,clasificacion e,2003-01-01,38,29,38,29,67
70102,COTOCA,estado nutricional en menores de 5 anos,clasificacion e,2003-01-01,8,0,8,0,8
70704,CUEVO,estado nutricional en menores de 5 anos,clasificacion e,2003-01-01,2,2,2,2,4
10902,CULPINA,estado nutricional en menores de 5 anos,clasificacion e,2003-01-01,31,39,31,39,70
40401,CURAHUARA DE CARANGAS,estado nutricional en menores de 5 anos,clasificacion e,2003-01-01,0,2,0,2,2
21602,CURVA,estado nutricional en menores de 5 anos,clasificacion e,2003-01-01,5,2,5,2,7
20804,DESAGUADERO,estado nutricional en menores de 5 anos,clasificacion e,2003-01-01,2,1,2,1,3
20105,EL ALTO,estado nutricional en menores de 5 anos,clasificacion e,2003-01-01,416,206,416,206,622
40103,EL CHORO,estado nutricional en menores de 5 anos,clasificacion e,2003-01-01,2,1,2,1,3
71503,EL PUENTE(STC),estado nutricional en menores de 5 anos,clasificacion e,2003-01-01,4,34,4,34,38
60502,EL PUENTE(TJA),estado nutricional en menores de 5 anos,clasificacion e,2003-01-01,8,11,8,11,19
70105,EL TORNO,estado nutricional en menores de 5 anos,clasificacion e,2003-01-01,14,17,14,17,31
10405,EL VILLAR,estado nutricional en menores de 5 anos,clasificacion e,2003-01-01,12,26,12,26,38
60601,ENTRE RIOS,estado nutricional en menores de 5 anos,clasificacion e,2003-01-01,12,10,12,10,22
41101,EUCALIPTUS,estado nutricional en menores de 5 anos,clasificacion e,2003-01-01,1,1,1,1,2
80402,EXALTACION,estado nutricional en menores de 5 anos,clasificacion e,2003-01-01,3,3,3,3,6
90203,FILADELFIA,estado nutricional en menores de 5 anos,clasificacion e,2003-01-01,1,3,1,3,4
71002,GENERAL SAAVEDRA,estado nutricional en menores de 5 anos,clasificacion e,2003-01-01,41,29,41,29,70
21601,GRAL. J.J. PEREZ (CHARAZANI),estado nutricional en menores de 5 anos,clasificacion e,2003-01-01,2,0,2,0,2
20602,GUANAY,estado nutricional en menores de 5 anos,clasificacion e,2003-01-01,28,12,28,12,40
20802,GUAQUI,estado nutricional en menores de 5 anos,clasificacion e,2003-01-01,0,2,0,2,2
80202,GUAYARAMERIN,estado nutricional en menores de 5 anos,clasificacion e,2003-01-01,47,33,47,33,80
70705,GUTIERREZ,estado nutricional en menores de 5 anos,clasificacion e,2003-01-01,66,54,66,54,120
10502,HUACARETA,estado nutricional en menores de 5 anos,clasificacion e,2003-01-01,12,20,12,20,32
11002,HUACAYA (VILLA DE HUACAYA),estado nutricional en menores de 5 anos,clasificacion e,2003-01-01,1,3,1,3,4
40501,HUACHACALLA,estado nutricional en menores de 5 anos,clasificacion e,2003-01-01,1,0,1,0,1
40701,HUANUNI,estado nutricional en menores de 5 anos,clasificacion e,2003-01-01,29,6,29,6,35
80803,HUARACAJE,estado nutricional en menores de 5 anos,clasificacion e,2003-01-01,1,0,1,0,1
41601,HUAYLLAMARCA,estado nutricional en menores de 5 anos,clasificacion e,2003-01-01,2,3,2,3,5
21005,ICHOCA,estado nutricional en menores de 5 anos,clasificacion e,2003-01-01,4,13,4,13,17
10304,ICLA,estado nutricional en menores de 5 anos,clasificacion e,2003-01-01,20,31,20,31,51
10703,INCAHUASI,estado nutricional en menores de 5 anos,clasificacion e,2003-01-01,58,36,58,36,94
21001,INQUISIVI,estado nutricional en menores de 5 anos,clasificacion e,2003-01-01,29,27,29,27,56
21102,IRUPANA (VILLA DE LANZA),estado nutricional en menores de 5 anos,clasificacion e,2003-01-01,1,5,1,5,6
21501,IXIAMAS,estado nutricional en menores de 5 anos,clasificacion e,2003-01-01,7,13,7,13,20
21105,LA ASUNTA,estado nutricional en menores de 5 anos,clasificacion e,2003-01-01,9,7,9,7,16
70104,LA GUARDIA,estado nutricional en menores de 5 anos,clasificacion e,2003-01-01,17,14,17,14,31
20101,LA PAZ,estado nutricional en menores de 5 anos,clasificacion e,2003-01-01,264,139,264,139,403
70701,LAGUNILLAS,estado nutricional en menores de 5 anos,clasificacion e,2003-01-01,15,15,15,15,30
21202,LAJA,estado nutricional en menores de 5 anos,clasificacion e,2003-01-01,1,7,1,7,8
10903,LAS CARRERAS,estado nutricional en menores de 5 anos,clasificacion e,2003-01-01,8,12,8,12,20
21006,LICOMA PAMPA,estado nutricional en menores de 5 anos,clasificacion e,2003-01-01,1,1,1,1,2
50203,LLALLAGUA,estado nutricional en menores de 5 anos,clasificacion e,2003-01-01,4,111,4,111,115
51401,LLICA,estado nutricional en menores de 5 anos,clasificacion e,2003-01-01,1,0,1,0,1
20901,LURIBAY,estado nutricional en menores de 5 anos,clasificacion e,2003-01-01,6,6,6,6,12
40702,MACHACAMARCA,estado nutricional en menores de 5 anos,clasificacion e,2003-01-01,4,1,4,1,5
11003,MACHARETI,estado nutricional en menores de 5 anos,clasificacion e,2003-01-01,12,13,12,13,25
80801,MAGDALENA,estado nutricional en menores de 5 anos,clasificacion e,2003-01-01,4,5,4,5,9
70903,MAIRANA,estado nutricional en menores de 5 anos,clasificacion e,2003-01-01,15,1,15,1,16
20904,MALLA,estado nutricional en menores de 5 anos,clasificacion e,2003-01-01,0,1,0,1,1
20103,MECAPACA,estado nutricional en menores de 5 anos,clasificacion e,2003-01-01,0,4,0,4,4
71003,MINEROS,estado nutricional en menores de 5 anos,clasificacion e,2003-01-01,68,28,68,28,96
31301,MIZQUE,estado nutricional en menores de 5 anos,clasificacion e,2003-01-01,8,2,8,2,10
20402,MOCOMOCO,estado nutricional en menores de 5 anos,clasificacion e,2003-01-01,7,5,7,5,12
51002,MOJINETE,estado nutricional en menores de 5 anos,clasificacion e,2003-01-01,0,2,0,2,2
10303,MOJOCOYA,estado nutricional en menores de 5 anos,clasificacion e,2003-01-01,12,17,12,17,29
10501,MONTEAGUDO,estado nutricional en menores de 5 anos,clasificacion e,2003-01-01,38,42,38,42,80
71001,MONTERO,estado nutricional en menores de 5 anos,clasificacion e,2003-01-01,153,53,153,53,206
70803,MORO MORO,estado nutricional en menores de 5 anos,clasificacion e,2003-01-01,0,1,0,1,1
30302,MOROCHATA,estado nutricional en menores de 5 anos,clasificacion e,2003-01-01,48,31,48,31,79
90401,NACEBE (SANTA ROSA DEL ABUNA),estado nutricional en menores de 5 anos,clasificacion e,2003-01-01,0,1,0,1,1
90501,NUEVO MANOA (NUEVA ESPERANZA),estado nutricional en menores de 5 anos,clasificacion e,2003-01-01,0,5,0,5,5
50404,OCURI,estado nutricional en menores de 5 anos,clasificacion e,2003-01-01,19,59,19,59,78
70202,OKINAWA,estado nutricional en menores de 5 anos,clasificacion e,2003-01-01,6,2,6,2,8
30203,OMEREQUE,estado nutricional en menores de 5 anos,clasificacion e,2003-01-01,0,2,0,2,2
40101,ORURO,estado nutricional en menores de 5 anos,clasificacion e,2003-01-01,157,95,157,95,252
60201,PADCAYA,estado nutricional en menores de 5 anos,clasificacion e,2003-01-01,4,6,4,6,10
10401,PADILLA,estado nutricional en menores de 5 anos,clasificacion e,2003-01-01,27,46,27,46,73
70502,PAILON,estado nutricional en menores de 5 anos,clasificacion e,2003-01-01,19,7,19,7,26
20102,PALCA,estado nutricional en menores de 5 anos,clasificacion e,2003-01-01,11,12,11,12,23
21104,PALOS BLANCOS,estado nutricional en menores de 5 anos,clasificacion e,2003-01-01,7,14,7,14,21
40802,PAMPA AULLAGAS,estado nutricional en menores de 5 anos,clasificacion e,2003-01-01,1,2,1,2,3
70902,PAMPA GRANDE,estado nutricional en menores de 5 anos,clasificacion e,2003-01-01,2,2,2,2,4
21802,PAPEL PAMPA,estado nutricional en menores de 5 anos,clasificacion e,2003-01-01,1,0,1,0,1
30202,PASORAPA,estado nutricional en menores de 5 anos,clasificacion e,2003-01-01,5,3,5,3,8
21305,PATACAMAYA,estado nutricional en menores de 5 anos,clasificacion e,2003-01-01,25,14,25,14,39
40602,PAZÃ‘A,estado nutricional en menores de 5 anos,clasificacion e,2003-01-01,1,0,1,0,1
20702,PELECHUCO,estado nutricional en menores de 5 anos,clasificacion e,2003-01-01,3,11,3,11,14
50403,POCOATA,estado nutricional en menores de 5 anos,clasificacion e,2003-01-01,29,53,29,53,82
31203,POCONA,estado nutricional en menores de 5 anos,clasificacion e,2003-01-01,11,6,11,6,17
31202,POJO (CBBA),estado nutricional en menores de 5 anos,clasificacion e,2003-01-01,9,3,9,3,12
40601,POOPO,estado nutricional en menores de 5 anos,clasificacion e,2003-01-01,0,7,0,7,7
51203,PORCO,estado nutricional en menores de 5 anos,clasificacion e,2003-01-01,5,3,5,3,8
10103,POROMA,estado nutricional en menores de 5 anos,clasificacion e,2003-01-01,42,34,42,34,76
70103,PORONGO,estado nutricional en menores de 5 anos,clasificacion e,2003-01-01,1,1,1,1,2
70601,PORTACHUELO,estado nutricional en menores de 5 anos,clasificacion e,2003-01-01,11,11,11,11,22
90102,PORVENIR,estado nutricional en menores de 5 anos,clasificacion e,2003-01-01,5,0,5,0,5
70804,POSTRER VALLE,estado nutricional en menores de 5 anos,clasificacion e,2003-01-01,1,3,1,3,4
50101,POTOSI,estado nutricional en menores de 5 anos,clasificacion e,2003-01-01,166,79,166,79,245
10302,PRESTO,estado nutricional en menores de 5 anos,clasificacion e,2003-01-01,21,28,21,28,49
21201,PUCARANI,estado nutricional en menores de 5 anos,clasificacion e,2003-01-01,1,2,1,2,3
20401,PUERTO ACOSTA,estado nutricional en menores de 5 anos,clasificacion e,2003-01-01,21,33,21,33,54
20403,PUERTO CARABUCO,estado nutricional en menores de 5 anos,clasificacion e,2003-01-01,8,25,8,25,33
21204,PUERTO PEREZ,estado nutricional en menores de 5 anos,clasificacion e,2003-01-01,0,2,0,2,2
71402,PUERTO QUIJARRO,estado nutricional en menores de 5 anos,clasificacion e,2003-01-01,14,3,14,3,17
90201,PUERTO RICO,estado nutricional en menores de 5 anos,clasificacion e,2003-01-01,0,8,0,8,8
71401,PUERTO SUAREZ,estado nutricional en menores de 5 anos,clasificacion e,2003-01-01,15,9,15,9,24
31205,PUERTO VILLARROEL,estado nutricional en menores de 5 anos,clasificacion e,2003-01-01,56,38,56,38,94
51101,PUNA,estado nutricional en menores de 5 anos,clasificacion e,2003-01-01,123,91,123,91,214
31401,PUNATA,estado nutricional en menores de 5 anos,clasificacion e,2003-01-01,33,7,33,7,40
20604,QUIABAYA,estado nutricional en menores de 5 anos,clasificacion e,2003-01-01,12,6,12,6,18
30901,QUILLACOLLO,estado nutricional en menores de 5 anos,clasificacion e,2003-01-01,16,26,16,26,42
21002,QUIME,estado nutricional en menores de 5 anos,clasificacion e,2003-01-01,9,8,9,8,17
50402,RAVELO,estado nutricional en menores de 5 anos,clasificacion e,2003-01-01,85,78,85,78,163
80301,REYES,estado nutricional en menores de 5 anos,clasificacion e,2003-01-01,8,6,8,6,14
80201,RIBERALTA,estado nutricional en menores de 5 anos,clasificacion e,2003-01-01,98,66,98,66,164
70503,ROBORE,estado nutricional en menores de 5 anos,clasificacion e,2003-01-01,16,13,16,13,29
40901,SABAYA,estado nutricional en menores de 5 anos,clasificacion e,2003-01-01,0,5,0,5,5
31001,SACABA,estado nutricional en menores de 5 anos,clasificacion e,2003-01-01,54,36,54,36,90
50701,SACACA,estado nutricional en menores de 5 anos,clasificacion e,2003-01-01,47,66,47,66,113
71302,SAIPINA,estado nutricional en menores de 5 anos,clasificacion e,2003-01-01,2,6,2,6,8
40801,SALINAS DE GARCI MENDOZA,estado nutricional en menores de 5 anos,clasificacion e,2003-01-01,5,7,5,7,12
70901,SAMAIPATA,estado nutricional en menores de 5 anos,clasificacion e,2003-01-01,3,0,3,0,3
80602,SAN ANDRES,estado nutricional en menores de 5 anos,clasificacion e,2003-01-01,1,4,1,4,5
51003,SAN ANTONIO DE ESMORUCO,estado nutricional en menores de 5 anos,clasificacion e,2003-01-01,2,3,2,3,5
71105,SAN ANTONIO DE LOMERIO,estado nutricional en menores de 5 anos,clasificacion e,2003-01-01,55,59,55,59,114
31403,SAN BENITO,estado nutricional en menores de 5 anos,clasificacion e,2003-01-01,7,8,7,8,15
80302,SAN BORJA,estado nutricional en menores de 5 anos,clasificacion e,2003-01-01,40,28,40,28,68
21502,SAN BUENA VENTURA,estado nutricional en menores de 5 anos,clasificacion e,2003-01-01,11,6,11,6,17
70402,SAN CARLOS,estado nutricional en menores de 5 anos,clasificacion e,2003-01-01,26,9,26,9,35
80501,SAN IGNACIO,estado nutricional en menores de 5 anos,clasificacion e,2003-01-01,32,6,32,6,38
70301,SAN IGNACIO DE VELASCO,estado nutricional en menores de 5 anos,clasificacion e,2003-01-01,73,38,73,38,111
71102,SAN JAVIER(STC),estado nutricional en menores de 5 anos,clasificacion e,2003-01-01,16,5,16,5,21
80701,SAN JOAQUIN,estado nutricional en menores de 5 anos,clasificacion e,2003-01-01,1,0,1,0,1
70501,SAN JOSE DE CHIQUITOS,estado nutricional en menores de 5 anos,clasificacion e,2003-01-01,18,6,18,6,24
71104,SAN JULIAN,estado nutricional en menores de 5 anos,clasificacion e,2003-01-01,44,25,44,25,69
90302,SAN LORENZO(PND),estado nutricional en menores de 5 anos,clasificacion e,2003-01-01,2,3,2,3,5
60501,SAN LORENZO(TJA),estado nutricional en menores de 5 anos,clasificacion e,2003-01-01,15,11,15,11,26
10702,SAN LUCAS,estado nutricional en menores de 5 anos,clasificacion e,2003-01-01,97,99,97,99,196
71201,SAN MATIAS,estado nutricional en menores de 5 anos,clasificacion e,2003-01-01,14,12,14,12,26
70302,SAN MIGUEL DE VELASCO,estado nutricional en menores de 5 anos,clasificacion e,2003-01-01,21,11,21,11,32
51001,SAN PABLO DE LIPEZ,estado nutricional en menores de 5 anos,clasificacion e,2003-01-01,0,3,0,3,3
50501,SAN PEDRO DE BUENA VISTA,estado nutricional en menores de 5 anos,clasificacion e,2003-01-01,34,28,34,28,62
21801,SAN PEDRO DE CURAHUARA,estado nutricional en menores de 5 anos,clasificacion e,2003-01-01,7,6,7,6,13
50902,SAN PEDRO DE QUEMES,estado nutricional en menores de 5 anos,clasificacion e,2003-01-01,2,0,2,0,2
21702,SAN PEDRO DE TIQUINA,estado nutricional en menores de 5 anos,clasificacion e,2003-01-01,0,2,0,2,2
90202,SAN PEDRO(PND),estado nutricional en menores de 5 anos,clasificacion e,2003-01-01,0,2,0,2,2
70303,SAN RAFAEL,estado nutricional en menores de 5 anos,clasificacion e,2003-01-01,13,8,13,8,21
80702,SAN RAMON,estado nutricional en menores de 5 anos,clasificacion e,2003-01-01,1,0,1,0,1
80401,SANTA ANA,estado nutricional en menores de 5 anos,clasificacion e,2003-01-01,1,0,1,0,1
70101,SANTA CRUZ DE LA SIERRA,estado nutricional en menores de 5 anos,clasificacion e,2003-01-01,264,120,264,120,384
80303,SANTA ROSA,estado nutricional en menores de 5 anos,clasificacion e,2003-01-01,1,1,1,1,2
70602,SANTA ROSA DEL SARA,estado nutricional en menores de 5 anos,clasificacion e,2003-01-01,0,1,0,1,1
20308,SANTIAGO DE CALLAPA,estado nutricional en menores de 5 anos,clasificacion e,2003-01-01,3,4,3,4,7
41401,SANTIAGO DE HUARI,estado nutricional en menores de 5 anos,clasificacion e,2003-01-01,2,11,2,11,13
21901,SANTIAGO DE MACHACA,estado nutricional en menores de 5 anos,clasificacion e,2003-01-01,5,1,5,1,6
30702,SANTIVAÃ‘ES,estado nutricional en menores de 5 anos,clasificacion e,2003-01-01,6,1,6,1,7
40202,SANTUARIO DE QUILLACAS,estado nutricional en menores de 5 anos,clasificacion e,2003-01-01,3,0,3,0,3
20902,SAPAHAQUI,estado nutricional en menores de 5 anos,clasificacion e,2003-01-01,8,0,8,0,8
90303,SENA,estado nutricional en menores de 5 anos,clasificacion e,2003-01-01,0,16,0,16,16
21301,SICA SICA (VILLA AROMA),estado nutricional en menores de 5 anos,clasificacion e,2003-01-01,21,16,21,16,37
30703,SICAYA,estado nutricional en menores de 5 anos,clasificacion e,2003-01-01,4,0,4,0,4
30902,SIPE SIPE,estado nutricional en menores de 5 anos,clasificacion e,2003-01-01,42,23,42,23,65
10403,SOPACHUY,estado nutricional en menores de 5 anos,clasificacion e,2003-01-01,32,24,32,24,56
20601,SORATA,estado nutricional en menores de 5 anos,clasificacion e,2003-01-01,7,9,7,9,16
10101,SUCRE,estado nutricional en menores de 5 anos,clasificacion e,2003-01-01,103,67,103,67,170
31404,TACACHI,estado nutricional en menores de 5 anos,clasificacion e,2003-01-01,1,3,1,3,4
20603,TACACOMA,estado nutricional en menores de 5 anos,clasificacion e,2003-01-01,4,0,4,0,4
50303,TACOBAMBA,estado nutricional en menores de 5 anos,clasificacion e,2003-01-01,17,10,17,10,27
30602,TACOPAYA,estado nutricional en menores de 5 anos,clasificacion e,2003-01-01,35,42,35,42,77
31101,TAPACARI,estado nutricional en menores de 5 anos,clasificacion e,2003-01-01,21,25,21,25,46
10601,TARABUCO,estado nutricional en menores de 5 anos,clasificacion e,2003-01-01,120,116,120,116,236
30401,TARATA,estado nutricional en menores de 5 anos,clasificacion e,2003-01-01,7,6,7,6,13
60101,TARIJA,estado nutricional en menores de 5 anos,clasificacion e,2003-01-01,60,30,60,30,90
10202,TARVITA,estado nutricional en menores de 5 anos,clasificacion e,2003-01-01,25,37,25,37,62
20803,TIAWANACU,estado nutricional en menores de 5 anos,clasificacion e,2003-01-01,0,3,0,3,3
50102,TINGUIPAYA,estado nutricional en menores de 5 anos,clasificacion e,2003-01-01,19,38,19,38,57
20606,TIPUANI,estado nutricional en menores de 5 anos,clasificacion e,2003-01-01,9,3,9,3,12
30903,TIQUIPAYA,estado nutricional en menores de 5 anos,clasificacion e,2003-01-01,6,5,6,5,11
31601,TIRAQUE (CBBA),estado nutricional en menores de 5 anos,clasificacion e,2003-01-01,44,43,44,43,87
30803,TOLATA,estado nutricional en menores de 5 anos,clasificacion e,2003-01-01,4,4,4,4,8
41001,TOLEDO,estado nutricional en menores de 5 anos,clasificacion e,2003-01-01,3,1,3,1,4
51202,TOMAVE,estado nutricional en menores de 5 anos,clasificacion e,2003-01-01,20,17,20,17,37
10402,TOMINA,estado nutricional en menores de 5 anos,clasificacion e,2003-01-01,29,32,29,32,61
50502,TORO TORO,estado nutricional en menores de 5 anos,clasificacion e,2003-01-01,11,16,11,16,27
31201,TOTORA(CBBA),estado nutricional en menores de 5 anos,clasificacion e,2003-01-01,5,6,5,6,11
41301,TOTORA(ORR),estado nutricional en menores de 5 anos,clasificacion e,2003-01-01,0,1,0,1,1
70802,TRIGAL,estado nutricional en menores de 5 anos,clasificacion e,2003-01-01,2,1,2,1,3
80101,TRINIDAD,estado nutricional en menores de 5 anos,clasificacion e,2003-01-01,64,89,64,89,153
50801,TUPIZA,estado nutricional en menores de 5 anos,clasificacion e,2003-01-01,18,86,18,86,104
40402,TURCO,estado nutricional en menores de 5 anos,clasificacion e,2003-01-01,2,0,2,0,2
21302,UMALA,estado nutricional en menores de 5 anos,clasificacion e,2003-01-01,12,0,12,0,12
50201,UNCIA,estado nutricional en menores de 5 anos,clasificacion e,2003-01-01,5,6,5,6,11
60401,URIONDO (A. CONCEPCION),estado nutricional en menores de 5 anos,clasificacion e,2003-01-01,4,0,4,0,4
71502,URUBICHA,estado nutricional en menores de 5 anos,clasificacion e,2003-01-01,4,9,4,9,13
51201,UYUNI,estado nutricional en menores de 5 anos,clasificacion e,2003-01-01,11,6,11,6,17
30502,VACAS,estado nutricional en menores de 5 anos,clasificacion e,2003-01-01,9,7,9,7,16
70801,VALLEGRANDE,estado nutricional en menores de 5 anos,clasificacion e,2003-01-01,13,12,13,12,25
20801,VIACHA,estado nutricional en menores de 5 anos,clasificacion e,2003-01-01,15,20,15,20,35
31302,VILA VILA,estado nutricional en menores de 5 anos,clasificacion e,2003-01-01,8,2,8,2,10
60303,VILLA MONTES,estado nutricional en menores de 5 anos,clasificacion e,2003-01-01,41,17,41,17,58
31402,VILLA RIVERO,estado nutricional en menores de 5 anos,clasificacion e,2003-01-01,11,5,11,5,16
10801,VILLA SERRANO,estado nutricional en menores de 5 anos,clasificacion e,2003-01-01,32,33,32,33,65
31003,VILLA TUNARI,estado nutricional en menores de 5 anos,clasificacion e,2003-01-01,40,42,40,42,82
11001,VILLA VACA GUZMAN (MUYUPAMPA),estado nutricional en menores de 5 anos,clasificacion e,2003-01-01,10,15,10,15,25
51501,VILLAZON,estado nutricional en menores de 5 anos,clasificacion e,2003-01-01,25,22,25,22,47
50602,VITICHI,estado nutricional en menores de 5 anos,clasificacion e,2003-01-01,14,20,14,20,34
70201,WARNES,estado nutricional en menores de 5 anos,clasificacion e,2003-01-01,30,17,30,17,47
20903,YACO,estado nutricional en menores de 5 anos,clasificacion e,2003-01-01,6,9,6,9,15
60301,YACUIBA,estado nutricional en menores de 5 anos,clasificacion e,2003-01-01,40,21,40,21,61
10602,YAMPARAEZ,estado nutricional en menores de 5 anos,clasificacion e,2003-01-01,64,44,64,44,108
21103,YANACACHI,estado nutricional en menores de 5 anos,clasificacion e,2003-01-01,2,2,2,2,4
70403,YAPACANI,estado nutricional en menores de 5 anos,clasificacion e,2003-01-01,39,25,39,25,64
50103,YOCALLA,estado nutricional en menores de 5 anos,clasificacion e,2003-01-01,9,10,9,10,19
10102,YOTALA,estado nutricional en menores de 5 anos,clasificacion e,2003-01-01,16,22,16,22,38
60402,YUNCHARA,estado nutricional en menores de 5 anos,clasificacion e,2003-01-01,1,1,1,1,2
10301,ZUDAÃ‘EZ,estado nutricional en menores de 5 anos,clasificacion e,2003-01-01,30,23,30,23,53
51302,ACACIO,estado nutricional en menores de 5 anos,clasificacion e,2003-02-01,26,25,26,25,51
20201,ACHACACHI,estado nutricional en menores de 5 anos,clasificacion e,2003-02-01,27,18,27,18,45
20104,ACHOCALLA,estado nutricional en menores de 5 anos,clasificacion e,2003-02-01,2,0,2,0,2
30201,AIQUILE,estado nutricional en menores de 5 anos,clasificacion e,2003-02-01,20,14,20,14,34
31303,ALALAY,estado nutricional en menores de 5 anos,clasificacion e,2003-02-01,7,1,7,1,8
10404,ALCALA,estado nutricional en menores de 5 anos,clasificacion e,2003-02-01,12,21,12,21,33
20202,ANCORAIMES,estado nutricional en menores de 5 anos,clasificacion e,2003-02-01,10,15,10,15,25
41201,ANDAMARCA,estado nutricional en menores de 5 anos,clasificacion e,2003-02-01,2,5,2,5,7
40603,ANTEQUERA,estado nutricional en menores de 5 anos,clasificacion e,2003-02-01,0,1,0,1,1
30402,ANZALDO,estado nutricional en menores de 5 anos,clasificacion e,2003-02-01,3,17,3,17,20
20701,APOLO,estado nutricional en menores de 5 anos,clasificacion e,2003-02-01,14,16,14,16,30
51301,ARAMPAMPA,estado nutricional en menores de 5 anos,clasificacion e,2003-02-01,11,22,11,22,33
30501,ARANI,estado nutricional en menores de 5 anos,clasificacion e,2003-02-01,0,2,0,2,2
30403,ARBIETO,estado nutricional en menores de 5 anos,clasificacion e,2003-02-01,1,0,1,0,1
30601,ARQUE,estado nutricional en menores de 5 anos,clasificacion e,2003-02-01,11,6,11,6,17
71501,ASCENCION DE GUARAYOS,estado nutricional en menores de 5 anos,clasificacion e,2003-02-01,85,58,85,58,143
50802,ATOCHA,estado nutricional en menores de 5 anos,clasificacion e,2003-02-01,2,32,2,32,34
20503,AUCAPATA,estado nutricional en menores de 5 anos,clasificacion e,2003-02-01,1,2,1,2,3
20502,AYATA,estado nutricional en menores de 5 anos,clasificacion e,2003-02-01,10,11,10,11,21
30301,AYOPAYA (V. DE INDEPENDENCIA),estado nutricional en menores de 5 anos,clasificacion e,2003-02-01,13,18,13,18,31
10201,AZURDUY,estado nutricional en menores de 5 anos,clasificacion e,2003-02-01,61,56,61,56,117
21203,BATALLAS,estado nutricional en menores de 5 anos,clasificacion e,2003-02-01,4,3,4,3,7
80802,BAURES,estado nutricional en menores de 5 anos,clasificacion e,2003-02-01,6,2,6,2,8
41202,BELEN DE ANDAMARCA,estado nutricional en menores de 5 anos,clasificacion e,2003-02-01,1,0,1,0,1
50104,BELEN DE URMIRI,estado nutricional en menores de 5 anos,clasificacion e,2003-02-01,1,2,1,2,3
60202,BERMEJO,estado nutricional en menores de 5 anos,clasificacion e,2003-02-01,8,1,8,1,9
50301,BETANZOS,estado nutricional en menores de 5 anos,clasificacion e,2003-02-01,69,53,69,53,122
31501,BOLIVAR,estado nutricional en menores de 5 anos,clasificacion e,2003-02-01,14,17,14,17,31
90103,BOLPEBRA,estado nutricional en menores de 5 anos,clasificacion e,2003-02-01,1,1,1,1,2
70707,BOYUIBE,estado nutricional en menores de 5 anos,clasificacion e,2003-02-01,3,0,3,0,3
70401,BUENA VISTA,estado nutricional en menores de 5 anos,clasificacion e,2003-02-01,6,5,6,5,11
70703,CABEZAS,estado nutricional en menores de 5 anos,clasificacion e,2003-02-01,6,7,6,7,13
20905,CAIROMA,estado nutricional en menores de 5 anos,clasificacion e,2003-02-01,20,20,20,20,40
51102,"CAIZA ""D""",estado nutricional en menores de 5 anos,clasificacion e,2003-02-01,23,16,23,16,39
21003,CAJUATA,estado nutricional en menores de 5 anos,clasificacion e,2003-02-01,12,3,12,3,15
20303,CALACOTO,estado nutricional en menores de 5 anos,clasificacion e,2003-02-01,1,1,1,1,2
21304,CALAMARCA,estado nutricional en menores de 5 anos,clasificacion e,2003-02-01,37,22,37,22,59
10701,CAMARGO,estado nutricional en menores de 5 anos,clasificacion e,2003-02-01,14,15,14,15,29
10901,CAMATAQUI (C. VILLA ABECIA),estado nutricional en menores de 5 anos,clasificacion e,2003-02-01,4,2,4,2,6
70706,CAMIRI,estado nutricional en menores de 5 anos,clasificacion e,2003-02-01,50,29,50,29,79
30701,CAPINOTA,estado nutricional en menores de 5 anos,clasificacion e,2003-02-01,14,9,14,9,23
20302,CAQUIAVIRI,estado nutricional en menores de 5 anos,clasificacion e,2003-02-01,5,5,5,5,10
40102,CARACOLLO,estado nutricional en menores de 5 anos,clasificacion e,2003-02-01,6,8,6,8,14
22001,CARANAVI,estado nutricional en menores de 5 anos,clasificacion e,2003-02-01,28,17,28,17,45
41503,CARANGAS,estado nutricional en menores de 5 anos,clasificacion e,2003-02-01,1,0,1,0,1
60302,CARAPARI,estado nutricional en menores de 5 anos,clasificacion e,2003-02-01,11,5,11,5,16
50702,CARIPUYO,estado nutricional en menores de 5 anos,clasificacion e,2003-02-01,27,32,27,32,59
21902,CATACORA,estado nutricional en menores de 5 anos,clasificacion e,2003-02-01,1,0,1,0,1
40201,CHALLAPATA,estado nutricional en menores de 5 anos,clasificacion e,2003-02-01,12,26,12,26,38
50302,CHAQUI,estado nutricional en menores de 5 anos,clasificacion e,2003-02-01,20,7,20,7,27
70702,CHARAGUA,estado nutricional en menores de 5 anos,clasificacion e,2003-02-01,44,37,44,37,81
20305,CHARAÃ‘A,estado nutricional en menores de 5 anos,clasificacion e,2003-02-01,1,0,1,0,1
50202,CHAYANTA,estado nutricional en menores de 5 anos,clasificacion e,2003-02-01,31,17,31,17,48
31204,CHIMORE,estado nutricional en menores de 5 anos,clasificacion e,2003-02-01,4,8,4,8,12
40302,CHOQUE COTA,estado nutricional en menores de 5 anos,clasificacion e,2003-02-01,1,0,1,0,1
21101,CHULUMANI (V. DE LA LIBERTAD),estado nutricional en menores de 5 anos,clasificacion e,2003-02-01,0,2,0,2,2
20501,CHUMA,estado nutricional en menores de 5 anos,clasificacion e,2003-02-01,8,8,8,8,16
30801,CLIZA,estado nutricional en menores de 5 anos,clasificacion e,2003-02-01,11,8,11,8,19
90101,COBIJA,estado nutricional en menores de 5 anos,clasificacion e,2003-02-01,13,5,13,5,18
30101,COCHABAMBA,estado nutricional en menores de 5 anos,clasificacion e,2003-02-01,120,58,120,58,178
30905,COLCAPIRHUA,estado nutricional en menores de 5 anos,clasificacion e,2003-02-01,6,0,6,0,6
50901,"COLCHA ""K""",estado nutricional en menores de 5 anos,clasificacion e,2003-02-01,8,7,8,7,15
21307,COLLANA,estado nutricional en menores de 5 anos,clasificacion e,2003-02-01,0,1,0,1,1
31002,COLOMI,estado nutricional en menores de 5 anos,clasificacion e,2003-02-01,15,5,15,5,20
50401,COLQUECHACA,estado nutricional en menores de 5 anos,clasificacion e,2003-02-01,41,15,41,15,56
21306,COLQUENCHA,estado nutricional en menores de 5 anos,clasificacion e,2003-02-01,3,5,3,5,8
21004,COLQUIRI,estado nutricional en menores de 5 anos,clasificacion e,2003-02-01,8,8,8,8,16
20304,COMANCHE,estado nutricional en menores de 5 anos,clasificacion e,2003-02-01,2,0,2,0,2
71301,COMARAPA,estado nutricional en menores de 5 anos,clasificacion e,2003-02-01,26,18,26,18,44
71101,CONCEPCION,estado nutricional en menores de 5 anos,clasificacion e,2003-02-01,6,4,6,4,10
21701,COPACABANA,estado nutricional en menores de 5 anos,clasificacion e,2003-02-01,5,8,5,8,13
21402,CORIPATA,estado nutricional en menores de 5 anos,clasificacion e,2003-02-01,2,0,2,0,2
20301,CORO CORO,estado nutricional en menores de 5 anos,clasificacion e,2003-02-01,8,5,8,5,13
21401,COROICO,estado nutricional en menores de 5 anos,clasificacion e,2003-02-01,8,3,8,3,11
40301,CORQUE,estado nutricional en menores de 5 anos,clasificacion e,2003-02-01,2,7,2,7,9
50601,COTAGAITA,estado nutricional en menores de 5 anos,clasificacion e,2003-02-01,36,31,36,31,67
70102,COTOCA,estado nutricional en menores de 5 anos,clasificacion e,2003-02-01,9,7,9,7,16
31405,CUCHUMUELA (V. G. VILLARROEL),estado nutricional en menores de 5 anos,clasificacion e,2003-02-01,0,1,0,1,1
70704,CUEVO,estado nutricional en menores de 5 anos,clasificacion e,2003-02-01,5,7,5,7,12
10902,CULPINA,estado nutricional en menores de 5 anos,clasificacion e,2003-02-01,52,47,52,47,99
40401,CURAHUARA DE CARANGAS,estado nutricional en menores de 5 anos,clasificacion e,2003-02-01,1,3,1,3,4
21602,CURVA,estado nutricional en menores de 5 anos,clasificacion e,2003-02-01,8,1,8,1,9
20804,DESAGUADERO,estado nutricional en menores de 5 anos,clasificacion e,2003-02-01,6,4,6,4,10
20105,EL ALTO,estado nutricional en menores de 5 anos,clasificacion e,2003-02-01,326,164,326,164,490
40103,EL CHORO,estado nutricional en menores de 5 anos,clasificacion e,2003-02-01,2,2,2,2,4
71503,EL PUENTE(STC),estado nutricional en menores de 5 anos,clasificacion e,2003-02-01,1,14,1,14,15
60502,EL PUENTE(TJA),estado nutricional en menores de 5 anos,clasificacion e,2003-02-01,16,32,16,32,48
70105,EL TORNO,estado nutricional en menores de 5 anos,clasificacion e,2003-02-01,10,11,10,11,21
10405,EL VILLAR,estado nutricional en menores de 5 anos,clasificacion e,2003-02-01,17,37,17,37,54
60601,ENTRE RIOS,estado nutricional en menores de 5 anos,clasificacion e,2003-02-01,8,5,8,5,13
41101,EUCALIPTUS,estado nutricional en menores de 5 anos,clasificacion e,2003-02-01,9,4,9,4,13
80402,EXALTACION,estado nutricional en menores de 5 anos,clasificacion e,2003-02-01,2,0,2,0,2
71002,GENERAL SAAVEDRA,estado nutricional en menores de 5 anos,clasificacion e,2003-02-01,27,22,27,22,49
21601,GRAL. J.J. PEREZ (CHARAZANI),estado nutricional en menores de 5 anos,clasificacion e,2003-02-01,4,3,4,3,7
20602,GUANAY,estado nutricional en menores de 5 anos,clasificacion e,2003-02-01,13,21,13,21,34
20802,GUAQUI,estado nutricional en menores de 5 anos,clasificacion e,2003-02-01,3,0,3,0,3
80202,GUAYARAMERIN,estado nutricional en menores de 5 anos,clasificacion e,2003-02-01,46,26,46,26,72
70705,GUTIERREZ,estado nutricional en menores de 5 anos,clasificacion e,2003-02-01,55,45,55,45,100
10502,HUACARETA,estado nutricional en menores de 5 anos,clasificacion e,2003-02-01,15,15,15,15,30
11002,HUACAYA (VILLA DE HUACAYA),estado nutricional en menores de 5 anos,clasificacion e,2003-02-01,1,1,1,1,2
40501,HUACHACALLA,estado nutricional en menores de 5 anos,clasificacion e,2003-02-01,1,0,1,0,1
40701,HUANUNI,estado nutricional en menores de 5 anos,clasificacion e,2003-02-01,12,12,12,12,24
80803,HUARACAJE,estado nutricional en menores de 5 anos,clasificacion e,2003-02-01,4,0,4,0,4
41601,HUAYLLAMARCA,estado nutricional en menores de 5 anos,clasificacion e,2003-02-01,0,1,0,1,1
21005,ICHOCA,estado nutricional en menores de 5 anos,clasificacion e,2003-02-01,5,3,5,3,8
10304,ICLA,estado nutricional en menores de 5 anos,clasificacion e,2003-02-01,20,38,20,38,58
10703,INCAHUASI,estado nutricional en menores de 5 anos,clasificacion e,2003-02-01,50,25,50,25,75
21001,INQUISIVI,estado nutricional en menores de 5 anos,clasificacion e,2003-02-01,19,16,19,16,35
21102,IRUPANA (VILLA DE LANZA),estado nutricional en menores de 5 anos,clasificacion e,2003-02-01,0,1,0,1,1
21501,IXIAMAS,estado nutricional en menores de 5 anos,clasificacion e,2003-02-01,5,4,5,4,9
21105,LA ASUNTA,estado nutricional en menores de 5 anos,clasificacion e,2003-02-01,11,11,11,11,22
70104,LA GUARDIA,estado nutricional en menores de 5 anos,clasificacion e,2003-02-01,12,5,12,5,17
20101,LA PAZ,estado nutricional en menores de 5 anos,clasificacion e,2003-02-01,192,120,192,120,312
70701,LAGUNILLAS,estado nutricional en menores de 5 anos,clasificacion e,2003-02-01,8,12,8,12,20
21202,LAJA,estado nutricional en menores de 5 anos,clasificacion e,2003-02-01,2,1,2,1,3
10903,LAS CARRERAS,estado nutricional en menores de 5 anos,clasificacion e,2003-02-01,11,12,11,12,23
21006,LICOMA PAMPA,estado nutricional en menores de 5 anos,clasificacion e,2003-02-01,1,1,1,1,2
50203,LLALLAGUA,estado nutricional en menores de 5 anos,clasificacion e,2003-02-01,5,104,5,104,109
51401,LLICA,estado nutricional en menores de 5 anos,clasificacion e,2003-02-01,3,2,3,2,5
20901,LURIBAY,estado nutricional en menores de 5 anos,clasificacion e,2003-02-01,5,2,5,2,7
40702,MACHACAMARCA,estado nutricional en menores de 5 anos,clasificacion e,2003-02-01,3,0,3,0,3
11003,MACHARETI,estado nutricional en menores de 5 anos,clasificacion e,2003-02-01,19,17,19,17,36
80801,MAGDALENA,estado nutricional en menores de 5 anos,clasificacion e,2003-02-01,5,6,5,6,11
70903,MAIRANA,estado nutricional en menores de 5 anos,clasificacion e,2003-02-01,8,2,8,2,10
20103,MECAPACA,estado nutricional en menores de 5 anos,clasificacion e,2003-02-01,3,0,3,0,3
71003,MINEROS,estado nutricional en menores de 5 anos,clasificacion e,2003-02-01,44,14,44,14,58
31301,MIZQUE,estado nutricional en menores de 5 anos,clasificacion e,2003-02-01,18,19,18,19,37
20402,MOCOMOCO,estado nutricional en menores de 5 anos,clasificacion e,2003-02-01,9,9,9,9,18
10303,MOJOCOYA,estado nutricional en menores de 5 anos,clasificacion e,2003-02-01,14,16,14,16,30
10501,MONTEAGUDO,estado nutricional en menores de 5 anos,clasificacion e,2003-02-01,41,31,41,31,72
71001,MONTERO,estado nutricional en menores de 5 anos,clasificacion e,2003-02-01,85,44,85,44,129
70803,MORO MORO,estado nutricional en menores de 5 anos,clasificacion e,2003-02-01,3,2,3,2,5
30302,MOROCHATA,estado nutricional en menores de 5 anos,clasificacion e,2003-02-01,14,29,14,29,43
90401,NACEBE (SANTA ROSA DEL ABUNA),estado nutricional en menores de 5 anos,clasificacion e,2003-02-01,5,1,5,1,6
50404,OCURI,estado nutricional en menores de 5 anos,clasificacion e,2003-02-01,19,30,19,30,49
70202,OKINAWA,estado nutricional en menores de 5 anos,clasificacion e,2003-02-01,3,2,3,2,5
30203,OMEREQUE,estado nutricional en menores de 5 anos,clasificacion e,2003-02-01,0,1,0,1,1
40101,ORURO,estado nutricional en menores de 5 anos,clasificacion e,2003-02-01,118,86,118,86,204
60201,PADCAYA,estado nutricional en menores de 5 anos,clasificacion e,2003-02-01,9,5,9,5,14
10401,PADILLA,estado nutricional en menores de 5 anos,clasificacion e,2003-02-01,37,65,37,65,102
70502,PAILON,estado nutricional en menores de 5 anos,clasificacion e,2003-02-01,9,4,9,4,13
20102,PALCA,estado nutricional en menores de 5 anos,clasificacion e,2003-02-01,13,9,13,9,22
21104,PALOS BLANCOS,estado nutricional en menores de 5 anos,clasificacion e,2003-02-01,14,14,14,14,28
40802,PAMPA AULLAGAS,estado nutricional en menores de 5 anos,clasificacion e,2003-02-01,5,3,5,3,8
70902,PAMPA GRANDE,estado nutricional en menores de 5 anos,clasificacion e,2003-02-01,2,5,2,5,7
30202,PASORAPA,estado nutricional en menores de 5 anos,clasificacion e,2003-02-01,9,9,9,9,18
21305,PATACAMAYA,estado nutricional en menores de 5 anos,clasificacion e,2003-02-01,37,18,37,18,55
40602,PAZÃ‘A,estado nutricional en menores de 5 anos,clasificacion e,2003-02-01,1,0,1,0,1
20702,PELECHUCO,estado nutricional en menores de 5 anos,clasificacion e,2003-02-01,7,4,7,4,11
50403,POCOATA,estado nutricional en menores de 5 anos,clasificacion e,2003-02-01,35,44,35,44,79
31203,POCONA,estado nutricional en menores de 5 anos,clasificacion e,2003-02-01,16,7,16,7,23
31202,POJO (CBBA),estado nutricional en menores de 5 anos,clasificacion e,2003-02-01,28,14,28,14,42
40601,POOPO,estado nutricional en menores de 5 anos,clasificacion e,2003-02-01,1,2,1,2,3
51203,PORCO,estado nutricional en menores de 5 anos,clasificacion e,2003-02-01,4,4,4,4,8
10103,POROMA,estado nutricional en menores de 5 anos,clasificacion e,2003-02-01,54,58,54,58,112
70601,PORTACHUELO,estado nutricional en menores de 5 anos,clasificacion e,2003-02-01,7,6,7,6,13
90102,PORVENIR,estado nutricional en menores de 5 anos,clasificacion e,2003-02-01,2,2,2,2,4
70804,POSTRER VALLE,estado nutricional en menores de 5 anos,clasificacion e,2003-02-01,7,3,7,3,10
50101,POTOSI,estado nutricional en menores de 5 anos,clasificacion e,2003-02-01,125,87,125,87,212
10302,PRESTO,estado nutricional en menores de 5 anos,clasificacion e,2003-02-01,24,23,24,23,47
21201,PUCARANI,estado nutricional en menores de 5 anos,clasificacion e,2003-02-01,4,1,4,1,5
20401,PUERTO ACOSTA,estado nutricional en menores de 5 anos,clasificacion e,2003-02-01,22,19,22,19,41
20403,PUERTO CARABUCO,estado nutricional en menores de 5 anos,clasificacion e,2003-02-01,19,19,19,19,38
90301,PUERTO GONZALO MORENO,estado nutricional en menores de 5 anos,clasificacion e,2003-02-01,4,0,4,0,4
21204,PUERTO PEREZ,estado nutricional en menores de 5 anos,clasificacion e,2003-02-01,1,1,1,1,2
71402,PUERTO QUIJARRO,estado nutricional en menores de 5 anos,clasificacion e,2003-02-01,15,1,15,1,16
90201,PUERTO RICO,estado nutricional en menores de 5 anos,clasificacion e,2003-02-01,1,1,1,1,2
71401,PUERTO SUAREZ,estado nutricional en menores de 5 anos,clasificacion e,2003-02-01,17,9,17,9,26
31205,PUERTO VILLARROEL,estado nutricional en menores de 5 anos,clasificacion e,2003-02-01,68,29,68,29,97
51101,PUNA,estado nutricional en menores de 5 anos,clasificacion e,2003-02-01,22,18,22,18,40
31401,PUNATA,estado nutricional en menores de 5 anos,clasificacion e,2003-02-01,21,6,21,6,27
30901,QUILLACOLLO,estado nutricional en menores de 5 anos,clasificacion e,2003-02-01,8,16,8,16,24
21002,QUIME,estado nutricional en menores de 5 anos,clasificacion e,2003-02-01,17,15,17,15,32
50402,RAVELO,estado nutricional en menores de 5 anos,clasificacion e,2003-02-01,89,71,89,71,160
80301,REYES,estado nutricional en menores de 5 anos,clasificacion e,2003-02-01,13,14,13,14,27
80201,RIBERALTA,estado nutricional en menores de 5 anos,clasificacion e,2003-02-01,55,42,55,42,97
70503,ROBORE,estado nutricional en menores de 5 anos,clasificacion e,2003-02-01,13,14,13,14,27
40901,SABAYA,estado nutricional en menores de 5 anos,clasificacion e,2003-02-01,0,3,0,3,3
31001,SACABA,estado nutricional en menores de 5 anos,clasificacion e,2003-02-01,46,21,46,21,67
30404,SACABAMBA,estado nutricional en menores de 5 anos,clasificacion e,2003-02-01,6,17,6,17,23
50701,SACACA,estado nutricional en menores de 5 anos,clasificacion e,2003-02-01,62,91,62,91,153
71302,SAIPINA,estado nutricional en menores de 5 anos,clasificacion e,2003-02-01,3,5,3,5,8
40801,SALINAS DE GARCI MENDOZA,estado nutricional en menores de 5 anos,clasificacion e,2003-02-01,4,2,4,2,6
70901,SAMAIPATA,estado nutricional en menores de 5 anos,clasificacion e,2003-02-01,5,2,5,2,7
80602,SAN ANDRES,estado nutricional en menores de 5 anos,clasificacion e,2003-02-01,2,4,2,4,6
51003,SAN ANTONIO DE ESMORUCO,estado nutricional en menores de 5 anos,clasificacion e,2003-02-01,0,2,0,2,2
71105,SAN ANTONIO DE LOMERIO,estado nutricional en menores de 5 anos,clasificacion e,2003-02-01,43,52,43,52,95
31403,SAN BENITO,estado nutricional en menores de 5 anos,clasificacion e,2003-02-01,12,4,12,4,16
80302,SAN BORJA,estado nutricional en menores de 5 anos,clasificacion e,2003-02-01,33,10,33,10,43
21502,SAN BUENA VENTURA,estado nutricional en menores de 5 anos,clasificacion e,2003-02-01,10,7,10,7,17
70402,SAN CARLOS,estado nutricional en menores de 5 anos,clasificacion e,2003-02-01,15,12,15,12,27
80501,SAN IGNACIO,estado nutricional en menores de 5 anos,clasificacion e,2003-02-01,23,19,23,19,42
70301,SAN IGNACIO DE VELASCO,estado nutricional en menores de 5 anos,clasificacion e,2003-02-01,79,40,79,40,119
80102,SAN JAVIER(BNI),estado nutricional en menores de 5 anos,clasificacion e,2003-02-01,1,1,1,1,2
71102,SAN JAVIER(STC),estado nutricional en menores de 5 anos,clasificacion e,2003-02-01,6,4,6,4,10
80701,SAN JOAQUIN,estado nutricional en menores de 5 anos,clasificacion e,2003-02-01,4,1,4,1,5
70501,SAN JOSE DE CHIQUITOS,estado nutricional en menores de 5 anos,clasificacion e,2003-02-01,15,5,15,5,20
71104,SAN JULIAN,estado nutricional en menores de 5 anos,clasificacion e,2003-02-01,81,55,81,55,136
90302,SAN LORENZO(PND),estado nutricional en menores de 5 anos,clasificacion e,2003-02-01,3,7,3,7,10
60501,SAN LORENZO(TJA),estado nutricional en menores de 5 anos,clasificacion e,2003-02-01,11,9,11,9,20
10702,SAN LUCAS,estado nutricional en menores de 5 anos,clasificacion e,2003-02-01,126,99,126,99,225
71201,SAN MATIAS,estado nutricional en menores de 5 anos,clasificacion e,2003-02-01,9,6,9,6,15
70302,SAN MIGUEL DE VELASCO,estado nutricional en menores de 5 anos,clasificacion e,2003-02-01,21,24,21,24,45
51001,SAN PABLO DE LIPEZ,estado nutricional en menores de 5 anos,clasificacion e,2003-02-01,1,3,1,3,4
50501,SAN PEDRO DE BUENA VISTA,estado nutricional en menores de 5 anos,clasificacion e,2003-02-01,36,39,36,39,75
21801,SAN PEDRO DE CURAHUARA,estado nutricional en menores de 5 anos,clasificacion e,2003-02-01,1,1,1,1,2
50902,SAN PEDRO DE QUEMES,estado nutricional en menores de 5 anos,clasificacion e,2003-02-01,1,0,1,0,1
70303,SAN RAFAEL,estado nutricional en menores de 5 anos,clasificacion e,2003-02-01,7,10,7,10,17
80702,SAN RAMON,estado nutricional en menores de 5 anos,clasificacion e,2003-02-01,1,1,1,1,2
70101,SANTA CRUZ DE LA SIERRA,estado nutricional en menores de 5 anos,clasificacion e,2003-02-01,152,55,152,55,207
70602,SANTA ROSA DEL SARA,estado nutricional en menores de 5 anos,clasificacion e,2003-02-01,4,4,4,4,8
41401,SANTIAGO DE HUARI,estado nutricional en menores de 5 anos,clasificacion e,2003-02-01,2,4,2,4,6
21901,SANTIAGO DE MACHACA,estado nutricional en menores de 5 anos,clasificacion e,2003-02-01,1,0,1,0,1
30702,SANTIVAÃ‘ES,estado nutricional en menores de 5 anos,clasificacion e,2003-02-01,8,7,8,7,15
40202,SANTUARIO DE QUILLACAS,estado nutricional en menores de 5 anos,clasificacion e,2003-02-01,4,2,4,2,6
20902,SAPAHAQUI,estado nutricional en menores de 5 anos,clasificacion e,2003-02-01,8,3,8,3,11
90303,SENA,estado nutricional en menores de 5 anos,clasificacion e,2003-02-01,3,2,3,2,5
21301,SICA SICA (VILLA AROMA),estado nutricional en menores de 5 anos,clasificacion e,2003-02-01,8,7,8,7,15
30703,SICAYA,estado nutricional en menores de 5 anos,clasificacion e,2003-02-01,1,1,1,1,2
30902,SIPE SIPE,estado nutricional en menores de 5 anos,clasificacion e,2003-02-01,35,10,35,10,45
10403,SOPACHUY,estado nutricional en menores de 5 anos,clasificacion e,2003-02-01,23,27,23,27,50
20601,SORATA,estado nutricional en menores de 5 anos,clasificacion e,2003-02-01,9,8,9,8,17
10101,SUCRE,estado nutricional en menores de 5 anos,clasificacion e,2003-02-01,130,129,130,129,259
31404,TACACHI,estado nutricional en menores de 5 anos,clasificacion e,2003-02-01,1,0,1,0,1
50303,TACOBAMBA,estado nutricional en menores de 5 anos,clasificacion e,2003-02-01,11,12,11,12,23
30602,TACOPAYA,estado nutricional en menores de 5 anos,clasificacion e,2003-02-01,16,17,16,17,33
51402,TAHUA,estado nutricional en menores de 5 anos,clasificacion e,2003-02-01,0,1,0,1,1
31101,TAPACARI,estado nutricional en menores de 5 anos,clasificacion e,2003-02-01,15,25,15,25,40
10601,TARABUCO,estado nutricional en menores de 5 anos,clasificacion e,2003-02-01,105,123,105,123,228
30401,TARATA,estado nutricional en menores de 5 anos,clasificacion e,2003-02-01,7,1,7,1,8
60101,TARIJA,estado nutricional en menores de 5 anos,clasificacion e,2003-02-01,81,36,81,36,117
10202,TARVITA,estado nutricional en menores de 5 anos,clasificacion e,2003-02-01,35,53,35,53,88
20803,TIAWANACU,estado nutricional en menores de 5 anos,clasificacion e,2003-02-01,8,0,8,0,8
50102,TINGUIPAYA,estado nutricional en menores de 5 anos,clasificacion e,2003-02-01,4,5,4,5,9
20606,TIPUANI,estado nutricional en menores de 5 anos,clasificacion e,2003-02-01,2,0,2,0,2
30903,TIQUIPAYA,estado nutricional en menores de 5 anos,clasificacion e,2003-02-01,1,7,1,7,8
31601,TIRAQUE (CBBA),estado nutricional en menores de 5 anos,clasificacion e,2003-02-01,34,26,34,26,60
30802,TOCO,estado nutricional en menores de 5 anos,clasificacion e,2003-02-01,0,2,0,2,2
30803,TOLATA,estado nutricional en menores de 5 anos,clasificacion e,2003-02-01,2,2,2,2,4
41001,TOLEDO,estado nutricional en menores de 5 anos,clasificacion e,2003-02-01,2,0,2,0,2
51202,TOMAVE,estado nutricional en menores de 5 anos,clasificacion e,2003-02-01,15,24,15,24,39
10402,TOMINA,estado nutricional en menores de 5 anos,clasificacion e,2003-02-01,40,36,40,36,76
50502,TORO TORO,estado nutricional en menores de 5 anos,clasificacion e,2003-02-01,25,22,25,22,47
31201,TOTORA(CBBA),estado nutricional en menores de 5 anos,clasificacion e,2003-02-01,4,4,4,4,8
41301,TOTORA(ORR),estado nutricional en menores de 5 anos,clasificacion e,2003-02-01,7,8,7,8,15
70802,TRIGAL,estado nutricional en menores de 5 anos,clasificacion e,2003-02-01,3,0,3,0,3
80101,TRINIDAD,estado nutricional en menores de 5 anos,clasificacion e,2003-02-01,30,56,30,56,86
50801,TUPIZA,estado nutricional en menores de 5 anos,clasificacion e,2003-02-01,24,108,24,108,132
40402,TURCO,estado nutricional en menores de 5 anos,clasificacion e,2003-02-01,0,2,0,2,2
21302,UMALA,estado nutricional en menores de 5 anos,clasificacion e,2003-02-01,3,4,3,4,7
50201,UNCIA,estado nutricional en menores de 5 anos,clasificacion e,2003-02-01,2,3,2,3,5
60401,URIONDO (A. CONCEPCION),estado nutricional en menores de 5 anos,clasificacion e,2003-02-01,6,0,6,0,6
71502,URUBICHA,estado nutricional en menores de 5 anos,clasificacion e,2003-02-01,13,18,13,18,31
51201,UYUNI,estado nutricional en menores de 5 anos,clasificacion e,2003-02-01,13,12,13,12,25
30502,VACAS,estado nutricional en menores de 5 anos,clasificacion e,2003-02-01,5,1,5,1,6
70801,VALLEGRANDE,estado nutricional en menores de 5 anos,clasificacion e,2003-02-01,20,15,20,15,35
20801,VIACHA,estado nutricional en menores de 5 anos,clasificacion e,2003-02-01,11,26,11,26,37
31302,VILA VILA,estado nutricional en menores de 5 anos,clasificacion e,2003-02-01,5,10,5,10,15
60303,VILLA MONTES,estado nutricional en menores de 5 anos,clasificacion e,2003-02-01,45,18,45,18,63
31402,VILLA RIVERO,estado nutricional en menores de 5 anos,clasificacion e,2003-02-01,10,2,10,2,12
10801,VILLA SERRANO,estado nutricional en menores de 5 anos,clasificacion e,2003-02-01,34,37,34,37,71
31003,VILLA TUNARI,estado nutricional en menores de 5 anos,clasificacion e,2003-02-01,31,20,31,20,51
11001,VILLA VACA GUZMAN (MUYUPAMPA),estado nutricional en menores de 5 anos,clasificacion e,2003-02-01,22,20,22,20,42
51501,VILLAZON,estado nutricional en menores de 5 anos,clasificacion e,2003-02-01,26,29,26,29,55
50602,VITICHI,estado nutricional en menores de 5 anos,clasificacion e,2003-02-01,24,28,24,28,52
20306,WALDO BALLIVIAN,estado nutricional en menores de 5 anos,clasificacion e,2003-02-01,1,0,1,0,1
70201,WARNES,estado nutricional en menores de 5 anos,clasificacion e,2003-02-01,27,15,27,15,42
20903,YACO,estado nutricional en menores de 5 anos,clasificacion e,2003-02-01,19,27,19,27,46
60301,YACUIBA,estado nutricional en menores de 5 anos,clasificacion e,2003-02-01,34,24,34,24,58
10602,YAMPARAEZ,estado nutricional en menores de 5 anos,clasificacion e,2003-02-01,76,49,76,49,125
21103,YANACACHI,estado nutricional en menores de 5 anos,clasificacion e,2003-02-01,4,2,4,2,6
70403,YAPACANI,estado nutricional en menores de 5 anos,clasificacion e,2003-02-01,32,25,32,25,57
50103,YOCALLA,estado nutricional en menores de 5 anos,clasificacion e,2003-02-01,6,2,6,2,8
10102,YOTALA,estado nutricional en menores de 5 anos,clasificacion e,2003-02-01,23,38,23,38,61
60402,YUNCHARA,estado nutricional en menores de 5 anos,clasificacion e,2003-02-01,3,8,3,8,11
10301,ZUDAÃ‘EZ,estado nutricional en menores de 5 anos,clasificacion e,2003-02-01,22,27,22,27,49
51302,ACACIO,estado nutricional en menores de 5 anos,clasificacion e,2003-03-01,33,32,33,32,65
20201,ACHACACHI,estado nutricional en menores de 5 anos,clasificacion e,2003-03-01,11,13,11,13,24
20104,ACHOCALLA,estado nutricional en menores de 5 anos,clasificacion e,2003-03-01,2,2,2,2,4
30201,AIQUILE,estado nutricional en menores de 5 anos,clasificacion e,2003-03-01,13,15,13,15,28
31303,ALALAY,estado nutricional en menores de 5 anos,clasificacion e,2003-03-01,2,2,2,2,4
10404,ALCALA,estado nutricional en menores de 5 anos,clasificacion e,2003-03-01,14,19,14,19,33
20202,ANCORAIMES,estado nutricional en menores de 5 anos,clasificacion e,2003-03-01,12,13,12,13,25
41201,ANDAMARCA,estado nutricional en menores de 5 anos,clasificacion e,2003-03-01,2,10,2,10,12
40603,ANTEQUERA,estado nutricional en menores de 5 anos,clasificacion e,2003-03-01,0,1,0,1,1
30402,ANZALDO,estado nutricional en menores de 5 anos,clasificacion e,2003-03-01,2,13,2,13,15
20701,APOLO,estado nutricional en menores de 5 anos,clasificacion e,2003-03-01,6,5,6,5,11
51301,ARAMPAMPA,estado nutricional en menores de 5 anos,clasificacion e,2003-03-01,9,18,9,18,27
30501,ARANI,estado nutricional en menores de 5 anos,clasificacion e,2003-03-01,0,10,0,10,10
30403,ARBIETO,estado nutricional en menores de 5 anos,clasificacion e,2003-03-01,2,5,2,5,7
30601,ARQUE,estado nutricional en menores de 5 anos,clasificacion e,2003-03-01,25,29,25,29,54
71501,ASCENCION DE GUARAYOS,estado nutricional en menores de 5 anos,clasificacion e,2003-03-01,1,2,1,2,3
50802,ATOCHA,estado nutricional en menores de 5 anos,clasificacion e,2003-03-01,2,49,2,49,51
20503,AUCAPATA,estado nutricional en menores de 5 anos,clasificacion e,2003-03-01,7,6,7,6,13
20502,AYATA,estado nutricional en menores de 5 anos,clasificacion e,2003-03-01,13,7,13,7,20
30301,AYOPAYA (V. DE INDEPENDENCIA),estado nutricional en menores de 5 anos,clasificacion e,2003-03-01,16,20,16,20,36
10201,AZURDUY,estado nutricional en menores de 5 anos,clasificacion e,2003-03-01,51,33,51,33,84
21203,BATALLAS,estado nutricional en menores de 5 anos,clasificacion e,2003-03-01,4,1,4,1,5
80802,BAURES,estado nutricional en menores de 5 anos,clasificacion e,2003-03-01,5,8,5,8,13
41202,BELEN DE ANDAMARCA,estado nutricional en menores de 5 anos,clasificacion e,2003-03-01,0,2,0,2,2
50104,BELEN DE URMIRI,estado nutricional en menores de 5 anos,clasificacion e,2003-03-01,0,3,0,3,3
90104,BELLA FLOR,estado nutricional en menores de 5 anos,clasificacion e,2003-03-01,1,2,1,2,3
60202,BERMEJO,estado nutricional en menores de 5 anos,clasificacion e,2003-03-01,0,1,0,1,1
50301,BETANZOS,estado nutricional en menores de 5 anos,clasificacion e,2003-03-01,124,88,124,88,212
31501,BOLIVAR,estado nutricional en menores de 5 anos,clasificacion e,2003-03-01,20,11,20,11,31
90103,BOLPEBRA,estado nutricional en menores de 5 anos,clasificacion e,2003-03-01,1,0,1,0,1
70707,BOYUIBE,estado nutricional en menores de 5 anos,clasificacion e,2003-03-01,2,0,2,0,2
70401,BUENA VISTA,estado nutricional en menores de 5 anos,clasificacion e,2003-03-01,5,10,5,10,15
70703,CABEZAS,estado nutricional en menores de 5 anos,clasificacion e,2003-03-01,0,1,0,1,1
20905,CAIROMA,estado nutricional en menores de 5 anos,clasificacion e,2003-03-01,7,4,7,4,11
51102,"CAIZA ""D""",estado nutricional en menores de 5 anos,clasificacion e,2003-03-01,40,31,40,31,71
21003,CAJUATA,estado nutricional en menores de 5 anos,clasificacion e,2003-03-01,7,4,7,4,11
20303,CALACOTO,estado nutricional en menores de 5 anos,clasificacion e,2003-03-01,1,1,1,1,2
21304,CALAMARCA,estado nutricional en menores de 5 anos,clasificacion e,2003-03-01,29,24,29,24,53
10701,CAMARGO,estado nutricional en menores de 5 anos,clasificacion e,2003-03-01,18,18,18,18,36
10901,CAMATAQUI (C. VILLA ABECIA),estado nutricional en menores de 5 anos,clasificacion e,2003-03-01,1,0,1,0,1
70706,CAMIRI,estado nutricional en menores de 5 anos,clasificacion e,2003-03-01,40,21,40,21,61
30701,CAPINOTA,estado nutricional en menores de 5 anos,clasificacion e,2003-03-01,16,31,16,31,47
20302,CAQUIAVIRI,estado nutricional en menores de 5 anos,clasificacion e,2003-03-01,6,2,6,2,8
40102,CARACOLLO,estado nutricional en menores de 5 anos,clasificacion e,2003-03-01,5,3,5,3,8
22001,CARANAVI,estado nutricional en menores de 5 anos,clasificacion e,2003-03-01,33,40,33,40,73
60302,CARAPARI,estado nutricional en menores de 5 anos,clasificacion e,2003-03-01,9,8,9,8,17
50702,CARIPUYO,estado nutricional en menores de 5 anos,clasificacion e,2003-03-01,18,18,18,18,36
40201,CHALLAPATA,estado nutricional en menores de 5 anos,clasificacion e,2003-03-01,25,19,25,19,44
50302,CHAQUI,estado nutricional en menores de 5 anos,clasificacion e,2003-03-01,27,10,27,10,37
70702,CHARAGUA,estado nutricional en menores de 5 anos,clasificacion e,2003-03-01,59,29,59,29,88
20305,CHARAÃ‘A,estado nutricional en menores de 5 anos,clasificacion e,2003-03-01,0,2,0,2,2
50202,CHAYANTA,estado nutricional en menores de 5 anos,clasificacion e,2003-03-01,15,13,15,13,28
31204,CHIMORE,estado nutricional en menores de 5 anos,clasificacion e,2003-03-01,10,2,10,2,12
21101,CHULUMANI (V. DE LA LIBERTAD),estado nutricional en menores de 5 anos,clasificacion e,2003-03-01,5,13,5,13,18
20501,CHUMA,estado nutricional en menores de 5 anos,clasificacion e,2003-03-01,7,7,7,7,14
30801,CLIZA,estado nutricional en menores de 5 anos,clasificacion e,2003-03-01,2,2,2,2,4
90101,COBIJA,estado nutricional en menores de 5 anos,clasificacion e,2003-03-01,10,10,10,10,20
30101,COCHABAMBA,estado nutricional en menores de 5 anos,clasificacion e,2003-03-01,90,55,90,55,145
30905,COLCAPIRHUA,estado nutricional en menores de 5 anos,clasificacion e,2003-03-01,2,3,2,3,5
50901,"COLCHA ""K""",estado nutricional en menores de 5 anos,clasificacion e,2003-03-01,11,9,11,9,20
21307,COLLANA,estado nutricional en menores de 5 anos,clasificacion e,2003-03-01,1,2,1,2,3
31002,COLOMI,estado nutricional en menores de 5 anos,clasificacion e,2003-03-01,12,15,12,15,27
50401,COLQUECHACA,estado nutricional en menores de 5 anos,clasificacion e,2003-03-01,54,13,54,13,67
21306,COLQUENCHA,estado nutricional en menores de 5 anos,clasificacion e,2003-03-01,4,2,4,2,6
21004,COLQUIRI,estado nutricional en menores de 5 anos,clasificacion e,2003-03-01,17,17,17,17,34
20304,COMANCHE,estado nutricional en menores de 5 anos,clasificacion e,2003-03-01,1,0,1,0,1
71301,COMARAPA,estado nutricional en menores de 5 anos,clasificacion e,2003-03-01,18,16,18,16,34
71101,CONCEPCION,estado nutricional en menores de 5 anos,clasificacion e,2003-03-01,5,2,5,2,7
21701,COPACABANA,estado nutricional en menores de 5 anos,clasificacion e,2003-03-01,1,0,1,0,1
21402,CORIPATA,estado nutricional en menores de 5 anos,clasificacion e,2003-03-01,0,1,0,1,1
20301,CORO CORO,estado nutricional en menores de 5 anos,clasificacion e,2003-03-01,11,5,11,5,16
21401,COROICO,estado nutricional en menores de 5 anos,clasificacion e,2003-03-01,27,3,27,3,30
40301,CORQUE,estado nutricional en menores de 5 anos,clasificacion e,2003-03-01,8,7,8,7,15
50601,COTAGAITA,estado nutricional en menores de 5 anos,clasificacion e,2003-03-01,17,22,17,22,39
70102,COTOCA,estado nutricional en menores de 5 anos,clasificacion e,2003-03-01,3,6,3,6,9
31405,CUCHUMUELA (V. G. VILLARROEL),estado nutricional en menores de 5 anos,clasificacion e,2003-03-01,1,0,1,0,1
70704,CUEVO,estado nutricional en menores de 5 anos,clasificacion e,2003-03-01,2,1,2,1,3
10902,CULPINA,estado nutricional en menores de 5 anos,clasificacion e,2003-03-01,44,39,44,39,83
40401,CURAHUARA DE CARANGAS,estado nutricional en menores de 5 anos,clasificacion e,2003-03-01,9,4,9,4,13
21602,CURVA,estado nutricional en menores de 5 anos,clasificacion e,2003-03-01,0,2,0,2,2
20804,DESAGUADERO,estado nutricional en menores de 5 anos,clasificacion e,2003-03-01,2,0,2,0,2
20105,EL ALTO,estado nutricional en menores de 5 anos,clasificacion e,2003-03-01,334,169,334,169,503
40103,EL CHORO,estado nutricional en menores de 5 anos,clasificacion e,2003-03-01,2,5,2,5,7
71503,EL PUENTE(STC),estado nutricional en menores de 5 anos,clasificacion e,2003-03-01,3,35,3,35,38
60502,EL PUENTE(TJA),estado nutricional en menores de 5 anos,clasificacion e,2003-03-01,10,5,10,5,15
70105,EL TORNO,estado nutricional en menores de 5 anos,clasificacion e,2003-03-01,21,17,21,17,38
10405,EL VILLAR,estado nutricional en menores de 5 anos,clasificacion e,2003-03-01,15,32,15,32,47
60601,ENTRE RIOS,estado nutricional en menores de 5 anos,clasificacion e,2003-03-01,5,2,5,2,7
40502,ESCARA,estado nutricional en menores de 5 anos,clasificacion e,2003-03-01,0,1,0,1,1
41101,EUCALIPTUS,estado nutricional en menores de 5 anos,clasificacion e,2003-03-01,2,1,2,1,3
80402,EXALTACION,estado nutricional en menores de 5 anos,clasificacion e,2003-03-01,0,7,0,7,7
71002,GENERAL SAAVEDRA,estado nutricional en menores de 5 anos,clasificacion e,2003-03-01,37,19,37,19,56
21601,GRAL. J.J. PEREZ (CHARAZANI),estado nutricional en menores de 5 anos,clasificacion e,2003-03-01,1,4,1,4,5
20602,GUANAY,estado nutricional en menores de 5 anos,clasificacion e,2003-03-01,32,17,32,17,49
20802,GUAQUI,estado nutricional en menores de 5 anos,clasificacion e,2003-03-01,1,2,1,2,3
80202,GUAYARAMERIN,estado nutricional en menores de 5 anos,clasificacion e,2003-03-01,45,27,45,27,72
70705,GUTIERREZ,estado nutricional en menores de 5 anos,clasificacion e,2003-03-01,50,44,50,44,94
10502,HUACARETA,estado nutricional en menores de 5 anos,clasificacion e,2003-03-01,11,21,11,21,32
11002,HUACAYA (VILLA DE HUACAYA),estado nutricional en menores de 5 anos,clasificacion e,2003-03-01,0,1,0,1,1
40701,HUANUNI,estado nutricional en menores de 5 anos,clasificacion e,2003-03-01,36,12,36,12,48
80803,HUARACAJE,estado nutricional en menores de 5 anos,clasificacion e,2003-03-01,1,0,1,0,1
21005,ICHOCA,estado nutricional en menores de 5 anos,clasificacion e,2003-03-01,2,4,2,4,6
10304,ICLA,estado nutricional en menores de 5 anos,clasificacion e,2003-03-01,39,52,39,52,91
10703,INCAHUASI,estado nutricional en menores de 5 anos,clasificacion e,2003-03-01,31,19,31,19,50
21001,INQUISIVI,estado nutricional en menores de 5 anos,clasificacion e,2003-03-01,23,17,23,17,40
21102,IRUPANA (VILLA DE LANZA),estado nutricional en menores de 5 anos,clasificacion e,2003-03-01,1,5,1,5,6
21501,IXIAMAS,estado nutricional en menores de 5 anos,clasificacion e,2003-03-01,9,9,9,9,18
21105,LA ASUNTA,estado nutricional en menores de 5 anos,clasificacion e,2003-03-01,15,13,15,13,28
70104,LA GUARDIA,estado nutricional en menores de 5 anos,clasificacion e,2003-03-01,12,5,12,5,17
20101,LA PAZ,estado nutricional en menores de 5 anos,clasificacion e,2003-03-01,183,149,183,149,332
70701,LAGUNILLAS,estado nutricional en menores de 5 anos,clasificacion e,2003-03-01,11,11,11,11,22
21202,LAJA,estado nutricional en menores de 5 anos,clasificacion e,2003-03-01,2,0,2,0,2
10903,LAS CARRERAS,estado nutricional en menores de 5 anos,clasificacion e,2003-03-01,6,16,6,16,22
21006,LICOMA PAMPA,estado nutricional en menores de 5 anos,clasificacion e,2003-03-01,4,0,4,0,4
50203,LLALLAGUA,estado nutricional en menores de 5 anos,clasificacion e,2003-03-01,8,50,8,50,58
51401,LLICA,estado nutricional en menores de 5 anos,clasificacion e,2003-03-01,2,6,2,6,8
80601,LORETO,estado nutricional en menores de 5 anos,clasificacion e,2003-03-01,1,0,1,0,1
20901,LURIBAY,estado nutricional en menores de 5 anos,clasificacion e,2003-03-01,5,2,5,2,7
40702,MACHACAMARCA,estado nutricional en menores de 5 anos,clasificacion e,2003-03-01,11,3,11,3,14
11003,MACHARETI,estado nutricional en menores de 5 anos,clasificacion e,2003-03-01,7,15,7,15,22
80801,MAGDALENA,estado nutricional en menores de 5 anos,clasificacion e,2003-03-01,3,6,3,6,9
70903,MAIRANA,estado nutricional en menores de 5 anos,clasificacion e,2003-03-01,5,6,5,6,11
20904,MALLA,estado nutricional en menores de 5 anos,clasificacion e,2003-03-01,4,4,4,4,8
20103,MECAPACA,estado nutricional en menores de 5 anos,clasificacion e,2003-03-01,2,3,2,3,5
71003,MINEROS,estado nutricional en menores de 5 anos,clasificacion e,2003-03-01,52,16,52,16,68
31301,MIZQUE,estado nutricional en menores de 5 anos,clasificacion e,2003-03-01,29,11,29,11,40
20402,MOCOMOCO,estado nutricional en menores de 5 anos,clasificacion e,2003-03-01,17,8,17,8,25
51002,MOJINETE,estado nutricional en menores de 5 anos,clasificacion e,2003-03-01,0,2,0,2,2
10303,MOJOCOYA,estado nutricional en menores de 5 anos,clasificacion e,2003-03-01,11,10,11,10,21
10501,MONTEAGUDO,estado nutricional en menores de 5 anos,clasificacion e,2003-03-01,32,28,32,28,60
71001,MONTERO,estado nutricional en menores de 5 anos,clasificacion e,2003-03-01,76,49,76,49,125
70803,MORO MORO,estado nutricional en menores de 5 anos,clasificacion e,2003-03-01,5,7,5,7,12
30302,MOROCHATA,estado nutricional en menores de 5 anos,clasificacion e,2003-03-01,30,31,30,31,61
90401,NACEBE (SANTA ROSA DEL ABUNA),estado nutricional en menores de 5 anos,clasificacion e,2003-03-01,2,0,2,0,2
50404,OCURI,estado nutricional en menores de 5 anos,clasificacion e,2003-03-01,23,40,23,40,63
70202,OKINAWA,estado nutricional en menores de 5 anos,clasificacion e,2003-03-01,4,6,4,6,10
40101,ORURO,estado nutricional en menores de 5 anos,clasificacion e,2003-03-01,108,69,108,69,177
60201,PADCAYA,estado nutricional en menores de 5 anos,clasificacion e,2003-03-01,14,15,14,15,29
10401,PADILLA,estado nutricional en menores de 5 anos,clasificacion e,2003-03-01,37,35,37,35,72
70502,PAILON,estado nutricional en menores de 5 anos,clasificacion e,2003-03-01,9,2,9,2,11
20102,PALCA,estado nutricional en menores de 5 anos,clasificacion e,2003-03-01,7,8,7,8,15
21104,PALOS BLANCOS,estado nutricional en menores de 5 anos,clasificacion e,2003-03-01,14,16,14,16,30
40802,PAMPA AULLAGAS,estado nutricional en menores de 5 anos,clasificacion e,2003-03-01,6,7,6,7,13
70902,PAMPA GRANDE,estado nutricional en menores de 5 anos,clasificacion e,2003-03-01,5,4,5,4,9
21802,PAPEL PAMPA,estado nutricional en menores de 5 anos,clasificacion e,2003-03-01,1,0,1,0,1
30202,PASORAPA,estado nutricional en menores de 5 anos,clasificacion e,2003-03-01,8,4,8,4,12
21305,PATACAMAYA,estado nutricional en menores de 5 anos,clasificacion e,2003-03-01,22,10,22,10,32
40602,PAZÃ‘A,estado nutricional en menores de 5 anos,clasificacion e,2003-03-01,1,7,1,7,8
20702,PELECHUCO,estado nutricional en menores de 5 anos,clasificacion e,2003-03-01,3,2,3,2,5
50403,POCOATA,estado nutricional en menores de 5 anos,clasificacion e,2003-03-01,24,29,24,29,53
31203,POCONA,estado nutricional en menores de 5 anos,clasificacion e,2003-03-01,17,13,17,13,30
31202,POJO (CBBA),estado nutricional en menores de 5 anos,clasificacion e,2003-03-01,18,14,18,14,32
40601,POOPO,estado nutricional en menores de 5 anos,clasificacion e,2003-03-01,0,1,0,1,1
51203,PORCO,estado nutricional en menores de 5 anos,clasificacion e,2003-03-01,5,4,5,4,9
10103,POROMA,estado nutricional en menores de 5 anos,clasificacion e,2003-03-01,50,57,50,57,107
70601,PORTACHUELO,estado nutricional en menores de 5 anos,clasificacion e,2003-03-01,5,7,5,7,12
90102,PORVENIR,estado nutricional en menores de 5 anos,clasificacion e,2003-03-01,0,1,0,1,1
70804,POSTRER VALLE,estado nutricional en menores de 5 anos,clasificacion e,2003-03-01,3,6,3,6,9
50101,POTOSI,estado nutricional en menores de 5 anos,clasificacion e,2003-03-01,127,86,127,86,213
10302,PRESTO,estado nutricional en menores de 5 anos,clasificacion e,2003-03-01,19,22,19,22,41
70805,PUCARA,estado nutricional en menores de 5 anos,clasificacion e,2003-03-01,0,1,0,1,1
21201,PUCARANI,estado nutricional en menores de 5 anos,clasificacion e,2003-03-01,0,6,0,6,6
20401,PUERTO ACOSTA,estado nutricional en menores de 5 anos,clasificacion e,2003-03-01,22,15,22,15,37
20403,PUERTO CARABUCO,estado nutricional en menores de 5 anos,clasificacion e,2003-03-01,15,18,15,18,33
90301,PUERTO GONZALO MORENO,estado nutricional en menores de 5 anos,clasificacion e,2003-03-01,4,1,4,1,5
71402,PUERTO QUIJARRO,estado nutricional en menores de 5 anos,clasificacion e,2003-03-01,7,2,7,2,9
90201,PUERTO RICO,estado nutricional en menores de 5 anos,clasificacion e,2003-03-01,1,7,1,7,8
71401,PUERTO SUAREZ,estado nutricional en menores de 5 anos,clasificacion e,2003-03-01,14,4,14,4,18
31205,PUERTO VILLARROEL,estado nutricional en menores de 5 anos,clasificacion e,2003-03-01,67,45,67,45,112
51101,PUNA,estado nutricional en menores de 5 anos,clasificacion e,2003-03-01,80,23,80,23,103
31401,PUNATA,estado nutricional en menores de 5 anos,clasificacion e,2003-03-01,54,10,54,10,64
30901,QUILLACOLLO,estado nutricional en menores de 5 anos,clasificacion e,2003-03-01,40,62,40,62,102
21002,QUIME,estado nutricional en menores de 5 anos,clasificacion e,2003-03-01,19,16,19,16,35
50402,RAVELO,estado nutricional en menores de 5 anos,clasificacion e,2003-03-01,75,75,75,75,150
80301,REYES,estado nutricional en menores de 5 anos,clasificacion e,2003-03-01,8,3,8,3,11
80201,RIBERALTA,estado nutricional en menores de 5 anos,clasificacion e,2003-03-01,59,54,59,54,113
70503,ROBORE,estado nutricional en menores de 5 anos,clasificacion e,2003-03-01,27,15,27,15,42
80304,RURRENABAQUE,estado nutricional en menores de 5 anos,clasificacion e,2003-03-01,3,1,3,1,4
40901,SABAYA,estado nutricional en menores de 5 anos,clasificacion e,2003-03-01,1,1,1,1,2
31001,SACABA,estado nutricional en menores de 5 anos,clasificacion e,2003-03-01,56,47,56,47,103
30404,SACABAMBA,estado nutricional en menores de 5 anos,clasificacion e,2003-03-01,5,10,5,10,15
50701,SACACA,estado nutricional en menores de 5 anos,clasificacion e,2003-03-01,55,81,55,81,136
71302,SAIPINA,estado nutricional en menores de 5 anos,clasificacion e,2003-03-01,1,0,1,0,1
40801,SALINAS DE GARCI MENDOZA,estado nutricional en menores de 5 anos,clasificacion e,2003-03-01,7,3,7,3,10
70901,SAMAIPATA,estado nutricional en menores de 5 anos,clasificacion e,2003-03-01,5,2,5,2,7
51601,SAN AGUSTIN,estado nutricional en menores de 5 anos,clasificacion e,2003-03-01,0,1,0,1,1
80602,SAN ANDRES,estado nutricional en menores de 5 anos,clasificacion e,2003-03-01,7,1,7,1,8
51003,SAN ANTONIO DE ESMORUCO,estado nutricional en menores de 5 anos,clasificacion e,2003-03-01,0,3,0,3,3
71105,SAN ANTONIO DE LOMERIO,estado nutricional en menores de 5 anos,clasificacion e,2003-03-01,32,45,32,45,77
31403,SAN BENITO,estado nutricional en menores de 5 anos,clasificacion e,2003-03-01,8,4,8,4,12
80302,SAN BORJA,estado nutricional en menores de 5 anos,clasificacion e,2003-03-01,39,14,39,14,53
21502,SAN BUENA VENTURA,estado nutricional en menores de 5 anos,clasificacion e,2003-03-01,9,1,9,1,10
70402,SAN CARLOS,estado nutricional en menores de 5 anos,clasificacion e,2003-03-01,14,12,14,12,26
80501,SAN IGNACIO,estado nutricional en menores de 5 anos,clasificacion e,2003-03-01,26,23,26,23,49
70301,SAN IGNACIO DE VELASCO,estado nutricional en menores de 5 anos,clasificacion e,2003-03-01,55,40,55,40,95
80102,SAN JAVIER(BNI),estado nutricional en menores de 5 anos,clasificacion e,2003-03-01,2,0,2,0,2
71102,SAN JAVIER(STC),estado nutricional en menores de 5 anos,clasificacion e,2003-03-01,11,2,11,2,13
70501,SAN JOSE DE CHIQUITOS,estado nutricional en menores de 5 anos,clasificacion e,2003-03-01,11,2,11,2,13
71104,SAN JULIAN,estado nutricional en menores de 5 anos,clasificacion e,2003-03-01,73,88,73,88,161
90302,SAN LORENZO(PND),estado nutricional en menores de 5 anos,clasificacion e,2003-03-01,9,12,9,12,21
60501,SAN LORENZO(TJA),estado nutricional en menores de 5 anos,clasificacion e,2003-03-01,10,8,10,8,18
10702,SAN LUCAS,estado nutricional en menores de 5 anos,clasificacion e,2003-03-01,160,96,160,96,256
70302,SAN MIGUEL DE VELASCO,estado nutricional en menores de 5 anos,clasificacion e,2003-03-01,17,20,17,20,37
51001,SAN PABLO DE LIPEZ,estado nutricional en menores de 5 anos,clasificacion e,2003-03-01,2,7,2,7,9
50501,SAN PEDRO DE BUENA VISTA,estado nutricional en menores de 5 anos,clasificacion e,2003-03-01,46,68,46,68,114
21801,SAN PEDRO DE CURAHUARA,estado nutricional en menores de 5 anos,clasificacion e,2003-03-01,0,3,0,3,3
70303,SAN RAFAEL,estado nutricional en menores de 5 anos,clasificacion e,2003-03-01,14,9,14,9,23
80702,SAN RAMON,estado nutricional en menores de 5 anos,clasificacion e,2003-03-01,0,1,0,1,1
80702,SAN RAMON,estado nutricional en menores de 5 anos,clasificacion e,2003-03-01,1,1,1,1,2
80401,SANTA ANA,estado nutricional en menores de 5 anos,clasificacion e,2003-03-01,0,1,0,1,1
70101,SANTA CRUZ DE LA SIERRA,estado nutricional en menores de 5 anos,clasificacion e,2003-03-01,136,56,136,56,192
80303,SANTA ROSA,estado nutricional en menores de 5 anos,clasificacion e,2003-03-01,1,1,1,1,2
70602,SANTA ROSA DEL SARA,estado nutricional en menores de 5 anos,clasificacion e,2003-03-01,4,8,4,8,12
20308,SANTIAGO DE CALLAPA,estado nutricional en menores de 5 anos,clasificacion e,2003-03-01,5,2,5,2,7
21901,SANTIAGO DE MACHACA,estado nutricional en menores de 5 anos,clasificacion e,2003-03-01,1,1,1,1,2
30702,SANTIVAÃ‘ES,estado nutricional en menores de 5 anos,clasificacion e,2003-03-01,13,2,13,2,15
40202,SANTUARIO DE QUILLACAS,estado nutricional en menores de 5 anos,clasificacion e,2003-03-01,1,2,1,2,3
20902,SAPAHAQUI,estado nutricional en menores de 5 anos,clasificacion e,2003-03-01,13,11,13,11,24
90303,SENA,estado nutricional en menores de 5 anos,clasificacion e,2003-03-01,0,6,0,6,6
21301,SICA SICA (VILLA AROMA),estado nutricional en menores de 5 anos,clasificacion e,2003-03-01,34,11,34,11,45
30703,SICAYA,estado nutricional en menores de 5 anos,clasificacion e,2003-03-01,2,0,2,0,2
30902,SIPE SIPE,estado nutricional en menores de 5 anos,clasificacion e,2003-03-01,37,17,37,17,54
10403,SOPACHUY,estado nutricional en menores de 5 anos,clasificacion e,2003-03-01,22,11,22,11,33
20601,SORATA,estado nutricional en menores de 5 anos,clasificacion e,2003-03-01,8,8,8,8,16
10101,SUCRE,estado nutricional en menores de 5 anos,clasificacion e,2003-03-01,126,91,126,91,217
31404,TACACHI,estado nutricional en menores de 5 anos,clasificacion e,2003-03-01,1,0,1,0,1
50303,TACOBAMBA,estado nutricional en menores de 5 anos,clasificacion e,2003-03-01,26,22,26,22,48
30602,TACOPAYA,estado nutricional en menores de 5 anos,clasificacion e,2003-03-01,20,23,20,23,43
31101,TAPACARI,estado nutricional en menores de 5 anos,clasificacion e,2003-03-01,39,22,39,22,61
10601,TARABUCO,estado nutricional en menores de 5 anos,clasificacion e,2003-03-01,104,100,104,100,204
30401,TARATA,estado nutricional en menores de 5 anos,clasificacion e,2003-03-01,5,10,5,10,15
60101,TARIJA,estado nutricional en menores de 5 anos,clasificacion e,2003-03-01,34,19,34,19,53
10202,TARVITA,estado nutricional en menores de 5 anos,clasificacion e,2003-03-01,40,38,40,38,78
20803,TIAWANACU,estado nutricional en menores de 5 anos,clasificacion e,2003-03-01,3,1,3,1,4
50102,TINGUIPAYA,estado nutricional en menores de 5 anos,clasificacion e,2003-03-01,20,26,20,26,46
20606,TIPUANI,estado nutricional en menores de 5 anos,clasificacion e,2003-03-01,3,2,3,2,5
30903,TIQUIPAYA,estado nutricional en menores de 5 anos,clasificacion e,2003-03-01,3,4,3,4,7
31601,TIRAQUE (CBBA),estado nutricional en menores de 5 anos,clasificacion e,2003-03-01,37,61,37,61,98
21703,TITO YUPANQUI (PARQUIPUJIO),estado nutricional en menores de 5 anos,clasificacion e,2003-03-01,1,3,1,3,4
30802,TOCO,estado nutricional en menores de 5 anos,clasificacion e,2003-03-01,0,3,0,3,3
30803,TOLATA,estado nutricional en menores de 5 anos,clasificacion e,2003-03-01,3,1,3,1,4
41001,TOLEDO,estado nutricional en menores de 5 anos,clasificacion e,2003-03-01,1,2,1,2,3
51202,TOMAVE,estado nutricional en menores de 5 anos,clasificacion e,2003-03-01,16,8,16,8,24
10402,TOMINA,estado nutricional en menores de 5 anos,clasificacion e,2003-03-01,42,52,42,52,94
50502,TORO TORO,estado nutricional en menores de 5 anos,clasificacion e,2003-03-01,23,18,23,18,41
31201,TOTORA(CBBA),estado nutricional en menores de 5 anos,clasificacion e,2003-03-01,17,4,17,4,21
41301,TOTORA(ORR),estado nutricional en menores de 5 anos,clasificacion e,2003-03-01,4,5,4,5,9
80101,TRINIDAD,estado nutricional en menores de 5 anos,clasificacion e,2003-03-01,37,40,37,40,77
50801,TUPIZA,estado nutricional en menores de 5 anos,clasificacion e,2003-03-01,18,66,18,66,84
40402,TURCO,estado nutricional en menores de 5 anos,clasificacion e,2003-03-01,2,1,2,1,3
21302,UMALA,estado nutricional en menores de 5 anos,clasificacion e,2003-03-01,1,3,1,3,4
50201,UNCIA,estado nutricional en menores de 5 anos,clasificacion e,2003-03-01,3,15,3,15,18
60401,URIONDO (A. CONCEPCION),estado nutricional en menores de 5 anos,clasificacion e,2003-03-01,2,0,2,0,2
51201,UYUNI,estado nutricional en menores de 5 anos,clasificacion e,2003-03-01,18,13,18,13,31
30502,VACAS,estado nutricional en menores de 5 anos,clasificacion e,2003-03-01,3,1,3,1,4
70801,VALLEGRANDE,estado nutricional en menores de 5 anos,clasificacion e,2003-03-01,22,30,22,30,52
20801,VIACHA,estado nutricional en menores de 5 anos,clasificacion e,2003-03-01,15,8,15,8,23
31302,VILA VILA,estado nutricional en menores de 5 anos,clasificacion e,2003-03-01,9,1,9,1,10
60303,VILLA MONTES,estado nutricional en menores de 5 anos,clasificacion e,2003-03-01,27,10,27,10,37
31402,VILLA RIVERO,estado nutricional en menores de 5 anos,clasificacion e,2003-03-01,10,4,10,4,14
10801,VILLA SERRANO,estado nutricional en menores de 5 anos,clasificacion e,2003-03-01,28,33,28,33,61
31003,VILLA TUNARI,estado nutricional en menores de 5 anos,clasificacion e,2003-03-01,26,23,26,23,49
11001,VILLA VACA GUZMAN (MUYUPAMPA),estado nutricional en menores de 5 anos,clasificacion e,2003-03-01,9,16,9,16,25
51501,VILLAZON,estado nutricional en menores de 5 anos,clasificacion e,2003-03-01,24,28,24,28,52
50602,VITICHI,estado nutricional en menores de 5 anos,clasificacion e,2003-03-01,17,17,17,17,34
20306,WALDO BALLIVIAN,estado nutricional en menores de 5 anos,clasificacion e,2003-03-01,0,1,0,1,1
70201,WARNES,estado nutricional en menores de 5 anos,clasificacion e,2003-03-01,44,21,44,21,65
20903,YACO,estado nutricional en menores de 5 anos,clasificacion e,2003-03-01,4,4,4,4,8
60301,YACUIBA,estado nutricional en menores de 5 anos,clasificacion e,2003-03-01,36,18,36,18,54
10602,YAMPARAEZ,estado nutricional en menores de 5 anos,clasificacion e,2003-03-01,70,42,70,42,112
21103,YANACACHI,estado nutricional en menores de 5 anos,clasificacion e,2003-03-01,1,2,1,2,3
70403,YAPACANI,estado nutricional en menores de 5 anos,clasificacion e,2003-03-01,28,15,28,15,43
50103,YOCALLA,estado nutricional en menores de 5 anos,clasificacion e,2003-03-01,8,5,8,5,13
10102,YOTALA,estado nutricional en menores de 5 anos,clasificacion e,2003-03-01,19,25,19,25,44
60402,YUNCHARA,estado nutricional en menores de 5 anos,clasificacion e,2003-03-01,1,8,1,8,9
10301,ZUDAÃ‘EZ,estado nutricional en menores de 5 anos,clasificacion e,2003-03-01,32,35,32,35,67
51302,ACACIO,estado nutricional en menores de 5 anos,clasificacion e,2003-04-01,41,32,41,32,73
20201,ACHACACHI,estado nutricional en menores de 5 anos,clasificacion e,2003-04-01,11,7,11,7,18
20104,ACHOCALLA,estado nutricional en menores de 5 anos,clasificacion e,2003-04-01,3,3,3,3,6
30201,AIQUILE,estado nutricional en menores de 5 anos,clasificacion e,2003-04-01,18,28,18,28,46
31303,ALALAY,estado nutricional en menores de 5 anos,clasificacion e,2003-04-01,2,0,2,0,2
10404,ALCALA,estado nutricional en menores de 5 anos,clasificacion e,2003-04-01,11,18,11,18,29
20202,ANCORAIMES,estado nutricional en menores de 5 anos,clasificacion e,2003-04-01,6,9,6,9,15
41201,ANDAMARCA,estado nutricional en menores de 5 anos,clasificacion e,2003-04-01,1,0,1,0,1
40603,ANTEQUERA,estado nutricional en menores de 5 anos,clasificacion e,2003-04-01,1,1,1,1,2
30402,ANZALDO,estado nutricional en menores de 5 anos,clasificacion e,2003-04-01,6,19,6,19,25
20701,APOLO,estado nutricional en menores de 5 anos,clasificacion e,2003-04-01,7,10,7,10,17
51301,ARAMPAMPA,estado nutricional en menores de 5 anos,clasificacion e,2003-04-01,8,17,8,17,25
30501,ARANI,estado nutricional en menores de 5 anos,clasificacion e,2003-04-01,3,22,3,22,25
30403,ARBIETO,estado nutricional en menores de 5 anos,clasificacion e,2003-04-01,4,2,4,2,6
30601,ARQUE,estado nutricional en menores de 5 anos,clasificacion e,2003-04-01,15,10,15,10,25
71501,ASCENCION DE GUARAYOS,estado nutricional en menores de 5 anos,clasificacion e,2003-04-01,77,77,77,77,154
50802,ATOCHA,estado nutricional en menores de 5 anos,clasificacion e,2003-04-01,12,53,12,53,65
20503,AUCAPATA,estado nutricional en menores de 5 anos,clasificacion e,2003-04-01,3,11,3,11,14
20502,AYATA,estado nutricional en menores de 5 anos,clasificacion e,2003-04-01,17,7,17,7,24
21303,AYO AYO,estado nutricional en menores de 5 anos,clasificacion e,2003-04-01,1,2,1,2,3
30301,AYOPAYA (V. DE INDEPENDENCIA),estado nutricional en menores de 5 anos,clasificacion e,2003-04-01,16,17,16,17,33
10201,AZURDUY,estado nutricional en menores de 5 anos,clasificacion e,2003-04-01,45,35,45,35,80
21203,BATALLAS,estado nutricional en menores de 5 anos,clasificacion e,2003-04-01,2,7,2,7,9
80802,BAURES,estado nutricional en menores de 5 anos,clasificacion e,2003-04-01,3,3,3,3,6
41202,BELEN DE ANDAMARCA,estado nutricional en menores de 5 anos,clasificacion e,2003-04-01,2,1,2,1,3
50104,BELEN DE URMIRI,estado nutricional en menores de 5 anos,clasificacion e,2003-04-01,2,1,2,1,3
90104,BELLA FLOR,estado nutricional en menores de 5 anos,clasificacion e,2003-04-01,3,4,3,4,7
60202,BERMEJO,estado nutricional en menores de 5 anos,clasificacion e,2003-04-01,0,1,0,1,1
50301,BETANZOS,estado nutricional en menores de 5 anos,clasificacion e,2003-04-01,97,86,97,86,183
31501,BOLIVAR,estado nutricional en menores de 5 anos,clasificacion e,2003-04-01,25,37,25,37,62
90103,BOLPEBRA,estado nutricional en menores de 5 anos,clasificacion e,2003-04-01,3,2,3,2,5
70707,BOYUIBE,estado nutricional en menores de 5 anos,clasificacion e,2003-04-01,3,2,3,2,5
70401,BUENA VISTA,estado nutricional en menores de 5 anos,clasificacion e,2003-04-01,10,13,10,13,23
70703,CABEZAS,estado nutricional en menores de 5 anos,clasificacion e,2003-04-01,18,4,18,4,22
20905,CAIROMA,estado nutricional en menores de 5 anos,clasificacion e,2003-04-01,17,11,17,11,28
51102,"CAIZA ""D""",estado nutricional en menores de 5 anos,clasificacion e,2003-04-01,26,12,26,12,38
21003,CAJUATA,estado nutricional en menores de 5 anos,clasificacion e,2003-04-01,13,12,13,12,25
20303,CALACOTO,estado nutricional en menores de 5 anos,clasificacion e,2003-04-01,2,2,2,2,4
21304,CALAMARCA,estado nutricional en menores de 5 anos,clasificacion e,2003-04-01,41,32,41,32,73
10701,CAMARGO,estado nutricional en menores de 5 anos,clasificacion e,2003-04-01,9,18,9,18,27
10901,CAMATAQUI (C. VILLA ABECIA),estado nutricional en menores de 5 anos,clasificacion e,2003-04-01,7,2,7,2,9
70706,CAMIRI,estado nutricional en menores de 5 anos,clasificacion e,2003-04-01,49,22,49,22,71
30701,CAPINOTA,estado nutricional en menores de 5 anos,clasificacion e,2003-04-01,11,8,11,8,19
20302,CAQUIAVIRI,estado nutricional en menores de 5 anos,clasificacion e,2003-04-01,3,7,3,7,10
40102,CARACOLLO,estado nutricional en menores de 5 anos,clasificacion e,2003-04-01,13,15,13,15,28
22001,CARANAVI,estado nutricional en menores de 5 anos,clasificacion e,2003-04-01,40,25,40,25,65
60302,CARAPARI,estado nutricional en menores de 5 anos,clasificacion e,2003-04-01,5,2,5,2,7
50702,CARIPUYO,estado nutricional en menores de 5 anos,clasificacion e,2003-04-01,17,33,17,33,50
40201,CHALLAPATA,estado nutricional en menores de 5 anos,clasificacion e,2003-04-01,21,31,21,31,52
50302,CHAQUI,estado nutricional en menores de 5 anos,clasificacion e,2003-04-01,21,5,21,5,26
70702,CHARAGUA,estado nutricional en menores de 5 anos,clasificacion e,2003-04-01,29,25,29,25,54
20305,CHARAÃ‘A,estado nutricional en menores de 5 anos,clasificacion e,2003-04-01,2,4,2,4,6
50202,CHAYANTA,estado nutricional en menores de 5 anos,clasificacion e,2003-04-01,17,12,17,12,29
31204,CHIMORE,estado nutricional en menores de 5 anos,clasificacion e,2003-04-01,6,1,6,1,7
40903,CHIPAYA,estado nutricional en menores de 5 anos,clasificacion e,2003-04-01,0,2,0,2,2
40302,CHOQUE COTA,estado nutricional en menores de 5 anos,clasificacion e,2003-04-01,1,2,1,2,3
21101,CHULUMANI (V. DE LA LIBERTAD),estado nutricional en menores de 5 anos,clasificacion e,2003-04-01,2,1,2,1,3
20501,CHUMA,estado nutricional en menores de 5 anos,clasificacion e,2003-04-01,12,7,12,7,19
30801,CLIZA,estado nutricional en menores de 5 anos,clasificacion e,2003-04-01,5,11,5,11,16
90101,COBIJA,estado nutricional en menores de 5 anos,clasificacion e,2003-04-01,7,8,7,8,15
30101,COCHABAMBA,estado nutricional en menores de 5 anos,clasificacion e,2003-04-01,143,67,143,67,210
30905,COLCAPIRHUA,estado nutricional en menores de 5 anos,clasificacion e,2003-04-01,0,1,0,1,1
50901,"COLCHA ""K""",estado nutricional en menores de 5 anos,clasificacion e,2003-04-01,8,7,8,7,15
31002,COLOMI,estado nutricional en menores de 5 anos,clasificacion e,2003-04-01,16,7,16,7,23
50401,COLQUECHACA,estado nutricional en menores de 5 anos,clasificacion e,2003-04-01,51,23,51,23,74
21306,COLQUENCHA,estado nutricional en menores de 5 anos,clasificacion e,2003-04-01,7,9,7,9,16
21004,COLQUIRI,estado nutricional en menores de 5 anos,clasificacion e,2003-04-01,24,21,24,21,45
20304,COMANCHE,estado nutricional en menores de 5 anos,clasificacion e,2003-04-01,1,1,1,1,2
71301,COMARAPA,estado nutricional en menores de 5 anos,clasificacion e,2003-04-01,22,17,22,17,39
20605,COMBAYA,estado nutricional en menores de 5 anos,clasificacion e,2003-04-01,6,3,6,3,9
71101,CONCEPCION,estado nutricional en menores de 5 anos,clasificacion e,2003-04-01,7,7,7,7,14
21701,COPACABANA,estado nutricional en menores de 5 anos,clasificacion e,2003-04-01,2,5,2,5,7
21402,CORIPATA,estado nutricional en menores de 5 anos,clasificacion e,2003-04-01,1,2,1,2,3
20301,CORO CORO,estado nutricional en menores de 5 anos,clasificacion e,2003-04-01,9,8,9,8,17
21401,COROICO,estado nutricional en menores de 5 anos,clasificacion e,2003-04-01,3,0,3,0,3
40301,CORQUE,estado nutricional en menores de 5 anos,clasificacion e,2003-04-01,8,8,8,8,16
50601,COTAGAITA,estado nutricional en menores de 5 anos,clasificacion e,2003-04-01,35,23,35,23,58
70102,COTOCA,estado nutricional en menores de 5 anos,clasificacion e,2003-04-01,10,4,10,4,14
31405,CUCHUMUELA (V. G. VILLARROEL),estado nutricional en menores de 5 anos,clasificacion e,2003-04-01,1,1,1,1,2
70704,CUEVO,estado nutricional en menores de 5 anos,clasificacion e,2003-04-01,1,1,1,1,2
10902,CULPINA,estado nutricional en menores de 5 anos,clasificacion e,2003-04-01,70,43,70,43,113
40401,CURAHUARA DE CARANGAS,estado nutricional en menores de 5 anos,clasificacion e,2003-04-01,4,2,4,2,6
21602,CURVA,estado nutricional en menores de 5 anos,clasificacion e,2003-04-01,1,1,1,1,2
20804,DESAGUADERO,estado nutricional en menores de 5 anos,clasificacion e,2003-04-01,2,2,2,2,4
20105,EL ALTO,estado nutricional en menores de 5 anos,clasificacion e,2003-04-01,575,307,575,307,882
40103,EL CHORO,estado nutricional en menores de 5 anos,clasificacion e,2003-04-01,1,0,1,0,1
71503,EL PUENTE(STC),estado nutricional en menores de 5 anos,clasificacion e,2003-04-01,2,20,2,20,22
60502,EL PUENTE(TJA),estado nutricional en menores de 5 anos,clasificacion e,2003-04-01,12,28,12,28,40
70105,EL TORNO,estado nutricional en menores de 5 anos,clasificacion e,2003-04-01,5,5,5,5,10
10405,EL VILLAR,estado nutricional en menores de 5 anos,clasificacion e,2003-04-01,15,27,15,27,42
60601,ENTRE RIOS,estado nutricional en menores de 5 anos,clasificacion e,2003-04-01,6,9,6,9,15
41101,EUCALIPTUS,estado nutricional en menores de 5 anos,clasificacion e,2003-04-01,6,2,6,2,8
80402,EXALTACION,estado nutricional en menores de 5 anos,clasificacion e,2003-04-01,4,5,4,5,9
90203,FILADELFIA,estado nutricional en menores de 5 anos,clasificacion e,2003-04-01,0,2,0,2,2
71002,GENERAL SAAVEDRA,estado nutricional en menores de 5 anos,clasificacion e,2003-04-01,24,16,24,16,40
21601,GRAL. J.J. PEREZ (CHARAZANI),estado nutricional en menores de 5 anos,clasificacion e,2003-04-01,4,13,4,13,17
20602,GUANAY,estado nutricional en menores de 5 anos,clasificacion e,2003-04-01,10,5,10,5,15
20802,GUAQUI,estado nutricional en menores de 5 anos,clasificacion e,2003-04-01,2,1,2,1,3
80202,GUAYARAMERIN,estado nutricional en menores de 5 anos,clasificacion e,2003-04-01,49,20,49,20,69
70705,GUTIERREZ,estado nutricional en menores de 5 anos,clasificacion e,2003-04-01,39,50,39,50,89
10502,HUACARETA,estado nutricional en menores de 5 anos,clasificacion e,2003-04-01,13,22,13,22,35
11002,HUACAYA (VILLA DE HUACAYA),estado nutricional en menores de 5 anos,clasificacion e,2003-04-01,2,4,2,4,6
40501,HUACHACALLA,estado nutricional en menores de 5 anos,clasificacion e,2003-04-01,0,1,0,1,1
40701,HUANUNI,estado nutricional en menores de 5 anos,clasificacion e,2003-04-01,14,11,14,11,25
80803,HUARACAJE,estado nutricional en menores de 5 anos,clasificacion e,2003-04-01,0,2,0,2,2
41601,HUAYLLAMARCA,estado nutricional en menores de 5 anos,clasificacion e,2003-04-01,3,0,3,0,3
21005,ICHOCA,estado nutricional en menores de 5 anos,clasificacion e,2003-04-01,8,2,8,2,10
10304,ICLA,estado nutricional en menores de 5 anos,clasificacion e,2003-04-01,44,55,44,55,99
10703,INCAHUASI,estado nutricional en menores de 5 anos,clasificacion e,2003-04-01,65,40,65,40,105
21001,INQUISIVI,estado nutricional en menores de 5 anos,clasificacion e,2003-04-01,35,12,35,12,47
21102,IRUPANA (VILLA DE LANZA),estado nutricional en menores de 5 anos,clasificacion e,2003-04-01,6,20,6,20,26
21501,IXIAMAS,estado nutricional en menores de 5 anos,clasificacion e,2003-04-01,7,6,7,6,13
21105,LA ASUNTA,estado nutricional en menores de 5 anos,clasificacion e,2003-04-01,5,9,5,9,14
70104,LA GUARDIA,estado nutricional en menores de 5 anos,clasificacion e,2003-04-01,20,8,20,8,28
20101,LA PAZ,estado nutricional en menores de 5 anos,clasificacion e,2003-04-01,311,207,311,207,518
70701,LAGUNILLAS,estado nutricional en menores de 5 anos,clasificacion e,2003-04-01,6,7,6,7,13
21202,LAJA,estado nutricional en menores de 5 anos,clasificacion e,2003-04-01,4,2,4,2,6
10903,LAS CARRERAS,estado nutricional en menores de 5 anos,clasificacion e,2003-04-01,16,10,16,10,26
50203,LLALLAGUA,estado nutricional en menores de 5 anos,clasificacion e,2003-04-01,0,77,0,77,77
51401,LLICA,estado nutricional en menores de 5 anos,clasificacion e,2003-04-01,1,4,1,4,5
80601,LORETO,estado nutricional en menores de 5 anos,clasificacion e,2003-04-01,0,1,0,1,1
20901,LURIBAY,estado nutricional en menores de 5 anos,clasificacion e,2003-04-01,24,19,24,19,43
40702,MACHACAMARCA,estado nutricional en menores de 5 anos,clasificacion e,2003-04-01,14,3,14,3,17
11003,MACHARETI,estado nutricional en menores de 5 anos,clasificacion e,2003-04-01,6,24,6,24,30
80801,MAGDALENA,estado nutricional en menores de 5 anos,clasificacion e,2003-04-01,2,6,2,6,8
70903,MAIRANA,estado nutricional en menores de 5 anos,clasificacion e,2003-04-01,10,5,10,5,15
20103,MECAPACA,estado nutricional en menores de 5 anos,clasificacion e,2003-04-01,2,0,2,0,2
71003,MINEROS,estado nutricional en menores de 5 anos,clasificacion e,2003-04-01,38,12,38,12,50
31301,MIZQUE,estado nutricional en menores de 5 anos,clasificacion e,2003-04-01,27,10,27,10,37
20402,MOCOMOCO,estado nutricional en menores de 5 anos,clasificacion e,2003-04-01,13,7,13,7,20
51002,MOJINETE,estado nutricional en menores de 5 anos,clasificacion e,2003-04-01,0,2,0,2,2
10303,MOJOCOYA,estado nutricional en menores de 5 anos,clasificacion e,2003-04-01,14,14,14,14,28
10501,MONTEAGUDO,estado nutricional en menores de 5 anos,clasificacion e,2003-04-01,31,29,31,29,60
71001,MONTERO,estado nutricional en menores de 5 anos,clasificacion e,2003-04-01,78,44,78,44,122
70803,MORO MORO,estado nutricional en menores de 5 anos,clasificacion e,2003-04-01,6,9,6,9,15
30302,MOROCHATA,estado nutricional en menores de 5 anos,clasificacion e,2003-04-01,44,37,44,37,81
90401,NACEBE (SANTA ROSA DEL ABUNA),estado nutricional en menores de 5 anos,clasificacion e,2003-04-01,2,3,2,3,5
90501,NUEVO MANOA (NUEVA ESPERANZA),estado nutricional en menores de 5 anos,clasificacion e,2003-04-01,0,1,0,1,1
50404,OCURI,estado nutricional en menores de 5 anos,clasificacion e,2003-04-01,28,24,28,24,52
70202,OKINAWA,estado nutricional en menores de 5 anos,clasificacion e,2003-04-01,5,1,5,1,6
30203,OMEREQUE,estado nutricional en menores de 5 anos,clasificacion e,2003-04-01,1,2,1,2,3
40101,ORURO,estado nutricional en menores de 5 anos,clasificacion e,2003-04-01,119,102,119,102,221
60201,PADCAYA,estado nutricional en menores de 5 anos,clasificacion e,2003-04-01,13,5,13,5,18
10401,PADILLA,estado nutricional en menores de 5 anos,clasificacion e,2003-04-01,47,52,47,52,99
70502,PAILON,estado nutricional en menores de 5 anos,clasificacion e,2003-04-01,8,3,8,3,11
20102,PALCA,estado nutricional en menores de 5 anos,clasificacion e,2003-04-01,11,11,11,11,22
21104,PALOS BLANCOS,estado nutricional en menores de 5 anos,clasificacion e,2003-04-01,23,13,23,13,36
40802,PAMPA AULLAGAS,estado nutricional en menores de 5 anos,clasificacion e,2003-04-01,7,7,7,7,14
70902,PAMPA GRANDE,estado nutricional en menores de 5 anos,clasificacion e,2003-04-01,3,5,3,5,8
21802,PAPEL PAMPA,estado nutricional en menores de 5 anos,clasificacion e,2003-04-01,3,1,3,1,4
30202,PASORAPA,estado nutricional en menores de 5 anos,clasificacion e,2003-04-01,8,8,8,8,16
21305,PATACAMAYA,estado nutricional en menores de 5 anos,clasificacion e,2003-04-01,20,20,20,20,40
40602,PAZÃ‘A,estado nutricional en menores de 5 anos,clasificacion e,2003-04-01,2,2,2,2,4
20702,PELECHUCO,estado nutricional en menores de 5 anos,clasificacion e,2003-04-01,3,7,3,7,10
50403,POCOATA,estado nutricional en menores de 5 anos,clasificacion e,2003-04-01,36,42,36,42,78
31203,POCONA,estado nutricional en menores de 5 anos,clasificacion e,2003-04-01,15,6,15,6,21
31202,POJO (CBBA),estado nutricional en menores de 5 anos,clasificacion e,2003-04-01,45,31,45,31,76
40601,POOPO,estado nutricional en menores de 5 anos,clasificacion e,2003-04-01,2,2,2,2,4
51203,PORCO,estado nutricional en menores de 5 anos,clasificacion e,2003-04-01,6,1,6,1,7
10103,POROMA,estado nutricional en menores de 5 anos,clasificacion e,2003-04-01,59,64,59,64,123
70601,PORTACHUELO,estado nutricional en menores de 5 anos,clasificacion e,2003-04-01,14,1,14,1,15
90102,PORVENIR,estado nutricional en menores de 5 anos,clasificacion e,2003-04-01,2,2,2,2,4
70804,POSTRER VALLE,estado nutricional en menores de 5 anos,clasificacion e,2003-04-01,2,2,2,2,4
50101,POTOSI,estado nutricional en menores de 5 anos,clasificacion e,2003-04-01,175,104,175,104,279
10302,PRESTO,estado nutricional en menores de 5 anos,clasificacion e,2003-04-01,19,26,19,26,45
70805,PUCARA,estado nutricional en menores de 5 anos,clasificacion e,2003-04-01,0,1,0,1,1
21201,PUCARANI,estado nutricional en menores de 5 anos,clasificacion e,2003-04-01,11,4,11,4,15
20401,PUERTO ACOSTA,estado nutricional en menores de 5 anos,clasificacion e,2003-04-01,21,10,21,10,31
20403,PUERTO CARABUCO,estado nutricional en menores de 5 anos,clasificacion e,2003-04-01,3,14,3,14,17
90301,PUERTO GONZALO MORENO,estado nutricional en menores de 5 anos,clasificacion e,2003-04-01,25,27,25,27,52
21204,PUERTO PEREZ,estado nutricional en menores de 5 anos,clasificacion e,2003-04-01,1,1,1,1,2
71402,PUERTO QUIJARRO,estado nutricional en menores de 5 anos,clasificacion e,2003-04-01,6,1,6,1,7
90201,PUERTO RICO,estado nutricional en menores de 5 anos,clasificacion e,2003-04-01,0,11,0,11,11
71401,PUERTO SUAREZ,estado nutricional en menores de 5 anos,clasificacion e,2003-04-01,15,3,15,3,18
31205,PUERTO VILLARROEL,estado nutricional en menores de 5 anos,clasificacion e,2003-04-01,81,49,81,49,130
51101,PUNA,estado nutricional en menores de 5 anos,clasificacion e,2003-04-01,30,18,30,18,48
31401,PUNATA,estado nutricional en menores de 5 anos,clasificacion e,2003-04-01,58,5,58,5,63
20604,QUIABAYA,estado nutricional en menores de 5 anos,clasificacion e,2003-04-01,7,8,7,8,15
30901,QUILLACOLLO,estado nutricional en menores de 5 anos,clasificacion e,2003-04-01,24,33,24,33,57
21002,QUIME,estado nutricional en menores de 5 anos,clasificacion e,2003-04-01,26,17,26,17,43
70904,QUIRUSILLAS,estado nutricional en menores de 5 anos,clasificacion e,2003-04-01,1,2,1,2,3
50402,RAVELO,estado nutricional en menores de 5 anos,clasificacion e,2003-04-01,73,63,73,63,136
80301,REYES,estado nutricional en menores de 5 anos,clasificacion e,2003-04-01,2,3,2,3,5
80201,RIBERALTA,estado nutricional en menores de 5 anos,clasificacion e,2003-04-01,89,69,89,69,158
70503,ROBORE,estado nutricional en menores de 5 anos,clasificacion e,2003-04-01,15,8,15,8,23
80304,RURRENABAQUE,estado nutricional en menores de 5 anos,clasificacion e,2003-04-01,2,0,2,0,2
40901,SABAYA,estado nutricional en menores de 5 anos,clasificacion e,2003-04-01,0,5,0,5,5
31001,SACABA,estado nutricional en menores de 5 anos,clasificacion e,2003-04-01,59,31,59,31,90
30404,SACABAMBA,estado nutricional en menores de 5 anos,clasificacion e,2003-04-01,2,6,2,6,8
50701,SACACA,estado nutricional en menores de 5 anos,clasificacion e,2003-04-01,78,99,78,99,177
71302,SAIPINA,estado nutricional en menores de 5 anos,clasificacion e,2003-04-01,7,5,7,5,12
40801,SALINAS DE GARCI MENDOZA,estado nutricional en menores de 5 anos,clasificacion e,2003-04-01,2,4,2,4,6
70901,SAMAIPATA,estado nutricional en menores de 5 anos,clasificacion e,2003-04-01,5,2,5,2,7
51601,SAN AGUSTIN,estado nutricional en menores de 5 anos,clasificacion e,2003-04-01,0,2,0,2,2
80602,SAN ANDRES,estado nutricional en menores de 5 anos,clasificacion e,2003-04-01,6,10,6,10,16
51003,SAN ANTONIO DE ESMORUCO,estado nutricional en menores de 5 anos,clasificacion e,2003-04-01,0,3,0,3,3
71105,SAN ANTONIO DE LOMERIO,estado nutricional en menores de 5 anos,clasificacion e,2003-04-01,35,45,35,45,80
31403,SAN BENITO,estado nutricional en menores de 5 anos,clasificacion e,2003-04-01,3,12,3,12,15
80302,SAN BORJA,estado nutricional en menores de 5 anos,clasificacion e,2003-04-01,48,40,48,40,88
21502,SAN BUENA VENTURA,estado nutricional en menores de 5 anos,clasificacion e,2003-04-01,13,8,13,8,21
70402,SAN CARLOS,estado nutricional en menores de 5 anos,clasificacion e,2003-04-01,14,14,14,14,28
80501,SAN IGNACIO,estado nutricional en menores de 5 anos,clasificacion e,2003-04-01,23,25,23,25,48
70301,SAN IGNACIO DE VELASCO,estado nutricional en menores de 5 anos,clasificacion e,2003-04-01,58,28,58,28,86
80102,SAN JAVIER(BNI),estado nutricional en menores de 5 anos,clasificacion e,2003-04-01,3,2,3,2,5
71102,SAN JAVIER(STC),estado nutricional en menores de 5 anos,clasificacion e,2003-04-01,6,10,6,10,16
80701,SAN JOAQUIN,estado nutricional en menores de 5 anos,clasificacion e,2003-04-01,1,0,1,0,1
70501,SAN JOSE DE CHIQUITOS,estado nutricional en menores de 5 anos,clasificacion e,2003-04-01,9,3,9,3,12
71104,SAN JULIAN,estado nutricional en menores de 5 anos,clasificacion e,2003-04-01,45,35,45,35,80
60501,SAN LORENZO(TJA),estado nutricional en menores de 5 anos,clasificacion e,2003-04-01,21,32,21,32,53
10702,SAN LUCAS,estado nutricional en menores de 5 anos,clasificacion e,2003-04-01,129,95,129,95,224
70302,SAN MIGUEL DE VELASCO,estado nutricional en menores de 5 anos,clasificacion e,2003-04-01,14,18,14,18,32
51001,SAN PABLO DE LIPEZ,estado nutricional en menores de 5 anos,clasificacion e,2003-04-01,4,2,4,2,6
50501,SAN PEDRO DE BUENA VISTA,estado nutricional en menores de 5 anos,clasificacion e,2003-04-01,39,73,39,73,112
21801,SAN PEDRO DE CURAHUARA,estado nutricional en menores de 5 anos,clasificacion e,2003-04-01,0,3,0,3,3
70303,SAN RAFAEL,estado nutricional en menores de 5 anos,clasificacion e,2003-04-01,15,8,15,8,23
80401,SANTA ANA,estado nutricional en menores de 5 anos,clasificacion e,2003-04-01,0,3,0,3,3
70101,SANTA CRUZ DE LA SIERRA,estado nutricional en menores de 5 anos,clasificacion e,2003-04-01,220,134,220,134,354
80303,SANTA ROSA,estado nutricional en menores de 5 anos,clasificacion e,2003-04-01,3,0,3,0,3
70602,SANTA ROSA DEL SARA,estado nutricional en menores de 5 anos,clasificacion e,2003-04-01,3,3,3,3,6
20308,SANTIAGO DE CALLAPA,estado nutricional en menores de 5 anos,clasificacion e,2003-04-01,1,5,1,5,6
41401,SANTIAGO DE HUARI,estado nutricional en menores de 5 anos,clasificacion e,2003-04-01,0,4,0,4,4
21901,SANTIAGO DE MACHACA,estado nutricional en menores de 5 anos,clasificacion e,2003-04-01,1,1,1,1,2
30702,SANTIVAÃ‘ES,estado nutricional en menores de 5 anos,clasificacion e,2003-04-01,6,5,6,5,11
40202,SANTUARIO DE QUILLACAS,estado nutricional en menores de 5 anos,clasificacion e,2003-04-01,0,2,0,2,2
20902,SAPAHAQUI,estado nutricional en menores de 5 anos,clasificacion e,2003-04-01,7,14,7,14,21
90303,SENA,estado nutricional en menores de 5 anos,clasificacion e,2003-04-01,0,5,0,5,5
21301,SICA SICA (VILLA AROMA),estado nutricional en menores de 5 anos,clasificacion e,2003-04-01,24,11,24,11,35
30703,SICAYA,estado nutricional en menores de 5 anos,clasificacion e,2003-04-01,8,6,8,6,14
30902,SIPE SIPE,estado nutricional en menores de 5 anos,clasificacion e,2003-04-01,32,19,32,19,51
10403,SOPACHUY,estado nutricional en menores de 5 anos,clasificacion e,2003-04-01,18,26,18,26,44
20601,SORATA,estado nutricional en menores de 5 anos,clasificacion e,2003-04-01,9,6,9,6,15
10101,SUCRE,estado nutricional en menores de 5 anos,clasificacion e,2003-04-01,163,136,163,136,299
31404,TACACHI,estado nutricional en menores de 5 anos,clasificacion e,2003-04-01,1,0,1,0,1
20603,TACACOMA,estado nutricional en menores de 5 anos,clasificacion e,2003-04-01,5,0,5,0,5
50303,TACOBAMBA,estado nutricional en menores de 5 anos,clasificacion e,2003-04-01,23,20,23,20,43
30602,TACOPAYA,estado nutricional en menores de 5 anos,clasificacion e,2003-04-01,50,36,50,36,86
51402,TAHUA,estado nutricional en menores de 5 anos,clasificacion e,2003-04-01,0,1,0,1,1
31101,TAPACARI,estado nutricional en menores de 5 anos,clasificacion e,2003-04-01,29,40,29,40,69
10601,TARABUCO,estado nutricional en menores de 5 anos,clasificacion e,2003-04-01,124,122,124,122,246
30401,TARATA,estado nutricional en menores de 5 anos,clasificacion e,2003-04-01,6,17,6,17,23
60101,TARIJA,estado nutricional en menores de 5 anos,clasificacion e,2003-04-01,35,36,35,36,71
10202,TARVITA,estado nutricional en menores de 5 anos,clasificacion e,2003-04-01,38,52,38,52,90
20803,TIAWANACU,estado nutricional en menores de 5 anos,clasificacion e,2003-04-01,3,1,3,1,4
50102,TINGUIPAYA,estado nutricional en menores de 5 anos,clasificacion e,2003-04-01,4,6,4,6,10
20606,TIPUANI,estado nutricional en menores de 5 anos,clasificacion e,2003-04-01,3,3,3,3,6
30903,TIQUIPAYA,estado nutricional en menores de 5 anos,clasificacion e,2003-04-01,10,9,10,9,19
31601,TIRAQUE (CBBA),estado nutricional en menores de 5 anos,clasificacion e,2003-04-01,39,45,39,45,84
30802,TOCO,estado nutricional en menores de 5 anos,clasificacion e,2003-04-01,2,1,2,1,3
30803,TOLATA,estado nutricional en menores de 5 anos,clasificacion e,2003-04-01,0,1,0,1,1
41001,TOLEDO,estado nutricional en menores de 5 anos,clasificacion e,2003-04-01,2,1,2,1,3
51202,TOMAVE,estado nutricional en menores de 5 anos,clasificacion e,2003-04-01,19,22,19,22,41
10402,TOMINA,estado nutricional en menores de 5 anos,clasificacion e,2003-04-01,51,57,51,57,108
50502,TORO TORO,estado nutricional en menores de 5 anos,clasificacion e,2003-04-01,22,19,22,19,41
31201,TOTORA(CBBA),estado nutricional en menores de 5 anos,clasificacion e,2003-04-01,10,8,10,8,18
41301,TOTORA(ORR),estado nutricional en menores de 5 anos,clasificacion e,2003-04-01,2,1,2,1,3
70802,TRIGAL,estado nutricional en menores de 5 anos,clasificacion e,2003-04-01,1,0,1,0,1
80101,TRINIDAD,estado nutricional en menores de 5 anos,clasificacion e,2003-04-01,52,67,52,67,119
50801,TUPIZA,estado nutricional en menores de 5 anos,clasificacion e,2003-04-01,22,70,22,70,92
40402,TURCO,estado nutricional en menores de 5 anos,clasificacion e,2003-04-01,2,1,2,1,3
21302,UMALA,estado nutricional en menores de 5 anos,clasificacion e,2003-04-01,1,4,1,4,5
50201,UNCIA,estado nutricional en menores de 5 anos,clasificacion e,2003-04-01,6,9,6,9,15
60401,URIONDO (A. CONCEPCION),estado nutricional en menores de 5 anos,clasificacion e,2003-04-01,6,6,6,6,12
71502,URUBICHA,estado nutricional en menores de 5 anos,clasificacion e,2003-04-01,37,49,37,49,86
51201,UYUNI,estado nutricional en menores de 5 anos,clasificacion e,2003-04-01,24,23,24,23,47
30502,VACAS,estado nutricional en menores de 5 anos,clasificacion e,2003-04-01,3,4,3,4,7
70801,VALLEGRANDE,estado nutricional en menores de 5 anos,clasificacion e,2003-04-01,14,12,14,12,26
20801,VIACHA,estado nutricional en menores de 5 anos,clasificacion e,2003-04-01,24,10,24,10,34
31302,VILA VILA,estado nutricional en menores de 5 anos,clasificacion e,2003-04-01,4,11,4,11,15
60303,VILLA MONTES,estado nutricional en menores de 5 anos,clasificacion e,2003-04-01,24,17,24,17,41
31402,VILLA RIVERO,estado nutricional en menores de 5 anos,clasificacion e,2003-04-01,3,3,3,3,6
10801,VILLA SERRANO,estado nutricional en menores de 5 anos,clasificacion e,2003-04-01,29,32,29,32,61
31003,VILLA TUNARI,estado nutricional en menores de 5 anos,clasificacion e,2003-04-01,50,31,50,31,81
11001,VILLA VACA GUZMAN (MUYUPAMPA),estado nutricional en menores de 5 anos,clasificacion e,2003-04-01,15,21,15,21,36
51501,VILLAZON,estado nutricional en menores de 5 anos,clasificacion e,2003-04-01,26,33,26,33,59
30904,VINTO,estado nutricional en menores de 5 anos,clasificacion e,2003-04-01,13,10,13,10,23
50602,VITICHI,estado nutricional en menores de 5 anos,clasificacion e,2003-04-01,26,24,26,24,50
70201,WARNES,estado nutricional en menores de 5 anos,clasificacion e,2003-04-01,39,18,39,18,57
20903,YACO,estado nutricional en menores de 5 anos,clasificacion e,2003-04-01,6,13,6,13,19
60301,YACUIBA,estado nutricional en menores de 5 anos,clasificacion e,2003-04-01,27,19,27,19,46
10602,YAMPARAEZ,estado nutricional en menores de 5 anos,clasificacion e,2003-04-01,74,40,74,40,114
21103,YANACACHI,estado nutricional en menores de 5 anos,clasificacion e,2003-04-01,0,2,0,2,2
70403,YAPACANI,estado nutricional en menores de 5 anos,clasificacion e,2003-04-01,68,34,68,34,102
50103,YOCALLA,estado nutricional en menores de 5 anos,clasificacion e,2003-04-01,4,3,4,3,7
10102,YOTALA,estado nutricional en menores de 5 anos,clasificacion e,2003-04-01,17,27,17,27,44
60402,YUNCHARA,estado nutricional en menores de 5 anos,clasificacion e,2003-04-01,10,10,10,10,20
10301,ZUDAÃ‘EZ,estado nutricional en menores de 5 anos,clasificacion e,2003-04-01,25,33,25,33,58
51302,ACACIO,estado nutricional en menores de 5 anos,clasificacion e,2003-05-01,38,43,38,43,81
20201,ACHACACHI,estado nutricional en menores de 5 anos,clasificacion e,2003-05-01,32,16,32,16,48
20104,ACHOCALLA,estado nutricional en menores de 5 anos,clasificacion e,2003-05-01,1,6,1,6,7
30201,AIQUILE,estado nutricional en menores de 5 anos,clasificacion e,2003-05-01,28,38,28,38,66
31303,ALALAY,estado nutricional en menores de 5 anos,clasificacion e,2003-05-01,1,0,1,0,1
10404,ALCALA,estado nutricional en menores de 5 anos,clasificacion e,2003-05-01,10,28,10,28,38
20202,ANCORAIMES,estado nutricional en menores de 5 anos,clasificacion e,2003-05-01,11,22,11,22,33
30402,ANZALDO,estado nutricional en menores de 5 anos,clasificacion e,2003-05-01,3,4,3,4,7
20701,APOLO,estado nutricional en menores de 5 anos,clasificacion e,2003-05-01,1,5,1,5,6
51301,ARAMPAMPA,estado nutricional en menores de 5 anos,clasificacion e,2003-05-01,12,20,12,20,32
30403,ARBIETO,estado nutricional en menores de 5 anos,clasificacion e,2003-05-01,1,0,1,0,1
30601,ARQUE,estado nutricional en menores de 5 anos,clasificacion e,2003-05-01,22,23,22,23,45
50802,ATOCHA,estado nutricional en menores de 5 anos,clasificacion e,2003-05-01,9,56,9,56,65
20503,AUCAPATA,estado nutricional en menores de 5 anos,clasificacion e,2003-05-01,7,6,7,6,13
20502,AYATA,estado nutricional en menores de 5 anos,clasificacion e,2003-05-01,15,9,15,9,24
21303,AYO AYO,estado nutricional en menores de 5 anos,clasificacion e,2003-05-01,3,4,3,4,7
30301,AYOPAYA (V. DE INDEPENDENCIA),estado nutricional en menores de 5 anos,clasificacion e,2003-05-01,18,27,18,27,45
10201,AZURDUY,estado nutricional en menores de 5 anos,clasificacion e,2003-05-01,51,49,51,49,100
21203,BATALLAS,estado nutricional en menores de 5 anos,clasificacion e,2003-05-01,4,10,4,10,14
80802,BAURES,estado nutricional en menores de 5 anos,clasificacion e,2003-05-01,5,7,5,7,12
41202,BELEN DE ANDAMARCA,estado nutricional en menores de 5 anos,clasificacion e,2003-05-01,1,0,1,0,1
50104,BELEN DE URMIRI,estado nutricional en menores de 5 anos,clasificacion e,2003-05-01,2,1,2,1,3
90104,BELLA FLOR,estado nutricional en menores de 5 anos,clasificacion e,2003-05-01,1,4,1,4,5
60202,BERMEJO,estado nutricional en menores de 5 anos,clasificacion e,2003-05-01,3,3,3,3,6
50301,BETANZOS,estado nutricional en menores de 5 anos,clasificacion e,2003-05-01,114,135,114,135,249
31501,BOLIVAR,estado nutricional en menores de 5 anos,clasificacion e,2003-05-01,51,48,51,48,99
90103,BOLPEBRA,estado nutricional en menores de 5 anos,clasificacion e,2003-05-01,1,17,1,17,18
70707,BOYUIBE,estado nutricional en menores de 5 anos,clasificacion e,2003-05-01,3,1,3,1,4
70401,BUENA VISTA,estado nutricional en menores de 5 anos,clasificacion e,2003-05-01,3,8,3,8,11
70703,CABEZAS,estado nutricional en menores de 5 anos,clasificacion e,2003-05-01,9,3,9,3,12
20905,CAIROMA,estado nutricional en menores de 5 anos,clasificacion e,2003-05-01,7,14,7,14,21
51102,"CAIZA ""D""",estado nutricional en menores de 5 anos,clasificacion e,2003-05-01,37,27,37,27,64
21003,CAJUATA,estado nutricional en menores de 5 anos,clasificacion e,2003-05-01,17,15,17,15,32
20303,CALACOTO,estado nutricional en menores de 5 anos,clasificacion e,2003-05-01,2,3,2,3,5
21304,CALAMARCA,estado nutricional en menores de 5 anos,clasificacion e,2003-05-01,44,26,44,26,70
10701,CAMARGO,estado nutricional en menores de 5 anos,clasificacion e,2003-05-01,20,13,20,13,33
10901,CAMATAQUI (C. VILLA ABECIA),estado nutricional en menores de 5 anos,clasificacion e,2003-05-01,7,6,7,6,13
70706,CAMIRI,estado nutricional en menores de 5 anos,clasificacion e,2003-05-01,14,16,14,16,30
30701,CAPINOTA,estado nutricional en menores de 5 anos,clasificacion e,2003-05-01,19,11,19,11,30
20302,CAQUIAVIRI,estado nutricional en menores de 5 anos,clasificacion e,2003-05-01,16,10,16,10,26
40102,CARACOLLO,estado nutricional en menores de 5 anos,clasificacion e,2003-05-01,9,7,9,7,16
22001,CARANAVI,estado nutricional en menores de 5 anos,clasificacion e,2003-05-01,53,35,53,35,88
60302,CARAPARI,estado nutricional en menores de 5 anos,clasificacion e,2003-05-01,7,6,7,6,13
50702,CARIPUYO,estado nutricional en menores de 5 anos,clasificacion e,2003-05-01,34,35,34,35,69
21902,CATACORA,estado nutricional en menores de 5 anos,clasificacion e,2003-05-01,3,0,3,0,3
40201,CHALLAPATA,estado nutricional en menores de 5 anos,clasificacion e,2003-05-01,28,13,28,13,41
50302,CHAQUI,estado nutricional en menores de 5 anos,clasificacion e,2003-05-01,24,17,24,17,41
70702,CHARAGUA,estado nutricional en menores de 5 anos,clasificacion e,2003-05-01,24,24,24,24,48
20305,CHARAÃ‘A,estado nutricional en menores de 5 anos,clasificacion e,2003-05-01,1,0,1,0,1
50202,CHAYANTA,estado nutricional en menores de 5 anos,clasificacion e,2003-05-01,18,29,18,29,47
31204,CHIMORE,estado nutricional en menores de 5 anos,clasificacion e,2003-05-01,3,13,3,13,16
40302,CHOQUE COTA,estado nutricional en menores de 5 anos,clasificacion e,2003-05-01,1,0,1,0,1
21101,CHULUMANI (V. DE LA LIBERTAD),estado nutricional en menores de 5 anos,clasificacion e,2003-05-01,4,1,4,1,5
20501,CHUMA,estado nutricional en menores de 5 anos,clasificacion e,2003-05-01,13,5,13,5,18
30801,CLIZA,estado nutricional en menores de 5 anos,clasificacion e,2003-05-01,5,1,5,1,6
90101,COBIJA,estado nutricional en menores de 5 anos,clasificacion e,2003-05-01,9,11,9,11,20
30101,COCHABAMBA,estado nutricional en menores de 5 anos,clasificacion e,2003-05-01,134,99,134,99,233
30905,COLCAPIRHUA,estado nutricional en menores de 5 anos,clasificacion e,2003-05-01,1,0,1,0,1
50901,"COLCHA ""K""",estado nutricional en menores de 5 anos,clasificacion e,2003-05-01,15,9,15,9,24
31002,COLOMI,estado nutricional en menores de 5 anos,clasificacion e,2003-05-01,15,5,15,5,20
50401,COLQUECHACA,estado nutricional en menores de 5 anos,clasificacion e,2003-05-01,36,17,36,17,53
21306,COLQUENCHA,estado nutricional en menores de 5 anos,clasificacion e,2003-05-01,4,9,4,9,13
21004,COLQUIRI,estado nutricional en menores de 5 anos,clasificacion e,2003-05-01,26,15,26,15,41
20304,COMANCHE,estado nutricional en menores de 5 anos,clasificacion e,2003-05-01,7,1,7,1,8
71301,COMARAPA,estado nutricional en menores de 5 anos,clasificacion e,2003-05-01,15,9,15,9,24
20605,COMBAYA,estado nutricional en menores de 5 anos,clasificacion e,2003-05-01,2,1,2,1,3
71101,CONCEPCION,estado nutricional en menores de 5 anos,clasificacion e,2003-05-01,6,1,6,1,7
21701,COPACABANA,estado nutricional en menores de 5 anos,clasificacion e,2003-05-01,5,3,5,3,8
21402,CORIPATA,estado nutricional en menores de 5 anos,clasificacion e,2003-05-01,2,0,2,0,2
20301,CORO CORO,estado nutricional en menores de 5 anos,clasificacion e,2003-05-01,9,9,9,9,18
21401,COROICO,estado nutricional en menores de 5 anos,clasificacion e,2003-05-01,8,9,8,9,17
40301,CORQUE,estado nutricional en menores de 5 anos,clasificacion e,2003-05-01,6,1,6,1,7
50601,COTAGAITA,estado nutricional en menores de 5 anos,clasificacion e,2003-05-01,58,54,58,54,112
70102,COTOCA,estado nutricional en menores de 5 anos,clasificacion e,2003-05-01,2,1,2,1,3
70704,CUEVO,estado nutricional en menores de 5 anos,clasificacion e,2003-05-01,0,1,0,1,1
10902,CULPINA,estado nutricional en menores de 5 anos,clasificacion e,2003-05-01,50,42,50,42,92
40401,CURAHUARA DE CARANGAS,estado nutricional en menores de 5 anos,clasificacion e,2003-05-01,0,6,0,6,6
21602,CURVA,estado nutricional en menores de 5 anos,clasificacion e,2003-05-01,2,4,2,4,6
20105,EL ALTO,estado nutricional en menores de 5 anos,clasificacion e,2003-05-01,530,322,530,322,852
40103,EL CHORO,estado nutricional en menores de 5 anos,clasificacion e,2003-05-01,0,1,0,1,1
71503,EL PUENTE(STC),estado nutricional en menores de 5 anos,clasificacion e,2003-05-01,0,36,0,36,36
60502,EL PUENTE(TJA),estado nutricional en menores de 5 anos,clasificacion e,2003-05-01,21,36,21,36,57
70105,EL TORNO,estado nutricional en menores de 5 anos,clasificacion e,2003-05-01,6,9,6,9,15
10405,EL VILLAR,estado nutricional en menores de 5 anos,clasificacion e,2003-05-01,20,33,20,33,53
60601,ENTRE RIOS,estado nutricional en menores de 5 anos,clasificacion e,2003-05-01,3,5,3,5,8
41101,EUCALIPTUS,estado nutricional en menores de 5 anos,clasificacion e,2003-05-01,4,0,4,0,4
80402,EXALTACION,estado nutricional en menores de 5 anos,clasificacion e,2003-05-01,0,21,0,21,21
90203,FILADELFIA,estado nutricional en menores de 5 anos,clasificacion e,2003-05-01,2,5,2,5,7
71002,GENERAL SAAVEDRA,estado nutricional en menores de 5 anos,clasificacion e,2003-05-01,26,17,26,17,43
21601,GRAL. J.J. PEREZ (CHARAZANI),estado nutricional en menores de 5 anos,clasificacion e,2003-05-01,8,7,8,7,15
20602,GUANAY,estado nutricional en menores de 5 anos,clasificacion e,2003-05-01,32,54,32,54,86
20802,GUAQUI,estado nutricional en menores de 5 anos,clasificacion e,2003-05-01,2,2,2,2,4
80202,GUAYARAMERIN,estado nutricional en menores de 5 anos,clasificacion e,2003-05-01,31,21,31,21,52
70705,GUTIERREZ,estado nutricional en menores de 5 anos,clasificacion e,2003-05-01,30,31,30,31,61
10502,HUACARETA,estado nutricional en menores de 5 anos,clasificacion e,2003-05-01,25,16,25,16,41
11002,HUACAYA (VILLA DE HUACAYA),estado nutricional en menores de 5 anos,clasificacion e,2003-05-01,4,9,4,9,13
40701,HUANUNI,estado nutricional en menores de 5 anos,clasificacion e,2003-05-01,19,8,19,8,27
80803,HUARACAJE,estado nutricional en menores de 5 anos,clasificacion e,2003-05-01,0,1,0,1,1
41601,HUAYLLAMARCA,estado nutricional en menores de 5 anos,clasificacion e,2003-05-01,1,2,1,2,3
21005,ICHOCA,estado nutricional en menores de 5 anos,clasificacion e,2003-05-01,7,11,7,11,18
10304,ICLA,estado nutricional en menores de 5 anos,clasificacion e,2003-05-01,69,79,69,79,148
10703,INCAHUASI,estado nutricional en menores de 5 anos,clasificacion e,2003-05-01,47,20,47,20,67
21001,INQUISIVI,estado nutricional en menores de 5 anos,clasificacion e,2003-05-01,58,52,58,52,110
21102,IRUPANA (VILLA DE LANZA),estado nutricional en menores de 5 anos,clasificacion e,2003-05-01,11,23,11,23,34
21501,IXIAMAS,estado nutricional en menores de 5 anos,clasificacion e,2003-05-01,4,2,4,2,6
21105,LA ASUNTA,estado nutricional en menores de 5 anos,clasificacion e,2003-05-01,16,21,16,21,37
70104,LA GUARDIA,estado nutricional en menores de 5 anos,clasificacion e,2003-05-01,10,7,10,7,17
20101,LA PAZ,estado nutricional en menores de 5 anos,clasificacion e,2003-05-01,320,190,320,190,510
70701,LAGUNILLAS,estado nutricional en menores de 5 anos,clasificacion e,2003-05-01,10,9,10,9,19
21202,LAJA,estado nutricional en menores de 5 anos,clasificacion e,2003-05-01,3,30,3,30,33
10903,LAS CARRERAS,estado nutricional en menores de 5 anos,clasificacion e,2003-05-01,2,12,2,12,14
21006,LICOMA PAMPA,estado nutricional en menores de 5 anos,clasificacion e,2003-05-01,1,0,1,0,1
50203,LLALLAGUA,estado nutricional en menores de 5 anos,clasificacion e,2003-05-01,0,109,0,109,109
51401,LLICA,estado nutricional en menores de 5 anos,clasificacion e,2003-05-01,1,2,1,2,3
80601,LORETO,estado nutricional en menores de 5 anos,clasificacion e,2003-05-01,4,2,4,2,6
20901,LURIBAY,estado nutricional en menores de 5 anos,clasificacion e,2003-05-01,10,6,10,6,16
40702,MACHACAMARCA,estado nutricional en menores de 5 anos,clasificacion e,2003-05-01,7,1,7,1,8
11003,MACHARETI,estado nutricional en menores de 5 anos,clasificacion e,2003-05-01,12,26,12,26,38
80801,MAGDALENA,estado nutricional en menores de 5 anos,clasificacion e,2003-05-01,3,4,3,4,7
70903,MAIRANA,estado nutricional en menores de 5 anos,clasificacion e,2003-05-01,7,0,7,0,7
20904,MALLA,estado nutricional en menores de 5 anos,clasificacion e,2003-05-01,1,4,1,4,5
20103,MECAPACA,estado nutricional en menores de 5 anos,clasificacion e,2003-05-01,0,3,0,3,3
71003,MINEROS,estado nutricional en menores de 5 anos,clasificacion e,2003-05-01,20,14,20,14,34
31301,MIZQUE,estado nutricional en menores de 5 anos,clasificacion e,2003-05-01,15,35,15,35,50
20402,MOCOMOCO,estado nutricional en menores de 5 anos,clasificacion e,2003-05-01,17,17,17,17,34
10303,MOJOCOYA,estado nutricional en menores de 5 anos,clasificacion e,2003-05-01,23,11,23,11,34
10501,MONTEAGUDO,estado nutricional en menores de 5 anos,clasificacion e,2003-05-01,46,35,46,35,81
71001,MONTERO,estado nutricional en menores de 5 anos,clasificacion e,2003-05-01,71,35,71,35,106
70803,MORO MORO,estado nutricional en menores de 5 anos,clasificacion e,2003-05-01,4,7,4,7,11
30302,MOROCHATA,estado nutricional en menores de 5 anos,clasificacion e,2003-05-01,68,48,68,48,116
90401,NACEBE (SANTA ROSA DEL ABUNA),estado nutricional en menores de 5 anos,clasificacion e,2003-05-01,1,2,1,2,3
20307,NAZACARA DE PACAJES,estado nutricional en menores de 5 anos,clasificacion e,2003-05-01,0,1,0,1,1
50404,OCURI,estado nutricional en menores de 5 anos,clasificacion e,2003-05-01,43,29,43,29,72
30203,OMEREQUE,estado nutricional en menores de 5 anos,clasificacion e,2003-05-01,1,1,1,1,2
40101,ORURO,estado nutricional en menores de 5 anos,clasificacion e,2003-05-01,111,73,111,73,184
60201,PADCAYA,estado nutricional en menores de 5 anos,clasificacion e,2003-05-01,13,11,13,11,24
10401,PADILLA,estado nutricional en menores de 5 anos,clasificacion e,2003-05-01,41,52,41,52,93
70502,PAILON,estado nutricional en menores de 5 anos,clasificacion e,2003-05-01,12,5,12,5,17
20102,PALCA,estado nutricional en menores de 5 anos,clasificacion e,2003-05-01,20,27,20,27,47
21104,PALOS BLANCOS,estado nutricional en menores de 5 anos,clasificacion e,2003-05-01,27,20,27,20,47
40802,PAMPA AULLAGAS,estado nutricional en menores de 5 anos,clasificacion e,2003-05-01,2,3,2,3,5
70902,PAMPA GRANDE,estado nutricional en menores de 5 anos,clasificacion e,2003-05-01,4,3,4,3,7
21802,PAPEL PAMPA,estado nutricional en menores de 5 anos,clasificacion e,2003-05-01,3,4,3,4,7
30202,PASORAPA,estado nutricional en menores de 5 anos,clasificacion e,2003-05-01,8,4,8,4,12
21305,PATACAMAYA,estado nutricional en menores de 5 anos,clasificacion e,2003-05-01,26,8,26,8,34
40602,PAZÃ‘A,estado nutricional en menores de 5 anos,clasificacion e,2003-05-01,4,1,4,1,5
20702,PELECHUCO,estado nutricional en menores de 5 anos,clasificacion e,2003-05-01,8,17,8,17,25
50403,POCOATA,estado nutricional en menores de 5 anos,clasificacion e,2003-05-01,47,65,47,65,112
31203,POCONA,estado nutricional en menores de 5 anos,clasificacion e,2003-05-01,14,4,14,4,18
31202,POJO (CBBA),estado nutricional en menores de 5 anos,clasificacion e,2003-05-01,40,42,40,42,82
40601,POOPO,estado nutricional en menores de 5 anos,clasificacion e,2003-05-01,1,3,1,3,4
51203,PORCO,estado nutricional en menores de 5 anos,clasificacion e,2003-05-01,3,1,3,1,4
10103,POROMA,estado nutricional en menores de 5 anos,clasificacion e,2003-05-01,78,96,78,96,174
70103,PORONGO,estado nutricional en menores de 5 anos,clasificacion e,2003-05-01,7,7,7,7,14
70601,PORTACHUELO,estado nutricional en menores de 5 anos,clasificacion e,2003-05-01,9,9,9,9,18
90102,PORVENIR,estado nutricional en menores de 5 anos,clasificacion e,2003-05-01,1,0,1,0,1
70804,POSTRER VALLE,estado nutricional en menores de 5 anos,clasificacion e,2003-05-01,2,1,2,1,3
50101,POTOSI,estado nutricional en menores de 5 anos,clasificacion e,2003-05-01,175,111,175,111,286
10302,PRESTO,estado nutricional en menores de 5 anos,clasificacion e,2003-05-01,34,39,34,39,73
21201,PUCARANI,estado nutricional en menores de 5 anos,clasificacion e,2003-05-01,11,1,11,1,12
20401,PUERTO ACOSTA,estado nutricional en menores de 5 anos,clasificacion e,2003-05-01,34,25,34,25,59
20403,PUERTO CARABUCO,estado nutricional en menores de 5 anos,clasificacion e,2003-05-01,22,20,22,20,42
90301,PUERTO GONZALO MORENO,estado nutricional en menores de 5 anos,clasificacion e,2003-05-01,4,1,4,1,5
21204,PUERTO PEREZ,estado nutricional en menores de 5 anos,clasificacion e,2003-05-01,0,3,0,3,3
71402,PUERTO QUIJARRO,estado nutricional en menores de 5 anos,clasificacion e,2003-05-01,8,0,8,0,8
90201,PUERTO RICO,estado nutricional en menores de 5 anos,clasificacion e,2003-05-01,2,2,2,2,4
80703,PUERTO SILES,estado nutricional en menores de 5 anos,clasificacion e,2003-05-01,0,2,0,2,2
71401,PUERTO SUAREZ,estado nutricional en menores de 5 anos,clasificacion e,2003-05-01,7,3,7,3,10
31205,PUERTO VILLARROEL,estado nutricional en menores de 5 anos,clasificacion e,2003-05-01,67,39,67,39,106
51101,PUNA,estado nutricional en menores de 5 anos,clasificacion e,2003-05-01,77,103,77,103,180
20604,QUIABAYA,estado nutricional en menores de 5 anos,clasificacion e,2003-05-01,2,9,2,9,11
30901,QUILLACOLLO,estado nutricional en menores de 5 anos,clasificacion e,2003-05-01,29,26,29,26,55
21002,QUIME,estado nutricional en menores de 5 anos,clasificacion e,2003-05-01,18,27,18,27,45
70904,QUIRUSILLAS,estado nutricional en menores de 5 anos,clasificacion e,2003-05-01,0,2,0,2,2
50402,RAVELO,estado nutricional en menores de 5 anos,clasificacion e,2003-05-01,95,69,95,69,164
80301,REYES,estado nutricional en menores de 5 anos,clasificacion e,2003-05-01,18,18,18,18,36
80201,RIBERALTA,estado nutricional en menores de 5 anos,clasificacion e,2003-05-01,76,66,76,66,142
70503,ROBORE,estado nutricional en menores de 5 anos,clasificacion e,2003-05-01,7,7,7,7,14
80304,RURRENABAQUE,estado nutricional en menores de 5 anos,clasificacion e,2003-05-01,10,5,10,5,15
31001,SACABA,estado nutricional en menores de 5 anos,clasificacion e,2003-05-01,71,41,71,41,112
30404,SACABAMBA,estado nutricional en menores de 5 anos,clasificacion e,2003-05-01,4,2,4,2,6
50701,SACACA,estado nutricional en menores de 5 anos,clasificacion e,2003-05-01,92,102,92,102,194
71302,SAIPINA,estado nutricional en menores de 5 anos,clasificacion e,2003-05-01,2,1,2,1,3
40801,SALINAS DE GARCI MENDOZA,estado nutricional en menores de 5 anos,clasificacion e,2003-05-01,3,2,3,2,5
70901,SAMAIPATA,estado nutricional en menores de 5 anos,clasificacion e,2003-05-01,1,0,1,0,1
80602,SAN ANDRES,estado nutricional en menores de 5 anos,clasificacion e,2003-05-01,2,1,2,1,3
51003,SAN ANTONIO DE ESMORUCO,estado nutricional en menores de 5 anos,clasificacion e,2003-05-01,2,4,2,4,6
71105,SAN ANTONIO DE LOMERIO,estado nutricional en menores de 5 anos,clasificacion e,2003-05-01,17,28,17,28,45
80302,SAN BORJA,estado nutricional en menores de 5 anos,clasificacion e,2003-05-01,75,71,75,71,146
21502,SAN BUENA VENTURA,estado nutricional en menores de 5 anos,clasificacion e,2003-05-01,14,5,14,5,19
70402,SAN CARLOS,estado nutricional en menores de 5 anos,clasificacion e,2003-05-01,15,12,15,12,27
80501,SAN IGNACIO,estado nutricional en menores de 5 anos,clasificacion e,2003-05-01,17,16,17,16,33
70301,SAN IGNACIO DE VELASCO,estado nutricional en menores de 5 anos,clasificacion e,2003-05-01,52,57,52,57,109
80102,SAN JAVIER(BNI),estado nutricional en menores de 5 anos,clasificacion e,2003-05-01,0,1,0,1,1
71102,SAN JAVIER(STC),estado nutricional en menores de 5 anos,clasificacion e,2003-05-01,6,4,6,4,10
80701,SAN JOAQUIN,estado nutricional en menores de 5 anos,clasificacion e,2003-05-01,2,0,2,0,2
70501,SAN JOSE DE CHIQUITOS,estado nutricional en menores de 5 anos,clasificacion e,2003-05-01,9,3,9,3,12
71104,SAN JULIAN,estado nutricional en menores de 5 anos,clasificacion e,2003-05-01,66,54,66,54,120
90302,SAN LORENZO(PND),estado nutricional en menores de 5 anos,clasificacion e,2003-05-01,4,0,4,0,4
60501,SAN LORENZO(TJA),estado nutricional en menores de 5 anos,clasificacion e,2003-05-01,8,15,8,15,23
10702,SAN LUCAS,estado nutricional en menores de 5 anos,clasificacion e,2003-05-01,129,119,129,119,248
70302,SAN MIGUEL DE VELASCO,estado nutricional en menores de 5 anos,clasificacion e,2003-05-01,19,21,19,21,40
51001,SAN PABLO DE LIPEZ,estado nutricional en menores de 5 anos,clasificacion e,2003-05-01,3,7,3,7,10
50501,SAN PEDRO DE BUENA VISTA,estado nutricional en menores de 5 anos,clasificacion e,2003-05-01,45,75,45,75,120
21801,SAN PEDRO DE CURAHUARA,estado nutricional en menores de 5 anos,clasificacion e,2003-05-01,0,1,0,1,1
50902,SAN PEDRO DE QUEMES,estado nutricional en menores de 5 anos,clasificacion e,2003-05-01,1,0,1,0,1
21702,SAN PEDRO DE TIQUINA,estado nutricional en menores de 5 anos,clasificacion e,2003-05-01,1,0,1,0,1
70303,SAN RAFAEL,estado nutricional en menores de 5 anos,clasificacion e,2003-05-01,9,10,9,10,19
80702,SAN RAMON,estado nutricional en menores de 5 anos,clasificacion e,2003-05-01,1,0,1,0,1
80702,SAN RAMON,estado nutricional en menores de 5 anos,clasificacion e,2003-05-01,2,1,2,1,3
80401,SANTA ANA,estado nutricional en menores de 5 anos,clasificacion e,2003-05-01,0,4,0,4,4
70101,SANTA CRUZ DE LA SIERRA,estado nutricional en menores de 5 anos,clasificacion e,2003-05-01,69,30,69,30,99
80303,SANTA ROSA,estado nutricional en menores de 5 anos,clasificacion e,2003-05-01,0,3,0,3,3
70602,SANTA ROSA DEL SARA,estado nutricional en menores de 5 anos,clasificacion e,2003-05-01,0,1,0,1,1
20308,SANTIAGO DE CALLAPA,estado nutricional en menores de 5 anos,clasificacion e,2003-05-01,5,10,5,10,15
41401,SANTIAGO DE HUARI,estado nutricional en menores de 5 anos,clasificacion e,2003-05-01,5,2,5,2,7
21901,SANTIAGO DE MACHACA,estado nutricional en menores de 5 anos,clasificacion e,2003-05-01,1,2,1,2,3
30702,SANTIVAÃ‘ES,estado nutricional en menores de 5 anos,clasificacion e,2003-05-01,3,5,3,5,8
40202,SANTUARIO DE QUILLACAS,estado nutricional en menores de 5 anos,clasificacion e,2003-05-01,0,2,0,2,2
20902,SAPAHAQUI,estado nutricional en menores de 5 anos,clasificacion e,2003-05-01,15,9,15,9,24
90303,SENA,estado nutricional en menores de 5 anos,clasificacion e,2003-05-01,2,0,2,0,2
21301,SICA SICA (VILLA AROMA),estado nutricional en menores de 5 anos,clasificacion e,2003-05-01,28,22,28,22,50
30703,SICAYA,estado nutricional en menores de 5 anos,clasificacion e,2003-05-01,6,1,6,1,7
30902,SIPE SIPE,estado nutricional en menores de 5 anos,clasificacion e,2003-05-01,19,10,19,10,29
10403,SOPACHUY,estado nutricional en menores de 5 anos,clasificacion e,2003-05-01,26,28,26,28,54
20601,SORATA,estado nutricional en menores de 5 anos,clasificacion e,2003-05-01,11,15,11,15,26
10101,SUCRE,estado nutricional en menores de 5 anos,clasificacion e,2003-05-01,158,156,158,156,314
20603,TACACOMA,estado nutricional en menores de 5 anos,clasificacion e,2003-05-01,2,2,2,2,4
50303,TACOBAMBA,estado nutricional en menores de 5 anos,clasificacion e,2003-05-01,26,37,26,37,63
30602,TACOPAYA,estado nutricional en menores de 5 anos,clasificacion e,2003-05-01,27,34,27,34,61
51402,TAHUA,estado nutricional en menores de 5 anos,clasificacion e,2003-05-01,0,1,0,1,1
31101,TAPACARI,estado nutricional en menores de 5 anos,clasificacion e,2003-05-01,60,41,60,41,101
10601,TARABUCO,estado nutricional en menores de 5 anos,clasificacion e,2003-05-01,124,115,124,115,239
30401,TARATA,estado nutricional en menores de 5 anos,clasificacion e,2003-05-01,1,134,1,134,135
60101,TARIJA,estado nutricional en menores de 5 anos,clasificacion e,2003-05-01,54,39,54,39,93
10202,TARVITA,estado nutricional en menores de 5 anos,clasificacion e,2003-05-01,40,77,40,77,117
20803,TIAWANACU,estado nutricional en menores de 5 anos,clasificacion e,2003-05-01,14,7,14,7,21
50102,TINGUIPAYA,estado nutricional en menores de 5 anos,clasificacion e,2003-05-01,23,36,23,36,59
20606,TIPUANI,estado nutricional en menores de 5 anos,clasificacion e,2003-05-01,8,3,8,3,11
30903,TIQUIPAYA,estado nutricional en menores de 5 anos,clasificacion e,2003-05-01,20,8,20,8,28
31601,TIRAQUE (CBBA),estado nutricional en menores de 5 anos,clasificacion e,2003-05-01,29,12,29,12,41
21703,TITO YUPANQUI (PARQUIPUJIO),estado nutricional en menores de 5 anos,clasificacion e,2003-05-01,0,2,0,2,2
30802,TOCO,estado nutricional en menores de 5 anos,clasificacion e,2003-05-01,0,5,0,5,5
30803,TOLATA,estado nutricional en menores de 5 anos,clasificacion e,2003-05-01,2,6,2,6,8
41001,TOLEDO,estado nutricional en menores de 5 anos,clasificacion e,2003-05-01,1,0,1,0,1
51202,TOMAVE,estado nutricional en menores de 5 anos,clasificacion e,2003-05-01,22,26,22,26,48
10402,TOMINA,estado nutricional en menores de 5 anos,clasificacion e,2003-05-01,55,63,55,63,118
50502,TORO TORO,estado nutricional en menores de 5 anos,clasificacion e,2003-05-01,49,32,49,32,81
31201,TOTORA(CBBA),estado nutricional en menores de 5 anos,clasificacion e,2003-05-01,17,7,17,7,24
41301,TOTORA(ORR),estado nutricional en menores de 5 anos,clasificacion e,2003-05-01,3,8,3,8,11
70802,TRIGAL,estado nutricional en menores de 5 anos,clasificacion e,2003-05-01,2,0,2,0,2
80101,TRINIDAD,estado nutricional en menores de 5 anos,clasificacion e,2003-05-01,41,33,41,33,74
50801,TUPIZA,estado nutricional en menores de 5 anos,clasificacion e,2003-05-01,21,77,21,77,98
40402,TURCO,estado nutricional en menores de 5 anos,clasificacion e,2003-05-01,1,1,1,1,2
21302,UMALA,estado nutricional en menores de 5 anos,clasificacion e,2003-05-01,1,5,1,5,6
50201,UNCIA,estado nutricional en menores de 5 anos,clasificacion e,2003-05-01,7,5,7,5,12
60401,URIONDO (A. CONCEPCION),estado nutricional en menores de 5 anos,clasificacion e,2003-05-01,2,7,2,7,9
71502,URUBICHA,estado nutricional en menores de 5 anos,clasificacion e,2003-05-01,1,2,1,2,3
51201,UYUNI,estado nutricional en menores de 5 anos,clasificacion e,2003-05-01,14,22,14,22,36
70801,VALLEGRANDE,estado nutricional en menores de 5 anos,clasificacion e,2003-05-01,25,16,25,16,41
20801,VIACHA,estado nutricional en menores de 5 anos,clasificacion e,2003-05-01,30,22,30,22,52
31302,VILA VILA,estado nutricional en menores de 5 anos,clasificacion e,2003-05-01,18,17,18,17,35
60303,VILLA MONTES,estado nutricional en menores de 5 anos,clasificacion e,2003-05-01,20,14,20,14,34
10801,VILLA SERRANO,estado nutricional en menores de 5 anos,clasificacion e,2003-05-01,33,37,33,37,70
31003,VILLA TUNARI,estado nutricional en menores de 5 anos,clasificacion e,2003-05-01,42,41,42,41,83
11001,VILLA VACA GUZMAN (MUYUPAMPA),estado nutricional en menores de 5 anos,clasificacion e,2003-05-01,6,21,6,21,27
51501,VILLAZON,estado nutricional en menores de 5 anos,clasificacion e,2003-05-01,22,31,22,31,53
50602,VITICHI,estado nutricional en menores de 5 anos,clasificacion e,2003-05-01,34,37,34,37,71
20306,WALDO BALLIVIAN,estado nutricional en menores de 5 anos,clasificacion e,2003-05-01,4,1,4,1,5
70201,WARNES,estado nutricional en menores de 5 anos,clasificacion e,2003-05-01,3,0,3,0,3
20903,YACO,estado nutricional en menores de 5 anos,clasificacion e,2003-05-01,2,13,2,13,15
60301,YACUIBA,estado nutricional en menores de 5 anos,clasificacion e,2003-05-01,14,14,14,14,28
10602,YAMPARAEZ,estado nutricional en menores de 5 anos,clasificacion e,2003-05-01,77,53,77,53,130
21103,YANACACHI,estado nutricional en menores de 5 anos,clasificacion e,2003-05-01,0,4,0,4,4
70403,YAPACANI,estado nutricional en menores de 5 anos,clasificacion e,2003-05-01,42,34,42,34,76
50103,YOCALLA,estado nutricional en menores de 5 anos,clasificacion e,2003-05-01,8,8,8,8,16
10102,YOTALA,estado nutricional en menores de 5 anos,clasificacion e,2003-05-01,28,38,28,38,66
60402,YUNCHARA,estado nutricional en menores de 5 anos,clasificacion e,2003-05-01,6,6,6,6,12
10301,ZUDAÃ‘EZ,estado nutricional en menores de 5 anos,clasificacion e,2003-05-01,24,35,24,35,59
51302,ACACIO,estado nutricional en menores de 5 anos,clasificacion e,2003-06-01,42,39,42,39,81
20201,ACHACACHI,estado nutricional en menores de 5 anos,clasificacion e,2003-06-01,12,18,12,18,30
20104,ACHOCALLA,estado nutricional en menores de 5 anos,clasificacion e,2003-06-01,2,5,2,5,7
30201,AIQUILE,estado nutricional en menores de 5 anos,clasificacion e,2003-06-01,8,11,8,11,19
31303,ALALAY,estado nutricional en menores de 5 anos,clasificacion e,2003-06-01,5,1,5,1,6
10404,ALCALA,estado nutricional en menores de 5 anos,clasificacion e,2003-06-01,7,27,7,27,34
20202,ANCORAIMES,estado nutricional en menores de 5 anos,clasificacion e,2003-06-01,11,14,11,14,25
41201,ANDAMARCA,estado nutricional en menores de 5 anos,clasificacion e,2003-06-01,1,2,1,2,3
30402,ANZALDO,estado nutricional en menores de 5 anos,clasificacion e,2003-06-01,9,18,9,18,27
20701,APOLO,estado nutricional en menores de 5 anos,clasificacion e,2003-06-01,9,11,9,11,20
51301,ARAMPAMPA,estado nutricional en menores de 5 anos,clasificacion e,2003-06-01,23,33,23,33,56
30501,ARANI,estado nutricional en menores de 5 anos,clasificacion e,2003-06-01,3,6,3,6,9
30403,ARBIETO,estado nutricional en menores de 5 anos,clasificacion e,2003-06-01,2,0,2,0,2
30601,ARQUE,estado nutricional en menores de 5 anos,clasificacion e,2003-06-01,19,13,19,13,32
71501,ASCENCION DE GUARAYOS,estado nutricional en menores de 5 anos,clasificacion e,2003-06-01,67,64,67,64,131
50802,ATOCHA,estado nutricional en menores de 5 anos,clasificacion e,2003-06-01,3,38,3,38,41
20503,AUCAPATA,estado nutricional en menores de 5 anos,clasificacion e,2003-06-01,10,4,10,4,14
20502,AYATA,estado nutricional en menores de 5 anos,clasificacion e,2003-06-01,9,9,9,9,18
21303,AYO AYO,estado nutricional en menores de 5 anos,clasificacion e,2003-06-01,4,4,4,4,8
30301,AYOPAYA (V. DE INDEPENDENCIA),estado nutricional en menores de 5 anos,clasificacion e,2003-06-01,22,22,22,22,44
10201,AZURDUY,estado nutricional en menores de 5 anos,clasificacion e,2003-06-01,46,55,46,55,101
21203,BATALLAS,estado nutricional en menores de 5 anos,clasificacion e,2003-06-01,4,9,4,9,13
80802,BAURES,estado nutricional en menores de 5 anos,clasificacion e,2003-06-01,3,2,3,2,5
41202,BELEN DE ANDAMARCA,estado nutricional en menores de 5 anos,clasificacion e,2003-06-01,1,2,1,2,3
50104,BELEN DE URMIRI,estado nutricional en menores de 5 anos,clasificacion e,2003-06-01,2,2,2,2,4
90104,BELLA FLOR,estado nutricional en menores de 5 anos,clasificacion e,2003-06-01,8,8,8,8,16
60202,BERMEJO,estado nutricional en menores de 5 anos,clasificacion e,2003-06-01,4,2,4,2,6
50301,BETANZOS,estado nutricional en menores de 5 anos,clasificacion e,2003-06-01,113,93,113,93,206
31501,BOLIVAR,estado nutricional en menores de 5 anos,clasificacion e,2003-06-01,27,30,27,30,57
90103,BOLPEBRA,estado nutricional en menores de 5 anos,clasificacion e,2003-06-01,0,4,0,4,4
70707,BOYUIBE,estado nutricional en menores de 5 anos,clasificacion e,2003-06-01,1,1,1,1,2
70401,BUENA VISTA,estado nutricional en menores de 5 anos,clasificacion e,2003-06-01,8,8,8,8,16
70703,CABEZAS,estado nutricional en menores de 5 anos,clasificacion e,2003-06-01,6,9,6,9,15
20905,CAIROMA,estado nutricional en menores de 5 anos,clasificacion e,2003-06-01,25,34,25,34,59
51102,"CAIZA ""D""",estado nutricional en menores de 5 anos,clasificacion e,2003-06-01,28,15,28,15,43
21003,CAJUATA,estado nutricional en menores de 5 anos,clasificacion e,2003-06-01,5,18,5,18,23
20303,CALACOTO,estado nutricional en menores de 5 anos,clasificacion e,2003-06-01,2,2,2,2,4
21304,CALAMARCA,estado nutricional en menores de 5 anos,clasificacion e,2003-06-01,50,26,50,26,76
10701,CAMARGO,estado nutricional en menores de 5 anos,clasificacion e,2003-06-01,16,17,16,17,33
10901,CAMATAQUI (C. VILLA ABECIA),estado nutricional en menores de 5 anos,clasificacion e,2003-06-01,0,4,0,4,4
70706,CAMIRI,estado nutricional en menores de 5 anos,clasificacion e,2003-06-01,21,15,21,15,36
30701,CAPINOTA,estado nutricional en menores de 5 anos,clasificacion e,2003-06-01,15,12,15,12,27
20302,CAQUIAVIRI,estado nutricional en menores de 5 anos,clasificacion e,2003-06-01,8,7,8,7,15
40102,CARACOLLO,estado nutricional en menores de 5 anos,clasificacion e,2003-06-01,13,7,13,7,20
22001,CARANAVI,estado nutricional en menores de 5 anos,clasificacion e,2003-06-01,23,27,23,27,50
60302,CARAPARI,estado nutricional en menores de 5 anos,clasificacion e,2003-06-01,7,2,7,2,9
50702,CARIPUYO,estado nutricional en menores de 5 anos,clasificacion e,2003-06-01,30,31,30,31,61
40201,CHALLAPATA,estado nutricional en menores de 5 anos,clasificacion e,2003-06-01,36,25,36,25,61
50302,CHAQUI,estado nutricional en menores de 5 anos,clasificacion e,2003-06-01,16,3,16,3,19
70702,CHARAGUA,estado nutricional en menores de 5 anos,clasificacion e,2003-06-01,18,10,18,10,28
50202,CHAYANTA,estado nutricional en menores de 5 anos,clasificacion e,2003-06-01,18,24,18,24,42
31204,CHIMORE,estado nutricional en menores de 5 anos,clasificacion e,2003-06-01,3,1,3,1,4
40302,CHOQUE COTA,estado nutricional en menores de 5 anos,clasificacion e,2003-06-01,2,1,2,1,3
21101,CHULUMANI (V. DE LA LIBERTAD),estado nutricional en menores de 5 anos,clasificacion e,2003-06-01,0,2,0,2,2
20501,CHUMA,estado nutricional en menores de 5 anos,clasificacion e,2003-06-01,16,12,16,12,28
30801,CLIZA,estado nutricional en menores de 5 anos,clasificacion e,2003-06-01,3,3,3,3,6
90101,COBIJA,estado nutricional en menores de 5 anos,clasificacion e,2003-06-01,7,10,7,10,17
30101,COCHABAMBA,estado nutricional en menores de 5 anos,clasificacion e,2003-06-01,128,77,128,77,205
40902,COIPASA,estado nutricional en menores de 5 anos,clasificacion e,2003-06-01,1,0,1,0,1
30905,COLCAPIRHUA,estado nutricional en menores de 5 anos,clasificacion e,2003-06-01,4,1,4,1,5
50901,"COLCHA ""K""",estado nutricional en menores de 5 anos,clasificacion e,2003-06-01,6,8,6,8,14
31002,COLOMI,estado nutricional en menores de 5 anos,clasificacion e,2003-06-01,18,17,18,17,35
50401,COLQUECHACA,estado nutricional en menores de 5 anos,clasificacion e,2003-06-01,70,41,70,41,111
21306,COLQUENCHA,estado nutricional en menores de 5 anos,clasificacion e,2003-06-01,2,6,2,6,8
21004,COLQUIRI,estado nutricional en menores de 5 anos,clasificacion e,2003-06-01,14,18,14,18,32
20304,COMANCHE,estado nutricional en menores de 5 anos,clasificacion e,2003-06-01,1,0,1,0,1
71301,COMARAPA,estado nutricional en menores de 5 anos,clasificacion e,2003-06-01,10,7,10,7,17
20605,COMBAYA,estado nutricional en menores de 5 anos,clasificacion e,2003-06-01,4,2,4,2,6
21701,COPACABANA,estado nutricional en menores de 5 anos,clasificacion e,2003-06-01,10,3,10,3,13
21402,CORIPATA,estado nutricional en menores de 5 anos,clasificacion e,2003-06-01,1,1,1,1,2
20301,CORO CORO,estado nutricional en menores de 5 anos,clasificacion e,2003-06-01,6,7,6,7,13
21401,COROICO,estado nutricional en menores de 5 anos,clasificacion e,2003-06-01,5,7,5,7,12
40301,CORQUE,estado nutricional en menores de 5 anos,clasificacion e,2003-06-01,0,4,0,4,4
50601,COTAGAITA,estado nutricional en menores de 5 anos,clasificacion e,2003-06-01,68,55,68,55,123
70102,COTOCA,estado nutricional en menores de 5 anos,clasificacion e,2003-06-01,1,2,1,2,3
31405,CUCHUMUELA (V. G. VILLARROEL),estado nutricional en menores de 5 anos,clasificacion e,2003-06-01,3,1,3,1,4
70704,CUEVO,estado nutricional en menores de 5 anos,clasificacion e,2003-06-01,1,4,1,4,5
10902,CULPINA,estado nutricional en menores de 5 anos,clasificacion e,2003-06-01,59,47,59,47,106
40401,CURAHUARA DE CARANGAS,estado nutricional en menores de 5 anos,clasificacion e,2003-06-01,0,7,0,7,7
21602,CURVA,estado nutricional en menores de 5 anos,clasificacion e,2003-06-01,1,2,1,2,3
20804,DESAGUADERO,estado nutricional en menores de 5 anos,clasificacion e,2003-06-01,3,3,3,3,6
20105,EL ALTO,estado nutricional en menores de 5 anos,clasificacion e,2003-06-01,434,285,434,285,719
40103,EL CHORO,estado nutricional en menores de 5 anos,clasificacion e,2003-06-01,1,0,1,0,1
71503,EL PUENTE(STC),estado nutricional en menores de 5 anos,clasificacion e,2003-06-01,6,19,6,19,25
60502,EL PUENTE(TJA),estado nutricional en menores de 5 anos,clasificacion e,2003-06-01,9,13,9,13,22
70105,EL TORNO,estado nutricional en menores de 5 anos,clasificacion e,2003-06-01,6,6,6,6,12
10405,EL VILLAR,estado nutricional en menores de 5 anos,clasificacion e,2003-06-01,25,24,25,24,49
60601,ENTRE RIOS,estado nutricional en menores de 5 anos,clasificacion e,2003-06-01,10,13,10,13,23
41101,EUCALIPTUS,estado nutricional en menores de 5 anos,clasificacion e,2003-06-01,5,2,5,2,7
80402,EXALTACION,estado nutricional en menores de 5 anos,clasificacion e,2003-06-01,0,8,0,8,8
90203,FILADELFIA,estado nutricional en menores de 5 anos,clasificacion e,2003-06-01,3,1,3,1,4
71002,GENERAL SAAVEDRA,estado nutricional en menores de 5 anos,clasificacion e,2003-06-01,27,17,27,17,44
21601,GRAL. J.J. PEREZ (CHARAZANI),estado nutricional en menores de 5 anos,clasificacion e,2003-06-01,8,18,8,18,26
20602,GUANAY,estado nutricional en menores de 5 anos,clasificacion e,2003-06-01,38,26,38,26,64
20802,GUAQUI,estado nutricional en menores de 5 anos,clasificacion e,2003-06-01,3,0,3,0,3
80202,GUAYARAMERIN,estado nutricional en menores de 5 anos,clasificacion e,2003-06-01,44,26,44,26,70
70705,GUTIERREZ,estado nutricional en menores de 5 anos,clasificacion e,2003-06-01,22,44,22,44,66
10502,HUACARETA,estado nutricional en menores de 5 anos,clasificacion e,2003-06-01,10,8,10,8,18
11002,HUACAYA (VILLA DE HUACAYA),estado nutricional en menores de 5 anos,clasificacion e,2003-06-01,1,2,1,2,3
40501,HUACHACALLA,estado nutricional en menores de 5 anos,clasificacion e,2003-06-01,1,0,1,0,1
40701,HUANUNI,estado nutricional en menores de 5 anos,clasificacion e,2003-06-01,27,9,27,9,36
80803,HUARACAJE,estado nutricional en menores de 5 anos,clasificacion e,2003-06-01,4,1,4,1,5
41601,HUAYLLAMARCA,estado nutricional en menores de 5 anos,clasificacion e,2003-06-01,1,0,1,0,1
21005,ICHOCA,estado nutricional en menores de 5 anos,clasificacion e,2003-06-01,2,3,2,3,5
10304,ICLA,estado nutricional en menores de 5 anos,clasificacion e,2003-06-01,44,62,44,62,106
10703,INCAHUASI,estado nutricional en menores de 5 anos,clasificacion e,2003-06-01,41,24,41,24,65
21001,INQUISIVI,estado nutricional en menores de 5 anos,clasificacion e,2003-06-01,30,35,30,35,65
21102,IRUPANA (VILLA DE LANZA),estado nutricional en menores de 5 anos,clasificacion e,2003-06-01,5,11,5,11,16
21501,IXIAMAS,estado nutricional en menores de 5 anos,clasificacion e,2003-06-01,7,3,7,3,10
21105,LA ASUNTA,estado nutricional en menores de 5 anos,clasificacion e,2003-06-01,17,15,17,15,32
70104,LA GUARDIA,estado nutricional en menores de 5 anos,clasificacion e,2003-06-01,14,6,14,6,20
20101,LA PAZ,estado nutricional en menores de 5 anos,clasificacion e,2003-06-01,262,162,262,162,424
70701,LAGUNILLAS,estado nutricional en menores de 5 anos,clasificacion e,2003-06-01,7,4,7,4,11
21202,LAJA,estado nutricional en menores de 5 anos,clasificacion e,2003-06-01,4,3,4,3,7
10903,LAS CARRERAS,estado nutricional en menores de 5 anos,clasificacion e,2003-06-01,3,8,3,8,11
21006,LICOMA PAMPA,estado nutricional en menores de 5 anos,clasificacion e,2003-06-01,0,3,0,3,3
50203,LLALLAGUA,estado nutricional en menores de 5 anos,clasificacion e,2003-06-01,7,80,7,80,87
51401,LLICA,estado nutricional en menores de 5 anos,clasificacion e,2003-06-01,1,1,1,1,2
80601,LORETO,estado nutricional en menores de 5 anos,clasificacion e,2003-06-01,1,0,1,0,1
20901,LURIBAY,estado nutricional en menores de 5 anos,clasificacion e,2003-06-01,31,19,31,19,50
40702,MACHACAMARCA,estado nutricional en menores de 5 anos,clasificacion e,2003-06-01,4,2,4,2,6
11003,MACHARETI,estado nutricional en menores de 5 anos,clasificacion e,2003-06-01,6,15,6,15,21
80801,MAGDALENA,estado nutricional en menores de 5 anos,clasificacion e,2003-06-01,5,4,5,4,9
70903,MAIRANA,estado nutricional en menores de 5 anos,clasificacion e,2003-06-01,4,2,4,2,6
20904,MALLA,estado nutricional en menores de 5 anos,clasificacion e,2003-06-01,4,6,4,6,10
20103,MECAPACA,estado nutricional en menores de 5 anos,clasificacion e,2003-06-01,2,9,2,9,11
71003,MINEROS,estado nutricional en menores de 5 anos,clasificacion e,2003-06-01,40,24,40,24,64
31301,MIZQUE,estado nutricional en menores de 5 anos,clasificacion e,2003-06-01,7,5,7,5,12
20402,MOCOMOCO,estado nutricional en menores de 5 anos,clasificacion e,2003-06-01,11,6,11,6,17
10303,MOJOCOYA,estado nutricional en menores de 5 anos,clasificacion e,2003-06-01,12,9,12,9,21
10501,MONTEAGUDO,estado nutricional en menores de 5 anos,clasificacion e,2003-06-01,24,22,24,22,46
71001,MONTERO,estado nutricional en menores de 5 anos,clasificacion e,2003-06-01,65,38,65,38,103
70803,MORO MORO,estado nutricional en menores de 5 anos,clasificacion e,2003-06-01,2,4,2,4,6
30302,MOROCHATA,estado nutricional en menores de 5 anos,clasificacion e,2003-06-01,29,27,29,27,56
90401,NACEBE (SANTA ROSA DEL ABUNA),estado nutricional en menores de 5 anos,clasificacion e,2003-06-01,2,2,2,2,4
50404,OCURI,estado nutricional en menores de 5 anos,clasificacion e,2003-06-01,18,24,18,24,42
30203,OMEREQUE,estado nutricional en menores de 5 anos,clasificacion e,2003-06-01,5,5,5,5,10
40101,ORURO,estado nutricional en menores de 5 anos,clasificacion e,2003-06-01,110,108,110,108,218
60201,PADCAYA,estado nutricional en menores de 5 anos,clasificacion e,2003-06-01,18,19,18,19,37
10401,PADILLA,estado nutricional en menores de 5 anos,clasificacion e,2003-06-01,43,46,43,46,89
70502,PAILON,estado nutricional en menores de 5 anos,clasificacion e,2003-06-01,8,3,8,3,11
20102,PALCA,estado nutricional en menores de 5 anos,clasificacion e,2003-06-01,8,8,8,8,16
21104,PALOS BLANCOS,estado nutricional en menores de 5 anos,clasificacion e,2003-06-01,28,21,28,21,49
40802,PAMPA AULLAGAS,estado nutricional en menores de 5 anos,clasificacion e,2003-06-01,2,3,2,3,5
70902,PAMPA GRANDE,estado nutricional en menores de 5 anos,clasificacion e,2003-06-01,6,2,6,2,8
21802,PAPEL PAMPA,estado nutricional en menores de 5 anos,clasificacion e,2003-06-01,0,1,0,1,1
30202,PASORAPA,estado nutricional en menores de 5 anos,clasificacion e,2003-06-01,6,3,6,3,9
21305,PATACAMAYA,estado nutricional en menores de 5 anos,clasificacion e,2003-06-01,62,32,62,32,94
40602,PAZÃ‘A,estado nutricional en menores de 5 anos,clasificacion e,2003-06-01,3,5,3,5,8
20702,PELECHUCO,estado nutricional en menores de 5 anos,clasificacion e,2003-06-01,5,8,5,8,13
50403,POCOATA,estado nutricional en menores de 5 anos,clasificacion e,2003-06-01,36,34,36,34,70
31203,POCONA,estado nutricional en menores de 5 anos,clasificacion e,2003-06-01,7,7,7,7,14
31202,POJO (CBBA),estado nutricional en menores de 5 anos,clasificacion e,2003-06-01,25,19,25,19,44
40601,POOPO,estado nutricional en menores de 5 anos,clasificacion e,2003-06-01,0,3,0,3,3
51203,PORCO,estado nutricional en menores de 5 anos,clasificacion e,2003-06-01,2,7,2,7,9
10103,POROMA,estado nutricional en menores de 5 anos,clasificacion e,2003-06-01,74,98,74,98,172
70103,PORONGO,estado nutricional en menores de 5 anos,clasificacion e,2003-06-01,2,1,2,1,3
70601,PORTACHUELO,estado nutricional en menores de 5 anos,clasificacion e,2003-06-01,10,6,10,6,16
90102,PORVENIR,estado nutricional en menores de 5 anos,clasificacion e,2003-06-01,3,0,3,0,3
70804,POSTRER VALLE,estado nutricional en menores de 5 anos,clasificacion e,2003-06-01,1,1,1,1,2
50101,POTOSI,estado nutricional en menores de 5 anos,clasificacion e,2003-06-01,176,123,176,123,299
10302,PRESTO,estado nutricional en menores de 5 anos,clasificacion e,2003-06-01,30,28,30,28,58
21201,PUCARANI,estado nutricional en menores de 5 anos,clasificacion e,2003-06-01,17,15,17,15,32
20401,PUERTO ACOSTA,estado nutricional en menores de 5 anos,clasificacion e,2003-06-01,9,5,9,5,14
20403,PUERTO CARABUCO,estado nutricional en menores de 5 anos,clasificacion e,2003-06-01,8,12,8,12,20
90301,PUERTO GONZALO MORENO,estado nutricional en menores de 5 anos,clasificacion e,2003-06-01,3,3,3,3,6
21204,PUERTO PEREZ,estado nutricional en menores de 5 anos,clasificacion e,2003-06-01,0,1,0,1,1
71402,PUERTO QUIJARRO,estado nutricional en menores de 5 anos,clasificacion e,2003-06-01,9,3,9,3,12
90201,PUERTO RICO,estado nutricional en menores de 5 anos,clasificacion e,2003-06-01,1,2,1,2,3
80703,PUERTO SILES,estado nutricional en menores de 5 anos,clasificacion e,2003-06-01,8,8,8,8,16
71401,PUERTO SUAREZ,estado nutricional en menores de 5 anos,clasificacion e,2003-06-01,8,1,8,1,9
31205,PUERTO VILLARROEL,estado nutricional en menores de 5 anos,clasificacion e,2003-06-01,36,38,36,38,74
51101,PUNA,estado nutricional en menores de 5 anos,clasificacion e,2003-06-01,17,23,17,23,40
31401,PUNATA,estado nutricional en menores de 5 anos,clasificacion e,2003-06-01,9,2,9,2,11
20604,QUIABAYA,estado nutricional en menores de 5 anos,clasificacion e,2003-06-01,6,11,6,11,17
30901,QUILLACOLLO,estado nutricional en menores de 5 anos,clasificacion e,2003-06-01,38,21,38,21,59
21002,QUIME,estado nutricional en menores de 5 anos,clasificacion e,2003-06-01,40,17,40,17,57
50402,RAVELO,estado nutricional en menores de 5 anos,clasificacion e,2003-06-01,97,84,97,84,181
80301,REYES,estado nutricional en menores de 5 anos,clasificacion e,2003-06-01,0,6,0,6,6
80201,RIBERALTA,estado nutricional en menores de 5 anos,clasificacion e,2003-06-01,135,96,135,96,231
70503,ROBORE,estado nutricional en menores de 5 anos,clasificacion e,2003-06-01,9,5,9,5,14
80304,RURRENABAQUE,estado nutricional en menores de 5 anos,clasificacion e,2003-06-01,7,6,7,6,13
31001,SACABA,estado nutricional en menores de 5 anos,clasificacion e,2003-06-01,33,7,33,7,40
30404,SACABAMBA,estado nutricional en menores de 5 anos,clasificacion e,2003-06-01,3,5,3,5,8
50701,SACACA,estado nutricional en menores de 5 anos,clasificacion e,2003-06-01,109,125,109,125,234
71302,SAIPINA,estado nutricional en menores de 5 anos,clasificacion e,2003-06-01,6,5,6,5,11
40801,SALINAS DE GARCI MENDOZA,estado nutricional en menores de 5 anos,clasificacion e,2003-06-01,3,2,3,2,5
70901,SAMAIPATA,estado nutricional en menores de 5 anos,clasificacion e,2003-06-01,5,2,5,2,7
80602,SAN ANDRES,estado nutricional en menores de 5 anos,clasificacion e,2003-06-01,2,1,2,1,3
71105,SAN ANTONIO DE LOMERIO,estado nutricional en menores de 5 anos,clasificacion e,2003-06-01,28,46,28,46,74
31403,SAN BENITO,estado nutricional en menores de 5 anos,clasificacion e,2003-06-01,4,2,4,2,6
80302,SAN BORJA,estado nutricional en menores de 5 anos,clasificacion e,2003-06-01,40,40,40,40,80
21502,SAN BUENA VENTURA,estado nutricional en menores de 5 anos,clasificacion e,2003-06-01,12,5,12,5,17
70402,SAN CARLOS,estado nutricional en menores de 5 anos,clasificacion e,2003-06-01,18,17,18,17,35
80501,SAN IGNACIO,estado nutricional en menores de 5 anos,clasificacion e,2003-06-01,28,15,28,15,43
70301,SAN IGNACIO DE VELASCO,estado nutricional en menores de 5 anos,clasificacion e,2003-06-01,48,33,48,33,81
80102,SAN JAVIER(BNI),estado nutricional en menores de 5 anos,clasificacion e,2003-06-01,0,1,0,1,1
71102,SAN JAVIER(STC),estado nutricional en menores de 5 anos,clasificacion e,2003-06-01,4,5,4,5,9
80701,SAN JOAQUIN,estado nutricional en menores de 5 anos,clasificacion e,2003-06-01,2,1,2,1,3
70501,SAN JOSE DE CHIQUITOS,estado nutricional en menores de 5 anos,clasificacion e,2003-06-01,12,3,12,3,15
71104,SAN JULIAN,estado nutricional en menores de 5 anos,clasificacion e,2003-06-01,35,39,35,39,74
60501,SAN LORENZO(TJA),estado nutricional en menores de 5 anos,clasificacion e,2003-06-01,8,20,8,20,28
10702,SAN LUCAS,estado nutricional en menores de 5 anos,clasificacion e,2003-06-01,111,80,111,80,191
71201,SAN MATIAS,estado nutricional en menores de 5 anos,clasificacion e,2003-06-01,18,11,18,11,29
70302,SAN MIGUEL DE VELASCO,estado nutricional en menores de 5 anos,clasificacion e,2003-06-01,10,9,10,9,19
51001,SAN PABLO DE LIPEZ,estado nutricional en menores de 5 anos,clasificacion e,2003-06-01,0,1,0,1,1
50501,SAN PEDRO DE BUENA VISTA,estado nutricional en menores de 5 anos,clasificacion e,2003-06-01,60,81,60,81,141
21801,SAN PEDRO DE CURAHUARA,estado nutricional en menores de 5 anos,clasificacion e,2003-06-01,1,6,1,6,7
50902,SAN PEDRO DE QUEMES,estado nutricional en menores de 5 anos,clasificacion e,2003-06-01,0,1,0,1,1
70303,SAN RAFAEL,estado nutricional en menores de 5 anos,clasificacion e,2003-06-01,8,12,8,12,20
70101,SANTA CRUZ DE LA SIERRA,estado nutricional en menores de 5 anos,clasificacion e,2003-06-01,152,63,152,63,215
70602,SANTA ROSA DEL SARA,estado nutricional en menores de 5 anos,clasificacion e,2003-06-01,1,1,1,1,2
20308,SANTIAGO DE CALLAPA,estado nutricional en menores de 5 anos,clasificacion e,2003-06-01,3,6,3,6,9
41401,SANTIAGO DE HUARI,estado nutricional en menores de 5 anos,clasificacion e,2003-06-01,6,7,6,7,13
21901,SANTIAGO DE MACHACA,estado nutricional en menores de 5 anos,clasificacion e,2003-06-01,1,0,1,0,1
30702,SANTIVAÃ‘ES,estado nutricional en menores de 5 anos,clasificacion e,2003-06-01,15,10,15,10,25
40202,SANTUARIO DE QUILLACAS,estado nutricional en menores de 5 anos,clasificacion e,2003-06-01,2,2,2,2,4
20902,SAPAHAQUI,estado nutricional en menores de 5 anos,clasificacion e,2003-06-01,6,14,6,14,20
90303,SENA,estado nutricional en menores de 5 anos,clasificacion e,2003-06-01,1,0,1,0,1
21301,SICA SICA (VILLA AROMA),estado nutricional en menores de 5 anos,clasificacion e,2003-06-01,39,18,39,18,57
30703,SICAYA,estado nutricional en menores de 5 anos,clasificacion e,2003-06-01,5,0,5,0,5
30902,SIPE SIPE,estado nutricional en menores de 5 anos,clasificacion e,2003-06-01,41,24,41,24,65
10403,SOPACHUY,estado nutricional en menores de 5 anos,clasificacion e,2003-06-01,31,40,31,40,71
20601,SORATA,estado nutricional en menores de 5 anos,clasificacion e,2003-06-01,6,19,6,19,25
10101,SUCRE,estado nutricional en menores de 5 anos,clasificacion e,2003-06-01,155,116,155,116,271
20603,TACACOMA,estado nutricional en menores de 5 anos,clasificacion e,2003-06-01,5,7,5,7,12
50303,TACOBAMBA,estado nutricional en menores de 5 anos,clasificacion e,2003-06-01,26,27,26,27,53
30602,TACOPAYA,estado nutricional en menores de 5 anos,clasificacion e,2003-06-01,26,31,26,31,57
31101,TAPACARI,estado nutricional en menores de 5 anos,clasificacion e,2003-06-01,31,30,31,30,61
10601,TARABUCO,estado nutricional en menores de 5 anos,clasificacion e,2003-06-01,137,154,137,154,291
30401,TARATA,estado nutricional en menores de 5 anos,clasificacion e,2003-06-01,13,4,13,4,17
60101,TARIJA,estado nutricional en menores de 5 anos,clasificacion e,2003-06-01,50,56,50,56,106
10202,TARVITA,estado nutricional en menores de 5 anos,clasificacion e,2003-06-01,32,41,32,41,73
20803,TIAWANACU,estado nutricional en menores de 5 anos,clasificacion e,2003-06-01,6,5,6,5,11
50102,TINGUIPAYA,estado nutricional en menores de 5 anos,clasificacion e,2003-06-01,33,64,33,64,97
20606,TIPUANI,estado nutricional en menores de 5 anos,clasificacion e,2003-06-01,7,2,7,2,9
30903,TIQUIPAYA,estado nutricional en menores de 5 anos,clasificacion e,2003-06-01,19,5,19,5,24
31601,TIRAQUE (CBBA),estado nutricional en menores de 5 anos,clasificacion e,2003-06-01,52,68,52,68,120
21703,TITO YUPANQUI (PARQUIPUJIO),estado nutricional en menores de 5 anos,clasificacion e,2003-06-01,0,1,0,1,1
30802,TOCO,estado nutricional en menores de 5 anos,clasificacion e,2003-06-01,0,1,0,1,1
51202,TOMAVE,estado nutricional en menores de 5 anos,clasificacion e,2003-06-01,24,31,24,31,55
10402,TOMINA,estado nutricional en menores de 5 anos,clasificacion e,2003-06-01,52,53,52,53,105
50502,TORO TORO,estado nutricional en menores de 5 anos,clasificacion e,2003-06-01,39,21,39,21,60
31201,TOTORA(CBBA),estado nutricional en menores de 5 anos,clasificacion e,2003-06-01,14,6,14,6,20
41301,TOTORA(ORR),estado nutricional en menores de 5 anos,clasificacion e,2003-06-01,2,6,2,6,8
70802,TRIGAL,estado nutricional en menores de 5 anos,clasificacion e,2003-06-01,0,1,0,1,1
80101,TRINIDAD,estado nutricional en menores de 5 anos,clasificacion e,2003-06-01,47,39,47,39,86
50801,TUPIZA,estado nutricional en menores de 5 anos,clasificacion e,2003-06-01,20,33,20,33,53
40402,TURCO,estado nutricional en menores de 5 anos,clasificacion e,2003-06-01,2,2,2,2,4
21302,UMALA,estado nutricional en menores de 5 anos,clasificacion e,2003-06-01,1,0,1,0,1
50201,UNCIA,estado nutricional en menores de 5 anos,clasificacion e,2003-06-01,5,3,5,3,8
60401,URIONDO (A. CONCEPCION),estado nutricional en menores de 5 anos,clasificacion e,2003-06-01,6,5,6,5,11
71502,URUBICHA,estado nutricional en menores de 5 anos,clasificacion e,2003-06-01,27,26,27,26,53
51201,UYUNI,estado nutricional en menores de 5 anos,clasificacion e,2003-06-01,16,18,16,18,34
30502,VACAS,estado nutricional en menores de 5 anos,clasificacion e,2003-06-01,11,12,11,12,23
70801,VALLEGRANDE,estado nutricional en menores de 5 anos,clasificacion e,2003-06-01,11,19,11,19,30
20801,VIACHA,estado nutricional en menores de 5 anos,clasificacion e,2003-06-01,25,14,25,14,39
31302,VILA VILA,estado nutricional en menores de 5 anos,clasificacion e,2003-06-01,6,12,6,12,18
60303,VILLA MONTES,estado nutricional en menores de 5 anos,clasificacion e,2003-06-01,10,6,10,6,16
31402,VILLA RIVERO,estado nutricional en menores de 5 anos,clasificacion e,2003-06-01,8,3,8,3,11
10801,VILLA SERRANO,estado nutricional en menores de 5 anos,clasificacion e,2003-06-01,27,35,27,35,62
31003,VILLA TUNARI,estado nutricional en menores de 5 anos,clasificacion e,2003-06-01,40,27,40,27,67
11001,VILLA VACA GUZMAN (MUYUPAMPA),estado nutricional en menores de 5 anos,clasificacion e,2003-06-01,9,6,9,6,15
51501,VILLAZON,estado nutricional en menores de 5 anos,clasificacion e,2003-06-01,35,24,35,24,59
30904,VINTO,estado nutricional en menores de 5 anos,clasificacion e,2003-06-01,2,0,2,0,2
50602,VITICHI,estado nutricional en menores de 5 anos,clasificacion e,2003-06-01,28,38,28,38,66
20903,YACO,estado nutricional en menores de 5 anos,clasificacion e,2003-06-01,9,10,9,10,19
60301,YACUIBA,estado nutricional en menores de 5 anos,clasificacion e,2003-06-01,11,14,11,14,25
10602,YAMPARAEZ,estado nutricional en menores de 5 anos,clasificacion e,2003-06-01,83,51,83,51,134
21103,YANACACHI,estado nutricional en menores de 5 anos,clasificacion e,2003-06-01,1,1,1,1,2
70403,YAPACANI,estado nutricional en menores de 5 anos,clasificacion e,2003-06-01,22,42,22,42,64
50103,YOCALLA,estado nutricional en menores de 5 anos,clasificacion e,2003-06-01,3,5,3,5,8
10102,YOTALA,estado nutricional en menores de 5 anos,clasificacion e,2003-06-01,29,35,29,35,64
60402,YUNCHARA,estado nutricional en menores de 5 anos,clasificacion e,2003-06-01,4,5,4,5,9
10301,ZUDAÃ‘EZ,estado nutricional en menores de 5 anos,clasificacion e,2003-06-01,22,19,22,19,41
51302,ACACIO,estado nutricional en menores de 5 anos,clasificacion e,2003-07-01,32,38,32,38,70
20201,ACHACACHI,estado nutricional en menores de 5 anos,clasificacion e,2003-07-01,13,12,13,12,25
20104,ACHOCALLA,estado nutricional en menores de 5 anos,clasificacion e,2003-07-01,1,5,1,5,6
30201,AIQUILE,estado nutricional en menores de 5 anos,clasificacion e,2003-07-01,15,8,15,8,23
31303,ALALAY,estado nutricional en menores de 5 anos,clasificacion e,2003-07-01,1,7,1,7,8
10404,ALCALA,estado nutricional en menores de 5 anos,clasificacion e,2003-07-01,9,20,9,20,29
20202,ANCORAIMES,estado nutricional en menores de 5 anos,clasificacion e,2003-07-01,4,14,4,14,18
41201,ANDAMARCA,estado nutricional en menores de 5 anos,clasificacion e,2003-07-01,1,1,1,1,2
30402,ANZALDO,estado nutricional en menores de 5 anos,clasificacion e,2003-07-01,6,7,6,7,13
20701,APOLO,estado nutricional en menores de 5 anos,clasificacion e,2003-07-01,7,7,7,7,14
51301,ARAMPAMPA,estado nutricional en menores de 5 anos,clasificacion e,2003-07-01,8,17,8,17,25
30501,ARANI,estado nutricional en menores de 5 anos,clasificacion e,2003-07-01,6,12,6,12,18
30403,ARBIETO,estado nutricional en menores de 5 anos,clasificacion e,2003-07-01,1,2,1,2,3
30601,ARQUE,estado nutricional en menores de 5 anos,clasificacion e,2003-07-01,25,42,25,42,67
71501,ASCENCION DE GUARAYOS,estado nutricional en menores de 5 anos,clasificacion e,2003-07-01,0,2,0,2,2
50802,ATOCHA,estado nutricional en menores de 5 anos,clasificacion e,2003-07-01,3,62,3,62,65
20503,AUCAPATA,estado nutricional en menores de 5 anos,clasificacion e,2003-07-01,3,2,3,2,5
20502,AYATA,estado nutricional en menores de 5 anos,clasificacion e,2003-07-01,12,8,12,8,20
21303,AYO AYO,estado nutricional en menores de 5 anos,clasificacion e,2003-07-01,1,0,1,0,1
30301,AYOPAYA (V. DE INDEPENDENCIA),estado nutricional en menores de 5 anos,clasificacion e,2003-07-01,25,10,25,10,35
10201,AZURDUY,estado nutricional en menores de 5 anos,clasificacion e,2003-07-01,44,37,44,37,81
21203,BATALLAS,estado nutricional en menores de 5 anos,clasificacion e,2003-07-01,1,3,1,3,4
80802,BAURES,estado nutricional en menores de 5 anos,clasificacion e,2003-07-01,3,6,3,6,9
50104,BELEN DE URMIRI,estado nutricional en menores de 5 anos,clasificacion e,2003-07-01,3,0,3,0,3
90104,BELLA FLOR,estado nutricional en menores de 5 anos,clasificacion e,2003-07-01,7,7,7,7,14
60202,BERMEJO,estado nutricional en menores de 5 anos,clasificacion e,2003-07-01,7,11,7,11,18
50301,BETANZOS,estado nutricional en menores de 5 anos,clasificacion e,2003-07-01,84,72,84,72,156
31501,BOLIVAR,estado nutricional en menores de 5 anos,clasificacion e,2003-07-01,34,23,34,23,57
90103,BOLPEBRA,estado nutricional en menores de 5 anos,clasificacion e,2003-07-01,2,2,2,2,4
70707,BOYUIBE,estado nutricional en menores de 5 anos,clasificacion e,2003-07-01,1,2,1,2,3
70401,BUENA VISTA,estado nutricional en menores de 5 anos,clasificacion e,2003-07-01,3,12,3,12,15
70703,CABEZAS,estado nutricional en menores de 5 anos,clasificacion e,2003-07-01,2,1,2,1,3
20905,CAIROMA,estado nutricional en menores de 5 anos,clasificacion e,2003-07-01,16,20,16,20,36
51102,"CAIZA ""D""",estado nutricional en menores de 5 anos,clasificacion e,2003-07-01,29,13,29,13,42
21003,CAJUATA,estado nutricional en menores de 5 anos,clasificacion e,2003-07-01,4,9,4,9,13
20303,CALACOTO,estado nutricional en menores de 5 anos,clasificacion e,2003-07-01,1,3,1,3,4
21304,CALAMARCA,estado nutricional en menores de 5 anos,clasificacion e,2003-07-01,35,21,35,21,56
10701,CAMARGO,estado nutricional en menores de 5 anos,clasificacion e,2003-07-01,22,18,22,18,40
10901,CAMATAQUI (C. VILLA ABECIA),estado nutricional en menores de 5 anos,clasificacion e,2003-07-01,1,0,1,0,1
70706,CAMIRI,estado nutricional en menores de 5 anos,clasificacion e,2003-07-01,31,23,31,23,54
30701,CAPINOTA,estado nutricional en menores de 5 anos,clasificacion e,2003-07-01,20,18,20,18,38
20302,CAQUIAVIRI,estado nutricional en menores de 5 anos,clasificacion e,2003-07-01,4,1,4,1,5
40102,CARACOLLO,estado nutricional en menores de 5 anos,clasificacion e,2003-07-01,6,7,6,7,13
22001,CARANAVI,estado nutricional en menores de 5 anos,clasificacion e,2003-07-01,39,25,39,25,64
60302,CARAPARI,estado nutricional en menores de 5 anos,clasificacion e,2003-07-01,4,5,4,5,9
50702,CARIPUYO,estado nutricional en menores de 5 anos,clasificacion e,2003-07-01,34,36,34,36,70
40201,CHALLAPATA,estado nutricional en menores de 5 anos,clasificacion e,2003-07-01,27,18,27,18,45
50302,CHAQUI,estado nutricional en menores de 5 anos,clasificacion e,2003-07-01,17,13,17,13,30
70702,CHARAGUA,estado nutricional en menores de 5 anos,clasificacion e,2003-07-01,21,33,21,33,54
20305,CHARAÃ‘A,estado nutricional en menores de 5 anos,clasificacion e,2003-07-01,2,0,2,0,2
50202,CHAYANTA,estado nutricional en menores de 5 anos,clasificacion e,2003-07-01,8,3,8,3,11
31204,CHIMORE,estado nutricional en menores de 5 anos,clasificacion e,2003-07-01,5,1,5,1,6
21101,CHULUMANI (V. DE LA LIBERTAD),estado nutricional en menores de 5 anos,clasificacion e,2003-07-01,1,3,1,3,4
20501,CHUMA,estado nutricional en menores de 5 anos,clasificacion e,2003-07-01,4,4,4,4,8
30801,CLIZA,estado nutricional en menores de 5 anos,clasificacion e,2003-07-01,5,2,5,2,7
90101,COBIJA,estado nutricional en menores de 5 anos,clasificacion e,2003-07-01,23,22,23,22,45
30101,COCHABAMBA,estado nutricional en menores de 5 anos,clasificacion e,2003-07-01,112,70,112,70,182
30905,COLCAPIRHUA,estado nutricional en menores de 5 anos,clasificacion e,2003-07-01,7,2,7,2,9
50901,"COLCHA ""K""",estado nutricional en menores de 5 anos,clasificacion e,2003-07-01,5,1,5,1,6
31002,COLOMI,estado nutricional en menores de 5 anos,clasificacion e,2003-07-01,16,4,16,4,20
50401,COLQUECHACA,estado nutricional en menores de 5 anos,clasificacion e,2003-07-01,83,35,83,35,118
21306,COLQUENCHA,estado nutricional en menores de 5 anos,clasificacion e,2003-07-01,5,0,5,0,5
21004,COLQUIRI,estado nutricional en menores de 5 anos,clasificacion e,2003-07-01,28,15,28,15,43
20304,COMANCHE,estado nutricional en menores de 5 anos,clasificacion e,2003-07-01,1,0,1,0,1
71301,COMARAPA,estado nutricional en menores de 5 anos,clasificacion e,2003-07-01,17,10,17,10,27
20605,COMBAYA,estado nutricional en menores de 5 anos,clasificacion e,2003-07-01,1,1,1,1,2
71101,CONCEPCION,estado nutricional en menores de 5 anos,clasificacion e,2003-07-01,3,1,3,1,4
21701,COPACABANA,estado nutricional en menores de 5 anos,clasificacion e,2003-07-01,4,1,4,1,5
20301,CORO CORO,estado nutricional en menores de 5 anos,clasificacion e,2003-07-01,12,8,12,8,20
21401,COROICO,estado nutricional en menores de 5 anos,clasificacion e,2003-07-01,5,4,5,4,9
40301,CORQUE,estado nutricional en menores de 5 anos,clasificacion e,2003-07-01,1,0,1,0,1
50601,COTAGAITA,estado nutricional en menores de 5 anos,clasificacion e,2003-07-01,27,19,27,19,46
70102,COTOCA,estado nutricional en menores de 5 anos,clasificacion e,2003-07-01,10,3,10,3,13
70704,CUEVO,estado nutricional en menores de 5 anos,clasificacion e,2003-07-01,1,4,1,4,5
10902,CULPINA,estado nutricional en menores de 5 anos,clasificacion e,2003-07-01,35,34,35,34,69
40401,CURAHUARA DE CARANGAS,estado nutricional en menores de 5 anos,clasificacion e,2003-07-01,5,5,5,5,10
21602,CURVA,estado nutricional en menores de 5 anos,clasificacion e,2003-07-01,1,0,1,0,1
20105,EL ALTO,estado nutricional en menores de 5 anos,clasificacion e,2003-07-01,442,228,442,228,670
71503,EL PUENTE(STC),estado nutricional en menores de 5 anos,clasificacion e,2003-07-01,8,36,8,36,44
60502,EL PUENTE(TJA),estado nutricional en menores de 5 anos,clasificacion e,2003-07-01,14,13,14,13,27
70105,EL TORNO,estado nutricional en menores de 5 anos,clasificacion e,2003-07-01,16,14,16,14,30
10405,EL VILLAR,estado nutricional en menores de 5 anos,clasificacion e,2003-07-01,27,23,27,23,50
60601,ENTRE RIOS,estado nutricional en menores de 5 anos,clasificacion e,2003-07-01,6,3,6,3,9
41101,EUCALIPTUS,estado nutricional en menores de 5 anos,clasificacion e,2003-07-01,3,4,3,4,7
80402,EXALTACION,estado nutricional en menores de 5 anos,clasificacion e,2003-07-01,2,6,2,6,8
90203,FILADELFIA,estado nutricional en menores de 5 anos,clasificacion e,2003-07-01,1,2,1,2,3
71002,GENERAL SAAVEDRA,estado nutricional en menores de 5 anos,clasificacion e,2003-07-01,17,17,17,17,34
21601,GRAL. J.J. PEREZ (CHARAZANI),estado nutricional en menores de 5 anos,clasificacion e,2003-07-01,21,28,21,28,49
20602,GUANAY,estado nutricional en menores de 5 anos,clasificacion e,2003-07-01,31,41,31,41,72
20802,GUAQUI,estado nutricional en menores de 5 anos,clasificacion e,2003-07-01,3,0,3,0,3
80202,GUAYARAMERIN,estado nutricional en menores de 5 anos,clasificacion e,2003-07-01,34,17,34,17,51
70705,GUTIERREZ,estado nutricional en menores de 5 anos,clasificacion e,2003-07-01,23,35,23,35,58
10502,HUACARETA,estado nutricional en menores de 5 anos,clasificacion e,2003-07-01,21,10,21,10,31
11002,HUACAYA (VILLA DE HUACAYA),estado nutricional en menores de 5 anos,clasificacion e,2003-07-01,0,5,0,5,5
40501,HUACHACALLA,estado nutricional en menores de 5 anos,clasificacion e,2003-07-01,1,0,1,0,1
40701,HUANUNI,estado nutricional en menores de 5 anos,clasificacion e,2003-07-01,5,4,5,4,9
80803,HUARACAJE,estado nutricional en menores de 5 anos,clasificacion e,2003-07-01,4,1,4,1,5
41601,HUAYLLAMARCA,estado nutricional en menores de 5 anos,clasificacion e,2003-07-01,1,2,1,2,3
21005,ICHOCA,estado nutricional en menores de 5 anos,clasificacion e,2003-07-01,5,7,5,7,12
10304,ICLA,estado nutricional en menores de 5 anos,clasificacion e,2003-07-01,55,69,55,69,124
10703,INCAHUASI,estado nutricional en menores de 5 anos,clasificacion e,2003-07-01,49,24,49,24,73
21001,INQUISIVI,estado nutricional en menores de 5 anos,clasificacion e,2003-07-01,14,21,14,21,35
21102,IRUPANA (VILLA DE LANZA),estado nutricional en menores de 5 anos,clasificacion e,2003-07-01,0,18,0,18,18
21501,IXIAMAS,estado nutricional en menores de 5 anos,clasificacion e,2003-07-01,8,5,8,5,13
21105,LA ASUNTA,estado nutricional en menores de 5 anos,clasificacion e,2003-07-01,10,9,10,9,19
70104,LA GUARDIA,estado nutricional en menores de 5 anos,clasificacion e,2003-07-01,4,4,4,4,8
20101,LA PAZ,estado nutricional en menores de 5 anos,clasificacion e,2003-07-01,228,239,228,239,467
70701,LAGUNILLAS,estado nutricional en menores de 5 anos,clasificacion e,2003-07-01,7,8,7,8,15
21202,LAJA,estado nutricional en menores de 5 anos,clasificacion e,2003-07-01,6,4,6,4,10
10903,LAS CARRERAS,estado nutricional en menores de 5 anos,clasificacion e,2003-07-01,6,13,6,13,19
50203,LLALLAGUA,estado nutricional en menores de 5 anos,clasificacion e,2003-07-01,8,91,8,91,99
51401,LLICA,estado nutricional en menores de 5 anos,clasificacion e,2003-07-01,3,2,3,2,5
80601,LORETO,estado nutricional en menores de 5 anos,clasificacion e,2003-07-01,2,1,2,1,3
20901,LURIBAY,estado nutricional en menores de 5 anos,clasificacion e,2003-07-01,13,13,13,13,26
40702,MACHACAMARCA,estado nutricional en menores de 5 anos,clasificacion e,2003-07-01,3,0,3,0,3
11003,MACHARETI,estado nutricional en menores de 5 anos,clasificacion e,2003-07-01,3,16,3,16,19
80801,MAGDALENA,estado nutricional en menores de 5 anos,clasificacion e,2003-07-01,1,1,1,1,2
70903,MAIRANA,estado nutricional en menores de 5 anos,clasificacion e,2003-07-01,4,4,4,4,8
20904,MALLA,estado nutricional en menores de 5 anos,clasificacion e,2003-07-01,2,0,2,0,2
20103,MECAPACA,estado nutricional en menores de 5 anos,clasificacion e,2003-07-01,3,2,3,2,5
71003,MINEROS,estado nutricional en menores de 5 anos,clasificacion e,2003-07-01,49,17,49,17,66
31301,MIZQUE,estado nutricional en menores de 5 anos,clasificacion e,2003-07-01,9,6,9,6,15
20402,MOCOMOCO,estado nutricional en menores de 5 anos,clasificacion e,2003-07-01,18,8,18,8,26
51002,MOJINETE,estado nutricional en menores de 5 anos,clasificacion e,2003-07-01,0,2,0,2,2
10303,MOJOCOYA,estado nutricional en menores de 5 anos,clasificacion e,2003-07-01,20,19,20,19,39
10501,MONTEAGUDO,estado nutricional en menores de 5 anos,clasificacion e,2003-07-01,29,24,29,24,53
71001,MONTERO,estado nutricional en menores de 5 anos,clasificacion e,2003-07-01,64,24,64,24,88
70803,MORO MORO,estado nutricional en menores de 5 anos,clasificacion e,2003-07-01,4,6,4,6,10
30302,MOROCHATA,estado nutricional en menores de 5 anos,clasificacion e,2003-07-01,57,37,57,37,94
50404,OCURI,estado nutricional en menores de 5 anos,clasificacion e,2003-07-01,29,56,29,56,85
70202,OKINAWA,estado nutricional en menores de 5 anos,clasificacion e,2003-07-01,1,0,1,0,1
30203,OMEREQUE,estado nutricional en menores de 5 anos,clasificacion e,2003-07-01,2,9,2,9,11
40101,ORURO,estado nutricional en menores de 5 anos,clasificacion e,2003-07-01,127,78,127,78,205
60201,PADCAYA,estado nutricional en menores de 5 anos,clasificacion e,2003-07-01,7,6,7,6,13
10401,PADILLA,estado nutricional en menores de 5 anos,clasificacion e,2003-07-01,25,40,25,40,65
70502,PAILON,estado nutricional en menores de 5 anos,clasificacion e,2003-07-01,10,2,10,2,12
20102,PALCA,estado nutricional en menores de 5 anos,clasificacion e,2003-07-01,4,9,4,9,13
21104,PALOS BLANCOS,estado nutricional en menores de 5 anos,clasificacion e,2003-07-01,19,13,19,13,32
40802,PAMPA AULLAGAS,estado nutricional en menores de 5 anos,clasificacion e,2003-07-01,2,4,2,4,6
70902,PAMPA GRANDE,estado nutricional en menores de 5 anos,clasificacion e,2003-07-01,3,2,3,2,5
21802,PAPEL PAMPA,estado nutricional en menores de 5 anos,clasificacion e,2003-07-01,1,0,1,0,1
30202,PASORAPA,estado nutricional en menores de 5 anos,clasificacion e,2003-07-01,10,9,10,9,19
21305,PATACAMAYA,estado nutricional en menores de 5 anos,clasificacion e,2003-07-01,22,16,22,16,38
40602,PAZÃ‘A,estado nutricional en menores de 5 anos,clasificacion e,2003-07-01,2,4,2,4,6
20702,PELECHUCO,estado nutricional en menores de 5 anos,clasificacion e,2003-07-01,4,3,4,3,7
50403,POCOATA,estado nutricional en menores de 5 anos,clasificacion e,2003-07-01,31,23,31,23,54
31203,POCONA,estado nutricional en menores de 5 anos,clasificacion e,2003-07-01,19,7,19,7,26
31202,POJO (CBBA),estado nutricional en menores de 5 anos,clasificacion e,2003-07-01,34,18,34,18,52
40601,POOPO,estado nutricional en menores de 5 anos,clasificacion e,2003-07-01,0,8,0,8,8
51203,PORCO,estado nutricional en menores de 5 anos,clasificacion e,2003-07-01,3,2,3,2,5
10103,POROMA,estado nutricional en menores de 5 anos,clasificacion e,2003-07-01,62,69,62,69,131
70103,PORONGO,estado nutricional en menores de 5 anos,clasificacion e,2003-07-01,1,1,1,1,2
70601,PORTACHUELO,estado nutricional en menores de 5 anos,clasificacion e,2003-07-01,14,10,14,10,24
90102,PORVENIR,estado nutricional en menores de 5 anos,clasificacion e,2003-07-01,5,3,5,3,8
70804,POSTRER VALLE,estado nutricional en menores de 5 anos,clasificacion e,2003-07-01,1,3,1,3,4
50101,POTOSI,estado nutricional en menores de 5 anos,clasificacion e,2003-07-01,205,112,205,112,317
10302,PRESTO,estado nutricional en menores de 5 anos,clasificacion e,2003-07-01,26,24,26,24,50
70805,PUCARA,estado nutricional en menores de 5 anos,clasificacion e,2003-07-01,0,1,0,1,1
21201,PUCARANI,estado nutricional en menores de 5 anos,clasificacion e,2003-07-01,3,3,3,3,6
20401,PUERTO ACOSTA,estado nutricional en menores de 5 anos,clasificacion e,2003-07-01,9,4,9,4,13
20403,PUERTO CARABUCO,estado nutricional en menores de 5 anos,clasificacion e,2003-07-01,7,11,7,11,18
90301,PUERTO GONZALO MORENO,estado nutricional en menores de 5 anos,clasificacion e,2003-07-01,2,1,2,1,3
21204,PUERTO PEREZ,estado nutricional en menores de 5 anos,clasificacion e,2003-07-01,1,0,1,0,1
71402,PUERTO QUIJARRO,estado nutricional en menores de 5 anos,clasificacion e,2003-07-01,11,7,11,7,18
90201,PUERTO RICO,estado nutricional en menores de 5 anos,clasificacion e,2003-07-01,0,4,0,4,4
80703,PUERTO SILES,estado nutricional en menores de 5 anos,clasificacion e,2003-07-01,4,8,4,8,12
71401,PUERTO SUAREZ,estado nutricional en menores de 5 anos,clasificacion e,2003-07-01,8,4,8,4,12
31205,PUERTO VILLARROEL,estado nutricional en menores de 5 anos,clasificacion e,2003-07-01,53,37,53,37,90
51101,PUNA,estado nutricional en menores de 5 anos,clasificacion e,2003-07-01,75,88,75,88,163
31401,PUNATA,estado nutricional en menores de 5 anos,clasificacion e,2003-07-01,13,4,13,4,17
20604,QUIABAYA,estado nutricional en menores de 5 anos,clasificacion e,2003-07-01,4,4,4,4,8
30901,QUILLACOLLO,estado nutricional en menores de 5 anos,clasificacion e,2003-07-01,36,25,36,25,61
21002,QUIME,estado nutricional en menores de 5 anos,clasificacion e,2003-07-01,21,13,21,13,34
50402,RAVELO,estado nutricional en menores de 5 anos,clasificacion e,2003-07-01,49,39,49,39,88
80301,REYES,estado nutricional en menores de 5 anos,clasificacion e,2003-07-01,3,2,3,2,5
80201,RIBERALTA,estado nutricional en menores de 5 anos,clasificacion e,2003-07-01,115,81,115,81,196
70503,ROBORE,estado nutricional en menores de 5 anos,clasificacion e,2003-07-01,7,3,7,3,10
80304,RURRENABAQUE,estado nutricional en menores de 5 anos,clasificacion e,2003-07-01,8,5,8,5,13
40901,SABAYA,estado nutricional en menores de 5 anos,clasificacion e,2003-07-01,4,0,4,0,4
31001,SACABA,estado nutricional en menores de 5 anos,clasificacion e,2003-07-01,51,36,51,36,87
30404,SACABAMBA,estado nutricional en menores de 5 anos,clasificacion e,2003-07-01,2,5,2,5,7
50701,SACACA,estado nutricional en menores de 5 anos,clasificacion e,2003-07-01,105,150,105,150,255
71302,SAIPINA,estado nutricional en menores de 5 anos,clasificacion e,2003-07-01,2,0,2,0,2
40801,SALINAS DE GARCI MENDOZA,estado nutricional en menores de 5 anos,clasificacion e,2003-07-01,5,7,5,7,12
70901,SAMAIPATA,estado nutricional en menores de 5 anos,clasificacion e,2003-07-01,5,1,5,1,6
80602,SAN ANDRES,estado nutricional en menores de 5 anos,clasificacion e,2003-07-01,5,5,5,5,10
51003,SAN ANTONIO DE ESMORUCO,estado nutricional en menores de 5 anos,clasificacion e,2003-07-01,2,1,2,1,3
71105,SAN ANTONIO DE LOMERIO,estado nutricional en menores de 5 anos,clasificacion e,2003-07-01,32,37,32,37,69
31403,SAN BENITO,estado nutricional en menores de 5 anos,clasificacion e,2003-07-01,7,4,7,4,11
80302,SAN BORJA,estado nutricional en menores de 5 anos,clasificacion e,2003-07-01,33,37,33,37,70
21502,SAN BUENA VENTURA,estado nutricional en menores de 5 anos,clasificacion e,2003-07-01,10,9,10,9,19
70402,SAN CARLOS,estado nutricional en menores de 5 anos,clasificacion e,2003-07-01,8,16,8,16,24
80501,SAN IGNACIO,estado nutricional en menores de 5 anos,clasificacion e,2003-07-01,22,9,22,9,31
70301,SAN IGNACIO DE VELASCO,estado nutricional en menores de 5 anos,clasificacion e,2003-07-01,69,38,69,38,107
80102,SAN JAVIER(BNI),estado nutricional en menores de 5 anos,clasificacion e,2003-07-01,1,3,1,3,4
71102,SAN JAVIER(STC),estado nutricional en menores de 5 anos,clasificacion e,2003-07-01,14,8,14,8,22
70501,SAN JOSE DE CHIQUITOS,estado nutricional en menores de 5 anos,clasificacion e,2003-07-01,12,2,12,2,14
71104,SAN JULIAN,estado nutricional en menores de 5 anos,clasificacion e,2003-07-01,26,27,26,27,53
90302,SAN LORENZO(PND),estado nutricional en menores de 5 anos,clasificacion e,2003-07-01,0,2,0,2,2
60501,SAN LORENZO(TJA),estado nutricional en menores de 5 anos,clasificacion e,2003-07-01,13,9,13,9,22
10702,SAN LUCAS,estado nutricional en menores de 5 anos,clasificacion e,2003-07-01,118,82,118,82,200
70302,SAN MIGUEL DE VELASCO,estado nutricional en menores de 5 anos,clasificacion e,2003-07-01,8,9,8,9,17
51001,SAN PABLO DE LIPEZ,estado nutricional en menores de 5 anos,clasificacion e,2003-07-01,1,1,1,1,2
50501,SAN PEDRO DE BUENA VISTA,estado nutricional en menores de 5 anos,clasificacion e,2003-07-01,60,69,60,69,129
21801,SAN PEDRO DE CURAHUARA,estado nutricional en menores de 5 anos,clasificacion e,2003-07-01,2,0,2,0,2
50902,SAN PEDRO DE QUEMES,estado nutricional en menores de 5 anos,clasificacion e,2003-07-01,0,1,0,1,1
70303,SAN RAFAEL,estado nutricional en menores de 5 anos,clasificacion e,2003-07-01,9,11,9,11,20
80401,SANTA ANA,estado nutricional en menores de 5 anos,clasificacion e,2003-07-01,7,2,7,2,9
70101,SANTA CRUZ DE LA SIERRA,estado nutricional en menores de 5 anos,clasificacion e,2003-07-01,166,49,166,49,215
80303,SANTA ROSA,estado nutricional en menores de 5 anos,clasificacion e,2003-07-01,3,2,3,2,5
70602,SANTA ROSA DEL SARA,estado nutricional en menores de 5 anos,clasificacion e,2003-07-01,1,1,1,1,2
20308,SANTIAGO DE CALLAPA,estado nutricional en menores de 5 anos,clasificacion e,2003-07-01,7,12,7,12,19
41401,SANTIAGO DE HUARI,estado nutricional en menores de 5 anos,clasificacion e,2003-07-01,2,3,2,3,5
21901,SANTIAGO DE MACHACA,estado nutricional en menores de 5 anos,clasificacion e,2003-07-01,3,0,3,0,3
30702,SANTIVAÃ‘ES,estado nutricional en menores de 5 anos,clasificacion e,2003-07-01,7,8,7,8,15
40202,SANTUARIO DE QUILLACAS,estado nutricional en menores de 5 anos,clasificacion e,2003-07-01,2,1,2,1,3
20902,SAPAHAQUI,estado nutricional en menores de 5 anos,clasificacion e,2003-07-01,7,11,7,11,18
90303,SENA,estado nutricional en menores de 5 anos,clasificacion e,2003-07-01,1,0,1,0,1
21301,SICA SICA (VILLA AROMA),estado nutricional en menores de 5 anos,clasificacion e,2003-07-01,46,18,46,18,64
30703,SICAYA,estado nutricional en menores de 5 anos,clasificacion e,2003-07-01,11,4,11,4,15
30902,SIPE SIPE,estado nutricional en menores de 5 anos,clasificacion e,2003-07-01,37,22,37,22,59
10403,SOPACHUY,estado nutricional en menores de 5 anos,clasificacion e,2003-07-01,24,39,24,39,63
20601,SORATA,estado nutricional en menores de 5 anos,clasificacion e,2003-07-01,13,16,13,16,29
10101,SUCRE,estado nutricional en menores de 5 anos,clasificacion e,2003-07-01,155,137,155,137,292
31404,TACACHI,estado nutricional en menores de 5 anos,clasificacion e,2003-07-01,0,2,0,2,2
20603,TACACOMA,estado nutricional en menores de 5 anos,clasificacion e,2003-07-01,5,0,5,0,5
50303,TACOBAMBA,estado nutricional en menores de 5 anos,clasificacion e,2003-07-01,24,15,24,15,39
30602,TACOPAYA,estado nutricional en menores de 5 anos,clasificacion e,2003-07-01,19,18,19,18,37
51402,TAHUA,estado nutricional en menores de 5 anos,clasificacion e,2003-07-01,0,1,0,1,1
31101,TAPACARI,estado nutricional en menores de 5 anos,clasificacion e,2003-07-01,31,21,31,21,52
10601,TARABUCO,estado nutricional en menores de 5 anos,clasificacion e,2003-07-01,139,131,139,131,270
30401,TARATA,estado nutricional en menores de 5 anos,clasificacion e,2003-07-01,3,4,3,4,7
60101,TARIJA,estado nutricional en menores de 5 anos,clasificacion e,2003-07-01,56,42,56,42,98
10202,TARVITA,estado nutricional en menores de 5 anos,clasificacion e,2003-07-01,68,86,68,86,154
20803,TIAWANACU,estado nutricional en menores de 5 anos,clasificacion e,2003-07-01,8,4,8,4,12
50102,TINGUIPAYA,estado nutricional en menores de 5 anos,clasificacion e,2003-07-01,19,20,19,20,39
20606,TIPUANI,estado nutricional en menores de 5 anos,clasificacion e,2003-07-01,2,2,2,2,4
30903,TIQUIPAYA,estado nutricional en menores de 5 anos,clasificacion e,2003-07-01,5,3,5,3,8
31601,TIRAQUE (CBBA),estado nutricional en menores de 5 anos,clasificacion e,2003-07-01,43,38,43,38,81
21703,TITO YUPANQUI (PARQUIPUJIO),estado nutricional en menores de 5 anos,clasificacion e,2003-07-01,0,1,0,1,1
30802,TOCO,estado nutricional en menores de 5 anos,clasificacion e,2003-07-01,0,3,0,3,3
41001,TOLEDO,estado nutricional en menores de 5 anos,clasificacion e,2003-07-01,6,0,6,0,6
51202,TOMAVE,estado nutricional en menores de 5 anos,clasificacion e,2003-07-01,14,10,14,10,24
10402,TOMINA,estado nutricional en menores de 5 anos,clasificacion e,2003-07-01,45,59,45,59,104
50502,TORO TORO,estado nutricional en menores de 5 anos,clasificacion e,2003-07-01,36,33,36,33,69
31201,TOTORA(CBBA),estado nutricional en menores de 5 anos,clasificacion e,2003-07-01,23,7,23,7,30
41301,TOTORA(ORR),estado nutricional en menores de 5 anos,clasificacion e,2003-07-01,1,3,1,3,4
80101,TRINIDAD,estado nutricional en menores de 5 anos,clasificacion e,2003-07-01,48,40,48,40,88
50801,TUPIZA,estado nutricional en menores de 5 anos,clasificacion e,2003-07-01,21,38,21,38,59
40402,TURCO,estado nutricional en menores de 5 anos,clasificacion e,2003-07-01,1,0,1,0,1
50201,UNCIA,estado nutricional en menores de 5 anos,clasificacion e,2003-07-01,4,4,4,4,8
60401,URIONDO (A. CONCEPCION),estado nutricional en menores de 5 anos,clasificacion e,2003-07-01,10,6,10,6,16
71502,URUBICHA,estado nutricional en menores de 5 anos,clasificacion e,2003-07-01,3,3,3,3,6
51201,UYUNI,estado nutricional en menores de 5 anos,clasificacion e,2003-07-01,12,15,12,15,27
30502,VACAS,estado nutricional en menores de 5 anos,clasificacion e,2003-07-01,11,9,11,9,20
70801,VALLEGRANDE,estado nutricional en menores de 5 anos,clasificacion e,2003-07-01,14,7,14,7,21
20801,VIACHA,estado nutricional en menores de 5 anos,clasificacion e,2003-07-01,15,12,15,12,27
31302,VILA VILA,estado nutricional en menores de 5 anos,clasificacion e,2003-07-01,2,0,2,0,2
60303,VILLA MONTES,estado nutricional en menores de 5 anos,clasificacion e,2003-07-01,28,11,28,11,39
31402,VILLA RIVERO,estado nutricional en menores de 5 anos,clasificacion e,2003-07-01,10,3,10,3,13
10801,VILLA SERRANO,estado nutricional en menores de 5 anos,clasificacion e,2003-07-01,41,45,41,45,86
31003,VILLA TUNARI,estado nutricional en menores de 5 anos,clasificacion e,2003-07-01,65,50,65,50,115
11001,VILLA VACA GUZMAN (MUYUPAMPA),estado nutricional en menores de 5 anos,clasificacion e,2003-07-01,7,11,7,11,18
51501,VILLAZON,estado nutricional en menores de 5 anos,clasificacion e,2003-07-01,29,14,29,14,43
30904,VINTO,estado nutricional en menores de 5 anos,clasificacion e,2003-07-01,17,11,17,11,28
50602,VITICHI,estado nutricional en menores de 5 anos,clasificacion e,2003-07-01,14,11,14,11,25
20306,WALDO BALLIVIAN,estado nutricional en menores de 5 anos,clasificacion e,2003-07-01,2,0,2,0,2
20903,YACO,estado nutricional en menores de 5 anos,clasificacion e,2003-07-01,15,19,15,19,34
60301,YACUIBA,estado nutricional en menores de 5 anos,clasificacion e,2003-07-01,31,13,31,13,44
10602,YAMPARAEZ,estado nutricional en menores de 5 anos,clasificacion e,2003-07-01,87,55,87,55,142
21103,YANACACHI,estado nutricional en menores de 5 anos,clasificacion e,2003-07-01,1,2,1,2,3
70403,YAPACANI,estado nutricional en menores de 5 anos,clasificacion e,2003-07-01,33,29,33,29,62
50103,YOCALLA,estado nutricional en menores de 5 anos,clasificacion e,2003-07-01,9,8,9,8,17
10102,YOTALA,estado nutricional en menores de 5 anos,clasificacion e,2003-07-01,34,42,34,42,76
60402,YUNCHARA,estado nutricional en menores de 5 anos,clasificacion e,2003-07-01,9,9,9,9,18
10301,ZUDAÃ‘EZ,estado nutricional en menores de 5 anos,clasificacion e,2003-07-01,20,33,20,33,53
51302,ACACIO,estado nutricional en menores de 5 anos,clasificacion e,2003-08-01,35,31,35,31,66
20201,ACHACACHI,estado nutricional en menores de 5 anos,clasificacion e,2003-08-01,8,9,8,9,17
20104,ACHOCALLA,estado nutricional en menores de 5 anos,clasificacion e,2003-08-01,4,1,4,1,5
30201,AIQUILE,estado nutricional en menores de 5 anos,clasificacion e,2003-08-01,18,18,18,18,36
31303,ALALAY,estado nutricional en menores de 5 anos,clasificacion e,2003-08-01,0,2,0,2,2
10404,ALCALA,estado nutricional en menores de 5 anos,clasificacion e,2003-08-01,13,18,13,18,31
20202,ANCORAIMES,estado nutricional en menores de 5 anos,clasificacion e,2003-08-01,9,10,9,10,19
41201,ANDAMARCA,estado nutricional en menores de 5 anos,clasificacion e,2003-08-01,2,1,2,1,3
30402,ANZALDO,estado nutricional en menores de 5 anos,clasificacion e,2003-08-01,3,5,3,5,8
20701,APOLO,estado nutricional en menores de 5 anos,clasificacion e,2003-08-01,12,12,12,12,24
51301,ARAMPAMPA,estado nutricional en menores de 5 anos,clasificacion e,2003-08-01,19,17,19,17,36
30501,ARANI,estado nutricional en menores de 5 anos,clasificacion e,2003-08-01,12,9,12,9,21
30403,ARBIETO,estado nutricional en menores de 5 anos,clasificacion e,2003-08-01,2,2,2,2,4
30601,ARQUE,estado nutricional en menores de 5 anos,clasificacion e,2003-08-01,11,6,11,6,17
71501,ASCENCION DE GUARAYOS,estado nutricional en menores de 5 anos,clasificacion e,2003-08-01,63,61,63,61,124
50802,ATOCHA,estado nutricional en menores de 5 anos,clasificacion e,2003-08-01,17,29,17,29,46
20503,AUCAPATA,estado nutricional en menores de 5 anos,clasificacion e,2003-08-01,13,4,13,4,17
20502,AYATA,estado nutricional en menores de 5 anos,clasificacion e,2003-08-01,2,2,2,2,4
21303,AYO AYO,estado nutricional en menores de 5 anos,clasificacion e,2003-08-01,5,4,5,4,9
30301,AYOPAYA (V. DE INDEPENDENCIA),estado nutricional en menores de 5 anos,clasificacion e,2003-08-01,30,20,30,20,50
10201,AZURDUY,estado nutricional en menores de 5 anos,clasificacion e,2003-08-01,69,90,69,90,159
21203,BATALLAS,estado nutricional en menores de 5 anos,clasificacion e,2003-08-01,2,4,2,4,6
80802,BAURES,estado nutricional en menores de 5 anos,clasificacion e,2003-08-01,1,3,1,3,4
50104,BELEN DE URMIRI,estado nutricional en menores de 5 anos,clasificacion e,2003-08-01,2,2,2,2,4
90104,BELLA FLOR,estado nutricional en menores de 5 anos,clasificacion e,2003-08-01,2,4,2,4,6
60202,BERMEJO,estado nutricional en menores de 5 anos,clasificacion e,2003-08-01,0,1,0,1,1
50301,BETANZOS,estado nutricional en menores de 5 anos,clasificacion e,2003-08-01,109,96,109,96,205
31501,BOLIVAR,estado nutricional en menores de 5 anos,clasificacion e,2003-08-01,24,12,24,12,36
90103,BOLPEBRA,estado nutricional en menores de 5 anos,clasificacion e,2003-08-01,2,0,2,0,2
70707,BOYUIBE,estado nutricional en menores de 5 anos,clasificacion e,2003-08-01,1,2,1,2,3
70401,BUENA VISTA,estado nutricional en menores de 5 anos,clasificacion e,2003-08-01,2,3,2,3,5
70703,CABEZAS,estado nutricional en menores de 5 anos,clasificacion e,2003-08-01,3,2,3,2,5
20905,CAIROMA,estado nutricional en menores de 5 anos,clasificacion e,2003-08-01,22,19,22,19,41
51102,"CAIZA ""D""",estado nutricional en menores de 5 anos,clasificacion e,2003-08-01,21,13,21,13,34
21003,CAJUATA,estado nutricional en menores de 5 anos,clasificacion e,2003-08-01,14,13,14,13,27
20303,CALACOTO,estado nutricional en menores de 5 anos,clasificacion e,2003-08-01,1,2,1,2,3
21304,CALAMARCA,estado nutricional en menores de 5 anos,clasificacion e,2003-08-01,58,33,58,33,91
10701,CAMARGO,estado nutricional en menores de 5 anos,clasificacion e,2003-08-01,22,10,22,10,32
10901,CAMATAQUI (C. VILLA ABECIA),estado nutricional en menores de 5 anos,clasificacion e,2003-08-01,3,1,3,1,4
70706,CAMIRI,estado nutricional en menores de 5 anos,clasificacion e,2003-08-01,26,18,26,18,44
30701,CAPINOTA,estado nutricional en menores de 5 anos,clasificacion e,2003-08-01,15,21,15,21,36
20302,CAQUIAVIRI,estado nutricional en menores de 5 anos,clasificacion e,2003-08-01,11,4,11,4,15
40102,CARACOLLO,estado nutricional en menores de 5 anos,clasificacion e,2003-08-01,9,4,9,4,13
22001,CARANAVI,estado nutricional en menores de 5 anos,clasificacion e,2003-08-01,37,25,37,25,62
60302,CARAPARI,estado nutricional en menores de 5 anos,clasificacion e,2003-08-01,9,2,9,2,11
50702,CARIPUYO,estado nutricional en menores de 5 anos,clasificacion e,2003-08-01,44,26,44,26,70
21902,CATACORA,estado nutricional en menores de 5 anos,clasificacion e,2003-08-01,1,3,1,3,4
40201,CHALLAPATA,estado nutricional en menores de 5 anos,clasificacion e,2003-08-01,33,24,33,24,57
50302,CHAQUI,estado nutricional en menores de 5 anos,clasificacion e,2003-08-01,16,10,16,10,26
70702,CHARAGUA,estado nutricional en menores de 5 anos,clasificacion e,2003-08-01,18,33,18,33,51
20305,CHARAÃ‘A,estado nutricional en menores de 5 anos,clasificacion e,2003-08-01,2,0,2,0,2
50202,CHAYANTA,estado nutricional en menores de 5 anos,clasificacion e,2003-08-01,22,20,22,20,42
31204,CHIMORE,estado nutricional en menores de 5 anos,clasificacion e,2003-08-01,5,2,5,2,7
40302,CHOQUE COTA,estado nutricional en menores de 5 anos,clasificacion e,2003-08-01,0,1,0,1,1
20501,CHUMA,estado nutricional en menores de 5 anos,clasificacion e,2003-08-01,8,4,8,4,12
90101,COBIJA,estado nutricional en menores de 5 anos,clasificacion e,2003-08-01,24,19,24,19,43
30101,COCHABAMBA,estado nutricional en menores de 5 anos,clasificacion e,2003-08-01,94,44,94,44,138
30905,COLCAPIRHUA,estado nutricional en menores de 5 anos,clasificacion e,2003-08-01,7,2,7,2,9
50901,"COLCHA ""K""",estado nutricional en menores de 5 anos,clasificacion e,2003-08-01,8,2,8,2,10
31002,COLOMI,estado nutricional en menores de 5 anos,clasificacion e,2003-08-01,11,5,11,5,16
50401,COLQUECHACA,estado nutricional en menores de 5 anos,clasificacion e,2003-08-01,73,44,73,44,117
21306,COLQUENCHA,estado nutricional en menores de 5 anos,clasificacion e,2003-08-01,10,6,10,6,16
21004,COLQUIRI,estado nutricional en menores de 5 anos,clasificacion e,2003-08-01,21,16,21,16,37
71301,COMARAPA,estado nutricional en menores de 5 anos,clasificacion e,2003-08-01,14,11,14,11,25
20605,COMBAYA,estado nutricional en menores de 5 anos,clasificacion e,2003-08-01,2,2,2,2,4
71101,CONCEPCION,estado nutricional en menores de 5 anos,clasificacion e,2003-08-01,4,6,4,6,10
21701,COPACABANA,estado nutricional en menores de 5 anos,clasificacion e,2003-08-01,4,2,4,2,6
21402,CORIPATA,estado nutricional en menores de 5 anos,clasificacion e,2003-08-01,2,0,2,0,2
20301,CORO CORO,estado nutricional en menores de 5 anos,clasificacion e,2003-08-01,13,7,13,7,20
21401,COROICO,estado nutricional en menores de 5 anos,clasificacion e,2003-08-01,7,6,7,6,13
40301,CORQUE,estado nutricional en menores de 5 anos,clasificacion e,2003-08-01,1,0,1,0,1
50601,COTAGAITA,estado nutricional en menores de 5 anos,clasificacion e,2003-08-01,66,100,66,100,166
70704,CUEVO,estado nutricional en menores de 5 anos,clasificacion e,2003-08-01,2,5,2,5,7
10902,CULPINA,estado nutricional en menores de 5 anos,clasificacion e,2003-08-01,50,42,50,42,92
40401,CURAHUARA DE CARANGAS,estado nutricional en menores de 5 anos,clasificacion e,2003-08-01,6,5,6,5,11
21602,CURVA,estado nutricional en menores de 5 anos,clasificacion e,2003-08-01,0,1,0,1,1
20804,DESAGUADERO,estado nutricional en menores de 5 anos,clasificacion e,2003-08-01,2,0,2,0,2
20105,EL ALTO,estado nutricional en menores de 5 anos,clasificacion e,2003-08-01,385,241,385,241,626
40103,EL CHORO,estado nutricional en menores de 5 anos,clasificacion e,2003-08-01,1,1,1,1,2
71503,EL PUENTE(STC),estado nutricional en menores de 5 anos,clasificacion e,2003-08-01,2,19,2,19,21
60502,EL PUENTE(TJA),estado nutricional en menores de 5 anos,clasificacion e,2003-08-01,11,23,11,23,34
70105,EL TORNO,estado nutricional en menores de 5 anos,clasificacion e,2003-08-01,16,10,16,10,26
10405,EL VILLAR,estado nutricional en menores de 5 anos,clasificacion e,2003-08-01,17,42,17,42,59
60601,ENTRE RIOS,estado nutricional en menores de 5 anos,clasificacion e,2003-08-01,9,15,9,15,24
41101,EUCALIPTUS,estado nutricional en menores de 5 anos,clasificacion e,2003-08-01,2,3,2,3,5
80402,EXALTACION,estado nutricional en menores de 5 anos,clasificacion e,2003-08-01,6,4,6,4,10
90203,FILADELFIA,estado nutricional en menores de 5 anos,clasificacion e,2003-08-01,1,1,1,1,2
71002,GENERAL SAAVEDRA,estado nutricional en menores de 5 anos,clasificacion e,2003-08-01,26,19,26,19,45
21601,GRAL. J.J. PEREZ (CHARAZANI),estado nutricional en menores de 5 anos,clasificacion e,2003-08-01,12,14,12,14,26
20602,GUANAY,estado nutricional en menores de 5 anos,clasificacion e,2003-08-01,26,32,26,32,58
20802,GUAQUI,estado nutricional en menores de 5 anos,clasificacion e,2003-08-01,2,0,2,0,2
80202,GUAYARAMERIN,estado nutricional en menores de 5 anos,clasificacion e,2003-08-01,26,18,26,18,44
70705,GUTIERREZ,estado nutricional en menores de 5 anos,clasificacion e,2003-08-01,22,32,22,32,54
10502,HUACARETA,estado nutricional en menores de 5 anos,clasificacion e,2003-08-01,21,16,21,16,37
11002,HUACAYA (VILLA DE HUACAYA),estado nutricional en menores de 5 anos,clasificacion e,2003-08-01,1,5,1,5,6
40701,HUANUNI,estado nutricional en menores de 5 anos,clasificacion e,2003-08-01,4,9,4,9,13
80803,HUARACAJE,estado nutricional en menores de 5 anos,clasificacion e,2003-08-01,9,3,9,3,12
41601,HUAYLLAMARCA,estado nutricional en menores de 5 anos,clasificacion e,2003-08-01,3,1,3,1,4
21005,ICHOCA,estado nutricional en menores de 5 anos,clasificacion e,2003-08-01,7,11,7,11,18
10304,ICLA,estado nutricional en menores de 5 anos,clasificacion e,2003-08-01,47,67,47,67,114
10703,INCAHUASI,estado nutricional en menores de 5 anos,clasificacion e,2003-08-01,79,40,79,40,119
21001,INQUISIVI,estado nutricional en menores de 5 anos,clasificacion e,2003-08-01,26,24,26,24,50
21102,IRUPANA (VILLA DE LANZA),estado nutricional en menores de 5 anos,clasificacion e,2003-08-01,6,10,6,10,16
21501,IXIAMAS,estado nutricional en menores de 5 anos,clasificacion e,2003-08-01,6,7,6,7,13
21105,LA ASUNTA,estado nutricional en menores de 5 anos,clasificacion e,2003-08-01,3,9,3,9,12
70104,LA GUARDIA,estado nutricional en menores de 5 anos,clasificacion e,2003-08-01,10,1,10,1,11
20101,LA PAZ,estado nutricional en menores de 5 anos,clasificacion e,2003-08-01,211,142,211,142,353
70701,LAGUNILLAS,estado nutricional en menores de 5 anos,clasificacion e,2003-08-01,8,8,8,8,16
21202,LAJA,estado nutricional en menores de 5 anos,clasificacion e,2003-08-01,5,1,5,1,6
10903,LAS CARRERAS,estado nutricional en menores de 5 anos,clasificacion e,2003-08-01,6,8,6,8,14
21006,LICOMA PAMPA,estado nutricional en menores de 5 anos,clasificacion e,2003-08-01,3,2,3,2,5
50203,LLALLAGUA,estado nutricional en menores de 5 anos,clasificacion e,2003-08-01,3,92,3,92,95
51401,LLICA,estado nutricional en menores de 5 anos,clasificacion e,2003-08-01,1,1,1,1,2
20901,LURIBAY,estado nutricional en menores de 5 anos,clasificacion e,2003-08-01,15,4,15,4,19
40702,MACHACAMARCA,estado nutricional en menores de 5 anos,clasificacion e,2003-08-01,3,1,3,1,4
11003,MACHARETI,estado nutricional en menores de 5 anos,clasificacion e,2003-08-01,8,14,8,14,22
80801,MAGDALENA,estado nutricional en menores de 5 anos,clasificacion e,2003-08-01,5,0,5,0,5
70903,MAIRANA,estado nutricional en menores de 5 anos,clasificacion e,2003-08-01,2,1,2,1,3
20904,MALLA,estado nutricional en menores de 5 anos,clasificacion e,2003-08-01,1,0,1,0,1
71003,MINEROS,estado nutricional en menores de 5 anos,clasificacion e,2003-08-01,15,10,15,10,25
31301,MIZQUE,estado nutricional en menores de 5 anos,clasificacion e,2003-08-01,12,12,12,12,24
20402,MOCOMOCO,estado nutricional en menores de 5 anos,clasificacion e,2003-08-01,13,13,13,13,26
51002,MOJINETE,estado nutricional en menores de 5 anos,clasificacion e,2003-08-01,0,2,0,2,2
10303,MOJOCOYA,estado nutricional en menores de 5 anos,clasificacion e,2003-08-01,21,28,21,28,49
10501,MONTEAGUDO,estado nutricional en menores de 5 anos,clasificacion e,2003-08-01,43,29,43,29,72
71001,MONTERO,estado nutricional en menores de 5 anos,clasificacion e,2003-08-01,34,27,34,27,61
70803,MORO MORO,estado nutricional en menores de 5 anos,clasificacion e,2003-08-01,3,1,3,1,4
30302,MOROCHATA,estado nutricional en menores de 5 anos,clasificacion e,2003-08-01,39,35,39,35,74
20307,NAZACARA DE PACAJES,estado nutricional en menores de 5 anos,clasificacion e,2003-08-01,1,0,1,0,1
50404,OCURI,estado nutricional en menores de 5 anos,clasificacion e,2003-08-01,46,37,46,37,83
30203,OMEREQUE,estado nutricional en menores de 5 anos,clasificacion e,2003-08-01,1,1,1,1,2
40101,ORURO,estado nutricional en menores de 5 anos,clasificacion e,2003-08-01,132,57,132,57,189
60201,PADCAYA,estado nutricional en menores de 5 anos,clasificacion e,2003-08-01,7,5,7,5,12
10401,PADILLA,estado nutricional en menores de 5 anos,clasificacion e,2003-08-01,25,39,25,39,64
70502,PAILON,estado nutricional en menores de 5 anos,clasificacion e,2003-08-01,1,1,1,1,2
20102,PALCA,estado nutricional en menores de 5 anos,clasificacion e,2003-08-01,10,12,10,12,22
21104,PALOS BLANCOS,estado nutricional en menores de 5 anos,clasificacion e,2003-08-01,14,1,14,1,15
40802,PAMPA AULLAGAS,estado nutricional en menores de 5 anos,clasificacion e,2003-08-01,2,1,2,1,3
70902,PAMPA GRANDE,estado nutricional en menores de 5 anos,clasificacion e,2003-08-01,5,4,5,4,9
21802,PAPEL PAMPA,estado nutricional en menores de 5 anos,clasificacion e,2003-08-01,2,0,2,0,2
30202,PASORAPA,estado nutricional en menores de 5 anos,clasificacion e,2003-08-01,4,4,4,4,8
21305,PATACAMAYA,estado nutricional en menores de 5 anos,clasificacion e,2003-08-01,38,30,38,30,68
40602,PAZÃ‘A,estado nutricional en menores de 5 anos,clasificacion e,2003-08-01,1,2,1,2,3
20702,PELECHUCO,estado nutricional en menores de 5 anos,clasificacion e,2003-08-01,7,3,7,3,10
50403,POCOATA,estado nutricional en menores de 5 anos,clasificacion e,2003-08-01,29,50,29,50,79
31203,POCONA,estado nutricional en menores de 5 anos,clasificacion e,2003-08-01,23,9,23,9,32
31202,POJO (CBBA),estado nutricional en menores de 5 anos,clasificacion e,2003-08-01,27,16,27,16,43
40601,POOPO,estado nutricional en menores de 5 anos,clasificacion e,2003-08-01,0,1,0,1,1
51203,PORCO,estado nutricional en menores de 5 anos,clasificacion e,2003-08-01,10,2,10,2,12
10103,POROMA,estado nutricional en menores de 5 anos,clasificacion e,2003-08-01,68,71,68,71,139
70103,PORONGO,estado nutricional en menores de 5 anos,clasificacion e,2003-08-01,1,0,1,0,1
70601,PORTACHUELO,estado nutricional en menores de 5 anos,clasificacion e,2003-08-01,14,7,14,7,21
90102,PORVENIR,estado nutricional en menores de 5 anos,clasificacion e,2003-08-01,4,2,4,2,6
70804,POSTRER VALLE,estado nutricional en menores de 5 anos,clasificacion e,2003-08-01,2,2,2,2,4
50101,POTOSI,estado nutricional en menores de 5 anos,clasificacion e,2003-08-01,149,99,149,99,248
10302,PRESTO,estado nutricional en menores de 5 anos,clasificacion e,2003-08-01,29,32,29,32,61
70805,PUCARA,estado nutricional en menores de 5 anos,clasificacion e,2003-08-01,1,2,1,2,3
21201,PUCARANI,estado nutricional en menores de 5 anos,clasificacion e,2003-08-01,6,4,6,4,10
20401,PUERTO ACOSTA,estado nutricional en menores de 5 anos,clasificacion e,2003-08-01,8,15,8,15,23
20403,PUERTO CARABUCO,estado nutricional en menores de 5 anos,clasificacion e,2003-08-01,16,11,16,11,27
90301,PUERTO GONZALO MORENO,estado nutricional en menores de 5 anos,clasificacion e,2003-08-01,4,3,4,3,7
21204,PUERTO PEREZ,estado nutricional en menores de 5 anos,clasificacion e,2003-08-01,6,1,6,1,7
71402,PUERTO QUIJARRO,estado nutricional en menores de 5 anos,clasificacion e,2003-08-01,4,0,4,0,4
90201,PUERTO RICO,estado nutricional en menores de 5 anos,clasificacion e,2003-08-01,1,2,1,2,3
71401,PUERTO SUAREZ,estado nutricional en menores de 5 anos,clasificacion e,2003-08-01,3,5,3,5,8
31205,PUERTO VILLARROEL,estado nutricional en menores de 5 anos,clasificacion e,2003-08-01,35,34,35,34,69
51101,PUNA,estado nutricional en menores de 5 anos,clasificacion e,2003-08-01,4,1,4,1,5
31401,PUNATA,estado nutricional en menores de 5 anos,clasificacion e,2003-08-01,15,20,15,20,35
20604,QUIABAYA,estado nutricional en menores de 5 anos,clasificacion e,2003-08-01,7,8,7,8,15
30901,QUILLACOLLO,estado nutricional en menores de 5 anos,clasificacion e,2003-08-01,27,16,27,16,43
21002,QUIME,estado nutricional en menores de 5 anos,clasificacion e,2003-08-01,7,6,7,6,13
50402,RAVELO,estado nutricional en menores de 5 anos,clasificacion e,2003-08-01,61,58,61,58,119
80301,REYES,estado nutricional en menores de 5 anos,clasificacion e,2003-08-01,1,5,1,5,6
80201,RIBERALTA,estado nutricional en menores de 5 anos,clasificacion e,2003-08-01,113,51,113,51,164
70503,ROBORE,estado nutricional en menores de 5 anos,clasificacion e,2003-08-01,5,3,5,3,8
40901,SABAYA,estado nutricional en menores de 5 anos,clasificacion e,2003-08-01,1,2,1,2,3
31001,SACABA,estado nutricional en menores de 5 anos,clasificacion e,2003-08-01,35,6,35,6,41
30404,SACABAMBA,estado nutricional en menores de 5 anos,clasificacion e,2003-08-01,11,9,11,9,20
50701,SACACA,estado nutricional en menores de 5 anos,clasificacion e,2003-08-01,77,104,77,104,181
71302,SAIPINA,estado nutricional en menores de 5 anos,clasificacion e,2003-08-01,3,6,3,6,9
40801,SALINAS DE GARCI MENDOZA,estado nutricional en menores de 5 anos,clasificacion e,2003-08-01,2,3,2,3,5
70901,SAMAIPATA,estado nutricional en menores de 5 anos,clasificacion e,2003-08-01,4,3,4,3,7
51601,SAN AGUSTIN,estado nutricional en menores de 5 anos,clasificacion e,2003-08-01,0,2,0,2,2
51003,SAN ANTONIO DE ESMORUCO,estado nutricional en menores de 5 anos,clasificacion e,2003-08-01,2,0,2,0,2
71105,SAN ANTONIO DE LOMERIO,estado nutricional en menores de 5 anos,clasificacion e,2003-08-01,23,42,23,42,65
31403,SAN BENITO,estado nutricional en menores de 5 anos,clasificacion e,2003-08-01,5,0,5,0,5
80302,SAN BORJA,estado nutricional en menores de 5 anos,clasificacion e,2003-08-01,51,45,51,45,96
21502,SAN BUENA VENTURA,estado nutricional en menores de 5 anos,clasificacion e,2003-08-01,12,3,12,3,15
70402,SAN CARLOS,estado nutricional en menores de 5 anos,clasificacion e,2003-08-01,11,18,11,18,29
80501,SAN IGNACIO,estado nutricional en menores de 5 anos,clasificacion e,2003-08-01,26,13,26,13,39
70301,SAN IGNACIO DE VELASCO,estado nutricional en menores de 5 anos,clasificacion e,2003-08-01,68,78,68,78,146
71102,SAN JAVIER(STC),estado nutricional en menores de 5 anos,clasificacion e,2003-08-01,6,2,6,2,8
80701,SAN JOAQUIN,estado nutricional en menores de 5 anos,clasificacion e,2003-08-01,1,1,1,1,2
70501,SAN JOSE DE CHIQUITOS,estado nutricional en menores de 5 anos,clasificacion e,2003-08-01,3,0,3,0,3
71104,SAN JULIAN,estado nutricional en menores de 5 anos,clasificacion e,2003-08-01,36,39,36,39,75
90302,SAN LORENZO(PND),estado nutricional en menores de 5 anos,clasificacion e,2003-08-01,8,0,8,0,8
60501,SAN LORENZO(TJA),estado nutricional en menores de 5 anos,clasificacion e,2003-08-01,15,25,15,25,40
10702,SAN LUCAS,estado nutricional en menores de 5 anos,clasificacion e,2003-08-01,181,118,181,118,299
71201,SAN MATIAS,estado nutricional en menores de 5 anos,clasificacion e,2003-08-01,20,6,20,6,26
70302,SAN MIGUEL DE VELASCO,estado nutricional en menores de 5 anos,clasificacion e,2003-08-01,11,19,11,19,30
51001,SAN PABLO DE LIPEZ,estado nutricional en menores de 5 anos,clasificacion e,2003-08-01,2,4,2,4,6
50501,SAN PEDRO DE BUENA VISTA,estado nutricional en menores de 5 anos,clasificacion e,2003-08-01,42,53,42,53,95
21801,SAN PEDRO DE CURAHUARA,estado nutricional en menores de 5 anos,clasificacion e,2003-08-01,3,3,3,3,6
70303,SAN RAFAEL,estado nutricional en menores de 5 anos,clasificacion e,2003-08-01,6,5,6,5,11
80401,SANTA ANA,estado nutricional en menores de 5 anos,clasificacion e,2003-08-01,15,5,15,5,20
70101,SANTA CRUZ DE LA SIERRA,estado nutricional en menores de 5 anos,clasificacion e,2003-08-01,124,51,124,51,175
80303,SANTA ROSA,estado nutricional en menores de 5 anos,clasificacion e,2003-08-01,6,4,6,4,10
70602,SANTA ROSA DEL SARA,estado nutricional en menores de 5 anos,clasificacion e,2003-08-01,1,5,1,5,6
20308,SANTIAGO DE CALLAPA,estado nutricional en menores de 5 anos,clasificacion e,2003-08-01,5,3,5,3,8
41401,SANTIAGO DE HUARI,estado nutricional en menores de 5 anos,clasificacion e,2003-08-01,5,4,5,4,9
21901,SANTIAGO DE MACHACA,estado nutricional en menores de 5 anos,clasificacion e,2003-08-01,1,2,1,2,3
30702,SANTIVAÃ‘ES,estado nutricional en menores de 5 anos,clasificacion e,2003-08-01,7,1,7,1,8
20902,SAPAHAQUI,estado nutricional en menores de 5 anos,clasificacion e,2003-08-01,14,13,14,13,27
90303,SENA,estado nutricional en menores de 5 anos,clasificacion e,2003-08-01,13,10,13,10,23
21301,SICA SICA (VILLA AROMA),estado nutricional en menores de 5 anos,clasificacion e,2003-08-01,36,22,36,22,58
30703,SICAYA,estado nutricional en menores de 5 anos,clasificacion e,2003-08-01,12,4,12,4,16
30902,SIPE SIPE,estado nutricional en menores de 5 anos,clasificacion e,2003-08-01,26,17,26,17,43
10403,SOPACHUY,estado nutricional en menores de 5 anos,clasificacion e,2003-08-01,30,25,30,25,55
20601,SORATA,estado nutricional en menores de 5 anos,clasificacion e,2003-08-01,4,7,4,7,11
10101,SUCRE,estado nutricional en menores de 5 anos,clasificacion e,2003-08-01,137,118,137,118,255
20603,TACACOMA,estado nutricional en menores de 5 anos,clasificacion e,2003-08-01,8,6,8,6,14
50303,TACOBAMBA,estado nutricional en menores de 5 anos,clasificacion e,2003-08-01,29,23,29,23,52
30602,TACOPAYA,estado nutricional en menores de 5 anos,clasificacion e,2003-08-01,38,26,38,26,64
31101,TAPACARI,estado nutricional en menores de 5 anos,clasificacion e,2003-08-01,41,22,41,22,63
10601,TARABUCO,estado nutricional en menores de 5 anos,clasificacion e,2003-08-01,126,129,126,129,255
30401,TARATA,estado nutricional en menores de 5 anos,clasificacion e,2003-08-01,7,5,7,5,12
60101,TARIJA,estado nutricional en menores de 5 anos,clasificacion e,2003-08-01,43,31,43,31,74
10202,TARVITA,estado nutricional en menores de 5 anos,clasificacion e,2003-08-01,80,127,80,127,207
20803,TIAWANACU,estado nutricional en menores de 5 anos,clasificacion e,2003-08-01,3,2,3,2,5
50102,TINGUIPAYA,estado nutricional en menores de 5 anos,clasificacion e,2003-08-01,33,55,33,55,88
20606,TIPUANI,estado nutricional en menores de 5 anos,clasificacion e,2003-08-01,3,2,3,2,5
30903,TIQUIPAYA,estado nutricional en menores de 5 anos,clasificacion e,2003-08-01,9,4,9,4,13
31601,TIRAQUE (CBBA),estado nutricional en menores de 5 anos,clasificacion e,2003-08-01,30,24,30,24,54
21703,TITO YUPANQUI (PARQUIPUJIO),estado nutricional en menores de 5 anos,clasificacion e,2003-08-01,1,0,1,0,1
30802,TOCO,estado nutricional en menores de 5 anos,clasificacion e,2003-08-01,0,1,0,1,1
30803,TOLATA,estado nutricional en menores de 5 anos,clasificacion e,2003-08-01,3,2,3,2,5
41001,TOLEDO,estado nutricional en menores de 5 anos,clasificacion e,2003-08-01,3,0,3,0,3
51202,TOMAVE,estado nutricional en menores de 5 anos,clasificacion e,2003-08-01,17,17,17,17,34
10402,TOMINA,estado nutricional en menores de 5 anos,clasificacion e,2003-08-01,40,43,40,43,83
50502,TORO TORO,estado nutricional en menores de 5 anos,clasificacion e,2003-08-01,34,37,34,37,71
31201,TOTORA(CBBA),estado nutricional en menores de 5 anos,clasificacion e,2003-08-01,17,8,17,8,25
41301,TOTORA(ORR),estado nutricional en menores de 5 anos,clasificacion e,2003-08-01,2,1,2,1,3
80101,TRINIDAD,estado nutricional en menores de 5 anos,clasificacion e,2003-08-01,34,29,34,29,63
50801,TUPIZA,estado nutricional en menores de 5 anos,clasificacion e,2003-08-01,20,51,20,51,71
40402,TURCO,estado nutricional en menores de 5 anos,clasificacion e,2003-08-01,2,2,2,2,4
21302,UMALA,estado nutricional en menores de 5 anos,clasificacion e,2003-08-01,6,15,6,15,21
50201,UNCIA,estado nutricional en menores de 5 anos,clasificacion e,2003-08-01,6,2,6,2,8
60401,URIONDO (A. CONCEPCION),estado nutricional en menores de 5 anos,clasificacion e,2003-08-01,8,12,8,12,20
71502,URUBICHA,estado nutricional en menores de 5 anos,clasificacion e,2003-08-01,20,30,20,30,50
51201,UYUNI,estado nutricional en menores de 5 anos,clasificacion e,2003-08-01,6,7,6,7,13
30502,VACAS,estado nutricional en menores de 5 anos,clasificacion e,2003-08-01,17,4,17,4,21
70801,VALLEGRANDE,estado nutricional en menores de 5 anos,clasificacion e,2003-08-01,5,6,5,6,11
20801,VIACHA,estado nutricional en menores de 5 anos,clasificacion e,2003-08-01,24,5,24,5,29
31302,VILA VILA,estado nutricional en menores de 5 anos,clasificacion e,2003-08-01,9,11,9,11,20
60303,VILLA MONTES,estado nutricional en menores de 5 anos,clasificacion e,2003-08-01,19,11,19,11,30
31402,VILLA RIVERO,estado nutricional en menores de 5 anos,clasificacion e,2003-08-01,6,7,6,7,13
10801,VILLA SERRANO,estado nutricional en menores de 5 anos,clasificacion e,2003-08-01,38,63,38,63,101
31003,VILLA TUNARI,estado nutricional en menores de 5 anos,clasificacion e,2003-08-01,39,34,39,34,73
11001,VILLA VACA GUZMAN (MUYUPAMPA),estado nutricional en menores de 5 anos,clasificacion e,2003-08-01,8,8,8,8,16
51501,VILLAZON,estado nutricional en menores de 5 anos,clasificacion e,2003-08-01,21,21,21,21,42
30904,VINTO,estado nutricional en menores de 5 anos,clasificacion e,2003-08-01,7,6,7,6,13
50602,VITICHI,estado nutricional en menores de 5 anos,clasificacion e,2003-08-01,56,46,56,46,102
20306,WALDO BALLIVIAN,estado nutricional en menores de 5 anos,clasificacion e,2003-08-01,0,2,0,2,2
20903,YACO,estado nutricional en menores de 5 anos,clasificacion e,2003-08-01,32,15,32,15,47
60301,YACUIBA,estado nutricional en menores de 5 anos,clasificacion e,2003-08-01,20,11,20,11,31
10602,YAMPARAEZ,estado nutricional en menores de 5 anos,clasificacion e,2003-08-01,75,52,75,52,127
21103,YANACACHI,estado nutricional en menores de 5 anos,clasificacion e,2003-08-01,0,2,0,2,2
70403,YAPACANI,estado nutricional en menores de 5 anos,clasificacion e,2003-08-01,26,18,26,18,44
50103,YOCALLA,estado nutricional en menores de 5 anos,clasificacion e,2003-08-01,2,3,2,3,5
10102,YOTALA,estado nutricional en menores de 5 anos,clasificacion e,2003-08-01,31,38,31,38,69
60402,YUNCHARA,estado nutricional en menores de 5 anos,clasificacion e,2003-08-01,12,26,12,26,38
10301,ZUDAÃ‘EZ,estado nutricional en menores de 5 anos,clasificacion e,2003-08-01,24,28,24,28,52
51302,ACACIO,estado nutricional en menores de 5 anos,clasificacion e,2003-09-01,21,33,21,33,54
20201,ACHACACHI,estado nutricional en menores de 5 anos,clasificacion e,2003-09-01,14,8,14,8,22
20104,ACHOCALLA,estado nutricional en menores de 5 anos,clasificacion e,2003-09-01,6,5,6,5,11
30201,AIQUILE,estado nutricional en menores de 5 anos,clasificacion e,2003-09-01,19,9,19,9,28
10404,ALCALA,estado nutricional en menores de 5 anos,clasificacion e,2003-09-01,11,31,11,31,42
20202,ANCORAIMES,estado nutricional en menores de 5 anos,clasificacion e,2003-09-01,9,13,9,13,22
41201,ANDAMARCA,estado nutricional en menores de 5 anos,clasificacion e,2003-09-01,2,1,2,1,3
30402,ANZALDO,estado nutricional en menores de 5 anos,clasificacion e,2003-09-01,3,9,3,9,12
20701,APOLO,estado nutricional en menores de 5 anos,clasificacion e,2003-09-01,11,7,11,7,18
51301,ARAMPAMPA,estado nutricional en menores de 5 anos,clasificacion e,2003-09-01,9,20,9,20,29
30501,ARANI,estado nutricional en menores de 5 anos,clasificacion e,2003-09-01,7,17,7,17,24
30403,ARBIETO,estado nutricional en menores de 5 anos,clasificacion e,2003-09-01,1,0,1,0,1
30601,ARQUE,estado nutricional en menores de 5 anos,clasificacion e,2003-09-01,29,13,29,13,42
71501,ASCENCION DE GUARAYOS,estado nutricional en menores de 5 anos,clasificacion e,2003-09-01,2,2,2,2,4
50802,ATOCHA,estado nutricional en menores de 5 anos,clasificacion e,2003-09-01,4,39,4,39,43
20503,AUCAPATA,estado nutricional en menores de 5 anos,clasificacion e,2003-09-01,8,1,8,1,9
20502,AYATA,estado nutricional en menores de 5 anos,clasificacion e,2003-09-01,6,2,6,2,8
21303,AYO AYO,estado nutricional en menores de 5 anos,clasificacion e,2003-09-01,1,0,1,0,1
30301,AYOPAYA (V. DE INDEPENDENCIA),estado nutricional en menores de 5 anos,clasificacion e,2003-09-01,22,12,22,12,34
10201,AZURDUY,estado nutricional en menores de 5 anos,clasificacion e,2003-09-01,78,59,78,59,137
21203,BATALLAS,estado nutricional en menores de 5 anos,clasificacion e,2003-09-01,7,2,7,2,9
80802,BAURES,estado nutricional en menores de 5 anos,clasificacion e,2003-09-01,2,3,2,3,5
41202,BELEN DE ANDAMARCA,estado nutricional en menores de 5 anos,clasificacion e,2003-09-01,1,0,1,0,1
50104,BELEN DE URMIRI,estado nutricional en menores de 5 anos,clasificacion e,2003-09-01,3,6,3,6,9
90104,BELLA FLOR,estado nutricional en menores de 5 anos,clasificacion e,2003-09-01,2,3,2,3,5
60202,BERMEJO,estado nutricional en menores de 5 anos,clasificacion e,2003-09-01,4,2,4,2,6
50301,BETANZOS,estado nutricional en menores de 5 anos,clasificacion e,2003-09-01,108,76,108,76,184
31501,BOLIVAR,estado nutricional en menores de 5 anos,clasificacion e,2003-09-01,48,25,48,25,73
90103,BOLPEBRA,estado nutricional en menores de 5 anos,clasificacion e,2003-09-01,3,1,3,1,4
70707,BOYUIBE,estado nutricional en menores de 5 anos,clasificacion e,2003-09-01,1,2,1,2,3
70401,BUENA VISTA,estado nutricional en menores de 5 anos,clasificacion e,2003-09-01,4,15,4,15,19
70703,CABEZAS,estado nutricional en menores de 5 anos,clasificacion e,2003-09-01,1,0,1,0,1
20905,CAIROMA,estado nutricional en menores de 5 anos,clasificacion e,2003-09-01,17,14,17,14,31
51102,"CAIZA ""D""",estado nutricional en menores de 5 anos,clasificacion e,2003-09-01,23,22,23,22,45
21003,CAJUATA,estado nutricional en menores de 5 anos,clasificacion e,2003-09-01,17,8,17,8,25
20303,CALACOTO,estado nutricional en menores de 5 anos,clasificacion e,2003-09-01,1,0,1,0,1
21304,CALAMARCA,estado nutricional en menores de 5 anos,clasificacion e,2003-09-01,46,27,46,27,73
10701,CAMARGO,estado nutricional en menores de 5 anos,clasificacion e,2003-09-01,25,26,25,26,51
10901,CAMATAQUI (C. VILLA ABECIA),estado nutricional en menores de 5 anos,clasificacion e,2003-09-01,1,2,1,2,3
70706,CAMIRI,estado nutricional en menores de 5 anos,clasificacion e,2003-09-01,33,27,33,27,60
30701,CAPINOTA,estado nutricional en menores de 5 anos,clasificacion e,2003-09-01,11,8,11,8,19
20302,CAQUIAVIRI,estado nutricional en menores de 5 anos,clasificacion e,2003-09-01,7,5,7,5,12
40102,CARACOLLO,estado nutricional en menores de 5 anos,clasificacion e,2003-09-01,7,2,7,2,9
22001,CARANAVI,estado nutricional en menores de 5 anos,clasificacion e,2003-09-01,22,15,22,15,37
60302,CARAPARI,estado nutricional en menores de 5 anos,clasificacion e,2003-09-01,5,0,5,0,5
50702,CARIPUYO,estado nutricional en menores de 5 anos,clasificacion e,2003-09-01,19,34,19,34,53
21902,CATACORA,estado nutricional en menores de 5 anos,clasificacion e,2003-09-01,1,1,1,1,2
40201,CHALLAPATA,estado nutricional en menores de 5 anos,clasificacion e,2003-09-01,26,20,26,20,46
50302,CHAQUI,estado nutricional en menores de 5 anos,clasificacion e,2003-09-01,18,18,18,18,36
70702,CHARAGUA,estado nutricional en menores de 5 anos,clasificacion e,2003-09-01,16,16,16,16,32
20305,CHARAÃ‘A,estado nutricional en menores de 5 anos,clasificacion e,2003-09-01,3,2,3,2,5
50202,CHAYANTA,estado nutricional en menores de 5 anos,clasificacion e,2003-09-01,15,16,15,16,31
31204,CHIMORE,estado nutricional en menores de 5 anos,clasificacion e,2003-09-01,2,3,2,3,5
21101,CHULUMANI (V. DE LA LIBERTAD),estado nutricional en menores de 5 anos,clasificacion e,2003-09-01,2,3,2,3,5
20501,CHUMA,estado nutricional en menores de 5 anos,clasificacion e,2003-09-01,7,11,7,11,18
30801,CLIZA,estado nutricional en menores de 5 anos,clasificacion e,2003-09-01,1,2,1,2,3
90101,COBIJA,estado nutricional en menores de 5 anos,clasificacion e,2003-09-01,23,18,23,18,41
30101,COCHABAMBA,estado nutricional en menores de 5 anos,clasificacion e,2003-09-01,112,75,112,75,187
30905,COLCAPIRHUA,estado nutricional en menores de 5 anos,clasificacion e,2003-09-01,3,1,3,1,4
50901,"COLCHA ""K""",estado nutricional en menores de 5 anos,clasificacion e,2003-09-01,4,1,4,1,5
31002,COLOMI,estado nutricional en menores de 5 anos,clasificacion e,2003-09-01,20,20,20,20,40
50401,COLQUECHACA,estado nutricional en menores de 5 anos,clasificacion e,2003-09-01,79,56,79,56,135
21306,COLQUENCHA,estado nutricional en menores de 5 anos,clasificacion e,2003-09-01,2,0,2,0,2
21004,COLQUIRI,estado nutricional en menores de 5 anos,clasificacion e,2003-09-01,9,7,9,7,16
20304,COMANCHE,estado nutricional en menores de 5 anos,clasificacion e,2003-09-01,0,1,0,1,1
71301,COMARAPA,estado nutricional en menores de 5 anos,clasificacion e,2003-09-01,14,19,14,19,33
20605,COMBAYA,estado nutricional en menores de 5 anos,clasificacion e,2003-09-01,3,1,3,1,4
21701,COPACABANA,estado nutricional en menores de 5 anos,clasificacion e,2003-09-01,4,1,4,1,5
20301,CORO CORO,estado nutricional en menores de 5 anos,clasificacion e,2003-09-01,8,4,8,4,12
21401,COROICO,estado nutricional en menores de 5 anos,clasificacion e,2003-09-01,5,4,5,4,9
40301,CORQUE,estado nutricional en menores de 5 anos,clasificacion e,2003-09-01,5,3,5,3,8
50601,COTAGAITA,estado nutricional en menores de 5 anos,clasificacion e,2003-09-01,30,19,30,19,49
70704,CUEVO,estado nutricional en menores de 5 anos,clasificacion e,2003-09-01,1,1,1,1,2
10902,CULPINA,estado nutricional en menores de 5 anos,clasificacion e,2003-09-01,46,42,46,42,88
40401,CURAHUARA DE CARANGAS,estado nutricional en menores de 5 anos,clasificacion e,2003-09-01,8,2,8,2,10
21602,CURVA,estado nutricional en menores de 5 anos,clasificacion e,2003-09-01,3,0,3,0,3
20804,DESAGUADERO,estado nutricional en menores de 5 anos,clasificacion e,2003-09-01,1,0,1,0,1
20105,EL ALTO,estado nutricional en menores de 5 anos,clasificacion e,2003-09-01,344,229,344,229,573
71503,EL PUENTE(STC),estado nutricional en menores de 5 anos,clasificacion e,2003-09-01,2,9,2,9,11
60502,EL PUENTE(TJA),estado nutricional en menores de 5 anos,clasificacion e,2003-09-01,20,23,20,23,43
70105,EL TORNO,estado nutricional en menores de 5 anos,clasificacion e,2003-09-01,16,14,16,14,30
10405,EL VILLAR,estado nutricional en menores de 5 anos,clasificacion e,2003-09-01,17,39,17,39,56
60601,ENTRE RIOS,estado nutricional en menores de 5 anos,clasificacion e,2003-09-01,7,5,7,5,12
41101,EUCALIPTUS,estado nutricional en menores de 5 anos,clasificacion e,2003-09-01,3,1,3,1,4
90503,EUREKA (SANTOS MERCADO),estado nutricional en menores de 5 anos,clasificacion e,2003-09-01,0,2,0,2,2
80402,EXALTACION,estado nutricional en menores de 5 anos,clasificacion e,2003-09-01,2,4,2,4,6
90203,FILADELFIA,estado nutricional en menores de 5 anos,clasificacion e,2003-09-01,1,5,1,5,6
71002,GENERAL SAAVEDRA,estado nutricional en menores de 5 anos,clasificacion e,2003-09-01,23,18,23,18,41
21601,GRAL. J.J. PEREZ (CHARAZANI),estado nutricional en menores de 5 anos,clasificacion e,2003-09-01,10,16,10,16,26
20602,GUANAY,estado nutricional en menores de 5 anos,clasificacion e,2003-09-01,22,15,22,15,37
80202,GUAYARAMERIN,estado nutricional en menores de 5 anos,clasificacion e,2003-09-01,21,20,21,20,41
70705,GUTIERREZ,estado nutricional en menores de 5 anos,clasificacion e,2003-09-01,22,24,22,24,46
10502,HUACARETA,estado nutricional en menores de 5 anos,clasificacion e,2003-09-01,20,12,20,12,32
11002,HUACAYA (VILLA DE HUACAYA),estado nutricional en menores de 5 anos,clasificacion e,2003-09-01,4,3,4,3,7
40701,HUANUNI,estado nutricional en menores de 5 anos,clasificacion e,2003-09-01,11,9,11,9,20
80803,HUARACAJE,estado nutricional en menores de 5 anos,clasificacion e,2003-09-01,1,0,1,0,1
41601,HUAYLLAMARCA,estado nutricional en menores de 5 anos,clasificacion e,2003-09-01,2,2,2,2,4
21005,ICHOCA,estado nutricional en menores de 5 anos,clasificacion e,2003-09-01,11,6,11,6,17
10304,ICLA,estado nutricional en menores de 5 anos,clasificacion e,2003-09-01,36,62,36,62,98
10703,INCAHUASI,estado nutricional en menores de 5 anos,clasificacion e,2003-09-01,71,28,71,28,99
21001,INQUISIVI,estado nutricional en menores de 5 anos,clasificacion e,2003-09-01,25,23,25,23,48
21102,IRUPANA (VILLA DE LANZA),estado nutricional en menores de 5 anos,clasificacion e,2003-09-01,0,8,0,8,8
21501,IXIAMAS,estado nutricional en menores de 5 anos,clasificacion e,2003-09-01,11,8,11,8,19
21105,LA ASUNTA,estado nutricional en menores de 5 anos,clasificacion e,2003-09-01,15,13,15,13,28
70104,LA GUARDIA,estado nutricional en menores de 5 anos,clasificacion e,2003-09-01,11,3,11,3,14
20101,LA PAZ,estado nutricional en menores de 5 anos,clasificacion e,2003-09-01,192,103,192,103,295
70701,LAGUNILLAS,estado nutricional en menores de 5 anos,clasificacion e,2003-09-01,8,6,8,6,14
21202,LAJA,estado nutricional en menores de 5 anos,clasificacion e,2003-09-01,1,0,1,0,1
10903,LAS CARRERAS,estado nutricional en menores de 5 anos,clasificacion e,2003-09-01,10,7,10,7,17
50203,LLALLAGUA,estado nutricional en menores de 5 anos,clasificacion e,2003-09-01,28,51,28,51,79
51401,LLICA,estado nutricional en menores de 5 anos,clasificacion e,2003-09-01,1,3,1,3,4
80601,LORETO,estado nutricional en menores de 5 anos,clasificacion e,2003-09-01,2,0,2,0,2
20901,LURIBAY,estado nutricional en menores de 5 anos,clasificacion e,2003-09-01,11,11,11,11,22
40702,MACHACAMARCA,estado nutricional en menores de 5 anos,clasificacion e,2003-09-01,2,1,2,1,3
11003,MACHARETI,estado nutricional en menores de 5 anos,clasificacion e,2003-09-01,7,11,7,11,18
80801,MAGDALENA,estado nutricional en menores de 5 anos,clasificacion e,2003-09-01,4,1,4,1,5
70903,MAIRANA,estado nutricional en menores de 5 anos,clasificacion e,2003-09-01,6,0,6,0,6
20103,MECAPACA,estado nutricional en menores de 5 anos,clasificacion e,2003-09-01,0,7,0,7,7
71003,MINEROS,estado nutricional en menores de 5 anos,clasificacion e,2003-09-01,20,18,20,18,38
31301,MIZQUE,estado nutricional en menores de 5 anos,clasificacion e,2003-09-01,5,3,5,3,8
20402,MOCOMOCO,estado nutricional en menores de 5 anos,clasificacion e,2003-09-01,16,14,16,14,30
51002,MOJINETE,estado nutricional en menores de 5 anos,clasificacion e,2003-09-01,1,0,1,0,1
10303,MOJOCOYA,estado nutricional en menores de 5 anos,clasificacion e,2003-09-01,7,18,7,18,25
10501,MONTEAGUDO,estado nutricional en menores de 5 anos,clasificacion e,2003-09-01,39,43,39,43,82
71001,MONTERO,estado nutricional en menores de 5 anos,clasificacion e,2003-09-01,39,26,39,26,65
70803,MORO MORO,estado nutricional en menores de 5 anos,clasificacion e,2003-09-01,2,3,2,3,5
30302,MOROCHATA,estado nutricional en menores de 5 anos,clasificacion e,2003-09-01,34,28,34,28,62
90401,NACEBE (SANTA ROSA DEL ABUNA),estado nutricional en menores de 5 anos,clasificacion e,2003-09-01,0,1,0,1,1
50404,OCURI,estado nutricional en menores de 5 anos,clasificacion e,2003-09-01,42,38,42,38,80
30203,OMEREQUE,estado nutricional en menores de 5 anos,clasificacion e,2003-09-01,0,2,0,2,2
40101,ORURO,estado nutricional en menores de 5 anos,clasificacion e,2003-09-01,110,71,110,71,181
60201,PADCAYA,estado nutricional en menores de 5 anos,clasificacion e,2003-09-01,9,15,9,15,24
10401,PADILLA,estado nutricional en menores de 5 anos,clasificacion e,2003-09-01,29,44,29,44,73
70502,PAILON,estado nutricional en menores de 5 anos,clasificacion e,2003-09-01,13,5,13,5,18
20102,PALCA,estado nutricional en menores de 5 anos,clasificacion e,2003-09-01,6,7,6,7,13
21104,PALOS BLANCOS,estado nutricional en menores de 5 anos,clasificacion e,2003-09-01,19,16,19,16,35
40802,PAMPA AULLAGAS,estado nutricional en menores de 5 anos,clasificacion e,2003-09-01,5,4,5,4,9
70902,PAMPA GRANDE,estado nutricional en menores de 5 anos,clasificacion e,2003-09-01,2,5,2,5,7
21802,PAPEL PAMPA,estado nutricional en menores de 5 anos,clasificacion e,2003-09-01,1,1,1,1,2
30202,PASORAPA,estado nutricional en menores de 5 anos,clasificacion e,2003-09-01,1,4,1,4,5
21305,PATACAMAYA,estado nutricional en menores de 5 anos,clasificacion e,2003-09-01,25,13,25,13,38
40602,PAZÃ‘A,estado nutricional en menores de 5 anos,clasificacion e,2003-09-01,5,1,5,1,6
20702,PELECHUCO,estado nutricional en menores de 5 anos,clasificacion e,2003-09-01,10,17,10,17,27
50403,POCOATA,estado nutricional en menores de 5 anos,clasificacion e,2003-09-01,23,27,23,27,50
31203,POCONA,estado nutricional en menores de 5 anos,clasificacion e,2003-09-01,16,10,16,10,26
31202,POJO (CBBA),estado nutricional en menores de 5 anos,clasificacion e,2003-09-01,34,20,34,20,54
40601,POOPO,estado nutricional en menores de 5 anos,clasificacion e,2003-09-01,3,5,3,5,8
51203,PORCO,estado nutricional en menores de 5 anos,clasificacion e,2003-09-01,7,3,7,3,10
10103,POROMA,estado nutricional en menores de 5 anos,clasificacion e,2003-09-01,60,57,60,57,117
70103,PORONGO,estado nutricional en menores de 5 anos,clasificacion e,2003-09-01,2,0,2,0,2
70601,PORTACHUELO,estado nutricional en menores de 5 anos,clasificacion e,2003-09-01,9,18,9,18,27
90102,PORVENIR,estado nutricional en menores de 5 anos,clasificacion e,2003-09-01,3,0,3,0,3
70804,POSTRER VALLE,estado nutricional en menores de 5 anos,clasificacion e,2003-09-01,1,1,1,1,2
50101,POTOSI,estado nutricional en menores de 5 anos,clasificacion e,2003-09-01,154,79,154,79,233
10302,PRESTO,estado nutricional en menores de 5 anos,clasificacion e,2003-09-01,20,38,20,38,58
70805,PUCARA,estado nutricional en menores de 5 anos,clasificacion e,2003-09-01,0,2,0,2,2
21201,PUCARANI,estado nutricional en menores de 5 anos,clasificacion e,2003-09-01,2,2,2,2,4
20401,PUERTO ACOSTA,estado nutricional en menores de 5 anos,clasificacion e,2003-09-01,16,14,16,14,30
20403,PUERTO CARABUCO,estado nutricional en menores de 5 anos,clasificacion e,2003-09-01,16,18,16,18,34
90301,PUERTO GONZALO MORENO,estado nutricional en menores de 5 anos,clasificacion e,2003-09-01,9,19,9,19,28
71402,PUERTO QUIJARRO,estado nutricional en menores de 5 anos,clasificacion e,2003-09-01,7,3,7,3,10
90201,PUERTO RICO,estado nutricional en menores de 5 anos,clasificacion e,2003-09-01,2,2,2,2,4
71401,PUERTO SUAREZ,estado nutricional en menores de 5 anos,clasificacion e,2003-09-01,11,8,11,8,19
31205,PUERTO VILLARROEL,estado nutricional en menores de 5 anos,clasificacion e,2003-09-01,34,28,34,28,62
51101,PUNA,estado nutricional en menores de 5 anos,clasificacion e,2003-09-01,62,51,62,51,113
31401,PUNATA,estado nutricional en menores de 5 anos,clasificacion e,2003-09-01,2,5,2,5,7
20604,QUIABAYA,estado nutricional en menores de 5 anos,clasificacion e,2003-09-01,3,5,3,5,8
30901,QUILLACOLLO,estado nutricional en menores de 5 anos,clasificacion e,2003-09-01,29,21,29,21,50
21002,QUIME,estado nutricional en menores de 5 anos,clasificacion e,2003-09-01,22,11,22,11,33
50402,RAVELO,estado nutricional en menores de 5 anos,clasificacion e,2003-09-01,74,66,74,66,140
80301,REYES,estado nutricional en menores de 5 anos,clasificacion e,2003-09-01,2,3,2,3,5
80201,RIBERALTA,estado nutricional en menores de 5 anos,clasificacion e,2003-09-01,119,80,119,80,199
70503,ROBORE,estado nutricional en menores de 5 anos,clasificacion e,2003-09-01,10,6,10,6,16
80304,RURRENABAQUE,estado nutricional en menores de 5 anos,clasificacion e,2003-09-01,6,0,6,0,6
40901,SABAYA,estado nutricional en menores de 5 anos,clasificacion e,2003-09-01,2,3,2,3,5
31001,SACABA,estado nutricional en menores de 5 anos,clasificacion e,2003-09-01,40,14,40,14,54
30404,SACABAMBA,estado nutricional en menores de 5 anos,clasificacion e,2003-09-01,7,3,7,3,10
50701,SACACA,estado nutricional en menores de 5 anos,clasificacion e,2003-09-01,64,95,64,95,159
71302,SAIPINA,estado nutricional en menores de 5 anos,clasificacion e,2003-09-01,1,2,1,2,3
40801,SALINAS DE GARCI MENDOZA,estado nutricional en menores de 5 anos,clasificacion e,2003-09-01,6,8,6,8,14
70901,SAMAIPATA,estado nutricional en menores de 5 anos,clasificacion e,2003-09-01,0,3,0,3,3
80602,SAN ANDRES,estado nutricional en menores de 5 anos,clasificacion e,2003-09-01,2,1,2,1,3
51003,SAN ANTONIO DE ESMORUCO,estado nutricional en menores de 5 anos,clasificacion e,2003-09-01,0,1,0,1,1
71105,SAN ANTONIO DE LOMERIO,estado nutricional en menores de 5 anos,clasificacion e,2003-09-01,33,41,33,41,74
31403,SAN BENITO,estado nutricional en menores de 5 anos,clasificacion e,2003-09-01,7,0,7,0,7
80302,SAN BORJA,estado nutricional en menores de 5 anos,clasificacion e,2003-09-01,51,31,51,31,82
21502,SAN BUENA VENTURA,estado nutricional en menores de 5 anos,clasificacion e,2003-09-01,13,8,13,8,21
70402,SAN CARLOS,estado nutricional en menores de 5 anos,clasificacion e,2003-09-01,7,6,7,6,13
80501,SAN IGNACIO,estado nutricional en menores de 5 anos,clasificacion e,2003-09-01,22,21,22,21,43
70301,SAN IGNACIO DE VELASCO,estado nutricional en menores de 5 anos,clasificacion e,2003-09-01,57,44,57,44,101
80102,SAN JAVIER(BNI),estado nutricional en menores de 5 anos,clasificacion e,2003-09-01,2,0,2,0,2
71102,SAN JAVIER(STC),estado nutricional en menores de 5 anos,clasificacion e,2003-09-01,8,7,8,7,15
70501,SAN JOSE DE CHIQUITOS,estado nutricional en menores de 5 anos,clasificacion e,2003-09-01,8,2,8,2,10
71104,SAN JULIAN,estado nutricional en menores de 5 anos,clasificacion e,2003-09-01,23,32,23,32,55
90302,SAN LORENZO(PND),estado nutricional en menores de 5 anos,clasificacion e,2003-09-01,1,0,1,0,1
60501,SAN LORENZO(TJA),estado nutricional en menores de 5 anos,clasificacion e,2003-09-01,6,6,6,6,12
10702,SAN LUCAS,estado nutricional en menores de 5 anos,clasificacion e,2003-09-01,175,147,175,147,322
70302,SAN MIGUEL DE VELASCO,estado nutricional en menores de 5 anos,clasificacion e,2003-09-01,14,5,14,5,19
51001,SAN PABLO DE LIPEZ,estado nutricional en menores de 5 anos,clasificacion e,2003-09-01,1,3,1,3,4
50501,SAN PEDRO DE BUENA VISTA,estado nutricional en menores de 5 anos,clasificacion e,2003-09-01,61,72,61,72,133
21801,SAN PEDRO DE CURAHUARA,estado nutricional en menores de 5 anos,clasificacion e,2003-09-01,5,4,5,4,9
50902,SAN PEDRO DE QUEMES,estado nutricional en menores de 5 anos,clasificacion e,2003-09-01,0,1,0,1,1
70303,SAN RAFAEL,estado nutricional en menores de 5 anos,clasificacion e,2003-09-01,4,3,4,3,7
80702,SAN RAMON,estado nutricional en menores de 5 anos,clasificacion e,2003-09-01,0,1,0,1,1
70101,SANTA CRUZ DE LA SIERRA,estado nutricional en menores de 5 anos,clasificacion e,2003-09-01,174,40,174,40,214
80303,SANTA ROSA,estado nutricional en menores de 5 anos,clasificacion e,2003-09-01,3,3,3,3,6
70602,SANTA ROSA DEL SARA,estado nutricional en menores de 5 anos,clasificacion e,2003-09-01,2,1,2,1,3
20308,SANTIAGO DE CALLAPA,estado nutricional en menores de 5 anos,clasificacion e,2003-09-01,1,2,1,2,3
41401,SANTIAGO DE HUARI,estado nutricional en menores de 5 anos,clasificacion e,2003-09-01,5,4,5,4,9
21901,SANTIAGO DE MACHACA,estado nutricional en menores de 5 anos,clasificacion e,2003-09-01,4,0,4,0,4
30702,SANTIVAÃ‘ES,estado nutricional en menores de 5 anos,clasificacion e,2003-09-01,12,7,12,7,19
40202,SANTUARIO DE QUILLACAS,estado nutricional en menores de 5 anos,clasificacion e,2003-09-01,1,2,1,2,3
20902,SAPAHAQUI,estado nutricional en menores de 5 anos,clasificacion e,2003-09-01,11,12,11,12,23
90303,SENA,estado nutricional en menores de 5 anos,clasificacion e,2003-09-01,2,2,2,2,4
21301,SICA SICA (VILLA AROMA),estado nutricional en menores de 5 anos,clasificacion e,2003-09-01,48,33,48,33,81
30703,SICAYA,estado nutricional en menores de 5 anos,clasificacion e,2003-09-01,12,2,12,2,14
30902,SIPE SIPE,estado nutricional en menores de 5 anos,clasificacion e,2003-09-01,39,28,39,28,67
10403,SOPACHUY,estado nutricional en menores de 5 anos,clasificacion e,2003-09-01,41,37,41,37,78
20601,SORATA,estado nutricional en menores de 5 anos,clasificacion e,2003-09-01,7,9,7,9,16
10101,SUCRE,estado nutricional en menores de 5 anos,clasificacion e,2003-09-01,112,112,112,112,224
31404,TACACHI,estado nutricional en menores de 5 anos,clasificacion e,2003-09-01,3,2,3,2,5
50303,TACOBAMBA,estado nutricional en menores de 5 anos,clasificacion e,2003-09-01,26,17,26,17,43
30602,TACOPAYA,estado nutricional en menores de 5 anos,clasificacion e,2003-09-01,33,32,33,32,65
51402,TAHUA,estado nutricional en menores de 5 anos,clasificacion e,2003-09-01,1,1,1,1,2
31101,TAPACARI,estado nutricional en menores de 5 anos,clasificacion e,2003-09-01,82,55,82,55,137
10601,TARABUCO,estado nutricional en menores de 5 anos,clasificacion e,2003-09-01,125,116,125,116,241
30401,TARATA,estado nutricional en menores de 5 anos,clasificacion e,2003-09-01,7,8,7,8,15
60101,TARIJA,estado nutricional en menores de 5 anos,clasificacion e,2003-09-01,20,23,20,23,43
10202,TARVITA,estado nutricional en menores de 5 anos,clasificacion e,2003-09-01,65,79,65,79,144
20803,TIAWANACU,estado nutricional en menores de 5 anos,clasificacion e,2003-09-01,6,0,6,0,6
50102,TINGUIPAYA,estado nutricional en menores de 5 anos,clasificacion e,2003-09-01,29,62,29,62,91
20606,TIPUANI,estado nutricional en menores de 5 anos,clasificacion e,2003-09-01,2,0,2,0,2
30903,TIQUIPAYA,estado nutricional en menores de 5 anos,clasificacion e,2003-09-01,12,6,12,6,18
31601,TIRAQUE (CBBA),estado nutricional en menores de 5 anos,clasificacion e,2003-09-01,44,45,44,45,89
21703,TITO YUPANQUI (PARQUIPUJIO),estado nutricional en menores de 5 anos,clasificacion e,2003-09-01,1,0,1,0,1
30802,TOCO,estado nutricional en menores de 5 anos,clasificacion e,2003-09-01,1,3,1,3,4
30803,TOLATA,estado nutricional en menores de 5 anos,clasificacion e,2003-09-01,2,6,2,6,8
51202,TOMAVE,estado nutricional en menores de 5 anos,clasificacion e,2003-09-01,13,12,13,12,25
10402,TOMINA,estado nutricional en menores de 5 anos,clasificacion e,2003-09-01,51,52,51,52,103
50502,TORO TORO,estado nutricional en menores de 5 anos,clasificacion e,2003-09-01,37,44,37,44,81
31201,TOTORA(CBBA),estado nutricional en menores de 5 anos,clasificacion e,2003-09-01,15,7,15,7,22
41301,TOTORA(ORR),estado nutricional en menores de 5 anos,clasificacion e,2003-09-01,4,5,4,5,9
70802,TRIGAL,estado nutricional en menores de 5 anos,clasificacion e,2003-09-01,1,1,1,1,2
80101,TRINIDAD,estado nutricional en menores de 5 anos,clasificacion e,2003-09-01,20,29,20,29,49
50801,TUPIZA,estado nutricional en menores de 5 anos,clasificacion e,2003-09-01,29,33,29,33,62
40402,TURCO,estado nutricional en menores de 5 anos,clasificacion e,2003-09-01,5,2,5,2,7
21302,UMALA,estado nutricional en menores de 5 anos,clasificacion e,2003-09-01,7,8,7,8,15
50201,UNCIA,estado nutricional en menores de 5 anos,clasificacion e,2003-09-01,8,2,8,2,10
60401,URIONDO (A. CONCEPCION),estado nutricional en menores de 5 anos,clasificacion e,2003-09-01,8,9,8,9,17
51201,UYUNI,estado nutricional en menores de 5 anos,clasificacion e,2003-09-01,15,10,15,10,25
30502,VACAS,estado nutricional en menores de 5 anos,clasificacion e,2003-09-01,6,2,6,2,8
70801,VALLEGRANDE,estado nutricional en menores de 5 anos,clasificacion e,2003-09-01,3,6,3,6,9
20801,VIACHA,estado nutricional en menores de 5 anos,clasificacion e,2003-09-01,16,10,16,10,26
31302,VILA VILA,estado nutricional en menores de 5 anos,clasificacion e,2003-09-01,14,1,14,1,15
60303,VILLA MONTES,estado nutricional en menores de 5 anos,clasificacion e,2003-09-01,13,21,13,21,34
31402,VILLA RIVERO,estado nutricional en menores de 5 anos,clasificacion e,2003-09-01,12,5,12,5,17
10801,VILLA SERRANO,estado nutricional en menores de 5 anos,clasificacion e,2003-09-01,43,55,43,55,98
31003,VILLA TUNARI,estado nutricional en menores de 5 anos,clasificacion e,2003-09-01,44,31,44,31,75
11001,VILLA VACA GUZMAN (MUYUPAMPA),estado nutricional en menores de 5 anos,clasificacion e,2003-09-01,9,8,9,8,17
51501,VILLAZON,estado nutricional en menores de 5 anos,clasificacion e,2003-09-01,19,13,19,13,32
30904,VINTO,estado nutricional en menores de 5 anos,clasificacion e,2003-09-01,17,7,17,7,24
50602,VITICHI,estado nutricional en menores de 5 anos,clasificacion e,2003-09-01,9,7,9,7,16
20306,WALDO BALLIVIAN,estado nutricional en menores de 5 anos,clasificacion e,2003-09-01,4,1,4,1,5
20903,YACO,estado nutricional en menores de 5 anos,clasificacion e,2003-09-01,15,3,15,3,18
60301,YACUIBA,estado nutricional en menores de 5 anos,clasificacion e,2003-09-01,0,20,0,20,20
10602,YAMPARAEZ,estado nutricional en menores de 5 anos,clasificacion e,2003-09-01,71,41,71,41,112
70403,YAPACANI,estado nutricional en menores de 5 anos,clasificacion e,2003-09-01,23,21,23,21,44
50103,YOCALLA,estado nutricional en menores de 5 anos,clasificacion e,2003-09-01,9,4,9,4,13
10102,YOTALA,estado nutricional en menores de 5 anos,clasificacion e,2003-09-01,30,36,30,36,66
60402,YUNCHARA,estado nutricional en menores de 5 anos,clasificacion e,2003-09-01,11,9,11,9,20
10301,ZUDAÃ‘EZ,estado nutricional en menores de 5 anos,clasificacion e,2003-09-01,28,34,28,34,62
51302,ACACIO,estado nutricional en menores de 5 anos,clasificacion e,2003-10-01,29,28,29,28,57
20201,ACHACACHI,estado nutricional en menores de 5 anos,clasificacion e,2003-10-01,9,5,9,5,14
20104,ACHOCALLA,estado nutricional en menores de 5 anos,clasificacion e,2003-10-01,4,4,4,4,8
30201,AIQUILE,estado nutricional en menores de 5 anos,clasificacion e,2003-10-01,30,27,30,27,57
31303,ALALAY,estado nutricional en menores de 5 anos,clasificacion e,2003-10-01,1,5,1,5,6
10404,ALCALA,estado nutricional en menores de 5 anos,clasificacion e,2003-10-01,10,17,10,17,27
20202,ANCORAIMES,estado nutricional en menores de 5 anos,clasificacion e,2003-10-01,13,10,13,10,23
41201,ANDAMARCA,estado nutricional en menores de 5 anos,clasificacion e,2003-10-01,1,1,1,1,2
30402,ANZALDO,estado nutricional en menores de 5 anos,clasificacion e,2003-10-01,11,16,11,16,27
20701,APOLO,estado nutricional en menores de 5 anos,clasificacion e,2003-10-01,4,0,4,0,4
51301,ARAMPAMPA,estado nutricional en menores de 5 anos,clasificacion e,2003-10-01,18,18,18,18,36
30501,ARANI,estado nutricional en menores de 5 anos,clasificacion e,2003-10-01,12,7,12,7,19
30403,ARBIETO,estado nutricional en menores de 5 anos,clasificacion e,2003-10-01,2,0,2,0,2
30601,ARQUE,estado nutricional en menores de 5 anos,clasificacion e,2003-10-01,21,20,21,20,41
71501,ASCENCION DE GUARAYOS,estado nutricional en menores de 5 anos,clasificacion e,2003-10-01,9,5,9,5,14
50802,ATOCHA,estado nutricional en menores de 5 anos,clasificacion e,2003-10-01,11,45,11,45,56
20503,AUCAPATA,estado nutricional en menores de 5 anos,clasificacion e,2003-10-01,12,1,12,1,13
20502,AYATA,estado nutricional en menores de 5 anos,clasificacion e,2003-10-01,9,12,9,12,21
21303,AYO AYO,estado nutricional en menores de 5 anos,clasificacion e,2003-10-01,3,0,3,0,3
30301,AYOPAYA (V. DE INDEPENDENCIA),estado nutricional en menores de 5 anos,clasificacion e,2003-10-01,28,18,28,18,46
10201,AZURDUY,estado nutricional en menores de 5 anos,clasificacion e,2003-10-01,67,72,67,72,139
21203,BATALLAS,estado nutricional en menores de 5 anos,clasificacion e,2003-10-01,9,4,9,4,13
80802,BAURES,estado nutricional en menores de 5 anos,clasificacion e,2003-10-01,1,2,1,2,3
50104,BELEN DE URMIRI,estado nutricional en menores de 5 anos,clasificacion e,2003-10-01,2,3,2,3,5
90104,BELLA FLOR,estado nutricional en menores de 5 anos,clasificacion e,2003-10-01,0,1,0,1,1
50301,BETANZOS,estado nutricional en menores de 5 anos,clasificacion e,2003-10-01,101,91,101,91,192
31501,BOLIVAR,estado nutricional en menores de 5 anos,clasificacion e,2003-10-01,35,22,35,22,57
90103,BOLPEBRA,estado nutricional en menores de 5 anos,clasificacion e,2003-10-01,2,1,2,1,3
70707,BOYUIBE,estado nutricional en menores de 5 anos,clasificacion e,2003-10-01,0,1,0,1,1
70401,BUENA VISTA,estado nutricional en menores de 5 anos,clasificacion e,2003-10-01,6,14,6,14,20
70703,CABEZAS,estado nutricional en menores de 5 anos,clasificacion e,2003-10-01,13,18,13,18,31
20905,CAIROMA,estado nutricional en menores de 5 anos,clasificacion e,2003-10-01,20,24,20,24,44
51102,"CAIZA ""D""",estado nutricional en menores de 5 anos,clasificacion e,2003-10-01,17,10,17,10,27
21003,CAJUATA,estado nutricional en menores de 5 anos,clasificacion e,2003-10-01,17,7,17,7,24
20303,CALACOTO,estado nutricional en menores de 5 anos,clasificacion e,2003-10-01,2,1,2,1,3
21304,CALAMARCA,estado nutricional en menores de 5 anos,clasificacion e,2003-10-01,57,29,57,29,86
10701,CAMARGO,estado nutricional en menores de 5 anos,clasificacion e,2003-10-01,18,19,18,19,37
10901,CAMATAQUI (C. VILLA ABECIA),estado nutricional en menores de 5 anos,clasificacion e,2003-10-01,3,3,3,3,6
70706,CAMIRI,estado nutricional en menores de 5 anos,clasificacion e,2003-10-01,24,17,24,17,41
30701,CAPINOTA,estado nutricional en menores de 5 anos,clasificacion e,2003-10-01,11,7,11,7,18
20302,CAQUIAVIRI,estado nutricional en menores de 5 anos,clasificacion e,2003-10-01,7,11,7,11,18
40102,CARACOLLO,estado nutricional en menores de 5 anos,clasificacion e,2003-10-01,13,11,13,11,24
22001,CARANAVI,estado nutricional en menores de 5 anos,clasificacion e,2003-10-01,22,29,22,29,51
60302,CARAPARI,estado nutricional en menores de 5 anos,clasificacion e,2003-10-01,7,2,7,2,9
50702,CARIPUYO,estado nutricional en menores de 5 anos,clasificacion e,2003-10-01,40,26,40,26,66
21902,CATACORA,estado nutricional en menores de 5 anos,clasificacion e,2003-10-01,2,1,2,1,3
40201,CHALLAPATA,estado nutricional en menores de 5 anos,clasificacion e,2003-10-01,42,32,42,32,74
50302,CHAQUI,estado nutricional en menores de 5 anos,clasificacion e,2003-10-01,15,17,15,17,32
70702,CHARAGUA,estado nutricional en menores de 5 anos,clasificacion e,2003-10-01,19,22,19,22,41
50202,CHAYANTA,estado nutricional en menores de 5 anos,clasificacion e,2003-10-01,59,51,59,51,110
31204,CHIMORE,estado nutricional en menores de 5 anos,clasificacion e,2003-10-01,2,7,2,7,9
40903,CHIPAYA,estado nutricional en menores de 5 anos,clasificacion e,2003-10-01,0,1,0,1,1
21101,CHULUMANI (V. DE LA LIBERTAD),estado nutricional en menores de 5 anos,clasificacion e,2003-10-01,1,4,1,4,5
20501,CHUMA,estado nutricional en menores de 5 anos,clasificacion e,2003-10-01,8,13,8,13,21
30801,CLIZA,estado nutricional en menores de 5 anos,clasificacion e,2003-10-01,2,0,2,0,2
90101,COBIJA,estado nutricional en menores de 5 anos,clasificacion e,2003-10-01,5,5,5,5,10
30101,COCHABAMBA,estado nutricional en menores de 5 anos,clasificacion e,2003-10-01,145,68,145,68,213
30905,COLCAPIRHUA,estado nutricional en menores de 5 anos,clasificacion e,2003-10-01,12,3,12,3,15
50901,"COLCHA ""K""",estado nutricional en menores de 5 anos,clasificacion e,2003-10-01,7,9,7,9,16
31002,COLOMI,estado nutricional en menores de 5 anos,clasificacion e,2003-10-01,32,22,32,22,54
50401,COLQUECHACA,estado nutricional en menores de 5 anos,clasificacion e,2003-10-01,102,33,102,33,135
21306,COLQUENCHA,estado nutricional en menores de 5 anos,clasificacion e,2003-10-01,8,1,8,1,9
21004,COLQUIRI,estado nutricional en menores de 5 anos,clasificacion e,2003-10-01,16,4,16,4,20
20304,COMANCHE,estado nutricional en menores de 5 anos,clasificacion e,2003-10-01,1,0,1,0,1
71301,COMARAPA,estado nutricional en menores de 5 anos,clasificacion e,2003-10-01,13,18,13,18,31
20605,COMBAYA,estado nutricional en menores de 5 anos,clasificacion e,2003-10-01,2,1,2,1,3
71101,CONCEPCION,estado nutricional en menores de 5 anos,clasificacion e,2003-10-01,1,0,1,0,1
21701,COPACABANA,estado nutricional en menores de 5 anos,clasificacion e,2003-10-01,4,1,4,1,5
20301,CORO CORO,estado nutricional en menores de 5 anos,clasificacion e,2003-10-01,7,7,7,7,14
21401,COROICO,estado nutricional en menores de 5 anos,clasificacion e,2003-10-01,3,4,3,4,7
40301,CORQUE,estado nutricional en menores de 5 anos,clasificacion e,2003-10-01,2,1,2,1,3
50601,COTAGAITA,estado nutricional en menores de 5 anos,clasificacion e,2003-10-01,93,97,93,97,190
70704,CUEVO,estado nutricional en menores de 5 anos,clasificacion e,2003-10-01,4,4,4,4,8
10902,CULPINA,estado nutricional en menores de 5 anos,clasificacion e,2003-10-01,59,53,59,53,112
40401,CURAHUARA DE CARANGAS,estado nutricional en menores de 5 anos,clasificacion e,2003-10-01,13,8,13,8,21
21602,CURVA,estado nutricional en menores de 5 anos,clasificacion e,2003-10-01,1,0,1,0,1
20804,DESAGUADERO,estado nutricional en menores de 5 anos,clasificacion e,2003-10-01,2,0,2,0,2
20105,EL ALTO,estado nutricional en menores de 5 anos,clasificacion e,2003-10-01,357,224,357,224,581
71503,EL PUENTE(STC),estado nutricional en menores de 5 anos,clasificacion e,2003-10-01,2,6,2,6,8
60502,EL PUENTE(TJA),estado nutricional en menores de 5 anos,clasificacion e,2003-10-01,15,15,15,15,30
70105,EL TORNO,estado nutricional en menores de 5 anos,clasificacion e,2003-10-01,15,13,15,13,28
10405,EL VILLAR,estado nutricional en menores de 5 anos,clasificacion e,2003-10-01,17,32,17,32,49
60601,ENTRE RIOS,estado nutricional en menores de 5 anos,clasificacion e,2003-10-01,15,20,15,20,35
41101,EUCALIPTUS,estado nutricional en menores de 5 anos,clasificacion e,2003-10-01,4,1,4,1,5
80402,EXALTACION,estado nutricional en menores de 5 anos,clasificacion e,2003-10-01,7,6,7,6,13
90203,FILADELFIA,estado nutricional en menores de 5 anos,clasificacion e,2003-10-01,0,1,0,1,1
71002,GENERAL SAAVEDRA,estado nutricional en menores de 5 anos,clasificacion e,2003-10-01,27,13,27,13,40
21601,GRAL. J.J. PEREZ (CHARAZANI),estado nutricional en menores de 5 anos,clasificacion e,2003-10-01,16,16,16,16,32
20602,GUANAY,estado nutricional en menores de 5 anos,clasificacion e,2003-10-01,29,18,29,18,47
20802,GUAQUI,estado nutricional en menores de 5 anos,clasificacion e,2003-10-01,2,1,2,1,3
80202,GUAYARAMERIN,estado nutricional en menores de 5 anos,clasificacion e,2003-10-01,45,34,45,34,79
70705,GUTIERREZ,estado nutricional en menores de 5 anos,clasificacion e,2003-10-01,29,36,29,36,65
10502,HUACARETA,estado nutricional en menores de 5 anos,clasificacion e,2003-10-01,14,27,14,27,41
11002,HUACAYA (VILLA DE HUACAYA),estado nutricional en menores de 5 anos,clasificacion e,2003-10-01,4,1,4,1,5
40701,HUANUNI,estado nutricional en menores de 5 anos,clasificacion e,2003-10-01,19,12,19,12,31
80803,HUARACAJE,estado nutricional en menores de 5 anos,clasificacion e,2003-10-01,2,2,2,2,4
41601,HUAYLLAMARCA,estado nutricional en menores de 5 anos,clasificacion e,2003-10-01,1,1,1,1,2
21005,ICHOCA,estado nutricional en menores de 5 anos,clasificacion e,2003-10-01,7,6,7,6,13
10304,ICLA,estado nutricional en menores de 5 anos,clasificacion e,2003-10-01,37,47,37,47,84
10703,INCAHUASI,estado nutricional en menores de 5 anos,clasificacion e,2003-10-01,66,48,66,48,114
21001,INQUISIVI,estado nutricional en menores de 5 anos,clasificacion e,2003-10-01,22,9,22,9,31
21501,IXIAMAS,estado nutricional en menores de 5 anos,clasificacion e,2003-10-01,4,5,4,5,9
21105,LA ASUNTA,estado nutricional en menores de 5 anos,clasificacion e,2003-10-01,10,7,10,7,17
70104,LA GUARDIA,estado nutricional en menores de 5 anos,clasificacion e,2003-10-01,11,7,11,7,18
20101,LA PAZ,estado nutricional en menores de 5 anos,clasificacion e,2003-10-01,234,171,234,171,405
70701,LAGUNILLAS,estado nutricional en menores de 5 anos,clasificacion e,2003-10-01,11,11,11,11,22
21202,LAJA,estado nutricional en menores de 5 anos,clasificacion e,2003-10-01,11,7,11,7,18
10903,LAS CARRERAS,estado nutricional en menores de 5 anos,clasificacion e,2003-10-01,3,13,3,13,16
50203,LLALLAGUA,estado nutricional en menores de 5 anos,clasificacion e,2003-10-01,40,82,40,82,122
51401,LLICA,estado nutricional en menores de 5 anos,clasificacion e,2003-10-01,3,4,3,4,7
80601,LORETO,estado nutricional en menores de 5 anos,clasificacion e,2003-10-01,1,1,1,1,2
20901,LURIBAY,estado nutricional en menores de 5 anos,clasificacion e,2003-10-01,14,16,14,16,30
40702,MACHACAMARCA,estado nutricional en menores de 5 anos,clasificacion e,2003-10-01,0,3,0,3,3
11003,MACHARETI,estado nutricional en menores de 5 anos,clasificacion e,2003-10-01,8,33,8,33,41
80801,MAGDALENA,estado nutricional en menores de 5 anos,clasificacion e,2003-10-01,1,1,1,1,2
70903,MAIRANA,estado nutricional en menores de 5 anos,clasificacion e,2003-10-01,5,0,5,0,5
20103,MECAPACA,estado nutricional en menores de 5 anos,clasificacion e,2003-10-01,3,1,3,1,4
71003,MINEROS,estado nutricional en menores de 5 anos,clasificacion e,2003-10-01,23,15,23,15,38
31301,MIZQUE,estado nutricional en menores de 5 anos,clasificacion e,2003-10-01,47,6,47,6,53
20402,MOCOMOCO,estado nutricional en menores de 5 anos,clasificacion e,2003-10-01,5,17,5,17,22
51002,MOJINETE,estado nutricional en menores de 5 anos,clasificacion e,2003-10-01,0,1,0,1,1
10303,MOJOCOYA,estado nutricional en menores de 5 anos,clasificacion e,2003-10-01,13,16,13,16,29
10501,MONTEAGUDO,estado nutricional en menores de 5 anos,clasificacion e,2003-10-01,38,42,38,42,80
71001,MONTERO,estado nutricional en menores de 5 anos,clasificacion e,2003-10-01,57,43,57,43,100
70803,MORO MORO,estado nutricional en menores de 5 anos,clasificacion e,2003-10-01,7,4,7,4,11
30302,MOROCHATA,estado nutricional en menores de 5 anos,clasificacion e,2003-10-01,37,24,37,24,61
50404,OCURI,estado nutricional en menores de 5 anos,clasificacion e,2003-10-01,34,42,34,42,76
40101,ORURO,estado nutricional en menores de 5 anos,clasificacion e,2003-10-01,112,70,112,70,182
60201,PADCAYA,estado nutricional en menores de 5 anos,clasificacion e,2003-10-01,2,5,2,5,7
10401,PADILLA,estado nutricional en menores de 5 anos,clasificacion e,2003-10-01,37,46,37,46,83
70502,PAILON,estado nutricional en menores de 5 anos,clasificacion e,2003-10-01,9,7,9,7,16
20102,PALCA,estado nutricional en menores de 5 anos,clasificacion e,2003-10-01,11,18,11,18,29
21104,PALOS BLANCOS,estado nutricional en menores de 5 anos,clasificacion e,2003-10-01,16,13,16,13,29
40802,PAMPA AULLAGAS,estado nutricional en menores de 5 anos,clasificacion e,2003-10-01,3,1,3,1,4
70902,PAMPA GRANDE,estado nutricional en menores de 5 anos,clasificacion e,2003-10-01,1,2,1,2,3
30202,PASORAPA,estado nutricional en menores de 5 anos,clasificacion e,2003-10-01,10,2,10,2,12
21305,PATACAMAYA,estado nutricional en menores de 5 anos,clasificacion e,2003-10-01,21,17,21,17,38
40602,PAZÃ‘A,estado nutricional en menores de 5 anos,clasificacion e,2003-10-01,3,1,3,1,4
20702,PELECHUCO,estado nutricional en menores de 5 anos,clasificacion e,2003-10-01,6,6,6,6,12
50403,POCOATA,estado nutricional en menores de 5 anos,clasificacion e,2003-10-01,42,44,42,44,86
31203,POCONA,estado nutricional en menores de 5 anos,clasificacion e,2003-10-01,23,16,23,16,39
31202,POJO (CBBA),estado nutricional en menores de 5 anos,clasificacion e,2003-10-01,35,19,35,19,54
40601,POOPO,estado nutricional en menores de 5 anos,clasificacion e,2003-10-01,1,0,1,0,1
51203,PORCO,estado nutricional en menores de 5 anos,clasificacion e,2003-10-01,0,1,0,1,1
10103,POROMA,estado nutricional en menores de 5 anos,clasificacion e,2003-10-01,45,55,45,55,100
70601,PORTACHUELO,estado nutricional en menores de 5 anos,clasificacion e,2003-10-01,14,11,14,11,25
90102,PORVENIR,estado nutricional en menores de 5 anos,clasificacion e,2003-10-01,0,1,0,1,1
70804,POSTRER VALLE,estado nutricional en menores de 5 anos,clasificacion e,2003-10-01,0,1,0,1,1
50101,POTOSI,estado nutricional en menores de 5 anos,clasificacion e,2003-10-01,174,116,174,116,290
10302,PRESTO,estado nutricional en menores de 5 anos,clasificacion e,2003-10-01,25,23,25,23,48
70805,PUCARA,estado nutricional en menores de 5 anos,clasificacion e,2003-10-01,0,3,0,3,3
21201,PUCARANI,estado nutricional en menores de 5 anos,clasificacion e,2003-10-01,5,5,5,5,10
20401,PUERTO ACOSTA,estado nutricional en menores de 5 anos,clasificacion e,2003-10-01,14,13,14,13,27
20403,PUERTO CARABUCO,estado nutricional en menores de 5 anos,clasificacion e,2003-10-01,11,8,11,8,19
90301,PUERTO GONZALO MORENO,estado nutricional en menores de 5 anos,clasificacion e,2003-10-01,11,5,11,5,16
21204,PUERTO PEREZ,estado nutricional en menores de 5 anos,clasificacion e,2003-10-01,1,0,1,0,1
71402,PUERTO QUIJARRO,estado nutricional en menores de 5 anos,clasificacion e,2003-10-01,3,3,3,3,6
90201,PUERTO RICO,estado nutricional en menores de 5 anos,clasificacion e,2003-10-01,0,2,0,2,2
71401,PUERTO SUAREZ,estado nutricional en menores de 5 anos,clasificacion e,2003-10-01,11,7,11,7,18
31205,PUERTO VILLARROEL,estado nutricional en menores de 5 anos,clasificacion e,2003-10-01,52,48,52,48,100
51101,PUNA,estado nutricional en menores de 5 anos,clasificacion e,2003-10-01,66,27,66,27,93
31401,PUNATA,estado nutricional en menores de 5 anos,clasificacion e,2003-10-01,12,5,12,5,17
20604,QUIABAYA,estado nutricional en menores de 5 anos,clasificacion e,2003-10-01,7,4,7,4,11
30901,QUILLACOLLO,estado nutricional en menores de 5 anos,clasificacion e,2003-10-01,18,19,18,19,37
21002,QUIME,estado nutricional en menores de 5 anos,clasificacion e,2003-10-01,20,12,20,12,32
70904,QUIRUSILLAS,estado nutricional en menores de 5 anos,clasificacion e,2003-10-01,1,0,1,0,1
50402,RAVELO,estado nutricional en menores de 5 anos,clasificacion e,2003-10-01,78,56,78,56,134
80301,REYES,estado nutricional en menores de 5 anos,clasificacion e,2003-10-01,3,13,3,13,16
80201,RIBERALTA,estado nutricional en menores de 5 anos,clasificacion e,2003-10-01,86,71,86,71,157
70503,ROBORE,estado nutricional en menores de 5 anos,clasificacion e,2003-10-01,10,8,10,8,18
80304,RURRENABAQUE,estado nutricional en menores de 5 anos,clasificacion e,2003-10-01,2,2,2,2,4
40901,SABAYA,estado nutricional en menores de 5 anos,clasificacion e,2003-10-01,0,1,0,1,1
31001,SACABA,estado nutricional en menores de 5 anos,clasificacion e,2003-10-01,30,8,30,8,38
30404,SACABAMBA,estado nutricional en menores de 5 anos,clasificacion e,2003-10-01,8,8,8,8,16
50701,SACACA,estado nutricional en menores de 5 anos,clasificacion e,2003-10-01,89,122,89,122,211
40801,SALINAS DE GARCI MENDOZA,estado nutricional en menores de 5 anos,clasificacion e,2003-10-01,3,3,3,3,6
70901,SAMAIPATA,estado nutricional en menores de 5 anos,clasificacion e,2003-10-01,3,4,3,4,7
51601,SAN AGUSTIN,estado nutricional en menores de 5 anos,clasificacion e,2003-10-01,0,2,0,2,2
80602,SAN ANDRES,estado nutricional en menores de 5 anos,clasificacion e,2003-10-01,2,11,2,11,13
51003,SAN ANTONIO DE ESMORUCO,estado nutricional en menores de 5 anos,clasificacion e,2003-10-01,1,6,1,6,7
71105,SAN ANTONIO DE LOMERIO,estado nutricional en menores de 5 anos,clasificacion e,2003-10-01,24,39,24,39,63
31403,SAN BENITO,estado nutricional en menores de 5 anos,clasificacion e,2003-10-01,4,3,4,3,7
80302,SAN BORJA,estado nutricional en menores de 5 anos,clasificacion e,2003-10-01,48,24,48,24,72
21502,SAN BUENA VENTURA,estado nutricional en menores de 5 anos,clasificacion e,2003-10-01,15,7,15,7,22
70402,SAN CARLOS,estado nutricional en menores de 5 anos,clasificacion e,2003-10-01,4,11,4,11,15
80501,SAN IGNACIO,estado nutricional en menores de 5 anos,clasificacion e,2003-10-01,33,22,33,22,55
70301,SAN IGNACIO DE VELASCO,estado nutricional en menores de 5 anos,clasificacion e,2003-10-01,63,37,63,37,100
80102,SAN JAVIER(BNI),estado nutricional en menores de 5 anos,clasificacion e,2003-10-01,3,0,3,0,3
71102,SAN JAVIER(STC),estado nutricional en menores de 5 anos,clasificacion e,2003-10-01,8,4,8,4,12
70501,SAN JOSE DE CHIQUITOS,estado nutricional en menores de 5 anos,clasificacion e,2003-10-01,8,6,8,6,14
71104,SAN JULIAN,estado nutricional en menores de 5 anos,clasificacion e,2003-10-01,33,26,33,26,59
60501,SAN LORENZO(TJA),estado nutricional en menores de 5 anos,clasificacion e,2003-10-01,11,17,11,17,28
10702,SAN LUCAS,estado nutricional en menores de 5 anos,clasificacion e,2003-10-01,142,120,142,120,262
71201,SAN MATIAS,estado nutricional en menores de 5 anos,clasificacion e,2003-10-01,27,11,27,11,38
70302,SAN MIGUEL DE VELASCO,estado nutricional en menores de 5 anos,clasificacion e,2003-10-01,24,16,24,16,40
51001,SAN PABLO DE LIPEZ,estado nutricional en menores de 5 anos,clasificacion e,2003-10-01,4,2,4,2,6
50501,SAN PEDRO DE BUENA VISTA,estado nutricional en menores de 5 anos,clasificacion e,2003-10-01,66,84,66,84,150
21801,SAN PEDRO DE CURAHUARA,estado nutricional en menores de 5 anos,clasificacion e,2003-10-01,2,2,2,2,4
50902,SAN PEDRO DE QUEMES,estado nutricional en menores de 5 anos,clasificacion e,2003-10-01,0,1,0,1,1
90202,SAN PEDRO(PND),estado nutricional en menores de 5 anos,clasificacion e,2003-10-01,1,1,1,1,2
70303,SAN RAFAEL,estado nutricional en menores de 5 anos,clasificacion e,2003-10-01,18,21,18,21,39
80401,SANTA ANA,estado nutricional en menores de 5 anos,clasificacion e,2003-10-01,8,6,8,6,14
70101,SANTA CRUZ DE LA SIERRA,estado nutricional en menores de 5 anos,clasificacion e,2003-10-01,233,84,233,84,317
80303,SANTA ROSA,estado nutricional en menores de 5 anos,clasificacion e,2003-10-01,2,1,2,1,3
70602,SANTA ROSA DEL SARA,estado nutricional en menores de 5 anos,clasificacion e,2003-10-01,1,9,1,9,10
20308,SANTIAGO DE CALLAPA,estado nutricional en menores de 5 anos,clasificacion e,2003-10-01,5,7,5,7,12
41401,SANTIAGO DE HUARI,estado nutricional en menores de 5 anos,clasificacion e,2003-10-01,6,6,6,6,12
21901,SANTIAGO DE MACHACA,estado nutricional en menores de 5 anos,clasificacion e,2003-10-01,3,1,3,1,4
30702,SANTIVAÃ‘ES,estado nutricional en menores de 5 anos,clasificacion e,2003-10-01,5,4,5,4,9
20902,SAPAHAQUI,estado nutricional en menores de 5 anos,clasificacion e,2003-10-01,13,10,13,10,23
90303,SENA,estado nutricional en menores de 5 anos,clasificacion e,2003-10-01,1,0,1,0,1
21301,SICA SICA (VILLA AROMA),estado nutricional en menores de 5 anos,clasificacion e,2003-10-01,50,29,50,29,79
30703,SICAYA,estado nutricional en menores de 5 anos,clasificacion e,2003-10-01,10,5,10,5,15
30902,SIPE SIPE,estado nutricional en menores de 5 anos,clasificacion e,2003-10-01,32,32,32,32,64
10403,SOPACHUY,estado nutricional en menores de 5 anos,clasificacion e,2003-10-01,39,47,39,47,86
20601,SORATA,estado nutricional en menores de 5 anos,clasificacion e,2003-10-01,9,21,9,21,30
10101,SUCRE,estado nutricional en menores de 5 anos,clasificacion e,2003-10-01,103,93,103,93,196
31404,TACACHI,estado nutricional en menores de 5 anos,clasificacion e,2003-10-01,1,0,1,0,1
20603,TACACOMA,estado nutricional en menores de 5 anos,clasificacion e,2003-10-01,0,2,0,2,2
50303,TACOBAMBA,estado nutricional en menores de 5 anos,clasificacion e,2003-10-01,19,38,19,38,57
30602,TACOPAYA,estado nutricional en menores de 5 anos,clasificacion e,2003-10-01,37,36,37,36,73
31101,TAPACARI,estado nutricional en menores de 5 anos,clasificacion e,2003-10-01,47,27,47,27,74
10601,TARABUCO,estado nutricional en menores de 5 anos,clasificacion e,2003-10-01,129,124,129,124,253
30401,TARATA,estado nutricional en menores de 5 anos,clasificacion e,2003-10-01,16,5,16,5,21
60101,TARIJA,estado nutricional en menores de 5 anos,clasificacion e,2003-10-01,43,39,43,39,82
10202,TARVITA,estado nutricional en menores de 5 anos,clasificacion e,2003-10-01,45,56,45,56,101
20803,TIAWANACU,estado nutricional en menores de 5 anos,clasificacion e,2003-10-01,3,3,3,3,6
50102,TINGUIPAYA,estado nutricional en menores de 5 anos,clasificacion e,2003-10-01,68,83,68,83,151
20606,TIPUANI,estado nutricional en menores de 5 anos,clasificacion e,2003-10-01,2,3,2,3,5
30903,TIQUIPAYA,estado nutricional en menores de 5 anos,clasificacion e,2003-10-01,22,15,22,15,37
31601,TIRAQUE (CBBA),estado nutricional en menores de 5 anos,clasificacion e,2003-10-01,50,28,50,28,78
21703,TITO YUPANQUI (PARQUIPUJIO),estado nutricional en menores de 5 anos,clasificacion e,2003-10-01,3,2,3,2,5
30802,TOCO,estado nutricional en menores de 5 anos,clasificacion e,2003-10-01,0,3,0,3,3
30803,TOLATA,estado nutricional en menores de 5 anos,clasificacion e,2003-10-01,5,2,5,2,7
41001,TOLEDO,estado nutricional en menores de 5 anos,clasificacion e,2003-10-01,1,1,1,1,2
51202,TOMAVE,estado nutricional en menores de 5 anos,clasificacion e,2003-10-01,19,16,19,16,35
10402,TOMINA,estado nutricional en menores de 5 anos,clasificacion e,2003-10-01,45,64,45,64,109
50502,TORO TORO,estado nutricional en menores de 5 anos,clasificacion e,2003-10-01,36,21,36,21,57
31201,TOTORA(CBBA),estado nutricional en menores de 5 anos,clasificacion e,2003-10-01,14,10,14,10,24
41301,TOTORA(ORR),estado nutricional en menores de 5 anos,clasificacion e,2003-10-01,5,1,5,1,6
70802,TRIGAL,estado nutricional en menores de 5 anos,clasificacion e,2003-10-01,2,0,2,0,2
80101,TRINIDAD,estado nutricional en menores de 5 anos,clasificacion e,2003-10-01,40,38,40,38,78
50801,TUPIZA,estado nutricional en menores de 5 anos,clasificacion e,2003-10-01,32,53,32,53,85
40402,TURCO,estado nutricional en menores de 5 anos,clasificacion e,2003-10-01,1,1,1,1,2
21302,UMALA,estado nutricional en menores de 5 anos,clasificacion e,2003-10-01,6,10,6,10,16
50201,UNCIA,estado nutricional en menores de 5 anos,clasificacion e,2003-10-01,13,1,13,1,14
60401,URIONDO (A. CONCEPCION),estado nutricional en menores de 5 anos,clasificacion e,2003-10-01,6,15,6,15,21
71502,URUBICHA,estado nutricional en menores de 5 anos,clasificacion e,2003-10-01,31,30,31,30,61
51201,UYUNI,estado nutricional en menores de 5 anos,clasificacion e,2003-10-01,10,16,10,16,26
30502,VACAS,estado nutricional en menores de 5 anos,clasificacion e,2003-10-01,6,3,6,3,9
70801,VALLEGRANDE,estado nutricional en menores de 5 anos,clasificacion e,2003-10-01,9,18,9,18,27
20801,VIACHA,estado nutricional en menores de 5 anos,clasificacion e,2003-10-01,20,19,20,19,39
31302,VILA VILA,estado nutricional en menores de 5 anos,clasificacion e,2003-10-01,19,6,19,6,25
60303,VILLA MONTES,estado nutricional en menores de 5 anos,clasificacion e,2003-10-01,16,15,16,15,31
31402,VILLA RIVERO,estado nutricional en menores de 5 anos,clasificacion e,2003-10-01,10,8,10,8,18
10801,VILLA SERRANO,estado nutricional en menores de 5 anos,clasificacion e,2003-10-01,44,57,44,57,101
31003,VILLA TUNARI,estado nutricional en menores de 5 anos,clasificacion e,2003-10-01,73,46,73,46,119
11001,VILLA VACA GUZMAN (MUYUPAMPA),estado nutricional en menores de 5 anos,clasificacion e,2003-10-01,21,21,21,21,42
51501,VILLAZON,estado nutricional en menores de 5 anos,clasificacion e,2003-10-01,22,26,22,26,48
30904,VINTO,estado nutricional en menores de 5 anos,clasificacion e,2003-10-01,24,7,24,7,31
50602,VITICHI,estado nutricional en menores de 5 anos,clasificacion e,2003-10-01,46,69,46,69,115
20306,WALDO BALLIVIAN,estado nutricional en menores de 5 anos,clasificacion e,2003-10-01,0,3,0,3,3
20903,YACO,estado nutricional en menores de 5 anos,clasificacion e,2003-10-01,33,29,33,29,62
60301,YACUIBA,estado nutricional en menores de 5 anos,clasificacion e,2003-10-01,4,2,4,2,6
10602,YAMPARAEZ,estado nutricional en menores de 5 anos,clasificacion e,2003-10-01,62,50,62,50,112
21103,YANACACHI,estado nutricional en menores de 5 anos,clasificacion e,2003-10-01,4,1,4,1,5
70403,YAPACANI,estado nutricional en menores de 5 anos,clasificacion e,2003-10-01,20,29,20,29,49
50103,YOCALLA,estado nutricional en menores de 5 anos,clasificacion e,2003-10-01,4,6,4,6,10
10102,YOTALA,estado nutricional en menores de 5 anos,clasificacion e,2003-10-01,30,35,30,35,65
60402,YUNCHARA,estado nutricional en menores de 5 anos,clasificacion e,2003-10-01,21,25,21,25,46
10301,ZUDAÃ‘EZ,estado nutricional en menores de 5 anos,clasificacion e,2003-10-01,21,30,21,30,51
51302,ACACIO,estado nutricional en menores de 5 anos,clasificacion e,2003-11-01,29,21,29,21,50
20201,ACHACACHI,estado nutricional en menores de 5 anos,clasificacion e,2003-11-01,19,10,19,10,29
20104,ACHOCALLA,estado nutricional en menores de 5 anos,clasificacion e,2003-11-01,4,9,4,9,13
30201,AIQUILE,estado nutricional en menores de 5 anos,clasificacion e,2003-11-01,18,16,18,16,34
31303,ALALAY,estado nutricional en menores de 5 anos,clasificacion e,2003-11-01,4,1,4,1,5
10404,ALCALA,estado nutricional en menores de 5 anos,clasificacion e,2003-11-01,9,27,9,27,36
20202,ANCORAIMES,estado nutricional en menores de 5 anos,clasificacion e,2003-11-01,7,6,7,6,13
41201,ANDAMARCA,estado nutricional en menores de 5 anos,clasificacion e,2003-11-01,2,0,2,0,2
40603,ANTEQUERA,estado nutricional en menores de 5 anos,clasificacion e,2003-11-01,1,0,1,0,1
30402,ANZALDO,estado nutricional en menores de 5 anos,clasificacion e,2003-11-01,2,4,2,4,6
20701,APOLO,estado nutricional en menores de 5 anos,clasificacion e,2003-11-01,9,9,9,9,18
51301,ARAMPAMPA,estado nutricional en menores de 5 anos,clasificacion e,2003-11-01,10,20,10,20,30
30501,ARANI,estado nutricional en menores de 5 anos,clasificacion e,2003-11-01,14,10,14,10,24
30403,ARBIETO,estado nutricional en menores de 5 anos,clasificacion e,2003-11-01,5,2,5,2,7
30601,ARQUE,estado nutricional en menores de 5 anos,clasificacion e,2003-11-01,20,30,20,30,50
50802,ATOCHA,estado nutricional en menores de 5 anos,clasificacion e,2003-11-01,22,32,22,32,54
20503,AUCAPATA,estado nutricional en menores de 5 anos,clasificacion e,2003-11-01,32,6,32,6,38
20502,AYATA,estado nutricional en menores de 5 anos,clasificacion e,2003-11-01,37,21,37,21,58
21303,AYO AYO,estado nutricional en menores de 5 anos,clasificacion e,2003-11-01,4,2,4,2,6
30301,AYOPAYA (V. DE INDEPENDENCIA),estado nutricional en menores de 5 anos,clasificacion e,2003-11-01,8,10,8,10,18
10201,AZURDUY,estado nutricional en menores de 5 anos,clasificacion e,2003-11-01,54,57,54,57,111
21203,BATALLAS,estado nutricional en menores de 5 anos,clasificacion e,2003-11-01,4,2,4,2,6
80802,BAURES,estado nutricional en menores de 5 anos,clasificacion e,2003-11-01,3,2,3,2,5
50104,BELEN DE URMIRI,estado nutricional en menores de 5 anos,clasificacion e,2003-11-01,4,2,4,2,6
90104,BELLA FLOR,estado nutricional en menores de 5 anos,clasificacion e,2003-11-01,0,1,0,1,1
60202,BERMEJO,estado nutricional en menores de 5 anos,clasificacion e,2003-11-01,3,6,3,6,9
50301,BETANZOS,estado nutricional en menores de 5 anos,clasificacion e,2003-11-01,104,88,104,88,192
31501,BOLIVAR,estado nutricional en menores de 5 anos,clasificacion e,2003-11-01,22,17,22,17,39
90103,BOLPEBRA,estado nutricional en menores de 5 anos,clasificacion e,2003-11-01,2,0,2,0,2
70707,BOYUIBE,estado nutricional en menores de 5 anos,clasificacion e,2003-11-01,1,2,1,2,3
70401,BUENA VISTA,estado nutricional en menores de 5 anos,clasificacion e,2003-11-01,4,12,4,12,16
70703,CABEZAS,estado nutricional en menores de 5 anos,clasificacion e,2003-11-01,7,11,7,11,18
20905,CAIROMA,estado nutricional en menores de 5 anos,clasificacion e,2003-11-01,15,11,15,11,26
51102,"CAIZA ""D""",estado nutricional en menores de 5 anos,clasificacion e,2003-11-01,5,3,5,3,8
21003,CAJUATA,estado nutricional en menores de 5 anos,clasificacion e,2003-11-01,9,5,9,5,14
21304,CALAMARCA,estado nutricional en menores de 5 anos,clasificacion e,2003-11-01,34,26,34,26,60
10701,CAMARGO,estado nutricional en menores de 5 anos,clasificacion e,2003-11-01,15,26,15,26,41
10901,CAMATAQUI (C. VILLA ABECIA),estado nutricional en menores de 5 anos,clasificacion e,2003-11-01,2,3,2,3,5
70706,CAMIRI,estado nutricional en menores de 5 anos,clasificacion e,2003-11-01,25,13,25,13,38
30701,CAPINOTA,estado nutricional en menores de 5 anos,clasificacion e,2003-11-01,24,21,24,21,45
20302,CAQUIAVIRI,estado nutricional en menores de 5 anos,clasificacion e,2003-11-01,2,2,2,2,4
40102,CARACOLLO,estado nutricional en menores de 5 anos,clasificacion e,2003-11-01,16,5,16,5,21
22001,CARANAVI,estado nutricional en menores de 5 anos,clasificacion e,2003-11-01,44,52,44,52,96
60302,CARAPARI,estado nutricional en menores de 5 anos,clasificacion e,2003-11-01,7,7,7,7,14
50702,CARIPUYO,estado nutricional en menores de 5 anos,clasificacion e,2003-11-01,34,25,34,25,59
21803,CHACARILLA,estado nutricional en menores de 5 anos,clasificacion e,2003-11-01,0,2,0,2,2
40201,CHALLAPATA,estado nutricional en menores de 5 anos,clasificacion e,2003-11-01,35,25,35,25,60
50302,CHAQUI,estado nutricional en menores de 5 anos,clasificacion e,2003-11-01,11,12,11,12,23
70702,CHARAGUA,estado nutricional en menores de 5 anos,clasificacion e,2003-11-01,30,19,30,19,49
20305,CHARAÃ‘A,estado nutricional en menores de 5 anos,clasificacion e,2003-11-01,2,1,2,1,3
50202,CHAYANTA,estado nutricional en menores de 5 anos,clasificacion e,2003-11-01,38,38,38,38,76
31204,CHIMORE,estado nutricional en menores de 5 anos,clasificacion e,2003-11-01,4,15,4,15,19
40302,CHOQUE COTA,estado nutricional en menores de 5 anos,clasificacion e,2003-11-01,3,3,3,3,6
21101,CHULUMANI (V. DE LA LIBERTAD),estado nutricional en menores de 5 anos,clasificacion e,2003-11-01,3,18,3,18,21
20501,CHUMA,estado nutricional en menores de 5 anos,clasificacion e,2003-11-01,18,12,18,12,30
30801,CLIZA,estado nutricional en menores de 5 anos,clasificacion e,2003-11-01,3,3,3,3,6
90101,COBIJA,estado nutricional en menores de 5 anos,clasificacion e,2003-11-01,18,15,18,15,33
30101,COCHABAMBA,estado nutricional en menores de 5 anos,clasificacion e,2003-11-01,122,80,122,80,202
30905,COLCAPIRHUA,estado nutricional en menores de 5 anos,clasificacion e,2003-11-01,11,5,11,5,16
50901,"COLCHA ""K""",estado nutricional en menores de 5 anos,clasificacion e,2003-11-01,1,11,1,11,12
31002,COLOMI,estado nutricional en menores de 5 anos,clasificacion e,2003-11-01,15,18,15,18,33
50401,COLQUECHACA,estado nutricional en menores de 5 anos,clasificacion e,2003-11-01,84,57,84,57,141
21306,COLQUENCHA,estado nutricional en menores de 5 anos,clasificacion e,2003-11-01,5,5,5,5,10
21004,COLQUIRI,estado nutricional en menores de 5 anos,clasificacion e,2003-11-01,15,11,15,11,26
20304,COMANCHE,estado nutricional en menores de 5 anos,clasificacion e,2003-11-01,5,4,5,4,9
71301,COMARAPA,estado nutricional en menores de 5 anos,clasificacion e,2003-11-01,17,15,17,15,32
20605,COMBAYA,estado nutricional en menores de 5 anos,clasificacion e,2003-11-01,2,5,2,5,7
71101,CONCEPCION,estado nutricional en menores de 5 anos,clasificacion e,2003-11-01,0,1,0,1,1
21701,COPACABANA,estado nutricional en menores de 5 anos,clasificacion e,2003-11-01,5,5,5,5,10
21402,CORIPATA,estado nutricional en menores de 5 anos,clasificacion e,2003-11-01,3,0,3,0,3
20301,CORO CORO,estado nutricional en menores de 5 anos,clasificacion e,2003-11-01,5,4,5,4,9
21401,COROICO,estado nutricional en menores de 5 anos,clasificacion e,2003-11-01,2,4,2,4,6
40301,CORQUE,estado nutricional en menores de 5 anos,clasificacion e,2003-11-01,11,3,11,3,14
50601,COTAGAITA,estado nutricional en menores de 5 anos,clasificacion e,2003-11-01,65,95,65,95,160
70704,CUEVO,estado nutricional en menores de 5 anos,clasificacion e,2003-11-01,2,1,2,1,3
10902,CULPINA,estado nutricional en menores de 5 anos,clasificacion e,2003-11-01,66,53,66,53,119
40401,CURAHUARA DE CARANGAS,estado nutricional en menores de 5 anos,clasificacion e,2003-11-01,7,4,7,4,11
21602,CURVA,estado nutricional en menores de 5 anos,clasificacion e,2003-11-01,3,4,3,4,7
20804,DESAGUADERO,estado nutricional en menores de 5 anos,clasificacion e,2003-11-01,2,2,2,2,4
20105,EL ALTO,estado nutricional en menores de 5 anos,clasificacion e,2003-11-01,372,235,372,235,607
71503,EL PUENTE(STC),estado nutricional en menores de 5 anos,clasificacion e,2003-11-01,11,7,11,7,18
60502,EL PUENTE(TJA),estado nutricional en menores de 5 anos,clasificacion e,2003-11-01,9,14,9,14,23
70105,EL TORNO,estado nutricional en menores de 5 anos,clasificacion e,2003-11-01,15,16,15,16,31
10405,EL VILLAR,estado nutricional en menores de 5 anos,clasificacion e,2003-11-01,25,31,25,31,56
60601,ENTRE RIOS,estado nutricional en menores de 5 anos,clasificacion e,2003-11-01,18,10,18,10,28
41101,EUCALIPTUS,estado nutricional en menores de 5 anos,clasificacion e,2003-11-01,6,2,6,2,8
80402,EXALTACION,estado nutricional en menores de 5 anos,clasificacion e,2003-11-01,3,4,3,4,7
90203,FILADELFIA,estado nutricional en menores de 5 anos,clasificacion e,2003-11-01,0,1,0,1,1
71002,GENERAL SAAVEDRA,estado nutricional en menores de 5 anos,clasificacion e,2003-11-01,17,24,17,24,41
21601,GRAL. J.J. PEREZ (CHARAZANI),estado nutricional en menores de 5 anos,clasificacion e,2003-11-01,28,39,28,39,67
20602,GUANAY,estado nutricional en menores de 5 anos,clasificacion e,2003-11-01,33,35,33,35,68
20802,GUAQUI,estado nutricional en menores de 5 anos,clasificacion e,2003-11-01,1,5,1,5,6
80202,GUAYARAMERIN,estado nutricional en menores de 5 anos,clasificacion e,2003-11-01,24,22,24,22,46
70705,GUTIERREZ,estado nutricional en menores de 5 anos,clasificacion e,2003-11-01,28,42,28,42,70
10502,HUACARETA,estado nutricional en menores de 5 anos,clasificacion e,2003-11-01,15,21,15,21,36
11002,HUACAYA (VILLA DE HUACAYA),estado nutricional en menores de 5 anos,clasificacion e,2003-11-01,4,3,4,3,7
40501,HUACHACALLA,estado nutricional en menores de 5 anos,clasificacion e,2003-11-01,0,2,0,2,2
40701,HUANUNI,estado nutricional en menores de 5 anos,clasificacion e,2003-11-01,10,10,10,10,20
80803,HUARACAJE,estado nutricional en menores de 5 anos,clasificacion e,2003-11-01,2,0,2,0,2
41601,HUAYLLAMARCA,estado nutricional en menores de 5 anos,clasificacion e,2003-11-01,2,1,2,1,3
21005,ICHOCA,estado nutricional en menores de 5 anos,clasificacion e,2003-11-01,6,3,6,3,9
10304,ICLA,estado nutricional en menores de 5 anos,clasificacion e,2003-11-01,62,64,62,64,126
10703,INCAHUASI,estado nutricional en menores de 5 anos,clasificacion e,2003-11-01,88,45,88,45,133
21001,INQUISIVI,estado nutricional en menores de 5 anos,clasificacion e,2003-11-01,29,22,29,22,51
21102,IRUPANA (VILLA DE LANZA),estado nutricional en menores de 5 anos,clasificacion e,2003-11-01,2,4,2,4,6
21501,IXIAMAS,estado nutricional en menores de 5 anos,clasificacion e,2003-11-01,11,10,11,10,21
21105,LA ASUNTA,estado nutricional en menores de 5 anos,clasificacion e,2003-11-01,15,14,15,14,29
70104,LA GUARDIA,estado nutricional en menores de 5 anos,clasificacion e,2003-11-01,9,7,9,7,16
20101,LA PAZ,estado nutricional en menores de 5 anos,clasificacion e,2003-11-01,217,157,217,157,374
70701,LAGUNILLAS,estado nutricional en menores de 5 anos,clasificacion e,2003-11-01,8,5,8,5,13
21202,LAJA,estado nutricional en menores de 5 anos,clasificacion e,2003-11-01,5,0,5,0,5
10903,LAS CARRERAS,estado nutricional en menores de 5 anos,clasificacion e,2003-11-01,2,7,2,7,9
21006,LICOMA PAMPA,estado nutricional en menores de 5 anos,clasificacion e,2003-11-01,0,2,0,2,2
50203,LLALLAGUA,estado nutricional en menores de 5 anos,clasificacion e,2003-11-01,82,73,82,73,155
51401,LLICA,estado nutricional en menores de 5 anos,clasificacion e,2003-11-01,3,2,3,2,5
80601,LORETO,estado nutricional en menores de 5 anos,clasificacion e,2003-11-01,1,0,1,0,1
20901,LURIBAY,estado nutricional en menores de 5 anos,clasificacion e,2003-11-01,6,3,6,3,9
40702,MACHACAMARCA,estado nutricional en menores de 5 anos,clasificacion e,2003-11-01,0,1,0,1,1
11003,MACHARETI,estado nutricional en menores de 5 anos,clasificacion e,2003-11-01,10,20,10,20,30
80801,MAGDALENA,estado nutricional en menores de 5 anos,clasificacion e,2003-11-01,2,2,2,2,4
70903,MAIRANA,estado nutricional en menores de 5 anos,clasificacion e,2003-11-01,4,1,4,1,5
20103,MECAPACA,estado nutricional en menores de 5 anos,clasificacion e,2003-11-01,2,5,2,5,7
31301,MIZQUE,estado nutricional en menores de 5 anos,clasificacion e,2003-11-01,11,5,11,5,16
20402,MOCOMOCO,estado nutricional en menores de 5 anos,clasificacion e,2003-11-01,20,22,20,22,42
51002,MOJINETE,estado nutricional en menores de 5 anos,clasificacion e,2003-11-01,2,1,2,1,3
10303,MOJOCOYA,estado nutricional en menores de 5 anos,clasificacion e,2003-11-01,17,14,17,14,31
10501,MONTEAGUDO,estado nutricional en menores de 5 anos,clasificacion e,2003-11-01,40,40,40,40,80
70803,MORO MORO,estado nutricional en menores de 5 anos,clasificacion e,2003-11-01,1,5,1,5,6
30302,MOROCHATA,estado nutricional en menores de 5 anos,clasificacion e,2003-11-01,29,21,29,21,50
50404,OCURI,estado nutricional en menores de 5 anos,clasificacion e,2003-11-01,46,40,46,40,86
30203,OMEREQUE,estado nutricional en menores de 5 anos,clasificacion e,2003-11-01,5,5,5,5,10
40101,ORURO,estado nutricional en menores de 5 anos,clasificacion e,2003-11-01,127,68,127,68,195
60201,PADCAYA,estado nutricional en menores de 5 anos,clasificacion e,2003-11-01,9,2,9,2,11
10401,PADILLA,estado nutricional en menores de 5 anos,clasificacion e,2003-11-01,34,42,34,42,76
70502,PAILON,estado nutricional en menores de 5 anos,clasificacion e,2003-11-01,5,7,5,7,12
20102,PALCA,estado nutricional en menores de 5 anos,clasificacion e,2003-11-01,16,23,16,23,39
21104,PALOS BLANCOS,estado nutricional en menores de 5 anos,clasificacion e,2003-11-01,16,21,16,21,37
40802,PAMPA AULLAGAS,estado nutricional en menores de 5 anos,clasificacion e,2003-11-01,4,4,4,4,8
70902,PAMPA GRANDE,estado nutricional en menores de 5 anos,clasificacion e,2003-11-01,2,2,2,2,4
30202,PASORAPA,estado nutricional en menores de 5 anos,clasificacion e,2003-11-01,5,2,5,2,7
21305,PATACAMAYA,estado nutricional en menores de 5 anos,clasificacion e,2003-11-01,20,17,20,17,37
40602,PAZÃ‘A,estado nutricional en menores de 5 anos,clasificacion e,2003-11-01,1,2,1,2,3
20702,PELECHUCO,estado nutricional en menores de 5 anos,clasificacion e,2003-11-01,7,14,7,14,21
50403,POCOATA,estado nutricional en menores de 5 anos,clasificacion e,2003-11-01,45,44,45,44,89
31203,POCONA,estado nutricional en menores de 5 anos,clasificacion e,2003-11-01,10,7,10,7,17
31202,POJO (CBBA),estado nutricional en menores de 5 anos,clasificacion e,2003-11-01,56,28,56,28,84
40601,POOPO,estado nutricional en menores de 5 anos,clasificacion e,2003-11-01,2,3,2,3,5
51203,PORCO,estado nutricional en menores de 5 anos,clasificacion e,2003-11-01,5,11,5,11,16
10103,POROMA,estado nutricional en menores de 5 anos,clasificacion e,2003-11-01,39,50,39,50,89
70103,PORONGO,estado nutricional en menores de 5 anos,clasificacion e,2003-11-01,1,0,1,0,1
70601,PORTACHUELO,estado nutricional en menores de 5 anos,clasificacion e,2003-11-01,10,7,10,7,17
90102,PORVENIR,estado nutricional en menores de 5 anos,clasificacion e,2003-11-01,3,3,3,3,6
70804,POSTRER VALLE,estado nutricional en menores de 5 anos,clasificacion e,2003-11-01,1,0,1,0,1
50101,POTOSI,estado nutricional en menores de 5 anos,clasificacion e,2003-11-01,135,104,135,104,239
10302,PRESTO,estado nutricional en menores de 5 anos,clasificacion e,2003-11-01,26,31,26,31,57
21201,PUCARANI,estado nutricional en menores de 5 anos,clasificacion e,2003-11-01,11,6,11,6,17
20401,PUERTO ACOSTA,estado nutricional en menores de 5 anos,clasificacion e,2003-11-01,19,15,19,15,34
20403,PUERTO CARABUCO,estado nutricional en menores de 5 anos,clasificacion e,2003-11-01,12,14,12,14,26
90301,PUERTO GONZALO MORENO,estado nutricional en menores de 5 anos,clasificacion e,2003-11-01,21,19,21,19,40
21204,PUERTO PEREZ,estado nutricional en menores de 5 anos,clasificacion e,2003-11-01,2,0,2,0,2
71402,PUERTO QUIJARRO,estado nutricional en menores de 5 anos,clasificacion e,2003-11-01,4,2,4,2,6
90201,PUERTO RICO,estado nutricional en menores de 5 anos,clasificacion e,2003-11-01,0,1,0,1,1
71401,PUERTO SUAREZ,estado nutricional en menores de 5 anos,clasificacion e,2003-11-01,5,1,5,1,6
31205,PUERTO VILLARROEL,estado nutricional en menores de 5 anos,clasificacion e,2003-11-01,51,69,51,69,120
51101,PUNA,estado nutricional en menores de 5 anos,clasificacion e,2003-11-01,61,44,61,44,105
31401,PUNATA,estado nutricional en menores de 5 anos,clasificacion e,2003-11-01,8,6,8,6,14
20604,QUIABAYA,estado nutricional en menores de 5 anos,clasificacion e,2003-11-01,2,6,2,6,8
30901,QUILLACOLLO,estado nutricional en menores de 5 anos,clasificacion e,2003-11-01,29,24,29,24,53
21002,QUIME,estado nutricional en menores de 5 anos,clasificacion e,2003-11-01,10,10,10,10,20
70904,QUIRUSILLAS,estado nutricional en menores de 5 anos,clasificacion e,2003-11-01,0,2,0,2,2
50402,RAVELO,estado nutricional en menores de 5 anos,clasificacion e,2003-11-01,71,79,71,79,150
80301,REYES,estado nutricional en menores de 5 anos,clasificacion e,2003-11-01,11,14,11,14,25
80201,RIBERALTA,estado nutricional en menores de 5 anos,clasificacion e,2003-11-01,93,51,93,51,144
70503,ROBORE,estado nutricional en menores de 5 anos,clasificacion e,2003-11-01,6,1,6,1,7
80304,RURRENABAQUE,estado nutricional en menores de 5 anos,clasificacion e,2003-11-01,5,2,5,2,7
31001,SACABA,estado nutricional en menores de 5 anos,clasificacion e,2003-11-01,36,43,36,43,79
30404,SACABAMBA,estado nutricional en menores de 5 anos,clasificacion e,2003-11-01,5,7,5,7,12
50701,SACACA,estado nutricional en menores de 5 anos,clasificacion e,2003-11-01,77,106,77,106,183
71302,SAIPINA,estado nutricional en menores de 5 anos,clasificacion e,2003-11-01,1,4,1,4,5
40801,SALINAS DE GARCI MENDOZA,estado nutricional en menores de 5 anos,clasificacion e,2003-11-01,3,3,3,3,6
70901,SAMAIPATA,estado nutricional en menores de 5 anos,clasificacion e,2003-11-01,9,0,9,0,9
80602,SAN ANDRES,estado nutricional en menores de 5 anos,clasificacion e,2003-11-01,8,7,8,7,15
51003,SAN ANTONIO DE ESMORUCO,estado nutricional en menores de 5 anos,clasificacion e,2003-11-01,1,0,1,0,1
71105,SAN ANTONIO DE LOMERIO,estado nutricional en menores de 5 anos,clasificacion e,2003-11-01,26,44,26,44,70
80302,SAN BORJA,estado nutricional en menores de 5 anos,clasificacion e,2003-11-01,44,36,44,36,80
21502,SAN BUENA VENTURA,estado nutricional en menores de 5 anos,clasificacion e,2003-11-01,10,17,10,17,27
70402,SAN CARLOS,estado nutricional en menores de 5 anos,clasificacion e,2003-11-01,6,7,6,7,13
80501,SAN IGNACIO,estado nutricional en menores de 5 anos,clasificacion e,2003-11-01,49,24,49,24,73
70301,SAN IGNACIO DE VELASCO,estado nutricional en menores de 5 anos,clasificacion e,2003-11-01,72,61,72,61,133
80102,SAN JAVIER(BNI),estado nutricional en menores de 5 anos,clasificacion e,2003-11-01,0,1,0,1,1
71102,SAN JAVIER(STC),estado nutricional en menores de 5 anos,clasificacion e,2003-11-01,19,18,19,18,37
70501,SAN JOSE DE CHIQUITOS,estado nutricional en menores de 5 anos,clasificacion e,2003-11-01,6,2,6,2,8
71104,SAN JULIAN,estado nutricional en menores de 5 anos,clasificacion e,2003-11-01,47,32,47,32,79
90302,SAN LORENZO(PND),estado nutricional en menores de 5 anos,clasificacion e,2003-11-01,1,0,1,0,1
60501,SAN LORENZO(TJA),estado nutricional en menores de 5 anos,clasificacion e,2003-11-01,9,26,9,26,35
10702,SAN LUCAS,estado nutricional en menores de 5 anos,clasificacion e,2003-11-01,163,117,163,117,280
70302,SAN MIGUEL DE VELASCO,estado nutricional en menores de 5 anos,clasificacion e,2003-11-01,6,4,6,4,10
51001,SAN PABLO DE LIPEZ,estado nutricional en menores de 5 anos,clasificacion e,2003-11-01,2,10,2,10,12
50501,SAN PEDRO DE BUENA VISTA,estado nutricional en menores de 5 anos,clasificacion e,2003-11-01,50,73,50,73,123
21801,SAN PEDRO DE CURAHUARA,estado nutricional en menores de 5 anos,clasificacion e,2003-11-01,4,8,4,8,12
21702,SAN PEDRO DE TIQUINA,estado nutricional en menores de 5 anos,clasificacion e,2003-11-01,1,3,1,3,4
70303,SAN RAFAEL,estado nutricional en menores de 5 anos,clasificacion e,2003-11-01,11,7,11,7,18
80401,SANTA ANA,estado nutricional en menores de 5 anos,clasificacion e,2003-11-01,7,2,7,2,9
70101,SANTA CRUZ DE LA SIERRA,estado nutricional en menores de 5 anos,clasificacion e,2003-11-01,74,32,74,32,106
80303,SANTA ROSA,estado nutricional en menores de 5 anos,clasificacion e,2003-11-01,2,0,2,0,2
70602,SANTA ROSA DEL SARA,estado nutricional en menores de 5 anos,clasificacion e,2003-11-01,2,0,2,0,2
20308,SANTIAGO DE CALLAPA,estado nutricional en menores de 5 anos,clasificacion e,2003-11-01,6,7,6,7,13
41401,SANTIAGO DE HUARI,estado nutricional en menores de 5 anos,clasificacion e,2003-11-01,4,9,4,9,13
21901,SANTIAGO DE MACHACA,estado nutricional en menores de 5 anos,clasificacion e,2003-11-01,4,0,4,0,4
30702,SANTIVAÃ‘ES,estado nutricional en menores de 5 anos,clasificacion e,2003-11-01,9,6,9,6,15
40202,SANTUARIO DE QUILLACAS,estado nutricional en menores de 5 anos,clasificacion e,2003-11-01,0,1,0,1,1
20902,SAPAHAQUI,estado nutricional en menores de 5 anos,clasificacion e,2003-11-01,24,13,24,13,37
90303,SENA,estado nutricional en menores de 5 anos,clasificacion e,2003-11-01,4,3,4,3,7
21301,SICA SICA (VILLA AROMA),estado nutricional en menores de 5 anos,clasificacion e,2003-11-01,32,21,32,21,53
30703,SICAYA,estado nutricional en menores de 5 anos,clasificacion e,2003-11-01,9,1,9,1,10
30902,SIPE SIPE,estado nutricional en menores de 5 anos,clasificacion e,2003-11-01,54,29,54,29,83
10403,SOPACHUY,estado nutricional en menores de 5 anos,clasificacion e,2003-11-01,46,61,46,61,107
20601,SORATA,estado nutricional en menores de 5 anos,clasificacion e,2003-11-01,8,13,8,13,21
10101,SUCRE,estado nutricional en menores de 5 anos,clasificacion e,2003-11-01,156,161,156,161,317
31404,TACACHI,estado nutricional en menores de 5 anos,clasificacion e,2003-11-01,1,0,1,0,1
50303,TACOBAMBA,estado nutricional en menores de 5 anos,clasificacion e,2003-11-01,25,25,25,25,50
30602,TACOPAYA,estado nutricional en menores de 5 anos,clasificacion e,2003-11-01,31,18,31,18,49
51402,TAHUA,estado nutricional en menores de 5 anos,clasificacion e,2003-11-01,0,1,0,1,1
31101,TAPACARI,estado nutricional en menores de 5 anos,clasificacion e,2003-11-01,50,49,50,49,99
10601,TARABUCO,estado nutricional en menores de 5 anos,clasificacion e,2003-11-01,118,133,118,133,251
30401,TARATA,estado nutricional en menores de 5 anos,clasificacion e,2003-11-01,12,5,12,5,17
60101,TARIJA,estado nutricional en menores de 5 anos,clasificacion e,2003-11-01,29,28,29,28,57
10202,TARVITA,estado nutricional en menores de 5 anos,clasificacion e,2003-11-01,59,101,59,101,160
20803,TIAWANACU,estado nutricional en menores de 5 anos,clasificacion e,2003-11-01,3,1,3,1,4
50102,TINGUIPAYA,estado nutricional en menores de 5 anos,clasificacion e,2003-11-01,49,93,49,93,142
20606,TIPUANI,estado nutricional en menores de 5 anos,clasificacion e,2003-11-01,2,1,2,1,3
30903,TIQUIPAYA,estado nutricional en menores de 5 anos,clasificacion e,2003-11-01,5,1,5,1,6
31601,TIRAQUE (CBBA),estado nutricional en menores de 5 anos,clasificacion e,2003-11-01,43,23,43,23,66
21703,TITO YUPANQUI (PARQUIPUJIO),estado nutricional en menores de 5 anos,clasificacion e,2003-11-01,3,1,3,1,4
30802,TOCO,estado nutricional en menores de 5 anos,clasificacion e,2003-11-01,2,4,2,4,6
30803,TOLATA,estado nutricional en menores de 5 anos,clasificacion e,2003-11-01,1,1,1,1,2
41001,TOLEDO,estado nutricional en menores de 5 anos,clasificacion e,2003-11-01,1,0,1,0,1
51202,TOMAVE,estado nutricional en menores de 5 anos,clasificacion e,2003-11-01,22,19,22,19,41
10402,TOMINA,estado nutricional en menores de 5 anos,clasificacion e,2003-11-01,47,69,47,69,116
50502,TORO TORO,estado nutricional en menores de 5 anos,clasificacion e,2003-11-01,90,35,90,35,125
31201,TOTORA(CBBA),estado nutricional en menores de 5 anos,clasificacion e,2003-11-01,22,11,22,11,33
41301,TOTORA(ORR),estado nutricional en menores de 5 anos,clasificacion e,2003-11-01,4,5,4,5,9
70802,TRIGAL,estado nutricional en menores de 5 anos,clasificacion e,2003-11-01,1,0,1,0,1
80101,TRINIDAD,estado nutricional en menores de 5 anos,clasificacion e,2003-11-01,26,40,26,40,66
50801,TUPIZA,estado nutricional en menores de 5 anos,clasificacion e,2003-11-01,37,35,37,35,72
40402,TURCO,estado nutricional en menores de 5 anos,clasificacion e,2003-11-01,0,1,0,1,1
21302,UMALA,estado nutricional en menores de 5 anos,clasificacion e,2003-11-01,11,8,11,8,19
50201,UNCIA,estado nutricional en menores de 5 anos,clasificacion e,2003-11-01,8,3,8,3,11
60401,URIONDO (A. CONCEPCION),estado nutricional en menores de 5 anos,clasificacion e,2003-11-01,10,12,10,12,22
71502,URUBICHA,estado nutricional en menores de 5 anos,clasificacion e,2003-11-01,6,1,6,1,7
51201,UYUNI,estado nutricional en menores de 5 anos,clasificacion e,2003-11-01,7,21,7,21,28
30502,VACAS,estado nutricional en menores de 5 anos,clasificacion e,2003-11-01,24,16,24,16,40
70801,VALLEGRANDE,estado nutricional en menores de 5 anos,clasificacion e,2003-11-01,4,4,4,4,8
20801,VIACHA,estado nutricional en menores de 5 anos,clasificacion e,2003-11-01,22,23,22,23,45
31302,VILA VILA,estado nutricional en menores de 5 anos,clasificacion e,2003-11-01,8,2,8,2,10
60303,VILLA MONTES,estado nutricional en menores de 5 anos,clasificacion e,2003-11-01,13,7,13,7,20
31402,VILLA RIVERO,estado nutricional en menores de 5 anos,clasificacion e,2003-11-01,8,3,8,3,11
10801,VILLA SERRANO,estado nutricional en menores de 5 anos,clasificacion e,2003-11-01,44,55,44,55,99
31003,VILLA TUNARI,estado nutricional en menores de 5 anos,clasificacion e,2003-11-01,53,47,53,47,100
11001,VILLA VACA GUZMAN (MUYUPAMPA),estado nutricional en menores de 5 anos,clasificacion e,2003-11-01,13,14,13,14,27
51501,VILLAZON,estado nutricional en menores de 5 anos,clasificacion e,2003-11-01,23,29,23,29,52
50602,VITICHI,estado nutricional en menores de 5 anos,clasificacion e,2003-11-01,55,64,55,64,119
20306,WALDO BALLIVIAN,estado nutricional en menores de 5 anos,clasificacion e,2003-11-01,3,2,3,2,5
20903,YACO,estado nutricional en menores de 5 anos,clasificacion e,2003-11-01,11,11,11,11,22
60301,YACUIBA,estado nutricional en menores de 5 anos,clasificacion e,2003-11-01,8,7,8,7,15
10602,YAMPARAEZ,estado nutricional en menores de 5 anos,clasificacion e,2003-11-01,65,58,65,58,123
21103,YANACACHI,estado nutricional en menores de 5 anos,clasificacion e,2003-11-01,2,0,2,0,2
70403,YAPACANI,estado nutricional en menores de 5 anos,clasificacion e,2003-11-01,19,21,19,21,40
50103,YOCALLA,estado nutricional en menores de 5 anos,clasificacion e,2003-11-01,13,10,13,10,23
10102,YOTALA,estado nutricional en menores de 5 anos,clasificacion e,2003-11-01,21,30,21,30,51
60402,YUNCHARA,estado nutricional en menores de 5 anos,clasificacion e,2003-11-01,15,18,15,18,33
10301,ZUDAÃ‘EZ,estado nutricional en menores de 5 anos,clasificacion e,2003-11-01,22,28,22,28,50
51302,ACACIO,estado nutricional en menores de 5 anos,clasificacion e,2003-12-01,32,23,32,23,55
20201,ACHACACHI,estado nutricional en menores de 5 anos,clasificacion e,2003-12-01,10,5,10,5,15
20104,ACHOCALLA,estado nutricional en menores de 5 anos,clasificacion e,2003-12-01,1,1,1,1,2
30201,AIQUILE,estado nutricional en menores de 5 anos,clasificacion e,2003-12-01,9,3,9,3,12
31303,ALALAY,estado nutricional en menores de 5 anos,clasificacion e,2003-12-01,7,2,7,2,9
10404,ALCALA,estado nutricional en menores de 5 anos,clasificacion e,2003-12-01,7,12,7,12,19
20202,ANCORAIMES,estado nutricional en menores de 5 anos,clasificacion e,2003-12-01,7,4,7,4,11
41201,ANDAMARCA,estado nutricional en menores de 5 anos,clasificacion e,2003-12-01,1,1,1,1,2
40603,ANTEQUERA,estado nutricional en menores de 5 anos,clasificacion e,2003-12-01,2,0,2,0,2
30402,ANZALDO,estado nutricional en menores de 5 anos,clasificacion e,2003-12-01,0,2,0,2,2
20701,APOLO,estado nutricional en menores de 5 anos,clasificacion e,2003-12-01,8,5,8,5,13
51301,ARAMPAMPA,estado nutricional en menores de 5 anos,clasificacion e,2003-12-01,5,12,5,12,17
30501,ARANI,estado nutricional en menores de 5 anos,clasificacion e,2003-12-01,6,3,6,3,9
30403,ARBIETO,estado nutricional en menores de 5 anos,clasificacion e,2003-12-01,0,1,0,1,1
30601,ARQUE,estado nutricional en menores de 5 anos,clasificacion e,2003-12-01,1,3,1,3,4
71501,ASCENCION DE GUARAYOS,estado nutricional en menores de 5 anos,clasificacion e,2003-12-01,46,91,46,91,137
50802,ATOCHA,estado nutricional en menores de 5 anos,clasificacion e,2003-12-01,13,22,13,22,35
20503,AUCAPATA,estado nutricional en menores de 5 anos,clasificacion e,2003-12-01,8,3,8,3,11
20502,AYATA,estado nutricional en menores de 5 anos,clasificacion e,2003-12-01,12,8,12,8,20
30301,AYOPAYA (V. DE INDEPENDENCIA),estado nutricional en menores de 5 anos,clasificacion e,2003-12-01,22,11,22,11,33
10201,AZURDUY,estado nutricional en menores de 5 anos,clasificacion e,2003-12-01,42,56,42,56,98
21203,BATALLAS,estado nutricional en menores de 5 anos,clasificacion e,2003-12-01,4,2,4,2,6
80802,BAURES,estado nutricional en menores de 5 anos,clasificacion e,2003-12-01,2,0,2,0,2
50104,BELEN DE URMIRI,estado nutricional en menores de 5 anos,clasificacion e,2003-12-01,3,4,3,4,7
90104,BELLA FLOR,estado nutricional en menores de 5 anos,clasificacion e,2003-12-01,1,3,1,3,4
60202,BERMEJO,estado nutricional en menores de 5 anos,clasificacion e,2003-12-01,1,5,1,5,6
50301,BETANZOS,estado nutricional en menores de 5 anos,clasificacion e,2003-12-01,100,90,100,90,190
70707,BOYUIBE,estado nutricional en menores de 5 anos,clasificacion e,2003-12-01,3,4,3,4,7
70401,BUENA VISTA,estado nutricional en menores de 5 anos,clasificacion e,2003-12-01,5,6,5,6,11
20905,CAIROMA,estado nutricional en menores de 5 anos,clasificacion e,2003-12-01,19,6,19,6,25
51102,"CAIZA ""D""",estado nutricional en menores de 5 anos,clasificacion e,2003-12-01,15,12,15,12,27
21003,CAJUATA,estado nutricional en menores de 5 anos,clasificacion e,2003-12-01,10,6,10,6,16
20303,CALACOTO,estado nutricional en menores de 5 anos,clasificacion e,2003-12-01,1,0,1,0,1
21304,CALAMARCA,estado nutricional en menores de 5 anos,clasificacion e,2003-12-01,53,30,53,30,83
10701,CAMARGO,estado nutricional en menores de 5 anos,clasificacion e,2003-12-01,17,24,17,24,41
10901,CAMATAQUI (C. VILLA ABECIA),estado nutricional en menores de 5 anos,clasificacion e,2003-12-01,2,2,2,2,4
70706,CAMIRI,estado nutricional en menores de 5 anos,clasificacion e,2003-12-01,35,21,35,21,56
30701,CAPINOTA,estado nutricional en menores de 5 anos,clasificacion e,2003-12-01,23,39,23,39,62
20302,CAQUIAVIRI,estado nutricional en menores de 5 anos,clasificacion e,2003-12-01,6,5,6,5,11
40102,CARACOLLO,estado nutricional en menores de 5 anos,clasificacion e,2003-12-01,13,4,13,4,17
22001,CARANAVI,estado nutricional en menores de 5 anos,clasificacion e,2003-12-01,46,32,46,32,78
60302,CARAPARI,estado nutricional en menores de 5 anos,clasificacion e,2003-12-01,2,3,2,3,5
50702,CARIPUYO,estado nutricional en menores de 5 anos,clasificacion e,2003-12-01,21,30,21,30,51
40201,CHALLAPATA,estado nutricional en menores de 5 anos,clasificacion e,2003-12-01,23,33,23,33,56
50302,CHAQUI,estado nutricional en menores de 5 anos,clasificacion e,2003-12-01,9,10,9,10,19
70702,CHARAGUA,estado nutricional en menores de 5 anos,clasificacion e,2003-12-01,21,19,21,19,40
20305,CHARAÃ‘A,estado nutricional en menores de 5 anos,clasificacion e,2003-12-01,4,4,4,4,8
50202,CHAYANTA,estado nutricional en menores de 5 anos,clasificacion e,2003-12-01,34,45,34,45,79
31204,CHIMORE,estado nutricional en menores de 5 anos,clasificacion e,2003-12-01,5,6,5,6,11
40302,CHOQUE COTA,estado nutricional en menores de 5 anos,clasificacion e,2003-12-01,1,0,1,0,1
21101,CHULUMANI (V. DE LA LIBERTAD),estado nutricional en menores de 5 anos,clasificacion e,2003-12-01,0,1,0,1,1
20501,CHUMA,estado nutricional en menores de 5 anos,clasificacion e,2003-12-01,3,1,3,1,4
30801,CLIZA,estado nutricional en menores de 5 anos,clasificacion e,2003-12-01,5,5,5,5,10
90101,COBIJA,estado nutricional en menores de 5 anos,clasificacion e,2003-12-01,16,9,16,9,25
30101,COCHABAMBA,estado nutricional en menores de 5 anos,clasificacion e,2003-12-01,153,72,153,72,225
30905,COLCAPIRHUA,estado nutricional en menores de 5 anos,clasificacion e,2003-12-01,17,5,17,5,22
50901,"COLCHA ""K""",estado nutricional en menores de 5 anos,clasificacion e,2003-12-01,4,6,4,6,10
21307,COLLANA,estado nutricional en menores de 5 anos,clasificacion e,2003-12-01,2,1,2,1,3
31002,COLOMI,estado nutricional en menores de 5 anos,clasificacion e,2003-12-01,55,33,55,33,88
50401,COLQUECHACA,estado nutricional en menores de 5 anos,clasificacion e,2003-12-01,61,36,61,36,97
21306,COLQUENCHA,estado nutricional en menores de 5 anos,clasificacion e,2003-12-01,4,2,4,2,6
21004,COLQUIRI,estado nutricional en menores de 5 anos,clasificacion e,2003-12-01,23,8,23,8,31
20304,COMANCHE,estado nutricional en menores de 5 anos,clasificacion e,2003-12-01,0,2,0,2,2
71301,COMARAPA,estado nutricional en menores de 5 anos,clasificacion e,2003-12-01,19,7,19,7,26
20605,COMBAYA,estado nutricional en menores de 5 anos,clasificacion e,2003-12-01,3,5,3,5,8
71101,CONCEPCION,estado nutricional en menores de 5 anos,clasificacion e,2003-12-01,2,0,2,0,2
21701,COPACABANA,estado nutricional en menores de 5 anos,clasificacion e,2003-12-01,5,4,5,4,9
20301,CORO CORO,estado nutricional en menores de 5 anos,clasificacion e,2003-12-01,1,1,1,1,2
21401,COROICO,estado nutricional en menores de 5 anos,clasificacion e,2003-12-01,15,2,15,2,17
40301,CORQUE,estado nutricional en menores de 5 anos,clasificacion e,2003-12-01,0,2,0,2,2
50601,COTAGAITA,estado nutricional en menores de 5 anos,clasificacion e,2003-12-01,20,34,20,34,54
31405,CUCHUMUELA (V. G. VILLARROEL),estado nutricional en menores de 5 anos,clasificacion e,2003-12-01,1,2,1,2,3
70704,CUEVO,estado nutricional en menores de 5 anos,clasificacion e,2003-12-01,1,2,1,2,3
10902,CULPINA,estado nutricional en menores de 5 anos,clasificacion e,2003-12-01,47,48,47,48,95
40401,CURAHUARA DE CARANGAS,estado nutricional en menores de 5 anos,clasificacion e,2003-12-01,9,7,9,7,16
21602,CURVA,estado nutricional en menores de 5 anos,clasificacion e,2003-12-01,0,1,0,1,1
20105,EL ALTO,estado nutricional en menores de 5 anos,clasificacion e,2003-12-01,401,179,401,179,580
71503,EL PUENTE(STC),estado nutricional en menores de 5 anos,clasificacion e,2003-12-01,15,7,15,7,22
60502,EL PUENTE(TJA),estado nutricional en menores de 5 anos,clasificacion e,2003-12-01,10,6,10,6,16
70105,EL TORNO,estado nutricional en menores de 5 anos,clasificacion e,2003-12-01,12,6,12,6,18
10405,EL VILLAR,estado nutricional en menores de 5 anos,clasificacion e,2003-12-01,17,27,17,27,44
60601,ENTRE RIOS,estado nutricional en menores de 5 anos,clasificacion e,2003-12-01,9,9,9,9,18
41101,EUCALIPTUS,estado nutricional en menores de 5 anos,clasificacion e,2003-12-01,4,2,4,2,6
80402,EXALTACION,estado nutricional en menores de 5 anos,clasificacion e,2003-12-01,8,4,8,4,12
90203,FILADELFIA,estado nutricional en menores de 5 anos,clasificacion e,2003-12-01,0,1,0,1,1
71002,GENERAL SAAVEDRA,estado nutricional en menores de 5 anos,clasificacion e,2003-12-01,30,24,30,24,54
21601,GRAL. J.J. PEREZ (CHARAZANI),estado nutricional en menores de 5 anos,clasificacion e,2003-12-01,7,14,7,14,21
20602,GUANAY,estado nutricional en menores de 5 anos,clasificacion e,2003-12-01,20,11,20,11,31
20802,GUAQUI,estado nutricional en menores de 5 anos,clasificacion e,2003-12-01,0,3,0,3,3
80202,GUAYARAMERIN,estado nutricional en menores de 5 anos,clasificacion e,2003-12-01,32,28,32,28,60
70705,GUTIERREZ,estado nutricional en menores de 5 anos,clasificacion e,2003-12-01,34,45,34,45,79
10502,HUACARETA,estado nutricional en menores de 5 anos,clasificacion e,2003-12-01,19,16,19,16,35
11002,HUACAYA (VILLA DE HUACAYA),estado nutricional en menores de 5 anos,clasificacion e,2003-12-01,4,2,4,2,6
40501,HUACHACALLA,estado nutricional en menores de 5 anos,clasificacion e,2003-12-01,1,2,1,2,3
40701,HUANUNI,estado nutricional en menores de 5 anos,clasificacion e,2003-12-01,16,6,16,6,22
80803,HUARACAJE,estado nutricional en menores de 5 anos,clasificacion e,2003-12-01,1,0,1,0,1
41601,HUAYLLAMARCA,estado nutricional en menores de 5 anos,clasificacion e,2003-12-01,3,2,3,2,5
21005,ICHOCA,estado nutricional en menores de 5 anos,clasificacion e,2003-12-01,9,8,9,8,17
10304,ICLA,estado nutricional en menores de 5 anos,clasificacion e,2003-12-01,73,76,73,76,149
10703,INCAHUASI,estado nutricional en menores de 5 anos,clasificacion e,2003-12-01,27,17,27,17,44
21001,INQUISIVI,estado nutricional en menores de 5 anos,clasificacion e,2003-12-01,19,9,19,9,28
21102,IRUPANA (VILLA DE LANZA),estado nutricional en menores de 5 anos,clasificacion e,2003-12-01,1,3,1,3,4
21501,IXIAMAS,estado nutricional en menores de 5 anos,clasificacion e,2003-12-01,3,4,3,4,7
21105,LA ASUNTA,estado nutricional en menores de 5 anos,clasificacion e,2003-12-01,1,6,1,6,7
70104,LA GUARDIA,estado nutricional en menores de 5 anos,clasificacion e,2003-12-01,11,10,11,10,21
20101,LA PAZ,estado nutricional en menores de 5 anos,clasificacion e,2003-12-01,231,147,231,147,378
70701,LAGUNILLAS,estado nutricional en menores de 5 anos,clasificacion e,2003-12-01,1,2,1,2,3
21202,LAJA,estado nutricional en menores de 5 anos,clasificacion e,2003-12-01,1,3,1,3,4
10903,LAS CARRERAS,estado nutricional en menores de 5 anos,clasificacion e,2003-12-01,3,7,3,7,10
50203,LLALLAGUA,estado nutricional en menores de 5 anos,clasificacion e,2003-12-01,37,64,37,64,101
51401,LLICA,estado nutricional en menores de 5 anos,clasificacion e,2003-12-01,1,1,1,1,2
80601,LORETO,estado nutricional en menores de 5 anos,clasificacion e,2003-12-01,1,0,1,0,1
20901,LURIBAY,estado nutricional en menores de 5 anos,clasificacion e,2003-12-01,10,5,10,5,15
11003,MACHARETI,estado nutricional en menores de 5 anos,clasificacion e,2003-12-01,11,10,11,10,21
80801,MAGDALENA,estado nutricional en menores de 5 anos,clasificacion e,2003-12-01,4,3,4,3,7
70903,MAIRANA,estado nutricional en menores de 5 anos,clasificacion e,2003-12-01,5,1,5,1,6
20904,MALLA,estado nutricional en menores de 5 anos,clasificacion e,2003-12-01,1,0,1,0,1
20103,MECAPACA,estado nutricional en menores de 5 anos,clasificacion e,2003-12-01,2,1,2,1,3
71003,MINEROS,estado nutricional en menores de 5 anos,clasificacion e,2003-12-01,20,14,20,14,34
31301,MIZQUE,estado nutricional en menores de 5 anos,clasificacion e,2003-12-01,1,1,1,1,2
20402,MOCOMOCO,estado nutricional en menores de 5 anos,clasificacion e,2003-12-01,14,20,14,20,34
51002,MOJINETE,estado nutricional en menores de 5 anos,clasificacion e,2003-12-01,2,1,2,1,3
10303,MOJOCOYA,estado nutricional en menores de 5 anos,clasificacion e,2003-12-01,9,13,9,13,22
10501,MONTEAGUDO,estado nutricional en menores de 5 anos,clasificacion e,2003-12-01,36,33,36,33,69
71001,MONTERO,estado nutricional en menores de 5 anos,clasificacion e,2003-12-01,27,31,27,31,58
70803,MORO MORO,estado nutricional en menores de 5 anos,clasificacion e,2003-12-01,1,0,1,0,1
30302,MOROCHATA,estado nutricional en menores de 5 anos,clasificacion e,2003-12-01,19,15,19,15,34
50404,OCURI,estado nutricional en menores de 5 anos,clasificacion e,2003-12-01,36,23,36,23,59
40101,ORURO,estado nutricional en menores de 5 anos,clasificacion e,2003-12-01,157,85,157,85,242
60201,PADCAYA,estado nutricional en menores de 5 anos,clasificacion e,2003-12-01,6,4,6,4,10
10401,PADILLA,estado nutricional en menores de 5 anos,clasificacion e,2003-12-01,33,29,33,29,62
20102,PALCA,estado nutricional en menores de 5 anos,clasificacion e,2003-12-01,1,11,1,11,12
21104,PALOS BLANCOS,estado nutricional en menores de 5 anos,clasificacion e,2003-12-01,9,8,9,8,17
40802,PAMPA AULLAGAS,estado nutricional en menores de 5 anos,clasificacion e,2003-12-01,1,5,1,5,6
70902,PAMPA GRANDE,estado nutricional en menores de 5 anos,clasificacion e,2003-12-01,1,2,1,2,3
21802,PAPEL PAMPA,estado nutricional en menores de 5 anos,clasificacion e,2003-12-01,1,2,1,2,3
30202,PASORAPA,estado nutricional en menores de 5 anos,clasificacion e,2003-12-01,7,9,7,9,16
21305,PATACAMAYA,estado nutricional en menores de 5 anos,clasificacion e,2003-12-01,33,32,33,32,65
40602,PAZÃ‘A,estado nutricional en menores de 5 anos,clasificacion e,2003-12-01,2,0,2,0,2
20702,PELECHUCO,estado nutricional en menores de 5 anos,clasificacion e,2003-12-01,10,3,10,3,13
50403,POCOATA,estado nutricional en menores de 5 anos,clasificacion e,2003-12-01,31,52,31,52,83
31203,POCONA,estado nutricional en menores de 5 anos,clasificacion e,2003-12-01,12,10,12,10,22
31202,POJO (CBBA),estado nutricional en menores de 5 anos,clasificacion e,2003-12-01,26,19,26,19,45
40601,POOPO,estado nutricional en menores de 5 anos,clasificacion e,2003-12-01,0,2,0,2,2
51203,PORCO,estado nutricional en menores de 5 anos,clasificacion e,2003-12-01,12,9,12,9,21
10103,POROMA,estado nutricional en menores de 5 anos,clasificacion e,2003-12-01,24,44,24,44,68
70103,PORONGO,estado nutricional en menores de 5 anos,clasificacion e,2003-12-01,2,0,2,0,2
70601,PORTACHUELO,estado nutricional en menores de 5 anos,clasificacion e,2003-12-01,4,9,4,9,13
90102,PORVENIR,estado nutricional en menores de 5 anos,clasificacion e,2003-12-01,1,2,1,2,3
50101,POTOSI,estado nutricional en menores de 5 anos,clasificacion e,2003-12-01,130,93,130,93,223
10302,PRESTO,estado nutricional en menores de 5 anos,clasificacion e,2003-12-01,16,20,16,20,36
70805,PUCARA,estado nutricional en menores de 5 anos,clasificacion e,2003-12-01,0,1,0,1,1
21201,PUCARANI,estado nutricional en menores de 5 anos,clasificacion e,2003-12-01,6,0,6,0,6
20401,PUERTO ACOSTA,estado nutricional en menores de 5 anos,clasificacion e,2003-12-01,14,9,14,9,23
20403,PUERTO CARABUCO,estado nutricional en menores de 5 anos,clasificacion e,2003-12-01,7,7,7,7,14
90301,PUERTO GONZALO MORENO,estado nutricional en menores de 5 anos,clasificacion e,2003-12-01,11,3,11,3,14
21204,PUERTO PEREZ,estado nutricional en menores de 5 anos,clasificacion e,2003-12-01,2,0,2,0,2
90201,PUERTO RICO,estado nutricional en menores de 5 anos,clasificacion e,2003-12-01,0,5,0,5,5
80703,PUERTO SILES,estado nutricional en menores de 5 anos,clasificacion e,2003-12-01,1,2,1,2,3
31205,PUERTO VILLARROEL,estado nutricional en menores de 5 anos,clasificacion e,2003-12-01,80,61,80,61,141
51101,PUNA,estado nutricional en menores de 5 anos,clasificacion e,2003-12-01,42,31,42,31,73
31401,PUNATA,estado nutricional en menores de 5 anos,clasificacion e,2003-12-01,36,6,36,6,42
20604,QUIABAYA,estado nutricional en menores de 5 anos,clasificacion e,2003-12-01,5,1,5,1,6
30901,QUILLACOLLO,estado nutricional en menores de 5 anos,clasificacion e,2003-12-01,37,26,37,26,63
21002,QUIME,estado nutricional en menores de 5 anos,clasificacion e,2003-12-01,11,11,11,11,22
70904,QUIRUSILLAS,estado nutricional en menores de 5 anos,clasificacion e,2003-12-01,0,1,0,1,1
50402,RAVELO,estado nutricional en menores de 5 anos,clasificacion e,2003-12-01,33,29,33,29,62
80301,REYES,estado nutricional en menores de 5 anos,clasificacion e,2003-12-01,6,8,6,8,14
80201,RIBERALTA,estado nutricional en menores de 5 anos,clasificacion e,2003-12-01,109,67,109,67,176
80304,RURRENABAQUE,estado nutricional en menores de 5 anos,clasificacion e,2003-12-01,3,1,3,1,4
40901,SABAYA,estado nutricional en menores de 5 anos,clasificacion e,2003-12-01,2,5,2,5,7
31001,SACABA,estado nutricional en menores de 5 anos,clasificacion e,2003-12-01,9,7,9,7,16
30404,SACABAMBA,estado nutricional en menores de 5 anos,clasificacion e,2003-12-01,2,6,2,6,8
50701,SACACA,estado nutricional en menores de 5 anos,clasificacion e,2003-12-01,94,104,94,104,198
71302,SAIPINA,estado nutricional en menores de 5 anos,clasificacion e,2003-12-01,1,3,1,3,4
40801,SALINAS DE GARCI MENDOZA,estado nutricional en menores de 5 anos,clasificacion e,2003-12-01,2,4,2,4,6
70901,SAMAIPATA,estado nutricional en menores de 5 anos,clasificacion e,2003-12-01,3,2,3,2,5
51601,SAN AGUSTIN,estado nutricional en menores de 5 anos,clasificacion e,2003-12-01,2,3,2,3,5
80602,SAN ANDRES,estado nutricional en menores de 5 anos,clasificacion e,2003-12-01,4,9,4,9,13
31403,SAN BENITO,estado nutricional en menores de 5 anos,clasificacion e,2003-12-01,7,3,7,3,10
80302,SAN BORJA,estado nutricional en menores de 5 anos,clasificacion e,2003-12-01,41,53,41,53,94
21502,SAN BUENA VENTURA,estado nutricional en menores de 5 anos,clasificacion e,2003-12-01,15,7,15,7,22
70402,SAN CARLOS,estado nutricional en menores de 5 anos,clasificacion e,2003-12-01,18,6,18,6,24
80501,SAN IGNACIO,estado nutricional en menores de 5 anos,clasificacion e,2003-12-01,13,9,13,9,22
70301,SAN IGNACIO DE VELASCO,estado nutricional en menores de 5 anos,clasificacion e,2003-12-01,35,20,35,20,55
80102,SAN JAVIER(BNI),estado nutricional en menores de 5 anos,clasificacion e,2003-12-01,4,0,4,0,4
71102,SAN JAVIER(STC),estado nutricional en menores de 5 anos,clasificacion e,2003-12-01,10,5,10,5,15
80701,SAN JOAQUIN,estado nutricional en menores de 5 anos,clasificacion e,2003-12-01,1,2,1,2,3
71104,SAN JULIAN,estado nutricional en menores de 5 anos,clasificacion e,2003-12-01,17,18,17,18,35
60501,SAN LORENZO(TJA),estado nutricional en menores de 5 anos,clasificacion e,2003-12-01,16,20,16,20,36
10702,SAN LUCAS,estado nutricional en menores de 5 anos,clasificacion e,2003-12-01,115,100,115,100,215
71201,SAN MATIAS,estado nutricional en menores de 5 anos,clasificacion e,2003-12-01,10,2,10,2,12
70302,SAN MIGUEL DE VELASCO,estado nutricional en menores de 5 anos,clasificacion e,2003-12-01,2,9,2,9,11
51001,SAN PABLO DE LIPEZ,estado nutricional en menores de 5 anos,clasificacion e,2003-12-01,2,5,2,5,7
50501,SAN PEDRO DE BUENA VISTA,estado nutricional en menores de 5 anos,clasificacion e,2003-12-01,74,91,74,91,165
21801,SAN PEDRO DE CURAHUARA,estado nutricional en menores de 5 anos,clasificacion e,2003-12-01,9,8,9,8,17
50902,SAN PEDRO DE QUEMES,estado nutricional en menores de 5 anos,clasificacion e,2003-12-01,0,1,0,1,1
21702,SAN PEDRO DE TIQUINA,estado nutricional en menores de 5 anos,clasificacion e,2003-12-01,0,1,0,1,1
70303,SAN RAFAEL,estado nutricional en menores de 5 anos,clasificacion e,2003-12-01,13,6,13,6,19
80702,SAN RAMON,estado nutricional en menores de 5 anos,clasificacion e,2003-12-01,1,0,1,0,1
80401,SANTA ANA,estado nutricional en menores de 5 anos,clasificacion e,2003-12-01,15,8,15,8,23
70101,SANTA CRUZ DE LA SIERRA,estado nutricional en menores de 5 anos,clasificacion e,2003-12-01,100,43,100,43,143
80303,SANTA ROSA,estado nutricional en menores de 5 anos,clasificacion e,2003-12-01,6,4,6,4,10
70602,SANTA ROSA DEL SARA,estado nutricional en menores de 5 anos,clasificacion e,2003-12-01,0,3,0,3,3
20308,SANTIAGO DE CALLAPA,estado nutricional en menores de 5 anos,clasificacion e,2003-12-01,9,9,9,9,18
41401,SANTIAGO DE HUARI,estado nutricional en menores de 5 anos,clasificacion e,2003-12-01,0,3,0,3,3
21901,SANTIAGO DE MACHACA,estado nutricional en menores de 5 anos,clasificacion e,2003-12-01,2,2,2,2,4
30702,SANTIVAÃ‘ES,estado nutricional en menores de 5 anos,clasificacion e,2003-12-01,2,6,2,6,8
40202,SANTUARIO DE QUILLACAS,estado nutricional en menores de 5 anos,clasificacion e,2003-12-01,1,1,1,1,2
20902,SAPAHAQUI,estado nutricional en menores de 5 anos,clasificacion e,2003-12-01,10,10,10,10,20
90303,SENA,estado nutricional en menores de 5 anos,clasificacion e,2003-12-01,4,1,4,1,5
21301,SICA SICA (VILLA AROMA),estado nutricional en menores de 5 anos,clasificacion e,2003-12-01,41,19,41,19,60
30703,SICAYA,estado nutricional en menores de 5 anos,clasificacion e,2003-12-01,3,5,3,5,8
30902,SIPE SIPE,estado nutricional en menores de 5 anos,clasificacion e,2003-12-01,29,12,29,12,41
10403,SOPACHUY,estado nutricional en menores de 5 anos,clasificacion e,2003-12-01,26,28,26,28,54
20601,SORATA,estado nutricional en menores de 5 anos,clasificacion e,2003-12-01,3,5,3,5,8
10101,SUCRE,estado nutricional en menores de 5 anos,clasificacion e,2003-12-01,93,80,93,80,173
31404,TACACHI,estado nutricional en menores de 5 anos,clasificacion e,2003-12-01,1,0,1,0,1
20603,TACACOMA,estado nutricional en menores de 5 anos,clasificacion e,2003-12-01,5,3,5,3,8
50303,TACOBAMBA,estado nutricional en menores de 5 anos,clasificacion e,2003-12-01,30,22,30,22,52
30602,TACOPAYA,estado nutricional en menores de 5 anos,clasificacion e,2003-12-01,11,9,11,9,20
31101,TAPACARI,estado nutricional en menores de 5 anos,clasificacion e,2003-12-01,51,44,51,44,95
10601,TARABUCO,estado nutricional en menores de 5 anos,clasificacion e,2003-12-01,127,142,127,142,269
30401,TARATA,estado nutricional en menores de 5 anos,clasificacion e,2003-12-01,14,3,14,3,17
60101,TARIJA,estado nutricional en menores de 5 anos,clasificacion e,2003-12-01,88,62,88,62,150
10202,TARVITA,estado nutricional en menores de 5 anos,clasificacion e,2003-12-01,17,27,17,27,44
20803,TIAWANACU,estado nutricional en menores de 5 anos,clasificacion e,2003-12-01,1,1,1,1,2
50102,TINGUIPAYA,estado nutricional en menores de 5 anos,clasificacion e,2003-12-01,97,78,97,78,175
20606,TIPUANI,estado nutricional en menores de 5 anos,clasificacion e,2003-12-01,1,0,1,0,1
30903,TIQUIPAYA,estado nutricional en menores de 5 anos,clasificacion e,2003-12-01,7,3,7,3,10
31601,TIRAQUE (CBBA),estado nutricional en menores de 5 anos,clasificacion e,2003-12-01,44,27,44,27,71
30802,TOCO,estado nutricional en menores de 5 anos,clasificacion e,2003-12-01,0,2,0,2,2
30803,TOLATA,estado nutricional en menores de 5 anos,clasificacion e,2003-12-01,1,1,1,1,2
51202,TOMAVE,estado nutricional en menores de 5 anos,clasificacion e,2003-12-01,14,14,14,14,28
10402,TOMINA,estado nutricional en menores de 5 anos,clasificacion e,2003-12-01,37,63,37,63,100
50502,TORO TORO,estado nutricional en menores de 5 anos,clasificacion e,2003-12-01,25,24,25,24,49
31201,TOTORA(CBBA),estado nutricional en menores de 5 anos,clasificacion e,2003-12-01,20,6,20,6,26
41301,TOTORA(ORR),estado nutricional en menores de 5 anos,clasificacion e,2003-12-01,3,1,3,1,4
80101,TRINIDAD,estado nutricional en menores de 5 anos,clasificacion e,2003-12-01,41,36,41,36,77
50801,TUPIZA,estado nutricional en menores de 5 anos,clasificacion e,2003-12-01,19,51,19,51,70
40402,TURCO,estado nutricional en menores de 5 anos,clasificacion e,2003-12-01,3,1,3,1,4
21302,UMALA,estado nutricional en menores de 5 anos,clasificacion e,2003-12-01,10,6,10,6,16
50201,UNCIA,estado nutricional en menores de 5 anos,clasificacion e,2003-12-01,6,3,6,3,9
60401,URIONDO (A. CONCEPCION),estado nutricional en menores de 5 anos,clasificacion e,2003-12-01,7,6,7,6,13
71502,URUBICHA,estado nutricional en menores de 5 anos,clasificacion e,2003-12-01,4,10,4,10,14
51201,UYUNI,estado nutricional en menores de 5 anos,clasificacion e,2003-12-01,13,13,13,13,26
30502,VACAS,estado nutricional en menores de 5 anos,clasificacion e,2003-12-01,10,2,10,2,12
70801,VALLEGRANDE,estado nutricional en menores de 5 anos,clasificacion e,2003-12-01,7,12,7,12,19
20801,VIACHA,estado nutricional en menores de 5 anos,clasificacion e,2003-12-01,29,8,29,8,37
31302,VILA VILA,estado nutricional en menores de 5 anos,clasificacion e,2003-12-01,7,5,7,5,12
60303,VILLA MONTES,estado nutricional en menores de 5 anos,clasificacion e,2003-12-01,15,13,15,13,28
31402,VILLA RIVERO,estado nutricional en menores de 5 anos,clasificacion e,2003-12-01,12,3,12,3,15
10801,VILLA SERRANO,estado nutricional en menores de 5 anos,clasificacion e,2003-12-01,33,58,33,58,91
31003,VILLA TUNARI,estado nutricional en menores de 5 anos,clasificacion e,2003-12-01,31,38,31,38,69
11001,VILLA VACA GUZMAN (MUYUPAMPA),estado nutricional en menores de 5 anos,clasificacion e,2003-12-01,16,15,16,15,31
51501,VILLAZON,estado nutricional en menores de 5 anos,clasificacion e,2003-12-01,32,29,32,29,61
30904,VINTO,estado nutricional en menores de 5 anos,clasificacion e,2003-12-01,7,6,7,6,13
50602,VITICHI,estado nutricional en menores de 5 anos,clasificacion e,2003-12-01,23,27,23,27,50
20306,WALDO BALLIVIAN,estado nutricional en menores de 5 anos,clasificacion e,2003-12-01,2,2,2,2,4
20903,YACO,estado nutricional en menores de 5 anos,clasificacion e,2003-12-01,28,25,28,25,53
60301,YACUIBA,estado nutricional en menores de 5 anos,clasificacion e,2003-12-01,16,8,16,8,24
10602,YAMPARAEZ,estado nutricional en menores de 5 anos,clasificacion e,2003-12-01,66,49,66,49,115
21103,YANACACHI,estado nutricional en menores de 5 anos,clasificacion e,2003-12-01,4,4,4,4,8
70403,YAPACANI,estado nutricional en menores de 5 anos,clasificacion e,2003-12-01,24,31,24,31,55
50103,YOCALLA,estado nutricional en menores de 5 anos,clasificacion e,2003-12-01,6,4,6,4,10
10102,YOTALA,estado nutricional en menores de 5 anos,clasificacion e,2003-12-01,11,18,11,18,29
60402,YUNCHARA,estado nutricional en menores de 5 anos,clasificacion e,2003-12-01,14,26,14,26,40
10301,ZUDAÃ‘EZ,estado nutricional en menores de 5 anos,clasificacion e,2003-12-01,19,28,19,28,47
