codigo_municipio,municipio,grupo,variable,mes,hombres,mujeres,hombres total,mujeres total,total
51302,ACACIO,estado nutricional,clasificacion f,2004-01-01,2,6,2,6,8
20201,ACHACACHI,estado nutricional,clasificacion f,2004-01-01,13,2,13,2,15
20104,ACHOCALLA,estado nutricional,clasificacion f,2004-01-01,1,0,1,0,1
30201,AIQUILE,estado nutricional,clasificacion f,2004-01-01,2,0,2,0,2
31303,ALALAY,estado nutricional,clasificacion f,2004-01-01,1,0,1,0,1
10404,ALCALA,estado nutricional,clasificacion f,2004-01-01,0,3,0,3,3
20202,ANCORAIMES,estado nutricional,clasificacion f,2004-01-01,2,0,2,0,2
20701,APOLO,estado nutricional,clasificacion f,2004-01-01,0,1,0,1,1
51301,ARAMPAMPA,estado nutricional,clasificacion f,2004-01-01,7,1,7,1,8
30501,ARANI,estado nutricional,clasificacion f,2004-01-01,5,1,5,1,6
30403,ARBIETO,estado nutricional,clasificacion f,2004-01-01,2,0,2,0,2
30601,ARQUE,estado nutricional,clasificacion f,2004-01-01,1,0,1,0,1
50802,ATOCHA,estado nutricional,clasificacion f,2004-01-01,2,2,2,2,4
20503,AUCAPATA,estado nutricional,clasificacion f,2004-01-01,1,0,1,0,1
20502,AYATA,estado nutricional,clasificacion f,2004-01-01,5,0,5,0,5
30301,AYOPAYA (V. DE INDEPENDENCIA),estado nutricional,clasificacion f,2004-01-01,8,4,8,4,12
10201,AZURDUY,estado nutricional,clasificacion f,2004-01-01,8,11,8,11,19
21203,BATALLAS,estado nutricional,clasificacion f,2004-01-01,1,0,1,0,1
50301,BETANZOS,estado nutricional,clasificacion f,2004-01-01,15,5,15,5,20
31501,BOLIVAR,estado nutricional,clasificacion f,2004-01-01,5,2,5,2,7
70703,CABEZAS,estado nutricional,clasificacion f,2004-01-01,12,5,12,5,17
20905,CAIROMA,estado nutricional,clasificacion f,2004-01-01,2,0,2,0,2
51102,"CAIZA ""D""",estado nutricional,clasificacion f,2004-01-01,2,2,2,2,4
21003,CAJUATA,estado nutricional,clasificacion f,2004-01-01,1,3,1,3,4
21304,CALAMARCA,estado nutricional,clasificacion f,2004-01-01,7,1,7,1,8
10701,CAMARGO,estado nutricional,clasificacion f,2004-01-01,1,1,1,1,2
70706,CAMIRI,estado nutricional,clasificacion f,2004-01-01,12,8,12,8,20
30701,CAPINOTA,estado nutricional,clasificacion f,2004-01-01,2,0,2,0,2
20302,CAQUIAVIRI,estado nutricional,clasificacion f,2004-01-01,1,0,1,0,1
22001,CARANAVI,estado nutricional,clasificacion f,2004-01-01,5,6,5,6,11
60302,CARAPARI,estado nutricional,clasificacion f,2004-01-01,0,1,0,1,1
50702,CARIPUYO,estado nutricional,clasificacion f,2004-01-01,9,4,9,4,13
40201,CHALLAPATA,estado nutricional,clasificacion f,2004-01-01,4,0,4,0,4
50302,CHAQUI,estado nutricional,clasificacion f,2004-01-01,3,1,3,1,4
70702,CHARAGUA,estado nutricional,clasificacion f,2004-01-01,7,1,7,1,8
50202,CHAYANTA,estado nutricional,clasificacion f,2004-01-01,3,2,3,2,5
31204,CHIMORE,estado nutricional,clasificacion f,2004-01-01,1,0,1,0,1
20501,CHUMA,estado nutricional,clasificacion f,2004-01-01,2,2,2,2,4
90101,COBIJA,estado nutricional,clasificacion f,2004-01-01,5,6,5,6,11
30101,COCHABAMBA,estado nutricional,clasificacion f,2004-01-01,18,3,18,3,21
50901,"COLCHA ""K""",estado nutricional,clasificacion f,2004-01-01,0,1,0,1,1
31002,COLOMI,estado nutricional,clasificacion f,2004-01-01,2,4,2,4,6
50401,COLQUECHACA,estado nutricional,clasificacion f,2004-01-01,27,19,27,19,46
21004,COLQUIRI,estado nutricional,clasificacion f,2004-01-01,2,0,2,0,2
71301,COMARAPA,estado nutricional,clasificacion f,2004-01-01,5,2,5,2,7
20605,COMBAYA,estado nutricional,clasificacion f,2004-01-01,1,0,1,0,1
21701,COPACABANA,estado nutricional,clasificacion f,2004-01-01,1,0,1,0,1
40301,CORQUE,estado nutricional,clasificacion f,2004-01-01,2,0,2,0,2
50601,COTAGAITA,estado nutricional,clasificacion f,2004-01-01,9,3,9,3,12
70102,COTOCA,estado nutricional,clasificacion f,2004-01-01,3,0,3,0,3
70704,CUEVO,estado nutricional,clasificacion f,2004-01-01,1,0,1,0,1
10902,CULPINA,estado nutricional,clasificacion f,2004-01-01,5,7,5,7,12
21602,CURVA,estado nutricional,clasificacion f,2004-01-01,1,0,1,0,1
20105,EL ALTO,estado nutricional,clasificacion f,2004-01-01,45,29,45,29,74
40103,EL CHORO,estado nutricional,clasificacion f,2004-01-01,1,0,1,0,1
71503,EL PUENTE(STC),estado nutricional,clasificacion f,2004-01-01,0,4,0,4,4
60502,EL PUENTE(TJA),estado nutricional,clasificacion f,2004-01-01,2,1,2,1,3
70105,EL TORNO,estado nutricional,clasificacion f,2004-01-01,4,2,4,2,6
10405,EL VILLAR,estado nutricional,clasificacion f,2004-01-01,3,2,3,2,5
60601,ENTRE RIOS,estado nutricional,clasificacion f,2004-01-01,2,1,2,1,3
80402,EXALTACION,estado nutricional,clasificacion f,2004-01-01,2,2,2,2,4
71002,GENERAL SAAVEDRA,estado nutricional,clasificacion f,2004-01-01,3,0,3,0,3
21601,GRAL. J.J. PEREZ (CHARAZANI),estado nutricional,clasificacion f,2004-01-01,1,1,1,1,2
20602,GUANAY,estado nutricional,clasificacion f,2004-01-01,4,1,4,1,5
80202,GUAYARAMERIN,estado nutricional,clasificacion f,2004-01-01,1,4,1,4,5
70705,GUTIERREZ,estado nutricional,clasificacion f,2004-01-01,11,11,11,11,22
10502,HUACARETA,estado nutricional,clasificacion f,2004-01-01,3,2,3,2,5
11002,HUACAYA (VILLA DE HUACAYA),estado nutricional,clasificacion f,2004-01-01,1,0,1,0,1
40701,HUANUNI,estado nutricional,clasificacion f,2004-01-01,1,0,1,0,1
21005,ICHOCA,estado nutricional,clasificacion f,2004-01-01,2,2,2,2,4
10304,ICLA,estado nutricional,clasificacion f,2004-01-01,6,2,6,2,8
10703,INCAHUASI,estado nutricional,clasificacion f,2004-01-01,13,6,13,6,19
21001,INQUISIVI,estado nutricional,clasificacion f,2004-01-01,5,5,5,5,10
21501,IXIAMAS,estado nutricional,clasificacion f,2004-01-01,9,2,9,2,11
21105,LA ASUNTA,estado nutricional,clasificacion f,2004-01-01,1,1,1,1,2
70104,LA GUARDIA,estado nutricional,clasificacion f,2004-01-01,3,2,3,2,5
20101,LA PAZ,estado nutricional,clasificacion f,2004-01-01,56,13,56,13,69
70701,LAGUNILLAS,estado nutricional,clasificacion f,2004-01-01,4,2,4,2,6
10903,LAS CARRERAS,estado nutricional,clasificacion f,2004-01-01,0,1,0,1,1
50203,LLALLAGUA,estado nutricional,clasificacion f,2004-01-01,16,13,16,13,29
11003,MACHARETI,estado nutricional,clasificacion f,2004-01-01,1,3,1,3,4
71003,MINEROS,estado nutricional,clasificacion f,2004-01-01,16,5,16,5,21
31301,MIZQUE,estado nutricional,clasificacion f,2004-01-01,6,2,6,2,8
20402,MOCOMOCO,estado nutricional,clasificacion f,2004-01-01,2,2,2,2,4
51002,MOJINETE,estado nutricional,clasificacion f,2004-01-01,0,1,0,1,1
10303,MOJOCOYA,estado nutricional,clasificacion f,2004-01-01,1,0,1,0,1
10501,MONTEAGUDO,estado nutricional,clasificacion f,2004-01-01,8,1,8,1,9
71001,MONTERO,estado nutricional,clasificacion f,2004-01-01,15,8,15,8,23
30302,MOROCHATA,estado nutricional,clasificacion f,2004-01-01,2,0,2,0,2
50404,OCURI,estado nutricional,clasificacion f,2004-01-01,11,1,11,1,12
70202,OKINAWA,estado nutricional,clasificacion f,2004-01-01,0,1,0,1,1
40101,ORURO,estado nutricional,clasificacion f,2004-01-01,14,40,14,40,54
10401,PADILLA,estado nutricional,clasificacion f,2004-01-01,8,3,8,3,11
70502,PAILON,estado nutricional,clasificacion f,2004-01-01,2,1,2,1,3
20102,PALCA,estado nutricional,clasificacion f,2004-01-01,1,1,1,1,2
21104,PALOS BLANCOS,estado nutricional,clasificacion f,2004-01-01,3,1,3,1,4
70902,PAMPA GRANDE,estado nutricional,clasificacion f,2004-01-01,1,0,1,0,1
30202,PASORAPA,estado nutricional,clasificacion f,2004-01-01,0,1,0,1,1
21305,PATACAMAYA,estado nutricional,clasificacion f,2004-01-01,1,0,1,0,1
40602,PAZÃ‘A,estado nutricional,clasificacion f,2004-01-01,1,1,1,1,2
20702,PELECHUCO,estado nutricional,clasificacion f,2004-01-01,2,0,2,0,2
50403,POCOATA,estado nutricional,clasificacion f,2004-01-01,2,3,2,3,5
31203,POCONA,estado nutricional,clasificacion f,2004-01-01,2,4,2,4,6
31202,POJO (CBBA),estado nutricional,clasificacion f,2004-01-01,2,1,2,1,3
40601,POOPO,estado nutricional,clasificacion f,2004-01-01,1,0,1,0,1
51203,PORCO,estado nutricional,clasificacion f,2004-01-01,1,0,1,0,1
10103,POROMA,estado nutricional,clasificacion f,2004-01-01,1,3,1,3,4
70601,PORTACHUELO,estado nutricional,clasificacion f,2004-01-01,6,1,6,1,7
70804,POSTRER VALLE,estado nutricional,clasificacion f,2004-01-01,1,0,1,0,1
50101,POTOSI,estado nutricional,clasificacion f,2004-01-01,19,4,19,4,23
10302,PRESTO,estado nutricional,clasificacion f,2004-01-01,6,2,6,2,8
20401,PUERTO ACOSTA,estado nutricional,clasificacion f,2004-01-01,0,1,0,1,1
20403,PUERTO CARABUCO,estado nutricional,clasificacion f,2004-01-01,0,1,0,1,1
21204,PUERTO PEREZ,estado nutricional,clasificacion f,2004-01-01,1,0,1,0,1
71402,PUERTO QUIJARRO,estado nutricional,clasificacion f,2004-01-01,0,1,0,1,1
71401,PUERTO SUAREZ,estado nutricional,clasificacion f,2004-01-01,1,2,1,2,3
31205,PUERTO VILLARROEL,estado nutricional,clasificacion f,2004-01-01,10,6,10,6,16
51101,PUNA,estado nutricional,clasificacion f,2004-01-01,6,4,6,4,10
31401,PUNATA,estado nutricional,clasificacion f,2004-01-01,1,1,1,1,2
20604,QUIABAYA,estado nutricional,clasificacion f,2004-01-01,1,0,1,0,1
30901,QUILLACOLLO,estado nutricional,clasificacion f,2004-01-01,2,0,2,0,2
21002,QUIME,estado nutricional,clasificacion f,2004-01-01,4,5,4,5,9
50402,RAVELO,estado nutricional,clasificacion f,2004-01-01,5,6,5,6,11
80301,REYES,estado nutricional,clasificacion f,2004-01-01,2,5,2,5,7
80201,RIBERALTA,estado nutricional,clasificacion f,2004-01-01,21,20,21,20,41
70503,ROBORE,estado nutricional,clasificacion f,2004-01-01,6,3,6,3,9
31001,SACABA,estado nutricional,clasificacion f,2004-01-01,4,3,4,3,7
30404,SACABAMBA,estado nutricional,clasificacion f,2004-01-01,2,0,2,0,2
50701,SACACA,estado nutricional,clasificacion f,2004-01-01,6,1,6,1,7
71302,SAIPINA,estado nutricional,clasificacion f,2004-01-01,0,1,0,1,1
40801,SALINAS DE GARCI MENDOZA,estado nutricional,clasificacion f,2004-01-01,2,0,2,0,2
51601,SAN AGUSTIN,estado nutricional,clasificacion f,2004-01-01,1,0,1,0,1
80602,SAN ANDRES,estado nutricional,clasificacion f,2004-01-01,0,1,0,1,1
71105,SAN ANTONIO DE LOMERIO,estado nutricional,clasificacion f,2004-01-01,7,5,7,5,12
31403,SAN BENITO,estado nutricional,clasificacion f,2004-01-01,2,0,2,0,2
80302,SAN BORJA,estado nutricional,clasificacion f,2004-01-01,17,2,17,2,19
21502,SAN BUENA VENTURA,estado nutricional,clasificacion f,2004-01-01,5,2,5,2,7
80501,SAN IGNACIO,estado nutricional,clasificacion f,2004-01-01,11,7,11,7,18
70301,SAN IGNACIO DE VELASCO,estado nutricional,clasificacion f,2004-01-01,27,10,27,10,37
80701,SAN JOAQUIN,estado nutricional,clasificacion f,2004-01-01,1,1,1,1,2
70501,SAN JOSE DE CHIQUITOS,estado nutricional,clasificacion f,2004-01-01,2,2,2,2,4
71104,SAN JULIAN,estado nutricional,clasificacion f,2004-01-01,5,5,5,5,10
90302,SAN LORENZO(PND),estado nutricional,clasificacion f,2004-01-01,1,0,1,0,1
60501,SAN LORENZO(TJA),estado nutricional,clasificacion f,2004-01-01,1,2,1,2,3
10702,SAN LUCAS,estado nutricional,clasificacion f,2004-01-01,11,8,11,8,19
71201,SAN MATIAS,estado nutricional,clasificacion f,2004-01-01,1,0,1,0,1
70302,SAN MIGUEL DE VELASCO,estado nutricional,clasificacion f,2004-01-01,0,1,0,1,1
50501,SAN PEDRO DE BUENA VISTA,estado nutricional,clasificacion f,2004-01-01,8,2,8,2,10
70303,SAN RAFAEL,estado nutricional,clasificacion f,2004-01-01,3,0,3,0,3
70101,SANTA CRUZ DE LA SIERRA,estado nutricional,clasificacion f,2004-01-01,52,14,52,14,66
80303,SANTA ROSA,estado nutricional,clasificacion f,2004-01-01,2,1,2,1,3
70602,SANTA ROSA DEL SARA,estado nutricional,clasificacion f,2004-01-01,1,0,1,0,1
41401,SANTIAGO DE HUARI,estado nutricional,clasificacion f,2004-01-01,1,0,1,0,1
30702,SANTIVAÃ‘ES,estado nutricional,clasificacion f,2004-01-01,3,0,3,0,3
20902,SAPAHAQUI,estado nutricional,clasificacion f,2004-01-01,1,1,1,1,2
21301,SICA SICA (VILLA AROMA),estado nutricional,clasificacion f,2004-01-01,9,1,9,1,10
30902,SIPE SIPE,estado nutricional,clasificacion f,2004-01-01,5,1,5,1,6
10403,SOPACHUY,estado nutricional,clasificacion f,2004-01-01,7,7,7,7,14
20601,SORATA,estado nutricional,clasificacion f,2004-01-01,1,1,1,1,2
10101,SUCRE,estado nutricional,clasificacion f,2004-01-01,21,14,21,14,35
50303,TACOBAMBA,estado nutricional,clasificacion f,2004-01-01,1,1,1,1,2
30602,TACOPAYA,estado nutricional,clasificacion f,2004-01-01,2,1,2,1,3
31101,TAPACARI,estado nutricional,clasificacion f,2004-01-01,6,2,6,2,8
10601,TARABUCO,estado nutricional,clasificacion f,2004-01-01,25,15,25,15,40
60101,TARIJA,estado nutricional,clasificacion f,2004-01-01,3,2,3,2,5
10202,TARVITA,estado nutricional,clasificacion f,2004-01-01,19,8,19,8,27
20803,TIAWANACU,estado nutricional,clasificacion f,2004-01-01,0,1,0,1,1
50102,TINGUIPAYA,estado nutricional,clasificacion f,2004-01-01,4,5,4,5,9
20606,TIPUANI,estado nutricional,clasificacion f,2004-01-01,1,0,1,0,1
31601,TIRAQUE (CBBA),estado nutricional,clasificacion f,2004-01-01,22,11,22,11,33
30803,TOLATA,estado nutricional,clasificacion f,2004-01-01,0,2,0,2,2
51202,TOMAVE,estado nutricional,clasificacion f,2004-01-01,2,1,2,1,3
10402,TOMINA,estado nutricional,clasificacion f,2004-01-01,10,19,10,19,29
50502,TORO TORO,estado nutricional,clasificacion f,2004-01-01,7,3,7,3,10
31201,TOTORA(CBBA),estado nutricional,clasificacion f,2004-01-01,4,1,4,1,5
80101,TRINIDAD,estado nutricional,clasificacion f,2004-01-01,13,22,13,22,35
50801,TUPIZA,estado nutricional,clasificacion f,2004-01-01,3,8,3,8,11
50201,UNCIA,estado nutricional,clasificacion f,2004-01-01,1,1,1,1,2
60401,URIONDO (A. CONCEPCION),estado nutricional,clasificacion f,2004-01-01,1,0,1,0,1
51201,UYUNI,estado nutricional,clasificacion f,2004-01-01,0,3,0,3,3
30502,VACAS,estado nutricional,clasificacion f,2004-01-01,4,0,4,0,4
70801,VALLEGRANDE,estado nutricional,clasificacion f,2004-01-01,1,1,1,1,2
20801,VIACHA,estado nutricional,clasificacion f,2004-01-01,4,4,4,4,8
60303,VILLA MONTES,estado nutricional,clasificacion f,2004-01-01,8,1,8,1,9
31402,VILLA RIVERO,estado nutricional,clasificacion f,2004-01-01,2,2,2,2,4
10801,VILLA SERRANO,estado nutricional,clasificacion f,2004-01-01,6,9,6,9,15
31003,VILLA TUNARI,estado nutricional,clasificacion f,2004-01-01,12,11,12,11,23
11001,VILLA VACA GUZMAN (MUYUPAMPA),estado nutricional,clasificacion f,2004-01-01,0,2,0,2,2
51501,VILLAZON,estado nutricional,clasificacion f,2004-01-01,2,0,2,0,2
30904,VINTO,estado nutricional,clasificacion f,2004-01-01,6,6,6,6,12
50602,VITICHI,estado nutricional,clasificacion f,2004-01-01,2,0,2,0,2
70201,WARNES,estado nutricional,clasificacion f,2004-01-01,9,1,9,1,10
60301,YACUIBA,estado nutricional,clasificacion f,2004-01-01,10,0,10,0,10
10602,YAMPARAEZ,estado nutricional,clasificacion f,2004-01-01,11,3,11,3,14
70403,YAPACANI,estado nutricional,clasificacion f,2004-01-01,3,1,3,1,4
10102,YOTALA,estado nutricional,clasificacion f,2004-01-01,2,1,2,1,3
60402,YUNCHARA,estado nutricional,clasificacion f,2004-01-01,0,2,0,2,2
10301,ZUDAÃ‘EZ,estado nutricional,clasificacion f,2004-01-01,7,2,7,2,9
51302,ACACIO,estado nutricional,clasificacion f,2004-02-01,3,6,3,6,9
20201,ACHACACHI,estado nutricional,clasificacion f,2004-02-01,1,3,1,3,4
20104,ACHOCALLA,estado nutricional,clasificacion f,2004-02-01,2,1,2,1,3
30201,AIQUILE,estado nutricional,clasificacion f,2004-02-01,11,1,11,1,12
10404,ALCALA,estado nutricional,clasificacion f,2004-02-01,1,5,1,5,6
20202,ANCORAIMES,estado nutricional,clasificacion f,2004-02-01,2,0,2,0,2
41201,ANDAMARCA,estado nutricional,clasificacion f,2004-02-01,1,0,1,0,1
30402,ANZALDO,estado nutricional,clasificacion f,2004-02-01,5,0,5,0,5
51301,ARAMPAMPA,estado nutricional,clasificacion f,2004-02-01,3,0,3,0,3
30501,ARANI,estado nutricional,clasificacion f,2004-02-01,2,0,2,0,2
30403,ARBIETO,estado nutricional,clasificacion f,2004-02-01,1,0,1,0,1
30601,ARQUE,estado nutricional,clasificacion f,2004-02-01,2,2,2,2,4
71501,ASCENCION DE GUARAYOS,estado nutricional,clasificacion f,2004-02-01,18,5,18,5,23
50802,ATOCHA,estado nutricional,clasificacion f,2004-02-01,2,3,2,3,5
20503,AUCAPATA,estado nutricional,clasificacion f,2004-02-01,2,0,2,0,2
20502,AYATA,estado nutricional,clasificacion f,2004-02-01,10,2,10,2,12
21303,AYO AYO,estado nutricional,clasificacion f,2004-02-01,1,1,1,1,2
30301,AYOPAYA (V. DE INDEPENDENCIA),estado nutricional,clasificacion f,2004-02-01,8,2,8,2,10
10201,AZURDUY,estado nutricional,clasificacion f,2004-02-01,12,16,12,16,28
80802,BAURES,estado nutricional,clasificacion f,2004-02-01,1,0,1,0,1
50301,BETANZOS,estado nutricional,clasificacion f,2004-02-01,19,11,19,11,30
31501,BOLIVAR,estado nutricional,clasificacion f,2004-02-01,0,2,0,2,2
70707,BOYUIBE,estado nutricional,clasificacion f,2004-02-01,1,0,1,0,1
70703,CABEZAS,estado nutricional,clasificacion f,2004-02-01,5,2,5,2,7
20905,CAIROMA,estado nutricional,clasificacion f,2004-02-01,2,0,2,0,2
51102,"CAIZA ""D""",estado nutricional,clasificacion f,2004-02-01,3,2,3,2,5
21003,CAJUATA,estado nutricional,clasificacion f,2004-02-01,1,1,1,1,2
20303,CALACOTO,estado nutricional,clasificacion f,2004-02-01,0,1,0,1,1
21304,CALAMARCA,estado nutricional,clasificacion f,2004-02-01,4,1,4,1,5
10701,CAMARGO,estado nutricional,clasificacion f,2004-02-01,1,0,1,0,1
70706,CAMIRI,estado nutricional,clasificacion f,2004-02-01,9,6,9,6,15
30701,CAPINOTA,estado nutricional,clasificacion f,2004-02-01,2,0,2,0,2
40102,CARACOLLO,estado nutricional,clasificacion f,2004-02-01,2,0,2,0,2
22001,CARANAVI,estado nutricional,clasificacion f,2004-02-01,6,3,6,3,9
60302,CARAPARI,estado nutricional,clasificacion f,2004-02-01,1,1,1,1,2
50702,CARIPUYO,estado nutricional,clasificacion f,2004-02-01,5,4,5,4,9
40201,CHALLAPATA,estado nutricional,clasificacion f,2004-02-01,4,1,4,1,5
70702,CHARAGUA,estado nutricional,clasificacion f,2004-02-01,13,6,13,6,19
50202,CHAYANTA,estado nutricional,clasificacion f,2004-02-01,1,3,1,3,4
20501,CHUMA,estado nutricional,clasificacion f,2004-02-01,5,0,5,0,5
90101,COBIJA,estado nutricional,clasificacion f,2004-02-01,6,4,6,4,10
30101,COCHABAMBA,estado nutricional,clasificacion f,2004-02-01,9,5,9,5,14
31002,COLOMI,estado nutricional,clasificacion f,2004-02-01,2,2,2,2,4
50401,COLQUECHACA,estado nutricional,clasificacion f,2004-02-01,10,13,10,13,23
71301,COMARAPA,estado nutricional,clasificacion f,2004-02-01,4,0,4,0,4
21701,COPACABANA,estado nutricional,clasificacion f,2004-02-01,1,0,1,0,1
20301,CORO CORO,estado nutricional,clasificacion f,2004-02-01,0,2,0,2,2
21401,COROICO,estado nutricional,clasificacion f,2004-02-01,1,0,1,0,1
40301,CORQUE,estado nutricional,clasificacion f,2004-02-01,3,0,3,0,3
50601,COTAGAITA,estado nutricional,clasificacion f,2004-02-01,6,5,6,5,11
70102,COTOCA,estado nutricional,clasificacion f,2004-02-01,1,2,1,2,3
10902,CULPINA,estado nutricional,clasificacion f,2004-02-01,7,7,7,7,14
21602,CURVA,estado nutricional,clasificacion f,2004-02-01,1,0,1,0,1
20105,EL ALTO,estado nutricional,clasificacion f,2004-02-01,55,18,55,18,73
40103,EL CHORO,estado nutricional,clasificacion f,2004-02-01,4,2,4,2,6
71503,EL PUENTE(STC),estado nutricional,clasificacion f,2004-02-01,3,3,3,3,6
70105,EL TORNO,estado nutricional,clasificacion f,2004-02-01,1,1,1,1,2
10405,EL VILLAR,estado nutricional,clasificacion f,2004-02-01,4,1,4,1,5
41101,EUCALIPTUS,estado nutricional,clasificacion f,2004-02-01,1,0,1,0,1
80402,EXALTACION,estado nutricional,clasificacion f,2004-02-01,2,2,2,2,4
71002,GENERAL SAAVEDRA,estado nutricional,clasificacion f,2004-02-01,11,8,11,8,19
21601,GRAL. J.J. PEREZ (CHARAZANI),estado nutricional,clasificacion f,2004-02-01,1,0,1,0,1
20602,GUANAY,estado nutricional,clasificacion f,2004-02-01,2,5,2,5,7
20802,GUAQUI,estado nutricional,clasificacion f,2004-02-01,2,0,2,0,2
80202,GUAYARAMERIN,estado nutricional,clasificacion f,2004-02-01,4,2,4,2,6
70705,GUTIERREZ,estado nutricional,clasificacion f,2004-02-01,6,18,6,18,24
10502,HUACARETA,estado nutricional,clasificacion f,2004-02-01,4,1,4,1,5
11002,HUACAYA (VILLA DE HUACAYA),estado nutricional,clasificacion f,2004-02-01,1,1,1,1,2
40501,HUACHACALLA,estado nutricional,clasificacion f,2004-02-01,0,1,0,1,1
80803,HUARACAJE,estado nutricional,clasificacion f,2004-02-01,2,0,2,0,2
21005,ICHOCA,estado nutricional,clasificacion f,2004-02-01,2,0,2,0,2
10304,ICLA,estado nutricional,clasificacion f,2004-02-01,5,7,5,7,12
10703,INCAHUASI,estado nutricional,clasificacion f,2004-02-01,9,12,9,12,21
21501,IXIAMAS,estado nutricional,clasificacion f,2004-02-01,3,4,3,4,7
21105,LA ASUNTA,estado nutricional,clasificacion f,2004-02-01,1,0,1,0,1
70104,LA GUARDIA,estado nutricional,clasificacion f,2004-02-01,2,3,2,3,5
20101,LA PAZ,estado nutricional,clasificacion f,2004-02-01,53,17,53,17,70
70701,LAGUNILLAS,estado nutricional,clasificacion f,2004-02-01,0,7,0,7,7
50203,LLALLAGUA,estado nutricional,clasificacion f,2004-02-01,14,4,14,4,18
20901,LURIBAY,estado nutricional,clasificacion f,2004-02-01,1,1,1,1,2
11003,MACHARETI,estado nutricional,clasificacion f,2004-02-01,3,2,3,2,5
80801,MAGDALENA,estado nutricional,clasificacion f,2004-02-01,0,1,0,1,1
71003,MINEROS,estado nutricional,clasificacion f,2004-02-01,7,4,7,4,11
31301,MIZQUE,estado nutricional,clasificacion f,2004-02-01,3,2,3,2,5
20402,MOCOMOCO,estado nutricional,clasificacion f,2004-02-01,1,2,1,2,3
10303,MOJOCOYA,estado nutricional,clasificacion f,2004-02-01,2,0,2,0,2
10501,MONTEAGUDO,estado nutricional,clasificacion f,2004-02-01,8,2,8,2,10
71001,MONTERO,estado nutricional,clasificacion f,2004-02-01,14,7,14,7,21
70803,MORO MORO,estado nutricional,clasificacion f,2004-02-01,0,1,0,1,1
30302,MOROCHATA,estado nutricional,clasificacion f,2004-02-01,1,1,1,1,2
50404,OCURI,estado nutricional,clasificacion f,2004-02-01,9,7,9,7,16
70202,OKINAWA,estado nutricional,clasificacion f,2004-02-01,1,0,1,0,1
40101,ORURO,estado nutricional,clasificacion f,2004-02-01,12,5,12,5,17
60201,PADCAYA,estado nutricional,clasificacion f,2004-02-01,1,0,1,0,1
10401,PADILLA,estado nutricional,clasificacion f,2004-02-01,8,1,8,1,9
70502,PAILON,estado nutricional,clasificacion f,2004-02-01,4,0,4,0,4
20102,PALCA,estado nutricional,clasificacion f,2004-02-01,1,0,1,0,1
21104,PALOS BLANCOS,estado nutricional,clasificacion f,2004-02-01,1,2,1,2,3
40802,PAMPA AULLAGAS,estado nutricional,clasificacion f,2004-02-01,0,1,0,1,1
70902,PAMPA GRANDE,estado nutricional,clasificacion f,2004-02-01,0,1,0,1,1
21305,PATACAMAYA,estado nutricional,clasificacion f,2004-02-01,5,4,5,4,9
50403,POCOATA,estado nutricional,clasificacion f,2004-02-01,7,5,7,5,12
31203,POCONA,estado nutricional,clasificacion f,2004-02-01,3,1,3,1,4
31202,POJO (CBBA),estado nutricional,clasificacion f,2004-02-01,3,1,3,1,4
40601,POOPO,estado nutricional,clasificacion f,2004-02-01,1,3,1,3,4
51203,PORCO,estado nutricional,clasificacion f,2004-02-01,1,0,1,0,1
10103,POROMA,estado nutricional,clasificacion f,2004-02-01,6,4,6,4,10
90102,PORVENIR,estado nutricional,clasificacion f,2004-02-01,1,1,1,1,2
50101,POTOSI,estado nutricional,clasificacion f,2004-02-01,14,3,14,3,17
10302,PRESTO,estado nutricional,clasificacion f,2004-02-01,5,0,5,0,5
21201,PUCARANI,estado nutricional,clasificacion f,2004-02-01,3,1,3,1,4
20403,PUERTO CARABUCO,estado nutricional,clasificacion f,2004-02-01,3,1,3,1,4
90301,PUERTO GONZALO MORENO,estado nutricional,clasificacion f,2004-02-01,1,2,1,2,3
80703,PUERTO SILES,estado nutricional,clasificacion f,2004-02-01,0,1,0,1,1
71401,PUERTO SUAREZ,estado nutricional,clasificacion f,2004-02-01,2,0,2,0,2
31205,PUERTO VILLARROEL,estado nutricional,clasificacion f,2004-02-01,11,11,11,11,22
51101,PUNA,estado nutricional,clasificacion f,2004-02-01,13,6,13,6,19
31401,PUNATA,estado nutricional,clasificacion f,2004-02-01,2,1,2,1,3
30901,QUILLACOLLO,estado nutricional,clasificacion f,2004-02-01,12,10,12,10,22
21002,QUIME,estado nutricional,clasificacion f,2004-02-01,1,2,1,2,3
50402,RAVELO,estado nutricional,clasificacion f,2004-02-01,16,7,16,7,23
80301,REYES,estado nutricional,clasificacion f,2004-02-01,1,2,1,2,3
80201,RIBERALTA,estado nutricional,clasificacion f,2004-02-01,19,7,19,7,26
70503,ROBORE,estado nutricional,clasificacion f,2004-02-01,5,4,5,4,9
80304,RURRENABAQUE,estado nutricional,clasificacion f,2004-02-01,1,1,1,1,2
31001,SACABA,estado nutricional,clasificacion f,2004-02-01,6,0,6,0,6
30404,SACABAMBA,estado nutricional,clasificacion f,2004-02-01,1,2,1,2,3
50701,SACACA,estado nutricional,clasificacion f,2004-02-01,24,11,24,11,35
71302,SAIPINA,estado nutricional,clasificacion f,2004-02-01,1,0,1,0,1
71105,SAN ANTONIO DE LOMERIO,estado nutricional,clasificacion f,2004-02-01,4,3,4,3,7
31403,SAN BENITO,estado nutricional,clasificacion f,2004-02-01,2,0,2,0,2
80302,SAN BORJA,estado nutricional,clasificacion f,2004-02-01,15,8,15,8,23
21502,SAN BUENA VENTURA,estado nutricional,clasificacion f,2004-02-01,2,0,2,0,2
70402,SAN CARLOS,estado nutricional,clasificacion f,2004-02-01,2,0,2,0,2
80501,SAN IGNACIO,estado nutricional,clasificacion f,2004-02-01,7,6,7,6,13
70301,SAN IGNACIO DE VELASCO,estado nutricional,clasificacion f,2004-02-01,25,13,25,13,38
80102,SAN JAVIER(BNI),estado nutricional,clasificacion f,2004-02-01,2,0,2,0,2
71102,SAN JAVIER(STC),estado nutricional,clasificacion f,2004-02-01,0,1,0,1,1
80701,SAN JOAQUIN,estado nutricional,clasificacion f,2004-02-01,1,0,1,0,1
70501,SAN JOSE DE CHIQUITOS,estado nutricional,clasificacion f,2004-02-01,1,0,1,0,1
71104,SAN JULIAN,estado nutricional,clasificacion f,2004-02-01,6,6,6,6,12
90302,SAN LORENZO(PND),estado nutricional,clasificacion f,2004-02-01,0,1,0,1,1
60501,SAN LORENZO(TJA),estado nutricional,clasificacion f,2004-02-01,1,0,1,0,1
10702,SAN LUCAS,estado nutricional,clasificacion f,2004-02-01,9,9,9,9,18
71201,SAN MATIAS,estado nutricional,clasificacion f,2004-02-01,0,1,0,1,1
70302,SAN MIGUEL DE VELASCO,estado nutricional,clasificacion f,2004-02-01,1,12,1,12,13
50501,SAN PEDRO DE BUENA VISTA,estado nutricional,clasificacion f,2004-02-01,7,5,7,5,12
90202,SAN PEDRO(PND),estado nutricional,clasificacion f,2004-02-01,0,1,0,1,1
70303,SAN RAFAEL,estado nutricional,clasificacion f,2004-02-01,4,1,4,1,5
80401,SANTA ANA,estado nutricional,clasificacion f,2004-02-01,2,1,2,1,3
70101,SANTA CRUZ DE LA SIERRA,estado nutricional,clasificacion f,2004-02-01,40,32,40,32,72
80303,SANTA ROSA,estado nutricional,clasificacion f,2004-02-01,2,0,2,0,2
70602,SANTA ROSA DEL SARA,estado nutricional,clasificacion f,2004-02-01,2,2,2,2,4
41401,SANTIAGO DE HUARI,estado nutricional,clasificacion f,2004-02-01,2,1,2,1,3
30702,SANTIVAÃ‘ES,estado nutricional,clasificacion f,2004-02-01,1,1,1,1,2
21301,SICA SICA (VILLA AROMA),estado nutricional,clasificacion f,2004-02-01,4,3,4,3,7
30703,SICAYA,estado nutricional,clasificacion f,2004-02-01,2,0,2,0,2
30902,SIPE SIPE,estado nutricional,clasificacion f,2004-02-01,8,3,8,3,11
10403,SOPACHUY,estado nutricional,clasificacion f,2004-02-01,6,6,6,6,12
10101,SUCRE,estado nutricional,clasificacion f,2004-02-01,12,11,12,11,23
50303,TACOBAMBA,estado nutricional,clasificacion f,2004-02-01,2,1,2,1,3
30602,TACOPAYA,estado nutricional,clasificacion f,2004-02-01,3,2,3,2,5
31101,TAPACARI,estado nutricional,clasificacion f,2004-02-01,11,2,11,2,13
10601,TARABUCO,estado nutricional,clasificacion f,2004-02-01,31,11,31,11,42
30401,TARATA,estado nutricional,clasificacion f,2004-02-01,3,0,3,0,3
60101,TARIJA,estado nutricional,clasificacion f,2004-02-01,5,3,5,3,8
10202,TARVITA,estado nutricional,clasificacion f,2004-02-01,6,6,6,6,12
20803,TIAWANACU,estado nutricional,clasificacion f,2004-02-01,1,0,1,0,1
50102,TINGUIPAYA,estado nutricional,clasificacion f,2004-02-01,6,14,6,14,20
31601,TIRAQUE (CBBA),estado nutricional,clasificacion f,2004-02-01,17,4,17,4,21
30802,TOCO,estado nutricional,clasificacion f,2004-02-01,0,1,0,1,1
51202,TOMAVE,estado nutricional,clasificacion f,2004-02-01,3,2,3,2,5
10402,TOMINA,estado nutricional,clasificacion f,2004-02-01,18,3,18,3,21
50502,TORO TORO,estado nutricional,clasificacion f,2004-02-01,7,1,7,1,8
31201,TOTORA(CBBA),estado nutricional,clasificacion f,2004-02-01,3,1,3,1,4
41301,TOTORA(ORR),estado nutricional,clasificacion f,2004-02-01,0,1,0,1,1
70802,TRIGAL,estado nutricional,clasificacion f,2004-02-01,1,0,1,0,1
80101,TRINIDAD,estado nutricional,clasificacion f,2004-02-01,1,6,1,6,7
50801,TUPIZA,estado nutricional,clasificacion f,2004-02-01,3,3,3,3,6
50201,UNCIA,estado nutricional,clasificacion f,2004-02-01,1,0,1,0,1
60401,URIONDO (A. CONCEPCION),estado nutricional,clasificacion f,2004-02-01,1,0,1,0,1
71502,URUBICHA,estado nutricional,clasificacion f,2004-02-01,1,3,1,3,4
51201,UYUNI,estado nutricional,clasificacion f,2004-02-01,2,1,2,1,3
30502,VACAS,estado nutricional,clasificacion f,2004-02-01,4,0,4,0,4
70801,VALLEGRANDE,estado nutricional,clasificacion f,2004-02-01,2,4,2,4,6
20801,VIACHA,estado nutricional,clasificacion f,2004-02-01,6,3,6,3,9
31302,VILA VILA,estado nutricional,clasificacion f,2004-02-01,3,4,3,4,7
60303,VILLA MONTES,estado nutricional,clasificacion f,2004-02-01,16,0,16,0,16
31402,VILLA RIVERO,estado nutricional,clasificacion f,2004-02-01,2,0,2,0,2
10801,VILLA SERRANO,estado nutricional,clasificacion f,2004-02-01,7,7,7,7,14
31003,VILLA TUNARI,estado nutricional,clasificacion f,2004-02-01,16,10,16,10,26
11001,VILLA VACA GUZMAN (MUYUPAMPA),estado nutricional,clasificacion f,2004-02-01,2,1,2,1,3
51501,VILLAZON,estado nutricional,clasificacion f,2004-02-01,5,3,5,3,8
30904,VINTO,estado nutricional,clasificacion f,2004-02-01,5,1,5,1,6
50602,VITICHI,estado nutricional,clasificacion f,2004-02-01,7,1,7,1,8
70201,WARNES,estado nutricional,clasificacion f,2004-02-01,3,2,3,2,5
20903,YACO,estado nutricional,clasificacion f,2004-02-01,7,2,7,2,9
60301,YACUIBA,estado nutricional,clasificacion f,2004-02-01,5,1,5,1,6
10602,YAMPARAEZ,estado nutricional,clasificacion f,2004-02-01,12,4,12,4,16
70403,YAPACANI,estado nutricional,clasificacion f,2004-02-01,2,2,2,2,4
10102,YOTALA,estado nutricional,clasificacion f,2004-02-01,3,2,3,2,5
60402,YUNCHARA,estado nutricional,clasificacion f,2004-02-01,2,2,2,2,4
10301,ZUDAÃ‘EZ,estado nutricional,clasificacion f,2004-02-01,7,1,7,1,8
51302,ACACIO,estado nutricional,clasificacion f,2004-03-01,5,7,5,7,12
20201,ACHACACHI,estado nutricional,clasificacion f,2004-03-01,6,3,6,3,9
30201,AIQUILE,estado nutricional,clasificacion f,2004-03-01,12,8,12,8,20
10404,ALCALA,estado nutricional,clasificacion f,2004-03-01,1,5,1,5,6
20202,ANCORAIMES,estado nutricional,clasificacion f,2004-03-01,5,1,5,1,6
40603,ANTEQUERA,estado nutricional,clasificacion f,2004-03-01,1,0,1,0,1
30402,ANZALDO,estado nutricional,clasificacion f,2004-03-01,3,0,3,0,3
20701,APOLO,estado nutricional,clasificacion f,2004-03-01,3,1,3,1,4
51301,ARAMPAMPA,estado nutricional,clasificacion f,2004-03-01,4,1,4,1,5
30501,ARANI,estado nutricional,clasificacion f,2004-03-01,2,4,2,4,6
30601,ARQUE,estado nutricional,clasificacion f,2004-03-01,13,5,13,5,18
50802,ATOCHA,estado nutricional,clasificacion f,2004-03-01,1,6,1,6,7
20503,AUCAPATA,estado nutricional,clasificacion f,2004-03-01,3,0,3,0,3
20502,AYATA,estado nutricional,clasificacion f,2004-03-01,9,4,9,4,13
21303,AYO AYO,estado nutricional,clasificacion f,2004-03-01,1,0,1,0,1
30301,AYOPAYA (V. DE INDEPENDENCIA),estado nutricional,clasificacion f,2004-03-01,9,3,9,3,12
10201,AZURDUY,estado nutricional,clasificacion f,2004-03-01,13,7,13,7,20
80802,BAURES,estado nutricional,clasificacion f,2004-03-01,2,0,2,0,2
60202,BERMEJO,estado nutricional,clasificacion f,2004-03-01,0,3,0,3,3
50301,BETANZOS,estado nutricional,clasificacion f,2004-03-01,15,10,15,10,25
31501,BOLIVAR,estado nutricional,clasificacion f,2004-03-01,3,4,3,4,7
70707,BOYUIBE,estado nutricional,clasificacion f,2004-03-01,0,2,0,2,2
70703,CABEZAS,estado nutricional,clasificacion f,2004-03-01,6,3,6,3,9
20905,CAIROMA,estado nutricional,clasificacion f,2004-03-01,5,1,5,1,6
51102,"CAIZA ""D""",estado nutricional,clasificacion f,2004-03-01,2,2,2,2,4
21003,CAJUATA,estado nutricional,clasificacion f,2004-03-01,0,1,0,1,1
21304,CALAMARCA,estado nutricional,clasificacion f,2004-03-01,3,0,3,0,3
10701,CAMARGO,estado nutricional,clasificacion f,2004-03-01,4,0,4,0,4
10901,CAMATAQUI (C. VILLA ABECIA),estado nutricional,clasificacion f,2004-03-01,2,0,2,0,2
70706,CAMIRI,estado nutricional,clasificacion f,2004-03-01,14,13,14,13,27
30701,CAPINOTA,estado nutricional,clasificacion f,2004-03-01,9,5,9,5,14
20302,CAQUIAVIRI,estado nutricional,clasificacion f,2004-03-01,1,0,1,0,1
22001,CARANAVI,estado nutricional,clasificacion f,2004-03-01,16,5,16,5,21
60302,CARAPARI,estado nutricional,clasificacion f,2004-03-01,2,3,2,3,5
50702,CARIPUYO,estado nutricional,clasificacion f,2004-03-01,23,4,23,4,27
40201,CHALLAPATA,estado nutricional,clasificacion f,2004-03-01,4,3,4,3,7
50302,CHAQUI,estado nutricional,clasificacion f,2004-03-01,0,2,0,2,2
70702,CHARAGUA,estado nutricional,clasificacion f,2004-03-01,23,5,23,5,28
50202,CHAYANTA,estado nutricional,clasificacion f,2004-03-01,8,3,8,3,11
20501,CHUMA,estado nutricional,clasificacion f,2004-03-01,6,3,6,3,9
30801,CLIZA,estado nutricional,clasificacion f,2004-03-01,5,2,5,2,7
90101,COBIJA,estado nutricional,clasificacion f,2004-03-01,4,1,4,1,5
30101,COCHABAMBA,estado nutricional,clasificacion f,2004-03-01,20,4,20,4,24
30905,COLCAPIRHUA,estado nutricional,clasificacion f,2004-03-01,2,0,2,0,2
50901,"COLCHA ""K""",estado nutricional,clasificacion f,2004-03-01,2,0,2,0,2
31002,COLOMI,estado nutricional,clasificacion f,2004-03-01,2,1,2,1,3
50401,COLQUECHACA,estado nutricional,clasificacion f,2004-03-01,30,12,30,12,42
21004,COLQUIRI,estado nutricional,clasificacion f,2004-03-01,9,1,9,1,10
71301,COMARAPA,estado nutricional,clasificacion f,2004-03-01,3,3,3,3,6
21701,COPACABANA,estado nutricional,clasificacion f,2004-03-01,2,0,2,0,2
40301,CORQUE,estado nutricional,clasificacion f,2004-03-01,2,4,2,4,6
50601,COTAGAITA,estado nutricional,clasificacion f,2004-03-01,13,12,13,12,25
70102,COTOCA,estado nutricional,clasificacion f,2004-03-01,5,2,5,2,7
70704,CUEVO,estado nutricional,clasificacion f,2004-03-01,1,0,1,0,1
10902,CULPINA,estado nutricional,clasificacion f,2004-03-01,12,7,12,7,19
20105,EL ALTO,estado nutricional,clasificacion f,2004-03-01,96,44,96,44,140
40103,EL CHORO,estado nutricional,clasificacion f,2004-03-01,1,0,1,0,1
71503,EL PUENTE(STC),estado nutricional,clasificacion f,2004-03-01,3,0,3,0,3
60502,EL PUENTE(TJA),estado nutricional,clasificacion f,2004-03-01,1,0,1,0,1
70105,EL TORNO,estado nutricional,clasificacion f,2004-03-01,3,0,3,0,3
10405,EL VILLAR,estado nutricional,clasificacion f,2004-03-01,5,1,5,1,6
60601,ENTRE RIOS,estado nutricional,clasificacion f,2004-03-01,2,3,2,3,5
80402,EXALTACION,estado nutricional,clasificacion f,2004-03-01,0,1,0,1,1
71002,GENERAL SAAVEDRA,estado nutricional,clasificacion f,2004-03-01,14,12,14,12,26
21601,GRAL. J.J. PEREZ (CHARAZANI),estado nutricional,clasificacion f,2004-03-01,4,10,4,10,14
20602,GUANAY,estado nutricional,clasificacion f,2004-03-01,11,3,11,3,14
80202,GUAYARAMERIN,estado nutricional,clasificacion f,2004-03-01,7,5,7,5,12
70705,GUTIERREZ,estado nutricional,clasificacion f,2004-03-01,18,20,18,20,38
10502,HUACARETA,estado nutricional,clasificacion f,2004-03-01,5,1,5,1,6
11002,HUACAYA (VILLA DE HUACAYA),estado nutricional,clasificacion f,2004-03-01,1,0,1,0,1
40701,HUANUNI,estado nutricional,clasificacion f,2004-03-01,3,2,3,2,5
10304,ICLA,estado nutricional,clasificacion f,2004-03-01,10,3,10,3,13
10703,INCAHUASI,estado nutricional,clasificacion f,2004-03-01,15,1,15,1,16
21001,INQUISIVI,estado nutricional,clasificacion f,2004-03-01,7,4,7,4,11
21102,IRUPANA (VILLA DE LANZA),estado nutricional,clasificacion f,2004-03-01,3,1,3,1,4
21501,IXIAMAS,estado nutricional,clasificacion f,2004-03-01,0,3,0,3,3
21105,LA ASUNTA,estado nutricional,clasificacion f,2004-03-01,1,1,1,1,2
70104,LA GUARDIA,estado nutricional,clasificacion f,2004-03-01,5,1,5,1,6
20101,LA PAZ,estado nutricional,clasificacion f,2004-03-01,70,37,70,37,107
70701,LAGUNILLAS,estado nutricional,clasificacion f,2004-03-01,4,1,4,1,5
50203,LLALLAGUA,estado nutricional,clasificacion f,2004-03-01,15,8,15,8,23
51401,LLICA,estado nutricional,clasificacion f,2004-03-01,3,0,3,0,3
20901,LURIBAY,estado nutricional,clasificacion f,2004-03-01,2,0,2,0,2
11003,MACHARETI,estado nutricional,clasificacion f,2004-03-01,3,2,3,2,5
80801,MAGDALENA,estado nutricional,clasificacion f,2004-03-01,2,3,2,3,5
70903,MAIRANA,estado nutricional,clasificacion f,2004-03-01,1,1,1,1,2
20904,MALLA,estado nutricional,clasificacion f,2004-03-01,0,2,0,2,2
71003,MINEROS,estado nutricional,clasificacion f,2004-03-01,5,1,5,1,6
31301,MIZQUE,estado nutricional,clasificacion f,2004-03-01,9,6,9,6,15
20402,MOCOMOCO,estado nutricional,clasificacion f,2004-03-01,6,0,6,0,6
51002,MOJINETE,estado nutricional,clasificacion f,2004-03-01,0,1,0,1,1
10303,MOJOCOYA,estado nutricional,clasificacion f,2004-03-01,2,0,2,0,2
10501,MONTEAGUDO,estado nutricional,clasificacion f,2004-03-01,8,5,8,5,13
71001,MONTERO,estado nutricional,clasificacion f,2004-03-01,17,9,17,9,26
70803,MORO MORO,estado nutricional,clasificacion f,2004-03-01,1,0,1,0,1
30302,MOROCHATA,estado nutricional,clasificacion f,2004-03-01,10,2,10,2,12
50404,OCURI,estado nutricional,clasificacion f,2004-03-01,6,2,6,2,8
70202,OKINAWA,estado nutricional,clasificacion f,2004-03-01,3,0,3,0,3
30203,OMEREQUE,estado nutricional,clasificacion f,2004-03-01,2,1,2,1,3
40101,ORURO,estado nutricional,clasificacion f,2004-03-01,30,4,30,4,34
60201,PADCAYA,estado nutricional,clasificacion f,2004-03-01,1,0,1,0,1
10401,PADILLA,estado nutricional,clasificacion f,2004-03-01,7,3,7,3,10
70502,PAILON,estado nutricional,clasificacion f,2004-03-01,0,2,0,2,2
20102,PALCA,estado nutricional,clasificacion f,2004-03-01,3,0,3,0,3
21104,PALOS BLANCOS,estado nutricional,clasificacion f,2004-03-01,5,0,5,0,5
70902,PAMPA GRANDE,estado nutricional,clasificacion f,2004-03-01,4,0,4,0,4
30202,PASORAPA,estado nutricional,clasificacion f,2004-03-01,0,3,0,3,3
21305,PATACAMAYA,estado nutricional,clasificacion f,2004-03-01,7,4,7,4,11
40602,PAZÃ‘A,estado nutricional,clasificacion f,2004-03-01,1,0,1,0,1
20702,PELECHUCO,estado nutricional,clasificacion f,2004-03-01,2,2,2,2,4
50403,POCOATA,estado nutricional,clasificacion f,2004-03-01,10,6,10,6,16
31203,POCONA,estado nutricional,clasificacion f,2004-03-01,5,1,5,1,6
31202,POJO (CBBA),estado nutricional,clasificacion f,2004-03-01,1,2,1,2,3
40601,POOPO,estado nutricional,clasificacion f,2004-03-01,2,0,2,0,2
51203,PORCO,estado nutricional,clasificacion f,2004-03-01,1,0,1,0,1
10103,POROMA,estado nutricional,clasificacion f,2004-03-01,13,6,13,6,19
70601,PORTACHUELO,estado nutricional,clasificacion f,2004-03-01,0,2,0,2,2
50101,POTOSI,estado nutricional,clasificacion f,2004-03-01,33,16,33,16,49
10302,PRESTO,estado nutricional,clasificacion f,2004-03-01,6,1,6,1,7
21201,PUCARANI,estado nutricional,clasificacion f,2004-03-01,1,1,1,1,2
20401,PUERTO ACOSTA,estado nutricional,clasificacion f,2004-03-01,5,1,5,1,6
20403,PUERTO CARABUCO,estado nutricional,clasificacion f,2004-03-01,2,1,2,1,3
90301,PUERTO GONZALO MORENO,estado nutricional,clasificacion f,2004-03-01,0,5,0,5,5
71401,PUERTO SUAREZ,estado nutricional,clasificacion f,2004-03-01,2,3,2,3,5
31205,PUERTO VILLARROEL,estado nutricional,clasificacion f,2004-03-01,36,30,36,30,66
51101,PUNA,estado nutricional,clasificacion f,2004-03-01,12,7,12,7,19
31401,PUNATA,estado nutricional,clasificacion f,2004-03-01,9,2,9,2,11
30901,QUILLACOLLO,estado nutricional,clasificacion f,2004-03-01,11,4,11,4,15
21002,QUIME,estado nutricional,clasificacion f,2004-03-01,1,0,1,0,1
50402,RAVELO,estado nutricional,clasificacion f,2004-03-01,16,6,16,6,22
80301,REYES,estado nutricional,clasificacion f,2004-03-01,4,0,4,0,4
80201,RIBERALTA,estado nutricional,clasificacion f,2004-03-01,34,41,34,41,75
70503,ROBORE,estado nutricional,clasificacion f,2004-03-01,9,2,9,2,11
80304,RURRENABAQUE,estado nutricional,clasificacion f,2004-03-01,2,0,2,0,2
31001,SACABA,estado nutricional,clasificacion f,2004-03-01,9,3,9,3,12
30404,SACABAMBA,estado nutricional,clasificacion f,2004-03-01,3,1,3,1,4
50701,SACACA,estado nutricional,clasificacion f,2004-03-01,13,16,13,16,29
71302,SAIPINA,estado nutricional,clasificacion f,2004-03-01,0,1,0,1,1
40801,SALINAS DE GARCI MENDOZA,estado nutricional,clasificacion f,2004-03-01,1,0,1,0,1
70901,SAMAIPATA,estado nutricional,clasificacion f,2004-03-01,1,0,1,0,1
51601,SAN AGUSTIN,estado nutricional,clasificacion f,2004-03-01,1,0,1,0,1
80602,SAN ANDRES,estado nutricional,clasificacion f,2004-03-01,4,1,4,1,5
71105,SAN ANTONIO DE LOMERIO,estado nutricional,clasificacion f,2004-03-01,9,11,9,11,20
31403,SAN BENITO,estado nutricional,clasificacion f,2004-03-01,2,0,2,0,2
80302,SAN BORJA,estado nutricional,clasificacion f,2004-03-01,20,18,20,18,38
21502,SAN BUENA VENTURA,estado nutricional,clasificacion f,2004-03-01,2,1,2,1,3
70402,SAN CARLOS,estado nutricional,clasificacion f,2004-03-01,2,6,2,6,8
80501,SAN IGNACIO,estado nutricional,clasificacion f,2004-03-01,22,10,22,10,32
70301,SAN IGNACIO DE VELASCO,estado nutricional,clasificacion f,2004-03-01,26,5,26,5,31
71102,SAN JAVIER(STC),estado nutricional,clasificacion f,2004-03-01,1,1,1,1,2
70501,SAN JOSE DE CHIQUITOS,estado nutricional,clasificacion f,2004-03-01,3,3,3,3,6
71104,SAN JULIAN,estado nutricional,clasificacion f,2004-03-01,9,4,9,4,13
90302,SAN LORENZO(PND),estado nutricional,clasificacion f,2004-03-01,1,1,1,1,2
60501,SAN LORENZO(TJA),estado nutricional,clasificacion f,2004-03-01,4,2,4,2,6
10702,SAN LUCAS,estado nutricional,clasificacion f,2004-03-01,19,6,19,6,25
71201,SAN MATIAS,estado nutricional,clasificacion f,2004-03-01,5,3,5,3,8
70302,SAN MIGUEL DE VELASCO,estado nutricional,clasificacion f,2004-03-01,3,2,3,2,5
50501,SAN PEDRO DE BUENA VISTA,estado nutricional,clasificacion f,2004-03-01,11,18,11,18,29
21801,SAN PEDRO DE CURAHUARA,estado nutricional,clasificacion f,2004-03-01,1,1,1,1,2
70303,SAN RAFAEL,estado nutricional,clasificacion f,2004-03-01,3,0,3,0,3
80401,SANTA ANA,estado nutricional,clasificacion f,2004-03-01,2,0,2,0,2
70101,SANTA CRUZ DE LA SIERRA,estado nutricional,clasificacion f,2004-03-01,63,29,63,29,92
80303,SANTA ROSA,estado nutricional,clasificacion f,2004-03-01,5,3,5,3,8
30702,SANTIVAÃ‘ES,estado nutricional,clasificacion f,2004-03-01,2,1,2,1,3
20902,SAPAHAQUI,estado nutricional,clasificacion f,2004-03-01,2,1,2,1,3
90303,SENA,estado nutricional,clasificacion f,2004-03-01,2,0,2,0,2
21301,SICA SICA (VILLA AROMA),estado nutricional,clasificacion f,2004-03-01,8,10,8,10,18
30703,SICAYA,estado nutricional,clasificacion f,2004-03-01,4,0,4,0,4
30902,SIPE SIPE,estado nutricional,clasificacion f,2004-03-01,16,3,16,3,19
10403,SOPACHUY,estado nutricional,clasificacion f,2004-03-01,2,3,2,3,5
10101,SUCRE,estado nutricional,clasificacion f,2004-03-01,31,20,31,20,51
50303,TACOBAMBA,estado nutricional,clasificacion f,2004-03-01,2,5,2,5,7
30602,TACOPAYA,estado nutricional,clasificacion f,2004-03-01,1,5,1,5,6
31101,TAPACARI,estado nutricional,clasificacion f,2004-03-01,15,9,15,9,24
10601,TARABUCO,estado nutricional,clasificacion f,2004-03-01,25,26,25,26,51
30401,TARATA,estado nutricional,clasificacion f,2004-03-01,1,0,1,0,1
60101,TARIJA,estado nutricional,clasificacion f,2004-03-01,3,3,3,3,6
10202,TARVITA,estado nutricional,clasificacion f,2004-03-01,21,6,21,6,27
20803,TIAWANACU,estado nutricional,clasificacion f,2004-03-01,1,1,1,1,2
50102,TINGUIPAYA,estado nutricional,clasificacion f,2004-03-01,7,12,7,12,19
30903,TIQUIPAYA,estado nutricional,clasificacion f,2004-03-01,4,0,4,0,4
31601,TIRAQUE (CBBA),estado nutricional,clasificacion f,2004-03-01,29,8,29,8,37
30802,TOCO,estado nutricional,clasificacion f,2004-03-01,1,3,1,3,4
41001,TOLEDO,estado nutricional,clasificacion f,2004-03-01,1,0,1,0,1
51202,TOMAVE,estado nutricional,clasificacion f,2004-03-01,3,2,3,2,5
10402,TOMINA,estado nutricional,clasificacion f,2004-03-01,14,6,14,6,20
50502,TORO TORO,estado nutricional,clasificacion f,2004-03-01,12,2,12,2,14
31201,TOTORA(CBBA),estado nutricional,clasificacion f,2004-03-01,4,1,4,1,5
41301,TOTORA(ORR),estado nutricional,clasificacion f,2004-03-01,1,0,1,0,1
80101,TRINIDAD,estado nutricional,clasificacion f,2004-03-01,14,9,14,9,23
50801,TUPIZA,estado nutricional,clasificacion f,2004-03-01,8,6,8,6,14
50201,UNCIA,estado nutricional,clasificacion f,2004-03-01,3,2,3,2,5
60401,URIONDO (A. CONCEPCION),estado nutricional,clasificacion f,2004-03-01,1,0,1,0,1
51201,UYUNI,estado nutricional,clasificacion f,2004-03-01,4,0,4,0,4
30502,VACAS,estado nutricional,clasificacion f,2004-03-01,2,1,2,1,3
70801,VALLEGRANDE,estado nutricional,clasificacion f,2004-03-01,3,5,3,5,8
20801,VIACHA,estado nutricional,clasificacion f,2004-03-01,8,3,8,3,11
31302,VILA VILA,estado nutricional,clasificacion f,2004-03-01,3,0,3,0,3
60303,VILLA MONTES,estado nutricional,clasificacion f,2004-03-01,13,3,13,3,16
31402,VILLA RIVERO,estado nutricional,clasificacion f,2004-03-01,2,1,2,1,3
10801,VILLA SERRANO,estado nutricional,clasificacion f,2004-03-01,5,5,5,5,10
31003,VILLA TUNARI,estado nutricional,clasificacion f,2004-03-01,19,13,19,13,32
11001,VILLA VACA GUZMAN (MUYUPAMPA),estado nutricional,clasificacion f,2004-03-01,1,4,1,4,5
51501,VILLAZON,estado nutricional,clasificacion f,2004-03-01,2,1,2,1,3
30904,VINTO,estado nutricional,clasificacion f,2004-03-01,5,2,5,2,7
50602,VITICHI,estado nutricional,clasificacion f,2004-03-01,6,1,6,1,7
70201,WARNES,estado nutricional,clasificacion f,2004-03-01,1,3,1,3,4
20903,YACO,estado nutricional,clasificacion f,2004-03-01,5,1,5,1,6
60301,YACUIBA,estado nutricional,clasificacion f,2004-03-01,7,2,7,2,9
10602,YAMPARAEZ,estado nutricional,clasificacion f,2004-03-01,17,4,17,4,21
21103,YANACACHI,estado nutricional,clasificacion f,2004-03-01,1,1,1,1,2
70403,YAPACANI,estado nutricional,clasificacion f,2004-03-01,9,3,9,3,12
50103,YOCALLA,estado nutricional,clasificacion f,2004-03-01,0,1,0,1,1
10102,YOTALA,estado nutricional,clasificacion f,2004-03-01,5,2,5,2,7
60402,YUNCHARA,estado nutricional,clasificacion f,2004-03-01,0,2,0,2,2
10301,ZUDAÃ‘EZ,estado nutricional,clasificacion f,2004-03-01,4,3,4,3,7
51302,ACACIO,estado nutricional,clasificacion f,2004-04-01,3,4,3,4,7
20201,ACHACACHI,estado nutricional,clasificacion f,2004-04-01,7,1,7,1,8
30201,AIQUILE,estado nutricional,clasificacion f,2004-04-01,5,1,5,1,6
10404,ALCALA,estado nutricional,clasificacion f,2004-04-01,0,2,0,2,2
20202,ANCORAIMES,estado nutricional,clasificacion f,2004-04-01,1,0,1,0,1
30402,ANZALDO,estado nutricional,clasificacion f,2004-04-01,1,1,1,1,2
20701,APOLO,estado nutricional,clasificacion f,2004-04-01,2,1,2,1,3
51301,ARAMPAMPA,estado nutricional,clasificacion f,2004-04-01,6,1,6,1,7
30501,ARANI,estado nutricional,clasificacion f,2004-04-01,5,0,5,0,5
30601,ARQUE,estado nutricional,clasificacion f,2004-04-01,6,2,6,2,8
71501,ASCENCION DE GUARAYOS,estado nutricional,clasificacion f,2004-04-01,13,6,13,6,19
50802,ATOCHA,estado nutricional,clasificacion f,2004-04-01,2,6,2,6,8
20502,AYATA,estado nutricional,clasificacion f,2004-04-01,6,1,6,1,7
30301,AYOPAYA (V. DE INDEPENDENCIA),estado nutricional,clasificacion f,2004-04-01,5,0,5,0,5
10201,AZURDUY,estado nutricional,clasificacion f,2004-04-01,9,7,9,7,16
80802,BAURES,estado nutricional,clasificacion f,2004-04-01,1,0,1,0,1
90104,BELLA FLOR,estado nutricional,clasificacion f,2004-04-01,1,1,1,1,2
50301,BETANZOS,estado nutricional,clasificacion f,2004-04-01,14,11,14,11,25
31501,BOLIVAR,estado nutricional,clasificacion f,2004-04-01,1,0,1,0,1
70707,BOYUIBE,estado nutricional,clasificacion f,2004-04-01,1,0,1,0,1
70703,CABEZAS,estado nutricional,clasificacion f,2004-04-01,5,1,5,1,6
20905,CAIROMA,estado nutricional,clasificacion f,2004-04-01,10,4,10,4,14
51102,"CAIZA ""D""",estado nutricional,clasificacion f,2004-04-01,2,3,2,3,5
21003,CAJUATA,estado nutricional,clasificacion f,2004-04-01,0,2,0,2,2
21304,CALAMARCA,estado nutricional,clasificacion f,2004-04-01,2,0,2,0,2
10701,CAMARGO,estado nutricional,clasificacion f,2004-04-01,2,1,2,1,3
70706,CAMIRI,estado nutricional,clasificacion f,2004-04-01,10,5,10,5,15
30701,CAPINOTA,estado nutricional,clasificacion f,2004-04-01,1,2,1,2,3
40102,CARACOLLO,estado nutricional,clasificacion f,2004-04-01,0,1,0,1,1
22001,CARANAVI,estado nutricional,clasificacion f,2004-04-01,9,5,9,5,14
60302,CARAPARI,estado nutricional,clasificacion f,2004-04-01,1,1,1,1,2
50702,CARIPUYO,estado nutricional,clasificacion f,2004-04-01,15,6,15,6,21
21902,CATACORA,estado nutricional,clasificacion f,2004-04-01,0,1,0,1,1
40201,CHALLAPATA,estado nutricional,clasificacion f,2004-04-01,2,2,2,2,4
50302,CHAQUI,estado nutricional,clasificacion f,2004-04-01,0,2,0,2,2
70702,CHARAGUA,estado nutricional,clasificacion f,2004-04-01,11,4,11,4,15
50202,CHAYANTA,estado nutricional,clasificacion f,2004-04-01,5,3,5,3,8
40903,CHIPAYA,estado nutricional,clasificacion f,2004-04-01,0,1,0,1,1
40302,CHOQUE COTA,estado nutricional,clasificacion f,2004-04-01,1,0,1,0,1
20501,CHUMA,estado nutricional,clasificacion f,2004-04-01,6,4,6,4,10
30801,CLIZA,estado nutricional,clasificacion f,2004-04-01,10,3,10,3,13
90101,COBIJA,estado nutricional,clasificacion f,2004-04-01,4,1,4,1,5
30101,COCHABAMBA,estado nutricional,clasificacion f,2004-04-01,37,7,37,7,44
30905,COLCAPIRHUA,estado nutricional,clasificacion f,2004-04-01,2,0,2,0,2
50901,"COLCHA ""K""",estado nutricional,clasificacion f,2004-04-01,1,0,1,0,1
31002,COLOMI,estado nutricional,clasificacion f,2004-04-01,4,2,4,2,6
50401,COLQUECHACA,estado nutricional,clasificacion f,2004-04-01,22,5,22,5,27
21306,COLQUENCHA,estado nutricional,clasificacion f,2004-04-01,5,1,5,1,6
21004,COLQUIRI,estado nutricional,clasificacion f,2004-04-01,2,5,2,5,7
20304,COMANCHE,estado nutricional,clasificacion f,2004-04-01,1,0,1,0,1
71301,COMARAPA,estado nutricional,clasificacion f,2004-04-01,3,0,3,0,3
21701,COPACABANA,estado nutricional,clasificacion f,2004-04-01,2,0,2,0,2
40301,CORQUE,estado nutricional,clasificacion f,2004-04-01,2,0,2,0,2
50601,COTAGAITA,estado nutricional,clasificacion f,2004-04-01,9,2,9,2,11
70704,CUEVO,estado nutricional,clasificacion f,2004-04-01,0,1,0,1,1
10902,CULPINA,estado nutricional,clasificacion f,2004-04-01,15,7,15,7,22
20105,EL ALTO,estado nutricional,clasificacion f,2004-04-01,79,31,79,31,110
40103,EL CHORO,estado nutricional,clasificacion f,2004-04-01,0,1,0,1,1
71503,EL PUENTE(STC),estado nutricional,clasificacion f,2004-04-01,4,3,4,3,7
60502,EL PUENTE(TJA),estado nutricional,clasificacion f,2004-04-01,0,2,0,2,2
70105,EL TORNO,estado nutricional,clasificacion f,2004-04-01,1,4,1,4,5
10405,EL VILLAR,estado nutricional,clasificacion f,2004-04-01,4,4,4,4,8
60601,ENTRE RIOS,estado nutricional,clasificacion f,2004-04-01,0,1,0,1,1
41101,EUCALIPTUS,estado nutricional,clasificacion f,2004-04-01,2,1,2,1,3
80402,EXALTACION,estado nutricional,clasificacion f,2004-04-01,1,1,1,1,2
90203,FILADELFIA,estado nutricional,clasificacion f,2004-04-01,1,3,1,3,4
71002,GENERAL SAAVEDRA,estado nutricional,clasificacion f,2004-04-01,8,4,8,4,12
21601,GRAL. J.J. PEREZ (CHARAZANI),estado nutricional,clasificacion f,2004-04-01,4,2,4,2,6
20602,GUANAY,estado nutricional,clasificacion f,2004-04-01,14,8,14,8,22
20802,GUAQUI,estado nutricional,clasificacion f,2004-04-01,1,0,1,0,1
80202,GUAYARAMERIN,estado nutricional,clasificacion f,2004-04-01,6,2,6,2,8
70705,GUTIERREZ,estado nutricional,clasificacion f,2004-04-01,10,9,10,9,19
10502,HUACARETA,estado nutricional,clasificacion f,2004-04-01,2,2,2,2,4
11002,HUACAYA (VILLA DE HUACAYA),estado nutricional,clasificacion f,2004-04-01,1,0,1,0,1
40701,HUANUNI,estado nutricional,clasificacion f,2004-04-01,3,0,3,0,3
41601,HUAYLLAMARCA,estado nutricional,clasificacion f,2004-04-01,1,0,1,0,1
21005,ICHOCA,estado nutricional,clasificacion f,2004-04-01,0,1,0,1,1
10304,ICLA,estado nutricional,clasificacion f,2004-04-01,13,5,13,5,18
10703,INCAHUASI,estado nutricional,clasificacion f,2004-04-01,17,10,17,10,27
21001,INQUISIVI,estado nutricional,clasificacion f,2004-04-01,10,1,10,1,11
21102,IRUPANA (VILLA DE LANZA),estado nutricional,clasificacion f,2004-04-01,0,1,0,1,1
21501,IXIAMAS,estado nutricional,clasificacion f,2004-04-01,5,1,5,1,6
21105,LA ASUNTA,estado nutricional,clasificacion f,2004-04-01,19,6,19,6,25
70104,LA GUARDIA,estado nutricional,clasificacion f,2004-04-01,2,0,2,0,2
20101,LA PAZ,estado nutricional,clasificacion f,2004-04-01,55,19,55,19,74
70701,LAGUNILLAS,estado nutricional,clasificacion f,2004-04-01,3,0,3,0,3
50203,LLALLAGUA,estado nutricional,clasificacion f,2004-04-01,4,2,4,2,6
20901,LURIBAY,estado nutricional,clasificacion f,2004-04-01,1,0,1,0,1
11003,MACHARETI,estado nutricional,clasificacion f,2004-04-01,1,1,1,1,2
80801,MAGDALENA,estado nutricional,clasificacion f,2004-04-01,3,2,3,2,5
70903,MAIRANA,estado nutricional,clasificacion f,2004-04-01,1,0,1,0,1
71003,MINEROS,estado nutricional,clasificacion f,2004-04-01,14,2,14,2,16
31301,MIZQUE,estado nutricional,clasificacion f,2004-04-01,13,6,13,6,19
20402,MOCOMOCO,estado nutricional,clasificacion f,2004-04-01,3,1,3,1,4
10303,MOJOCOYA,estado nutricional,clasificacion f,2004-04-01,6,1,6,1,7
10501,MONTEAGUDO,estado nutricional,clasificacion f,2004-04-01,8,3,8,3,11
71001,MONTERO,estado nutricional,clasificacion f,2004-04-01,25,4,25,4,29
30302,MOROCHATA,estado nutricional,clasificacion f,2004-04-01,7,5,7,5,12
50404,OCURI,estado nutricional,clasificacion f,2004-04-01,8,1,8,1,9
70202,OKINAWA,estado nutricional,clasificacion f,2004-04-01,1,0,1,0,1
30203,OMEREQUE,estado nutricional,clasificacion f,2004-04-01,1,1,1,1,2
40101,ORURO,estado nutricional,clasificacion f,2004-04-01,20,6,20,6,26
60201,PADCAYA,estado nutricional,clasificacion f,2004-04-01,0,1,0,1,1
10401,PADILLA,estado nutricional,clasificacion f,2004-04-01,8,3,8,3,11
70502,PAILON,estado nutricional,clasificacion f,2004-04-01,1,0,1,0,1
20102,PALCA,estado nutricional,clasificacion f,2004-04-01,2,0,2,0,2
21104,PALOS BLANCOS,estado nutricional,clasificacion f,2004-04-01,22,5,22,5,27
30202,PASORAPA,estado nutricional,clasificacion f,2004-04-01,1,0,1,0,1
21305,PATACAMAYA,estado nutricional,clasificacion f,2004-04-01,9,1,9,1,10
20702,PELECHUCO,estado nutricional,clasificacion f,2004-04-01,1,2,1,2,3
50403,POCOATA,estado nutricional,clasificacion f,2004-04-01,15,6,15,6,21
31203,POCONA,estado nutricional,clasificacion f,2004-04-01,7,3,7,3,10
31202,POJO (CBBA),estado nutricional,clasificacion f,2004-04-01,5,7,5,7,12
40601,POOPO,estado nutricional,clasificacion f,2004-04-01,1,2,1,2,3
51203,PORCO,estado nutricional,clasificacion f,2004-04-01,0,2,0,2,2
10103,POROMA,estado nutricional,clasificacion f,2004-04-01,10,6,10,6,16
70601,PORTACHUELO,estado nutricional,clasificacion f,2004-04-01,2,0,2,0,2
50101,POTOSI,estado nutricional,clasificacion f,2004-04-01,32,21,32,21,53
10302,PRESTO,estado nutricional,clasificacion f,2004-04-01,19,6,19,6,25
21201,PUCARANI,estado nutricional,clasificacion f,2004-04-01,4,0,4,0,4
20401,PUERTO ACOSTA,estado nutricional,clasificacion f,2004-04-01,2,0,2,0,2
20403,PUERTO CARABUCO,estado nutricional,clasificacion f,2004-04-01,4,3,4,3,7
90301,PUERTO GONZALO MORENO,estado nutricional,clasificacion f,2004-04-01,4,5,4,5,9
80703,PUERTO SILES,estado nutricional,clasificacion f,2004-04-01,0,1,0,1,1
71401,PUERTO SUAREZ,estado nutricional,clasificacion f,2004-04-01,0,1,0,1,1
31205,PUERTO VILLARROEL,estado nutricional,clasificacion f,2004-04-01,31,9,31,9,40
51101,PUNA,estado nutricional,clasificacion f,2004-04-01,4,1,4,1,5
31401,PUNATA,estado nutricional,clasificacion f,2004-04-01,3,0,3,0,3
20604,QUIABAYA,estado nutricional,clasificacion f,2004-04-01,1,0,1,0,1
30901,QUILLACOLLO,estado nutricional,clasificacion f,2004-04-01,4,6,4,6,10
21002,QUIME,estado nutricional,clasificacion f,2004-04-01,1,1,1,1,2
50402,RAVELO,estado nutricional,clasificacion f,2004-04-01,16,5,16,5,21
80301,REYES,estado nutricional,clasificacion f,2004-04-01,9,2,9,2,11
80201,RIBERALTA,estado nutricional,clasificacion f,2004-04-01,34,31,34,31,65
70503,ROBORE,estado nutricional,clasificacion f,2004-04-01,2,1,2,1,3
80304,RURRENABAQUE,estado nutricional,clasificacion f,2004-04-01,1,0,1,0,1
31001,SACABA,estado nutricional,clasificacion f,2004-04-01,2,0,2,0,2
30404,SACABAMBA,estado nutricional,clasificacion f,2004-04-01,2,3,2,3,5
50701,SACACA,estado nutricional,clasificacion f,2004-04-01,21,12,21,12,33
71302,SAIPINA,estado nutricional,clasificacion f,2004-04-01,0,1,0,1,1
80602,SAN ANDRES,estado nutricional,clasificacion f,2004-04-01,1,1,1,1,2
71105,SAN ANTONIO DE LOMERIO,estado nutricional,clasificacion f,2004-04-01,9,4,9,4,13
31403,SAN BENITO,estado nutricional,clasificacion f,2004-04-01,3,0,3,0,3
80302,SAN BORJA,estado nutricional,clasificacion f,2004-04-01,11,6,11,6,17
21502,SAN BUENA VENTURA,estado nutricional,clasificacion f,2004-04-01,5,4,5,4,9
70402,SAN CARLOS,estado nutricional,clasificacion f,2004-04-01,1,12,1,12,13
80501,SAN IGNACIO,estado nutricional,clasificacion f,2004-04-01,8,4,8,4,12
70301,SAN IGNACIO DE VELASCO,estado nutricional,clasificacion f,2004-04-01,16,4,16,4,20
80102,SAN JAVIER(BNI),estado nutricional,clasificacion f,2004-04-01,0,1,0,1,1
71102,SAN JAVIER(STC),estado nutricional,clasificacion f,2004-04-01,1,0,1,0,1
70501,SAN JOSE DE CHIQUITOS,estado nutricional,clasificacion f,2004-04-01,8,0,8,0,8
71104,SAN JULIAN,estado nutricional,clasificacion f,2004-04-01,12,3,12,3,15
60501,SAN LORENZO(TJA),estado nutricional,clasificacion f,2004-04-01,2,0,2,0,2
10702,SAN LUCAS,estado nutricional,clasificacion f,2004-04-01,27,7,27,7,34
71201,SAN MATIAS,estado nutricional,clasificacion f,2004-04-01,1,4,1,4,5
70302,SAN MIGUEL DE VELASCO,estado nutricional,clasificacion f,2004-04-01,0,4,0,4,4
50501,SAN PEDRO DE BUENA VISTA,estado nutricional,clasificacion f,2004-04-01,9,12,9,12,21
70303,SAN RAFAEL,estado nutricional,clasificacion f,2004-04-01,2,2,2,2,4
80401,SANTA ANA,estado nutricional,clasificacion f,2004-04-01,0,2,0,2,2
70101,SANTA CRUZ DE LA SIERRA,estado nutricional,clasificacion f,2004-04-01,25,71,25,71,96
80303,SANTA ROSA,estado nutricional,clasificacion f,2004-04-01,0,1,0,1,1
70602,SANTA ROSA DEL SARA,estado nutricional,clasificacion f,2004-04-01,4,5,4,5,9
20308,SANTIAGO DE CALLAPA,estado nutricional,clasificacion f,2004-04-01,2,1,2,1,3
41401,SANTIAGO DE HUARI,estado nutricional,clasificacion f,2004-04-01,3,2,3,2,5
30702,SANTIVAÃ‘ES,estado nutricional,clasificacion f,2004-04-01,1,0,1,0,1
90303,SENA,estado nutricional,clasificacion f,2004-04-01,1,0,1,0,1
21301,SICA SICA (VILLA AROMA),estado nutricional,clasificacion f,2004-04-01,1,2,1,2,3
30703,SICAYA,estado nutricional,clasificacion f,2004-04-01,1,3,1,3,4
30902,SIPE SIPE,estado nutricional,clasificacion f,2004-04-01,4,6,4,6,10
10403,SOPACHUY,estado nutricional,clasificacion f,2004-04-01,3,6,3,6,9
20601,SORATA,estado nutricional,clasificacion f,2004-04-01,1,1,1,1,2
10101,SUCRE,estado nutricional,clasificacion f,2004-04-01,21,11,21,11,32
50303,TACOBAMBA,estado nutricional,clasificacion f,2004-04-01,3,1,3,1,4
30602,TACOPAYA,estado nutricional,clasificacion f,2004-04-01,7,3,7,3,10
31101,TAPACARI,estado nutricional,clasificacion f,2004-04-01,8,3,8,3,11
10601,TARABUCO,estado nutricional,clasificacion f,2004-04-01,24,28,24,28,52
30401,TARATA,estado nutricional,clasificacion f,2004-04-01,1,0,1,0,1
60101,TARIJA,estado nutricional,clasificacion f,2004-04-01,8,7,8,7,15
10202,TARVITA,estado nutricional,clasificacion f,2004-04-01,4,3,4,3,7
50102,TINGUIPAYA,estado nutricional,clasificacion f,2004-04-01,6,3,6,3,9
20606,TIPUANI,estado nutricional,clasificacion f,2004-04-01,1,1,1,1,2
30903,TIQUIPAYA,estado nutricional,clasificacion f,2004-04-01,1,0,1,0,1
31601,TIRAQUE (CBBA),estado nutricional,clasificacion f,2004-04-01,10,8,10,8,18
30802,TOCO,estado nutricional,clasificacion f,2004-04-01,3,3,3,3,6
51202,TOMAVE,estado nutricional,clasificacion f,2004-04-01,7,0,7,0,7
10402,TOMINA,estado nutricional,clasificacion f,2004-04-01,4,4,4,4,8
50502,TORO TORO,estado nutricional,clasificacion f,2004-04-01,18,10,18,10,28
31201,TOTORA(CBBA),estado nutricional,clasificacion f,2004-04-01,5,2,5,2,7
41301,TOTORA(ORR),estado nutricional,clasificacion f,2004-04-01,1,4,1,4,5
80101,TRINIDAD,estado nutricional,clasificacion f,2004-04-01,4,6,4,6,10
50801,TUPIZA,estado nutricional,clasificacion f,2004-04-01,6,7,6,7,13
50201,UNCIA,estado nutricional,clasificacion f,2004-04-01,2,0,2,0,2
71502,URUBICHA,estado nutricional,clasificacion f,2004-04-01,8,1,8,1,9
51201,UYUNI,estado nutricional,clasificacion f,2004-04-01,2,3,2,3,5
30502,VACAS,estado nutricional,clasificacion f,2004-04-01,3,1,3,1,4
70801,VALLEGRANDE,estado nutricional,clasificacion f,2004-04-01,1,0,1,0,1
20801,VIACHA,estado nutricional,clasificacion f,2004-04-01,9,3,9,3,12
31302,VILA VILA,estado nutricional,clasificacion f,2004-04-01,4,0,4,0,4
60303,VILLA MONTES,estado nutricional,clasificacion f,2004-04-01,4,6,4,6,10
31402,VILLA RIVERO,estado nutricional,clasificacion f,2004-04-01,2,0,2,0,2
10801,VILLA SERRANO,estado nutricional,clasificacion f,2004-04-01,4,5,4,5,9
31003,VILLA TUNARI,estado nutricional,clasificacion f,2004-04-01,24,7,24,7,31
11001,VILLA VACA GUZMAN (MUYUPAMPA),estado nutricional,clasificacion f,2004-04-01,0,2,0,2,2
51501,VILLAZON,estado nutricional,clasificacion f,2004-04-01,3,2,3,2,5
30904,VINTO,estado nutricional,clasificacion f,2004-04-01,3,5,3,5,8
50602,VITICHI,estado nutricional,clasificacion f,2004-04-01,5,0,5,0,5
70201,WARNES,estado nutricional,clasificacion f,2004-04-01,3,1,3,1,4
20903,YACO,estado nutricional,clasificacion f,2004-04-01,8,1,8,1,9
60301,YACUIBA,estado nutricional,clasificacion f,2004-04-01,2,0,2,0,2
10602,YAMPARAEZ,estado nutricional,clasificacion f,2004-04-01,17,2,17,2,19
70403,YAPACANI,estado nutricional,clasificacion f,2004-04-01,8,2,8,2,10
10102,YOTALA,estado nutricional,clasificacion f,2004-04-01,5,1,5,1,6
60402,YUNCHARA,estado nutricional,clasificacion f,2004-04-01,0,3,0,3,3
10301,ZUDAÃ‘EZ,estado nutricional,clasificacion f,2004-04-01,5,2,5,2,7
51302,ACACIO,estado nutricional,clasificacion f,2004-05-01,3,3,3,3,6
20201,ACHACACHI,estado nutricional,clasificacion f,2004-05-01,2,1,2,1,3
30201,AIQUILE,estado nutricional,clasificacion f,2004-05-01,4,5,4,5,9
10404,ALCALA,estado nutricional,clasificacion f,2004-05-01,0,4,0,4,4
20202,ANCORAIMES,estado nutricional,clasificacion f,2004-05-01,2,0,2,0,2
30402,ANZALDO,estado nutricional,clasificacion f,2004-05-01,2,0,2,0,2
20701,APOLO,estado nutricional,clasificacion f,2004-05-01,2,1,2,1,3
51301,ARAMPAMPA,estado nutricional,clasificacion f,2004-05-01,7,0,7,0,7
30501,ARANI,estado nutricional,clasificacion f,2004-05-01,5,2,5,2,7
30601,ARQUE,estado nutricional,clasificacion f,2004-05-01,14,2,14,2,16
50802,ATOCHA,estado nutricional,clasificacion f,2004-05-01,2,2,2,2,4
20503,AUCAPATA,estado nutricional,clasificacion f,2004-05-01,3,0,3,0,3
20502,AYATA,estado nutricional,clasificacion f,2004-05-01,6,1,6,1,7
30301,AYOPAYA (V. DE INDEPENDENCIA),estado nutricional,clasificacion f,2004-05-01,9,3,9,3,12
10201,AZURDUY,estado nutricional,clasificacion f,2004-05-01,7,3,7,3,10
21203,BATALLAS,estado nutricional,clasificacion f,2004-05-01,0,1,0,1,1
60202,BERMEJO,estado nutricional,clasificacion f,2004-05-01,1,0,1,0,1
50301,BETANZOS,estado nutricional,clasificacion f,2004-05-01,16,8,16,8,24
31501,BOLIVAR,estado nutricional,clasificacion f,2004-05-01,3,0,3,0,3
70401,BUENA VISTA,estado nutricional,clasificacion f,2004-05-01,2,2,2,2,4
70703,CABEZAS,estado nutricional,clasificacion f,2004-05-01,4,1,4,1,5
20905,CAIROMA,estado nutricional,clasificacion f,2004-05-01,7,2,7,2,9
51102,"CAIZA ""D""",estado nutricional,clasificacion f,2004-05-01,1,0,1,0,1
21003,CAJUATA,estado nutricional,clasificacion f,2004-05-01,2,1,2,1,3
21304,CALAMARCA,estado nutricional,clasificacion f,2004-05-01,6,1,6,1,7
10701,CAMARGO,estado nutricional,clasificacion f,2004-05-01,0,1,0,1,1
70706,CAMIRI,estado nutricional,clasificacion f,2004-05-01,11,8,11,8,19
30701,CAPINOTA,estado nutricional,clasificacion f,2004-05-01,1,0,1,0,1
40102,CARACOLLO,estado nutricional,clasificacion f,2004-05-01,1,1,1,1,2
22001,CARANAVI,estado nutricional,clasificacion f,2004-05-01,6,3,6,3,9
60302,CARAPARI,estado nutricional,clasificacion f,2004-05-01,1,0,1,0,1
50702,CARIPUYO,estado nutricional,clasificacion f,2004-05-01,9,18,9,18,27
40201,CHALLAPATA,estado nutricional,clasificacion f,2004-05-01,1,0,1,0,1
50302,CHAQUI,estado nutricional,clasificacion f,2004-05-01,0,1,0,1,1
70702,CHARAGUA,estado nutricional,clasificacion f,2004-05-01,5,2,5,2,7
50202,CHAYANTA,estado nutricional,clasificacion f,2004-05-01,5,0,5,0,5
40302,CHOQUE COTA,estado nutricional,clasificacion f,2004-05-01,1,0,1,0,1
21101,CHULUMANI (V. DE LA LIBERTAD),estado nutricional,clasificacion f,2004-05-01,1,0,1,0,1
20501,CHUMA,estado nutricional,clasificacion f,2004-05-01,3,0,3,0,3
30801,CLIZA,estado nutricional,clasificacion f,2004-05-01,7,0,7,0,7
90101,COBIJA,estado nutricional,clasificacion f,2004-05-01,3,2,3,2,5
30101,COCHABAMBA,estado nutricional,clasificacion f,2004-05-01,37,9,37,9,46
31002,COLOMI,estado nutricional,clasificacion f,2004-05-01,2,0,2,0,2
50401,COLQUECHACA,estado nutricional,clasificacion f,2004-05-01,33,7,33,7,40
21004,COLQUIRI,estado nutricional,clasificacion f,2004-05-01,2,0,2,0,2
71301,COMARAPA,estado nutricional,clasificacion f,2004-05-01,2,1,2,1,3
21401,COROICO,estado nutricional,clasificacion f,2004-05-01,1,1,1,1,2
50601,COTAGAITA,estado nutricional,clasificacion f,2004-05-01,11,12,11,12,23
10902,CULPINA,estado nutricional,clasificacion f,2004-05-01,7,2,7,2,9
40401,CURAHUARA DE CARANGAS,estado nutricional,clasificacion f,2004-05-01,1,0,1,0,1
21602,CURVA,estado nutricional,clasificacion f,2004-05-01,1,0,1,0,1
20105,EL ALTO,estado nutricional,clasificacion f,2004-05-01,74,27,74,27,101
40103,EL CHORO,estado nutricional,clasificacion f,2004-05-01,2,0,2,0,2
71503,EL PUENTE(STC),estado nutricional,clasificacion f,2004-05-01,2,0,2,0,2
70105,EL TORNO,estado nutricional,clasificacion f,2004-05-01,1,0,1,0,1
10405,EL VILLAR,estado nutricional,clasificacion f,2004-05-01,7,2,7,2,9
60601,ENTRE RIOS,estado nutricional,clasificacion f,2004-05-01,2,1,2,1,3
41101,EUCALIPTUS,estado nutricional,clasificacion f,2004-05-01,1,1,1,1,2
80402,EXALTACION,estado nutricional,clasificacion f,2004-05-01,1,2,1,2,3
71002,GENERAL SAAVEDRA,estado nutricional,clasificacion f,2004-05-01,4,3,4,3,7
21601,GRAL. J.J. PEREZ (CHARAZANI),estado nutricional,clasificacion f,2004-05-01,1,1,1,1,2
20602,GUANAY,estado nutricional,clasificacion f,2004-05-01,2,1,2,1,3
80202,GUAYARAMERIN,estado nutricional,clasificacion f,2004-05-01,6,2,6,2,8
70705,GUTIERREZ,estado nutricional,clasificacion f,2004-05-01,3,1,3,1,4
10502,HUACARETA,estado nutricional,clasificacion f,2004-05-01,3,2,3,2,5
40701,HUANUNI,estado nutricional,clasificacion f,2004-05-01,1,0,1,0,1
21005,ICHOCA,estado nutricional,clasificacion f,2004-05-01,1,3,1,3,4
10304,ICLA,estado nutricional,clasificacion f,2004-05-01,13,5,13,5,18
10703,INCAHUASI,estado nutricional,clasificacion f,2004-05-01,10,8,10,8,18
21001,INQUISIVI,estado nutricional,clasificacion f,2004-05-01,2,0,2,0,2
21501,IXIAMAS,estado nutricional,clasificacion f,2004-05-01,2,2,2,2,4
21105,LA ASUNTA,estado nutricional,clasificacion f,2004-05-01,0,3,0,3,3
70104,LA GUARDIA,estado nutricional,clasificacion f,2004-05-01,4,0,4,0,4
20101,LA PAZ,estado nutricional,clasificacion f,2004-05-01,55,24,55,24,79
21202,LAJA,estado nutricional,clasificacion f,2004-05-01,3,0,3,0,3
10903,LAS CARRERAS,estado nutricional,clasificacion f,2004-05-01,0,1,0,1,1
50203,LLALLAGUA,estado nutricional,clasificacion f,2004-05-01,5,6,5,6,11
51401,LLICA,estado nutricional,clasificacion f,2004-05-01,1,0,1,0,1
20901,LURIBAY,estado nutricional,clasificacion f,2004-05-01,1,0,1,0,1
11003,MACHARETI,estado nutricional,clasificacion f,2004-05-01,0,2,0,2,2
80801,MAGDALENA,estado nutricional,clasificacion f,2004-05-01,1,1,1,1,2
71003,MINEROS,estado nutricional,clasificacion f,2004-05-01,6,3,6,3,9
31301,MIZQUE,estado nutricional,clasificacion f,2004-05-01,2,1,2,1,3
20402,MOCOMOCO,estado nutricional,clasificacion f,2004-05-01,2,3,2,3,5
51002,MOJINETE,estado nutricional,clasificacion f,2004-05-01,0,1,0,1,1
10303,MOJOCOYA,estado nutricional,clasificacion f,2004-05-01,4,0,4,0,4
10501,MONTEAGUDO,estado nutricional,clasificacion f,2004-05-01,2,2,2,2,4
71001,MONTERO,estado nutricional,clasificacion f,2004-05-01,18,6,18,6,24
30302,MOROCHATA,estado nutricional,clasificacion f,2004-05-01,9,4,9,4,13
50404,OCURI,estado nutricional,clasificacion f,2004-05-01,6,3,6,3,9
70202,OKINAWA,estado nutricional,clasificacion f,2004-05-01,1,0,1,0,1
30203,OMEREQUE,estado nutricional,clasificacion f,2004-05-01,0,1,0,1,1
40101,ORURO,estado nutricional,clasificacion f,2004-05-01,13,12,13,12,25
60201,PADCAYA,estado nutricional,clasificacion f,2004-05-01,0,1,0,1,1
10401,PADILLA,estado nutricional,clasificacion f,2004-05-01,6,3,6,3,9
70502,PAILON,estado nutricional,clasificacion f,2004-05-01,0,2,0,2,2
20102,PALCA,estado nutricional,clasificacion f,2004-05-01,5,1,5,1,6
21104,PALOS BLANCOS,estado nutricional,clasificacion f,2004-05-01,4,2,4,2,6
70902,PAMPA GRANDE,estado nutricional,clasificacion f,2004-05-01,1,1,1,1,2
30202,PASORAPA,estado nutricional,clasificacion f,2004-05-01,0,2,0,2,2
21305,PATACAMAYA,estado nutricional,clasificacion f,2004-05-01,1,1,1,1,2
40602,PAZÃ‘A,estado nutricional,clasificacion f,2004-05-01,0,1,0,1,1
20702,PELECHUCO,estado nutricional,clasificacion f,2004-05-01,2,0,2,0,2
50403,POCOATA,estado nutricional,clasificacion f,2004-05-01,10,10,10,10,20
31203,POCONA,estado nutricional,clasificacion f,2004-05-01,2,0,2,0,2
31202,POJO (CBBA),estado nutricional,clasificacion f,2004-05-01,4,1,4,1,5
40601,POOPO,estado nutricional,clasificacion f,2004-05-01,1,0,1,0,1
51203,PORCO,estado nutricional,clasificacion f,2004-05-01,3,2,3,2,5
10103,POROMA,estado nutricional,clasificacion f,2004-05-01,11,9,11,9,20
50101,POTOSI,estado nutricional,clasificacion f,2004-05-01,27,8,27,8,35
10302,PRESTO,estado nutricional,clasificacion f,2004-05-01,9,7,9,7,16
70805,PUCARA,estado nutricional,clasificacion f,2004-05-01,0,2,0,2,2
21201,PUCARANI,estado nutricional,clasificacion f,2004-05-01,3,0,3,0,3
20401,PUERTO ACOSTA,estado nutricional,clasificacion f,2004-05-01,2,1,2,1,3
20403,PUERTO CARABUCO,estado nutricional,clasificacion f,2004-05-01,0,1,0,1,1
90301,PUERTO GONZALO MORENO,estado nutricional,clasificacion f,2004-05-01,7,0,7,0,7
21204,PUERTO PEREZ,estado nutricional,clasificacion f,2004-05-01,0,1,0,1,1
71402,PUERTO QUIJARRO,estado nutricional,clasificacion f,2004-05-01,0,1,0,1,1
90201,PUERTO RICO,estado nutricional,clasificacion f,2004-05-01,1,0,1,0,1
31205,PUERTO VILLARROEL,estado nutricional,clasificacion f,2004-05-01,8,2,8,2,10
51101,PUNA,estado nutricional,clasificacion f,2004-05-01,15,2,15,2,17
31401,PUNATA,estado nutricional,clasificacion f,2004-05-01,3,0,3,0,3
20604,QUIABAYA,estado nutricional,clasificacion f,2004-05-01,2,0,2,0,2
30901,QUILLACOLLO,estado nutricional,clasificacion f,2004-05-01,3,1,3,1,4
21002,QUIME,estado nutricional,clasificacion f,2004-05-01,1,1,1,1,2
50402,RAVELO,estado nutricional,clasificacion f,2004-05-01,31,11,31,11,42
80301,REYES,estado nutricional,clasificacion f,2004-05-01,1,1,1,1,2
80201,RIBERALTA,estado nutricional,clasificacion f,2004-05-01,30,14,30,14,44
31001,SACABA,estado nutricional,clasificacion f,2004-05-01,4,1,4,1,5
50701,SACACA,estado nutricional,clasificacion f,2004-05-01,13,6,13,6,19
71302,SAIPINA,estado nutricional,clasificacion f,2004-05-01,2,0,2,0,2
70901,SAMAIPATA,estado nutricional,clasificacion f,2004-05-01,2,0,2,0,2
80602,SAN ANDRES,estado nutricional,clasificacion f,2004-05-01,0,1,0,1,1
71105,SAN ANTONIO DE LOMERIO,estado nutricional,clasificacion f,2004-05-01,7,1,7,1,8
31403,SAN BENITO,estado nutricional,clasificacion f,2004-05-01,4,0,4,0,4
80302,SAN BORJA,estado nutricional,clasificacion f,2004-05-01,15,14,15,14,29
21502,SAN BUENA VENTURA,estado nutricional,clasificacion f,2004-05-01,2,0,2,0,2
70402,SAN CARLOS,estado nutricional,clasificacion f,2004-05-01,1,4,1,4,5
80501,SAN IGNACIO,estado nutricional,clasificacion f,2004-05-01,2,4,2,4,6
70301,SAN IGNACIO DE VELASCO,estado nutricional,clasificacion f,2004-05-01,6,5,6,5,11
71102,SAN JAVIER(STC),estado nutricional,clasificacion f,2004-05-01,0,1,0,1,1
70501,SAN JOSE DE CHIQUITOS,estado nutricional,clasificacion f,2004-05-01,1,2,1,2,3
71104,SAN JULIAN,estado nutricional,clasificacion f,2004-05-01,8,3,8,3,11
90302,SAN LORENZO(PND),estado nutricional,clasificacion f,2004-05-01,3,0,3,0,3
60501,SAN LORENZO(TJA),estado nutricional,clasificacion f,2004-05-01,4,0,4,0,4
10702,SAN LUCAS,estado nutricional,clasificacion f,2004-05-01,31,7,31,7,38
71201,SAN MATIAS,estado nutricional,clasificacion f,2004-05-01,5,2,5,2,7
70302,SAN MIGUEL DE VELASCO,estado nutricional,clasificacion f,2004-05-01,1,1,1,1,2
50501,SAN PEDRO DE BUENA VISTA,estado nutricional,clasificacion f,2004-05-01,10,6,10,6,16
21801,SAN PEDRO DE CURAHUARA,estado nutricional,clasificacion f,2004-05-01,1,0,1,0,1
70303,SAN RAFAEL,estado nutricional,clasificacion f,2004-05-01,2,1,2,1,3
70101,SANTA CRUZ DE LA SIERRA,estado nutricional,clasificacion f,2004-05-01,15,6,15,6,21
80303,SANTA ROSA,estado nutricional,clasificacion f,2004-05-01,1,0,1,0,1
70602,SANTA ROSA DEL SARA,estado nutricional,clasificacion f,2004-05-01,0,1,0,1,1
20308,SANTIAGO DE CALLAPA,estado nutricional,clasificacion f,2004-05-01,0,1,0,1,1
41401,SANTIAGO DE HUARI,estado nutricional,clasificacion f,2004-05-01,2,0,2,0,2
30702,SANTIVAÃ‘ES,estado nutricional,clasificacion f,2004-05-01,1,0,1,0,1
20902,SAPAHAQUI,estado nutricional,clasificacion f,2004-05-01,1,0,1,0,1
90303,SENA,estado nutricional,clasificacion f,2004-05-01,1,2,1,2,3
21301,SICA SICA (VILLA AROMA),estado nutricional,clasificacion f,2004-05-01,5,1,5,1,6
30703,SICAYA,estado nutricional,clasificacion f,2004-05-01,1,1,1,1,2
30902,SIPE SIPE,estado nutricional,clasificacion f,2004-05-01,4,4,4,4,8
10403,SOPACHUY,estado nutricional,clasificacion f,2004-05-01,9,8,9,8,17
20601,SORATA,estado nutricional,clasificacion f,2004-05-01,3,3,3,3,6
10101,SUCRE,estado nutricional,clasificacion f,2004-05-01,22,10,22,10,32
50303,TACOBAMBA,estado nutricional,clasificacion f,2004-05-01,3,0,3,0,3
30602,TACOPAYA,estado nutricional,clasificacion f,2004-05-01,10,7,10,7,17
31101,TAPACARI,estado nutricional,clasificacion f,2004-05-01,6,2,6,2,8
10601,TARABUCO,estado nutricional,clasificacion f,2004-05-01,26,17,26,17,43
60101,TARIJA,estado nutricional,clasificacion f,2004-05-01,2,2,2,2,4
10202,TARVITA,estado nutricional,clasificacion f,2004-05-01,12,5,12,5,17
50102,TINGUIPAYA,estado nutricional,clasificacion f,2004-05-01,11,5,11,5,16
20606,TIPUANI,estado nutricional,clasificacion f,2004-05-01,1,0,1,0,1
30903,TIQUIPAYA,estado nutricional,clasificacion f,2004-05-01,1,0,1,0,1
31601,TIRAQUE (CBBA),estado nutricional,clasificacion f,2004-05-01,10,5,10,5,15
30802,TOCO,estado nutricional,clasificacion f,2004-05-01,4,48,4,48,52
51202,TOMAVE,estado nutricional,clasificacion f,2004-05-01,6,0,6,0,6
10402,TOMINA,estado nutricional,clasificacion f,2004-05-01,6,4,6,4,10
50502,TORO TORO,estado nutricional,clasificacion f,2004-05-01,11,2,11,2,13
31201,TOTORA(CBBA),estado nutricional,clasificacion f,2004-05-01,3,1,3,1,4
80101,TRINIDAD,estado nutricional,clasificacion f,2004-05-01,2,4,2,4,6
50801,TUPIZA,estado nutricional,clasificacion f,2004-05-01,2,7,2,7,9
50201,UNCIA,estado nutricional,clasificacion f,2004-05-01,6,2,6,2,8
60401,URIONDO (A. CONCEPCION),estado nutricional,clasificacion f,2004-05-01,2,0,2,0,2
71502,URUBICHA,estado nutricional,clasificacion f,2004-05-01,12,1,12,1,13
51201,UYUNI,estado nutricional,clasificacion f,2004-05-01,0,1,0,1,1
30502,VACAS,estado nutricional,clasificacion f,2004-05-01,2,1,2,1,3
20801,VIACHA,estado nutricional,clasificacion f,2004-05-01,7,8,7,8,15
31302,VILA VILA,estado nutricional,clasificacion f,2004-05-01,2,4,2,4,6
60303,VILLA MONTES,estado nutricional,clasificacion f,2004-05-01,3,1,3,1,4
10801,VILLA SERRANO,estado nutricional,clasificacion f,2004-05-01,6,2,6,2,8
31003,VILLA TUNARI,estado nutricional,clasificacion f,2004-05-01,18,4,18,4,22
11001,VILLA VACA GUZMAN (MUYUPAMPA),estado nutricional,clasificacion f,2004-05-01,1,0,1,0,1
51501,VILLAZON,estado nutricional,clasificacion f,2004-05-01,1,1,1,1,2
50602,VITICHI,estado nutricional,clasificacion f,2004-05-01,2,2,2,2,4
70201,WARNES,estado nutricional,clasificacion f,2004-05-01,0,1,0,1,1
20903,YACO,estado nutricional,clasificacion f,2004-05-01,1,0,1,0,1
60301,YACUIBA,estado nutricional,clasificacion f,2004-05-01,1,0,1,0,1
10602,YAMPARAEZ,estado nutricional,clasificacion f,2004-05-01,13,2,13,2,15
21103,YANACACHI,estado nutricional,clasificacion f,2004-05-01,1,0,1,0,1
70403,YAPACANI,estado nutricional,clasificacion f,2004-05-01,8,0,8,0,8
50103,YOCALLA,estado nutricional,clasificacion f,2004-05-01,1,1,1,1,2
10102,YOTALA,estado nutricional,clasificacion f,2004-05-01,1,2,1,2,3
60402,YUNCHARA,estado nutricional,clasificacion f,2004-05-01,1,2,1,2,3
10301,ZUDAÃ‘EZ,estado nutricional,clasificacion f,2004-05-01,6,3,6,3,9
51302,ACACIO,estado nutricional,clasificacion f,2004-06-01,3,3,3,3,6
20201,ACHACACHI,estado nutricional,clasificacion f,2004-06-01,1,0,1,0,1
30201,AIQUILE,estado nutricional,clasificacion f,2004-06-01,2,1,2,1,3
20202,ANCORAIMES,estado nutricional,clasificacion f,2004-06-01,1,1,1,1,2
41201,ANDAMARCA,estado nutricional,clasificacion f,2004-06-01,1,0,1,0,1
40603,ANTEQUERA,estado nutricional,clasificacion f,2004-06-01,0,1,0,1,1
30402,ANZALDO,estado nutricional,clasificacion f,2004-06-01,2,3,2,3,5
51301,ARAMPAMPA,estado nutricional,clasificacion f,2004-06-01,6,3,6,3,9
30501,ARANI,estado nutricional,clasificacion f,2004-06-01,2,0,2,0,2
30403,ARBIETO,estado nutricional,clasificacion f,2004-06-01,2,0,2,0,2
30601,ARQUE,estado nutricional,clasificacion f,2004-06-01,7,1,7,1,8
71501,ASCENCION DE GUARAYOS,estado nutricional,clasificacion f,2004-06-01,7,2,7,2,9
50802,ATOCHA,estado nutricional,clasificacion f,2004-06-01,8,2,8,2,10
20503,AUCAPATA,estado nutricional,clasificacion f,2004-06-01,2,0,2,0,2
20502,AYATA,estado nutricional,clasificacion f,2004-06-01,1,1,1,1,2
30301,AYOPAYA (V. DE INDEPENDENCIA),estado nutricional,clasificacion f,2004-06-01,7,1,7,1,8
10201,AZURDUY,estado nutricional,clasificacion f,2004-06-01,9,4,9,4,13
80802,BAURES,estado nutricional,clasificacion f,2004-06-01,1,0,1,0,1
90104,BELLA FLOR,estado nutricional,clasificacion f,2004-06-01,0,3,0,3,3
60202,BERMEJO,estado nutricional,clasificacion f,2004-06-01,0,4,0,4,4
50301,BETANZOS,estado nutricional,clasificacion f,2004-06-01,16,5,16,5,21
31501,BOLIVAR,estado nutricional,clasificacion f,2004-06-01,4,3,4,3,7
90103,BOLPEBRA,estado nutricional,clasificacion f,2004-06-01,0,1,0,1,1
70401,BUENA VISTA,estado nutricional,clasificacion f,2004-06-01,2,10,2,10,12
70703,CABEZAS,estado nutricional,clasificacion f,2004-06-01,0,1,0,1,1
20905,CAIROMA,estado nutricional,clasificacion f,2004-06-01,6,7,6,7,13
51102,"CAIZA ""D""",estado nutricional,clasificacion f,2004-06-01,1,3,1,3,4
21003,CAJUATA,estado nutricional,clasificacion f,2004-06-01,2,1,2,1,3
21304,CALAMARCA,estado nutricional,clasificacion f,2004-06-01,7,0,7,0,7
70706,CAMIRI,estado nutricional,clasificacion f,2004-06-01,4,5,4,5,9
22001,CARANAVI,estado nutricional,clasificacion f,2004-06-01,8,2,8,2,10
50702,CARIPUYO,estado nutricional,clasificacion f,2004-06-01,15,9,15,9,24
40201,CHALLAPATA,estado nutricional,clasificacion f,2004-06-01,5,3,5,3,8
50302,CHAQUI,estado nutricional,clasificacion f,2004-06-01,1,1,1,1,2
70702,CHARAGUA,estado nutricional,clasificacion f,2004-06-01,9,3,9,3,12
50202,CHAYANTA,estado nutricional,clasificacion f,2004-06-01,2,0,2,0,2
20501,CHUMA,estado nutricional,clasificacion f,2004-06-01,2,0,2,0,2
30801,CLIZA,estado nutricional,clasificacion f,2004-06-01,15,1,15,1,16
90101,COBIJA,estado nutricional,clasificacion f,2004-06-01,3,1,3,1,4
30101,COCHABAMBA,estado nutricional,clasificacion f,2004-06-01,11,6,11,6,17
30905,COLCAPIRHUA,estado nutricional,clasificacion f,2004-06-01,0,1,0,1,1
31002,COLOMI,estado nutricional,clasificacion f,2004-06-01,8,1,8,1,9
50401,COLQUECHACA,estado nutricional,clasificacion f,2004-06-01,23,10,23,10,33
21306,COLQUENCHA,estado nutricional,clasificacion f,2004-06-01,3,1,3,1,4
21004,COLQUIRI,estado nutricional,clasificacion f,2004-06-01,2,0,2,0,2
71301,COMARAPA,estado nutricional,clasificacion f,2004-06-01,3,3,3,3,6
71101,CONCEPCION,estado nutricional,clasificacion f,2004-06-01,0,1,0,1,1
21701,COPACABANA,estado nutricional,clasificacion f,2004-06-01,1,0,1,0,1
20301,CORO CORO,estado nutricional,clasificacion f,2004-06-01,2,1,2,1,3
21401,COROICO,estado nutricional,clasificacion f,2004-06-01,6,1,6,1,7
40301,CORQUE,estado nutricional,clasificacion f,2004-06-01,4,1,4,1,5
50601,COTAGAITA,estado nutricional,clasificacion f,2004-06-01,6,5,6,5,11
70102,COTOCA,estado nutricional,clasificacion f,2004-06-01,1,0,1,0,1
10902,CULPINA,estado nutricional,clasificacion f,2004-06-01,12,4,12,4,16
21602,CURVA,estado nutricional,clasificacion f,2004-06-01,0,2,0,2,2
20105,EL ALTO,estado nutricional,clasificacion f,2004-06-01,88,29,88,29,117
71503,EL PUENTE(STC),estado nutricional,clasificacion f,2004-06-01,3,2,3,2,5
60502,EL PUENTE(TJA),estado nutricional,clasificacion f,2004-06-01,2,1,2,1,3
70105,EL TORNO,estado nutricional,clasificacion f,2004-06-01,1,0,1,0,1
10405,EL VILLAR,estado nutricional,clasificacion f,2004-06-01,3,1,3,1,4
60601,ENTRE RIOS,estado nutricional,clasificacion f,2004-06-01,0,1,0,1,1
41101,EUCALIPTUS,estado nutricional,clasificacion f,2004-06-01,2,0,2,0,2
71002,GENERAL SAAVEDRA,estado nutricional,clasificacion f,2004-06-01,6,4,6,4,10
21601,GRAL. J.J. PEREZ (CHARAZANI),estado nutricional,clasificacion f,2004-06-01,2,2,2,2,4
20602,GUANAY,estado nutricional,clasificacion f,2004-06-01,8,3,8,3,11
80202,GUAYARAMERIN,estado nutricional,clasificacion f,2004-06-01,3,1,3,1,4
70705,GUTIERREZ,estado nutricional,clasificacion f,2004-06-01,8,7,8,7,15
10502,HUACARETA,estado nutricional,clasificacion f,2004-06-01,2,1,2,1,3
11002,HUACAYA (VILLA DE HUACAYA),estado nutricional,clasificacion f,2004-06-01,1,0,1,0,1
40701,HUANUNI,estado nutricional,clasificacion f,2004-06-01,0,1,0,1,1
21005,ICHOCA,estado nutricional,clasificacion f,2004-06-01,0,1,0,1,1
10304,ICLA,estado nutricional,clasificacion f,2004-06-01,12,6,12,6,18
10703,INCAHUASI,estado nutricional,clasificacion f,2004-06-01,24,10,24,10,34
21001,INQUISIVI,estado nutricional,clasificacion f,2004-06-01,2,3,2,3,5
21102,IRUPANA (VILLA DE LANZA),estado nutricional,clasificacion f,2004-06-01,1,0,1,0,1
21501,IXIAMAS,estado nutricional,clasificacion f,2004-06-01,0,2,0,2,2
21105,LA ASUNTA,estado nutricional,clasificacion f,2004-06-01,4,7,4,7,11
70104,LA GUARDIA,estado nutricional,clasificacion f,2004-06-01,3,0,3,0,3
20101,LA PAZ,estado nutricional,clasificacion f,2004-06-01,62,17,62,17,79
10903,LAS CARRERAS,estado nutricional,clasificacion f,2004-06-01,1,0,1,0,1
50203,LLALLAGUA,estado nutricional,clasificacion f,2004-06-01,12,6,12,6,18
20901,LURIBAY,estado nutricional,clasificacion f,2004-06-01,1,0,1,0,1
80801,MAGDALENA,estado nutricional,clasificacion f,2004-06-01,3,0,3,0,3
20103,MECAPACA,estado nutricional,clasificacion f,2004-06-01,0,1,0,1,1
71003,MINEROS,estado nutricional,clasificacion f,2004-06-01,13,0,13,0,13
31301,MIZQUE,estado nutricional,clasificacion f,2004-06-01,9,6,9,6,15
20402,MOCOMOCO,estado nutricional,clasificacion f,2004-06-01,3,1,3,1,4
10303,MOJOCOYA,estado nutricional,clasificacion f,2004-06-01,5,0,5,0,5
10501,MONTEAGUDO,estado nutricional,clasificacion f,2004-06-01,7,3,7,3,10
71001,MONTERO,estado nutricional,clasificacion f,2004-06-01,13,4,13,4,17
70803,MORO MORO,estado nutricional,clasificacion f,2004-06-01,3,0,3,0,3
30302,MOROCHATA,estado nutricional,clasificacion f,2004-06-01,20,3,20,3,23
50404,OCURI,estado nutricional,clasificacion f,2004-06-01,9,8,9,8,17
70202,OKINAWA,estado nutricional,clasificacion f,2004-06-01,4,0,4,0,4
30203,OMEREQUE,estado nutricional,clasificacion f,2004-06-01,1,1,1,1,2
40101,ORURO,estado nutricional,clasificacion f,2004-06-01,19,8,19,8,27
60201,PADCAYA,estado nutricional,clasificacion f,2004-06-01,1,0,1,0,1
10401,PADILLA,estado nutricional,clasificacion f,2004-06-01,10,2,10,2,12
70502,PAILON,estado nutricional,clasificacion f,2004-06-01,1,0,1,0,1
20102,PALCA,estado nutricional,clasificacion f,2004-06-01,1,0,1,0,1
21104,PALOS BLANCOS,estado nutricional,clasificacion f,2004-06-01,6,2,6,2,8
40802,PAMPA AULLAGAS,estado nutricional,clasificacion f,2004-06-01,1,0,1,0,1
70902,PAMPA GRANDE,estado nutricional,clasificacion f,2004-06-01,3,0,3,0,3
30202,PASORAPA,estado nutricional,clasificacion f,2004-06-01,0,1,0,1,1
21305,PATACAMAYA,estado nutricional,clasificacion f,2004-06-01,2,1,2,1,3
50403,POCOATA,estado nutricional,clasificacion f,2004-06-01,13,19,13,19,32
31203,POCONA,estado nutricional,clasificacion f,2004-06-01,4,3,4,3,7
31202,POJO (CBBA),estado nutricional,clasificacion f,2004-06-01,4,0,4,0,4
40601,POOPO,estado nutricional,clasificacion f,2004-06-01,1,0,1,0,1
51203,PORCO,estado nutricional,clasificacion f,2004-06-01,1,2,1,2,3
10103,POROMA,estado nutricional,clasificacion f,2004-06-01,4,7,4,7,11
90102,PORVENIR,estado nutricional,clasificacion f,2004-06-01,1,0,1,0,1
50101,POTOSI,estado nutricional,clasificacion f,2004-06-01,30,11,30,11,41
10302,PRESTO,estado nutricional,clasificacion f,2004-06-01,6,1,6,1,7
21201,PUCARANI,estado nutricional,clasificacion f,2004-06-01,1,0,1,0,1
20401,PUERTO ACOSTA,estado nutricional,clasificacion f,2004-06-01,1,3,1,3,4
20403,PUERTO CARABUCO,estado nutricional,clasificacion f,2004-06-01,3,0,3,0,3
90301,PUERTO GONZALO MORENO,estado nutricional,clasificacion f,2004-06-01,1,0,1,0,1
71402,PUERTO QUIJARRO,estado nutricional,clasificacion f,2004-06-01,1,1,1,1,2
90201,PUERTO RICO,estado nutricional,clasificacion f,2004-06-01,2,1,2,1,3
31205,PUERTO VILLARROEL,estado nutricional,clasificacion f,2004-06-01,16,10,16,10,26
51101,PUNA,estado nutricional,clasificacion f,2004-06-01,11,0,11,0,11
31401,PUNATA,estado nutricional,clasificacion f,2004-06-01,1,6,1,6,7
20604,QUIABAYA,estado nutricional,clasificacion f,2004-06-01,3,0,3,0,3
30901,QUILLACOLLO,estado nutricional,clasificacion f,2004-06-01,4,5,4,5,9
21002,QUIME,estado nutricional,clasificacion f,2004-06-01,1,0,1,0,1
50402,RAVELO,estado nutricional,clasificacion f,2004-06-01,20,14,20,14,34
80301,REYES,estado nutricional,clasificacion f,2004-06-01,1,0,1,0,1
80201,RIBERALTA,estado nutricional,clasificacion f,2004-06-01,61,30,61,30,91
70503,ROBORE,estado nutricional,clasificacion f,2004-06-01,6,1,6,1,7
80304,RURRENABAQUE,estado nutricional,clasificacion f,2004-06-01,2,0,2,0,2
31001,SACABA,estado nutricional,clasificacion f,2004-06-01,3,3,3,3,6
30404,SACABAMBA,estado nutricional,clasificacion f,2004-06-01,1,0,1,0,1
50701,SACACA,estado nutricional,clasificacion f,2004-06-01,22,16,22,16,38
71302,SAIPINA,estado nutricional,clasificacion f,2004-06-01,1,0,1,0,1
40801,SALINAS DE GARCI MENDOZA,estado nutricional,clasificacion f,2004-06-01,1,1,1,1,2
71105,SAN ANTONIO DE LOMERIO,estado nutricional,clasificacion f,2004-06-01,1,1,1,1,2
31403,SAN BENITO,estado nutricional,clasificacion f,2004-06-01,5,1,5,1,6
80302,SAN BORJA,estado nutricional,clasificacion f,2004-06-01,5,5,5,5,10
21502,SAN BUENA VENTURA,estado nutricional,clasificacion f,2004-06-01,3,0,3,0,3
70402,SAN CARLOS,estado nutricional,clasificacion f,2004-06-01,3,3,3,3,6
80501,SAN IGNACIO,estado nutricional,clasificacion f,2004-06-01,5,0,5,0,5
70301,SAN IGNACIO DE VELASCO,estado nutricional,clasificacion f,2004-06-01,14,5,14,5,19
80102,SAN JAVIER(BNI),estado nutricional,clasificacion f,2004-06-01,0,1,0,1,1
70501,SAN JOSE DE CHIQUITOS,estado nutricional,clasificacion f,2004-06-01,1,0,1,0,1
71104,SAN JULIAN,estado nutricional,clasificacion f,2004-06-01,7,6,7,6,13
60501,SAN LORENZO(TJA),estado nutricional,clasificacion f,2004-06-01,0,3,0,3,3
10702,SAN LUCAS,estado nutricional,clasificacion f,2004-06-01,28,9,28,9,37
71201,SAN MATIAS,estado nutricional,clasificacion f,2004-06-01,0,2,0,2,2
70302,SAN MIGUEL DE VELASCO,estado nutricional,clasificacion f,2004-06-01,1,0,1,0,1
50501,SAN PEDRO DE BUENA VISTA,estado nutricional,clasificacion f,2004-06-01,8,8,8,8,16
90202,SAN PEDRO(PND),estado nutricional,clasificacion f,2004-06-01,2,0,2,0,2
70303,SAN RAFAEL,estado nutricional,clasificacion f,2004-06-01,3,0,3,0,3
80401,SANTA ANA,estado nutricional,clasificacion f,2004-06-01,1,0,1,0,1
70101,SANTA CRUZ DE LA SIERRA,estado nutricional,clasificacion f,2004-06-01,20,8,20,8,28
80303,SANTA ROSA,estado nutricional,clasificacion f,2004-06-01,3,1,3,1,4
70602,SANTA ROSA DEL SARA,estado nutricional,clasificacion f,2004-06-01,0,1,0,1,1
20308,SANTIAGO DE CALLAPA,estado nutricional,clasificacion f,2004-06-01,3,1,3,1,4
41401,SANTIAGO DE HUARI,estado nutricional,clasificacion f,2004-06-01,1,1,1,1,2
30702,SANTIVAÃ‘ES,estado nutricional,clasificacion f,2004-06-01,1,1,1,1,2
20902,SAPAHAQUI,estado nutricional,clasificacion f,2004-06-01,4,0,4,0,4
90303,SENA,estado nutricional,clasificacion f,2004-06-01,4,0,4,0,4
21301,SICA SICA (VILLA AROMA),estado nutricional,clasificacion f,2004-06-01,5,2,5,2,7
30703,SICAYA,estado nutricional,clasificacion f,2004-06-01,0,1,0,1,1
30902,SIPE SIPE,estado nutricional,clasificacion f,2004-06-01,4,8,4,8,12
10403,SOPACHUY,estado nutricional,clasificacion f,2004-06-01,5,2,5,2,7
20601,SORATA,estado nutricional,clasificacion f,2004-06-01,0,3,0,3,3
10101,SUCRE,estado nutricional,clasificacion f,2004-06-01,16,13,16,13,29
50303,TACOBAMBA,estado nutricional,clasificacion f,2004-06-01,3,1,3,1,4
30602,TACOPAYA,estado nutricional,clasificacion f,2004-06-01,4,5,4,5,9
31101,TAPACARI,estado nutricional,clasificacion f,2004-06-01,5,5,5,5,10
10601,TARABUCO,estado nutricional,clasificacion f,2004-06-01,26,12,26,12,38
60101,TARIJA,estado nutricional,clasificacion f,2004-06-01,13,6,13,6,19
10202,TARVITA,estado nutricional,clasificacion f,2004-06-01,1,2,1,2,3
20803,TIAWANACU,estado nutricional,clasificacion f,2004-06-01,1,0,1,0,1
50102,TINGUIPAYA,estado nutricional,clasificacion f,2004-06-01,10,3,10,3,13
30903,TIQUIPAYA,estado nutricional,clasificacion f,2004-06-01,1,1,1,1,2
31601,TIRAQUE (CBBA),estado nutricional,clasificacion f,2004-06-01,8,6,8,6,14
30802,TOCO,estado nutricional,clasificacion f,2004-06-01,1,1,1,1,2
41001,TOLEDO,estado nutricional,clasificacion f,2004-06-01,1,0,1,0,1
51202,TOMAVE,estado nutricional,clasificacion f,2004-06-01,4,1,4,1,5
10402,TOMINA,estado nutricional,clasificacion f,2004-06-01,11,5,11,5,16
50502,TORO TORO,estado nutricional,clasificacion f,2004-06-01,16,12,16,12,28
31201,TOTORA(CBBA),estado nutricional,clasificacion f,2004-06-01,3,3,3,3,6
41301,TOTORA(ORR),estado nutricional,clasificacion f,2004-06-01,1,0,1,0,1
80101,TRINIDAD,estado nutricional,clasificacion f,2004-06-01,4,4,4,4,8
50801,TUPIZA,estado nutricional,clasificacion f,2004-06-01,3,2,3,2,5
50201,UNCIA,estado nutricional,clasificacion f,2004-06-01,4,2,4,2,6
71502,URUBICHA,estado nutricional,clasificacion f,2004-06-01,2,0,2,0,2
51201,UYUNI,estado nutricional,clasificacion f,2004-06-01,1,0,1,0,1
30502,VACAS,estado nutricional,clasificacion f,2004-06-01,4,3,4,3,7
70801,VALLEGRANDE,estado nutricional,clasificacion f,2004-06-01,4,7,4,7,11
20801,VIACHA,estado nutricional,clasificacion f,2004-06-01,4,2,4,2,6
31302,VILA VILA,estado nutricional,clasificacion f,2004-06-01,4,2,4,2,6
60303,VILLA MONTES,estado nutricional,clasificacion f,2004-06-01,3,4,3,4,7
31402,VILLA RIVERO,estado nutricional,clasificacion f,2004-06-01,0,2,0,2,2
10801,VILLA SERRANO,estado nutricional,clasificacion f,2004-06-01,7,2,7,2,9
31003,VILLA TUNARI,estado nutricional,clasificacion f,2004-06-01,17,13,17,13,30
51501,VILLAZON,estado nutricional,clasificacion f,2004-06-01,1,2,1,2,3
30904,VINTO,estado nutricional,clasificacion f,2004-06-01,6,1,6,1,7
50602,VITICHI,estado nutricional,clasificacion f,2004-06-01,7,5,7,5,12
70201,WARNES,estado nutricional,clasificacion f,2004-06-01,2,1,2,1,3
20903,YACO,estado nutricional,clasificacion f,2004-06-01,7,2,7,2,9
60301,YACUIBA,estado nutricional,clasificacion f,2004-06-01,1,1,1,1,2
10602,YAMPARAEZ,estado nutricional,clasificacion f,2004-06-01,18,5,18,5,23
70403,YAPACANI,estado nutricional,clasificacion f,2004-06-01,6,1,6,1,7
10102,YOTALA,estado nutricional,clasificacion f,2004-06-01,1,4,1,4,5
60402,YUNCHARA,estado nutricional,clasificacion f,2004-06-01,1,1,1,1,2
10301,ZUDAÃ‘EZ,estado nutricional,clasificacion f,2004-06-01,3,2,3,2,5
51302,ACACIO,estado nutricional,clasificacion f,2004-07-01,5,3,5,3,8
20201,ACHACACHI,estado nutricional,clasificacion f,2004-07-01,3,1,3,1,4
30201,AIQUILE,estado nutricional,clasificacion f,2004-07-01,3,0,3,0,3
10404,ALCALA,estado nutricional,clasificacion f,2004-07-01,0,5,0,5,5
20202,ANCORAIMES,estado nutricional,clasificacion f,2004-07-01,3,0,3,0,3
40603,ANTEQUERA,estado nutricional,clasificacion f,2004-07-01,0,1,0,1,1
20701,APOLO,estado nutricional,clasificacion f,2004-07-01,6,0,6,0,6
51301,ARAMPAMPA,estado nutricional,clasificacion f,2004-07-01,4,1,4,1,5
30501,ARANI,estado nutricional,clasificacion f,2004-07-01,5,0,5,0,5
30403,ARBIETO,estado nutricional,clasificacion f,2004-07-01,2,3,2,3,5
30601,ARQUE,estado nutricional,clasificacion f,2004-07-01,6,0,6,0,6
50802,ATOCHA,estado nutricional,clasificacion f,2004-07-01,2,1,2,1,3
20502,AYATA,estado nutricional,clasificacion f,2004-07-01,2,0,2,0,2
30301,AYOPAYA (V. DE INDEPENDENCIA),estado nutricional,clasificacion f,2004-07-01,3,0,3,0,3
10201,AZURDUY,estado nutricional,clasificacion f,2004-07-01,11,7,11,7,18
80802,BAURES,estado nutricional,clasificacion f,2004-07-01,1,0,1,0,1
50301,BETANZOS,estado nutricional,clasificacion f,2004-07-01,12,4,12,4,16
31501,BOLIVAR,estado nutricional,clasificacion f,2004-07-01,6,2,6,2,8
70707,BOYUIBE,estado nutricional,clasificacion f,2004-07-01,1,0,1,0,1
70401,BUENA VISTA,estado nutricional,clasificacion f,2004-07-01,1,0,1,0,1
70703,CABEZAS,estado nutricional,clasificacion f,2004-07-01,1,1,1,1,2
20905,CAIROMA,estado nutricional,clasificacion f,2004-07-01,7,2,7,2,9
51102,"CAIZA ""D""",estado nutricional,clasificacion f,2004-07-01,0,2,0,2,2
21003,CAJUATA,estado nutricional,clasificacion f,2004-07-01,2,1,2,1,3
21304,CALAMARCA,estado nutricional,clasificacion f,2004-07-01,2,1,2,1,3
10701,CAMARGO,estado nutricional,clasificacion f,2004-07-01,1,1,1,1,2
10901,CAMATAQUI (C. VILLA ABECIA),estado nutricional,clasificacion f,2004-07-01,1,0,1,0,1
70706,CAMIRI,estado nutricional,clasificacion f,2004-07-01,1,0,1,0,1
30701,CAPINOTA,estado nutricional,clasificacion f,2004-07-01,6,3,6,3,9
20302,CAQUIAVIRI,estado nutricional,clasificacion f,2004-07-01,2,1,2,1,3
40102,CARACOLLO,estado nutricional,clasificacion f,2004-07-01,2,0,2,0,2
22001,CARANAVI,estado nutricional,clasificacion f,2004-07-01,2,2,2,2,4
50702,CARIPUYO,estado nutricional,clasificacion f,2004-07-01,11,0,11,0,11
40201,CHALLAPATA,estado nutricional,clasificacion f,2004-07-01,4,3,4,3,7
50302,CHAQUI,estado nutricional,clasificacion f,2004-07-01,1,1,1,1,2
70702,CHARAGUA,estado nutricional,clasificacion f,2004-07-01,7,3,7,3,10
50202,CHAYANTA,estado nutricional,clasificacion f,2004-07-01,3,3,3,3,6
21101,CHULUMANI (V. DE LA LIBERTAD),estado nutricional,clasificacion f,2004-07-01,4,0,4,0,4
20501,CHUMA,estado nutricional,clasificacion f,2004-07-01,3,0,3,0,3
30801,CLIZA,estado nutricional,clasificacion f,2004-07-01,3,0,3,0,3
90101,COBIJA,estado nutricional,clasificacion f,2004-07-01,5,3,5,3,8
30101,COCHABAMBA,estado nutricional,clasificacion f,2004-07-01,3,2,3,2,5
30905,COLCAPIRHUA,estado nutricional,clasificacion f,2004-07-01,1,0,1,0,1
31002,COLOMI,estado nutricional,clasificacion f,2004-07-01,3,2,3,2,5
50401,COLQUECHACA,estado nutricional,clasificacion f,2004-07-01,5,2,5,2,7
21306,COLQUENCHA,estado nutricional,clasificacion f,2004-07-01,1,3,1,3,4
21004,COLQUIRI,estado nutricional,clasificacion f,2004-07-01,3,0,3,0,3
20304,COMANCHE,estado nutricional,clasificacion f,2004-07-01,1,0,1,0,1
71301,COMARAPA,estado nutricional,clasificacion f,2004-07-01,2,0,2,0,2
20605,COMBAYA,estado nutricional,clasificacion f,2004-07-01,1,0,1,0,1
21701,COPACABANA,estado nutricional,clasificacion f,2004-07-01,1,0,1,0,1
21401,COROICO,estado nutricional,clasificacion f,2004-07-01,1,1,1,1,2
40301,CORQUE,estado nutricional,clasificacion f,2004-07-01,2,0,2,0,2
50601,COTAGAITA,estado nutricional,clasificacion f,2004-07-01,10,15,10,15,25
70102,COTOCA,estado nutricional,clasificacion f,2004-07-01,0,1,0,1,1
10902,CULPINA,estado nutricional,clasificacion f,2004-07-01,6,5,6,5,11
21602,CURVA,estado nutricional,clasificacion f,2004-07-01,2,0,2,0,2
20105,EL ALTO,estado nutricional,clasificacion f,2004-07-01,68,26,68,26,94
71503,EL PUENTE(STC),estado nutricional,clasificacion f,2004-07-01,1,0,1,0,1
70105,EL TORNO,estado nutricional,clasificacion f,2004-07-01,0,1,0,1,1
10405,EL VILLAR,estado nutricional,clasificacion f,2004-07-01,2,2,2,2,4
60601,ENTRE RIOS,estado nutricional,clasificacion f,2004-07-01,1,1,1,1,2
80402,EXALTACION,estado nutricional,clasificacion f,2004-07-01,1,1,1,1,2
90203,FILADELFIA,estado nutricional,clasificacion f,2004-07-01,2,1,2,1,3
71002,GENERAL SAAVEDRA,estado nutricional,clasificacion f,2004-07-01,1,2,1,2,3
21601,GRAL. J.J. PEREZ (CHARAZANI),estado nutricional,clasificacion f,2004-07-01,2,3,2,3,5
20602,GUANAY,estado nutricional,clasificacion f,2004-07-01,5,3,5,3,8
20802,GUAQUI,estado nutricional,clasificacion f,2004-07-01,1,0,1,0,1
80202,GUAYARAMERIN,estado nutricional,clasificacion f,2004-07-01,6,5,6,5,11
70705,GUTIERREZ,estado nutricional,clasificacion f,2004-07-01,4,2,4,2,6
10502,HUACARETA,estado nutricional,clasificacion f,2004-07-01,5,0,5,0,5
21005,ICHOCA,estado nutricional,clasificacion f,2004-07-01,3,2,3,2,5
10304,ICLA,estado nutricional,clasificacion f,2004-07-01,9,10,9,10,19
10703,INCAHUASI,estado nutricional,clasificacion f,2004-07-01,7,6,7,6,13
21001,INQUISIVI,estado nutricional,clasificacion f,2004-07-01,3,2,3,2,5
21102,IRUPANA (VILLA DE LANZA),estado nutricional,clasificacion f,2004-07-01,2,1,2,1,3
21501,IXIAMAS,estado nutricional,clasificacion f,2004-07-01,1,3,1,3,4
21105,LA ASUNTA,estado nutricional,clasificacion f,2004-07-01,2,3,2,3,5
70104,LA GUARDIA,estado nutricional,clasificacion f,2004-07-01,1,0,1,0,1
20101,LA PAZ,estado nutricional,clasificacion f,2004-07-01,24,11,24,11,35
70701,LAGUNILLAS,estado nutricional,clasificacion f,2004-07-01,3,2,3,2,5
10903,LAS CARRERAS,estado nutricional,clasificacion f,2004-07-01,2,2,2,2,4
50203,LLALLAGUA,estado nutricional,clasificacion f,2004-07-01,12,12,12,12,24
11003,MACHARETI,estado nutricional,clasificacion f,2004-07-01,1,1,1,1,2
80801,MAGDALENA,estado nutricional,clasificacion f,2004-07-01,0,1,0,1,1
70903,MAIRANA,estado nutricional,clasificacion f,2004-07-01,1,0,1,0,1
20904,MALLA,estado nutricional,clasificacion f,2004-07-01,1,1,1,1,2
20103,MECAPACA,estado nutricional,clasificacion f,2004-07-01,0,2,0,2,2
71003,MINEROS,estado nutricional,clasificacion f,2004-07-01,7,2,7,2,9
31301,MIZQUE,estado nutricional,clasificacion f,2004-07-01,1,4,1,4,5
20402,MOCOMOCO,estado nutricional,clasificacion f,2004-07-01,4,2,4,2,6
10303,MOJOCOYA,estado nutricional,clasificacion f,2004-07-01,2,1,2,1,3
10501,MONTEAGUDO,estado nutricional,clasificacion f,2004-07-01,8,3,8,3,11
71001,MONTERO,estado nutricional,clasificacion f,2004-07-01,11,3,11,3,14
70803,MORO MORO,estado nutricional,clasificacion f,2004-07-01,0,2,0,2,2
30302,MOROCHATA,estado nutricional,clasificacion f,2004-07-01,5,1,5,1,6
50404,OCURI,estado nutricional,clasificacion f,2004-07-01,10,9,10,9,19
30203,OMEREQUE,estado nutricional,clasificacion f,2004-07-01,1,0,1,0,1
40101,ORURO,estado nutricional,clasificacion f,2004-07-01,13,7,13,7,20
60201,PADCAYA,estado nutricional,clasificacion f,2004-07-01,1,1,1,1,2
10401,PADILLA,estado nutricional,clasificacion f,2004-07-01,8,4,8,4,12
70502,PAILON,estado nutricional,clasificacion f,2004-07-01,2,0,2,0,2
21104,PALOS BLANCOS,estado nutricional,clasificacion f,2004-07-01,4,7,4,7,11
21305,PATACAMAYA,estado nutricional,clasificacion f,2004-07-01,2,0,2,0,2
20702,PELECHUCO,estado nutricional,clasificacion f,2004-07-01,1,1,1,1,2
50403,POCOATA,estado nutricional,clasificacion f,2004-07-01,3,5,3,5,8
31203,POCONA,estado nutricional,clasificacion f,2004-07-01,0,1,0,1,1
31202,POJO (CBBA),estado nutricional,clasificacion f,2004-07-01,4,3,4,3,7
40601,POOPO,estado nutricional,clasificacion f,2004-07-01,1,0,1,0,1
51203,PORCO,estado nutricional,clasificacion f,2004-07-01,1,0,1,0,1
10103,POROMA,estado nutricional,clasificacion f,2004-07-01,7,4,7,4,11
70601,PORTACHUELO,estado nutricional,clasificacion f,2004-07-01,0,1,0,1,1
70804,POSTRER VALLE,estado nutricional,clasificacion f,2004-07-01,1,0,1,0,1
50101,POTOSI,estado nutricional,clasificacion f,2004-07-01,27,9,27,9,36
10302,PRESTO,estado nutricional,clasificacion f,2004-07-01,2,0,2,0,2
21201,PUCARANI,estado nutricional,clasificacion f,2004-07-01,1,0,1,0,1
20401,PUERTO ACOSTA,estado nutricional,clasificacion f,2004-07-01,1,0,1,0,1
90301,PUERTO GONZALO MORENO,estado nutricional,clasificacion f,2004-07-01,4,0,4,0,4
90201,PUERTO RICO,estado nutricional,clasificacion f,2004-07-01,5,0,5,0,5
71401,PUERTO SUAREZ,estado nutricional,clasificacion f,2004-07-01,0,2,0,2,2
31205,PUERTO VILLARROEL,estado nutricional,clasificacion f,2004-07-01,14,4,14,4,18
51101,PUNA,estado nutricional,clasificacion f,2004-07-01,7,2,7,2,9
20604,QUIABAYA,estado nutricional,clasificacion f,2004-07-01,1,0,1,0,1
30901,QUILLACOLLO,estado nutricional,clasificacion f,2004-07-01,5,2,5,2,7
21002,QUIME,estado nutricional,clasificacion f,2004-07-01,0,1,0,1,1
50402,RAVELO,estado nutricional,clasificacion f,2004-07-01,16,6,16,6,22
80301,REYES,estado nutricional,clasificacion f,2004-07-01,2,1,2,1,3
80201,RIBERALTA,estado nutricional,clasificacion f,2004-07-01,29,17,29,17,46
70503,ROBORE,estado nutricional,clasificacion f,2004-07-01,4,0,4,0,4
31001,SACABA,estado nutricional,clasificacion f,2004-07-01,1,3,1,3,4
50701,SACACA,estado nutricional,clasificacion f,2004-07-01,16,7,16,7,23
40801,SALINAS DE GARCI MENDOZA,estado nutricional,clasificacion f,2004-07-01,0,1,0,1,1
70901,SAMAIPATA,estado nutricional,clasificacion f,2004-07-01,1,0,1,0,1
71105,SAN ANTONIO DE LOMERIO,estado nutricional,clasificacion f,2004-07-01,6,2,6,2,8
31403,SAN BENITO,estado nutricional,clasificacion f,2004-07-01,3,1,3,1,4
80302,SAN BORJA,estado nutricional,clasificacion f,2004-07-01,5,4,5,4,9
80501,SAN IGNACIO,estado nutricional,clasificacion f,2004-07-01,0,2,0,2,2
70301,SAN IGNACIO DE VELASCO,estado nutricional,clasificacion f,2004-07-01,16,9,16,9,25
80102,SAN JAVIER(BNI),estado nutricional,clasificacion f,2004-07-01,0,2,0,2,2
70501,SAN JOSE DE CHIQUITOS,estado nutricional,clasificacion f,2004-07-01,4,0,4,0,4
71104,SAN JULIAN,estado nutricional,clasificacion f,2004-07-01,1,0,1,0,1
90302,SAN LORENZO(PND),estado nutricional,clasificacion f,2004-07-01,1,0,1,0,1
60501,SAN LORENZO(TJA),estado nutricional,clasificacion f,2004-07-01,1,0,1,0,1
10702,SAN LUCAS,estado nutricional,clasificacion f,2004-07-01,33,9,33,9,42
71201,SAN MATIAS,estado nutricional,clasificacion f,2004-07-01,1,0,1,0,1
70302,SAN MIGUEL DE VELASCO,estado nutricional,clasificacion f,2004-07-01,1,0,1,0,1
50501,SAN PEDRO DE BUENA VISTA,estado nutricional,clasificacion f,2004-07-01,18,16,18,16,34
21801,SAN PEDRO DE CURAHUARA,estado nutricional,clasificacion f,2004-07-01,1,0,1,0,1
90202,SAN PEDRO(PND),estado nutricional,clasificacion f,2004-07-01,0,1,0,1,1
70303,SAN RAFAEL,estado nutricional,clasificacion f,2004-07-01,2,2,2,2,4
80401,SANTA ANA,estado nutricional,clasificacion f,2004-07-01,1,4,1,4,5
70101,SANTA CRUZ DE LA SIERRA,estado nutricional,clasificacion f,2004-07-01,32,4,32,4,36
80303,SANTA ROSA,estado nutricional,clasificacion f,2004-07-01,1,2,1,2,3
20308,SANTIAGO DE CALLAPA,estado nutricional,clasificacion f,2004-07-01,1,1,1,1,2
41401,SANTIAGO DE HUARI,estado nutricional,clasificacion f,2004-07-01,1,1,1,1,2
30702,SANTIVAÃ‘ES,estado nutricional,clasificacion f,2004-07-01,0,1,0,1,1
90303,SENA,estado nutricional,clasificacion f,2004-07-01,4,1,4,1,5
21301,SICA SICA (VILLA AROMA),estado nutricional,clasificacion f,2004-07-01,2,2,2,2,4
30703,SICAYA,estado nutricional,clasificacion f,2004-07-01,4,0,4,0,4
30902,SIPE SIPE,estado nutricional,clasificacion f,2004-07-01,4,1,4,1,5
10403,SOPACHUY,estado nutricional,clasificacion f,2004-07-01,4,4,4,4,8
20601,SORATA,estado nutricional,clasificacion f,2004-07-01,2,1,2,1,3
10101,SUCRE,estado nutricional,clasificacion f,2004-07-01,9,4,9,4,13
50303,TACOBAMBA,estado nutricional,clasificacion f,2004-07-01,5,0,5,0,5
30602,TACOPAYA,estado nutricional,clasificacion f,2004-07-01,13,0,13,0,13
31101,TAPACARI,estado nutricional,clasificacion f,2004-07-01,5,1,5,1,6
10601,TARABUCO,estado nutricional,clasificacion f,2004-07-01,30,11,30,11,41
30401,TARATA,estado nutricional,clasificacion f,2004-07-01,1,0,1,0,1
60101,TARIJA,estado nutricional,clasificacion f,2004-07-01,5,1,5,1,6
10202,TARVITA,estado nutricional,clasificacion f,2004-07-01,11,1,11,1,12
50102,TINGUIPAYA,estado nutricional,clasificacion f,2004-07-01,9,0,9,0,9
30903,TIQUIPAYA,estado nutricional,clasificacion f,2004-07-01,3,0,3,0,3
31601,TIRAQUE (CBBA),estado nutricional,clasificacion f,2004-07-01,10,9,10,9,19
30802,TOCO,estado nutricional,clasificacion f,2004-07-01,0,1,0,1,1
51202,TOMAVE,estado nutricional,clasificacion f,2004-07-01,3,0,3,0,3
10402,TOMINA,estado nutricional,clasificacion f,2004-07-01,9,6,9,6,15
50502,TORO TORO,estado nutricional,clasificacion f,2004-07-01,17,5,17,5,22
31201,TOTORA(CBBA),estado nutricional,clasificacion f,2004-07-01,0,1,0,1,1
80101,TRINIDAD,estado nutricional,clasificacion f,2004-07-01,10,2,10,2,12
50801,TUPIZA,estado nutricional,clasificacion f,2004-07-01,5,0,5,0,5
50201,UNCIA,estado nutricional,clasificacion f,2004-07-01,4,1,4,1,5
60401,URIONDO (A. CONCEPCION),estado nutricional,clasificacion f,2004-07-01,3,3,3,3,6
51201,UYUNI,estado nutricional,clasificacion f,2004-07-01,0,1,0,1,1
30502,VACAS,estado nutricional,clasificacion f,2004-07-01,3,1,3,1,4
20801,VIACHA,estado nutricional,clasificacion f,2004-07-01,3,0,3,0,3
31302,VILA VILA,estado nutricional,clasificacion f,2004-07-01,1,1,1,1,2
60303,VILLA MONTES,estado nutricional,clasificacion f,2004-07-01,5,3,5,3,8
31402,VILLA RIVERO,estado nutricional,clasificacion f,2004-07-01,4,3,4,3,7
10801,VILLA SERRANO,estado nutricional,clasificacion f,2004-07-01,4,2,4,2,6
31003,VILLA TUNARI,estado nutricional,clasificacion f,2004-07-01,9,4,9,4,13
51501,VILLAZON,estado nutricional,clasificacion f,2004-07-01,2,2,2,2,4
30904,VINTO,estado nutricional,clasificacion f,2004-07-01,5,1,5,1,6
50602,VITICHI,estado nutricional,clasificacion f,2004-07-01,6,2,6,2,8
70201,WARNES,estado nutricional,clasificacion f,2004-07-01,3,1,3,1,4
20903,YACO,estado nutricional,clasificacion f,2004-07-01,1,0,1,0,1
60301,YACUIBA,estado nutricional,clasificacion f,2004-07-01,3,1,3,1,4
10602,YAMPARAEZ,estado nutricional,clasificacion f,2004-07-01,13,4,13,4,17
70403,YAPACANI,estado nutricional,clasificacion f,2004-07-01,3,0,3,0,3
50103,YOCALLA,estado nutricional,clasificacion f,2004-07-01,1,0,1,0,1
10102,YOTALA,estado nutricional,clasificacion f,2004-07-01,3,0,3,0,3
60402,YUNCHARA,estado nutricional,clasificacion f,2004-07-01,2,0,2,0,2
10301,ZUDAÃ‘EZ,estado nutricional,clasificacion f,2004-07-01,4,2,4,2,6
51302,ACACIO,estado nutricional,clasificacion f,2004-08-01,6,4,6,4,10
20201,ACHACACHI,estado nutricional,clasificacion f,2004-08-01,4,0,4,0,4
20104,ACHOCALLA,estado nutricional,clasificacion f,2004-08-01,4,0,4,0,4
30201,AIQUILE,estado nutricional,clasificacion f,2004-08-01,2,0,2,0,2
10404,ALCALA,estado nutricional,clasificacion f,2004-08-01,0,1,0,1,1
20202,ANCORAIMES,estado nutricional,clasificacion f,2004-08-01,2,0,2,0,2
40603,ANTEQUERA,estado nutricional,clasificacion f,2004-08-01,1,0,1,0,1
51301,ARAMPAMPA,estado nutricional,clasificacion f,2004-08-01,5,1,5,1,6
30501,ARANI,estado nutricional,clasificacion f,2004-08-01,2,2,2,2,4
30403,ARBIETO,estado nutricional,clasificacion f,2004-08-01,0,2,0,2,2
30601,ARQUE,estado nutricional,clasificacion f,2004-08-01,5,2,5,2,7
50802,ATOCHA,estado nutricional,clasificacion f,2004-08-01,3,2,3,2,5
20503,AUCAPATA,estado nutricional,clasificacion f,2004-08-01,1,1,1,1,2
20502,AYATA,estado nutricional,clasificacion f,2004-08-01,2,1,2,1,3
30301,AYOPAYA (V. DE INDEPENDENCIA),estado nutricional,clasificacion f,2004-08-01,8,2,8,2,10
10201,AZURDUY,estado nutricional,clasificacion f,2004-08-01,3,2,3,2,5
80802,BAURES,estado nutricional,clasificacion f,2004-08-01,2,0,2,0,2
50301,BETANZOS,estado nutricional,clasificacion f,2004-08-01,10,4,10,4,14
31501,BOLIVAR,estado nutricional,clasificacion f,2004-08-01,1,2,1,2,3
70401,BUENA VISTA,estado nutricional,clasificacion f,2004-08-01,2,0,2,0,2
20905,CAIROMA,estado nutricional,clasificacion f,2004-08-01,3,0,3,0,3
51102,"CAIZA ""D""",estado nutricional,clasificacion f,2004-08-01,1,1,1,1,2
20303,CALACOTO,estado nutricional,clasificacion f,2004-08-01,0,1,0,1,1
21304,CALAMARCA,estado nutricional,clasificacion f,2004-08-01,4,0,4,0,4
70706,CAMIRI,estado nutricional,clasificacion f,2004-08-01,1,0,1,0,1
30701,CAPINOTA,estado nutricional,clasificacion f,2004-08-01,0,1,0,1,1
20302,CAQUIAVIRI,estado nutricional,clasificacion f,2004-08-01,0,1,0,1,1
40102,CARACOLLO,estado nutricional,clasificacion f,2004-08-01,2,2,2,2,4
22001,CARANAVI,estado nutricional,clasificacion f,2004-08-01,6,7,6,7,13
50702,CARIPUYO,estado nutricional,clasificacion f,2004-08-01,9,8,9,8,17
40201,CHALLAPATA,estado nutricional,clasificacion f,2004-08-01,2,2,2,2,4
50302,CHAQUI,estado nutricional,clasificacion f,2004-08-01,1,0,1,0,1
70702,CHARAGUA,estado nutricional,clasificacion f,2004-08-01,4,7,4,7,11
50202,CHAYANTA,estado nutricional,clasificacion f,2004-08-01,5,2,5,2,7
31204,CHIMORE,estado nutricional,clasificacion f,2004-08-01,2,1,2,1,3
21101,CHULUMANI (V. DE LA LIBERTAD),estado nutricional,clasificacion f,2004-08-01,1,0,1,0,1
20501,CHUMA,estado nutricional,clasificacion f,2004-08-01,1,0,1,0,1
30801,CLIZA,estado nutricional,clasificacion f,2004-08-01,4,0,4,0,4
90101,COBIJA,estado nutricional,clasificacion f,2004-08-01,4,0,4,0,4
30101,COCHABAMBA,estado nutricional,clasificacion f,2004-08-01,5,5,5,5,10
30905,COLCAPIRHUA,estado nutricional,clasificacion f,2004-08-01,1,0,1,0,1
31002,COLOMI,estado nutricional,clasificacion f,2004-08-01,1,1,1,1,2
50401,COLQUECHACA,estado nutricional,clasificacion f,2004-08-01,7,5,7,5,12
21306,COLQUENCHA,estado nutricional,clasificacion f,2004-08-01,0,1,0,1,1
71301,COMARAPA,estado nutricional,clasificacion f,2004-08-01,1,1,1,1,2
21701,COPACABANA,estado nutricional,clasificacion f,2004-08-01,1,0,1,0,1
21401,COROICO,estado nutricional,clasificacion f,2004-08-01,1,0,1,0,1
40301,CORQUE,estado nutricional,clasificacion f,2004-08-01,2,0,2,0,2
50601,COTAGAITA,estado nutricional,clasificacion f,2004-08-01,2,0,2,0,2
70102,COTOCA,estado nutricional,clasificacion f,2004-08-01,0,1,0,1,1
10902,CULPINA,estado nutricional,clasificacion f,2004-08-01,6,13,6,13,19
21602,CURVA,estado nutricional,clasificacion f,2004-08-01,1,0,1,0,1
20105,EL ALTO,estado nutricional,clasificacion f,2004-08-01,60,20,60,20,80
60502,EL PUENTE(TJA),estado nutricional,clasificacion f,2004-08-01,0,1,0,1,1
70105,EL TORNO,estado nutricional,clasificacion f,2004-08-01,3,0,3,0,3
10405,EL VILLAR,estado nutricional,clasificacion f,2004-08-01,3,2,3,2,5
80402,EXALTACION,estado nutricional,clasificacion f,2004-08-01,1,1,1,1,2
71002,GENERAL SAAVEDRA,estado nutricional,clasificacion f,2004-08-01,0,1,0,1,1
21601,GRAL. J.J. PEREZ (CHARAZANI),estado nutricional,clasificacion f,2004-08-01,4,1,4,1,5
80202,GUAYARAMERIN,estado nutricional,clasificacion f,2004-08-01,5,0,5,0,5
70705,GUTIERREZ,estado nutricional,clasificacion f,2004-08-01,11,2,11,2,13
40701,HUANUNI,estado nutricional,clasificacion f,2004-08-01,1,0,1,0,1
10304,ICLA,estado nutricional,clasificacion f,2004-08-01,17,8,17,8,25
10703,INCAHUASI,estado nutricional,clasificacion f,2004-08-01,17,13,17,13,30
21001,INQUISIVI,estado nutricional,clasificacion f,2004-08-01,4,1,4,1,5
21102,IRUPANA (VILLA DE LANZA),estado nutricional,clasificacion f,2004-08-01,3,0,3,0,3
21501,IXIAMAS,estado nutricional,clasificacion f,2004-08-01,2,1,2,1,3
21105,LA ASUNTA,estado nutricional,clasificacion f,2004-08-01,2,2,2,2,4
70104,LA GUARDIA,estado nutricional,clasificacion f,2004-08-01,3,0,3,0,3
20101,LA PAZ,estado nutricional,clasificacion f,2004-08-01,26,10,26,10,36
70701,LAGUNILLAS,estado nutricional,clasificacion f,2004-08-01,1,0,1,0,1
10903,LAS CARRERAS,estado nutricional,clasificacion f,2004-08-01,2,0,2,0,2
50203,LLALLAGUA,estado nutricional,clasificacion f,2004-08-01,7,7,7,7,14
51401,LLICA,estado nutricional,clasificacion f,2004-08-01,0,1,0,1,1
20901,LURIBAY,estado nutricional,clasificacion f,2004-08-01,8,3,8,3,11
70903,MAIRANA,estado nutricional,clasificacion f,2004-08-01,2,0,2,0,2
71003,MINEROS,estado nutricional,clasificacion f,2004-08-01,7,3,7,3,10
31301,MIZQUE,estado nutricional,clasificacion f,2004-08-01,4,0,4,0,4
20402,MOCOMOCO,estado nutricional,clasificacion f,2004-08-01,0,1,0,1,1
10303,MOJOCOYA,estado nutricional,clasificacion f,2004-08-01,1,1,1,1,2
10501,MONTEAGUDO,estado nutricional,clasificacion f,2004-08-01,5,4,5,4,9
71001,MONTERO,estado nutricional,clasificacion f,2004-08-01,5,1,5,1,6
30302,MOROCHATA,estado nutricional,clasificacion f,2004-08-01,5,5,5,5,10
50404,OCURI,estado nutricional,clasificacion f,2004-08-01,23,10,23,10,33
40101,ORURO,estado nutricional,clasificacion f,2004-08-01,10,3,10,3,13
60201,PADCAYA,estado nutricional,clasificacion f,2004-08-01,1,1,1,1,2
10401,PADILLA,estado nutricional,clasificacion f,2004-08-01,1,2,1,2,3
70502,PAILON,estado nutricional,clasificacion f,2004-08-01,3,0,3,0,3
21104,PALOS BLANCOS,estado nutricional,clasificacion f,2004-08-01,2,1,2,1,3
70902,PAMPA GRANDE,estado nutricional,clasificacion f,2004-08-01,0,1,0,1,1
21305,PATACAMAYA,estado nutricional,clasificacion f,2004-08-01,2,0,2,0,2
20702,PELECHUCO,estado nutricional,clasificacion f,2004-08-01,2,1,2,1,3
50403,POCOATA,estado nutricional,clasificacion f,2004-08-01,4,6,4,6,10
31203,POCONA,estado nutricional,clasificacion f,2004-08-01,3,0,3,0,3
31202,POJO (CBBA),estado nutricional,clasificacion f,2004-08-01,4,1,4,1,5
40601,POOPO,estado nutricional,clasificacion f,2004-08-01,1,0,1,0,1
10103,POROMA,estado nutricional,clasificacion f,2004-08-01,12,3,12,3,15
70601,PORTACHUELO,estado nutricional,clasificacion f,2004-08-01,2,0,2,0,2
70804,POSTRER VALLE,estado nutricional,clasificacion f,2004-08-01,0,1,0,1,1
50101,POTOSI,estado nutricional,clasificacion f,2004-08-01,25,12,25,12,37
10302,PRESTO,estado nutricional,clasificacion f,2004-08-01,9,3,9,3,12
21201,PUCARANI,estado nutricional,clasificacion f,2004-08-01,2,0,2,0,2
20401,PUERTO ACOSTA,estado nutricional,clasificacion f,2004-08-01,1,0,1,0,1
20403,PUERTO CARABUCO,estado nutricional,clasificacion f,2004-08-01,4,1,4,1,5
90201,PUERTO RICO,estado nutricional,clasificacion f,2004-08-01,2,0,2,0,2
31205,PUERTO VILLARROEL,estado nutricional,clasificacion f,2004-08-01,18,14,18,14,32
51101,PUNA,estado nutricional,clasificacion f,2004-08-01,9,0,9,0,9
31401,PUNATA,estado nutricional,clasificacion f,2004-08-01,3,0,3,0,3
20604,QUIABAYA,estado nutricional,clasificacion f,2004-08-01,2,0,2,0,2
30901,QUILLACOLLO,estado nutricional,clasificacion f,2004-08-01,3,2,3,2,5
21002,QUIME,estado nutricional,clasificacion f,2004-08-01,4,2,4,2,6
50402,RAVELO,estado nutricional,clasificacion f,2004-08-01,22,4,22,4,26
80301,REYES,estado nutricional,clasificacion f,2004-08-01,4,1,4,1,5
80201,RIBERALTA,estado nutricional,clasificacion f,2004-08-01,48,19,48,19,67
70503,ROBORE,estado nutricional,clasificacion f,2004-08-01,1,2,1,2,3
80304,RURRENABAQUE,estado nutricional,clasificacion f,2004-08-01,1,0,1,0,1
31001,SACABA,estado nutricional,clasificacion f,2004-08-01,2,0,2,0,2
30404,SACABAMBA,estado nutricional,clasificacion f,2004-08-01,2,0,2,0,2
50701,SACACA,estado nutricional,clasificacion f,2004-08-01,22,9,22,9,31
80602,SAN ANDRES,estado nutricional,clasificacion f,2004-08-01,1,0,1,0,1
71105,SAN ANTONIO DE LOMERIO,estado nutricional,clasificacion f,2004-08-01,1,1,1,1,2
31403,SAN BENITO,estado nutricional,clasificacion f,2004-08-01,2,3,2,3,5
80302,SAN BORJA,estado nutricional,clasificacion f,2004-08-01,2,2,2,2,4
21502,SAN BUENA VENTURA,estado nutricional,clasificacion f,2004-08-01,2,0,2,0,2
70402,SAN CARLOS,estado nutricional,clasificacion f,2004-08-01,3,0,3,0,3
80501,SAN IGNACIO,estado nutricional,clasificacion f,2004-08-01,4,2,4,2,6
70301,SAN IGNACIO DE VELASCO,estado nutricional,clasificacion f,2004-08-01,9,2,9,2,11
70501,SAN JOSE DE CHIQUITOS,estado nutricional,clasificacion f,2004-08-01,1,1,1,1,2
71104,SAN JULIAN,estado nutricional,clasificacion f,2004-08-01,4,1,4,1,5
90302,SAN LORENZO(PND),estado nutricional,clasificacion f,2004-08-01,2,0,2,0,2
60501,SAN LORENZO(TJA),estado nutricional,clasificacion f,2004-08-01,2,2,2,2,4
10702,SAN LUCAS,estado nutricional,clasificacion f,2004-08-01,35,10,35,10,45
70302,SAN MIGUEL DE VELASCO,estado nutricional,clasificacion f,2004-08-01,0,2,0,2,2
50501,SAN PEDRO DE BUENA VISTA,estado nutricional,clasificacion f,2004-08-01,20,11,20,11,31
70303,SAN RAFAEL,estado nutricional,clasificacion f,2004-08-01,3,2,3,2,5
70101,SANTA CRUZ DE LA SIERRA,estado nutricional,clasificacion f,2004-08-01,29,6,29,6,35
80303,SANTA ROSA,estado nutricional,clasificacion f,2004-08-01,0,1,0,1,1
70602,SANTA ROSA DEL SARA,estado nutricional,clasificacion f,2004-08-01,0,2,0,2,2
20308,SANTIAGO DE CALLAPA,estado nutricional,clasificacion f,2004-08-01,1,2,1,2,3
41401,SANTIAGO DE HUARI,estado nutricional,clasificacion f,2004-08-01,0,1,0,1,1
20902,SAPAHAQUI,estado nutricional,clasificacion f,2004-08-01,3,0,3,0,3
90303,SENA,estado nutricional,clasificacion f,2004-08-01,0,1,0,1,1
21301,SICA SICA (VILLA AROMA),estado nutricional,clasificacion f,2004-08-01,3,2,3,2,5
30703,SICAYA,estado nutricional,clasificacion f,2004-08-01,1,0,1,0,1
30902,SIPE SIPE,estado nutricional,clasificacion f,2004-08-01,6,2,6,2,8
10403,SOPACHUY,estado nutricional,clasificacion f,2004-08-01,7,5,7,5,12
20601,SORATA,estado nutricional,clasificacion f,2004-08-01,0,4,0,4,4
10101,SUCRE,estado nutricional,clasificacion f,2004-08-01,17,8,17,8,25
50303,TACOBAMBA,estado nutricional,clasificacion f,2004-08-01,2,0,2,0,2
30602,TACOPAYA,estado nutricional,clasificacion f,2004-08-01,9,7,9,7,16
31101,TAPACARI,estado nutricional,clasificacion f,2004-08-01,5,2,5,2,7
10601,TARABUCO,estado nutricional,clasificacion f,2004-08-01,26,11,26,11,37
60101,TARIJA,estado nutricional,clasificacion f,2004-08-01,7,3,7,3,10
10202,TARVITA,estado nutricional,clasificacion f,2004-08-01,7,0,7,0,7
50102,TINGUIPAYA,estado nutricional,clasificacion f,2004-08-01,5,0,5,0,5
30903,TIQUIPAYA,estado nutricional,clasificacion f,2004-08-01,1,0,1,0,1
31601,TIRAQUE (CBBA),estado nutricional,clasificacion f,2004-08-01,10,1,10,1,11
21703,TITO YUPANQUI (PARQUIPUJIO),estado nutricional,clasificacion f,2004-08-01,1,0,1,0,1
51202,TOMAVE,estado nutricional,clasificacion f,2004-08-01,3,1,3,1,4
10402,TOMINA,estado nutricional,clasificacion f,2004-08-01,8,9,8,9,17
50502,TORO TORO,estado nutricional,clasificacion f,2004-08-01,10,4,10,4,14
31201,TOTORA(CBBA),estado nutricional,clasificacion f,2004-08-01,4,0,4,0,4
80101,TRINIDAD,estado nutricional,clasificacion f,2004-08-01,18,7,18,7,25
50801,TUPIZA,estado nutricional,clasificacion f,2004-08-01,3,3,3,3,6
50201,UNCIA,estado nutricional,clasificacion f,2004-08-01,3,5,3,5,8
60401,URIONDO (A. CONCEPCION),estado nutricional,clasificacion f,2004-08-01,2,0,2,0,2
51201,UYUNI,estado nutricional,clasificacion f,2004-08-01,4,0,4,0,4
30502,VACAS,estado nutricional,clasificacion f,2004-08-01,0,1,0,1,1
70801,VALLEGRANDE,estado nutricional,clasificacion f,2004-08-01,2,1,2,1,3
20801,VIACHA,estado nutricional,clasificacion f,2004-08-01,3,0,3,0,3
31302,VILA VILA,estado nutricional,clasificacion f,2004-08-01,2,0,2,0,2
60303,VILLA MONTES,estado nutricional,clasificacion f,2004-08-01,2,2,2,2,4
31402,VILLA RIVERO,estado nutricional,clasificacion f,2004-08-01,2,1,2,1,3
10801,VILLA SERRANO,estado nutricional,clasificacion f,2004-08-01,5,5,5,5,10
31003,VILLA TUNARI,estado nutricional,clasificacion f,2004-08-01,13,3,13,3,16
51501,VILLAZON,estado nutricional,clasificacion f,2004-08-01,0,1,0,1,1
30904,VINTO,estado nutricional,clasificacion f,2004-08-01,10,3,10,3,13
50602,VITICHI,estado nutricional,clasificacion f,2004-08-01,5,2,5,2,7
70201,WARNES,estado nutricional,clasificacion f,2004-08-01,1,1,1,1,2
20903,YACO,estado nutricional,clasificacion f,2004-08-01,2,0,2,0,2
60301,YACUIBA,estado nutricional,clasificacion f,2004-08-01,2,3,2,3,5
10602,YAMPARAEZ,estado nutricional,clasificacion f,2004-08-01,19,2,19,2,21
70403,YAPACANI,estado nutricional,clasificacion f,2004-08-01,7,0,7,0,7
50103,YOCALLA,estado nutricional,clasificacion f,2004-08-01,1,0,1,0,1
10102,YOTALA,estado nutricional,clasificacion f,2004-08-01,0,2,0,2,2
60402,YUNCHARA,estado nutricional,clasificacion f,2004-08-01,1,0,1,0,1
10301,ZUDAÃ‘EZ,estado nutricional,clasificacion f,2004-08-01,5,2,5,2,7
51302,ACACIO,estado nutricional,clasificacion f,2004-09-01,4,1,4,1,5
20201,ACHACACHI,estado nutricional,clasificacion f,2004-09-01,2,0,2,0,2
20104,ACHOCALLA,estado nutricional,clasificacion f,2004-09-01,4,1,4,1,5
10404,ALCALA,estado nutricional,clasificacion f,2004-09-01,0,2,0,2,2
20202,ANCORAIMES,estado nutricional,clasificacion f,2004-09-01,1,1,1,1,2
41201,ANDAMARCA,estado nutricional,clasificacion f,2004-09-01,1,0,1,0,1
30402,ANZALDO,estado nutricional,clasificacion f,2004-09-01,1,2,1,2,3
20701,APOLO,estado nutricional,clasificacion f,2004-09-01,1,0,1,0,1
51301,ARAMPAMPA,estado nutricional,clasificacion f,2004-09-01,6,0,6,0,6
30501,ARANI,estado nutricional,clasificacion f,2004-09-01,0,2,0,2,2
30601,ARQUE,estado nutricional,clasificacion f,2004-09-01,1,0,1,0,1
50802,ATOCHA,estado nutricional,clasificacion f,2004-09-01,6,1,6,1,7
20503,AUCAPATA,estado nutricional,clasificacion f,2004-09-01,1,1,1,1,2
20502,AYATA,estado nutricional,clasificacion f,2004-09-01,2,2,2,2,4
30301,AYOPAYA (V. DE INDEPENDENCIA),estado nutricional,clasificacion f,2004-09-01,3,1,3,1,4
10201,AZURDUY,estado nutricional,clasificacion f,2004-09-01,7,3,7,3,10
50104,BELEN DE URMIRI,estado nutricional,clasificacion f,2004-09-01,0,1,0,1,1
50301,BETANZOS,estado nutricional,clasificacion f,2004-09-01,8,4,8,4,12
31501,BOLIVAR,estado nutricional,clasificacion f,2004-09-01,9,1,9,1,10
70401,BUENA VISTA,estado nutricional,clasificacion f,2004-09-01,1,0,1,0,1
70703,CABEZAS,estado nutricional,clasificacion f,2004-09-01,2,3,2,3,5
20905,CAIROMA,estado nutricional,clasificacion f,2004-09-01,5,3,5,3,8
51102,"CAIZA ""D""",estado nutricional,clasificacion f,2004-09-01,2,1,2,1,3
20303,CALACOTO,estado nutricional,clasificacion f,2004-09-01,0,1,0,1,1
21304,CALAMARCA,estado nutricional,clasificacion f,2004-09-01,1,0,1,0,1
10701,CAMARGO,estado nutricional,clasificacion f,2004-09-01,1,0,1,0,1
70706,CAMIRI,estado nutricional,clasificacion f,2004-09-01,1,0,1,0,1
30701,CAPINOTA,estado nutricional,clasificacion f,2004-09-01,7,9,7,9,16
40102,CARACOLLO,estado nutricional,clasificacion f,2004-09-01,1,0,1,0,1
22001,CARANAVI,estado nutricional,clasificacion f,2004-09-01,2,0,2,0,2
60302,CARAPARI,estado nutricional,clasificacion f,2004-09-01,1,0,1,0,1
50702,CARIPUYO,estado nutricional,clasificacion f,2004-09-01,10,5,10,5,15
40201,CHALLAPATA,estado nutricional,clasificacion f,2004-09-01,4,1,4,1,5
50302,CHAQUI,estado nutricional,clasificacion f,2004-09-01,0,2,0,2,2
70702,CHARAGUA,estado nutricional,clasificacion f,2004-09-01,10,3,10,3,13
50202,CHAYANTA,estado nutricional,clasificacion f,2004-09-01,10,1,10,1,11
31204,CHIMORE,estado nutricional,clasificacion f,2004-09-01,1,0,1,0,1
40903,CHIPAYA,estado nutricional,clasificacion f,2004-09-01,0,1,0,1,1
21101,CHULUMANI (V. DE LA LIBERTAD),estado nutricional,clasificacion f,2004-09-01,2,0,2,0,2
20501,CHUMA,estado nutricional,clasificacion f,2004-09-01,1,0,1,0,1
30801,CLIZA,estado nutricional,clasificacion f,2004-09-01,6,2,6,2,8
90101,COBIJA,estado nutricional,clasificacion f,2004-09-01,1,1,1,1,2
30101,COCHABAMBA,estado nutricional,clasificacion f,2004-09-01,16,8,16,8,24
30905,COLCAPIRHUA,estado nutricional,clasificacion f,2004-09-01,1,0,1,0,1
50901,"COLCHA ""K""",estado nutricional,clasificacion f,2004-09-01,1,0,1,0,1
31002,COLOMI,estado nutricional,clasificacion f,2004-09-01,2,1,2,1,3
50401,COLQUECHACA,estado nutricional,clasificacion f,2004-09-01,7,2,7,2,9
21306,COLQUENCHA,estado nutricional,clasificacion f,2004-09-01,2,3,2,3,5
21004,COLQUIRI,estado nutricional,clasificacion f,2004-09-01,1,0,1,0,1
71301,COMARAPA,estado nutricional,clasificacion f,2004-09-01,4,3,4,3,7
20605,COMBAYA,estado nutricional,clasificacion f,2004-09-01,1,0,1,0,1
21701,COPACABANA,estado nutricional,clasificacion f,2004-09-01,2,0,2,0,2
21402,CORIPATA,estado nutricional,clasificacion f,2004-09-01,1,0,1,0,1
20301,CORO CORO,estado nutricional,clasificacion f,2004-09-01,0,1,0,1,1
50601,COTAGAITA,estado nutricional,clasificacion f,2004-09-01,5,8,5,8,13
70102,COTOCA,estado nutricional,clasificacion f,2004-09-01,0,1,0,1,1
10902,CULPINA,estado nutricional,clasificacion f,2004-09-01,10,3,10,3,13
20804,DESAGUADERO,estado nutricional,clasificacion f,2004-09-01,1,0,1,0,1
20105,EL ALTO,estado nutricional,clasificacion f,2004-09-01,64,24,64,24,88
71503,EL PUENTE(STC),estado nutricional,clasificacion f,2004-09-01,3,0,3,0,3
60502,EL PUENTE(TJA),estado nutricional,clasificacion f,2004-09-01,0,1,0,1,1
70105,EL TORNO,estado nutricional,clasificacion f,2004-09-01,0,2,0,2,2
10405,EL VILLAR,estado nutricional,clasificacion f,2004-09-01,2,1,2,1,3
60601,ENTRE RIOS,estado nutricional,clasificacion f,2004-09-01,2,0,2,0,2
71002,GENERAL SAAVEDRA,estado nutricional,clasificacion f,2004-09-01,1,0,1,0,1
21601,GRAL. J.J. PEREZ (CHARAZANI),estado nutricional,clasificacion f,2004-09-01,1,4,1,4,5
20602,GUANAY,estado nutricional,clasificacion f,2004-09-01,4,3,4,3,7
80202,GUAYARAMERIN,estado nutricional,clasificacion f,2004-09-01,6,1,6,1,7
70705,GUTIERREZ,estado nutricional,clasificacion f,2004-09-01,6,3,6,3,9
10502,HUACARETA,estado nutricional,clasificacion f,2004-09-01,2,0,2,0,2
40701,HUANUNI,estado nutricional,clasificacion f,2004-09-01,0,1,0,1,1
21005,ICHOCA,estado nutricional,clasificacion f,2004-09-01,0,1,0,1,1
10304,ICLA,estado nutricional,clasificacion f,2004-09-01,15,6,15,6,21
10703,INCAHUASI,estado nutricional,clasificacion f,2004-09-01,17,10,17,10,27
21001,INQUISIVI,estado nutricional,clasificacion f,2004-09-01,1,0,1,0,1
21102,IRUPANA (VILLA DE LANZA),estado nutricional,clasificacion f,2004-09-01,2,0,2,0,2
21501,IXIAMAS,estado nutricional,clasificacion f,2004-09-01,3,3,3,3,6
21105,LA ASUNTA,estado nutricional,clasificacion f,2004-09-01,2,1,2,1,3
70104,LA GUARDIA,estado nutricional,clasificacion f,2004-09-01,3,1,3,1,4
20101,LA PAZ,estado nutricional,clasificacion f,2004-09-01,30,16,30,16,46
70701,LAGUNILLAS,estado nutricional,clasificacion f,2004-09-01,1,1,1,1,2
50203,LLALLAGUA,estado nutricional,clasificacion f,2004-09-01,5,14,5,14,19
80601,LORETO,estado nutricional,clasificacion f,2004-09-01,2,0,2,0,2
20901,LURIBAY,estado nutricional,clasificacion f,2004-09-01,5,0,5,0,5
11003,MACHARETI,estado nutricional,clasificacion f,2004-09-01,1,0,1,0,1
80801,MAGDALENA,estado nutricional,clasificacion f,2004-09-01,2,0,2,0,2
70903,MAIRANA,estado nutricional,clasificacion f,2004-09-01,2,0,2,0,2
20904,MALLA,estado nutricional,clasificacion f,2004-09-01,3,2,3,2,5
71003,MINEROS,estado nutricional,clasificacion f,2004-09-01,15,2,15,2,17
20402,MOCOMOCO,estado nutricional,clasificacion f,2004-09-01,1,2,1,2,3
10303,MOJOCOYA,estado nutricional,clasificacion f,2004-09-01,3,0,3,0,3
10501,MONTEAGUDO,estado nutricional,clasificacion f,2004-09-01,5,3,5,3,8
71001,MONTERO,estado nutricional,clasificacion f,2004-09-01,4,4,4,4,8
70803,MORO MORO,estado nutricional,clasificacion f,2004-09-01,1,1,1,1,2
30302,MOROCHATA,estado nutricional,clasificacion f,2004-09-01,7,3,7,3,10
50404,OCURI,estado nutricional,clasificacion f,2004-09-01,17,10,17,10,27
40101,ORURO,estado nutricional,clasificacion f,2004-09-01,13,5,13,5,18
60201,PADCAYA,estado nutricional,clasificacion f,2004-09-01,1,1,1,1,2
10401,PADILLA,estado nutricional,clasificacion f,2004-09-01,5,6,5,6,11
20102,PALCA,estado nutricional,clasificacion f,2004-09-01,1,0,1,0,1
21104,PALOS BLANCOS,estado nutricional,clasificacion f,2004-09-01,7,2,7,2,9
70902,PAMPA GRANDE,estado nutricional,clasificacion f,2004-09-01,0,1,0,1,1
21305,PATACAMAYA,estado nutricional,clasificacion f,2004-09-01,4,0,4,0,4
50403,POCOATA,estado nutricional,clasificacion f,2004-09-01,12,5,12,5,17
31203,POCONA,estado nutricional,clasificacion f,2004-09-01,1,0,1,0,1
31202,POJO (CBBA),estado nutricional,clasificacion f,2004-09-01,5,3,5,3,8
51203,PORCO,estado nutricional,clasificacion f,2004-09-01,1,1,1,1,2
10103,POROMA,estado nutricional,clasificacion f,2004-09-01,12,3,12,3,15
70601,PORTACHUELO,estado nutricional,clasificacion f,2004-09-01,3,2,3,2,5
50101,POTOSI,estado nutricional,clasificacion f,2004-09-01,30,27,30,27,57
10302,PRESTO,estado nutricional,clasificacion f,2004-09-01,8,4,8,4,12
21201,PUCARANI,estado nutricional,clasificacion f,2004-09-01,0,1,0,1,1
20401,PUERTO ACOSTA,estado nutricional,clasificacion f,2004-09-01,1,0,1,0,1
20403,PUERTO CARABUCO,estado nutricional,clasificacion f,2004-09-01,1,0,1,0,1
90301,PUERTO GONZALO MORENO,estado nutricional,clasificacion f,2004-09-01,1,0,1,0,1
31205,PUERTO VILLARROEL,estado nutricional,clasificacion f,2004-09-01,12,23,12,23,35
51101,PUNA,estado nutricional,clasificacion f,2004-09-01,11,3,11,3,14
31401,PUNATA,estado nutricional,clasificacion f,2004-09-01,0,1,0,1,1
30901,QUILLACOLLO,estado nutricional,clasificacion f,2004-09-01,12,2,12,2,14
21002,QUIME,estado nutricional,clasificacion f,2004-09-01,2,1,2,1,3
50402,RAVELO,estado nutricional,clasificacion f,2004-09-01,17,12,17,12,29
80301,REYES,estado nutricional,clasificacion f,2004-09-01,1,0,1,0,1
80201,RIBERALTA,estado nutricional,clasificacion f,2004-09-01,36,25,36,25,61
70503,ROBORE,estado nutricional,clasificacion f,2004-09-01,4,0,4,0,4
80304,RURRENABAQUE,estado nutricional,clasificacion f,2004-09-01,5,0,5,0,5
31001,SACABA,estado nutricional,clasificacion f,2004-09-01,9,1,9,1,10
50701,SACACA,estado nutricional,clasificacion f,2004-09-01,10,8,10,8,18
80602,SAN ANDRES,estado nutricional,clasificacion f,2004-09-01,1,0,1,0,1
71105,SAN ANTONIO DE LOMERIO,estado nutricional,clasificacion f,2004-09-01,2,3,2,3,5
31403,SAN BENITO,estado nutricional,clasificacion f,2004-09-01,0,4,0,4,4
80302,SAN BORJA,estado nutricional,clasificacion f,2004-09-01,10,8,10,8,18
21502,SAN BUENA VENTURA,estado nutricional,clasificacion f,2004-09-01,2,3,2,3,5
70402,SAN CARLOS,estado nutricional,clasificacion f,2004-09-01,1,0,1,0,1
80501,SAN IGNACIO,estado nutricional,clasificacion f,2004-09-01,3,1,3,1,4
70301,SAN IGNACIO DE VELASCO,estado nutricional,clasificacion f,2004-09-01,12,11,12,11,23
80102,SAN JAVIER(BNI),estado nutricional,clasificacion f,2004-09-01,0,1,0,1,1
80701,SAN JOAQUIN,estado nutricional,clasificacion f,2004-09-01,0,1,0,1,1
70501,SAN JOSE DE CHIQUITOS,estado nutricional,clasificacion f,2004-09-01,1,0,1,0,1
71104,SAN JULIAN,estado nutricional,clasificacion f,2004-09-01,2,0,2,0,2
60501,SAN LORENZO(TJA),estado nutricional,clasificacion f,2004-09-01,1,1,1,1,2
10702,SAN LUCAS,estado nutricional,clasificacion f,2004-09-01,33,13,33,13,46
70302,SAN MIGUEL DE VELASCO,estado nutricional,clasificacion f,2004-09-01,2,3,2,3,5
51001,SAN PABLO DE LIPEZ,estado nutricional,clasificacion f,2004-09-01,1,0,1,0,1
50501,SAN PEDRO DE BUENA VISTA,estado nutricional,clasificacion f,2004-09-01,19,14,19,14,33
50902,SAN PEDRO DE QUEMES,estado nutricional,clasificacion f,2004-09-01,1,0,1,0,1
70303,SAN RAFAEL,estado nutricional,clasificacion f,2004-09-01,2,1,2,1,3
70101,SANTA CRUZ DE LA SIERRA,estado nutricional,clasificacion f,2004-09-01,22,7,22,7,29
80303,SANTA ROSA,estado nutricional,clasificacion f,2004-09-01,4,1,4,1,5
70602,SANTA ROSA DEL SARA,estado nutricional,clasificacion f,2004-09-01,2,2,2,2,4
20308,SANTIAGO DE CALLAPA,estado nutricional,clasificacion f,2004-09-01,2,0,2,0,2
90303,SENA,estado nutricional,clasificacion f,2004-09-01,1,0,1,0,1
21301,SICA SICA (VILLA AROMA),estado nutricional,clasificacion f,2004-09-01,4,2,4,2,6
30703,SICAYA,estado nutricional,clasificacion f,2004-09-01,4,2,4,2,6
30902,SIPE SIPE,estado nutricional,clasificacion f,2004-09-01,21,8,21,8,29
10403,SOPACHUY,estado nutricional,clasificacion f,2004-09-01,4,9,4,9,13
20601,SORATA,estado nutricional,clasificacion f,2004-09-01,0,1,0,1,1
10101,SUCRE,estado nutricional,clasificacion f,2004-09-01,23,4,23,4,27
50303,TACOBAMBA,estado nutricional,clasificacion f,2004-09-01,3,2,3,2,5
30602,TACOPAYA,estado nutricional,clasificacion f,2004-09-01,3,0,3,0,3
31101,TAPACARI,estado nutricional,clasificacion f,2004-09-01,12,2,12,2,14
10601,TARABUCO,estado nutricional,clasificacion f,2004-09-01,25,16,25,16,41
60101,TARIJA,estado nutricional,clasificacion f,2004-09-01,15,6,15,6,21
10202,TARVITA,estado nutricional,clasificacion f,2004-09-01,4,1,4,1,5
20803,TIAWANACU,estado nutricional,clasificacion f,2004-09-01,3,0,3,0,3
50102,TINGUIPAYA,estado nutricional,clasificacion f,2004-09-01,10,2,10,2,12
31601,TIRAQUE (CBBA),estado nutricional,clasificacion f,2004-09-01,16,11,16,11,27
30802,TOCO,estado nutricional,clasificacion f,2004-09-01,1,1,1,1,2
51202,TOMAVE,estado nutricional,clasificacion f,2004-09-01,4,0,4,0,4
10402,TOMINA,estado nutricional,clasificacion f,2004-09-01,7,7,7,7,14
50502,TORO TORO,estado nutricional,clasificacion f,2004-09-01,15,4,15,4,19
31201,TOTORA(CBBA),estado nutricional,clasificacion f,2004-09-01,4,2,4,2,6
41301,TOTORA(ORR),estado nutricional,clasificacion f,2004-09-01,0,1,0,1,1
80101,TRINIDAD,estado nutricional,clasificacion f,2004-09-01,6,2,6,2,8
50801,TUPIZA,estado nutricional,clasificacion f,2004-09-01,6,0,6,0,6
50201,UNCIA,estado nutricional,clasificacion f,2004-09-01,5,1,5,1,6
51201,UYUNI,estado nutricional,clasificacion f,2004-09-01,1,0,1,0,1
30502,VACAS,estado nutricional,clasificacion f,2004-09-01,3,1,3,1,4
70801,VALLEGRANDE,estado nutricional,clasificacion f,2004-09-01,5,7,5,7,12
20801,VIACHA,estado nutricional,clasificacion f,2004-09-01,5,1,5,1,6
31302,VILA VILA,estado nutricional,clasificacion f,2004-09-01,2,1,2,1,3
60303,VILLA MONTES,estado nutricional,clasificacion f,2004-09-01,2,1,2,1,3
31402,VILLA RIVERO,estado nutricional,clasificacion f,2004-09-01,0,2,0,2,2
10801,VILLA SERRANO,estado nutricional,clasificacion f,2004-09-01,4,3,4,3,7
31003,VILLA TUNARI,estado nutricional,clasificacion f,2004-09-01,27,11,27,11,38
11001,VILLA VACA GUZMAN (MUYUPAMPA),estado nutricional,clasificacion f,2004-09-01,0,2,0,2,2
51501,VILLAZON,estado nutricional,clasificacion f,2004-09-01,0,2,0,2,2
50602,VITICHI,estado nutricional,clasificacion f,2004-09-01,5,1,5,1,6
20903,YACO,estado nutricional,clasificacion f,2004-09-01,5,0,5,0,5
60301,YACUIBA,estado nutricional,clasificacion f,2004-09-01,2,1,2,1,3
10602,YAMPARAEZ,estado nutricional,clasificacion f,2004-09-01,13,8,13,8,21
70403,YAPACANI,estado nutricional,clasificacion f,2004-09-01,8,3,8,3,11
50103,YOCALLA,estado nutricional,clasificacion f,2004-09-01,1,0,1,0,1
10102,YOTALA,estado nutricional,clasificacion f,2004-09-01,4,2,4,2,6
60402,YUNCHARA,estado nutricional,clasificacion f,2004-09-01,1,1,1,1,2
10301,ZUDAÃ‘EZ,estado nutricional,clasificacion f,2004-09-01,2,5,2,5,7
51302,ACACIO,estado nutricional,clasificacion f,2004-10-01,10,1,10,1,11
20201,ACHACACHI,estado nutricional,clasificacion f,2004-10-01,3,0,3,0,3
20104,ACHOCALLA,estado nutricional,clasificacion f,2004-10-01,2,0,2,0,2
30201,AIQUILE,estado nutricional,clasificacion f,2004-10-01,1,0,1,0,1
10404,ALCALA,estado nutricional,clasificacion f,2004-10-01,1,2,1,2,3
20202,ANCORAIMES,estado nutricional,clasificacion f,2004-10-01,1,0,1,0,1
20701,APOLO,estado nutricional,clasificacion f,2004-10-01,2,0,2,0,2
51301,ARAMPAMPA,estado nutricional,clasificacion f,2004-10-01,3,1,3,1,4
30403,ARBIETO,estado nutricional,clasificacion f,2004-10-01,1,0,1,0,1
30601,ARQUE,estado nutricional,clasificacion f,2004-10-01,2,1,2,1,3
71501,ASCENCION DE GUARAYOS,estado nutricional,clasificacion f,2004-10-01,5,7,5,7,12
50802,ATOCHA,estado nutricional,clasificacion f,2004-10-01,4,1,4,1,5
20503,AUCAPATA,estado nutricional,clasificacion f,2004-10-01,1,0,1,0,1
20502,AYATA,estado nutricional,clasificacion f,2004-10-01,3,1,3,1,4
30301,AYOPAYA (V. DE INDEPENDENCIA),estado nutricional,clasificacion f,2004-10-01,1,1,1,1,2
10201,AZURDUY,estado nutricional,clasificacion f,2004-10-01,4,0,4,0,4
21203,BATALLAS,estado nutricional,clasificacion f,2004-10-01,2,0,2,0,2
50301,BETANZOS,estado nutricional,clasificacion f,2004-10-01,7,5,7,5,12
31501,BOLIVAR,estado nutricional,clasificacion f,2004-10-01,7,2,7,2,9
70401,BUENA VISTA,estado nutricional,clasificacion f,2004-10-01,1,0,1,0,1
70703,CABEZAS,estado nutricional,clasificacion f,2004-10-01,2,0,2,0,2
20905,CAIROMA,estado nutricional,clasificacion f,2004-10-01,5,2,5,2,7
51102,"CAIZA ""D""",estado nutricional,clasificacion f,2004-10-01,2,1,2,1,3
21003,CAJUATA,estado nutricional,clasificacion f,2004-10-01,2,2,2,2,4
21304,CALAMARCA,estado nutricional,clasificacion f,2004-10-01,4,2,4,2,6
70706,CAMIRI,estado nutricional,clasificacion f,2004-10-01,6,5,6,5,11
30701,CAPINOTA,estado nutricional,clasificacion f,2004-10-01,3,5,3,5,8
20302,CAQUIAVIRI,estado nutricional,clasificacion f,2004-10-01,2,0,2,0,2
40102,CARACOLLO,estado nutricional,clasificacion f,2004-10-01,1,3,1,3,4
22001,CARANAVI,estado nutricional,clasificacion f,2004-10-01,6,0,6,0,6
60302,CARAPARI,estado nutricional,clasificacion f,2004-10-01,1,1,1,1,2
50702,CARIPUYO,estado nutricional,clasificacion f,2004-10-01,21,3,21,3,24
40201,CHALLAPATA,estado nutricional,clasificacion f,2004-10-01,4,4,4,4,8
50302,CHAQUI,estado nutricional,clasificacion f,2004-10-01,1,3,1,3,4
70702,CHARAGUA,estado nutricional,clasificacion f,2004-10-01,7,1,7,1,8
50202,CHAYANTA,estado nutricional,clasificacion f,2004-10-01,2,2,2,2,4
21101,CHULUMANI (V. DE LA LIBERTAD),estado nutricional,clasificacion f,2004-10-01,1,0,1,0,1
20501,CHUMA,estado nutricional,clasificacion f,2004-10-01,1,1,1,1,2
30801,CLIZA,estado nutricional,clasificacion f,2004-10-01,1,1,1,1,2
90101,COBIJA,estado nutricional,clasificacion f,2004-10-01,6,0,6,0,6
30101,COCHABAMBA,estado nutricional,clasificacion f,2004-10-01,15,6,15,6,21
30905,COLCAPIRHUA,estado nutricional,clasificacion f,2004-10-01,0,1,0,1,1
31002,COLOMI,estado nutricional,clasificacion f,2004-10-01,0,2,0,2,2
50401,COLQUECHACA,estado nutricional,clasificacion f,2004-10-01,11,3,11,3,14
21004,COLQUIRI,estado nutricional,clasificacion f,2004-10-01,0,1,0,1,1
71301,COMARAPA,estado nutricional,clasificacion f,2004-10-01,3,2,3,2,5
21701,COPACABANA,estado nutricional,clasificacion f,2004-10-01,2,0,2,0,2
21402,CORIPATA,estado nutricional,clasificacion f,2004-10-01,0,1,0,1,1
21401,COROICO,estado nutricional,clasificacion f,2004-10-01,0,1,0,1,1
50601,COTAGAITA,estado nutricional,clasificacion f,2004-10-01,5,0,5,0,5
70102,COTOCA,estado nutricional,clasificacion f,2004-10-01,1,1,1,1,2
70704,CUEVO,estado nutricional,clasificacion f,2004-10-01,1,0,1,0,1
10902,CULPINA,estado nutricional,clasificacion f,2004-10-01,11,4,11,4,15
20105,EL ALTO,estado nutricional,clasificacion f,2004-10-01,64,29,64,29,93
40103,EL CHORO,estado nutricional,clasificacion f,2004-10-01,0,1,0,1,1
71503,EL PUENTE(STC),estado nutricional,clasificacion f,2004-10-01,1,5,1,5,6
70105,EL TORNO,estado nutricional,clasificacion f,2004-10-01,1,0,1,0,1
10405,EL VILLAR,estado nutricional,clasificacion f,2004-10-01,1,3,1,3,4
60601,ENTRE RIOS,estado nutricional,clasificacion f,2004-10-01,3,2,3,2,5
80402,EXALTACION,estado nutricional,clasificacion f,2004-10-01,1,1,1,1,2
71002,GENERAL SAAVEDRA,estado nutricional,clasificacion f,2004-10-01,0,1,0,1,1
21601,GRAL. J.J. PEREZ (CHARAZANI),estado nutricional,clasificacion f,2004-10-01,1,1,1,1,2
20602,GUANAY,estado nutricional,clasificacion f,2004-10-01,2,6,2,6,8
20802,GUAQUI,estado nutricional,clasificacion f,2004-10-01,1,0,1,0,1
80202,GUAYARAMERIN,estado nutricional,clasificacion f,2004-10-01,1,2,1,2,3
70705,GUTIERREZ,estado nutricional,clasificacion f,2004-10-01,5,5,5,5,10
10502,HUACARETA,estado nutricional,clasificacion f,2004-10-01,1,2,1,2,3
11002,HUACAYA (VILLA DE HUACAYA),estado nutricional,clasificacion f,2004-10-01,1,1,1,1,2
40501,HUACHACALLA,estado nutricional,clasificacion f,2004-10-01,1,0,1,0,1
10304,ICLA,estado nutricional,clasificacion f,2004-10-01,13,2,13,2,15
10703,INCAHUASI,estado nutricional,clasificacion f,2004-10-01,19,9,19,9,28
21001,INQUISIVI,estado nutricional,clasificacion f,2004-10-01,2,0,2,0,2
21102,IRUPANA (VILLA DE LANZA),estado nutricional,clasificacion f,2004-10-01,3,3,3,3,6
21501,IXIAMAS,estado nutricional,clasificacion f,2004-10-01,3,0,3,0,3
21105,LA ASUNTA,estado nutricional,clasificacion f,2004-10-01,1,2,1,2,3
70104,LA GUARDIA,estado nutricional,clasificacion f,2004-10-01,6,4,6,4,10
20101,LA PAZ,estado nutricional,clasificacion f,2004-10-01,25,13,25,13,38
70701,LAGUNILLAS,estado nutricional,clasificacion f,2004-10-01,1,2,1,2,3
21202,LAJA,estado nutricional,clasificacion f,2004-10-01,2,0,2,0,2
50203,LLALLAGUA,estado nutricional,clasificacion f,2004-10-01,20,7,20,7,27
20901,LURIBAY,estado nutricional,clasificacion f,2004-10-01,6,0,6,0,6
11003,MACHARETI,estado nutricional,clasificacion f,2004-10-01,1,1,1,1,2
80801,MAGDALENA,estado nutricional,clasificacion f,2004-10-01,2,0,2,0,2
71003,MINEROS,estado nutricional,clasificacion f,2004-10-01,10,1,10,1,11
31301,MIZQUE,estado nutricional,clasificacion f,2004-10-01,3,2,3,2,5
20402,MOCOMOCO,estado nutricional,clasificacion f,2004-10-01,3,1,3,1,4
10303,MOJOCOYA,estado nutricional,clasificacion f,2004-10-01,3,0,3,0,3
10501,MONTEAGUDO,estado nutricional,clasificacion f,2004-10-01,4,5,4,5,9
71001,MONTERO,estado nutricional,clasificacion f,2004-10-01,14,6,14,6,20
30302,MOROCHATA,estado nutricional,clasificacion f,2004-10-01,2,1,2,1,3
50404,OCURI,estado nutricional,clasificacion f,2004-10-01,17,7,17,7,24
40101,ORURO,estado nutricional,clasificacion f,2004-10-01,13,9,13,9,22
10401,PADILLA,estado nutricional,clasificacion f,2004-10-01,4,4,4,4,8
21104,PALOS BLANCOS,estado nutricional,clasificacion f,2004-10-01,3,2,3,2,5
21305,PATACAMAYA,estado nutricional,clasificacion f,2004-10-01,6,2,6,2,8
20702,PELECHUCO,estado nutricional,clasificacion f,2004-10-01,1,0,1,0,1
50403,POCOATA,estado nutricional,clasificacion f,2004-10-01,15,7,15,7,22
31203,POCONA,estado nutricional,clasificacion f,2004-10-01,1,1,1,1,2
31202,POJO (CBBA),estado nutricional,clasificacion f,2004-10-01,3,4,3,4,7
10103,POROMA,estado nutricional,clasificacion f,2004-10-01,7,6,7,6,13
70103,PORONGO,estado nutricional,clasificacion f,2004-10-01,1,0,1,0,1
70601,PORTACHUELO,estado nutricional,clasificacion f,2004-10-01,2,2,2,2,4
70804,POSTRER VALLE,estado nutricional,clasificacion f,2004-10-01,0,1,0,1,1
50101,POTOSI,estado nutricional,clasificacion f,2004-10-01,21,9,21,9,30
10302,PRESTO,estado nutricional,clasificacion f,2004-10-01,1,1,1,1,2
21201,PUCARANI,estado nutricional,clasificacion f,2004-10-01,2,0,2,0,2
20401,PUERTO ACOSTA,estado nutricional,clasificacion f,2004-10-01,2,0,2,0,2
90201,PUERTO RICO,estado nutricional,clasificacion f,2004-10-01,1,0,1,0,1
31205,PUERTO VILLARROEL,estado nutricional,clasificacion f,2004-10-01,19,9,19,9,28
51101,PUNA,estado nutricional,clasificacion f,2004-10-01,4,0,4,0,4
31401,PUNATA,estado nutricional,clasificacion f,2004-10-01,1,0,1,0,1
20604,QUIABAYA,estado nutricional,clasificacion f,2004-10-01,4,7,4,7,11
30901,QUILLACOLLO,estado nutricional,clasificacion f,2004-10-01,6,1,6,1,7
21002,QUIME,estado nutricional,clasificacion f,2004-10-01,3,1,3,1,4
50402,RAVELO,estado nutricional,clasificacion f,2004-10-01,15,4,15,4,19
80301,REYES,estado nutricional,clasificacion f,2004-10-01,3,0,3,0,3
80201,RIBERALTA,estado nutricional,clasificacion f,2004-10-01,39,27,39,27,66
70503,ROBORE,estado nutricional,clasificacion f,2004-10-01,1,2,1,2,3
80304,RURRENABAQUE,estado nutricional,clasificacion f,2004-10-01,3,0,3,0,3
31001,SACABA,estado nutricional,clasificacion f,2004-10-01,3,4,3,4,7
50701,SACACA,estado nutricional,clasificacion f,2004-10-01,20,9,20,9,29
71302,SAIPINA,estado nutricional,clasificacion f,2004-10-01,2,0,2,0,2
40801,SALINAS DE GARCI MENDOZA,estado nutricional,clasificacion f,2004-10-01,2,0,2,0,2
71105,SAN ANTONIO DE LOMERIO,estado nutricional,clasificacion f,2004-10-01,3,1,3,1,4
31403,SAN BENITO,estado nutricional,clasificacion f,2004-10-01,4,1,4,1,5
80302,SAN BORJA,estado nutricional,clasificacion f,2004-10-01,7,4,7,4,11
21502,SAN BUENA VENTURA,estado nutricional,clasificacion f,2004-10-01,1,2,1,2,3
80501,SAN IGNACIO,estado nutricional,clasificacion f,2004-10-01,3,2,3,2,5
70301,SAN IGNACIO DE VELASCO,estado nutricional,clasificacion f,2004-10-01,8,5,8,5,13
71102,SAN JAVIER(STC),estado nutricional,clasificacion f,2004-10-01,1,0,1,0,1
70501,SAN JOSE DE CHIQUITOS,estado nutricional,clasificacion f,2004-10-01,3,2,3,2,5
71104,SAN JULIAN,estado nutricional,clasificacion f,2004-10-01,1,2,1,2,3
90302,SAN LORENZO(PND),estado nutricional,clasificacion f,2004-10-01,1,0,1,0,1
60501,SAN LORENZO(TJA),estado nutricional,clasificacion f,2004-10-01,3,2,3,2,5
10702,SAN LUCAS,estado nutricional,clasificacion f,2004-10-01,39,6,39,6,45
70302,SAN MIGUEL DE VELASCO,estado nutricional,clasificacion f,2004-10-01,6,0,6,0,6
50501,SAN PEDRO DE BUENA VISTA,estado nutricional,clasificacion f,2004-10-01,19,14,19,14,33
70303,SAN RAFAEL,estado nutricional,clasificacion f,2004-10-01,10,4,10,4,14
70101,SANTA CRUZ DE LA SIERRA,estado nutricional,clasificacion f,2004-10-01,27,9,27,9,36
80303,SANTA ROSA,estado nutricional,clasificacion f,2004-10-01,2,1,2,1,3
70602,SANTA ROSA DEL SARA,estado nutricional,clasificacion f,2004-10-01,1,1,1,1,2
20308,SANTIAGO DE CALLAPA,estado nutricional,clasificacion f,2004-10-01,3,0,3,0,3
21901,SANTIAGO DE MACHACA,estado nutricional,clasificacion f,2004-10-01,0,1,0,1,1
20902,SAPAHAQUI,estado nutricional,clasificacion f,2004-10-01,3,2,3,2,5
90303,SENA,estado nutricional,clasificacion f,2004-10-01,0,1,0,1,1
21301,SICA SICA (VILLA AROMA),estado nutricional,clasificacion f,2004-10-01,0,1,0,1,1
30703,SICAYA,estado nutricional,clasificacion f,2004-10-01,1,0,1,0,1
30902,SIPE SIPE,estado nutricional,clasificacion f,2004-10-01,9,8,9,8,17
10403,SOPACHUY,estado nutricional,clasificacion f,2004-10-01,3,4,3,4,7
20601,SORATA,estado nutricional,clasificacion f,2004-10-01,2,0,2,0,2
10101,SUCRE,estado nutricional,clasificacion f,2004-10-01,13,8,13,8,21
30602,TACOPAYA,estado nutricional,clasificacion f,2004-10-01,1,0,1,0,1
31101,TAPACARI,estado nutricional,clasificacion f,2004-10-01,6,1,6,1,7
10601,TARABUCO,estado nutricional,clasificacion f,2004-10-01,19,19,19,19,38
30401,TARATA,estado nutricional,clasificacion f,2004-10-01,3,1,3,1,4
60101,TARIJA,estado nutricional,clasificacion f,2004-10-01,3,4,3,4,7
10202,TARVITA,estado nutricional,clasificacion f,2004-10-01,2,0,2,0,2
50102,TINGUIPAYA,estado nutricional,clasificacion f,2004-10-01,4,7,4,7,11
30903,TIQUIPAYA,estado nutricional,clasificacion f,2004-10-01,2,0,2,0,2
31601,TIRAQUE (CBBA),estado nutricional,clasificacion f,2004-10-01,9,3,9,3,12
41001,TOLEDO,estado nutricional,clasificacion f,2004-10-01,0,1,0,1,1
51202,TOMAVE,estado nutricional,clasificacion f,2004-10-01,1,0,1,0,1
10402,TOMINA,estado nutricional,clasificacion f,2004-10-01,8,7,8,7,15
50502,TORO TORO,estado nutricional,clasificacion f,2004-10-01,11,4,11,4,15
31201,TOTORA(CBBA),estado nutricional,clasificacion f,2004-10-01,5,3,5,3,8
80101,TRINIDAD,estado nutricional,clasificacion f,2004-10-01,5,1,5,1,6
50801,TUPIZA,estado nutricional,clasificacion f,2004-10-01,2,1,2,1,3
50201,UNCIA,estado nutricional,clasificacion f,2004-10-01,5,1,5,1,6
60401,URIONDO (A. CONCEPCION),estado nutricional,clasificacion f,2004-10-01,1,1,1,1,2
71502,URUBICHA,estado nutricional,clasificacion f,2004-10-01,3,4,3,4,7
30502,VACAS,estado nutricional,clasificacion f,2004-10-01,1,0,1,0,1
70801,VALLEGRANDE,estado nutricional,clasificacion f,2004-10-01,2,2,2,2,4
20801,VIACHA,estado nutricional,clasificacion f,2004-10-01,6,2,6,2,8
31302,VILA VILA,estado nutricional,clasificacion f,2004-10-01,1,0,1,0,1
60303,VILLA MONTES,estado nutricional,clasificacion f,2004-10-01,5,0,5,0,5
31402,VILLA RIVERO,estado nutricional,clasificacion f,2004-10-01,2,1,2,1,3
10801,VILLA SERRANO,estado nutricional,clasificacion f,2004-10-01,4,2,4,2,6
31003,VILLA TUNARI,estado nutricional,clasificacion f,2004-10-01,15,19,15,19,34
11001,VILLA VACA GUZMAN (MUYUPAMPA),estado nutricional,clasificacion f,2004-10-01,1,2,1,2,3
51501,VILLAZON,estado nutricional,clasificacion f,2004-10-01,5,1,5,1,6
50602,VITICHI,estado nutricional,clasificacion f,2004-10-01,2,2,2,2,4
70201,WARNES,estado nutricional,clasificacion f,2004-10-01,1,0,1,0,1
20903,YACO,estado nutricional,clasificacion f,2004-10-01,2,0,2,0,2
60301,YACUIBA,estado nutricional,clasificacion f,2004-10-01,2,1,2,1,3
10602,YAMPARAEZ,estado nutricional,clasificacion f,2004-10-01,15,4,15,4,19
21103,YANACACHI,estado nutricional,clasificacion f,2004-10-01,1,0,1,0,1
70403,YAPACANI,estado nutricional,clasificacion f,2004-10-01,11,1,11,1,12
10102,YOTALA,estado nutricional,clasificacion f,2004-10-01,1,1,1,1,2
10301,ZUDAÃ‘EZ,estado nutricional,clasificacion f,2004-10-01,2,4,2,4,6
51302,ACACIO,estado nutricional,clasificacion f,2004-11-01,6,3,6,3,9
20201,ACHACACHI,estado nutricional,clasificacion f,2004-11-01,3,1,3,1,4
30201,AIQUILE,estado nutricional,clasificacion f,2004-11-01,6,2,6,2,8
20202,ANCORAIMES,estado nutricional,clasificacion f,2004-11-01,2,6,2,6,8
30402,ANZALDO,estado nutricional,clasificacion f,2004-11-01,1,2,1,2,3
20701,APOLO,estado nutricional,clasificacion f,2004-11-01,3,0,3,0,3
51301,ARAMPAMPA,estado nutricional,clasificacion f,2004-11-01,6,5,6,5,11
30501,ARANI,estado nutricional,clasificacion f,2004-11-01,1,2,1,2,3
30403,ARBIETO,estado nutricional,clasificacion f,2004-11-01,0,1,0,1,1
30601,ARQUE,estado nutricional,clasificacion f,2004-11-01,2,0,2,0,2
71501,ASCENCION DE GUARAYOS,estado nutricional,clasificacion f,2004-11-01,2,0,2,0,2
50802,ATOCHA,estado nutricional,clasificacion f,2004-11-01,3,0,3,0,3
20502,AYATA,estado nutricional,clasificacion f,2004-11-01,6,1,6,1,7
21303,AYO AYO,estado nutricional,clasificacion f,2004-11-01,2,1,2,1,3
30301,AYOPAYA (V. DE INDEPENDENCIA),estado nutricional,clasificacion f,2004-11-01,5,1,5,1,6
10201,AZURDUY,estado nutricional,clasificacion f,2004-11-01,12,12,12,12,24
21203,BATALLAS,estado nutricional,clasificacion f,2004-11-01,0,1,0,1,1
90104,BELLA FLOR,estado nutricional,clasificacion f,2004-11-01,0,1,0,1,1
60202,BERMEJO,estado nutricional,clasificacion f,2004-11-01,2,0,2,0,2
50301,BETANZOS,estado nutricional,clasificacion f,2004-11-01,13,6,13,6,19
31501,BOLIVAR,estado nutricional,clasificacion f,2004-11-01,4,2,4,2,6
70401,BUENA VISTA,estado nutricional,clasificacion f,2004-11-01,1,0,1,0,1
70703,CABEZAS,estado nutricional,clasificacion f,2004-11-01,4,1,4,1,5
20905,CAIROMA,estado nutricional,clasificacion f,2004-11-01,4,2,4,2,6
51102,"CAIZA ""D""",estado nutricional,clasificacion f,2004-11-01,1,2,1,2,3
21304,CALAMARCA,estado nutricional,clasificacion f,2004-11-01,1,7,1,7,8
10901,CAMATAQUI (C. VILLA ABECIA),estado nutricional,clasificacion f,2004-11-01,1,0,1,0,1
70706,CAMIRI,estado nutricional,clasificacion f,2004-11-01,1,1,1,1,2
30701,CAPINOTA,estado nutricional,clasificacion f,2004-11-01,2,4,2,4,6
40102,CARACOLLO,estado nutricional,clasificacion f,2004-11-01,3,1,3,1,4
22001,CARANAVI,estado nutricional,clasificacion f,2004-11-01,3,1,3,1,4
50702,CARIPUYO,estado nutricional,clasificacion f,2004-11-01,12,6,12,6,18
40201,CHALLAPATA,estado nutricional,clasificacion f,2004-11-01,4,0,4,0,4
50302,CHAQUI,estado nutricional,clasificacion f,2004-11-01,1,0,1,0,1
70702,CHARAGUA,estado nutricional,clasificacion f,2004-11-01,5,4,5,4,9
50202,CHAYANTA,estado nutricional,clasificacion f,2004-11-01,3,3,3,3,6
20501,CHUMA,estado nutricional,clasificacion f,2004-11-01,1,0,1,0,1
30801,CLIZA,estado nutricional,clasificacion f,2004-11-01,5,0,5,0,5
90101,COBIJA,estado nutricional,clasificacion f,2004-11-01,1,1,1,1,2
30101,COCHABAMBA,estado nutricional,clasificacion f,2004-11-01,10,3,10,3,13
30905,COLCAPIRHUA,estado nutricional,clasificacion f,2004-11-01,1,0,1,0,1
31002,COLOMI,estado nutricional,clasificacion f,2004-11-01,3,0,3,0,3
50401,COLQUECHACA,estado nutricional,clasificacion f,2004-11-01,7,11,7,11,18
21306,COLQUENCHA,estado nutricional,clasificacion f,2004-11-01,1,0,1,0,1
21004,COLQUIRI,estado nutricional,clasificacion f,2004-11-01,0,1,0,1,1
71301,COMARAPA,estado nutricional,clasificacion f,2004-11-01,3,0,3,0,3
21401,COROICO,estado nutricional,clasificacion f,2004-11-01,1,0,1,0,1
40301,CORQUE,estado nutricional,clasificacion f,2004-11-01,2,0,2,0,2
50601,COTAGAITA,estado nutricional,clasificacion f,2004-11-01,8,8,8,8,16
70102,COTOCA,estado nutricional,clasificacion f,2004-11-01,3,0,3,0,3
10902,CULPINA,estado nutricional,clasificacion f,2004-11-01,5,11,5,11,16
40401,CURAHUARA DE CARANGAS,estado nutricional,clasificacion f,2004-11-01,1,1,1,1,2
20105,EL ALTO,estado nutricional,clasificacion f,2004-11-01,54,42,54,42,96
71503,EL PUENTE(STC),estado nutricional,clasificacion f,2004-11-01,4,5,4,5,9
60502,EL PUENTE(TJA),estado nutricional,clasificacion f,2004-11-01,0,1,0,1,1
70105,EL TORNO,estado nutricional,clasificacion f,2004-11-01,0,1,0,1,1
10405,EL VILLAR,estado nutricional,clasificacion f,2004-11-01,1,4,1,4,5
60601,ENTRE RIOS,estado nutricional,clasificacion f,2004-11-01,3,2,3,2,5
80402,EXALTACION,estado nutricional,clasificacion f,2004-11-01,0,1,0,1,1
71002,GENERAL SAAVEDRA,estado nutricional,clasificacion f,2004-11-01,7,3,7,3,10
21601,GRAL. J.J. PEREZ (CHARAZANI),estado nutricional,clasificacion f,2004-11-01,1,1,1,1,2
20602,GUANAY,estado nutricional,clasificacion f,2004-11-01,3,2,3,2,5
80202,GUAYARAMERIN,estado nutricional,clasificacion f,2004-11-01,3,2,3,2,5
70705,GUTIERREZ,estado nutricional,clasificacion f,2004-11-01,9,8,9,8,17
10502,HUACARETA,estado nutricional,clasificacion f,2004-11-01,3,0,3,0,3
21005,ICHOCA,estado nutricional,clasificacion f,2004-11-01,2,3,2,3,5
10304,ICLA,estado nutricional,clasificacion f,2004-11-01,8,5,8,5,13
10703,INCAHUASI,estado nutricional,clasificacion f,2004-11-01,9,15,9,15,24
21001,INQUISIVI,estado nutricional,clasificacion f,2004-11-01,2,1,2,1,3
21501,IXIAMAS,estado nutricional,clasificacion f,2004-11-01,0,2,0,2,2
21105,LA ASUNTA,estado nutricional,clasificacion f,2004-11-01,3,2,3,2,5
70104,LA GUARDIA,estado nutricional,clasificacion f,2004-11-01,0,1,0,1,1
20101,LA PAZ,estado nutricional,clasificacion f,2004-11-01,35,13,35,13,48
70701,LAGUNILLAS,estado nutricional,clasificacion f,2004-11-01,1,1,1,1,2
21202,LAJA,estado nutricional,clasificacion f,2004-11-01,1,0,1,0,1
10903,LAS CARRERAS,estado nutricional,clasificacion f,2004-11-01,0,1,0,1,1
21006,LICOMA PAMPA,estado nutricional,clasificacion f,2004-11-01,1,0,1,0,1
50203,LLALLAGUA,estado nutricional,clasificacion f,2004-11-01,14,6,14,6,20
20901,LURIBAY,estado nutricional,clasificacion f,2004-11-01,2,1,2,1,3
40702,MACHACAMARCA,estado nutricional,clasificacion f,2004-11-01,0,1,0,1,1
11003,MACHARETI,estado nutricional,clasificacion f,2004-11-01,1,1,1,1,2
80801,MAGDALENA,estado nutricional,clasificacion f,2004-11-01,3,0,3,0,3
70903,MAIRANA,estado nutricional,clasificacion f,2004-11-01,1,1,1,1,2
71003,MINEROS,estado nutricional,clasificacion f,2004-11-01,10,6,10,6,16
31301,MIZQUE,estado nutricional,clasificacion f,2004-11-01,15,3,15,3,18
20402,MOCOMOCO,estado nutricional,clasificacion f,2004-11-01,2,0,2,0,2
10303,MOJOCOYA,estado nutricional,clasificacion f,2004-11-01,1,0,1,0,1
10501,MONTEAGUDO,estado nutricional,clasificacion f,2004-11-01,4,5,4,5,9
71001,MONTERO,estado nutricional,clasificacion f,2004-11-01,13,5,13,5,18
30302,MOROCHATA,estado nutricional,clasificacion f,2004-11-01,10,2,10,2,12
50404,OCURI,estado nutricional,clasificacion f,2004-11-01,13,8,13,8,21
40101,ORURO,estado nutricional,clasificacion f,2004-11-01,24,9,24,9,33
10401,PADILLA,estado nutricional,clasificacion f,2004-11-01,5,3,5,3,8
70502,PAILON,estado nutricional,clasificacion f,2004-11-01,0,4,0,4,4
20102,PALCA,estado nutricional,clasificacion f,2004-11-01,2,1,2,1,3
21104,PALOS BLANCOS,estado nutricional,clasificacion f,2004-11-01,8,2,8,2,10
21305,PATACAMAYA,estado nutricional,clasificacion f,2004-11-01,9,4,9,4,13
20702,PELECHUCO,estado nutricional,clasificacion f,2004-11-01,2,0,2,0,2
50403,POCOATA,estado nutricional,clasificacion f,2004-11-01,11,10,11,10,21
31203,POCONA,estado nutricional,clasificacion f,2004-11-01,1,0,1,0,1
31202,POJO (CBBA),estado nutricional,clasificacion f,2004-11-01,8,1,8,1,9
51203,PORCO,estado nutricional,clasificacion f,2004-11-01,2,0,2,0,2
10103,POROMA,estado nutricional,clasificacion f,2004-11-01,7,5,7,5,12
70601,PORTACHUELO,estado nutricional,clasificacion f,2004-11-01,2,0,2,0,2
70804,POSTRER VALLE,estado nutricional,clasificacion f,2004-11-01,0,1,0,1,1
50101,POTOSI,estado nutricional,clasificacion f,2004-11-01,14,4,14,4,18
10302,PRESTO,estado nutricional,clasificacion f,2004-11-01,5,2,5,2,7
21201,PUCARANI,estado nutricional,clasificacion f,2004-11-01,1,0,1,0,1
90201,PUERTO RICO,estado nutricional,clasificacion f,2004-11-01,1,0,1,0,1
31205,PUERTO VILLARROEL,estado nutricional,clasificacion f,2004-11-01,13,10,13,10,23
51101,PUNA,estado nutricional,clasificacion f,2004-11-01,12,2,12,2,14
31401,PUNATA,estado nutricional,clasificacion f,2004-11-01,2,2,2,2,4
20604,QUIABAYA,estado nutricional,clasificacion f,2004-11-01,3,2,3,2,5
30901,QUILLACOLLO,estado nutricional,clasificacion f,2004-11-01,5,0,5,0,5
50402,RAVELO,estado nutricional,clasificacion f,2004-11-01,17,5,17,5,22
80301,REYES,estado nutricional,clasificacion f,2004-11-01,2,4,2,4,6
80201,RIBERALTA,estado nutricional,clasificacion f,2004-11-01,24,10,24,10,34
70503,ROBORE,estado nutricional,clasificacion f,2004-11-01,3,3,3,3,6
80304,RURRENABAQUE,estado nutricional,clasificacion f,2004-11-01,4,0,4,0,4
31001,SACABA,estado nutricional,clasificacion f,2004-11-01,5,1,5,1,6
30404,SACABAMBA,estado nutricional,clasificacion f,2004-11-01,1,0,1,0,1
50701,SACACA,estado nutricional,clasificacion f,2004-11-01,14,9,14,9,23
71302,SAIPINA,estado nutricional,clasificacion f,2004-11-01,1,0,1,0,1
70901,SAMAIPATA,estado nutricional,clasificacion f,2004-11-01,1,0,1,0,1
71105,SAN ANTONIO DE LOMERIO,estado nutricional,clasificacion f,2004-11-01,1,6,1,6,7
80302,SAN BORJA,estado nutricional,clasificacion f,2004-11-01,7,8,7,8,15
80501,SAN IGNACIO,estado nutricional,clasificacion f,2004-11-01,4,1,4,1,5
70301,SAN IGNACIO DE VELASCO,estado nutricional,clasificacion f,2004-11-01,21,20,21,20,41
80102,SAN JAVIER(BNI),estado nutricional,clasificacion f,2004-11-01,0,1,0,1,1
71102,SAN JAVIER(STC),estado nutricional,clasificacion f,2004-11-01,3,1,3,1,4
80701,SAN JOAQUIN,estado nutricional,clasificacion f,2004-11-01,1,0,1,0,1
70501,SAN JOSE DE CHIQUITOS,estado nutricional,clasificacion f,2004-11-01,3,0,3,0,3
71104,SAN JULIAN,estado nutricional,clasificacion f,2004-11-01,4,6,4,6,10
60501,SAN LORENZO(TJA),estado nutricional,clasificacion f,2004-11-01,0,1,0,1,1
10702,SAN LUCAS,estado nutricional,clasificacion f,2004-11-01,34,6,34,6,40
70302,SAN MIGUEL DE VELASCO,estado nutricional,clasificacion f,2004-11-01,1,2,1,2,3
50501,SAN PEDRO DE BUENA VISTA,estado nutricional,clasificacion f,2004-11-01,22,15,22,15,37
21801,SAN PEDRO DE CURAHUARA,estado nutricional,clasificacion f,2004-11-01,1,0,1,0,1
90202,SAN PEDRO(PND),estado nutricional,clasificacion f,2004-11-01,0,1,0,1,1
70303,SAN RAFAEL,estado nutricional,clasificacion f,2004-11-01,4,0,4,0,4
70101,SANTA CRUZ DE LA SIERRA,estado nutricional,clasificacion f,2004-11-01,27,4,27,4,31
80303,SANTA ROSA,estado nutricional,clasificacion f,2004-11-01,2,1,2,1,3
70602,SANTA ROSA DEL SARA,estado nutricional,clasificacion f,2004-11-01,1,1,1,1,2
20308,SANTIAGO DE CALLAPA,estado nutricional,clasificacion f,2004-11-01,1,2,1,2,3
20902,SAPAHAQUI,estado nutricional,clasificacion f,2004-11-01,1,0,1,0,1
90303,SENA,estado nutricional,clasificacion f,2004-11-01,3,0,3,0,3
21301,SICA SICA (VILLA AROMA),estado nutricional,clasificacion f,2004-11-01,1,2,1,2,3
30902,SIPE SIPE,estado nutricional,clasificacion f,2004-11-01,5,3,5,3,8
10403,SOPACHUY,estado nutricional,clasificacion f,2004-11-01,0,8,0,8,8
20601,SORATA,estado nutricional,clasificacion f,2004-11-01,0,1,0,1,1
10101,SUCRE,estado nutricional,clasificacion f,2004-11-01,10,5,10,5,15
20603,TACACOMA,estado nutricional,clasificacion f,2004-11-01,1,3,1,3,4
50303,TACOBAMBA,estado nutricional,clasificacion f,2004-11-01,3,1,3,1,4
30602,TACOPAYA,estado nutricional,clasificacion f,2004-11-01,3,2,3,2,5
31101,TAPACARI,estado nutricional,clasificacion f,2004-11-01,13,1,13,1,14
10601,TARABUCO,estado nutricional,clasificacion f,2004-11-01,19,15,19,15,34
30401,TARATA,estado nutricional,clasificacion f,2004-11-01,2,0,2,0,2
60101,TARIJA,estado nutricional,clasificacion f,2004-11-01,6,7,6,7,13
10202,TARVITA,estado nutricional,clasificacion f,2004-11-01,5,3,5,3,8
20803,TIAWANACU,estado nutricional,clasificacion f,2004-11-01,2,0,2,0,2
50102,TINGUIPAYA,estado nutricional,clasificacion f,2004-11-01,1,2,1,2,3
31601,TIRAQUE (CBBA),estado nutricional,clasificacion f,2004-11-01,9,7,9,7,16
51202,TOMAVE,estado nutricional,clasificacion f,2004-11-01,1,0,1,0,1
10402,TOMINA,estado nutricional,clasificacion f,2004-11-01,10,6,10,6,16
50502,TORO TORO,estado nutricional,clasificacion f,2004-11-01,10,4,10,4,14
31201,TOTORA(CBBA),estado nutricional,clasificacion f,2004-11-01,3,0,3,0,3
80101,TRINIDAD,estado nutricional,clasificacion f,2004-11-01,5,2,5,2,7
50801,TUPIZA,estado nutricional,clasificacion f,2004-11-01,3,3,3,3,6
50201,UNCIA,estado nutricional,clasificacion f,2004-11-01,2,1,2,1,3
60401,URIONDO (A. CONCEPCION),estado nutricional,clasificacion f,2004-11-01,2,2,2,2,4
71502,URUBICHA,estado nutricional,clasificacion f,2004-11-01,0,1,0,1,1
51201,UYUNI,estado nutricional,clasificacion f,2004-11-01,1,0,1,0,1
30502,VACAS,estado nutricional,clasificacion f,2004-11-01,1,1,1,1,2
70801,VALLEGRANDE,estado nutricional,clasificacion f,2004-11-01,1,6,1,6,7
20801,VIACHA,estado nutricional,clasificacion f,2004-11-01,3,1,3,1,4
31302,VILA VILA,estado nutricional,clasificacion f,2004-11-01,7,6,7,6,13
60303,VILLA MONTES,estado nutricional,clasificacion f,2004-11-01,2,1,2,1,3
31402,VILLA RIVERO,estado nutricional,clasificacion f,2004-11-01,0,1,0,1,1
10801,VILLA SERRANO,estado nutricional,clasificacion f,2004-11-01,5,2,5,2,7
31003,VILLA TUNARI,estado nutricional,clasificacion f,2004-11-01,8,0,8,0,8
11001,VILLA VACA GUZMAN (MUYUPAMPA),estado nutricional,clasificacion f,2004-11-01,1,1,1,1,2
50602,VITICHI,estado nutricional,clasificacion f,2004-11-01,5,0,5,0,5
70201,WARNES,estado nutricional,clasificacion f,2004-11-01,2,2,2,2,4
20903,YACO,estado nutricional,clasificacion f,2004-11-01,1,1,1,1,2
60301,YACUIBA,estado nutricional,clasificacion f,2004-11-01,0,3,0,3,3
10602,YAMPARAEZ,estado nutricional,clasificacion f,2004-11-01,8,6,8,6,14
70403,YAPACANI,estado nutricional,clasificacion f,2004-11-01,3,5,3,5,8
50103,YOCALLA,estado nutricional,clasificacion f,2004-11-01,1,0,1,0,1
10102,YOTALA,estado nutricional,clasificacion f,2004-11-01,3,2,3,2,5
60402,YUNCHARA,estado nutricional,clasificacion f,2004-11-01,2,0,2,0,2
10301,ZUDAÃ‘EZ,estado nutricional,clasificacion f,2004-11-01,1,3,1,3,4
51302,ACACIO,estado nutricional,clasificacion f,2004-12-01,4,1,4,1,5
20201,ACHACACHI,estado nutricional,clasificacion f,2004-12-01,2,0,2,0,2
30201,AIQUILE,estado nutricional,clasificacion f,2004-12-01,1,1,1,1,2
10404,ALCALA,estado nutricional,clasificacion f,2004-12-01,1,3,1,3,4
20202,ANCORAIMES,estado nutricional,clasificacion f,2004-12-01,1,0,1,0,1
30402,ANZALDO,estado nutricional,clasificacion f,2004-12-01,0,1,0,1,1
51301,ARAMPAMPA,estado nutricional,clasificacion f,2004-12-01,2,5,2,5,7
30501,ARANI,estado nutricional,clasificacion f,2004-12-01,2,0,2,0,2
30403,ARBIETO,estado nutricional,clasificacion f,2004-12-01,1,0,1,0,1
30601,ARQUE,estado nutricional,clasificacion f,2004-12-01,7,0,7,0,7
50802,ATOCHA,estado nutricional,clasificacion f,2004-12-01,3,1,3,1,4
20503,AUCAPATA,estado nutricional,clasificacion f,2004-12-01,0,1,0,1,1
20502,AYATA,estado nutricional,clasificacion f,2004-12-01,2,0,2,0,2
30301,AYOPAYA (V. DE INDEPENDENCIA),estado nutricional,clasificacion f,2004-12-01,7,0,7,0,7
10201,AZURDUY,estado nutricional,clasificacion f,2004-12-01,2,1,2,1,3
60202,BERMEJO,estado nutricional,clasificacion f,2004-12-01,0,2,0,2,2
50301,BETANZOS,estado nutricional,clasificacion f,2004-12-01,12,3,12,3,15
31501,BOLIVAR,estado nutricional,clasificacion f,2004-12-01,1,2,1,2,3
70401,BUENA VISTA,estado nutricional,clasificacion f,2004-12-01,1,0,1,0,1
70703,CABEZAS,estado nutricional,clasificacion f,2004-12-01,2,1,2,1,3
20905,CAIROMA,estado nutricional,clasificacion f,2004-12-01,2,1,2,1,3
51102,"CAIZA ""D""",estado nutricional,clasificacion f,2004-12-01,1,1,1,1,2
21003,CAJUATA,estado nutricional,clasificacion f,2004-12-01,2,1,2,1,3
21304,CALAMARCA,estado nutricional,clasificacion f,2004-12-01,2,1,2,1,3
10701,CAMARGO,estado nutricional,clasificacion f,2004-12-01,2,1,2,1,3
70706,CAMIRI,estado nutricional,clasificacion f,2004-12-01,6,0,6,0,6
30701,CAPINOTA,estado nutricional,clasificacion f,2004-12-01,1,2,1,2,3
20302,CAQUIAVIRI,estado nutricional,clasificacion f,2004-12-01,1,5,1,5,6
40102,CARACOLLO,estado nutricional,clasificacion f,2004-12-01,3,0,3,0,3
22001,CARANAVI,estado nutricional,clasificacion f,2004-12-01,0,3,0,3,3
60302,CARAPARI,estado nutricional,clasificacion f,2004-12-01,2,0,2,0,2
50702,CARIPUYO,estado nutricional,clasificacion f,2004-12-01,4,4,4,4,8
40201,CHALLAPATA,estado nutricional,clasificacion f,2004-12-01,4,0,4,0,4
50302,CHAQUI,estado nutricional,clasificacion f,2004-12-01,1,0,1,0,1
50202,CHAYANTA,estado nutricional,clasificacion f,2004-12-01,3,1,3,1,4
21101,CHULUMANI (V. DE LA LIBERTAD),estado nutricional,clasificacion f,2004-12-01,3,0,3,0,3
20501,CHUMA,estado nutricional,clasificacion f,2004-12-01,2,1,2,1,3
30801,CLIZA,estado nutricional,clasificacion f,2004-12-01,7,1,7,1,8
90101,COBIJA,estado nutricional,clasificacion f,2004-12-01,3,1,3,1,4
30101,COCHABAMBA,estado nutricional,clasificacion f,2004-12-01,22,5,22,5,27
31002,COLOMI,estado nutricional,clasificacion f,2004-12-01,4,3,4,3,7
50401,COLQUECHACA,estado nutricional,clasificacion f,2004-12-01,3,0,3,0,3
71301,COMARAPA,estado nutricional,clasificacion f,2004-12-01,2,0,2,0,2
20605,COMBAYA,estado nutricional,clasificacion f,2004-12-01,0,2,0,2,2
20301,CORO CORO,estado nutricional,clasificacion f,2004-12-01,1,0,1,0,1
21401,COROICO,estado nutricional,clasificacion f,2004-12-01,1,0,1,0,1
40301,CORQUE,estado nutricional,clasificacion f,2004-12-01,0,3,0,3,3
50601,COTAGAITA,estado nutricional,clasificacion f,2004-12-01,3,0,3,0,3
70102,COTOCA,estado nutricional,clasificacion f,2004-12-01,2,1,2,1,3
10902,CULPINA,estado nutricional,clasificacion f,2004-12-01,4,7,4,7,11
20804,DESAGUADERO,estado nutricional,clasificacion f,2004-12-01,1,0,1,0,1
20105,EL ALTO,estado nutricional,clasificacion f,2004-12-01,63,35,63,35,98
60502,EL PUENTE(TJA),estado nutricional,clasificacion f,2004-12-01,1,1,1,1,2
70105,EL TORNO,estado nutricional,clasificacion f,2004-12-01,1,1,1,1,2
10405,EL VILLAR,estado nutricional,clasificacion f,2004-12-01,1,1,1,1,2
60601,ENTRE RIOS,estado nutricional,clasificacion f,2004-12-01,1,0,1,0,1
80402,EXALTACION,estado nutricional,clasificacion f,2004-12-01,2,0,2,0,2
71002,GENERAL SAAVEDRA,estado nutricional,clasificacion f,2004-12-01,2,2,2,2,4
21601,GRAL. J.J. PEREZ (CHARAZANI),estado nutricional,clasificacion f,2004-12-01,1,0,1,0,1
20602,GUANAY,estado nutricional,clasificacion f,2004-12-01,3,2,3,2,5
80202,GUAYARAMERIN,estado nutricional,clasificacion f,2004-12-01,6,2,6,2,8
70705,GUTIERREZ,estado nutricional,clasificacion f,2004-12-01,8,3,8,3,11
10502,HUACARETA,estado nutricional,clasificacion f,2004-12-01,1,1,1,1,2
11002,HUACAYA (VILLA DE HUACAYA),estado nutricional,clasificacion f,2004-12-01,1,0,1,0,1
40701,HUANUNI,estado nutricional,clasificacion f,2004-12-01,2,1,2,1,3
10304,ICLA,estado nutricional,clasificacion f,2004-12-01,9,6,9,6,15
10703,INCAHUASI,estado nutricional,clasificacion f,2004-12-01,11,5,11,5,16
21001,INQUISIVI,estado nutricional,clasificacion f,2004-12-01,3,0,3,0,3
21102,IRUPANA (VILLA DE LANZA),estado nutricional,clasificacion f,2004-12-01,1,0,1,0,1
21105,LA ASUNTA,estado nutricional,clasificacion f,2004-12-01,1,0,1,0,1
70104,LA GUARDIA,estado nutricional,clasificacion f,2004-12-01,2,2,2,2,4
20101,LA PAZ,estado nutricional,clasificacion f,2004-12-01,35,23,35,23,58
50203,LLALLAGUA,estado nutricional,clasificacion f,2004-12-01,6,7,6,7,13
40702,MACHACAMARCA,estado nutricional,clasificacion f,2004-12-01,2,0,2,0,2
11003,MACHARETI,estado nutricional,clasificacion f,2004-12-01,0,2,0,2,2
80801,MAGDALENA,estado nutricional,clasificacion f,2004-12-01,4,1,4,1,5
70903,MAIRANA,estado nutricional,clasificacion f,2004-12-01,1,1,1,1,2
20904,MALLA,estado nutricional,clasificacion f,2004-12-01,1,2,1,2,3
71003,MINEROS,estado nutricional,clasificacion f,2004-12-01,10,2,10,2,12
20402,MOCOMOCO,estado nutricional,clasificacion f,2004-12-01,1,0,1,0,1
10303,MOJOCOYA,estado nutricional,clasificacion f,2004-12-01,1,0,1,0,1
10501,MONTEAGUDO,estado nutricional,clasificacion f,2004-12-01,6,4,6,4,10
71001,MONTERO,estado nutricional,clasificacion f,2004-12-01,24,5,24,5,29
70803,MORO MORO,estado nutricional,clasificacion f,2004-12-01,1,0,1,0,1
30302,MOROCHATA,estado nutricional,clasificacion f,2004-12-01,7,5,7,5,12
50404,OCURI,estado nutricional,clasificacion f,2004-12-01,4,3,4,3,7
70202,OKINAWA,estado nutricional,clasificacion f,2004-12-01,2,0,2,0,2
40101,ORURO,estado nutricional,clasificacion f,2004-12-01,13,7,13,7,20
10401,PADILLA,estado nutricional,clasificacion f,2004-12-01,4,4,4,4,8
21104,PALOS BLANCOS,estado nutricional,clasificacion f,2004-12-01,5,1,5,1,6
70902,PAMPA GRANDE,estado nutricional,clasificacion f,2004-12-01,1,0,1,0,1
40602,PAZÃ‘A,estado nutricional,clasificacion f,2004-12-01,1,1,1,1,2
20702,PELECHUCO,estado nutricional,clasificacion f,2004-12-01,2,0,2,0,2
50403,POCOATA,estado nutricional,clasificacion f,2004-12-01,5,5,5,5,10
31203,POCONA,estado nutricional,clasificacion f,2004-12-01,1,0,1,0,1
31202,POJO (CBBA),estado nutricional,clasificacion f,2004-12-01,7,4,7,4,11
40601,POOPO,estado nutricional,clasificacion f,2004-12-01,1,0,1,0,1
51203,PORCO,estado nutricional,clasificacion f,2004-12-01,1,0,1,0,1
10103,POROMA,estado nutricional,clasificacion f,2004-12-01,5,2,5,2,7
70103,PORONGO,estado nutricional,clasificacion f,2004-12-01,1,0,1,0,1
70601,PORTACHUELO,estado nutricional,clasificacion f,2004-12-01,2,1,2,1,3
70804,POSTRER VALLE,estado nutricional,clasificacion f,2004-12-01,0,2,0,2,2
50101,POTOSI,estado nutricional,clasificacion f,2004-12-01,20,3,20,3,23
10302,PRESTO,estado nutricional,clasificacion f,2004-12-01,10,1,10,1,11
20401,PUERTO ACOSTA,estado nutricional,clasificacion f,2004-12-01,1,0,1,0,1
90301,PUERTO GONZALO MORENO,estado nutricional,clasificacion f,2004-12-01,1,0,1,0,1
90201,PUERTO RICO,estado nutricional,clasificacion f,2004-12-01,2,0,2,0,2
31205,PUERTO VILLARROEL,estado nutricional,clasificacion f,2004-12-01,20,9,20,9,29
51101,PUNA,estado nutricional,clasificacion f,2004-12-01,12,6,12,6,18
31401,PUNATA,estado nutricional,clasificacion f,2004-12-01,2,0,2,0,2
30901,QUILLACOLLO,estado nutricional,clasificacion f,2004-12-01,9,2,9,2,11
50402,RAVELO,estado nutricional,clasificacion f,2004-12-01,29,14,29,14,43
80301,REYES,estado nutricional,clasificacion f,2004-12-01,3,0,3,0,3
80201,RIBERALTA,estado nutricional,clasificacion f,2004-12-01,41,39,41,39,80
70503,ROBORE,estado nutricional,clasificacion f,2004-12-01,2,0,2,0,2
31001,SACABA,estado nutricional,clasificacion f,2004-12-01,1,1,1,1,2
50701,SACACA,estado nutricional,clasificacion f,2004-12-01,25,9,25,9,34
71302,SAIPINA,estado nutricional,clasificacion f,2004-12-01,1,0,1,0,1
70901,SAMAIPATA,estado nutricional,clasificacion f,2004-12-01,2,2,2,2,4
71105,SAN ANTONIO DE LOMERIO,estado nutricional,clasificacion f,2004-12-01,7,3,7,3,10
31403,SAN BENITO,estado nutricional,clasificacion f,2004-12-01,1,0,1,0,1
80302,SAN BORJA,estado nutricional,clasificacion f,2004-12-01,8,15,8,15,23
21502,SAN BUENA VENTURA,estado nutricional,clasificacion f,2004-12-01,0,3,0,3,3
80501,SAN IGNACIO,estado nutricional,clasificacion f,2004-12-01,1,0,1,0,1
70301,SAN IGNACIO DE VELASCO,estado nutricional,clasificacion f,2004-12-01,16,9,16,9,25
80102,SAN JAVIER(BNI),estado nutricional,clasificacion f,2004-12-01,1,0,1,0,1
71102,SAN JAVIER(STC),estado nutricional,clasificacion f,2004-12-01,1,1,1,1,2
70501,SAN JOSE DE CHIQUITOS,estado nutricional,clasificacion f,2004-12-01,3,0,3,0,3
71104,SAN JULIAN,estado nutricional,clasificacion f,2004-12-01,6,0,6,0,6
60501,SAN LORENZO(TJA),estado nutricional,clasificacion f,2004-12-01,2,0,2,0,2
10702,SAN LUCAS,estado nutricional,clasificacion f,2004-12-01,17,9,17,9,26
70302,SAN MIGUEL DE VELASCO,estado nutricional,clasificacion f,2004-12-01,8,1,8,1,9
50501,SAN PEDRO DE BUENA VISTA,estado nutricional,clasificacion f,2004-12-01,9,13,9,13,22
21801,SAN PEDRO DE CURAHUARA,estado nutricional,clasificacion f,2004-12-01,0,1,0,1,1
90202,SAN PEDRO(PND),estado nutricional,clasificacion f,2004-12-01,0,4,0,4,4
70303,SAN RAFAEL,estado nutricional,clasificacion f,2004-12-01,2,1,2,1,3
80702,SAN RAMON,estado nutricional,clasificacion f,2004-12-01,0,2,0,2,2
80702,SAN RAMON,estado nutricional,clasificacion f,2004-12-01,1,0,1,0,1
70101,SANTA CRUZ DE LA SIERRA,estado nutricional,clasificacion f,2004-12-01,76,15,76,15,91
70602,SANTA ROSA DEL SARA,estado nutricional,clasificacion f,2004-12-01,6,0,6,0,6
20308,SANTIAGO DE CALLAPA,estado nutricional,clasificacion f,2004-12-01,3,0,3,0,3
20902,SAPAHAQUI,estado nutricional,clasificacion f,2004-12-01,1,0,1,0,1
21301,SICA SICA (VILLA AROMA),estado nutricional,clasificacion f,2004-12-01,2,0,2,0,2
30902,SIPE SIPE,estado nutricional,clasificacion f,2004-12-01,9,2,9,2,11
10403,SOPACHUY,estado nutricional,clasificacion f,2004-12-01,0,7,0,7,7
20601,SORATA,estado nutricional,clasificacion f,2004-12-01,2,0,2,0,2
10101,SUCRE,estado nutricional,clasificacion f,2004-12-01,12,4,12,4,16
20603,TACACOMA,estado nutricional,clasificacion f,2004-12-01,0,1,0,1,1
50303,TACOBAMBA,estado nutricional,clasificacion f,2004-12-01,1,1,1,1,2
30602,TACOPAYA,estado nutricional,clasificacion f,2004-12-01,3,2,3,2,5
31101,TAPACARI,estado nutricional,clasificacion f,2004-12-01,7,6,7,6,13
10601,TARABUCO,estado nutricional,clasificacion f,2004-12-01,23,16,23,16,39
30401,TARATA,estado nutricional,clasificacion f,2004-12-01,4,3,4,3,7
60101,TARIJA,estado nutricional,clasificacion f,2004-12-01,8,7,8,7,15
10202,TARVITA,estado nutricional,clasificacion f,2004-12-01,4,0,4,0,4
50102,TINGUIPAYA,estado nutricional,clasificacion f,2004-12-01,8,15,8,15,23
30903,TIQUIPAYA,estado nutricional,clasificacion f,2004-12-01,1,1,1,1,2
31601,TIRAQUE (CBBA),estado nutricional,clasificacion f,2004-12-01,11,3,11,3,14
51202,TOMAVE,estado nutricional,clasificacion f,2004-12-01,6,0,6,0,6
10402,TOMINA,estado nutricional,clasificacion f,2004-12-01,6,2,6,2,8
50502,TORO TORO,estado nutricional,clasificacion f,2004-12-01,15,10,15,10,25
31201,TOTORA(CBBA),estado nutricional,clasificacion f,2004-12-01,1,0,1,0,1
80101,TRINIDAD,estado nutricional,clasificacion f,2004-12-01,3,10,3,10,13
50801,TUPIZA,estado nutricional,clasificacion f,2004-12-01,3,2,3,2,5
50201,UNCIA,estado nutricional,clasificacion f,2004-12-01,3,1,3,1,4
60401,URIONDO (A. CONCEPCION),estado nutricional,clasificacion f,2004-12-01,2,2,2,2,4
51201,UYUNI,estado nutricional,clasificacion f,2004-12-01,0,1,0,1,1
30502,VACAS,estado nutricional,clasificacion f,2004-12-01,2,0,2,0,2
70801,VALLEGRANDE,estado nutricional,clasificacion f,2004-12-01,2,5,2,5,7
20801,VIACHA,estado nutricional,clasificacion f,2004-12-01,1,1,1,1,2
31302,VILA VILA,estado nutricional,clasificacion f,2004-12-01,0,1,0,1,1
60303,VILLA MONTES,estado nutricional,clasificacion f,2004-12-01,3,2,3,2,5
31402,VILLA RIVERO,estado nutricional,clasificacion f,2004-12-01,3,0,3,0,3
10801,VILLA SERRANO,estado nutricional,clasificacion f,2004-12-01,5,1,5,1,6
31003,VILLA TUNARI,estado nutricional,clasificacion f,2004-12-01,17,15,17,15,32
11001,VILLA VACA GUZMAN (MUYUPAMPA),estado nutricional,clasificacion f,2004-12-01,1,0,1,0,1
51501,VILLAZON,estado nutricional,clasificacion f,2004-12-01,4,1,4,1,5
30904,VINTO,estado nutricional,clasificacion f,2004-12-01,1,0,1,0,1
50602,VITICHI,estado nutricional,clasificacion f,2004-12-01,0,1,0,1,1
70201,WARNES,estado nutricional,clasificacion f,2004-12-01,0,1,0,1,1
20903,YACO,estado nutricional,clasificacion f,2004-12-01,2,2,2,2,4
60301,YACUIBA,estado nutricional,clasificacion f,2004-12-01,7,6,7,6,13
10602,YAMPARAEZ,estado nutricional,clasificacion f,2004-12-01,7,6,7,6,13
70403,YAPACANI,estado nutricional,clasificacion f,2004-12-01,5,5,5,5,10
10102,YOTALA,estado nutricional,clasificacion f,2004-12-01,1,1,1,1,2
60402,YUNCHARA,estado nutricional,clasificacion f,2004-12-01,0,2,0,2,2
10301,ZUDAÃ‘EZ,estado nutricional,clasificacion f,2004-12-01,2,5,2,5,7
