codigo_municipio,municipio,grupo,variable,mes,< de 2 años-H,< de 2 años-M,2 a 4 años-H,2 a 4 años-M,TOTAL-H,TOTAL-M,TOTAL
51302,ACACIO,desnutricion global,desnutricion grave (g),2005-01-01,2,1,0,0,2,1,3
20201,ACHACACHI,desnutricion global,desnutricion grave (g),2005-01-01,5,0,0,2,5,2,7
20104,ACHOCALLA,desnutricion global,desnutricion grave (g),2005-01-01,0,3,0,1,0,4,4
30201,AIQUILE,desnutricion global,desnutricion grave (g),2005-01-01,3,4,2,0,5,4,9
31303,ALALAY,desnutricion global,desnutricion grave (g),2005-01-01,1,0,0,1,1,1,2
10404,ALCALA,desnutricion global,desnutricion grave (g),2005-01-01,0,1,0,3,0,4,4
20202,ANCORAIMES,desnutricion global,desnutricion grave (g),2005-01-01,2,1,0,1,2,2,4
40603,ANTEQUERA,desnutricion global,desnutricion grave (g),2005-01-01,1,0,1,0,2,0,2
30402,ANZALDO,desnutricion global,desnutricion grave (g),2005-01-01,3,3,0,2,3,5,8
20701,APOLO,desnutricion global,desnutricion grave (g),2005-01-01,0,1,1,1,1,2,3
30501,ARANI,desnutricion global,desnutricion grave (g),2005-01-01,1,1,0,0,1,1,2
30601,ARQUE,desnutricion global,desnutricion grave (g),2005-01-01,0,1,0,0,0,1,1
50802,ATOCHA,desnutricion global,desnutricion grave (g),2005-01-01,3,5,0,1,3,6,9
20503,AUCAPATA,desnutricion global,desnutricion grave (g),2005-01-01,2,0,0,0,2,0,2
20502,AYATA,desnutricion global,desnutricion grave (g),2005-01-01,2,2,1,3,3,5,8
30301,AYOPAYA (V. DE INDEPENDENCIA),desnutricion global,desnutricion grave (g),2005-01-01,0,0,1,0,1,0,1
10201,AZURDUY,desnutricion global,desnutricion grave (g),2005-01-01,7,4,1,2,8,6,14
80802,BAURES,desnutricion global,desnutricion grave (g),2005-01-01,1,0,0,0,1,0,1
60202,BERMEJO,desnutricion global,desnutricion grave (g),2005-01-01,2,1,0,1,2,2,4
50301,BETANZOS,desnutricion global,desnutricion grave (g),2005-01-01,2,2,1,2,3,4,7
31501,BOLIVAR,desnutricion global,desnutricion grave (g),2005-01-01,2,9,0,1,2,10,12
70401,BUENA VISTA,desnutricion global,desnutricion grave (g),2005-01-01,1,0,0,0,1,0,1
70703,CABEZAS,desnutricion global,desnutricion grave (g),2005-01-01,3,2,1,0,4,2,6
20905,CAIROMA,desnutricion global,desnutricion grave (g),2005-01-01,1,1,1,1,2,2,4
51102,"CAIZA ""D""",desnutricion global,desnutricion grave (g),2005-01-01,0,1,0,0,0,1,1
21003,CAJUATA,desnutricion global,desnutricion grave (g),2005-01-01,2,0,0,0,2,0,2
21304,CALAMARCA,desnutricion global,desnutricion grave (g),2005-01-01,0,1,0,2,0,3,3
70706,CAMIRI,desnutricion global,desnutricion grave (g),2005-01-01,5,12,5,10,10,22,32
30701,CAPINOTA,desnutricion global,desnutricion grave (g),2005-01-01,3,0,1,0,4,0,4
20302,CAQUIAVIRI,desnutricion global,desnutricion grave (g),2005-01-01,1,0,0,0,1,0,1
22001,CARANAVI,desnutricion global,desnutricion grave (g),2005-01-01,8,6,5,4,13,10,23
60302,CARAPARI,desnutricion global,desnutricion grave (g),2005-01-01,1,0,0,0,1,0,1
40201,CHALLAPATA,desnutricion global,desnutricion grave (g),2005-01-01,2,3,0,0,2,3,5
70702,CHARAGUA,desnutricion global,desnutricion grave (g),2005-01-01,7,4,2,2,9,6,15
50202,CHAYANTA,desnutricion global,desnutricion grave (g),2005-01-01,3,3,1,1,4,4,8
31204,CHIMORE,desnutricion global,desnutricion grave (g),2005-01-01,0,0,0,1,0,1,1
20501,CHUMA,desnutricion global,desnutricion grave (g),2005-01-01,0,2,0,0,0,2,2
30801,CLIZA,desnutricion global,desnutricion grave (g),2005-01-01,4,2,0,0,4,2,6
90101,COBIJA,desnutricion global,desnutricion grave (g),2005-01-01,2,1,0,1,2,2,4
30101,COCHABAMBA,desnutricion global,desnutricion grave (g),2005-01-01,14,12,3,0,17,12,29
30905,COLCAPIRHUA,desnutricion global,desnutricion grave (g),2005-01-01,3,0,0,0,3,0,3
31002,COLOMI,desnutricion global,desnutricion grave (g),2005-01-01,2,2,1,1,3,3,6
70603,COLPA BELGICA,desnutricion global,desnutricion grave (g),2005-01-01,0,1,0,0,0,1,1
50401,COLQUECHACA,desnutricion global,desnutricion grave (g),2005-01-01,6,1,3,0,9,1,10
21004,COLQUIRI,desnutricion global,desnutricion grave (g),2005-01-01,1,0,0,2,1,2,3
71301,COMARAPA,desnutricion global,desnutricion grave (g),2005-01-01,2,3,0,0,2,3,5
40301,CORQUE,desnutricion global,desnutricion grave (g),2005-01-01,1,1,0,0,1,1,2
50601,COTAGAITA,desnutricion global,desnutricion grave (g),2005-01-01,6,4,4,2,10,6,16
70102,COTOCA,desnutricion global,desnutricion grave (g),2005-01-01,0,1,0,1,0,2,2
10902,CULPINA,desnutricion global,desnutricion grave (g),2005-01-01,3,4,2,1,5,5,10
20105,EL ALTO,desnutricion global,desnutricion grave (g),2005-01-01,18,21,11,10,29,31,60
60502,EL PUENTE(TJA),desnutricion global,desnutricion grave (g),2005-01-01,0,0,0,1,0,1,1
70105,EL TORNO,desnutricion global,desnutricion grave (g),2005-01-01,1,0,0,0,1,0,1
10405,EL VILLAR,desnutricion global,desnutricion grave (g),2005-01-01,0,0,0,1,0,1,1
60601,ENTRE RIOS,desnutricion global,desnutricion grave (g),2005-01-01,3,2,3,3,6,5,11
60601,ENTRE RIOS,desnutricion global,desnutricion grave (g),2005-01-01,1,0,0,1,1,1,2
41101,EUCALIPTUS,desnutricion global,desnutricion grave (g),2005-01-01,1,1,0,0,1,1,2
71002,GENERAL SAAVEDRA,desnutricion global,desnutricion grave (g),2005-01-01,2,0,0,0,2,0,2
21601,GRAL. J.J. PEREZ (CHARAZANI),desnutricion global,desnutricion grave (g),2005-01-01,0,1,0,0,0,1,1
20602,GUANAY,desnutricion global,desnutricion grave (g),2005-01-01,0,1,0,0,0,1,1
70705,GUTIERREZ,desnutricion global,desnutricion grave (g),2005-01-01,7,3,3,5,10,8,18
10502,HUACARETA,desnutricion global,desnutricion grave (g),2005-01-01,0,1,0,1,0,2,2
11002,HUACAYA (VILLA DE HUACAYA),desnutricion global,desnutricion grave (g),2005-01-01,0,0,2,1,2,1,3
40701,HUANUNI,desnutricion global,desnutricion grave (g),2005-01-01,2,0,0,0,2,0,2
41601,HUAYLLAMARCA,desnutricion global,desnutricion grave (g),2005-01-01,1,0,0,0,1,0,1
21005,ICHOCA,desnutricion global,desnutricion grave (g),2005-01-01,0,0,1,0,1,0,1
10304,ICLA,desnutricion global,desnutricion grave (g),2005-01-01,6,0,0,1,6,1,7
10703,INCAHUASI,desnutricion global,desnutricion grave (g),2005-01-01,3,3,1,1,4,4,8
21001,INQUISIVI,desnutricion global,desnutricion grave (g),2005-01-01,0,0,0,1,0,1,1
21501,IXIAMAS,desnutricion global,desnutricion grave (g),2005-01-01,2,0,0,1,2,1,3
21105,LA ASUNTA,desnutricion global,desnutricion grave (g),2005-01-01,2,4,6,4,8,8,16
70104,LA GUARDIA,desnutricion global,desnutricion grave (g),2005-01-01,0,1,2,3,2,4,6
20101,LA PAZ,desnutricion global,desnutricion grave (g),2005-01-01,9,5,1,8,10,13,23
21202,LAJA,desnutricion global,desnutricion grave (g),2005-01-01,1,0,0,0,1,0,1
50203,LLALLAGUA,desnutricion global,desnutricion grave (g),2005-01-01,3,3,2,3,5,6,11
51401,LLICA,desnutricion global,desnutricion grave (g),2005-01-01,1,0,0,0,1,0,1
20901,LURIBAY,desnutricion global,desnutricion grave (g),2005-01-01,0,2,0,0,0,2,2
40702,MACHACAMARCA,desnutricion global,desnutricion grave (g),2005-01-01,0,0,0,1,0,1,1
11003,MACHARETI,desnutricion global,desnutricion grave (g),2005-01-01,2,1,2,1,4,2,6
80801,MAGDALENA,desnutricion global,desnutricion grave (g),2005-01-01,2,0,0,1,2,1,3
20607,MAPIRI,desnutricion global,desnutricion grave (g),2005-01-01,2,1,0,1,2,2,4
20103,MECAPACA,desnutricion global,desnutricion grave (g),2005-01-01,0,0,1,1,1,1,2
71003,MINEROS,desnutricion global,desnutricion grave (g),2005-01-01,9,4,2,1,11,5,16
31301,MIZQUE,desnutricion global,desnutricion grave (g),2005-01-01,0,0,4,2,4,2,6
10303,MOJOCOYA,desnutricion global,desnutricion grave (g),2005-01-01,2,0,0,0,2,0,2
10501,MONTEAGUDO,desnutricion global,desnutricion grave (g),2005-01-01,1,4,1,0,2,4,6
71001,MONTERO,desnutricion global,desnutricion grave (g),2005-01-01,15,2,6,1,21,3,24
70803,MORO MORO,desnutricion global,desnutricion grave (g),2005-01-01,1,0,1,1,2,1,3
50404,OCURI,desnutricion global,desnutricion grave (g),2005-01-01,7,7,5,3,12,10,22
70202,OKINAWA,desnutricion global,desnutricion grave (g),2005-01-01,2,3,0,0,2,3,5
40101,ORURO,desnutricion global,desnutricion grave (g),2005-01-01,5,6,2,1,7,7,14
60201,PADCAYA,desnutricion global,desnutricion grave (g),2005-01-01,1,0,0,0,1,0,1
10401,PADILLA,desnutricion global,desnutricion grave (g),2005-01-01,2,1,1,2,3,3,6
70502,PAILON,desnutricion global,desnutricion grave (g),2005-01-01,0,0,2,0,2,0,2
20102,PALCA,desnutricion global,desnutricion grave (g),2005-01-01,5,2,0,0,5,2,7
21104,PALOS BLANCOS,desnutricion global,desnutricion grave (g),2005-01-01,1,5,1,2,2,7,9
70902,PAMPA GRANDE,desnutricion global,desnutricion grave (g),2005-01-01,0,2,0,0,0,2,2
21305,PATACAMAYA,desnutricion global,desnutricion grave (g),2005-01-01,0,2,0,0,0,2,2
40602,PAZÑA,desnutricion global,desnutricion grave (g),2005-01-01,0,0,1,0,1,0,1
50403,POCOATA,desnutricion global,desnutricion grave (g),2005-01-01,2,2,5,4,7,6,13
31203,POCONA,desnutricion global,desnutricion grave (g),2005-01-01,1,2,1,0,2,2,4
31202,POJO (CBBA),desnutricion global,desnutricion grave (g),2005-01-01,2,1,0,1,2,2,4
51203,PORCO,desnutricion global,desnutricion grave (g),2005-01-01,1,0,0,0,1,0,1
10103,POROMA,desnutricion global,desnutricion grave (g),2005-01-01,5,0,4,2,9,2,11
70601,PORTACHUELO,desnutricion global,desnutricion grave (g),2005-01-01,1,0,0,0,1,0,1
50101,POTOSI,desnutricion global,desnutricion grave (g),2005-01-01,7,1,2,1,9,2,11
10302,PRESTO,desnutricion global,desnutricion grave (g),2005-01-01,7,0,0,0,7,0,7
21201,PUCARANI,desnutricion global,desnutricion grave (g),2005-01-01,2,0,0,0,2,0,2
20401,PUERTO ACOSTA,desnutricion global,desnutricion grave (g),2005-01-01,1,2,0,0,1,2,3
90301,PUERTO GONZALO MORENO,desnutricion global,desnutricion grave (g),2005-01-01,1,0,0,0,1,0,1
21204,PUERTO PEREZ,desnutricion global,desnutricion grave (g),2005-01-01,0,0,1,0,1,0,1
31205,PUERTO VILLARROEL,desnutricion global,desnutricion grave (g),2005-01-01,11,14,10,11,21,25,46
51101,PUNA,desnutricion global,desnutricion grave (g),2005-01-01,3,8,2,1,5,9,14
31401,PUNATA,desnutricion global,desnutricion grave (g),2005-01-01,3,3,0,0,3,3,6
20604,QUIABAYA,desnutricion global,desnutricion grave (g),2005-01-01,0,1,0,0,0,1,1
30901,QUILLACOLLO,desnutricion global,desnutricion grave (g),2005-01-01,5,5,1,3,6,8,14
21002,QUIME,desnutricion global,desnutricion grave (g),2005-01-01,1,1,0,0,1,1,2
50402,RAVELO,desnutricion global,desnutricion grave (g),2005-01-01,2,1,1,1,3,2,5
80301,REYES,desnutricion global,desnutricion grave (g),2005-01-01,0,0,0,1,0,1,1
80201,RIBERALTA,desnutricion global,desnutricion grave (g),2005-01-01,6,15,12,17,18,32,50
70503,ROBORE,desnutricion global,desnutricion grave (g),2005-01-01,0,3,2,0,2,3,5
31001,SACABA,desnutricion global,desnutricion grave (g),2005-01-01,4,2,2,1,6,3,9
30404,SACABAMBA,desnutricion global,desnutricion grave (g),2005-01-01,2,2,0,0,2,2,4
71105,SAN ANTONIO DE LOMERIO,desnutricion global,desnutricion grave (g),2005-01-01,1,3,1,2,2,5,7
31403,SAN BENITO,desnutricion global,desnutricion grave (g),2005-01-01,1,0,0,0,1,0,1
80302,SAN BORJA,desnutricion global,desnutricion grave (g),2005-01-01,5,5,1,1,6,6,12
21502,SAN BUENA VENTURA,desnutricion global,desnutricion grave (g),2005-01-01,0,1,0,0,0,1,1
70402,SAN CARLOS,desnutricion global,desnutricion grave (g),2005-01-01,3,1,1,0,4,1,5
80501,SAN IGNACIO,desnutricion global,desnutricion grave (g),2005-01-01,3,1,2,0,5,1,6
70301,SAN IGNACIO DE VELASCO,desnutricion global,desnutricion grave (g),2005-01-01,13,11,4,4,17,15,32
80102,SAN JAVIER(BNI),desnutricion global,desnutricion grave (g),2005-01-01,0,1,1,0,1,1,2
80701,SAN JOAQUIN,desnutricion global,desnutricion grave (g),2005-01-01,0,1,0,0,0,1,1
70501,SAN JOSE DE CHIQUITOS,desnutricion global,desnutricion grave (g),2005-01-01,1,0,0,0,1,0,1
71104,SAN JULIAN,desnutricion global,desnutricion grave (g),2005-01-01,5,0,1,0,6,0,6
90302,SAN LORENZO(PND),desnutricion global,desnutricion grave (g),2005-01-01,1,0,0,0,1,0,1
60501,SAN LORENZO(TJA),desnutricion global,desnutricion grave (g),2005-01-01,0,0,2,0,2,0,2
10702,SAN LUCAS,desnutricion global,desnutricion grave (g),2005-01-01,10,12,4,7,14,19,33
70302,SAN MIGUEL DE VELASCO,desnutricion global,desnutricion grave (g),2005-01-01,3,1,0,1,3,2,5
51001,SAN PABLO DE LIPEZ,desnutricion global,desnutricion grave (g),2005-01-01,0,1,0,0,0,1,1
50501,SAN PEDRO DE BUENA VISTA,desnutricion global,desnutricion grave (g),2005-01-01,0,1,1,3,1,4,5
70303,SAN RAFAEL,desnutricion global,desnutricion grave (g),2005-01-01,1,1,0,1,1,2,3
80401,SANTA ANA,desnutricion global,desnutricion grave (g),2005-01-01,0,1,0,1,0,2,2
70101,SANTA CRUZ DE LA SIERRA,desnutricion global,desnutricion grave (g),2005-01-01,82,51,17,13,99,64,163
70602,SANTA ROSA DEL SARA,desnutricion global,desnutricion grave (g),2005-01-01,1,2,1,1,2,3,5
41401,SANTIAGO DE HUARI,desnutricion global,desnutricion grave (g),2005-01-01,0,1,0,0,0,1,1
40202,SANTUARIO DE QUILLACAS,desnutricion global,desnutricion grave (g),2005-01-01,1,0,0,0,1,0,1
90303,SENA,desnutricion global,desnutricion grave (g),2005-01-01,0,0,1,1,1,1,2
21301,SICA SICA (VILLA AROMA),desnutricion global,desnutricion grave (g),2005-01-01,1,3,0,0,1,3,4
30902,SIPE SIPE,desnutricion global,desnutricion grave (g),2005-01-01,7,4,0,1,7,5,12
10403,SOPACHUY,desnutricion global,desnutricion grave (g),2005-01-01,1,3,0,4,1,7,8
40104,SORACACHI,desnutricion global,desnutricion grave (g),2005-01-01,1,0,0,0,1,0,1
10101,SUCRE,desnutricion global,desnutricion grave (g),2005-01-01,7,4,2,3,9,7,16
31404,TACACHI,desnutricion global,desnutricion grave (g),2005-01-01,0,1,0,0,0,1,1
30602,TACOPAYA,desnutricion global,desnutricion grave (g),2005-01-01,2,0,0,0,2,0,2
31101,TAPACARI,desnutricion global,desnutricion grave (g),2005-01-01,7,1,1,2,8,3,11
10601,TARABUCO,desnutricion global,desnutricion grave (g),2005-01-01,12,13,7,8,19,21,40
20807,TARACO,desnutricion global,desnutricion grave (g),2005-01-01,0,0,0,4,0,4,4
60101,TARIJA,desnutricion global,desnutricion grave (g),2005-01-01,2,3,0,1,2,4,6
10202,TARVITA,desnutricion global,desnutricion grave (g),2005-01-01,2,3,0,3,2,6,8
20803,TIAWANACU,desnutricion global,desnutricion grave (g),2005-01-01,2,0,0,0,2,0,2
50102,TINGUIPAYA,desnutricion global,desnutricion grave (g),2005-01-01,5,3,3,2,8,5,13
30903,TIQUIPAYA,desnutricion global,desnutricion grave (g),2005-01-01,4,0,0,0,4,0,4
31601,TIRAQUE (CBBA),desnutricion global,desnutricion grave (g),2005-01-01,9,7,2,2,11,9,20
21703,TITO YUPANQUI (PARQUIPUJIO),desnutricion global,desnutricion grave (g),2005-01-01,0,1,0,0,0,1,1
51202,TOMAVE,desnutricion global,desnutricion grave (g),2005-01-01,1,0,0,1,1,1,2
10402,TOMINA,desnutricion global,desnutricion grave (g),2005-01-01,0,1,3,1,3,2,5
31201,TOTORA(CBBA),desnutricion global,desnutricion grave (g),2005-01-01,0,1,0,0,0,1,1
80101,TRINIDAD,desnutricion global,desnutricion grave (g),2005-01-01,8,4,1,2,9,6,15
50801,TUPIZA,desnutricion global,desnutricion grave (g),2005-01-01,2,1,0,0,2,1,3
50201,UNCIA,desnutricion global,desnutricion grave (g),2005-01-01,4,3,1,3,5,6,11
60401,URIONDO (A. CONCEPCION),desnutricion global,desnutricion grave (g),2005-01-01,3,0,1,0,4,0,4
30502,VACAS,desnutricion global,desnutricion grave (g),2005-01-01,0,1,0,2,0,3,3
70801,VALLEGRANDE,desnutricion global,desnutricion grave (g),2005-01-01,1,0,1,1,2,1,3
20801,VIACHA,desnutricion global,desnutricion grave (g),2005-01-01,3,6,0,1,3,7,10
31302,VILA VILA,desnutricion global,desnutricion grave (g),2005-01-01,1,0,1,0,2,0,2
60303,VILLA MONTES,desnutricion global,desnutricion grave (g),2005-01-01,3,2,4,2,7,4,11
31402,VILLA RIVERO,desnutricion global,desnutricion grave (g),2005-01-01,0,1,1,0,1,1,2
10801,VILLA SERRANO,desnutricion global,desnutricion grave (g),2005-01-01,2,0,1,1,3,1,4
31003,VILLA TUNARI,desnutricion global,desnutricion grave (g),2005-01-01,7,3,1,1,8,4,12
11001,VILLA VACA GUZMAN (MUYUPAMPA),desnutricion global,desnutricion grave (g),2005-01-01,3,0,0,1,3,1,4
51501,VILLAZON,desnutricion global,desnutricion grave (g),2005-01-01,0,1,1,0,1,1,2
30904,VINTO,desnutricion global,desnutricion grave (g),2005-01-01,0,0,1,0,1,0,1
50602,VITICHI,desnutricion global,desnutricion grave (g),2005-01-01,1,0,0,0,1,0,1
70201,WARNES,desnutricion global,desnutricion grave (g),2005-01-01,0,0,1,3,1,3,4
60301,YACUIBA,desnutricion global,desnutricion grave (g),2005-01-01,2,4,2,1,4,5,9
10602,YAMPARAEZ,desnutricion global,desnutricion grave (g),2005-01-01,2,4,2,5,4,9,13
70403,YAPACANI,desnutricion global,desnutricion grave (g),2005-01-01,4,6,0,1,4,7,11
50103,YOCALLA,desnutricion global,desnutricion grave (g),2005-01-01,1,0,0,2,1,2,3
10102,YOTALA,desnutricion global,desnutricion grave (g),2005-01-01,1,0,0,0,1,0,1
60402,YUNCHARA,desnutricion global,desnutricion grave (g),2005-01-01,1,0,0,1,1,1,2
10301,ZUDAÑEZ,desnutricion global,desnutricion grave (g),2005-01-01,2,0,4,1,6,1,7
51302,ACACIO,desnutricion global,desnutricion grave (g),2005-02-01,1,3,0,1,1,4,5
20201,ACHACACHI,desnutricion global,desnutricion grave (g),2005-02-01,0,0,4,1,4,1,5
20104,ACHOCALLA,desnutricion global,desnutricion grave (g),2005-02-01,1,0,0,2,1,2,3
30201,AIQUILE,desnutricion global,desnutricion grave (g),2005-02-01,4,3,0,0,4,3,7
10404,ALCALA,desnutricion global,desnutricion grave (g),2005-02-01,1,1,0,0,1,1,2
30402,ANZALDO,desnutricion global,desnutricion grave (g),2005-02-01,0,0,0,1,0,1,1
20701,APOLO,desnutricion global,desnutricion grave (g),2005-02-01,0,1,2,1,2,2,4
51301,ARAMPAMPA,desnutricion global,desnutricion grave (g),2005-02-01,0,0,0,1,0,1,1
30501,ARANI,desnutricion global,desnutricion grave (g),2005-02-01,2,2,0,0,2,2,4
30403,ARBIETO,desnutricion global,desnutricion grave (g),2005-02-01,0,3,0,0,0,3,3
30601,ARQUE,desnutricion global,desnutricion grave (g),2005-02-01,1,0,0,0,1,0,1
50802,ATOCHA,desnutricion global,desnutricion grave (g),2005-02-01,3,4,2,0,5,4,9
20503,AUCAPATA,desnutricion global,desnutricion grave (g),2005-02-01,1,0,0,0,1,0,1
20502,AYATA,desnutricion global,desnutricion grave (g),2005-02-01,3,0,0,1,3,1,4
30301,AYOPAYA (V. DE INDEPENDENCIA),desnutricion global,desnutricion grave (g),2005-02-01,3,1,0,0,3,1,4
10201,AZURDUY,desnutricion global,desnutricion grave (g),2005-02-01,4,3,1,2,5,5,10
50104,BELEN DE URMIRI,desnutricion global,desnutricion grave (g),2005-02-01,0,0,1,0,1,0,1
50301,BETANZOS,desnutricion global,desnutricion grave (g),2005-02-01,7,3,2,2,9,5,14
31501,BOLIVAR,desnutricion global,desnutricion grave (g),2005-02-01,0,2,0,0,0,2,2
70401,BUENA VISTA,desnutricion global,desnutricion grave (g),2005-02-01,1,0,0,1,1,1,2
70703,CABEZAS,desnutricion global,desnutricion grave (g),2005-02-01,1,2,1,0,2,2,4
20905,CAIROMA,desnutricion global,desnutricion grave (g),2005-02-01,1,1,0,0,1,1,2
51102,"CAIZA ""D""",desnutricion global,desnutricion grave (g),2005-02-01,1,1,0,0,1,1,2
21304,CALAMARCA,desnutricion global,desnutricion grave (g),2005-02-01,3,1,1,1,4,2,6
10701,CAMARGO,desnutricion global,desnutricion grave (g),2005-02-01,0,3,1,0,1,3,4
70706,CAMIRI,desnutricion global,desnutricion grave (g),2005-02-01,7,4,3,7,10,11,21
30701,CAPINOTA,desnutricion global,desnutricion grave (g),2005-02-01,4,2,0,2,4,4,8
20302,CAQUIAVIRI,desnutricion global,desnutricion grave (g),2005-02-01,0,0,0,1,0,1,1
40102,CARACOLLO,desnutricion global,desnutricion grave (g),2005-02-01,2,0,0,0,2,0,2
22001,CARANAVI,desnutricion global,desnutricion grave (g),2005-02-01,4,6,2,7,6,13,19
50702,CARIPUYO,desnutricion global,desnutricion grave (g),2005-02-01,1,1,0,0,1,1,2
40201,CHALLAPATA,desnutricion global,desnutricion grave (g),2005-02-01,0,4,0,0,0,4,4
70702,CHARAGUA,desnutricion global,desnutricion grave (g),2005-02-01,3,6,4,4,7,10,17
50202,CHAYANTA,desnutricion global,desnutricion grave (g),2005-02-01,2,2,0,1,2,3,5
20501,CHUMA,desnutricion global,desnutricion grave (g),2005-02-01,2,0,0,1,2,1,3
30801,CLIZA,desnutricion global,desnutricion grave (g),2005-02-01,1,2,0,1,1,3,4
90101,COBIJA,desnutricion global,desnutricion grave (g),2005-02-01,1,0,0,0,1,0,1
30101,COCHABAMBA,desnutricion global,desnutricion grave (g),2005-02-01,7,4,3,3,10,7,17
30905,COLCAPIRHUA,desnutricion global,desnutricion grave (g),2005-02-01,1,0,0,1,1,1,2
50901,"COLCHA ""K""",desnutricion global,desnutricion grave (g),2005-02-01,0,1,0,0,0,1,1
31002,COLOMI,desnutricion global,desnutricion grave (g),2005-02-01,1,2,0,1,1,3,4
50401,COLQUECHACA,desnutricion global,desnutricion grave (g),2005-02-01,8,9,6,1,14,10,24
21004,COLQUIRI,desnutricion global,desnutricion grave (g),2005-02-01,0,0,0,2,0,2,2
71301,COMARAPA,desnutricion global,desnutricion grave (g),2005-02-01,3,2,0,0,3,2,5
21402,CORIPATA,desnutricion global,desnutricion grave (g),2005-02-01,0,0,0,1,0,1,1
20301,CORO CORO,desnutricion global,desnutricion grave (g),2005-02-01,1,0,0,0,1,0,1
21401,COROICO,desnutricion global,desnutricion grave (g),2005-02-01,1,0,0,0,1,0,1
40301,CORQUE,desnutricion global,desnutricion grave (g),2005-02-01,0,1,0,0,0,1,1
50601,COTAGAITA,desnutricion global,desnutricion grave (g),2005-02-01,1,2,1,0,2,2,4
70102,COTOCA,desnutricion global,desnutricion grave (g),2005-02-01,1,3,0,0,1,3,4
71106,CUATRO CAÑADAS,desnutricion global,desnutricion grave (g),2005-02-01,2,0,0,1,2,1,3
70704,CUEVO,desnutricion global,desnutricion grave (g),2005-02-01,0,0,0,1,0,1,1
10902,CULPINA,desnutricion global,desnutricion grave (g),2005-02-01,3,3,3,2,6,5,11
20105,EL ALTO,desnutricion global,desnutricion grave (g),2005-02-01,25,10,8,6,33,16,49
60502,EL PUENTE(TJA),desnutricion global,desnutricion grave (g),2005-02-01,1,0,0,0,1,0,1
70105,EL TORNO,desnutricion global,desnutricion grave (g),2005-02-01,0,2,0,0,0,2,2
10405,EL VILLAR,desnutricion global,desnutricion grave (g),2005-02-01,0,0,1,1,1,1,2
60601,ENTRE RIOS,desnutricion global,desnutricion grave (g),2005-02-01,3,5,1,0,4,5,9
41101,EUCALIPTUS,desnutricion global,desnutricion grave (g),2005-02-01,1,0,0,0,1,0,1
80402,EXALTACION,desnutricion global,desnutricion grave (g),2005-02-01,0,0,0,1,0,1,1
71004,FERNANDEZ ALONSO,desnutricion global,desnutricion grave (g),2005-02-01,1,3,0,1,1,4,5
71002,GENERAL SAAVEDRA,desnutricion global,desnutricion grave (g),2005-02-01,2,0,1,0,3,0,3
21601,GRAL. J.J. PEREZ (CHARAZANI),desnutricion global,desnutricion grave (g),2005-02-01,0,0,1,1,1,1,2
20602,GUANAY,desnutricion global,desnutricion grave (g),2005-02-01,2,0,0,1,2,1,3
70705,GUTIERREZ,desnutricion global,desnutricion grave (g),2005-02-01,3,3,0,3,3,6,9
10502,HUACARETA,desnutricion global,desnutricion grave (g),2005-02-01,0,3,0,1,0,4,4
40701,HUANUNI,desnutricion global,desnutricion grave (g),2005-02-01,2,0,0,1,2,1,3
21005,ICHOCA,desnutricion global,desnutricion grave (g),2005-02-01,0,0,0,1,0,1,1
10304,ICLA,desnutricion global,desnutricion grave (g),2005-02-01,7,3,0,2,7,5,12
10703,INCAHUASI,desnutricion global,desnutricion grave (g),2005-02-01,9,5,3,5,12,10,22
21001,INQUISIVI,desnutricion global,desnutricion grave (g),2005-02-01,0,0,2,0,2,0,2
21102,IRUPANA (VILLA DE LANZA),desnutricion global,desnutricion grave (g),2005-02-01,0,0,1,1,1,1,2
21501,IXIAMAS,desnutricion global,desnutricion grave (g),2005-02-01,0,2,1,0,1,2,3
20806,JESUS DE MACHACA,desnutricion global,desnutricion grave (g),2005-02-01,0,0,1,0,1,0,1
21105,LA ASUNTA,desnutricion global,desnutricion grave (g),2005-02-01,1,2,2,3,3,5,8
70104,LA GUARDIA,desnutricion global,desnutricion grave (g),2005-02-01,4,4,2,0,6,4,10
20101,LA PAZ,desnutricion global,desnutricion grave (g),2005-02-01,12,6,4,3,16,9,25
70701,LAGUNILLAS,desnutricion global,desnutricion grave (g),2005-02-01,3,0,1,0,4,0,4
21202,LAJA,desnutricion global,desnutricion grave (g),2005-02-01,1,0,0,0,1,0,1
10903,LAS CARRERAS,desnutricion global,desnutricion grave (g),2005-02-01,0,0,1,0,1,0,1
50203,LLALLAGUA,desnutricion global,desnutricion grave (g),2005-02-01,1,4,2,1,3,5,8
20901,LURIBAY,desnutricion global,desnutricion grave (g),2005-02-01,0,1,0,0,0,1,1
11003,MACHARETI,desnutricion global,desnutricion grave (g),2005-02-01,0,1,0,1,0,2,2
80801,MAGDALENA,desnutricion global,desnutricion grave (g),2005-02-01,1,1,0,0,1,1,2
70903,MAIRANA,desnutricion global,desnutricion grave (g),2005-02-01,2,0,1,0,3,0,3
20607,MAPIRI,desnutricion global,desnutricion grave (g),2005-02-01,0,1,0,0,0,1,1
20103,MECAPACA,desnutricion global,desnutricion grave (g),2005-02-01,2,0,2,0,4,0,4
71003,MINEROS,desnutricion global,desnutricion grave (g),2005-02-01,2,0,1,0,3,0,3
31301,MIZQUE,desnutricion global,desnutricion grave (g),2005-02-01,4,6,0,2,4,8,12
10303,MOJOCOYA,desnutricion global,desnutricion grave (g),2005-02-01,2,0,0,0,2,0,2
10501,MONTEAGUDO,desnutricion global,desnutricion grave (g),2005-02-01,3,1,1,2,4,3,7
71001,MONTERO,desnutricion global,desnutricion grave (g),2005-02-01,8,4,5,3,13,7,20
30302,MOROCHATA,desnutricion global,desnutricion grave (g),2005-02-01,0,0,1,0,1,0,1
50404,OCURI,desnutricion global,desnutricion grave (g),2005-02-01,2,5,1,3,3,8,11
70202,OKINAWA,desnutricion global,desnutricion grave (g),2005-02-01,0,1,0,0,0,1,1
40101,ORURO,desnutricion global,desnutricion grave (g),2005-02-01,6,15,3,0,9,15,24
60201,PADCAYA,desnutricion global,desnutricion grave (g),2005-02-01,1,0,0,1,1,1,2
10401,PADILLA,desnutricion global,desnutricion grave (g),2005-02-01,3,1,1,3,4,4,8
70502,PAILON,desnutricion global,desnutricion grave (g),2005-02-01,0,0,6,0,6,0,6
20102,PALCA,desnutricion global,desnutricion grave (g),2005-02-01,3,2,3,1,6,3,9
21104,PALOS BLANCOS,desnutricion global,desnutricion grave (g),2005-02-01,3,1,2,2,5,3,8
21802,PAPEL PAMPA,desnutricion global,desnutricion grave (g),2005-02-01,0,0,1,0,1,0,1
30202,PASORAPA,desnutricion global,desnutricion grave (g),2005-02-01,1,0,0,2,1,2,3
21305,PATACAMAYA,desnutricion global,desnutricion grave (g),2005-02-01,1,1,0,0,1,1,2
20702,PELECHUCO,desnutricion global,desnutricion grave (g),2005-02-01,1,2,0,0,1,2,3
50403,POCOATA,desnutricion global,desnutricion grave (g),2005-02-01,3,3,2,2,5,5,10
31203,POCONA,desnutricion global,desnutricion grave (g),2005-02-01,2,0,0,0,2,0,2
40601,POOPO,desnutricion global,desnutricion grave (g),2005-02-01,0,1,0,0,0,1,1
51203,PORCO,desnutricion global,desnutricion grave (g),2005-02-01,1,0,0,0,1,0,1
10103,POROMA,desnutricion global,desnutricion grave (g),2005-02-01,2,6,1,2,3,8,11
90102,PORVENIR,desnutricion global,desnutricion grave (g),2005-02-01,1,0,0,0,1,0,1
50101,POTOSI,desnutricion global,desnutricion grave (g),2005-02-01,4,3,1,1,5,4,9
10302,PRESTO,desnutricion global,desnutricion grave (g),2005-02-01,4,3,2,2,6,5,11
20403,PUERTO CARABUCO,desnutricion global,desnutricion grave (g),2005-02-01,1,1,0,0,1,1,2
31205,PUERTO VILLARROEL,desnutricion global,desnutricion grave (g),2005-02-01,11,10,3,13,14,23,37
51101,PUNA,desnutricion global,desnutricion grave (g),2005-02-01,10,1,1,2,11,3,14
30901,QUILLACOLLO,desnutricion global,desnutricion grave (g),2005-02-01,4,7,0,0,4,7,11
21002,QUIME,desnutricion global,desnutricion grave (g),2005-02-01,0,3,0,0,0,3,3
70904,QUIRUSILLAS,desnutricion global,desnutricion grave (g),2005-02-01,0,2,0,0,0,2,2
50402,RAVELO,desnutricion global,desnutricion grave (g),2005-02-01,2,7,1,0,3,7,10
80301,REYES,desnutricion global,desnutricion grave (g),2005-02-01,0,2,0,1,0,3,3
80201,RIBERALTA,desnutricion global,desnutricion grave (g),2005-02-01,12,15,6,7,18,22,40
31001,SACABA,desnutricion global,desnutricion grave (g),2005-02-01,0,2,1,0,1,2,3
30404,SACABAMBA,desnutricion global,desnutricion grave (g),2005-02-01,0,1,0,0,0,1,1
50701,SACACA,desnutricion global,desnutricion grave (g),2005-02-01,8,3,3,1,11,4,15
71302,SAIPINA,desnutricion global,desnutricion grave (g),2005-02-01,1,0,0,0,1,0,1
70901,SAMAIPATA,desnutricion global,desnutricion grave (g),2005-02-01,1,0,0,0,1,0,1
80602,SAN ANDRES,desnutricion global,desnutricion grave (g),2005-02-01,1,1,0,0,1,1,2
71105,SAN ANTONIO DE LOMERIO,desnutricion global,desnutricion grave (g),2005-02-01,1,2,1,0,2,2,4
80302,SAN BORJA,desnutricion global,desnutricion grave (g),2005-02-01,3,4,3,2,6,6,12
21502,SAN BUENA VENTURA,desnutricion global,desnutricion grave (g),2005-02-01,0,2,0,2,0,4,4
80501,SAN IGNACIO,desnutricion global,desnutricion grave (g),2005-02-01,1,1,0,0,1,1,2
70301,SAN IGNACIO DE VELASCO,desnutricion global,desnutricion grave (g),2005-02-01,5,1,1,3,6,4,10
80102,SAN JAVIER(BNI),desnutricion global,desnutricion grave (g),2005-02-01,0,1,0,0,0,1,1
71102,SAN JAVIER(STC),desnutricion global,desnutricion grave (g),2005-02-01,1,0,1,0,2,0,2
70501,SAN JOSE DE CHIQUITOS,desnutricion global,desnutricion grave (g),2005-02-01,1,1,1,2,2,3,5
70404,SAN JUAN DE YAPACANI,desnutricion global,desnutricion grave (g),2005-02-01,0,1,0,0,0,1,1
71104,SAN JULIAN,desnutricion global,desnutricion grave (g),2005-02-01,3,3,1,0,4,3,7
90302,SAN LORENZO(PND),desnutricion global,desnutricion grave (g),2005-02-01,0,2,0,1,0,3,3
60501,SAN LORENZO(TJA),desnutricion global,desnutricion grave (g),2005-02-01,3,0,1,1,4,1,5
10702,SAN LUCAS,desnutricion global,desnutricion grave (g),2005-02-01,10,8,4,4,14,12,26
70302,SAN MIGUEL DE VELASCO,desnutricion global,desnutricion grave (g),2005-02-01,0,0,0,1,0,1,1
50501,SAN PEDRO DE BUENA VISTA,desnutricion global,desnutricion grave (g),2005-02-01,1,10,1,1,2,11,13
21702,SAN PEDRO DE TIQUINA,desnutricion global,desnutricion grave (g),2005-02-01,0,0,1,0,1,0,1
90202,SAN PEDRO(PND),desnutricion global,desnutricion grave (g),2005-02-01,0,0,0,3,0,3,3
70303,SAN RAFAEL,desnutricion global,desnutricion grave (g),2005-02-01,2,1,1,2,3,3,6
80401,SANTA ANA,desnutricion global,desnutricion grave (g),2005-02-01,2,0,0,0,2,0,2
70101,SANTA CRUZ DE LA SIERRA,desnutricion global,desnutricion grave (g),2005-02-01,57,34,13,16,70,50,120
70602,SANTA ROSA DEL SARA,desnutricion global,desnutricion grave (g),2005-02-01,1,0,1,0,2,0,2
41401,SANTIAGO DE HUARI,desnutricion global,desnutricion grave (g),2005-02-01,0,2,0,0,0,2,2
21901,SANTIAGO DE MACHACA,desnutricion global,desnutricion grave (g),2005-02-01,0,0,0,1,0,1,1
30702,SANTIVAÑES,desnutricion global,desnutricion grave (g),2005-02-01,0,0,0,1,0,1,1
20902,SAPAHAQUI,desnutricion global,desnutricion grave (g),2005-02-01,3,0,0,0,3,0,3
21301,SICA SICA (VILLA AROMA),desnutricion global,desnutricion grave (g),2005-02-01,0,0,0,1,0,1,1
30902,SIPE SIPE,desnutricion global,desnutricion grave (g),2005-02-01,7,2,1,0,8,2,10
10403,SOPACHUY,desnutricion global,desnutricion grave (g),2005-02-01,1,6,0,1,1,7,8
40104,SORACACHI,desnutricion global,desnutricion grave (g),2005-02-01,0,0,1,0,1,0,1
20601,SORATA,desnutricion global,desnutricion grave (g),2005-02-01,1,0,1,1,2,1,3
10101,SUCRE,desnutricion global,desnutricion grave (g),2005-02-01,1,4,0,3,1,7,8
30602,TACOPAYA,desnutricion global,desnutricion grave (g),2005-02-01,2,0,1,0,3,0,3
31101,TAPACARI,desnutricion global,desnutricion grave (g),2005-02-01,3,2,5,0,8,2,10
10601,TARABUCO,desnutricion global,desnutricion grave (g),2005-02-01,10,8,4,6,14,14,28
30401,TARATA,desnutricion global,desnutricion grave (g),2005-02-01,1,0,0,0,1,0,1
60101,TARIJA,desnutricion global,desnutricion grave (g),2005-02-01,1,4,0,0,1,4,5
10202,TARVITA,desnutricion global,desnutricion grave (g),2005-02-01,1,2,2,0,3,2,5
20608,TEOPONTE,desnutricion global,desnutricion grave (g),2005-02-01,1,1,2,0,3,1,4
50102,TINGUIPAYA,desnutricion global,desnutricion grave (g),2005-02-01,3,0,2,1,5,1,6
30903,TIQUIPAYA,desnutricion global,desnutricion grave (g),2005-02-01,2,0,0,0,2,0,2
31601,TIRAQUE (CBBA),desnutricion global,desnutricion grave (g),2005-02-01,5,3,0,1,5,4,9
51202,TOMAVE,desnutricion global,desnutricion grave (g),2005-02-01,2,2,2,0,4,2,6
10402,TOMINA,desnutricion global,desnutricion grave (g),2005-02-01,0,0,1,5,1,5,6
50502,TORO TORO,desnutricion global,desnutricion grave (g),2005-02-01,3,6,1,0,4,6,10
31201,TOTORA(CBBA),desnutricion global,desnutricion grave (g),2005-02-01,1,0,0,4,1,4,5
41301,TOTORA(ORR),desnutricion global,desnutricion grave (g),2005-02-01,0,1,0,0,0,1,1
80101,TRINIDAD,desnutricion global,desnutricion grave (g),2005-02-01,7,5,4,7,11,12,23
50801,TUPIZA,desnutricion global,desnutricion grave (g),2005-02-01,5,4,0,0,5,4,9
21302,UMALA,desnutricion global,desnutricion grave (g),2005-02-01,0,1,0,0,0,1,1
50201,UNCIA,desnutricion global,desnutricion grave (g),2005-02-01,1,1,0,0,1,1,2
60401,URIONDO (A. CONCEPCION),desnutricion global,desnutricion grave (g),2005-02-01,1,0,1,0,2,0,2
30502,VACAS,desnutricion global,desnutricion grave (g),2005-02-01,2,2,1,0,3,2,5
70801,VALLEGRANDE,desnutricion global,desnutricion grave (g),2005-02-01,1,0,0,0,1,0,1
20801,VIACHA,desnutricion global,desnutricion grave (g),2005-02-01,1,10,2,4,3,14,17
31302,VILA VILA,desnutricion global,desnutricion grave (g),2005-02-01,1,0,1,1,2,1,3
60303,VILLA MONTES,desnutricion global,desnutricion grave (g),2005-02-01,4,0,4,1,8,1,9
10801,VILLA SERRANO,desnutricion global,desnutricion grave (g),2005-02-01,5,0,2,2,7,2,9
31003,VILLA TUNARI,desnutricion global,desnutricion grave (g),2005-02-01,2,3,4,5,6,8,14
11001,VILLA VACA GUZMAN (MUYUPAMPA),desnutricion global,desnutricion grave (g),2005-02-01,0,0,0,1,0,1,1
51501,VILLAZON,desnutricion global,desnutricion grave (g),2005-02-01,1,3,0,1,1,4,5
30904,VINTO,desnutricion global,desnutricion grave (g),2005-02-01,2,0,0,0,2,0,2
50602,VITICHI,desnutricion global,desnutricion grave (g),2005-02-01,3,1,0,0,3,1,4
70201,WARNES,desnutricion global,desnutricion grave (g),2005-02-01,1,1,0,1,1,2,3
60301,YACUIBA,desnutricion global,desnutricion grave (g),2005-02-01,2,1,1,0,3,1,4
10602,YAMPARAEZ,desnutricion global,desnutricion grave (g),2005-02-01,2,1,1,4,3,5,8
70403,YAPACANI,desnutricion global,desnutricion grave (g),2005-02-01,3,5,0,1,3,6,9
10102,YOTALA,desnutricion global,desnutricion grave (g),2005-02-01,3,0,1,0,4,0,4
60402,YUNCHARA,desnutricion global,desnutricion grave (g),2005-02-01,0,0,0,1,0,1,1
10301,ZUDAÑEZ,desnutricion global,desnutricion grave (g),2005-02-01,2,0,1,3,3,3,6
51302,ACACIO,desnutricion global,desnutricion grave (g),2005-03-01,0,1,0,0,0,1,1
20201,ACHACACHI,desnutricion global,desnutricion grave (g),2005-03-01,0,0,1,2,1,2,3
20104,ACHOCALLA,desnutricion global,desnutricion grave (g),2005-03-01,0,1,1,0,1,1,2
30201,AIQUILE,desnutricion global,desnutricion grave (g),2005-03-01,0,1,3,0,3,1,4
10404,ALCALA,desnutricion global,desnutricion grave (g),2005-03-01,1,0,0,1,1,1,2
20202,ANCORAIMES,desnutricion global,desnutricion grave (g),2005-03-01,1,1,1,0,2,1,3
30402,ANZALDO,desnutricion global,desnutricion grave (g),2005-03-01,2,1,0,0,2,1,3
20701,APOLO,desnutricion global,desnutricion grave (g),2005-03-01,0,1,0,0,0,1,1
51301,ARAMPAMPA,desnutricion global,desnutricion grave (g),2005-03-01,0,0,0,1,0,1,1
30501,ARANI,desnutricion global,desnutricion grave (g),2005-03-01,1,1,3,2,4,3,7
30403,ARBIETO,desnutricion global,desnutricion grave (g),2005-03-01,2,0,0,0,2,0,2
30601,ARQUE,desnutricion global,desnutricion grave (g),2005-03-01,0,0,0,1,0,1,1
50802,ATOCHA,desnutricion global,desnutricion grave (g),2005-03-01,5,3,0,1,5,4,9
20503,AUCAPATA,desnutricion global,desnutricion grave (g),2005-03-01,3,0,0,0,3,0,3
20502,AYATA,desnutricion global,desnutricion grave (g),2005-03-01,3,3,1,0,4,3,7
30301,AYOPAYA (V. DE INDEPENDENCIA),desnutricion global,desnutricion grave (g),2005-03-01,8,6,0,2,8,8,16
10201,AZURDUY,desnutricion global,desnutricion grave (g),2005-03-01,3,5,3,1,6,6,12
21203,BATALLAS,desnutricion global,desnutricion grave (g),2005-03-01,1,0,0,0,1,0,1
60202,BERMEJO,desnutricion global,desnutricion grave (g),2005-03-01,1,0,0,0,1,0,1
50301,BETANZOS,desnutricion global,desnutricion grave (g),2005-03-01,9,6,2,3,11,9,20
31501,BOLIVAR,desnutricion global,desnutricion grave (g),2005-03-01,0,2,0,0,0,2,2
70401,BUENA VISTA,desnutricion global,desnutricion grave (g),2005-03-01,1,0,0,0,1,0,1
70703,CABEZAS,desnutricion global,desnutricion grave (g),2005-03-01,1,2,1,0,2,2,4
20905,CAIROMA,desnutricion global,desnutricion grave (g),2005-03-01,5,2,1,2,6,4,10
51102,"CAIZA ""D""",desnutricion global,desnutricion grave (g),2005-03-01,0,1,1,0,1,1,2
21003,CAJUATA,desnutricion global,desnutricion grave (g),2005-03-01,0,0,0,1,0,1,1
21304,CALAMARCA,desnutricion global,desnutricion grave (g),2005-03-01,3,2,1,0,4,2,6
10701,CAMARGO,desnutricion global,desnutricion grave (g),2005-03-01,5,2,0,0,5,2,7
10901,CAMATAQUI (C. VILLA ABECIA),desnutricion global,desnutricion grave (g),2005-03-01,0,1,0,0,0,1,1
70706,CAMIRI,desnutricion global,desnutricion grave (g),2005-03-01,5,7,3,9,8,16,24
30701,CAPINOTA,desnutricion global,desnutricion grave (g),2005-03-01,3,1,0,4,3,5,8
40102,CARACOLLO,desnutricion global,desnutricion grave (g),2005-03-01,1,1,0,1,1,2,3
22001,CARANAVI,desnutricion global,desnutricion grave (g),2005-03-01,8,4,2,0,10,4,14
60302,CARAPARI,desnutricion global,desnutricion grave (g),2005-03-01,1,0,0,0,1,0,1
50702,CARIPUYO,desnutricion global,desnutricion grave (g),2005-03-01,6,5,5,4,11,9,20
40201,CHALLAPATA,desnutricion global,desnutricion grave (g),2005-03-01,7,4,3,6,10,10,20
50302,CHAQUI,desnutricion global,desnutricion grave (g),2005-03-01,0,1,0,1,0,2,2
70702,CHARAGUA,desnutricion global,desnutricion grave (g),2005-03-01,5,5,3,3,8,8,16
50202,CHAYANTA,desnutricion global,desnutricion grave (g),2005-03-01,11,3,2,3,13,6,19
40903,CHIPAYA,desnutricion global,desnutricion grave (g),2005-03-01,0,0,1,0,1,0,1
21101,CHULUMANI (V. DE LA LIBERTAD),desnutricion global,desnutricion grave (g),2005-03-01,1,1,0,0,1,1,2
20501,CHUMA,desnutricion global,desnutricion grave (g),2005-03-01,1,0,0,1,1,1,2
30801,CLIZA,desnutricion global,desnutricion grave (g),2005-03-01,1,1,0,0,1,1,2
90101,COBIJA,desnutricion global,desnutricion grave (g),2005-03-01,1,1,0,1,1,2,3
30101,COCHABAMBA,desnutricion global,desnutricion grave (g),2005-03-01,14,13,2,1,16,14,30
30905,COLCAPIRHUA,desnutricion global,desnutricion grave (g),2005-03-01,0,3,0,0,0,3,3
31002,COLOMI,desnutricion global,desnutricion grave (g),2005-03-01,8,2,0,1,8,3,11
70603,COLPA BELGICA,desnutricion global,desnutricion grave (g),2005-03-01,0,1,0,0,0,1,1
50401,COLQUECHACA,desnutricion global,desnutricion grave (g),2005-03-01,11,10,2,3,13,13,26
21004,COLQUIRI,desnutricion global,desnutricion grave (g),2005-03-01,0,1,0,3,0,4,4
20304,COMANCHE,desnutricion global,desnutricion grave (g),2005-03-01,0,0,1,0,1,0,1
71301,COMARAPA,desnutricion global,desnutricion grave (g),2005-03-01,4,1,1,1,5,2,7
21402,CORIPATA,desnutricion global,desnutricion grave (g),2005-03-01,0,0,0,2,0,2,2
21401,COROICO,desnutricion global,desnutricion grave (g),2005-03-01,0,2,0,0,0,2,2
50601,COTAGAITA,desnutricion global,desnutricion grave (g),2005-03-01,1,2,0,2,1,4,5
70102,COTOCA,desnutricion global,desnutricion grave (g),2005-03-01,5,2,3,1,8,3,11
70704,CUEVO,desnutricion global,desnutricion grave (g),2005-03-01,1,0,0,0,1,0,1
10902,CULPINA,desnutricion global,desnutricion grave (g),2005-03-01,4,6,4,1,8,7,15
21602,CURVA,desnutricion global,desnutricion grave (g),2005-03-01,0,0,0,1,0,1,1
20105,EL ALTO,desnutricion global,desnutricion grave (g),2005-03-01,36,35,16,6,52,41,93
60502,EL PUENTE(TJA),desnutricion global,desnutricion grave (g),2005-03-01,0,1,0,2,0,3,3
70105,EL TORNO,desnutricion global,desnutricion grave (g),2005-03-01,0,1,0,0,0,1,1
10405,EL VILLAR,desnutricion global,desnutricion grave (g),2005-03-01,0,0,0,4,0,4,4
60601,ENTRE RIOS,desnutricion global,desnutricion grave (g),2005-03-01,3,10,0,3,3,13,16
60601,ENTRE RIOS,desnutricion global,desnutricion grave (g),2005-03-01,1,0,0,1,1,1,2
41101,EUCALIPTUS,desnutricion global,desnutricion grave (g),2005-03-01,2,0,0,0,2,0,2
80402,EXALTACION,desnutricion global,desnutricion grave (g),2005-03-01,0,0,1,0,1,0,1
71004,FERNANDEZ ALONSO,desnutricion global,desnutricion grave (g),2005-03-01,0,3,0,0,0,3,3
90203,FILADELFIA,desnutricion global,desnutricion grave (g),2005-03-01,0,2,0,1,0,3,3
71002,GENERAL SAAVEDRA,desnutricion global,desnutricion grave (g),2005-03-01,7,0,2,0,9,0,9
21601,GRAL. J.J. PEREZ (CHARAZANI),desnutricion global,desnutricion grave (g),2005-03-01,1,2,1,2,2,4,6
20602,GUANAY,desnutricion global,desnutricion grave (g),2005-03-01,2,1,1,0,3,1,4
70705,GUTIERREZ,desnutricion global,desnutricion grave (g),2005-03-01,1,2,2,2,3,4,7
10502,HUACARETA,desnutricion global,desnutricion grave (g),2005-03-01,3,3,0,1,3,4,7
11002,HUACAYA (VILLA DE HUACAYA),desnutricion global,desnutricion grave (g),2005-03-01,1,0,1,0,2,0,2
40701,HUANUNI,desnutricion global,desnutricion grave (g),2005-03-01,1,0,1,1,2,1,3
41601,HUAYLLAMARCA,desnutricion global,desnutricion grave (g),2005-03-01,0,0,0,1,0,1,1
21005,ICHOCA,desnutricion global,desnutricion grave (g),2005-03-01,0,0,1,0,1,0,1
10304,ICLA,desnutricion global,desnutricion grave (g),2005-03-01,8,2,3,5,11,7,18
10703,INCAHUASI,desnutricion global,desnutricion grave (g),2005-03-01,9,10,5,5,14,15,29
21001,INQUISIVI,desnutricion global,desnutricion grave (g),2005-03-01,0,0,1,1,1,1,2
21102,IRUPANA (VILLA DE LANZA),desnutricion global,desnutricion grave (g),2005-03-01,1,0,1,0,2,0,2
21501,IXIAMAS,desnutricion global,desnutricion grave (g),2005-03-01,1,2,1,0,2,2,4
20806,JESUS DE MACHACA,desnutricion global,desnutricion grave (g),2005-03-01,1,0,1,1,2,1,3
21105,LA ASUNTA,desnutricion global,desnutricion grave (g),2005-03-01,2,1,0,0,2,1,3
70104,LA GUARDIA,desnutricion global,desnutricion grave (g),2005-03-01,2,5,0,0,2,5,7
20101,LA PAZ,desnutricion global,desnutricion grave (g),2005-03-01,24,9,6,10,30,19,49
70701,LAGUNILLAS,desnutricion global,desnutricion grave (g),2005-03-01,2,5,1,2,3,7,10
21202,LAJA,desnutricion global,desnutricion grave (g),2005-03-01,1,0,0,0,1,0,1
10903,LAS CARRERAS,desnutricion global,desnutricion grave (g),2005-03-01,1,1,0,0,1,1,2
50203,LLALLAGUA,desnutricion global,desnutricion grave (g),2005-03-01,6,2,1,3,7,5,12
51401,LLICA,desnutricion global,desnutricion grave (g),2005-03-01,0,1,0,0,0,1,1
20901,LURIBAY,desnutricion global,desnutricion grave (g),2005-03-01,0,1,0,2,0,3,3
40702,MACHACAMARCA,desnutricion global,desnutricion grave (g),2005-03-01,1,1,0,0,1,1,2
11003,MACHARETI,desnutricion global,desnutricion grave (g),2005-03-01,0,0,0,1,0,1,1
70903,MAIRANA,desnutricion global,desnutricion grave (g),2005-03-01,0,0,1,0,1,0,1
20904,MALLA,desnutricion global,desnutricion grave (g),2005-03-01,1,2,0,0,1,2,3
20607,MAPIRI,desnutricion global,desnutricion grave (g),2005-03-01,1,0,0,0,1,0,1
20103,MECAPACA,desnutricion global,desnutricion grave (g),2005-03-01,1,1,0,1,1,2,3
71003,MINEROS,desnutricion global,desnutricion grave (g),2005-03-01,7,0,1,0,8,0,8
31301,MIZQUE,desnutricion global,desnutricion grave (g),2005-03-01,2,8,3,0,5,8,13
20402,MOCOMOCO,desnutricion global,desnutricion grave (g),2005-03-01,3,0,1,0,4,0,4
10303,MOJOCOYA,desnutricion global,desnutricion grave (g),2005-03-01,3,0,0,1,3,1,4
10501,MONTEAGUDO,desnutricion global,desnutricion grave (g),2005-03-01,2,0,6,4,8,4,12
71001,MONTERO,desnutricion global,desnutricion grave (g),2005-03-01,17,4,12,3,29,7,36
70803,MORO MORO,desnutricion global,desnutricion grave (g),2005-03-01,1,0,0,0,1,0,1
30302,MOROCHATA,desnutricion global,desnutricion grave (g),2005-03-01,1,5,0,0,1,5,6
50404,OCURI,desnutricion global,desnutricion grave (g),2005-03-01,17,8,6,7,23,15,38
30203,OMEREQUE,desnutricion global,desnutricion grave (g),2005-03-01,0,0,0,1,0,1,1
40101,ORURO,desnutricion global,desnutricion grave (g),2005-03-01,10,7,7,3,17,10,27
10401,PADILLA,desnutricion global,desnutricion grave (g),2005-03-01,2,2,0,3,2,5,7
70502,PAILON,desnutricion global,desnutricion grave (g),2005-03-01,0,1,1,0,1,1,2
20102,PALCA,desnutricion global,desnutricion grave (g),2005-03-01,3,4,2,4,5,8,13
21104,PALOS BLANCOS,desnutricion global,desnutricion grave (g),2005-03-01,4,2,1,3,5,5,10
40802,PAMPA AULLAGAS,desnutricion global,desnutricion grave (g),2005-03-01,0,1,0,0,0,1,1
21305,PATACAMAYA,desnutricion global,desnutricion grave (g),2005-03-01,0,1,0,0,0,1,1
20702,PELECHUCO,desnutricion global,desnutricion grave (g),2005-03-01,2,1,0,0,2,1,3
50403,POCOATA,desnutricion global,desnutricion grave (g),2005-03-01,4,2,3,4,7,6,13
31203,POCONA,desnutricion global,desnutricion grave (g),2005-03-01,0,0,1,1,1,1,2
31202,POJO (CBBA),desnutricion global,desnutricion grave (g),2005-03-01,0,1,0,0,0,1,1
40601,POOPO,desnutricion global,desnutricion grave (g),2005-03-01,1,0,0,0,1,0,1
51203,PORCO,desnutricion global,desnutricion grave (g),2005-03-01,1,1,0,0,1,1,2
10103,POROMA,desnutricion global,desnutricion grave (g),2005-03-01,8,3,4,2,12,5,17
70103,PORONGO,desnutricion global,desnutricion grave (g),2005-03-01,2,1,0,0,2,1,3
90102,PORVENIR,desnutricion global,desnutricion grave (g),2005-03-01,2,0,0,0,2,0,2
50101,POTOSI,desnutricion global,desnutricion grave (g),2005-03-01,17,3,1,1,18,4,22
10302,PRESTO,desnutricion global,desnutricion grave (g),2005-03-01,7,1,2,0,9,1,10
21201,PUCARANI,desnutricion global,desnutricion grave (g),2005-03-01,1,0,0,0,1,0,1
20401,PUERTO ACOSTA,desnutricion global,desnutricion grave (g),2005-03-01,1,2,0,0,1,2,3
20403,PUERTO CARABUCO,desnutricion global,desnutricion grave (g),2005-03-01,3,2,3,2,6,4,10
90301,PUERTO GONZALO MORENO,desnutricion global,desnutricion grave (g),2005-03-01,2,1,0,0,2,1,3
90201,PUERTO RICO,desnutricion global,desnutricion grave (g),2005-03-01,1,0,0,0,1,0,1
31205,PUERTO VILLARROEL,desnutricion global,desnutricion grave (g),2005-03-01,12,7,8,8,20,15,35
51101,PUNA,desnutricion global,desnutricion grave (g),2005-03-01,4,10,5,1,9,11,20
31401,PUNATA,desnutricion global,desnutricion grave (g),2005-03-01,1,2,0,3,1,5,6
20604,QUIABAYA,desnutricion global,desnutricion grave (g),2005-03-01,1,0,0,0,1,0,1
30901,QUILLACOLLO,desnutricion global,desnutricion grave (g),2005-03-01,2,5,4,3,6,8,14
50402,RAVELO,desnutricion global,desnutricion grave (g),2005-03-01,10,13,1,3,11,16,27
80301,REYES,desnutricion global,desnutricion grave (g),2005-03-01,2,0,0,0,2,0,2
80201,RIBERALTA,desnutricion global,desnutricion grave (g),2005-03-01,12,28,10,8,22,36,58
70503,ROBORE,desnutricion global,desnutricion grave (g),2005-03-01,0,1,1,0,1,1,2
80304,RURRENABAQUE,desnutricion global,desnutricion grave (g),2005-03-01,1,0,0,0,1,0,1
40901,SABAYA,desnutricion global,desnutricion grave (g),2005-03-01,0,1,0,0,0,1,1
31001,SACABA,desnutricion global,desnutricion grave (g),2005-03-01,2,1,1,2,3,3,6
50701,SACACA,desnutricion global,desnutricion grave (g),2005-03-01,8,7,7,5,15,12,27
71302,SAIPINA,desnutricion global,desnutricion grave (g),2005-03-01,3,1,0,0,3,1,4
40801,SALINAS DE GARCI MENDOZA,desnutricion global,desnutricion grave (g),2005-03-01,1,0,0,1,1,1,2
70901,SAMAIPATA,desnutricion global,desnutricion grave (g),2005-03-01,2,0,1,0,3,0,3
80602,SAN ANDRES,desnutricion global,desnutricion grave (g),2005-03-01,1,2,0,0,1,2,3
71105,SAN ANTONIO DE LOMERIO,desnutricion global,desnutricion grave (g),2005-03-01,0,0,0,1,0,1,1
80302,SAN BORJA,desnutricion global,desnutricion grave (g),2005-03-01,2,5,2,2,4,7,11
21502,SAN BUENA VENTURA,desnutricion global,desnutricion grave (g),2005-03-01,2,1,0,2,2,3,5
70402,SAN CARLOS,desnutricion global,desnutricion grave (g),2005-03-01,2,1,1,2,3,3,6
80501,SAN IGNACIO,desnutricion global,desnutricion grave (g),2005-03-01,1,1,0,1,1,2,3
70301,SAN IGNACIO DE VELASCO,desnutricion global,desnutricion grave (g),2005-03-01,7,14,3,9,10,23,33
80102,SAN JAVIER(BNI),desnutricion global,desnutricion grave (g),2005-03-01,0,0,0,1,0,1,1
70501,SAN JOSE DE CHIQUITOS,desnutricion global,desnutricion grave (g),2005-03-01,2,3,0,1,2,4,6
71104,SAN JULIAN,desnutricion global,desnutricion grave (g),2005-03-01,1,2,1,1,2,3,5
90302,SAN LORENZO(PND),desnutricion global,desnutricion grave (g),2005-03-01,1,0,0,0,1,0,1
60501,SAN LORENZO(TJA),desnutricion global,desnutricion grave (g),2005-03-01,1,2,1,1,2,3,5
10702,SAN LUCAS,desnutricion global,desnutricion grave (g),2005-03-01,13,11,9,16,22,27,49
70302,SAN MIGUEL DE VELASCO,desnutricion global,desnutricion grave (g),2005-03-01,1,2,1,0,2,2,4
71005,SAN PEDRO,desnutricion global,desnutricion grave (g),2005-03-01,2,0,0,0,2,0,2
50501,SAN PEDRO DE BUENA VISTA,desnutricion global,desnutricion grave (g),2005-03-01,6,9,6,2,12,11,23
70303,SAN RAFAEL,desnutricion global,desnutricion grave (g),2005-03-01,1,2,2,0,3,2,5
80401,SANTA ANA,desnutricion global,desnutricion grave (g),2005-03-01,2,0,0,1,2,1,3
70101,SANTA CRUZ DE LA SIERRA,desnutricion global,desnutricion grave (g),2005-03-01,78,62,15,21,93,83,176
80303,SANTA ROSA,desnutricion global,desnutricion grave (g),2005-03-01,2,1,0,0,2,1,3
70602,SANTA ROSA DEL SARA,desnutricion global,desnutricion grave (g),2005-03-01,3,0,2,0,5,0,5
20308,SANTIAGO DE CALLAPA,desnutricion global,desnutricion grave (g),2005-03-01,1,0,0,0,1,0,1
21901,SANTIAGO DE MACHACA,desnutricion global,desnutricion grave (g),2005-03-01,0,0,0,1,0,1,1
30702,SANTIVAÑES,desnutricion global,desnutricion grave (g),2005-03-01,1,0,0,0,1,0,1
90303,SENA,desnutricion global,desnutricion grave (g),2005-03-01,0,1,0,0,0,1,1
21301,SICA SICA (VILLA AROMA),desnutricion global,desnutricion grave (g),2005-03-01,2,1,2,1,4,2,6
30902,SIPE SIPE,desnutricion global,desnutricion grave (g),2005-03-01,7,5,4,3,11,8,19
10403,SOPACHUY,desnutricion global,desnutricion grave (g),2005-03-01,1,3,0,7,1,10,11
20601,SORATA,desnutricion global,desnutricion grave (g),2005-03-01,0,1,0,0,0,1,1
10101,SUCRE,desnutricion global,desnutricion grave (g),2005-03-01,13,11,12,12,25,23,48
50303,TACOBAMBA,desnutricion global,desnutricion grave (g),2005-03-01,1,0,1,0,2,0,2
30602,TACOPAYA,desnutricion global,desnutricion grave (g),2005-03-01,0,2,0,0,0,2,2
31101,TAPACARI,desnutricion global,desnutricion grave (g),2005-03-01,2,5,0,1,2,6,8
10601,TARABUCO,desnutricion global,desnutricion grave (g),2005-03-01,16,14,6,5,22,19,41
30401,TARATA,desnutricion global,desnutricion grave (g),2005-03-01,0,1,0,1,0,2,2
60101,TARIJA,desnutricion global,desnutricion grave (g),2005-03-01,4,3,0,3,4,6,10
10202,TARVITA,desnutricion global,desnutricion grave (g),2005-03-01,4,6,2,2,6,8,14
20608,TEOPONTE,desnutricion global,desnutricion grave (g),2005-03-01,1,2,1,2,2,4,6
20803,TIAWANACU,desnutricion global,desnutricion grave (g),2005-03-01,0,0,0,1,0,1,1
50102,TINGUIPAYA,desnutricion global,desnutricion grave (g),2005-03-01,12,12,8,8,20,20,40
20606,TIPUANI,desnutricion global,desnutricion grave (g),2005-03-01,0,0,0,1,0,1,1
30903,TIQUIPAYA,desnutricion global,desnutricion grave (g),2005-03-01,1,0,0,0,1,0,1
31601,TIRAQUE (CBBA),desnutricion global,desnutricion grave (g),2005-03-01,7,5,3,2,10,7,17
51202,TOMAVE,desnutricion global,desnutricion grave (g),2005-03-01,2,1,0,0,2,1,3
10402,TOMINA,desnutricion global,desnutricion grave (g),2005-03-01,0,1,2,2,2,3,5
50502,TORO TORO,desnutricion global,desnutricion grave (g),2005-03-01,2,5,1,0,3,5,8
31201,TOTORA(CBBA),desnutricion global,desnutricion grave (g),2005-03-01,1,0,0,2,1,2,3
41301,TOTORA(ORR),desnutricion global,desnutricion grave (g),2005-03-01,0,0,1,0,1,0,1
80101,TRINIDAD,desnutricion global,desnutricion grave (g),2005-03-01,2,3,0,1,2,4,6
50801,TUPIZA,desnutricion global,desnutricion grave (g),2005-03-01,5,1,1,0,6,1,7
40402,TURCO,desnutricion global,desnutricion grave (g),2005-03-01,1,0,0,0,1,0,1
21302,UMALA,desnutricion global,desnutricion grave (g),2005-03-01,0,0,0,1,0,1,1
50201,UNCIA,desnutricion global,desnutricion grave (g),2005-03-01,1,2,0,0,1,2,3
60401,URIONDO (A. CONCEPCION),desnutricion global,desnutricion grave (g),2005-03-01,2,0,0,0,2,0,2
51201,UYUNI,desnutricion global,desnutricion grave (g),2005-03-01,2,3,2,1,4,4,8
30502,VACAS,desnutricion global,desnutricion grave (g),2005-03-01,2,1,0,0,2,1,3
70801,VALLEGRANDE,desnutricion global,desnutricion grave (g),2005-03-01,2,0,1,2,3,2,5
20801,VIACHA,desnutricion global,desnutricion grave (g),2005-03-01,4,6,7,5,11,11,22
31302,VILA VILA,desnutricion global,desnutricion grave (g),2005-03-01,1,2,0,0,1,2,3
60303,VILLA MONTES,desnutricion global,desnutricion grave (g),2005-03-01,3,0,3,0,6,0,6
31402,VILLA RIVERO,desnutricion global,desnutricion grave (g),2005-03-01,1,1,1,0,2,1,3
10801,VILLA SERRANO,desnutricion global,desnutricion grave (g),2005-03-01,1,2,2,1,3,3,6
31003,VILLA TUNARI,desnutricion global,desnutricion grave (g),2005-03-01,7,7,2,1,9,8,17
11001,VILLA VACA GUZMAN (MUYUPAMPA),desnutricion global,desnutricion grave (g),2005-03-01,1,0,0,0,1,0,1
51501,VILLAZON,desnutricion global,desnutricion grave (g),2005-03-01,1,1,0,0,1,1,2
30904,VINTO,desnutricion global,desnutricion grave (g),2005-03-01,5,0,0,0,5,0,5
70201,WARNES,desnutricion global,desnutricion grave (g),2005-03-01,0,5,0,3,0,8,8
20903,YACO,desnutricion global,desnutricion grave (g),2005-03-01,0,1,0,0,0,1,1
60301,YACUIBA,desnutricion global,desnutricion grave (g),2005-03-01,1,2,4,0,5,2,7
10602,YAMPARAEZ,desnutricion global,desnutricion grave (g),2005-03-01,6,1,1,3,7,4,11
70403,YAPACANI,desnutricion global,desnutricion grave (g),2005-03-01,3,6,1,2,4,8,12
50103,YOCALLA,desnutricion global,desnutricion grave (g),2005-03-01,0,1,1,1,1,2,3
10102,YOTALA,desnutricion global,desnutricion grave (g),2005-03-01,2,1,1,0,3,1,4
10301,ZUDAÑEZ,desnutricion global,desnutricion grave (g),2005-03-01,4,2,1,0,5,2,7
51302,ACACIO,desnutricion global,desnutricion grave (g),2005-04-01,4,4,0,1,4,5,9
20201,ACHACACHI,desnutricion global,desnutricion grave (g),2005-04-01,0,0,0,2,0,2,2
20104,ACHOCALLA,desnutricion global,desnutricion grave (g),2005-04-01,0,0,0,2,0,2,2
30201,AIQUILE,desnutricion global,desnutricion grave (g),2005-04-01,1,1,3,1,4,2,6
31303,ALALAY,desnutricion global,desnutricion grave (g),2005-04-01,0,1,0,0,0,1,1
10404,ALCALA,desnutricion global,desnutricion grave (g),2005-04-01,0,1,1,3,1,4,5
20202,ANCORAIMES,desnutricion global,desnutricion grave (g),2005-04-01,1,0,0,1,1,1,2
41201,ANDAMARCA,desnutricion global,desnutricion grave (g),2005-04-01,1,0,0,0,1,0,1
40603,ANTEQUERA,desnutricion global,desnutricion grave (g),2005-04-01,0,1,0,1,0,2,2
30402,ANZALDO,desnutricion global,desnutricion grave (g),2005-04-01,1,0,0,1,1,1,2
20701,APOLO,desnutricion global,desnutricion grave (g),2005-04-01,0,5,1,1,1,6,7
51301,ARAMPAMPA,desnutricion global,desnutricion grave (g),2005-04-01,2,0,0,1,2,1,3
30501,ARANI,desnutricion global,desnutricion grave (g),2005-04-01,1,2,0,0,1,2,3
30403,ARBIETO,desnutricion global,desnutricion grave (g),2005-04-01,0,0,1,0,1,0,1
30601,ARQUE,desnutricion global,desnutricion grave (g),2005-04-01,2,0,0,0,2,0,2
50802,ATOCHA,desnutricion global,desnutricion grave (g),2005-04-01,2,2,0,1,2,3,5
20503,AUCAPATA,desnutricion global,desnutricion grave (g),2005-04-01,2,0,0,0,2,0,2
20502,AYATA,desnutricion global,desnutricion grave (g),2005-04-01,1,1,0,1,1,2,3
21303,AYO AYO,desnutricion global,desnutricion grave (g),2005-04-01,1,0,1,0,2,0,2
30301,AYOPAYA (V. DE INDEPENDENCIA),desnutricion global,desnutricion grave (g),2005-04-01,3,1,1,0,4,1,5
10201,AZURDUY,desnutricion global,desnutricion grave (g),2005-04-01,5,3,3,0,8,3,11
21203,BATALLAS,desnutricion global,desnutricion grave (g),2005-04-01,1,0,0,0,1,0,1
50104,BELEN DE URMIRI,desnutricion global,desnutricion grave (g),2005-04-01,1,0,0,0,1,0,1
50301,BETANZOS,desnutricion global,desnutricion grave (g),2005-04-01,6,10,2,1,8,11,19
31501,BOLIVAR,desnutricion global,desnutricion grave (g),2005-04-01,2,5,0,3,2,8,10
70401,BUENA VISTA,desnutricion global,desnutricion grave (g),2005-04-01,0,2,0,0,0,2,2
70703,CABEZAS,desnutricion global,desnutricion grave (g),2005-04-01,0,1,0,0,0,1,1
20905,CAIROMA,desnutricion global,desnutricion grave (g),2005-04-01,3,1,0,0,3,1,4
20303,CALACOTO,desnutricion global,desnutricion grave (g),2005-04-01,1,0,0,0,1,0,1
21304,CALAMARCA,desnutricion global,desnutricion grave (g),2005-04-01,4,0,1,2,5,2,7
10701,CAMARGO,desnutricion global,desnutricion grave (g),2005-04-01,2,3,0,0,2,3,5
70706,CAMIRI,desnutricion global,desnutricion grave (g),2005-04-01,3,1,0,0,3,1,4
30701,CAPINOTA,desnutricion global,desnutricion grave (g),2005-04-01,1,1,0,1,1,2,3
20302,CAQUIAVIRI,desnutricion global,desnutricion grave (g),2005-04-01,0,1,0,0,0,1,1
40102,CARACOLLO,desnutricion global,desnutricion grave (g),2005-04-01,0,0,1,0,1,0,1
22001,CARANAVI,desnutricion global,desnutricion grave (g),2005-04-01,4,5,0,1,4,6,10
60302,CARAPARI,desnutricion global,desnutricion grave (g),2005-04-01,0,0,0,1,0,1,1
50702,CARIPUYO,desnutricion global,desnutricion grave (g),2005-04-01,3,10,4,2,7,12,19
40201,CHALLAPATA,desnutricion global,desnutricion grave (g),2005-04-01,2,1,1,2,3,3,6
50302,CHAQUI,desnutricion global,desnutricion grave (g),2005-04-01,1,0,0,0,1,0,1
70702,CHARAGUA,desnutricion global,desnutricion grave (g),2005-04-01,3,0,3,2,6,2,8
50202,CHAYANTA,desnutricion global,desnutricion grave (g),2005-04-01,2,1,1,6,3,7,10
31204,CHIMORE,desnutricion global,desnutricion grave (g),2005-04-01,0,1,0,0,0,1,1
20501,CHUMA,desnutricion global,desnutricion grave (g),2005-04-01,7,0,0,0,7,0,7
30801,CLIZA,desnutricion global,desnutricion grave (g),2005-04-01,10,4,0,0,10,4,14
90101,COBIJA,desnutricion global,desnutricion grave (g),2005-04-01,3,1,0,2,3,3,6
30101,COCHABAMBA,desnutricion global,desnutricion grave (g),2005-04-01,9,6,3,6,12,12,24
30905,COLCAPIRHUA,desnutricion global,desnutricion grave (g),2005-04-01,0,0,0,2,0,2,2
31002,COLOMI,desnutricion global,desnutricion grave (g),2005-04-01,5,0,1,1,6,1,7
50401,COLQUECHACA,desnutricion global,desnutricion grave (g),2005-04-01,9,6,3,3,12,9,21
21004,COLQUIRI,desnutricion global,desnutricion grave (g),2005-04-01,0,0,0,2,0,2,2
71301,COMARAPA,desnutricion global,desnutricion grave (g),2005-04-01,1,3,0,0,1,3,4
20605,COMBAYA,desnutricion global,desnutricion grave (g),2005-04-01,0,0,1,0,1,0,1
21701,COPACABANA,desnutricion global,desnutricion grave (g),2005-04-01,1,1,0,3,1,4,5
20301,CORO CORO,desnutricion global,desnutricion grave (g),2005-04-01,0,1,0,0,0,1,1
21401,COROICO,desnutricion global,desnutricion grave (g),2005-04-01,1,0,0,0,1,0,1
40301,CORQUE,desnutricion global,desnutricion grave (g),2005-04-01,0,0,1,0,1,0,1
50601,COTAGAITA,desnutricion global,desnutricion grave (g),2005-04-01,3,1,1,4,4,5,9
70102,COTOCA,desnutricion global,desnutricion grave (g),2005-04-01,2,1,0,0,2,1,3
70704,CUEVO,desnutricion global,desnutricion grave (g),2005-04-01,0,1,0,1,0,2,2
10902,CULPINA,desnutricion global,desnutricion grave (g),2005-04-01,7,3,2,2,9,5,14
21602,CURVA,desnutricion global,desnutricion grave (g),2005-04-01,1,1,1,0,2,1,3
20105,EL ALTO,desnutricion global,desnutricion grave (g),2005-04-01,32,25,9,15,41,40,81
40103,EL CHORO,desnutricion global,desnutricion grave (g),2005-04-01,0,0,0,1,0,1,1
60502,EL PUENTE(TJA),desnutricion global,desnutricion grave (g),2005-04-01,1,1,0,2,1,3,4
70105,EL TORNO,desnutricion global,desnutricion grave (g),2005-04-01,1,1,1,0,2,1,3
10405,EL VILLAR,desnutricion global,desnutricion grave (g),2005-04-01,0,0,0,1,0,1,1
60601,ENTRE RIOS,desnutricion global,desnutricion grave (g),2005-04-01,2,2,0,1,2,3,5
60601,ENTRE RIOS,desnutricion global,desnutricion grave (g),2005-04-01,2,1,0,0,2,1,3
41101,EUCALIPTUS,desnutricion global,desnutricion grave (g),2005-04-01,1,0,1,0,2,0,2
80402,EXALTACION,desnutricion global,desnutricion grave (g),2005-04-01,0,0,1,0,1,0,1
71002,GENERAL SAAVEDRA,desnutricion global,desnutricion grave (g),2005-04-01,4,0,2,0,6,0,6
21601,GRAL. J.J. PEREZ (CHARAZANI),desnutricion global,desnutricion grave (g),2005-04-01,1,0,1,1,2,1,3
20602,GUANAY,desnutricion global,desnutricion grave (g),2005-04-01,1,0,0,0,1,0,1
80202,GUAYARAMERIN,desnutricion global,desnutricion grave (g),2005-04-01,0,1,0,0,0,1,1
70705,GUTIERREZ,desnutricion global,desnutricion grave (g),2005-04-01,2,3,1,7,3,10,13
10502,HUACARETA,desnutricion global,desnutricion grave (g),2005-04-01,1,4,0,0,1,4,5
40701,HUANUNI,desnutricion global,desnutricion grave (g),2005-04-01,1,0,0,0,1,0,1
10304,ICLA,desnutricion global,desnutricion grave (g),2005-04-01,8,1,3,2,11,3,14
10703,INCAHUASI,desnutricion global,desnutricion grave (g),2005-04-01,2,5,6,1,8,6,14
21001,INQUISIVI,desnutricion global,desnutricion grave (g),2005-04-01,0,2,0,1,0,3,3
21102,IRUPANA (VILLA DE LANZA),desnutricion global,desnutricion grave (g),2005-04-01,2,3,5,3,7,6,13
21501,IXIAMAS,desnutricion global,desnutricion grave (g),2005-04-01,0,1,0,0,0,1,1
20806,JESUS DE MACHACA,desnutricion global,desnutricion grave (g),2005-04-01,2,0,0,1,2,1,3
21105,LA ASUNTA,desnutricion global,desnutricion grave (g),2005-04-01,0,1,0,0,0,1,1
70104,LA GUARDIA,desnutricion global,desnutricion grave (g),2005-04-01,0,1,2,0,2,1,3
20101,LA PAZ,desnutricion global,desnutricion grave (g),2005-04-01,20,19,5,7,25,26,51
10903,LAS CARRERAS,desnutricion global,desnutricion grave (g),2005-04-01,1,0,0,1,1,1,2
50203,LLALLAGUA,desnutricion global,desnutricion grave (g),2005-04-01,9,11,1,0,10,11,21
20901,LURIBAY,desnutricion global,desnutricion grave (g),2005-04-01,0,1,0,0,0,1,1
40702,MACHACAMARCA,desnutricion global,desnutricion grave (g),2005-04-01,0,0,0,1,0,1,1
11003,MACHARETI,desnutricion global,desnutricion grave (g),2005-04-01,0,0,0,1,0,1,1
80801,MAGDALENA,desnutricion global,desnutricion grave (g),2005-04-01,2,1,0,0,2,1,3
20904,MALLA,desnutricion global,desnutricion grave (g),2005-04-01,0,0,0,1,0,1,1
20607,MAPIRI,desnutricion global,desnutricion grave (g),2005-04-01,1,2,0,0,1,2,3
20103,MECAPACA,desnutricion global,desnutricion grave (g),2005-04-01,1,0,0,0,1,0,1
71003,MINEROS,desnutricion global,desnutricion grave (g),2005-04-01,4,2,0,0,4,2,6
31301,MIZQUE,desnutricion global,desnutricion grave (g),2005-04-01,0,12,2,2,2,14,16
20402,MOCOMOCO,desnutricion global,desnutricion grave (g),2005-04-01,1,0,0,1,1,1,2
10303,MOJOCOYA,desnutricion global,desnutricion grave (g),2005-04-01,1,0,0,1,1,1,2
10501,MONTEAGUDO,desnutricion global,desnutricion grave (g),2005-04-01,3,1,1,3,4,4,8
71001,MONTERO,desnutricion global,desnutricion grave (g),2005-04-01,14,4,3,0,17,4,21
70803,MORO MORO,desnutricion global,desnutricion grave (g),2005-04-01,0,0,0,1,0,1,1
30302,MOROCHATA,desnutricion global,desnutricion grave (g),2005-04-01,0,4,2,1,2,5,7
50404,OCURI,desnutricion global,desnutricion grave (g),2005-04-01,8,7,3,7,11,14,25
70202,OKINAWA,desnutricion global,desnutricion grave (g),2005-04-01,1,0,1,0,2,0,2
40101,ORURO,desnutricion global,desnutricion grave (g),2005-04-01,7,5,4,0,11,5,16
10401,PADILLA,desnutricion global,desnutricion grave (g),2005-04-01,2,1,0,1,2,2,4
70502,PAILON,desnutricion global,desnutricion grave (g),2005-04-01,0,2,2,0,2,2,4
20102,PALCA,desnutricion global,desnutricion grave (g),2005-04-01,0,0,1,0,1,0,1
21104,PALOS BLANCOS,desnutricion global,desnutricion grave (g),2005-04-01,3,0,1,0,4,0,4
70902,PAMPA GRANDE,desnutricion global,desnutricion grave (g),2005-04-01,0,1,0,0,0,1,1
30202,PASORAPA,desnutricion global,desnutricion grave (g),2005-04-01,3,7,3,0,6,7,13
21305,PATACAMAYA,desnutricion global,desnutricion grave (g),2005-04-01,0,1,0,0,0,1,1
40602,PAZÑA,desnutricion global,desnutricion grave (g),2005-04-01,0,0,0,1,0,1,1
50403,POCOATA,desnutricion global,desnutricion grave (g),2005-04-01,2,1,1,3,3,4,7
31203,POCONA,desnutricion global,desnutricion grave (g),2005-04-01,2,3,0,0,2,3,5
31202,POJO (CBBA),desnutricion global,desnutricion grave (g),2005-04-01,2,2,1,2,3,4,7
51203,PORCO,desnutricion global,desnutricion grave (g),2005-04-01,1,0,0,0,1,0,1
10103,POROMA,desnutricion global,desnutricion grave (g),2005-04-01,2,2,0,0,2,2,4
70103,PORONGO,desnutricion global,desnutricion grave (g),2005-04-01,1,1,0,0,1,1,2
50101,POTOSI,desnutricion global,desnutricion grave (g),2005-04-01,7,9,1,2,8,11,19
10302,PRESTO,desnutricion global,desnutricion grave (g),2005-04-01,7,4,2,1,9,5,14
20401,PUERTO ACOSTA,desnutricion global,desnutricion grave (g),2005-04-01,0,1,0,1,0,2,2
20403,PUERTO CARABUCO,desnutricion global,desnutricion grave (g),2005-04-01,2,1,0,0,2,1,3
90301,PUERTO GONZALO MORENO,desnutricion global,desnutricion grave (g),2005-04-01,2,1,1,2,3,3,6
21204,PUERTO PEREZ,desnutricion global,desnutricion grave (g),2005-04-01,0,0,1,0,1,0,1
90201,PUERTO RICO,desnutricion global,desnutricion grave (g),2005-04-01,1,0,0,0,1,0,1
31205,PUERTO VILLARROEL,desnutricion global,desnutricion grave (g),2005-04-01,3,8,6,8,9,16,25
51101,PUNA,desnutricion global,desnutricion grave (g),2005-04-01,3,7,3,6,6,13,19
31401,PUNATA,desnutricion global,desnutricion grave (g),2005-04-01,1,2,1,2,2,4,6
30901,QUILLACOLLO,desnutricion global,desnutricion grave (g),2005-04-01,5,6,1,1,6,7,13
21002,QUIME,desnutricion global,desnutricion grave (g),2005-04-01,0,2,0,0,0,2,2
70904,QUIRUSILLAS,desnutricion global,desnutricion grave (g),2005-04-01,0,1,0,0,0,1,1
50402,RAVELO,desnutricion global,desnutricion grave (g),2005-04-01,18,12,6,6,24,18,42
80301,REYES,desnutricion global,desnutricion grave (g),2005-04-01,2,1,2,1,4,2,6
80201,RIBERALTA,desnutricion global,desnutricion grave (g),2005-04-01,15,19,6,8,21,27,48
70503,ROBORE,desnutricion global,desnutricion grave (g),2005-04-01,2,3,0,0,2,3,5
80304,RURRENABAQUE,desnutricion global,desnutricion grave (g),2005-04-01,1,0,0,0,1,0,1
40901,SABAYA,desnutricion global,desnutricion grave (g),2005-04-01,1,0,0,0,1,0,1
31001,SACABA,desnutricion global,desnutricion grave (g),2005-04-01,8,3,2,3,10,6,16
50701,SACACA,desnutricion global,desnutricion grave (g),2005-04-01,10,5,3,3,13,8,21
71302,SAIPINA,desnutricion global,desnutricion grave (g),2005-04-01,1,1,0,0,1,1,2
70901,SAMAIPATA,desnutricion global,desnutricion grave (g),2005-04-01,2,0,0,0,2,0,2
51601,SAN AGUSTIN,desnutricion global,desnutricion grave (g),2005-04-01,1,0,0,0,1,0,1
80602,SAN ANDRES,desnutricion global,desnutricion grave (g),2005-04-01,1,1,0,0,1,1,2
71105,SAN ANTONIO DE LOMERIO,desnutricion global,desnutricion grave (g),2005-04-01,2,0,0,0,2,0,2
31403,SAN BENITO,desnutricion global,desnutricion grave (g),2005-04-01,0,1,0,0,0,1,1
80302,SAN BORJA,desnutricion global,desnutricion grave (g),2005-04-01,7,6,0,1,7,7,14
21502,SAN BUENA VENTURA,desnutricion global,desnutricion grave (g),2005-04-01,1,1,1,1,2,2,4
70402,SAN CARLOS,desnutricion global,desnutricion grave (g),2005-04-01,0,0,1,0,1,0,1
80501,SAN IGNACIO,desnutricion global,desnutricion grave (g),2005-04-01,2,9,1,1,3,10,13
70301,SAN IGNACIO DE VELASCO,desnutricion global,desnutricion grave (g),2005-04-01,6,7,4,8,10,15,25
70501,SAN JOSE DE CHIQUITOS,desnutricion global,desnutricion grave (g),2005-04-01,3,3,1,0,4,3,7
70404,SAN JUAN DE YAPACANI,desnutricion global,desnutricion grave (g),2005-04-01,0,0,1,0,1,0,1
71104,SAN JULIAN,desnutricion global,desnutricion grave (g),2005-04-01,1,0,3,1,4,1,5
60501,SAN LORENZO(TJA),desnutricion global,desnutricion grave (g),2005-04-01,1,0,3,0,4,0,4
10702,SAN LUCAS,desnutricion global,desnutricion grave (g),2005-04-01,8,9,3,7,11,16,27
70302,SAN MIGUEL DE VELASCO,desnutricion global,desnutricion grave (g),2005-04-01,0,0,0,1,0,1,1
71005,SAN PEDRO,desnutricion global,desnutricion grave (g),2005-04-01,0,0,2,0,2,0,2
50501,SAN PEDRO DE BUENA VISTA,desnutricion global,desnutricion grave (g),2005-04-01,4,2,5,5,9,7,16
70303,SAN RAFAEL,desnutricion global,desnutricion grave (g),2005-04-01,0,1,1,0,1,1,2
80401,SANTA ANA,desnutricion global,desnutricion grave (g),2005-04-01,0,1,0,1,0,2,2
70101,SANTA CRUZ DE LA SIERRA,desnutricion global,desnutricion grave (g),2005-04-01,131,112,46,62,177,174,351
80303,SANTA ROSA,desnutricion global,desnutricion grave (g),2005-04-01,1,2,0,0,1,2,3
70602,SANTA ROSA DEL SARA,desnutricion global,desnutricion grave (g),2005-04-01,0,1,1,0,1,1,2
20308,SANTIAGO DE CALLAPA,desnutricion global,desnutricion grave (g),2005-04-01,0,1,1,1,1,2,3
41401,SANTIAGO DE HUARI,desnutricion global,desnutricion grave (g),2005-04-01,2,0,0,0,2,0,2
21901,SANTIAGO DE MACHACA,desnutricion global,desnutricion grave (g),2005-04-01,1,0,0,0,1,0,1
20902,SAPAHAQUI,desnutricion global,desnutricion grave (g),2005-04-01,0,1,0,1,0,2,2
21301,SICA SICA (VILLA AROMA),desnutricion global,desnutricion grave (g),2005-04-01,0,1,0,0,0,1,1
30703,SICAYA,desnutricion global,desnutricion grave (g),2005-04-01,2,0,0,0,2,0,2
30902,SIPE SIPE,desnutricion global,desnutricion grave (g),2005-04-01,6,6,1,4,7,10,17
10403,SOPACHUY,desnutricion global,desnutricion grave (g),2005-04-01,3,5,2,6,5,11,16
20601,SORATA,desnutricion global,desnutricion grave (g),2005-04-01,0,1,1,1,1,2,3
10101,SUCRE,desnutricion global,desnutricion grave (g),2005-04-01,13,7,6,1,19,8,27
50303,TACOBAMBA,desnutricion global,desnutricion grave (g),2005-04-01,1,4,0,0,1,4,5
30602,TACOPAYA,desnutricion global,desnutricion grave (g),2005-04-01,4,2,0,0,4,2,6
51402,TAHUA,desnutricion global,desnutricion grave (g),2005-04-01,0,0,0,1,0,1,1
31101,TAPACARI,desnutricion global,desnutricion grave (g),2005-04-01,6,6,1,1,7,7,14
10601,TARABUCO,desnutricion global,desnutricion grave (g),2005-04-01,9,13,6,11,15,24,39
20807,TARACO,desnutricion global,desnutricion grave (g),2005-04-01,0,1,0,0,0,1,1
30401,TARATA,desnutricion global,desnutricion grave (g),2005-04-01,0,1,0,3,0,4,4
60101,TARIJA,desnutricion global,desnutricion grave (g),2005-04-01,5,6,0,3,5,9,14
10202,TARVITA,desnutricion global,desnutricion grave (g),2005-04-01,0,2,0,0,0,2,2
20608,TEOPONTE,desnutricion global,desnutricion grave (g),2005-04-01,1,0,0,0,1,0,1
50102,TINGUIPAYA,desnutricion global,desnutricion grave (g),2005-04-01,4,5,3,3,7,8,15
20606,TIPUANI,desnutricion global,desnutricion grave (g),2005-04-01,0,0,0,1,0,1,1
30903,TIQUIPAYA,desnutricion global,desnutricion grave (g),2005-04-01,2,2,1,0,3,2,5
31601,TIRAQUE (CBBA),desnutricion global,desnutricion grave (g),2005-04-01,1,3,2,6,3,9,12
41001,TOLEDO,desnutricion global,desnutricion grave (g),2005-04-01,4,1,0,0,4,1,5
51202,TOMAVE,desnutricion global,desnutricion grave (g),2005-04-01,1,1,0,0,1,1,2
10402,TOMINA,desnutricion global,desnutricion grave (g),2005-04-01,4,1,0,3,4,4,8
50502,TORO TORO,desnutricion global,desnutricion grave (g),2005-04-01,3,6,1,4,4,10,14
31201,TOTORA(CBBA),desnutricion global,desnutricion grave (g),2005-04-01,1,1,1,0,2,1,3
80101,TRINIDAD,desnutricion global,desnutricion grave (g),2005-04-01,0,6,0,0,0,6,6
50801,TUPIZA,desnutricion global,desnutricion grave (g),2005-04-01,2,2,0,0,2,2,4
50201,UNCIA,desnutricion global,desnutricion grave (g),2005-04-01,1,0,1,1,2,1,3
60401,URIONDO (A. CONCEPCION),desnutricion global,desnutricion grave (g),2005-04-01,1,0,1,0,2,0,2
51201,UYUNI,desnutricion global,desnutricion grave (g),2005-04-01,1,0,1,2,2,2,4
30502,VACAS,desnutricion global,desnutricion grave (g),2005-04-01,2,3,1,1,3,4,7
70801,VALLEGRANDE,desnutricion global,desnutricion grave (g),2005-04-01,0,1,0,1,0,2,2
20801,VIACHA,desnutricion global,desnutricion grave (g),2005-04-01,1,1,0,0,1,1,2
31302,VILA VILA,desnutricion global,desnutricion grave (g),2005-04-01,1,0,1,0,2,0,2
60303,VILLA MONTES,desnutricion global,desnutricion grave (g),2005-04-01,4,1,0,1,4,2,6
31402,VILLA RIVERO,desnutricion global,desnutricion grave (g),2005-04-01,0,0,1,2,1,2,3
10801,VILLA SERRANO,desnutricion global,desnutricion grave (g),2005-04-01,5,2,2,1,7,3,10
31003,VILLA TUNARI,desnutricion global,desnutricion grave (g),2005-04-01,4,4,4,1,8,5,13
51501,VILLAZON,desnutricion global,desnutricion grave (g),2005-04-01,1,1,0,0,1,1,2
30904,VINTO,desnutricion global,desnutricion grave (g),2005-04-01,1,0,1,0,2,0,2
50602,VITICHI,desnutricion global,desnutricion grave (g),2005-04-01,1,0,2,0,3,0,3
20903,YACO,desnutricion global,desnutricion grave (g),2005-04-01,0,0,1,0,1,0,1
60301,YACUIBA,desnutricion global,desnutricion grave (g),2005-04-01,0,1,0,1,0,2,2
10602,YAMPARAEZ,desnutricion global,desnutricion grave (g),2005-04-01,8,1,1,4,9,5,14
70403,YAPACANI,desnutricion global,desnutricion grave (g),2005-04-01,2,5,2,0,4,5,9
50103,YOCALLA,desnutricion global,desnutricion grave (g),2005-04-01,2,0,0,0,2,0,2
10102,YOTALA,desnutricion global,desnutricion grave (g),2005-04-01,3,0,1,1,4,1,5
10301,ZUDAÑEZ,desnutricion global,desnutricion grave (g),2005-04-01,2,2,0,4,2,6,8
51302,ACACIO,desnutricion global,desnutricion grave (g),2005-05-01,4,2,0,1,4,3,7
20201,ACHACACHI,desnutricion global,desnutricion grave (g),2005-05-01,0,1,0,2,0,3,3
30201,AIQUILE,desnutricion global,desnutricion grave (g),2005-05-01,0,1,1,0,1,1,2
31303,ALALAY,desnutricion global,desnutricion grave (g),2005-05-01,0,0,0,1,0,1,1
10404,ALCALA,desnutricion global,desnutricion grave (g),2005-05-01,0,1,0,1,0,2,2
20202,ANCORAIMES,desnutricion global,desnutricion grave (g),2005-05-01,1,0,0,0,1,0,1
40603,ANTEQUERA,desnutricion global,desnutricion grave (g),2005-05-01,0,2,1,1,1,3,4
20701,APOLO,desnutricion global,desnutricion grave (g),2005-05-01,1,1,0,0,1,1,2
30501,ARANI,desnutricion global,desnutricion grave (g),2005-05-01,1,1,1,0,2,1,3
30601,ARQUE,desnutricion global,desnutricion grave (g),2005-05-01,1,5,0,0,1,5,6
50802,ATOCHA,desnutricion global,desnutricion grave (g),2005-05-01,1,3,1,1,2,4,6
20503,AUCAPATA,desnutricion global,desnutricion grave (g),2005-05-01,2,0,1,0,3,0,3
20502,AYATA,desnutricion global,desnutricion grave (g),2005-05-01,0,1,0,0,0,1,1
21303,AYO AYO,desnutricion global,desnutricion grave (g),2005-05-01,0,1,0,0,0,1,1
30301,AYOPAYA (V. DE INDEPENDENCIA),desnutricion global,desnutricion grave (g),2005-05-01,5,2,2,0,7,2,9
10201,AZURDUY,desnutricion global,desnutricion grave (g),2005-05-01,5,2,1,7,6,9,15
50301,BETANZOS,desnutricion global,desnutricion grave (g),2005-05-01,8,7,3,5,11,12,23
31501,BOLIVAR,desnutricion global,desnutricion grave (g),2005-05-01,0,1,0,0,0,1,1
70703,CABEZAS,desnutricion global,desnutricion grave (g),2005-05-01,2,1,0,0,2,1,3
20905,CAIROMA,desnutricion global,desnutricion grave (g),2005-05-01,2,0,1,3,3,3,6
51102,"CAIZA ""D""",desnutricion global,desnutricion grave (g),2005-05-01,1,0,0,0,1,0,1
21003,CAJUATA,desnutricion global,desnutricion grave (g),2005-05-01,0,2,0,0,0,2,2
20303,CALACOTO,desnutricion global,desnutricion grave (g),2005-05-01,0,1,0,0,0,1,1
21304,CALAMARCA,desnutricion global,desnutricion grave (g),2005-05-01,4,1,1,1,5,2,7
10701,CAMARGO,desnutricion global,desnutricion grave (g),2005-05-01,7,4,5,4,12,8,20
70706,CAMIRI,desnutricion global,desnutricion grave (g),2005-05-01,0,1,0,2,0,3,3
30701,CAPINOTA,desnutricion global,desnutricion grave (g),2005-05-01,3,2,0,0,3,2,5
40102,CARACOLLO,desnutricion global,desnutricion grave (g),2005-05-01,2,0,0,0,2,0,2
22001,CARANAVI,desnutricion global,desnutricion grave (g),2005-05-01,2,1,2,1,4,2,6
50702,CARIPUYO,desnutricion global,desnutricion grave (g),2005-05-01,0,0,1,1,1,1,2
40201,CHALLAPATA,desnutricion global,desnutricion grave (g),2005-05-01,4,2,1,3,5,5,10
50302,CHAQUI,desnutricion global,desnutricion grave (g),2005-05-01,0,1,0,1,0,2,2
70702,CHARAGUA,desnutricion global,desnutricion grave (g),2005-05-01,1,0,0,1,1,1,2
50202,CHAYANTA,desnutricion global,desnutricion grave (g),2005-05-01,3,3,2,1,5,4,9
31204,CHIMORE,desnutricion global,desnutricion grave (g),2005-05-01,0,0,1,0,1,0,1
20501,CHUMA,desnutricion global,desnutricion grave (g),2005-05-01,1,2,1,0,2,2,4
30801,CLIZA,desnutricion global,desnutricion grave (g),2005-05-01,2,3,0,0,2,3,5
90101,COBIJA,desnutricion global,desnutricion grave (g),2005-05-01,2,1,0,1,2,2,4
30101,COCHABAMBA,desnutricion global,desnutricion grave (g),2005-05-01,4,4,0,1,4,5,9
30905,COLCAPIRHUA,desnutricion global,desnutricion grave (g),2005-05-01,1,0,0,1,1,1,2
50901,"COLCHA ""K""",desnutricion global,desnutricion grave (g),2005-05-01,0,1,0,0,0,1,1
21307,COLLANA,desnutricion global,desnutricion grave (g),2005-05-01,1,0,1,0,2,0,2
31002,COLOMI,desnutricion global,desnutricion grave (g),2005-05-01,5,8,0,2,5,10,15
50401,COLQUECHACA,desnutricion global,desnutricion grave (g),2005-05-01,4,8,0,0,4,8,12
21306,COLQUENCHA,desnutricion global,desnutricion grave (g),2005-05-01,0,0,1,0,1,0,1
21004,COLQUIRI,desnutricion global,desnutricion grave (g),2005-05-01,1,1,1,0,2,1,3
71301,COMARAPA,desnutricion global,desnutricion grave (g),2005-05-01,0,1,1,0,1,1,2
21402,CORIPATA,desnutricion global,desnutricion grave (g),2005-05-01,2,1,0,0,2,1,3
21401,COROICO,desnutricion global,desnutricion grave (g),2005-05-01,1,0,0,0,1,0,1
40301,CORQUE,desnutricion global,desnutricion grave (g),2005-05-01,1,0,0,0,1,0,1
50601,COTAGAITA,desnutricion global,desnutricion grave (g),2005-05-01,5,4,0,0,5,4,9
70102,COTOCA,desnutricion global,desnutricion grave (g),2005-05-01,1,2,0,0,1,2,3
10902,CULPINA,desnutricion global,desnutricion grave (g),2005-05-01,6,4,5,1,11,5,16
21602,CURVA,desnutricion global,desnutricion grave (g),2005-05-01,1,0,0,0,1,0,1
20105,EL ALTO,desnutricion global,desnutricion grave (g),2005-05-01,36,26,10,11,46,37,83
71503,EL PUENTE(STC),desnutricion global,desnutricion grave (g),2005-05-01,1,2,1,1,2,3,5
60502,EL PUENTE(TJA),desnutricion global,desnutricion grave (g),2005-05-01,0,0,0,1,0,1,1
70105,EL TORNO,desnutricion global,desnutricion grave (g),2005-05-01,0,2,1,2,1,4,5
10405,EL VILLAR,desnutricion global,desnutricion grave (g),2005-05-01,0,0,0,2,0,2,2
60601,ENTRE RIOS,desnutricion global,desnutricion grave (g),2005-05-01,2,6,1,0,3,6,9
60601,ENTRE RIOS,desnutricion global,desnutricion grave (g),2005-05-01,1,0,0,0,1,0,1
80402,EXALTACION,desnutricion global,desnutricion grave (g),2005-05-01,1,1,0,6,1,7,8
71004,FERNANDEZ ALONSO,desnutricion global,desnutricion grave (g),2005-05-01,0,1,0,1,0,2,2
90203,FILADELFIA,desnutricion global,desnutricion grave (g),2005-05-01,0,1,0,1,0,2,2
71002,GENERAL SAAVEDRA,desnutricion global,desnutricion grave (g),2005-05-01,1,0,1,0,2,0,2
20602,GUANAY,desnutricion global,desnutricion grave (g),2005-05-01,0,1,0,0,0,1,1
80202,GUAYARAMERIN,desnutricion global,desnutricion grave (g),2005-05-01,0,1,0,0,0,1,1
70705,GUTIERREZ,desnutricion global,desnutricion grave (g),2005-05-01,1,1,0,3,1,4,5
10502,HUACARETA,desnutricion global,desnutricion grave (g),2005-05-01,1,2,0,0,1,2,3
11002,HUACAYA (VILLA DE HUACAYA),desnutricion global,desnutricion grave (g),2005-05-01,0,1,0,0,0,1,1
10304,ICLA,desnutricion global,desnutricion grave (g),2005-05-01,3,2,3,4,6,6,12
10703,INCAHUASI,desnutricion global,desnutricion grave (g),2005-05-01,6,2,2,3,8,5,13
21001,INQUISIVI,desnutricion global,desnutricion grave (g),2005-05-01,1,1,1,0,2,1,3
21501,IXIAMAS,desnutricion global,desnutricion grave (g),2005-05-01,1,1,2,2,3,3,6
20806,JESUS DE MACHACA,desnutricion global,desnutricion grave (g),2005-05-01,1,0,0,0,1,0,1
21105,LA ASUNTA,desnutricion global,desnutricion grave (g),2005-05-01,5,2,0,0,5,2,7
70104,LA GUARDIA,desnutricion global,desnutricion grave (g),2005-05-01,4,3,2,0,6,3,9
20101,LA PAZ,desnutricion global,desnutricion grave (g),2005-05-01,11,15,5,7,16,22,38
70701,LAGUNILLAS,desnutricion global,desnutricion grave (g),2005-05-01,2,0,0,0,2,0,2
21202,LAJA,desnutricion global,desnutricion grave (g),2005-05-01,1,0,0,0,1,0,1
10903,LAS CARRERAS,desnutricion global,desnutricion grave (g),2005-05-01,1,0,0,0,1,0,1
50203,LLALLAGUA,desnutricion global,desnutricion grave (g),2005-05-01,6,4,3,5,9,9,18
20901,LURIBAY,desnutricion global,desnutricion grave (g),2005-05-01,0,2,0,0,0,2,2
40702,MACHACAMARCA,desnutricion global,desnutricion grave (g),2005-05-01,1,1,0,0,1,1,2
20904,MALLA,desnutricion global,desnutricion grave (g),2005-05-01,2,0,0,0,2,0,2
20607,MAPIRI,desnutricion global,desnutricion grave (g),2005-05-01,0,2,0,0,0,2,2
71003,MINEROS,desnutricion global,desnutricion grave (g),2005-05-01,0,1,0,0,0,1,1
31301,MIZQUE,desnutricion global,desnutricion grave (g),2005-05-01,3,1,0,1,3,2,5
20402,MOCOMOCO,desnutricion global,desnutricion grave (g),2005-05-01,4,0,0,1,4,1,5
10303,MOJOCOYA,desnutricion global,desnutricion grave (g),2005-05-01,1,1,0,1,1,2,3
10501,MONTEAGUDO,desnutricion global,desnutricion grave (g),2005-05-01,3,2,2,1,5,3,8
71001,MONTERO,desnutricion global,desnutricion grave (g),2005-05-01,9,12,4,2,13,14,27
30302,MOROCHATA,desnutricion global,desnutricion grave (g),2005-05-01,10,4,2,2,12,6,18
50404,OCURI,desnutricion global,desnutricion grave (g),2005-05-01,5,5,2,4,7,9,16
40101,ORURO,desnutricion global,desnutricion grave (g),2005-05-01,9,6,1,0,10,6,16
60201,PADCAYA,desnutricion global,desnutricion grave (g),2005-05-01,1,0,0,0,1,0,1
10401,PADILLA,desnutricion global,desnutricion grave (g),2005-05-01,1,2,0,1,1,3,4
70502,PAILON,desnutricion global,desnutricion grave (g),2005-05-01,0,1,0,0,0,1,1
20102,PALCA,desnutricion global,desnutricion grave (g),2005-05-01,0,0,1,0,1,0,1
21104,PALOS BLANCOS,desnutricion global,desnutricion grave (g),2005-05-01,0,6,1,4,1,10,11
70902,PAMPA GRANDE,desnutricion global,desnutricion grave (g),2005-05-01,1,0,0,0,1,0,1
21305,PATACAMAYA,desnutricion global,desnutricion grave (g),2005-05-01,0,1,0,0,0,1,1
20702,PELECHUCO,desnutricion global,desnutricion grave (g),2005-05-01,2,1,0,0,2,1,3
50403,POCOATA,desnutricion global,desnutricion grave (g),2005-05-01,5,3,3,4,8,7,15
31203,POCONA,desnutricion global,desnutricion grave (g),2005-05-01,2,0,1,0,3,0,3
31202,POJO (CBBA),desnutricion global,desnutricion grave (g),2005-05-01,1,3,1,1,2,4,6
51203,PORCO,desnutricion global,desnutricion grave (g),2005-05-01,0,1,0,0,0,1,1
10103,POROMA,desnutricion global,desnutricion grave (g),2005-05-01,8,6,3,5,11,11,22
90102,PORVENIR,desnutricion global,desnutricion grave (g),2005-05-01,1,0,0,0,1,0,1
70804,POSTRER VALLE,desnutricion global,desnutricion grave (g),2005-05-01,1,0,1,1,2,1,3
50101,POTOSI,desnutricion global,desnutricion grave (g),2005-05-01,6,4,3,1,9,5,14
10302,PRESTO,desnutricion global,desnutricion grave (g),2005-05-01,3,1,0,4,3,5,8
20403,PUERTO CARABUCO,desnutricion global,desnutricion grave (g),2005-05-01,1,2,2,0,3,2,5
90301,PUERTO GONZALO MORENO,desnutricion global,desnutricion grave (g),2005-05-01,1,1,1,2,2,3,5
31205,PUERTO VILLARROEL,desnutricion global,desnutricion grave (g),2005-05-01,6,11,2,3,8,14,22
51101,PUNA,desnutricion global,desnutricion grave (g),2005-05-01,7,10,2,2,9,12,21
31401,PUNATA,desnutricion global,desnutricion grave (g),2005-05-01,2,3,0,0,2,3,5
30901,QUILLACOLLO,desnutricion global,desnutricion grave (g),2005-05-01,1,7,3,1,4,8,12
21002,QUIME,desnutricion global,desnutricion grave (g),2005-05-01,0,1,1,0,1,1,2
70904,QUIRUSILLAS,desnutricion global,desnutricion grave (g),2005-05-01,0,1,0,0,0,1,1
50402,RAVELO,desnutricion global,desnutricion grave (g),2005-05-01,21,17,16,12,37,29,66
80301,REYES,desnutricion global,desnutricion grave (g),2005-05-01,1,3,1,0,2,3,5
80201,RIBERALTA,desnutricion global,desnutricion grave (g),2005-05-01,11,13,7,6,18,19,37
70503,ROBORE,desnutricion global,desnutricion grave (g),2005-05-01,1,1,0,0,1,1,2
80304,RURRENABAQUE,desnutricion global,desnutricion grave (g),2005-05-01,0,0,0,1,0,1,1
31001,SACABA,desnutricion global,desnutricion grave (g),2005-05-01,7,3,3,1,10,4,14
30404,SACABAMBA,desnutricion global,desnutricion grave (g),2005-05-01,1,0,1,0,2,0,2
80602,SAN ANDRES,desnutricion global,desnutricion grave (g),2005-05-01,0,1,1,0,1,1,2
71105,SAN ANTONIO DE LOMERIO,desnutricion global,desnutricion grave (g),2005-05-01,0,2,0,1,0,3,3
31403,SAN BENITO,desnutricion global,desnutricion grave (g),2005-05-01,0,2,0,1,0,3,3
80302,SAN BORJA,desnutricion global,desnutricion grave (g),2005-05-01,2,3,0,0,2,3,5
70402,SAN CARLOS,desnutricion global,desnutricion grave (g),2005-05-01,1,2,0,1,1,3,4
80501,SAN IGNACIO,desnutricion global,desnutricion grave (g),2005-05-01,0,1,0,1,0,2,2
70301,SAN IGNACIO DE VELASCO,desnutricion global,desnutricion grave (g),2005-05-01,8,6,0,3,8,9,17
70501,SAN JOSE DE CHIQUITOS,desnutricion global,desnutricion grave (g),2005-05-01,0,0,1,0,1,0,1
71104,SAN JULIAN,desnutricion global,desnutricion grave (g),2005-05-01,5,0,2,0,7,0,7
90302,SAN LORENZO(PND),desnutricion global,desnutricion grave (g),2005-05-01,1,0,1,1,2,1,3
60501,SAN LORENZO(TJA),desnutricion global,desnutricion grave (g),2005-05-01,1,1,5,5,6,6,12
10702,SAN LUCAS,desnutricion global,desnutricion grave (g),2005-05-01,16,15,7,5,23,20,43
70302,SAN MIGUEL DE VELASCO,desnutricion global,desnutricion grave (g),2005-05-01,0,0,1,0,1,0,1
71005,SAN PEDRO,desnutricion global,desnutricion grave (g),2005-05-01,0,0,0,1,0,1,1
50501,SAN PEDRO DE BUENA VISTA,desnutricion global,desnutricion grave (g),2005-05-01,6,6,1,6,7,12,19
70303,SAN RAFAEL,desnutricion global,desnutricion grave (g),2005-05-01,0,3,1,2,1,5,6
70101,SANTA CRUZ DE LA SIERRA,desnutricion global,desnutricion grave (g),2005-05-01,35,28,16,11,51,39,90
80303,SANTA ROSA,desnutricion global,desnutricion grave (g),2005-05-01,0,1,0,1,0,2,2
70602,SANTA ROSA DEL SARA,desnutricion global,desnutricion grave (g),2005-05-01,0,0,2,0,2,0,2
20308,SANTIAGO DE CALLAPA,desnutricion global,desnutricion grave (g),2005-05-01,1,0,1,0,2,0,2
30702,SANTIVAÑES,desnutricion global,desnutricion grave (g),2005-05-01,0,0,2,1,2,1,3
20902,SAPAHAQUI,desnutricion global,desnutricion grave (g),2005-05-01,1,0,0,0,1,0,1
90303,SENA,desnutricion global,desnutricion grave (g),2005-05-01,0,2,2,1,2,3,5
21301,SICA SICA (VILLA AROMA),desnutricion global,desnutricion grave (g),2005-05-01,4,4,1,0,5,4,9
30703,SICAYA,desnutricion global,desnutricion grave (g),2005-05-01,0,0,1,0,1,0,1
30902,SIPE SIPE,desnutricion global,desnutricion grave (g),2005-05-01,5,8,6,3,11,11,22
10403,SOPACHUY,desnutricion global,desnutricion grave (g),2005-05-01,3,5,0,0,3,5,8
40104,SORACACHI,desnutricion global,desnutricion grave (g),2005-05-01,0,2,0,0,0,2,2
20601,SORATA,desnutricion global,desnutricion grave (g),2005-05-01,1,1,0,1,1,2,3
10101,SUCRE,desnutricion global,desnutricion grave (g),2005-05-01,7,9,4,4,11,13,24
31404,TACACHI,desnutricion global,desnutricion grave (g),2005-05-01,1,2,0,0,1,2,3
51402,TAHUA,desnutricion global,desnutricion grave (g),2005-05-01,0,0,0,1,0,1,1
31101,TAPACARI,desnutricion global,desnutricion grave (g),2005-05-01,1,3,1,0,2,3,5
10601,TARABUCO,desnutricion global,desnutricion grave (g),2005-05-01,12,14,4,4,16,18,34
20807,TARACO,desnutricion global,desnutricion grave (g),2005-05-01,0,1,0,0,0,1,1
30401,TARATA,desnutricion global,desnutricion grave (g),2005-05-01,0,1,1,0,1,1,2
60101,TARIJA,desnutricion global,desnutricion grave (g),2005-05-01,3,0,0,2,3,2,5
10202,TARVITA,desnutricion global,desnutricion grave (g),2005-05-01,4,3,7,4,11,7,18
20608,TEOPONTE,desnutricion global,desnutricion grave (g),2005-05-01,1,0,1,0,2,0,2
20803,TIAWANACU,desnutricion global,desnutricion grave (g),2005-05-01,0,1,0,0,0,1,1
50102,TINGUIPAYA,desnutricion global,desnutricion grave (g),2005-05-01,13,5,2,6,15,11,26
31601,TIRAQUE (CBBA),desnutricion global,desnutricion grave (g),2005-05-01,8,5,2,4,10,9,19
30802,TOCO,desnutricion global,desnutricion grave (g),2005-05-01,1,0,1,0,2,0,2
41001,TOLEDO,desnutricion global,desnutricion grave (g),2005-05-01,1,0,0,0,1,0,1
51202,TOMAVE,desnutricion global,desnutricion grave (g),2005-05-01,2,0,2,0,4,0,4
10402,TOMINA,desnutricion global,desnutricion grave (g),2005-05-01,6,6,1,3,7,9,16
50502,TORO TORO,desnutricion global,desnutricion grave (g),2005-05-01,2,3,2,2,4,5,9
31201,TOTORA(CBBA),desnutricion global,desnutricion grave (g),2005-05-01,0,0,1,0,1,0,1
80101,TRINIDAD,desnutricion global,desnutricion grave (g),2005-05-01,3,2,0,1,3,3,6
50801,TUPIZA,desnutricion global,desnutricion grave (g),2005-05-01,3,1,0,1,3,2,5
50201,UNCIA,desnutricion global,desnutricion grave (g),2005-05-01,0,3,0,0,0,3,3
60401,URIONDO (A. CONCEPCION),desnutricion global,desnutricion grave (g),2005-05-01,1,1,0,0,1,1,2
51201,UYUNI,desnutricion global,desnutricion grave (g),2005-05-01,1,1,0,2,1,3,4
30502,VACAS,desnutricion global,desnutricion grave (g),2005-05-01,4,1,0,1,4,2,6
70801,VALLEGRANDE,desnutricion global,desnutricion grave (g),2005-05-01,8,0,1,1,9,1,10
20801,VIACHA,desnutricion global,desnutricion grave (g),2005-05-01,0,1,1,0,1,1,2
31302,VILA VILA,desnutricion global,desnutricion grave (g),2005-05-01,2,0,3,0,5,0,5
60303,VILLA MONTES,desnutricion global,desnutricion grave (g),2005-05-01,1,0,1,0,2,0,2
31402,VILLA RIVERO,desnutricion global,desnutricion grave (g),2005-05-01,1,0,0,1,1,1,2
10801,VILLA SERRANO,desnutricion global,desnutricion grave (g),2005-05-01,6,1,0,1,6,2,8
31003,VILLA TUNARI,desnutricion global,desnutricion grave (g),2005-05-01,10,8,3,6,13,14,27
11001,VILLA VACA GUZMAN (MUYUPAMPA),desnutricion global,desnutricion grave (g),2005-05-01,1,0,0,0,1,0,1
51501,VILLAZON,desnutricion global,desnutricion grave (g),2005-05-01,0,1,1,0,1,1,2
30904,VINTO,desnutricion global,desnutricion grave (g),2005-05-01,1,1,0,0,1,1,2
50602,VITICHI,desnutricion global,desnutricion grave (g),2005-05-01,1,1,0,0,1,1,2
70201,WARNES,desnutricion global,desnutricion grave (g),2005-05-01,4,1,0,1,4,2,6
20903,YACO,desnutricion global,desnutricion grave (g),2005-05-01,2,2,1,0,3,2,5
60301,YACUIBA,desnutricion global,desnutricion grave (g),2005-05-01,0,1,0,0,0,1,1
10602,YAMPARAEZ,desnutricion global,desnutricion grave (g),2005-05-01,5,2,3,5,8,7,15
70403,YAPACANI,desnutricion global,desnutricion grave (g),2005-05-01,2,2,0,1,2,3,5
50103,YOCALLA,desnutricion global,desnutricion grave (g),2005-05-01,1,0,0,1,1,1,2
10102,YOTALA,desnutricion global,desnutricion grave (g),2005-05-01,2,0,0,1,2,1,3
10301,ZUDAÑEZ,desnutricion global,desnutricion grave (g),2005-05-01,6,1,2,4,8,5,13
51302,ACACIO,desnutricion global,desnutricion grave (g),2005-06-01,1,2,0,0,1,2,3
30201,AIQUILE,desnutricion global,desnutricion grave (g),2005-06-01,0,2,1,1,1,3,4
10404,ALCALA,desnutricion global,desnutricion grave (g),2005-06-01,1,1,1,3,2,4,6
40603,ANTEQUERA,desnutricion global,desnutricion grave (g),2005-06-01,1,0,1,2,2,2,4
20701,APOLO,desnutricion global,desnutricion grave (g),2005-06-01,1,2,0,1,1,3,4
51301,ARAMPAMPA,desnutricion global,desnutricion grave (g),2005-06-01,2,1,2,5,4,6,10
30501,ARANI,desnutricion global,desnutricion grave (g),2005-06-01,0,1,0,1,0,2,2
30601,ARQUE,desnutricion global,desnutricion grave (g),2005-06-01,1,2,0,0,1,2,3
50802,ATOCHA,desnutricion global,desnutricion grave (g),2005-06-01,0,4,1,1,1,5,6
20503,AUCAPATA,desnutricion global,desnutricion grave (g),2005-06-01,4,0,0,0,4,0,4
20502,AYATA,desnutricion global,desnutricion grave (g),2005-06-01,0,2,0,0,0,2,2
30301,AYOPAYA (V. DE INDEPENDENCIA),desnutricion global,desnutricion grave (g),2005-06-01,2,4,0,1,2,5,7
10201,AZURDUY,desnutricion global,desnutricion grave (g),2005-06-01,2,1,0,2,2,3,5
50104,BELEN DE URMIRI,desnutricion global,desnutricion grave (g),2005-06-01,0,0,0,1,0,1,1
60202,BERMEJO,desnutricion global,desnutricion grave (g),2005-06-01,1,0,0,0,1,0,1
50301,BETANZOS,desnutricion global,desnutricion grave (g),2005-06-01,6,3,2,1,8,4,12
31501,BOLIVAR,desnutricion global,desnutricion grave (g),2005-06-01,0,4,0,0,0,4,4
70401,BUENA VISTA,desnutricion global,desnutricion grave (g),2005-06-01,1,2,0,0,1,2,3
70703,CABEZAS,desnutricion global,desnutricion grave (g),2005-06-01,0,1,0,1,0,2,2
20905,CAIROMA,desnutricion global,desnutricion grave (g),2005-06-01,1,0,0,3,1,3,4
51102,"CAIZA ""D""",desnutricion global,desnutricion grave (g),2005-06-01,0,1,0,0,0,1,1
21003,CAJUATA,desnutricion global,desnutricion grave (g),2005-06-01,0,1,0,0,0,1,1
21304,CALAMARCA,desnutricion global,desnutricion grave (g),2005-06-01,4,0,1,0,5,0,5
10701,CAMARGO,desnutricion global,desnutricion grave (g),2005-06-01,6,6,0,0,6,6,12
70706,CAMIRI,desnutricion global,desnutricion grave (g),2005-06-01,5,5,1,4,6,9,15
30701,CAPINOTA,desnutricion global,desnutricion grave (g),2005-06-01,5,4,3,5,8,9,17
40102,CARACOLLO,desnutricion global,desnutricion grave (g),2005-06-01,0,0,1,0,1,0,1
22001,CARANAVI,desnutricion global,desnutricion grave (g),2005-06-01,2,2,1,0,3,2,5
60302,CARAPARI,desnutricion global,desnutricion grave (g),2005-06-01,0,0,1,0,1,0,1
50702,CARIPUYO,desnutricion global,desnutricion grave (g),2005-06-01,2,3,6,5,8,8,16
40201,CHALLAPATA,desnutricion global,desnutricion grave (g),2005-06-01,1,1,1,2,2,3,5
50302,CHAQUI,desnutricion global,desnutricion grave (g),2005-06-01,1,3,1,3,2,6,8
70702,CHARAGUA,desnutricion global,desnutricion grave (g),2005-06-01,3,2,0,1,3,3,6
50202,CHAYANTA,desnutricion global,desnutricion grave (g),2005-06-01,2,3,0,2,2,5,7
31204,CHIMORE,desnutricion global,desnutricion grave (g),2005-06-01,0,0,0,1,0,1,1
21101,CHULUMANI (V. DE LA LIBERTAD),desnutricion global,desnutricion grave (g),2005-06-01,0,2,0,0,0,2,2
20501,CHUMA,desnutricion global,desnutricion grave (g),2005-06-01,1,0,0,2,1,2,3
30801,CLIZA,desnutricion global,desnutricion grave (g),2005-06-01,7,0,2,0,9,0,9
90101,COBIJA,desnutricion global,desnutricion grave (g),2005-06-01,1,2,0,1,1,3,4
30101,COCHABAMBA,desnutricion global,desnutricion grave (g),2005-06-01,7,5,1,2,8,7,15
30905,COLCAPIRHUA,desnutricion global,desnutricion grave (g),2005-06-01,3,4,1,0,4,4,8
50901,"COLCHA ""K""",desnutricion global,desnutricion grave (g),2005-06-01,0,1,0,0,0,1,1
31002,COLOMI,desnutricion global,desnutricion grave (g),2005-06-01,2,6,1,2,3,8,11
70603,COLPA BELGICA,desnutricion global,desnutricion grave (g),2005-06-01,0,1,0,0,0,1,1
50401,COLQUECHACA,desnutricion global,desnutricion grave (g),2005-06-01,5,10,6,8,11,18,29
21004,COLQUIRI,desnutricion global,desnutricion grave (g),2005-06-01,1,0,0,0,1,0,1
20304,COMANCHE,desnutricion global,desnutricion grave (g),2005-06-01,0,1,1,0,1,1,2
71301,COMARAPA,desnutricion global,desnutricion grave (g),2005-06-01,3,0,1,0,4,0,4
20605,COMBAYA,desnutricion global,desnutricion grave (g),2005-06-01,1,0,0,0,1,0,1
40301,CORQUE,desnutricion global,desnutricion grave (g),2005-06-01,0,0,1,0,1,0,1
50601,COTAGAITA,desnutricion global,desnutricion grave (g),2005-06-01,3,2,0,0,3,2,5
71106,CUATRO CAÑADAS,desnutricion global,desnutricion grave (g),2005-06-01,1,0,0,0,1,0,1
70704,CUEVO,desnutricion global,desnutricion grave (g),2005-06-01,0,0,1,0,1,0,1
10902,CULPINA,desnutricion global,desnutricion grave (g),2005-06-01,3,5,6,5,9,10,19
21602,CURVA,desnutricion global,desnutricion grave (g),2005-06-01,1,0,0,0,1,0,1
20105,EL ALTO,desnutricion global,desnutricion grave (g),2005-06-01,26,27,12,18,38,45,83
60502,EL PUENTE(TJA),desnutricion global,desnutricion grave (g),2005-06-01,0,0,0,1,0,1,1
70105,EL TORNO,desnutricion global,desnutricion grave (g),2005-06-01,1,0,1,0,2,0,2
60601,ENTRE RIOS,desnutricion global,desnutricion grave (g),2005-06-01,1,0,0,0,1,0,1
60601,ENTRE RIOS,desnutricion global,desnutricion grave (g),2005-06-01,0,1,1,2,1,3,4
80402,EXALTACION,desnutricion global,desnutricion grave (g),2005-06-01,0,2,3,0,3,2,5
71004,FERNANDEZ ALONSO,desnutricion global,desnutricion grave (g),2005-06-01,0,5,0,0,0,5,5
71002,GENERAL SAAVEDRA,desnutricion global,desnutricion grave (g),2005-06-01,1,2,0,0,1,2,3
21601,GRAL. J.J. PEREZ (CHARAZANI),desnutricion global,desnutricion grave (g),2005-06-01,0,2,0,0,0,2,2
20602,GUANAY,desnutricion global,desnutricion grave (g),2005-06-01,0,1,0,0,0,1,1
80202,GUAYARAMERIN,desnutricion global,desnutricion grave (g),2005-06-01,7,3,0,0,7,3,10
70705,GUTIERREZ,desnutricion global,desnutricion grave (g),2005-06-01,4,2,1,0,5,2,7
10502,HUACARETA,desnutricion global,desnutricion grave (g),2005-06-01,2,0,0,0,2,0,2
11002,HUACAYA (VILLA DE HUACAYA),desnutricion global,desnutricion grave (g),2005-06-01,1,0,0,0,1,0,1
40701,HUANUNI,desnutricion global,desnutricion grave (g),2005-06-01,1,2,0,0,1,2,3
10304,ICLA,desnutricion global,desnutricion grave (g),2005-06-01,3,1,1,0,4,1,5
10703,INCAHUASI,desnutricion global,desnutricion grave (g),2005-06-01,4,9,3,7,7,16,23
90402,INGAVI (HUMAITA),desnutricion global,desnutricion grave (g),2005-06-01,0,1,0,0,0,1,1
21001,INQUISIVI,desnutricion global,desnutricion grave (g),2005-06-01,4,0,0,0,4,0,4
21501,IXIAMAS,desnutricion global,desnutricion grave (g),2005-06-01,1,0,1,0,2,0,2
20806,JESUS DE MACHACA,desnutricion global,desnutricion grave (g),2005-06-01,2,1,0,0,2,1,3
21105,LA ASUNTA,desnutricion global,desnutricion grave (g),2005-06-01,1,0,0,0,1,0,1
70104,LA GUARDIA,desnutricion global,desnutricion grave (g),2005-06-01,2,2,1,1,3,3,6
20101,LA PAZ,desnutricion global,desnutricion grave (g),2005-06-01,13,13,6,11,19,24,43
70701,LAGUNILLAS,desnutricion global,desnutricion grave (g),2005-06-01,0,1,0,0,0,1,1
21202,LAJA,desnutricion global,desnutricion grave (g),2005-06-01,1,0,0,0,1,0,1
10903,LAS CARRERAS,desnutricion global,desnutricion grave (g),2005-06-01,0,0,0,1,0,1,1
50203,LLALLAGUA,desnutricion global,desnutricion grave (g),2005-06-01,6,6,6,0,12,6,18
20901,LURIBAY,desnutricion global,desnutricion grave (g),2005-06-01,2,2,0,0,2,2,4
40702,MACHACAMARCA,desnutricion global,desnutricion grave (g),2005-06-01,3,1,0,0,3,1,4
11003,MACHARETI,desnutricion global,desnutricion grave (g),2005-06-01,0,0,0,1,0,1,1
80801,MAGDALENA,desnutricion global,desnutricion grave (g),2005-06-01,1,0,0,0,1,0,1
20904,MALLA,desnutricion global,desnutricion grave (g),2005-06-01,1,3,0,0,1,3,4
20607,MAPIRI,desnutricion global,desnutricion grave (g),2005-06-01,0,2,0,3,0,5,5
71003,MINEROS,desnutricion global,desnutricion grave (g),2005-06-01,5,2,1,0,6,2,8
31301,MIZQUE,desnutricion global,desnutricion grave (g),2005-06-01,4,2,0,0,4,2,6
20402,MOCOMOCO,desnutricion global,desnutricion grave (g),2005-06-01,1,0,0,1,1,1,2
10303,MOJOCOYA,desnutricion global,desnutricion grave (g),2005-06-01,2,2,1,0,3,2,5
10501,MONTEAGUDO,desnutricion global,desnutricion grave (g),2005-06-01,2,3,2,1,4,4,8
71001,MONTERO,desnutricion global,desnutricion grave (g),2005-06-01,7,8,2,2,9,10,19
30302,MOROCHATA,desnutricion global,desnutricion grave (g),2005-06-01,3,2,0,0,3,2,5
50404,OCURI,desnutricion global,desnutricion grave (g),2005-06-01,3,4,6,2,9,6,15
70202,OKINAWA,desnutricion global,desnutricion grave (g),2005-06-01,0,0,1,0,1,0,1
30203,OMEREQUE,desnutricion global,desnutricion grave (g),2005-06-01,0,0,1,0,1,0,1
40101,ORURO,desnutricion global,desnutricion grave (g),2005-06-01,11,12,9,8,20,20,40
10401,PADILLA,desnutricion global,desnutricion grave (g),2005-06-01,1,1,0,1,1,2,3
20102,PALCA,desnutricion global,desnutricion grave (g),2005-06-01,0,1,0,0,0,1,1
21104,PALOS BLANCOS,desnutricion global,desnutricion grave (g),2005-06-01,2,1,0,0,2,1,3
70902,PAMPA GRANDE,desnutricion global,desnutricion grave (g),2005-06-01,1,0,0,0,1,0,1
30202,PASORAPA,desnutricion global,desnutricion grave (g),2005-06-01,1,0,0,0,1,0,1
40602,PAZÑA,desnutricion global,desnutricion grave (g),2005-06-01,0,1,0,1,0,2,2
50403,POCOATA,desnutricion global,desnutricion grave (g),2005-06-01,5,3,2,3,7,6,13
31203,POCONA,desnutricion global,desnutricion grave (g),2005-06-01,1,0,1,0,2,0,2
31202,POJO (CBBA),desnutricion global,desnutricion grave (g),2005-06-01,1,1,1,1,2,2,4
40601,POOPO,desnutricion global,desnutricion grave (g),2005-06-01,0,0,0,2,0,2,2
10103,POROMA,desnutricion global,desnutricion grave (g),2005-06-01,6,0,2,3,8,3,11
50101,POTOSI,desnutricion global,desnutricion grave (g),2005-06-01,8,10,8,3,16,13,29
10302,PRESTO,desnutricion global,desnutricion grave (g),2005-06-01,5,2,3,2,8,4,12
21201,PUCARANI,desnutricion global,desnutricion grave (g),2005-06-01,0,1,0,0,0,1,1
20403,PUERTO CARABUCO,desnutricion global,desnutricion grave (g),2005-06-01,0,0,0,1,0,1,1
90301,PUERTO GONZALO MORENO,desnutricion global,desnutricion grave (g),2005-06-01,1,0,0,0,1,0,1
71401,PUERTO SUAREZ,desnutricion global,desnutricion grave (g),2005-06-01,2,0,0,0,2,0,2
31205,PUERTO VILLARROEL,desnutricion global,desnutricion grave (g),2005-06-01,7,12,8,5,15,17,32
51101,PUNA,desnutricion global,desnutricion grave (g),2005-06-01,10,5,2,0,12,5,17
31401,PUNATA,desnutricion global,desnutricion grave (g),2005-06-01,1,0,0,0,1,0,1
30901,QUILLACOLLO,desnutricion global,desnutricion grave (g),2005-06-01,2,1,1,1,3,2,5
21002,QUIME,desnutricion global,desnutricion grave (g),2005-06-01,0,1,0,0,0,1,1
50402,RAVELO,desnutricion global,desnutricion grave (g),2005-06-01,11,10,5,5,16,15,31
80301,REYES,desnutricion global,desnutricion grave (g),2005-06-01,4,5,0,0,4,5,9
80201,RIBERALTA,desnutricion global,desnutricion grave (g),2005-06-01,11,24,10,12,21,36,57
80304,RURRENABAQUE,desnutricion global,desnutricion grave (g),2005-06-01,1,0,0,0,1,0,1
31001,SACABA,desnutricion global,desnutricion grave (g),2005-06-01,3,5,1,1,4,6,10
50701,SACACA,desnutricion global,desnutricion grave (g),2005-06-01,8,2,2,3,10,5,15
71302,SAIPINA,desnutricion global,desnutricion grave (g),2005-06-01,0,1,0,0,0,1,1
40801,SALINAS DE GARCI MENDOZA,desnutricion global,desnutricion grave (g),2005-06-01,1,0,0,0,1,0,1
70901,SAMAIPATA,desnutricion global,desnutricion grave (g),2005-06-01,0,1,0,0,0,1,1
80302,SAN BORJA,desnutricion global,desnutricion grave (g),2005-06-01,1,1,1,2,2,3,5
21502,SAN BUENA VENTURA,desnutricion global,desnutricion grave (g),2005-06-01,1,1,0,0,1,1,2
70402,SAN CARLOS,desnutricion global,desnutricion grave (g),2005-06-01,1,1,0,0,1,1,2
80501,SAN IGNACIO,desnutricion global,desnutricion grave (g),2005-06-01,1,0,2,2,3,2,5
70301,SAN IGNACIO DE VELASCO,desnutricion global,desnutricion grave (g),2005-06-01,3,5,3,8,6,13,19
80102,SAN JAVIER(BNI),desnutricion global,desnutricion grave (g),2005-06-01,0,0,0,1,0,1,1
70404,SAN JUAN DE YAPACANI,desnutricion global,desnutricion grave (g),2005-06-01,0,0,0,2,0,2,2
71104,SAN JULIAN,desnutricion global,desnutricion grave (g),2005-06-01,0,1,1,2,1,3,4
60501,SAN LORENZO(TJA),desnutricion global,desnutricion grave (g),2005-06-01,3,3,6,2,9,5,14
10702,SAN LUCAS,desnutricion global,desnutricion grave (g),2005-06-01,16,13,6,6,22,19,41
70302,SAN MIGUEL DE VELASCO,desnutricion global,desnutricion grave (g),2005-06-01,0,1,0,0,0,1,1
50501,SAN PEDRO DE BUENA VISTA,desnutricion global,desnutricion grave (g),2005-06-01,3,2,1,3,4,5,9
90202,SAN PEDRO(PND),desnutricion global,desnutricion grave (g),2005-06-01,0,1,0,0,0,1,1
70303,SAN RAFAEL,desnutricion global,desnutricion grave (g),2005-06-01,0,0,1,0,1,0,1
80401,SANTA ANA,desnutricion global,desnutricion grave (g),2005-06-01,1,0,0,0,1,0,1
70101,SANTA CRUZ DE LA SIERRA,desnutricion global,desnutricion grave (g),2005-06-01,56,44,15,13,71,57,128
80303,SANTA ROSA,desnutricion global,desnutricion grave (g),2005-06-01,1,0,0,0,1,0,1
70602,SANTA ROSA DEL SARA,desnutricion global,desnutricion grave (g),2005-06-01,2,0,0,1,2,1,3
20308,SANTIAGO DE CALLAPA,desnutricion global,desnutricion grave (g),2005-06-01,1,0,0,1,1,1,2
21901,SANTIAGO DE MACHACA,desnutricion global,desnutricion grave (g),2005-06-01,0,1,0,1,0,2,2
20902,SAPAHAQUI,desnutricion global,desnutricion grave (g),2005-06-01,1,0,0,1,1,1,2
30703,SICAYA,desnutricion global,desnutricion grave (g),2005-06-01,3,0,0,0,3,0,3
30902,SIPE SIPE,desnutricion global,desnutricion grave (g),2005-06-01,6,3,2,1,8,4,12
10403,SOPACHUY,desnutricion global,desnutricion grave (g),2005-06-01,1,5,0,2,1,7,8
40104,SORACACHI,desnutricion global,desnutricion grave (g),2005-06-01,1,0,0,0,1,0,1
10101,SUCRE,desnutricion global,desnutricion grave (g),2005-06-01,10,10,4,4,14,14,28
50303,TACOBAMBA,desnutricion global,desnutricion grave (g),2005-06-01,3,2,4,1,7,3,10
30602,TACOPAYA,desnutricion global,desnutricion grave (g),2005-06-01,3,1,2,2,5,3,8
31101,TAPACARI,desnutricion global,desnutricion grave (g),2005-06-01,2,3,1,3,3,6,9
10601,TARABUCO,desnutricion global,desnutricion grave (g),2005-06-01,15,15,7,8,22,23,45
20807,TARACO,desnutricion global,desnutricion grave (g),2005-06-01,1,0,0,0,1,0,1
30401,TARATA,desnutricion global,desnutricion grave (g),2005-06-01,3,0,0,0,3,0,3
60101,TARIJA,desnutricion global,desnutricion grave (g),2005-06-01,13,4,4,4,17,8,25
10202,TARVITA,desnutricion global,desnutricion grave (g),2005-06-01,1,0,0,0,1,0,1
20608,TEOPONTE,desnutricion global,desnutricion grave (g),2005-06-01,0,0,1,0,1,0,1
50102,TINGUIPAYA,desnutricion global,desnutricion grave (g),2005-06-01,7,9,1,8,8,17,25
20606,TIPUANI,desnutricion global,desnutricion grave (g),2005-06-01,0,1,0,0,0,1,1
30903,TIQUIPAYA,desnutricion global,desnutricion grave (g),2005-06-01,1,0,0,1,1,1,2
31601,TIRAQUE (CBBA),desnutricion global,desnutricion grave (g),2005-06-01,2,2,1,1,3,3,6
30802,TOCO,desnutricion global,desnutricion grave (g),2005-06-01,1,0,0,0,1,0,1
51202,TOMAVE,desnutricion global,desnutricion grave (g),2005-06-01,3,0,0,0,3,0,3
10402,TOMINA,desnutricion global,desnutricion grave (g),2005-06-01,1,2,0,2,1,4,5
50502,TORO TORO,desnutricion global,desnutricion grave (g),2005-06-01,11,15,4,3,15,18,33
31201,TOTORA(CBBA),desnutricion global,desnutricion grave (g),2005-06-01,2,1,1,2,3,3,6
80101,TRINIDAD,desnutricion global,desnutricion grave (g),2005-06-01,5,9,0,2,5,11,16
50801,TUPIZA,desnutricion global,desnutricion grave (g),2005-06-01,2,3,1,3,3,6,9
50201,UNCIA,desnutricion global,desnutricion grave (g),2005-06-01,2,2,2,3,4,5,9
60401,URIONDO (A. CONCEPCION),desnutricion global,desnutricion grave (g),2005-06-01,1,0,0,0,1,0,1
30502,VACAS,desnutricion global,desnutricion grave (g),2005-06-01,2,3,0,1,2,4,6
70801,VALLEGRANDE,desnutricion global,desnutricion grave (g),2005-06-01,0,1,0,2,0,3,3
20801,VIACHA,desnutricion global,desnutricion grave (g),2005-06-01,0,1,0,0,0,1,1
31302,VILA VILA,desnutricion global,desnutricion grave (g),2005-06-01,0,5,2,2,2,7,9
60303,VILLA MONTES,desnutricion global,desnutricion grave (g),2005-06-01,1,0,0,1,1,1,2
31402,VILLA RIVERO,desnutricion global,desnutricion grave (g),2005-06-01,1,0,0,0,1,0,1
10801,VILLA SERRANO,desnutricion global,desnutricion grave (g),2005-06-01,4,1,2,1,6,2,8
31003,VILLA TUNARI,desnutricion global,desnutricion grave (g),2005-06-01,3,7,0,0,3,7,10
51501,VILLAZON,desnutricion global,desnutricion grave (g),2005-06-01,0,2,0,1,0,3,3
50602,VITICHI,desnutricion global,desnutricion grave (g),2005-06-01,0,0,0,1,0,1,1
70201,WARNES,desnutricion global,desnutricion grave (g),2005-06-01,3,3,1,1,4,4,8
20903,YACO,desnutricion global,desnutricion grave (g),2005-06-01,1,2,1,1,2,3,5
60301,YACUIBA,desnutricion global,desnutricion grave (g),2005-06-01,2,1,1,0,3,1,4
10602,YAMPARAEZ,desnutricion global,desnutricion grave (g),2005-06-01,6,2,3,4,9,6,15
70403,YAPACANI,desnutricion global,desnutricion grave (g),2005-06-01,3,4,0,0,3,4,7
50103,YOCALLA,desnutricion global,desnutricion grave (g),2005-06-01,0,1,0,0,0,1,1
10102,YOTALA,desnutricion global,desnutricion grave (g),2005-06-01,2,0,2,0,4,0,4
60402,YUNCHARA,desnutricion global,desnutricion grave (g),2005-06-01,0,1,0,0,0,1,1
10301,ZUDAÑEZ,desnutricion global,desnutricion grave (g),2005-06-01,3,2,3,3,6,5,11
51302,ACACIO,desnutricion global,desnutricion grave (g),2005-07-01,2,6,0,1,2,7,9
20201,ACHACACHI,desnutricion global,desnutricion grave (g),2005-07-01,0,2,1,3,1,5,6
30201,AIQUILE,desnutricion global,desnutricion grave (g),2005-07-01,1,0,0,0,1,0,1
31303,ALALAY,desnutricion global,desnutricion grave (g),2005-07-01,1,2,0,0,1,2,3
10404,ALCALA,desnutricion global,desnutricion grave (g),2005-07-01,0,0,2,4,2,4,6
20202,ANCORAIMES,desnutricion global,desnutricion grave (g),2005-07-01,1,0,0,1,1,1,2
40603,ANTEQUERA,desnutricion global,desnutricion grave (g),2005-07-01,0,0,0,1,0,1,1
30402,ANZALDO,desnutricion global,desnutricion grave (g),2005-07-01,1,1,0,0,1,1,2
20701,APOLO,desnutricion global,desnutricion grave (g),2005-07-01,1,0,1,1,2,1,3
51301,ARAMPAMPA,desnutricion global,desnutricion grave (g),2005-07-01,2,0,0,1,2,1,3
30601,ARQUE,desnutricion global,desnutricion grave (g),2005-07-01,4,0,0,0,4,0,4
50802,ATOCHA,desnutricion global,desnutricion grave (g),2005-07-01,0,1,0,0,0,1,1
20503,AUCAPATA,desnutricion global,desnutricion grave (g),2005-07-01,0,0,1,0,1,0,1
20502,AYATA,desnutricion global,desnutricion grave (g),2005-07-01,1,1,0,0,1,1,2
21303,AYO AYO,desnutricion global,desnutricion grave (g),2005-07-01,2,0,0,1,2,1,3
30301,AYOPAYA (V. DE INDEPENDENCIA),desnutricion global,desnutricion grave (g),2005-07-01,0,1,0,0,0,1,1
10201,AZURDUY,desnutricion global,desnutricion grave (g),2005-07-01,3,5,1,3,4,8,12
60202,BERMEJO,desnutricion global,desnutricion grave (g),2005-07-01,0,0,0,1,0,1,1
50301,BETANZOS,desnutricion global,desnutricion grave (g),2005-07-01,8,3,7,3,15,6,21
31501,BOLIVAR,desnutricion global,desnutricion grave (g),2005-07-01,1,0,0,2,1,2,3
70401,BUENA VISTA,desnutricion global,desnutricion grave (g),2005-07-01,0,0,0,1,0,1,1
70703,CABEZAS,desnutricion global,desnutricion grave (g),2005-07-01,0,1,0,1,0,2,2
20905,CAIROMA,desnutricion global,desnutricion grave (g),2005-07-01,1,0,1,2,2,2,4
21003,CAJUATA,desnutricion global,desnutricion grave (g),2005-07-01,1,0,0,0,1,0,1
21304,CALAMARCA,desnutricion global,desnutricion grave (g),2005-07-01,5,0,1,1,6,1,7
10701,CAMARGO,desnutricion global,desnutricion grave (g),2005-07-01,1,2,0,1,1,3,4
70706,CAMIRI,desnutricion global,desnutricion grave (g),2005-07-01,0,0,3,2,3,2,5
30701,CAPINOTA,desnutricion global,desnutricion grave (g),2005-07-01,1,4,0,0,1,4,5
40102,CARACOLLO,desnutricion global,desnutricion grave (g),2005-07-01,1,0,0,0,1,0,1
22001,CARANAVI,desnutricion global,desnutricion grave (g),2005-07-01,4,2,0,1,4,3,7
50702,CARIPUYO,desnutricion global,desnutricion grave (g),2005-07-01,1,0,0,5,1,5,6
40201,CHALLAPATA,desnutricion global,desnutricion grave (g),2005-07-01,4,1,0,0,4,1,5
50302,CHAQUI,desnutricion global,desnutricion grave (g),2005-07-01,0,1,0,2,0,3,3
70702,CHARAGUA,desnutricion global,desnutricion grave (g),2005-07-01,3,2,3,4,6,6,12
50202,CHAYANTA,desnutricion global,desnutricion grave (g),2005-07-01,4,2,1,1,5,3,8
20501,CHUMA,desnutricion global,desnutricion grave (g),2005-07-01,1,3,1,2,2,5,7
30801,CLIZA,desnutricion global,desnutricion grave (g),2005-07-01,0,1,0,0,0,1,1
90101,COBIJA,desnutricion global,desnutricion grave (g),2005-07-01,0,1,0,0,0,1,1
30101,COCHABAMBA,desnutricion global,desnutricion grave (g),2005-07-01,3,9,0,5,3,14,17
30905,COLCAPIRHUA,desnutricion global,desnutricion grave (g),2005-07-01,2,0,0,2,2,2,4
31002,COLOMI,desnutricion global,desnutricion grave (g),2005-07-01,3,1,0,0,3,1,4
50401,COLQUECHACA,desnutricion global,desnutricion grave (g),2005-07-01,12,8,6,3,18,11,29
21306,COLQUENCHA,desnutricion global,desnutricion grave (g),2005-07-01,1,0,1,0,2,0,2
21004,COLQUIRI,desnutricion global,desnutricion grave (g),2005-07-01,3,1,2,3,5,4,9
71301,COMARAPA,desnutricion global,desnutricion grave (g),2005-07-01,1,1,0,0,1,1,2
21401,COROICO,desnutricion global,desnutricion grave (g),2005-07-01,0,1,0,0,0,1,1
40301,CORQUE,desnutricion global,desnutricion grave (g),2005-07-01,0,1,0,0,0,1,1
50601,COTAGAITA,desnutricion global,desnutricion grave (g),2005-07-01,7,5,0,0,7,5,12
70102,COTOCA,desnutricion global,desnutricion grave (g),2005-07-01,2,0,0,0,2,0,2
71106,CUATRO CAÑADAS,desnutricion global,desnutricion grave (g),2005-07-01,1,0,0,0,1,0,1
10902,CULPINA,desnutricion global,desnutricion grave (g),2005-07-01,4,2,6,2,10,4,14
21602,CURVA,desnutricion global,desnutricion grave (g),2005-07-01,0,0,0,1,0,1,1
20105,EL ALTO,desnutricion global,desnutricion grave (g),2005-07-01,46,27,10,13,56,40,96
60502,EL PUENTE(TJA),desnutricion global,desnutricion grave (g),2005-07-01,0,0,0,1,0,1,1
70105,EL TORNO,desnutricion global,desnutricion grave (g),2005-07-01,3,0,0,0,3,0,3
60601,ENTRE RIOS,desnutricion global,desnutricion grave (g),2005-07-01,0,0,1,2,1,2,3
60601,ENTRE RIOS,desnutricion global,desnutricion grave (g),2005-07-01,0,1,0,2,0,3,3
71004,FERNANDEZ ALONSO,desnutricion global,desnutricion grave (g),2005-07-01,2,1,1,0,3,1,4
21601,GRAL. J.J. PEREZ (CHARAZANI),desnutricion global,desnutricion grave (g),2005-07-01,2,1,0,1,2,2,4
20602,GUANAY,desnutricion global,desnutricion grave (g),2005-07-01,0,0,2,1,2,1,3
80202,GUAYARAMERIN,desnutricion global,desnutricion grave (g),2005-07-01,0,3,0,0,0,3,3
70705,GUTIERREZ,desnutricion global,desnutricion grave (g),2005-07-01,1,1,1,0,2,1,3
10502,HUACARETA,desnutricion global,desnutricion grave (g),2005-07-01,1,0,0,0,1,0,1
11002,HUACAYA (VILLA DE HUACAYA),desnutricion global,desnutricion grave (g),2005-07-01,0,0,1,0,1,0,1
40701,HUANUNI,desnutricion global,desnutricion grave (g),2005-07-01,6,1,0,1,6,2,8
10304,ICLA,desnutricion global,desnutricion grave (g),2005-07-01,7,3,2,3,9,6,15
10703,INCAHUASI,desnutricion global,desnutricion grave (g),2005-07-01,4,5,3,3,7,8,15
21001,INQUISIVI,desnutricion global,desnutricion grave (g),2005-07-01,1,0,1,1,2,1,3
21501,IXIAMAS,desnutricion global,desnutricion grave (g),2005-07-01,1,1,0,0,1,1,2
20806,JESUS DE MACHACA,desnutricion global,desnutricion grave (g),2005-07-01,2,1,1,0,3,1,4
21105,LA ASUNTA,desnutricion global,desnutricion grave (g),2005-07-01,1,3,0,0,1,3,4
70104,LA GUARDIA,desnutricion global,desnutricion grave (g),2005-07-01,3,1,3,1,6,2,8
20101,LA PAZ,desnutricion global,desnutricion grave (g),2005-07-01,14,9,2,3,16,12,28
50203,LLALLAGUA,desnutricion global,desnutricion grave (g),2005-07-01,8,7,3,3,11,10,21
20901,LURIBAY,desnutricion global,desnutricion grave (g),2005-07-01,3,3,0,0,3,3,6
40702,MACHACAMARCA,desnutricion global,desnutricion grave (g),2005-07-01,1,0,0,0,1,0,1
20607,MAPIRI,desnutricion global,desnutricion grave (g),2005-07-01,2,2,0,0,2,2,4
71003,MINEROS,desnutricion global,desnutricion grave (g),2005-07-01,0,0,1,0,1,0,1
31301,MIZQUE,desnutricion global,desnutricion grave (g),2005-07-01,4,4,0,0,4,4,8
20402,MOCOMOCO,desnutricion global,desnutricion grave (g),2005-07-01,4,1,0,3,4,4,8
10303,MOJOCOYA,desnutricion global,desnutricion grave (g),2005-07-01,0,1,1,0,1,1,2
10501,MONTEAGUDO,desnutricion global,desnutricion grave (g),2005-07-01,1,2,2,1,3,3,6
71001,MONTERO,desnutricion global,desnutricion grave (g),2005-07-01,2,5,2,3,4,8,12
30302,MOROCHATA,desnutricion global,desnutricion grave (g),2005-07-01,5,0,1,2,6,2,8
50404,OCURI,desnutricion global,desnutricion grave (g),2005-07-01,5,7,5,4,10,11,21
40101,ORURO,desnutricion global,desnutricion grave (g),2005-07-01,5,6,3,0,8,6,14
60201,PADCAYA,desnutricion global,desnutricion grave (g),2005-07-01,0,0,1,0,1,0,1
10401,PADILLA,desnutricion global,desnutricion grave (g),2005-07-01,1,0,0,1,1,1,2
20102,PALCA,desnutricion global,desnutricion grave (g),2005-07-01,1,0,0,0,1,0,1
21104,PALOS BLANCOS,desnutricion global,desnutricion grave (g),2005-07-01,1,0,0,2,1,2,3
70902,PAMPA GRANDE,desnutricion global,desnutricion grave (g),2005-07-01,1,0,0,0,1,0,1
40602,PAZÑA,desnutricion global,desnutricion grave (g),2005-07-01,1,1,0,0,1,1,2
50403,POCOATA,desnutricion global,desnutricion grave (g),2005-07-01,2,8,2,3,4,11,15
31203,POCONA,desnutricion global,desnutricion grave (g),2005-07-01,1,0,0,0,1,0,1
31202,POJO (CBBA),desnutricion global,desnutricion grave (g),2005-07-01,1,3,0,2,1,5,6
51203,PORCO,desnutricion global,desnutricion grave (g),2005-07-01,0,1,0,0,0,1,1
10103,POROMA,desnutricion global,desnutricion grave (g),2005-07-01,5,3,4,6,9,9,18
50101,POTOSI,desnutricion global,desnutricion grave (g),2005-07-01,5,14,1,2,6,16,22
10302,PRESTO,desnutricion global,desnutricion grave (g),2005-07-01,3,3,2,1,5,4,9
20403,PUERTO CARABUCO,desnutricion global,desnutricion grave (g),2005-07-01,2,0,1,0,3,0,3
31205,PUERTO VILLARROEL,desnutricion global,desnutricion grave (g),2005-07-01,3,2,6,3,9,5,14
51101,PUNA,desnutricion global,desnutricion grave (g),2005-07-01,12,13,3,4,15,17,32
31401,PUNATA,desnutricion global,desnutricion grave (g),2005-07-01,2,4,1,0,3,4,7
30901,QUILLACOLLO,desnutricion global,desnutricion grave (g),2005-07-01,0,1,3,4,3,5,8
21002,QUIME,desnutricion global,desnutricion grave (g),2005-07-01,0,2,0,0,0,2,2
50402,RAVELO,desnutricion global,desnutricion grave (g),2005-07-01,15,20,6,4,21,24,45
80301,REYES,desnutricion global,desnutricion grave (g),2005-07-01,1,4,0,1,1,5,6
80201,RIBERALTA,desnutricion global,desnutricion grave (g),2005-07-01,10,21,9,9,19,30,49
31001,SACABA,desnutricion global,desnutricion grave (g),2005-07-01,3,2,2,0,5,2,7
50701,SACACA,desnutricion global,desnutricion grave (g),2005-07-01,6,2,1,1,7,3,10
71105,SAN ANTONIO DE LOMERIO,desnutricion global,desnutricion grave (g),2005-07-01,0,1,0,0,0,1,1
31403,SAN BENITO,desnutricion global,desnutricion grave (g),2005-07-01,1,0,0,0,1,0,1
80302,SAN BORJA,desnutricion global,desnutricion grave (g),2005-07-01,7,3,3,3,10,6,16
21502,SAN BUENA VENTURA,desnutricion global,desnutricion grave (g),2005-07-01,1,2,0,1,1,3,4
70402,SAN CARLOS,desnutricion global,desnutricion grave (g),2005-07-01,1,1,0,0,1,1,2
80501,SAN IGNACIO,desnutricion global,desnutricion grave (g),2005-07-01,2,3,1,3,3,6,9
70301,SAN IGNACIO DE VELASCO,desnutricion global,desnutricion grave (g),2005-07-01,2,9,4,5,6,14,20
80102,SAN JAVIER(BNI),desnutricion global,desnutricion grave (g),2005-07-01,1,0,0,0,1,0,1
71102,SAN JAVIER(STC),desnutricion global,desnutricion grave (g),2005-07-01,0,0,0,2,0,2,2
70404,SAN JUAN DE YAPACANI,desnutricion global,desnutricion grave (g),2005-07-01,0,1,0,0,0,1,1
71104,SAN JULIAN,desnutricion global,desnutricion grave (g),2005-07-01,2,0,1,1,3,1,4
60501,SAN LORENZO(TJA),desnutricion global,desnutricion grave (g),2005-07-01,3,5,6,6,9,11,20
10702,SAN LUCAS,desnutricion global,desnutricion grave (g),2005-07-01,13,8,2,7,15,15,30
70302,SAN MIGUEL DE VELASCO,desnutricion global,desnutricion grave (g),2005-07-01,2,1,0,0,2,1,3
71005,SAN PEDRO,desnutricion global,desnutricion grave (g),2005-07-01,0,0,1,0,1,0,1
50501,SAN PEDRO DE BUENA VISTA,desnutricion global,desnutricion grave (g),2005-07-01,5,1,9,7,14,8,22
70303,SAN RAFAEL,desnutricion global,desnutricion grave (g),2005-07-01,0,0,0,3,0,3,3
70101,SANTA CRUZ DE LA SIERRA,desnutricion global,desnutricion grave (g),2005-07-01,25,24,11,13,36,37,73
80303,SANTA ROSA,desnutricion global,desnutricion grave (g),2005-07-01,3,0,0,0,3,0,3
70602,SANTA ROSA DEL SARA,desnutricion global,desnutricion grave (g),2005-07-01,2,1,0,0,2,1,3
41401,SANTIAGO DE HUARI,desnutricion global,desnutricion grave (g),2005-07-01,1,0,0,0,1,0,1
21901,SANTIAGO DE MACHACA,desnutricion global,desnutricion grave (g),2005-07-01,0,1,1,1,1,2,3
20902,SAPAHAQUI,desnutricion global,desnutricion grave (g),2005-07-01,0,1,0,0,0,1,1
90303,SENA,desnutricion global,desnutricion grave (g),2005-07-01,1,2,0,0,1,2,3
21301,SICA SICA (VILLA AROMA),desnutricion global,desnutricion grave (g),2005-07-01,1,0,0,0,1,0,1
30703,SICAYA,desnutricion global,desnutricion grave (g),2005-07-01,2,0,0,0,2,0,2
30902,SIPE SIPE,desnutricion global,desnutricion grave (g),2005-07-01,3,2,0,0,3,2,5
10403,SOPACHUY,desnutricion global,desnutricion grave (g),2005-07-01,1,3,0,2,1,5,6
40104,SORACACHI,desnutricion global,desnutricion grave (g),2005-07-01,3,1,0,0,3,1,4
20601,SORATA,desnutricion global,desnutricion grave (g),2005-07-01,1,0,0,0,1,0,1
10101,SUCRE,desnutricion global,desnutricion grave (g),2005-07-01,8,10,1,4,9,14,23
50303,TACOBAMBA,desnutricion global,desnutricion grave (g),2005-07-01,1,2,0,1,1,3,4
30602,TACOPAYA,desnutricion global,desnutricion grave (g),2005-07-01,1,3,1,0,2,3,5
31101,TAPACARI,desnutricion global,desnutricion grave (g),2005-07-01,3,2,1,1,4,3,7
10601,TARABUCO,desnutricion global,desnutricion grave (g),2005-07-01,13,14,6,11,19,25,44
20807,TARACO,desnutricion global,desnutricion grave (g),2005-07-01,1,0,0,0,1,0,1
30401,TARATA,desnutricion global,desnutricion grave (g),2005-07-01,0,0,0,1,0,1,1
60101,TARIJA,desnutricion global,desnutricion grave (g),2005-07-01,5,3,0,2,5,5,10
10202,TARVITA,desnutricion global,desnutricion grave (g),2005-07-01,1,3,6,3,7,6,13
20608,TEOPONTE,desnutricion global,desnutricion grave (g),2005-07-01,0,0,2,0,2,0,2
50102,TINGUIPAYA,desnutricion global,desnutricion grave (g),2005-07-01,6,7,3,2,9,9,18
20606,TIPUANI,desnutricion global,desnutricion grave (g),2005-07-01,1,0,0,0,1,0,1
30903,TIQUIPAYA,desnutricion global,desnutricion grave (g),2005-07-01,0,1,0,0,0,1,1
31601,TIRAQUE (CBBA),desnutricion global,desnutricion grave (g),2005-07-01,1,3,0,3,1,6,7
30802,TOCO,desnutricion global,desnutricion grave (g),2005-07-01,1,0,1,0,2,0,2
51202,TOMAVE,desnutricion global,desnutricion grave (g),2005-07-01,1,1,0,0,1,1,2
10402,TOMINA,desnutricion global,desnutricion grave (g),2005-07-01,2,1,3,5,5,6,11
50502,TORO TORO,desnutricion global,desnutricion grave (g),2005-07-01,4,2,0,4,4,6,10
41301,TOTORA(ORR),desnutricion global,desnutricion grave (g),2005-07-01,0,0,0,1,0,1,1
80101,TRINIDAD,desnutricion global,desnutricion grave (g),2005-07-01,2,1,0,1,2,2,4
50801,TUPIZA,desnutricion global,desnutricion grave (g),2005-07-01,3,1,0,1,3,2,5
50201,UNCIA,desnutricion global,desnutricion grave (g),2005-07-01,0,0,1,2,1,2,3
60401,URIONDO (A. CONCEPCION),desnutricion global,desnutricion grave (g),2005-07-01,1,0,0,0,1,0,1
51201,UYUNI,desnutricion global,desnutricion grave (g),2005-07-01,0,1,2,0,2,1,3
30502,VACAS,desnutricion global,desnutricion grave (g),2005-07-01,4,1,0,2,4,3,7
70801,VALLEGRANDE,desnutricion global,desnutricion grave (g),2005-07-01,1,0,1,2,2,2,4
20801,VIACHA,desnutricion global,desnutricion grave (g),2005-07-01,1,3,0,0,1,3,4
31302,VILA VILA,desnutricion global,desnutricion grave (g),2005-07-01,2,3,0,0,2,3,5
60303,VILLA MONTES,desnutricion global,desnutricion grave (g),2005-07-01,1,0,1,0,2,0,2
10801,VILLA SERRANO,desnutricion global,desnutricion grave (g),2005-07-01,5,2,2,1,7,3,10
31003,VILLA TUNARI,desnutricion global,desnutricion grave (g),2005-07-01,1,1,2,2,3,3,6
11001,VILLA VACA GUZMAN (MUYUPAMPA),desnutricion global,desnutricion grave (g),2005-07-01,0,3,0,0,0,3,3
51501,VILLAZON,desnutricion global,desnutricion grave (g),2005-07-01,1,0,0,0,1,0,1
30904,VINTO,desnutricion global,desnutricion grave (g),2005-07-01,1,0,0,0,1,0,1
50602,VITICHI,desnutricion global,desnutricion grave (g),2005-07-01,0,1,2,0,2,1,3
20306,WALDO BALLIVIAN,desnutricion global,desnutricion grave (g),2005-07-01,0,1,0,0,0,1,1
70201,WARNES,desnutricion global,desnutricion grave (g),2005-07-01,2,2,1,0,3,2,5
20903,YACO,desnutricion global,desnutricion grave (g),2005-07-01,2,0,0,0,2,0,2
60301,YACUIBA,desnutricion global,desnutricion grave (g),2005-07-01,1,0,1,0,2,0,2
10602,YAMPARAEZ,desnutricion global,desnutricion grave (g),2005-07-01,3,2,2,3,5,5,10
70403,YAPACANI,desnutricion global,desnutricion grave (g),2005-07-01,3,1,0,0,3,1,4
50103,YOCALLA,desnutricion global,desnutricion grave (g),2005-07-01,1,0,0,0,1,0,1
10102,YOTALA,desnutricion global,desnutricion grave (g),2005-07-01,3,1,1,0,4,1,5
10301,ZUDAÑEZ,desnutricion global,desnutricion grave (g),2005-07-01,3,5,3,2,6,7,13
51302,ACACIO,desnutricion global,desnutricion grave (g),2005-08-01,1,3,3,1,4,4,8
20201,ACHACACHI,desnutricion global,desnutricion grave (g),2005-08-01,2,2,0,3,2,5,7
30201,AIQUILE,desnutricion global,desnutricion grave (g),2005-08-01,1,3,1,3,2,6,8
10404,ALCALA,desnutricion global,desnutricion grave (g),2005-08-01,1,1,0,2,1,3,4
20202,ANCORAIMES,desnutricion global,desnutricion grave (g),2005-08-01,2,1,0,1,2,2,4
41201,ANDAMARCA,desnutricion global,desnutricion grave (g),2005-08-01,1,1,0,0,1,1,2
20701,APOLO,desnutricion global,desnutricion grave (g),2005-08-01,0,2,1,1,1,3,4
51301,ARAMPAMPA,desnutricion global,desnutricion grave (g),2005-08-01,9,1,1,2,10,3,13
30601,ARQUE,desnutricion global,desnutricion grave (g),2005-08-01,2,3,0,1,2,4,6
20503,AUCAPATA,desnutricion global,desnutricion grave (g),2005-08-01,1,0,0,0,1,0,1
20502,AYATA,desnutricion global,desnutricion grave (g),2005-08-01,3,0,0,0,3,0,3
21303,AYO AYO,desnutricion global,desnutricion grave (g),2005-08-01,0,1,0,0,0,1,1
30301,AYOPAYA (V. DE INDEPENDENCIA),desnutricion global,desnutricion grave (g),2005-08-01,4,5,2,2,6,7,13
10201,AZURDUY,desnutricion global,desnutricion grave (g),2005-08-01,3,1,0,2,3,3,6
21203,BATALLAS,desnutricion global,desnutricion grave (g),2005-08-01,0,1,0,0,0,1,1
50104,BELEN DE URMIRI,desnutricion global,desnutricion grave (g),2005-08-01,1,0,0,0,1,0,1
60202,BERMEJO,desnutricion global,desnutricion grave (g),2005-08-01,0,1,0,0,0,1,1
50301,BETANZOS,desnutricion global,desnutricion grave (g),2005-08-01,9,7,1,7,10,14,24
31501,BOLIVAR,desnutricion global,desnutricion grave (g),2005-08-01,3,4,1,3,4,7,11
70707,BOYUIBE,desnutricion global,desnutricion grave (g),2005-08-01,0,1,0,0,0,1,1
70401,BUENA VISTA,desnutricion global,desnutricion grave (g),2005-08-01,0,1,0,0,0,1,1
70703,CABEZAS,desnutricion global,desnutricion grave (g),2005-08-01,0,0,1,1,1,1,2
20905,CAIROMA,desnutricion global,desnutricion grave (g),2005-08-01,5,2,1,3,6,5,11
51102,"CAIZA ""D""",desnutricion global,desnutricion grave (g),2005-08-01,1,0,1,1,2,1,3
21003,CAJUATA,desnutricion global,desnutricion grave (g),2005-08-01,3,6,0,1,3,7,10
20303,CALACOTO,desnutricion global,desnutricion grave (g),2005-08-01,1,0,0,0,1,0,1
21304,CALAMARCA,desnutricion global,desnutricion grave (g),2005-08-01,2,1,1,0,3,1,4
10701,CAMARGO,desnutricion global,desnutricion grave (g),2005-08-01,6,2,2,3,8,5,13
70706,CAMIRI,desnutricion global,desnutricion grave (g),2005-08-01,2,3,1,5,3,8,11
30701,CAPINOTA,desnutricion global,desnutricion grave (g),2005-08-01,3,4,3,3,6,7,13
20302,CAQUIAVIRI,desnutricion global,desnutricion grave (g),2005-08-01,0,1,0,0,0,1,1
40102,CARACOLLO,desnutricion global,desnutricion grave (g),2005-08-01,1,0,1,0,2,0,2
22001,CARANAVI,desnutricion global,desnutricion grave (g),2005-08-01,6,6,0,1,6,7,13
50702,CARIPUYO,desnutricion global,desnutricion grave (g),2005-08-01,4,5,3,3,7,8,15
40201,CHALLAPATA,desnutricion global,desnutricion grave (g),2005-08-01,5,2,2,4,7,6,13
50302,CHAQUI,desnutricion global,desnutricion grave (g),2005-08-01,0,1,0,3,0,4,4
70702,CHARAGUA,desnutricion global,desnutricion grave (g),2005-08-01,3,2,1,0,4,2,6
50202,CHAYANTA,desnutricion global,desnutricion grave (g),2005-08-01,3,5,2,3,5,8,13
31204,CHIMORE,desnutricion global,desnutricion grave (g),2005-08-01,2,2,2,0,4,2,6
40903,CHIPAYA,desnutricion global,desnutricion grave (g),2005-08-01,0,0,2,0,2,0,2
20501,CHUMA,desnutricion global,desnutricion grave (g),2005-08-01,2,3,1,1,3,4,7
30801,CLIZA,desnutricion global,desnutricion grave (g),2005-08-01,2,3,0,0,2,3,5
90101,COBIJA,desnutricion global,desnutricion grave (g),2005-08-01,0,0,0,1,0,1,1
30101,COCHABAMBA,desnutricion global,desnutricion grave (g),2005-08-01,8,4,2,1,10,5,15
30905,COLCAPIRHUA,desnutricion global,desnutricion grave (g),2005-08-01,2,0,0,0,2,0,2
31002,COLOMI,desnutricion global,desnutricion grave (g),2005-08-01,2,0,0,0,2,0,2
70603,COLPA BELGICA,desnutricion global,desnutricion grave (g),2005-08-01,0,2,0,1,0,3,3
50401,COLQUECHACA,desnutricion global,desnutricion grave (g),2005-08-01,7,32,3,1,10,33,43
21306,COLQUENCHA,desnutricion global,desnutricion grave (g),2005-08-01,1,1,0,1,1,2,3
21004,COLQUIRI,desnutricion global,desnutricion grave (g),2005-08-01,0,0,1,1,1,1,2
71301,COMARAPA,desnutricion global,desnutricion grave (g),2005-08-01,2,0,0,0,2,0,2
20605,COMBAYA,desnutricion global,desnutricion grave (g),2005-08-01,1,0,0,0,1,0,1
71101,CONCEPCION,desnutricion global,desnutricion grave (g),2005-08-01,0,1,0,0,0,1,1
21701,COPACABANA,desnutricion global,desnutricion grave (g),2005-08-01,1,1,0,0,1,1,2
20301,CORO CORO,desnutricion global,desnutricion grave (g),2005-08-01,1,0,0,0,1,0,1
50601,COTAGAITA,desnutricion global,desnutricion grave (g),2005-08-01,3,3,0,3,3,6,9
70102,COTOCA,desnutricion global,desnutricion grave (g),2005-08-01,0,1,2,0,2,1,3
10902,CULPINA,desnutricion global,desnutricion grave (g),2005-08-01,3,8,2,5,5,13,18
21602,CURVA,desnutricion global,desnutricion grave (g),2005-08-01,0,0,1,1,1,1,2
20804,DESAGUADERO,desnutricion global,desnutricion grave (g),2005-08-01,1,0,0,0,1,0,1
20105,EL ALTO,desnutricion global,desnutricion grave (g),2005-08-01,26,24,19,9,45,33,78
40103,EL CHORO,desnutricion global,desnutricion grave (g),2005-08-01,1,0,0,0,1,0,1
60502,EL PUENTE(TJA),desnutricion global,desnutricion grave (g),2005-08-01,0,1,0,0,0,1,1
70105,EL TORNO,desnutricion global,desnutricion grave (g),2005-08-01,0,0,1,0,1,0,1
10405,EL VILLAR,desnutricion global,desnutricion grave (g),2005-08-01,0,0,0,1,0,1,1
60601,ENTRE RIOS,desnutricion global,desnutricion grave (g),2005-08-01,3,4,0,3,3,7,10
60601,ENTRE RIOS,desnutricion global,desnutricion grave (g),2005-08-01,1,0,0,3,1,3,4
80402,EXALTACION,desnutricion global,desnutricion grave (g),2005-08-01,0,0,1,0,1,0,1
71004,FERNANDEZ ALONSO,desnutricion global,desnutricion grave (g),2005-08-01,2,2,0,0,2,2,4
71002,GENERAL SAAVEDRA,desnutricion global,desnutricion grave (g),2005-08-01,2,3,9,1,11,4,15
21601,GRAL. J.J. PEREZ (CHARAZANI),desnutricion global,desnutricion grave (g),2005-08-01,2,0,0,0,2,0,2
20602,GUANAY,desnutricion global,desnutricion grave (g),2005-08-01,0,1,0,1,0,2,2
20802,GUAQUI,desnutricion global,desnutricion grave (g),2005-08-01,1,0,0,0,1,0,1
80202,GUAYARAMERIN,desnutricion global,desnutricion grave (g),2005-08-01,2,2,0,3,2,5,7
70705,GUTIERREZ,desnutricion global,desnutricion grave (g),2005-08-01,0,1,2,1,2,2,4
10502,HUACARETA,desnutricion global,desnutricion grave (g),2005-08-01,0,1,1,0,1,1,2
80803,HUARACAJE,desnutricion global,desnutricion grave (g),2005-08-01,1,0,0,0,1,0,1
10304,ICLA,desnutricion global,desnutricion grave (g),2005-08-01,2,1,2,1,4,2,6
10703,INCAHUASI,desnutricion global,desnutricion grave (g),2005-08-01,19,9,0,8,19,17,36
90402,INGAVI (HUMAITA),desnutricion global,desnutricion grave (g),2005-08-01,1,0,0,0,1,0,1
21001,INQUISIVI,desnutricion global,desnutricion grave (g),2005-08-01,1,1,3,3,4,4,8
21501,IXIAMAS,desnutricion global,desnutricion grave (g),2005-08-01,0,1,0,0,0,1,1
20806,JESUS DE MACHACA,desnutricion global,desnutricion grave (g),2005-08-01,1,0,1,0,2,0,2
21105,LA ASUNTA,desnutricion global,desnutricion grave (g),2005-08-01,2,0,0,0,2,0,2
70104,LA GUARDIA,desnutricion global,desnutricion grave (g),2005-08-01,0,1,1,0,1,1,2
20101,LA PAZ,desnutricion global,desnutricion grave (g),2005-08-01,16,9,4,5,20,14,34
70701,LAGUNILLAS,desnutricion global,desnutricion grave (g),2005-08-01,0,1,0,0,0,1,1
50203,LLALLAGUA,desnutricion global,desnutricion grave (g),2005-08-01,16,4,8,5,24,9,33
20901,LURIBAY,desnutricion global,desnutricion grave (g),2005-08-01,1,1,1,0,2,1,3
40702,MACHACAMARCA,desnutricion global,desnutricion grave (g),2005-08-01,1,0,0,0,1,0,1
11003,MACHARETI,desnutricion global,desnutricion grave (g),2005-08-01,0,0,1,0,1,0,1
80801,MAGDALENA,desnutricion global,desnutricion grave (g),2005-08-01,1,0,0,0,1,0,1
70903,MAIRANA,desnutricion global,desnutricion grave (g),2005-08-01,0,0,0,1,0,1,1
20904,MALLA,desnutricion global,desnutricion grave (g),2005-08-01,0,2,0,0,0,2,2
20607,MAPIRI,desnutricion global,desnutricion grave (g),2005-08-01,0,1,0,0,0,1,1
20103,MECAPACA,desnutricion global,desnutricion grave (g),2005-08-01,1,0,0,0,1,0,1
71003,MINEROS,desnutricion global,desnutricion grave (g),2005-08-01,3,1,3,1,6,2,8
31301,MIZQUE,desnutricion global,desnutricion grave (g),2005-08-01,0,7,4,3,4,10,14
20402,MOCOMOCO,desnutricion global,desnutricion grave (g),2005-08-01,0,1,0,0,0,1,1
10303,MOJOCOYA,desnutricion global,desnutricion grave (g),2005-08-01,2,0,1,0,3,0,3
10501,MONTEAGUDO,desnutricion global,desnutricion grave (g),2005-08-01,4,3,1,2,5,5,10
71001,MONTERO,desnutricion global,desnutricion grave (g),2005-08-01,7,10,4,4,11,14,25
70803,MORO MORO,desnutricion global,desnutricion grave (g),2005-08-01,1,0,0,0,1,0,1
30302,MOROCHATA,desnutricion global,desnutricion grave (g),2005-08-01,6,4,1,0,7,4,11
90501,NUEVO MANOA (NUEVA ESPERANZA),desnutricion global,desnutricion grave (g),2005-08-01,0,1,0,0,0,1,1
50404,OCURI,desnutricion global,desnutricion grave (g),2005-08-01,9,7,4,1,13,8,21
70202,OKINAWA,desnutricion global,desnutricion grave (g),2005-08-01,1,0,0,0,1,0,1
40101,ORURO,desnutricion global,desnutricion grave (g),2005-08-01,10,15,1,1,11,16,27
60201,PADCAYA,desnutricion global,desnutricion grave (g),2005-08-01,1,0,0,0,1,0,1
10401,PADILLA,desnutricion global,desnutricion grave (g),2005-08-01,0,1,1,0,1,1,2
20102,PALCA,desnutricion global,desnutricion grave (g),2005-08-01,0,1,0,0,0,1,1
21104,PALOS BLANCOS,desnutricion global,desnutricion grave (g),2005-08-01,1,0,0,0,1,0,1
70902,PAMPA GRANDE,desnutricion global,desnutricion grave (g),2005-08-01,1,1,0,0,1,1,2
50403,POCOATA,desnutricion global,desnutricion grave (g),2005-08-01,3,4,2,2,5,6,11
31203,POCONA,desnutricion global,desnutricion grave (g),2005-08-01,1,2,0,1,1,3,4
31202,POJO (CBBA),desnutricion global,desnutricion grave (g),2005-08-01,1,2,0,0,1,2,3
51203,PORCO,desnutricion global,desnutricion grave (g),2005-08-01,0,2,0,0,0,2,2
10103,POROMA,desnutricion global,desnutricion grave (g),2005-08-01,5,7,1,3,6,10,16
70103,PORONGO,desnutricion global,desnutricion grave (g),2005-08-01,0,1,0,0,0,1,1
70601,PORTACHUELO,desnutricion global,desnutricion grave (g),2005-08-01,0,1,0,0,0,1,1
50101,POTOSI,desnutricion global,desnutricion grave (g),2005-08-01,7,12,2,0,9,12,21
10302,PRESTO,desnutricion global,desnutricion grave (g),2005-08-01,2,4,1,1,3,5,8
21201,PUCARANI,desnutricion global,desnutricion grave (g),2005-08-01,2,0,1,0,3,0,3
21204,PUERTO PEREZ,desnutricion global,desnutricion grave (g),2005-08-01,1,0,0,0,1,0,1
80703,PUERTO SILES,desnutricion global,desnutricion grave (g),2005-08-01,1,0,0,0,1,0,1
31205,PUERTO VILLARROEL,desnutricion global,desnutricion grave (g),2005-08-01,1,4,2,4,3,8,11
51101,PUNA,desnutricion global,desnutricion grave (g),2005-08-01,8,3,2,3,10,6,16
31401,PUNATA,desnutricion global,desnutricion grave (g),2005-08-01,0,1,0,0,0,1,1
30901,QUILLACOLLO,desnutricion global,desnutricion grave (g),2005-08-01,4,1,0,0,4,1,5
50402,RAVELO,desnutricion global,desnutricion grave (g),2005-08-01,14,10,9,4,23,14,37
80301,REYES,desnutricion global,desnutricion grave (g),2005-08-01,2,3,2,1,4,4,8
80201,RIBERALTA,desnutricion global,desnutricion grave (g),2005-08-01,11,35,12,8,23,43,66
80304,RURRENABAQUE,desnutricion global,desnutricion grave (g),2005-08-01,1,0,0,0,1,0,1
31001,SACABA,desnutricion global,desnutricion grave (g),2005-08-01,4,2,3,4,7,6,13
30404,SACABAMBA,desnutricion global,desnutricion grave (g),2005-08-01,2,0,1,0,3,0,3
50701,SACACA,desnutricion global,desnutricion grave (g),2005-08-01,13,8,2,5,15,13,28
40801,SALINAS DE GARCI MENDOZA,desnutricion global,desnutricion grave (g),2005-08-01,2,0,0,0,2,0,2
70901,SAMAIPATA,desnutricion global,desnutricion grave (g),2005-08-01,0,1,0,0,0,1,1
80602,SAN ANDRES,desnutricion global,desnutricion grave (g),2005-08-01,0,0,1,0,1,0,1
20805,SAN ANDRES DE MACHACA,desnutricion global,desnutricion grave (g),2005-08-01,0,0,0,1,0,1,1
71105,SAN ANTONIO DE LOMERIO,desnutricion global,desnutricion grave (g),2005-08-01,2,0,0,0,2,0,2
80302,SAN BORJA,desnutricion global,desnutricion grave (g),2005-08-01,10,9,0,1,10,10,20
21502,SAN BUENA VENTURA,desnutricion global,desnutricion grave (g),2005-08-01,1,2,0,0,1,2,3
70402,SAN CARLOS,desnutricion global,desnutricion grave (g),2005-08-01,0,1,0,0,0,1,1
80501,SAN IGNACIO,desnutricion global,desnutricion grave (g),2005-08-01,1,0,0,1,1,1,2
70301,SAN IGNACIO DE VELASCO,desnutricion global,desnutricion grave (g),2005-08-01,4,7,2,2,6,9,15
80102,SAN JAVIER(BNI),desnutricion global,desnutricion grave (g),2005-08-01,2,1,0,1,2,2,4
70404,SAN JUAN DE YAPACANI,desnutricion global,desnutricion grave (g),2005-08-01,0,0,1,0,1,0,1
71104,SAN JULIAN,desnutricion global,desnutricion grave (g),2005-08-01,0,0,1,0,1,0,1
60501,SAN LORENZO(TJA),desnutricion global,desnutricion grave (g),2005-08-01,1,1,0,2,1,3,4
10702,SAN LUCAS,desnutricion global,desnutricion grave (g),2005-08-01,22,15,6,11,28,26,54
70302,SAN MIGUEL DE VELASCO,desnutricion global,desnutricion grave (g),2005-08-01,0,2,0,1,0,3,3
71005,SAN PEDRO,desnutricion global,desnutricion grave (g),2005-08-01,0,0,1,0,1,0,1
50501,SAN PEDRO DE BUENA VISTA,desnutricion global,desnutricion grave (g),2005-08-01,14,7,7,11,21,18,39
90202,SAN PEDRO(PND),desnutricion global,desnutricion grave (g),2005-08-01,0,1,0,0,0,1,1
70303,SAN RAFAEL,desnutricion global,desnutricion grave (g),2005-08-01,2,0,1,0,3,0,3
80401,SANTA ANA,desnutricion global,desnutricion grave (g),2005-08-01,0,1,0,0,0,1,1
70101,SANTA CRUZ DE LA SIERRA,desnutricion global,desnutricion grave (g),2005-08-01,32,41,12,7,44,48,92
70602,SANTA ROSA DEL SARA,desnutricion global,desnutricion grave (g),2005-08-01,0,3,1,0,1,3,4
20308,SANTIAGO DE CALLAPA,desnutricion global,desnutricion grave (g),2005-08-01,0,0,1,1,1,1,2
21901,SANTIAGO DE MACHACA,desnutricion global,desnutricion grave (g),2005-08-01,1,0,0,0,1,0,1
40202,SANTUARIO DE QUILLACAS,desnutricion global,desnutricion grave (g),2005-08-01,1,0,0,0,1,0,1
20902,SAPAHAQUI,desnutricion global,desnutricion grave (g),2005-08-01,0,1,0,0,0,1,1
90303,SENA,desnutricion global,desnutricion grave (g),2005-08-01,1,0,0,0,1,0,1
21301,SICA SICA (VILLA AROMA),desnutricion global,desnutricion grave (g),2005-08-01,3,1,1,0,4,1,5
30703,SICAYA,desnutricion global,desnutricion grave (g),2005-08-01,2,1,1,0,3,1,4
30902,SIPE SIPE,desnutricion global,desnutricion grave (g),2005-08-01,6,2,1,1,7,3,10
10403,SOPACHUY,desnutricion global,desnutricion grave (g),2005-08-01,2,4,0,1,2,5,7
40104,SORACACHI,desnutricion global,desnutricion grave (g),2005-08-01,3,1,0,0,3,1,4
10101,SUCRE,desnutricion global,desnutricion grave (g),2005-08-01,15,12,4,3,19,15,34
31404,TACACHI,desnutricion global,desnutricion grave (g),2005-08-01,0,1,0,0,0,1,1
50303,TACOBAMBA,desnutricion global,desnutricion grave (g),2005-08-01,2,2,0,0,2,2,4
30602,TACOPAYA,desnutricion global,desnutricion grave (g),2005-08-01,3,3,1,0,4,3,7
31101,TAPACARI,desnutricion global,desnutricion grave (g),2005-08-01,4,1,0,0,4,1,5
10601,TARABUCO,desnutricion global,desnutricion grave (g),2005-08-01,9,14,2,6,11,20,31
30401,TARATA,desnutricion global,desnutricion grave (g),2005-08-01,0,1,0,0,0,1,1
60101,TARIJA,desnutricion global,desnutricion grave (g),2005-08-01,28,22,10,15,38,37,75
10202,TARVITA,desnutricion global,desnutricion grave (g),2005-08-01,2,2,1,0,3,2,5
20608,TEOPONTE,desnutricion global,desnutricion grave (g),2005-08-01,0,0,1,1,1,1,2
50102,TINGUIPAYA,desnutricion global,desnutricion grave (g),2005-08-01,6,5,1,4,7,9,16
30903,TIQUIPAYA,desnutricion global,desnutricion grave (g),2005-08-01,2,2,0,0,2,2,4
31601,TIRAQUE (CBBA),desnutricion global,desnutricion grave (g),2005-08-01,4,3,1,2,5,5,10
51202,TOMAVE,desnutricion global,desnutricion grave (g),2005-08-01,4,1,1,0,5,1,6
10402,TOMINA,desnutricion global,desnutricion grave (g),2005-08-01,3,2,5,5,8,7,15
50502,TORO TORO,desnutricion global,desnutricion grave (g),2005-08-01,4,5,3,1,7,6,13
31201,TOTORA(CBBA),desnutricion global,desnutricion grave (g),2005-08-01,2,0,0,0,2,0,2
80101,TRINIDAD,desnutricion global,desnutricion grave (g),2005-08-01,2,4,2,0,4,4,8
50801,TUPIZA,desnutricion global,desnutricion grave (g),2005-08-01,3,0,0,1,3,1,4
40402,TURCO,desnutricion global,desnutricion grave (g),2005-08-01,0,1,0,0,0,1,1
21302,UMALA,desnutricion global,desnutricion grave (g),2005-08-01,0,0,1,0,1,0,1
51201,UYUNI,desnutricion global,desnutricion grave (g),2005-08-01,1,1,1,1,2,2,4
30502,VACAS,desnutricion global,desnutricion grave (g),2005-08-01,2,0,1,0,3,0,3
70801,VALLEGRANDE,desnutricion global,desnutricion grave (g),2005-08-01,0,0,1,0,1,0,1
20801,VIACHA,desnutricion global,desnutricion grave (g),2005-08-01,1,0,7,1,8,1,9
31302,VILA VILA,desnutricion global,desnutricion grave (g),2005-08-01,0,1,0,0,0,1,1
60303,VILLA MONTES,desnutricion global,desnutricion grave (g),2005-08-01,3,0,0,1,3,1,4
31402,VILLA RIVERO,desnutricion global,desnutricion grave (g),2005-08-01,1,1,0,0,1,1,2
10801,VILLA SERRANO,desnutricion global,desnutricion grave (g),2005-08-01,6,1,0,2,6,3,9
31003,VILLA TUNARI,desnutricion global,desnutricion grave (g),2005-08-01,10,3,6,3,16,6,22
11001,VILLA VACA GUZMAN (MUYUPAMPA),desnutricion global,desnutricion grave (g),2005-08-01,0,0,1,0,1,0,1
51501,VILLAZON,desnutricion global,desnutricion grave (g),2005-08-01,1,1,1,0,2,1,3
50602,VITICHI,desnutricion global,desnutricion grave (g),2005-08-01,2,0,0,0,2,0,2
70201,WARNES,desnutricion global,desnutricion grave (g),2005-08-01,1,4,1,1,2,5,7
20903,YACO,desnutricion global,desnutricion grave (g),2005-08-01,1,1,1,2,2,3,5
60301,YACUIBA,desnutricion global,desnutricion grave (g),2005-08-01,2,5,0,1,2,6,8
10602,YAMPARAEZ,desnutricion global,desnutricion grave (g),2005-08-01,3,4,1,3,4,7,11
70403,YAPACANI,desnutricion global,desnutricion grave (g),2005-08-01,1,1,0,1,1,2,3
50103,YOCALLA,desnutricion global,desnutricion grave (g),2005-08-01,0,1,0,0,0,1,1
10102,YOTALA,desnutricion global,desnutricion grave (g),2005-08-01,3,0,0,0,3,0,3
10301,ZUDAÑEZ,desnutricion global,desnutricion grave (g),2005-08-01,5,7,2,4,7,11,18
51302,ACACIO,desnutricion global,desnutricion grave (g),2005-09-01,1,2,2,0,3,2,5
20201,ACHACACHI,desnutricion global,desnutricion grave (g),2005-09-01,0,0,0,1,0,1,1
30201,AIQUILE,desnutricion global,desnutricion grave (g),2005-09-01,3,1,1,1,4,2,6
31303,ALALAY,desnutricion global,desnutricion grave (g),2005-09-01,0,1,0,0,0,1,1
10404,ALCALA,desnutricion global,desnutricion grave (g),2005-09-01,0,2,0,2,0,4,4
20202,ANCORAIMES,desnutricion global,desnutricion grave (g),2005-09-01,1,0,0,2,1,2,3
41201,ANDAMARCA,desnutricion global,desnutricion grave (g),2005-09-01,0,0,0,1,0,1,1
30402,ANZALDO,desnutricion global,desnutricion grave (g),2005-09-01,1,0,0,0,1,0,1
20701,APOLO,desnutricion global,desnutricion grave (g),2005-09-01,0,2,1,0,1,2,3
51301,ARAMPAMPA,desnutricion global,desnutricion grave (g),2005-09-01,3,1,4,14,7,15,22
30501,ARANI,desnutricion global,desnutricion grave (g),2005-09-01,0,1,0,1,0,2,2
30601,ARQUE,desnutricion global,desnutricion grave (g),2005-09-01,0,1,0,1,0,2,2
50802,ATOCHA,desnutricion global,desnutricion grave (g),2005-09-01,1,3,0,2,1,5,6
20502,AYATA,desnutricion global,desnutricion grave (g),2005-09-01,0,0,1,1,1,1,2
21303,AYO AYO,desnutricion global,desnutricion grave (g),2005-09-01,0,0,0,1,0,1,1
30301,AYOPAYA (V. DE INDEPENDENCIA),desnutricion global,desnutricion grave (g),2005-09-01,2,1,1,0,3,1,4
10201,AZURDUY,desnutricion global,desnutricion grave (g),2005-09-01,5,3,1,5,6,8,14
41202,BELEN DE ANDAMARCA,desnutricion global,desnutricion grave (g),2005-09-01,0,1,0,0,0,1,1
50301,BETANZOS,desnutricion global,desnutricion grave (g),2005-09-01,16,7,1,2,17,9,26
31501,BOLIVAR,desnutricion global,desnutricion grave (g),2005-09-01,5,2,0,1,5,3,8
70703,CABEZAS,desnutricion global,desnutricion grave (g),2005-09-01,0,0,1,2,1,2,3
20905,CAIROMA,desnutricion global,desnutricion grave (g),2005-09-01,4,1,3,3,7,4,11
51102,"CAIZA ""D""",desnutricion global,desnutricion grave (g),2005-09-01,1,0,1,0,2,0,2
21003,CAJUATA,desnutricion global,desnutricion grave (g),2005-09-01,2,0,0,0,2,0,2
21304,CALAMARCA,desnutricion global,desnutricion grave (g),2005-09-01,3,0,1,0,4,0,4
10701,CAMARGO,desnutricion global,desnutricion grave (g),2005-09-01,5,1,0,0,5,1,6
70706,CAMIRI,desnutricion global,desnutricion grave (g),2005-09-01,3,0,2,5,5,5,10
30701,CAPINOTA,desnutricion global,desnutricion grave (g),2005-09-01,6,2,6,6,12,8,20
20302,CAQUIAVIRI,desnutricion global,desnutricion grave (g),2005-09-01,1,0,0,0,1,0,1
40102,CARACOLLO,desnutricion global,desnutricion grave (g),2005-09-01,0,0,0,1,0,1,1
22001,CARANAVI,desnutricion global,desnutricion grave (g),2005-09-01,4,1,2,0,6,1,7
60302,CARAPARI,desnutricion global,desnutricion grave (g),2005-09-01,1,0,0,0,1,0,1
50702,CARIPUYO,desnutricion global,desnutricion grave (g),2005-09-01,3,5,2,1,5,6,11
40201,CHALLAPATA,desnutricion global,desnutricion grave (g),2005-09-01,1,1,0,0,1,1,2
50302,CHAQUI,desnutricion global,desnutricion grave (g),2005-09-01,0,0,0,1,0,1,1
70702,CHARAGUA,desnutricion global,desnutricion grave (g),2005-09-01,0,1,1,3,1,4,5
50202,CHAYANTA,desnutricion global,desnutricion grave (g),2005-09-01,7,3,3,3,10,6,16
31204,CHIMORE,desnutricion global,desnutricion grave (g),2005-09-01,1,1,0,0,1,1,2
40903,CHIPAYA,desnutricion global,desnutricion grave (g),2005-09-01,0,0,2,0,2,0,2
21101,CHULUMANI (V. DE LA LIBERTAD),desnutricion global,desnutricion grave (g),2005-09-01,1,0,0,0,1,0,1
20501,CHUMA,desnutricion global,desnutricion grave (g),2005-09-01,1,0,1,3,2,3,5
30101,COCHABAMBA,desnutricion global,desnutricion grave (g),2005-09-01,1,3,1,0,2,3,5
21307,COLLANA,desnutricion global,desnutricion grave (g),2005-09-01,0,0,1,0,1,0,1
31002,COLOMI,desnutricion global,desnutricion grave (g),2005-09-01,1,1,0,0,1,1,2
50401,COLQUECHACA,desnutricion global,desnutricion grave (g),2005-09-01,3,8,3,7,6,15,21
21004,COLQUIRI,desnutricion global,desnutricion grave (g),2005-09-01,1,0,0,0,1,0,1
71301,COMARAPA,desnutricion global,desnutricion grave (g),2005-09-01,3,1,0,0,3,1,4
20605,COMBAYA,desnutricion global,desnutricion grave (g),2005-09-01,2,0,0,0,2,0,2
71101,CONCEPCION,desnutricion global,desnutricion grave (g),2005-09-01,0,0,0,1,0,1,1
50601,COTAGAITA,desnutricion global,desnutricion grave (g),2005-09-01,6,2,0,1,6,3,9
70102,COTOCA,desnutricion global,desnutricion grave (g),2005-09-01,1,1,0,0,1,1,2
71106,CUATRO CAÑADAS,desnutricion global,desnutricion grave (g),2005-09-01,1,0,1,0,2,0,2
70704,CUEVO,desnutricion global,desnutricion grave (g),2005-09-01,0,1,0,0,0,1,1
10902,CULPINA,desnutricion global,desnutricion grave (g),2005-09-01,4,1,0,0,4,1,5
40401,CURAHUARA DE CARANGAS,desnutricion global,desnutricion grave (g),2005-09-01,1,0,0,0,1,0,1
21602,CURVA,desnutricion global,desnutricion grave (g),2005-09-01,1,0,1,0,2,0,2
20105,EL ALTO,desnutricion global,desnutricion grave (g),2005-09-01,32,22,23,21,55,43,98
60502,EL PUENTE(TJA),desnutricion global,desnutricion grave (g),2005-09-01,0,0,0,1,0,1,1
60601,ENTRE RIOS,desnutricion global,desnutricion grave (g),2005-09-01,1,0,0,1,1,1,2
60601,ENTRE RIOS,desnutricion global,desnutricion grave (g),2005-09-01,0,1,0,3,0,4,4
41101,EUCALIPTUS,desnutricion global,desnutricion grave (g),2005-09-01,1,0,0,1,1,1,2
90503,EUREKA (SANTOS MERCADO),desnutricion global,desnutricion grave (g),2005-09-01,0,1,0,0,0,1,1
71004,FERNANDEZ ALONSO,desnutricion global,desnutricion grave (g),2005-09-01,3,0,0,1,3,1,4
90203,FILADELFIA,desnutricion global,desnutricion grave (g),2005-09-01,0,0,1,0,1,0,1
71002,GENERAL SAAVEDRA,desnutricion global,desnutricion grave (g),2005-09-01,0,1,7,6,7,7,14
21601,GRAL. J.J. PEREZ (CHARAZANI),desnutricion global,desnutricion grave (g),2005-09-01,1,1,0,0,1,1,2
20602,GUANAY,desnutricion global,desnutricion grave (g),2005-09-01,2,1,0,0,2,1,3
20802,GUAQUI,desnutricion global,desnutricion grave (g),2005-09-01,0,1,0,0,0,1,1
80202,GUAYARAMERIN,desnutricion global,desnutricion grave (g),2005-09-01,1,2,0,1,1,3,4
70705,GUTIERREZ,desnutricion global,desnutricion grave (g),2005-09-01,0,3,2,3,2,6,8
11002,HUACAYA (VILLA DE HUACAYA),desnutricion global,desnutricion grave (g),2005-09-01,1,0,0,0,1,0,1
40701,HUANUNI,desnutricion global,desnutricion grave (g),2005-09-01,3,1,0,0,3,1,4
41601,HUAYLLAMARCA,desnutricion global,desnutricion grave (g),2005-09-01,0,0,0,1,0,1,1
21005,ICHOCA,desnutricion global,desnutricion grave (g),2005-09-01,0,1,0,0,0,1,1
10304,ICLA,desnutricion global,desnutricion grave (g),2005-09-01,0,1,0,0,0,1,1
10703,INCAHUASI,desnutricion global,desnutricion grave (g),2005-09-01,6,5,0,2,6,7,13
21001,INQUISIVI,desnutricion global,desnutricion grave (g),2005-09-01,0,0,1,1,1,1,2
21501,IXIAMAS,desnutricion global,desnutricion grave (g),2005-09-01,0,1,0,0,0,1,1
21105,LA ASUNTA,desnutricion global,desnutricion grave (g),2005-09-01,0,2,0,0,0,2,2
70104,LA GUARDIA,desnutricion global,desnutricion grave (g),2005-09-01,1,0,0,0,1,0,1
20101,LA PAZ,desnutricion global,desnutricion grave (g),2005-09-01,14,11,5,1,19,12,31
70701,LAGUNILLAS,desnutricion global,desnutricion grave (g),2005-09-01,1,0,0,0,1,0,1
21202,LAJA,desnutricion global,desnutricion grave (g),2005-09-01,1,0,0,0,1,0,1
50203,LLALLAGUA,desnutricion global,desnutricion grave (g),2005-09-01,5,10,3,2,8,12,20
20901,LURIBAY,desnutricion global,desnutricion grave (g),2005-09-01,1,0,0,1,1,1,2
11003,MACHARETI,desnutricion global,desnutricion grave (g),2005-09-01,0,0,0,1,0,1,1
80801,MAGDALENA,desnutricion global,desnutricion grave (g),2005-09-01,0,2,0,0,0,2,2
70903,MAIRANA,desnutricion global,desnutricion grave (g),2005-09-01,0,0,0,1,0,1,1
20607,MAPIRI,desnutricion global,desnutricion grave (g),2005-09-01,0,1,0,0,0,1,1
71003,MINEROS,desnutricion global,desnutricion grave (g),2005-09-01,1,1,1,1,2,2,4
31301,MIZQUE,desnutricion global,desnutricion grave (g),2005-09-01,1,2,2,1,3,3,6
20402,MOCOMOCO,desnutricion global,desnutricion grave (g),2005-09-01,1,0,1,0,2,0,2
10303,MOJOCOYA,desnutricion global,desnutricion grave (g),2005-09-01,2,0,0,0,2,0,2
10501,MONTEAGUDO,desnutricion global,desnutricion grave (g),2005-09-01,1,1,2,1,3,2,5
71001,MONTERO,desnutricion global,desnutricion grave (g),2005-09-01,7,4,4,0,11,4,15
30302,MOROCHATA,desnutricion global,desnutricion grave (g),2005-09-01,4,3,4,0,8,3,11
50404,OCURI,desnutricion global,desnutricion grave (g),2005-09-01,8,5,6,3,14,8,22
30203,OMEREQUE,desnutricion global,desnutricion grave (g),2005-09-01,0,0,0,1,0,1,1
40101,ORURO,desnutricion global,desnutricion grave (g),2005-09-01,6,6,2,2,8,8,16
10401,PADILLA,desnutricion global,desnutricion grave (g),2005-09-01,1,0,1,2,2,2,4
21104,PALOS BLANCOS,desnutricion global,desnutricion grave (g),2005-09-01,2,3,0,1,2,4,6
70902,PAMPA GRANDE,desnutricion global,desnutricion grave (g),2005-09-01,0,1,0,0,0,1,1
30202,PASORAPA,desnutricion global,desnutricion grave (g),2005-09-01,0,1,0,1,0,2,2
20702,PELECHUCO,desnutricion global,desnutricion grave (g),2005-09-01,0,1,0,1,0,2,2
50403,POCOATA,desnutricion global,desnutricion grave (g),2005-09-01,4,1,4,3,8,4,12
31203,POCONA,desnutricion global,desnutricion grave (g),2005-09-01,0,1,0,0,0,1,1
31202,POJO (CBBA),desnutricion global,desnutricion grave (g),2005-09-01,1,2,3,0,4,2,6
10103,POROMA,desnutricion global,desnutricion grave (g),2005-09-01,5,7,5,3,10,10,20
70103,PORONGO,desnutricion global,desnutricion grave (g),2005-09-01,1,1,0,0,1,1,2
90102,PORVENIR,desnutricion global,desnutricion grave (g),2005-09-01,1,1,0,0,1,1,2
50101,POTOSI,desnutricion global,desnutricion grave (g),2005-09-01,13,10,2,1,15,11,26
10302,PRESTO,desnutricion global,desnutricion grave (g),2005-09-01,2,1,1,0,3,1,4
90301,PUERTO GONZALO MORENO,desnutricion global,desnutricion grave (g),2005-09-01,0,0,0,1,0,1,1
90201,PUERTO RICO,desnutricion global,desnutricion grave (g),2005-09-01,1,0,0,1,1,1,2
80703,PUERTO SILES,desnutricion global,desnutricion grave (g),2005-09-01,2,0,0,0,2,0,2
31205,PUERTO VILLARROEL,desnutricion global,desnutricion grave (g),2005-09-01,1,2,2,1,3,3,6
51101,PUNA,desnutricion global,desnutricion grave (g),2005-09-01,12,10,4,3,16,13,29
31401,PUNATA,desnutricion global,desnutricion grave (g),2005-09-01,1,1,0,0,1,1,2
30901,QUILLACOLLO,desnutricion global,desnutricion grave (g),2005-09-01,6,1,9,4,15,5,20
21002,QUIME,desnutricion global,desnutricion grave (g),2005-09-01,1,0,0,0,1,0,1
50402,RAVELO,desnutricion global,desnutricion grave (g),2005-09-01,13,9,1,5,14,14,28
80301,REYES,desnutricion global,desnutricion grave (g),2005-09-01,2,2,1,0,3,2,5
80201,RIBERALTA,desnutricion global,desnutricion grave (g),2005-09-01,10,23,4,9,14,32,46
31001,SACABA,desnutricion global,desnutricion grave (g),2005-09-01,3,2,1,1,4,3,7
30404,SACABAMBA,desnutricion global,desnutricion grave (g),2005-09-01,3,2,0,0,3,2,5
50701,SACACA,desnutricion global,desnutricion grave (g),2005-09-01,7,5,4,1,11,6,17
71302,SAIPINA,desnutricion global,desnutricion grave (g),2005-09-01,0,1,0,0,0,1,1
70901,SAMAIPATA,desnutricion global,desnutricion grave (g),2005-09-01,0,0,1,1,1,1,2
80602,SAN ANDRES,desnutricion global,desnutricion grave (g),2005-09-01,1,1,1,0,2,1,3
71105,SAN ANTONIO DE LOMERIO,desnutricion global,desnutricion grave (g),2005-09-01,0,1,0,11,0,12,12
31403,SAN BENITO,desnutricion global,desnutricion grave (g),2005-09-01,0,0,2,0,2,0,2
80302,SAN BORJA,desnutricion global,desnutricion grave (g),2005-09-01,6,5,2,3,8,8,16
21502,SAN BUENA VENTURA,desnutricion global,desnutricion grave (g),2005-09-01,0,3,0,0,0,3,3
70301,SAN IGNACIO DE VELASCO,desnutricion global,desnutricion grave (g),2005-09-01,6,7,3,5,9,12,21
80102,SAN JAVIER(BNI),desnutricion global,desnutricion grave (g),2005-09-01,0,0,0,1,0,1,1
71104,SAN JULIAN,desnutricion global,desnutricion grave (g),2005-09-01,0,0,1,0,1,0,1
90302,SAN LORENZO(PND),desnutricion global,desnutricion grave (g),2005-09-01,1,1,0,0,1,1,2
60501,SAN LORENZO(TJA),desnutricion global,desnutricion grave (g),2005-09-01,1,1,1,3,2,4,6
10702,SAN LUCAS,desnutricion global,desnutricion grave (g),2005-09-01,11,4,7,8,18,12,30
51001,SAN PABLO DE LIPEZ,desnutricion global,desnutricion grave (g),2005-09-01,0,0,2,0,2,0,2
50501,SAN PEDRO DE BUENA VISTA,desnutricion global,desnutricion grave (g),2005-09-01,9,11,5,11,14,22,36
70303,SAN RAFAEL,desnutricion global,desnutricion grave (g),2005-09-01,1,0,0,0,1,0,1
80401,SANTA ANA,desnutricion global,desnutricion grave (g),2005-09-01,1,0,1,1,2,1,3
70101,SANTA CRUZ DE LA SIERRA,desnutricion global,desnutricion grave (g),2005-09-01,12,12,6,3,18,15,33
70602,SANTA ROSA DEL SARA,desnutricion global,desnutricion grave (g),2005-09-01,1,0,0,1,1,1,2
90303,SENA,desnutricion global,desnutricion grave (g),2005-09-01,1,1,0,0,1,1,2
21301,SICA SICA (VILLA AROMA),desnutricion global,desnutricion grave (g),2005-09-01,2,2,1,0,3,2,5
30703,SICAYA,desnutricion global,desnutricion grave (g),2005-09-01,2,0,0,0,2,0,2
30902,SIPE SIPE,desnutricion global,desnutricion grave (g),2005-09-01,5,4,0,0,5,4,9
10403,SOPACHUY,desnutricion global,desnutricion grave (g),2005-09-01,2,3,0,2,2,5,7
40104,SORACACHI,desnutricion global,desnutricion grave (g),2005-09-01,1,1,1,0,2,1,3
10101,SUCRE,desnutricion global,desnutricion grave (g),2005-09-01,7,7,2,3,9,10,19
50303,TACOBAMBA,desnutricion global,desnutricion grave (g),2005-09-01,0,1,0,0,0,1,1
30602,TACOPAYA,desnutricion global,desnutricion grave (g),2005-09-01,2,1,0,2,2,3,5
31101,TAPACARI,desnutricion global,desnutricion grave (g),2005-09-01,5,3,2,2,7,5,12
10601,TARABUCO,desnutricion global,desnutricion grave (g),2005-09-01,15,7,7,6,22,13,35
30401,TARATA,desnutricion global,desnutricion grave (g),2005-09-01,1,1,0,0,1,1,2
60101,TARIJA,desnutricion global,desnutricion grave (g),2005-09-01,3,1,0,0,3,1,4
10202,TARVITA,desnutricion global,desnutricion grave (g),2005-09-01,5,2,3,1,8,3,11
20608,TEOPONTE,desnutricion global,desnutricion grave (g),2005-09-01,2,0,1,0,3,0,3
20803,TIAWANACU,desnutricion global,desnutricion grave (g),2005-09-01,0,1,0,0,0,1,1
50102,TINGUIPAYA,desnutricion global,desnutricion grave (g),2005-09-01,12,8,3,4,15,12,27
31601,TIRAQUE (CBBA),desnutricion global,desnutricion grave (g),2005-09-01,0,5,2,4,2,9,11
30802,TOCO,desnutricion global,desnutricion grave (g),2005-09-01,0,0,1,1,1,1,2
51202,TOMAVE,desnutricion global,desnutricion grave (g),2005-09-01,0,1,1,1,1,2,3
10402,TOMINA,desnutricion global,desnutricion grave (g),2005-09-01,1,1,3,2,4,3,7
50502,TORO TORO,desnutricion global,desnutricion grave (g),2005-09-01,2,4,4,0,6,4,10
31201,TOTORA(CBBA),desnutricion global,desnutricion grave (g),2005-09-01,0,0,2,0,2,0,2
80101,TRINIDAD,desnutricion global,desnutricion grave (g),2005-09-01,6,1,2,2,8,3,11
50801,TUPIZA,desnutricion global,desnutricion grave (g),2005-09-01,1,0,1,1,2,1,3
50201,UNCIA,desnutricion global,desnutricion grave (g),2005-09-01,2,2,2,5,4,7,11
60401,URIONDO (A. CONCEPCION),desnutricion global,desnutricion grave (g),2005-09-01,1,0,0,0,1,0,1
51201,UYUNI,desnutricion global,desnutricion grave (g),2005-09-01,0,2,1,0,1,2,3
30502,VACAS,desnutricion global,desnutricion grave (g),2005-09-01,0,0,1,0,1,0,1
70801,VALLEGRANDE,desnutricion global,desnutricion grave (g),2005-09-01,0,3,1,1,1,4,5
20801,VIACHA,desnutricion global,desnutricion grave (g),2005-09-01,2,1,0,0,2,1,3
31302,VILA VILA,desnutricion global,desnutricion grave (g),2005-09-01,0,1,1,0,1,1,2
60303,VILLA MONTES,desnutricion global,desnutricion grave (g),2005-09-01,1,2,0,0,1,2,3
90502,VILLA NUEVA (LOMA ALTA),desnutricion global,desnutricion grave (g),2005-09-01,0,0,1,0,1,0,1
31402,VILLA RIVERO,desnutricion global,desnutricion grave (g),2005-09-01,0,1,1,1,1,2,3
10801,VILLA SERRANO,desnutricion global,desnutricion grave (g),2005-09-01,3,0,0,1,3,1,4
31003,VILLA TUNARI,desnutricion global,desnutricion grave (g),2005-09-01,8,7,1,0,9,7,16
51501,VILLAZON,desnutricion global,desnutricion grave (g),2005-09-01,1,2,1,0,2,2,4
30904,VINTO,desnutricion global,desnutricion grave (g),2005-09-01,0,1,0,0,0,1,1
50602,VITICHI,desnutricion global,desnutricion grave (g),2005-09-01,1,1,4,4,5,5,10
70201,WARNES,desnutricion global,desnutricion grave (g),2005-09-01,0,8,2,0,2,8,10
20903,YACO,desnutricion global,desnutricion grave (g),2005-09-01,2,0,1,1,3,1,4
60301,YACUIBA,desnutricion global,desnutricion grave (g),2005-09-01,10,1,0,2,10,3,13
10602,YAMPARAEZ,desnutricion global,desnutricion grave (g),2005-09-01,2,2,0,3,2,5,7
70403,YAPACANI,desnutricion global,desnutricion grave (g),2005-09-01,2,4,1,2,3,6,9
50103,YOCALLA,desnutricion global,desnutricion grave (g),2005-09-01,2,0,0,0,2,0,2
10102,YOTALA,desnutricion global,desnutricion grave (g),2005-09-01,1,1,1,0,2,1,3
60402,YUNCHARA,desnutricion global,desnutricion grave (g),2005-09-01,1,1,0,0,1,1,2
10301,ZUDAÑEZ,desnutricion global,desnutricion grave (g),2005-09-01,1,1,1,3,2,4,6
51302,ACACIO,desnutricion global,desnutricion grave (g),2005-10-01,1,3,1,1,2,4,6
30201,AIQUILE,desnutricion global,desnutricion grave (g),2005-10-01,0,0,1,3,1,3,4
31303,ALALAY,desnutricion global,desnutricion grave (g),2005-10-01,0,1,0,0,0,1,1
10404,ALCALA,desnutricion global,desnutricion grave (g),2005-10-01,0,1,0,0,0,1,1
20202,ANCORAIMES,desnutricion global,desnutricion grave (g),2005-10-01,1,0,0,2,1,2,3
41201,ANDAMARCA,desnutricion global,desnutricion grave (g),2005-10-01,1,0,1,0,2,0,2
30402,ANZALDO,desnutricion global,desnutricion grave (g),2005-10-01,1,0,0,0,1,0,1
51301,ARAMPAMPA,desnutricion global,desnutricion grave (g),2005-10-01,2,3,2,0,4,3,7
30501,ARANI,desnutricion global,desnutricion grave (g),2005-10-01,2,1,0,0,2,1,3
30403,ARBIETO,desnutricion global,desnutricion grave (g),2005-10-01,0,1,0,1,0,2,2
30601,ARQUE,desnutricion global,desnutricion grave (g),2005-10-01,5,3,1,3,6,6,12
71501,ASCENCION DE GUARAYOS,desnutricion global,desnutricion grave (g),2005-10-01,6,1,2,0,8,1,9
50802,ATOCHA,desnutricion global,desnutricion grave (g),2005-10-01,1,1,0,0,1,1,2
20503,AUCAPATA,desnutricion global,desnutricion grave (g),2005-10-01,1,0,1,0,2,0,2
20502,AYATA,desnutricion global,desnutricion grave (g),2005-10-01,1,0,0,0,1,0,1
21303,AYO AYO,desnutricion global,desnutricion grave (g),2005-10-01,1,0,0,0,1,0,1
30301,AYOPAYA (V. DE INDEPENDENCIA),desnutricion global,desnutricion grave (g),2005-10-01,5,5,1,3,6,8,14
10201,AZURDUY,desnutricion global,desnutricion grave (g),2005-10-01,3,4,2,1,5,5,10
80802,BAURES,desnutricion global,desnutricion grave (g),2005-10-01,0,0,1,0,1,0,1
41202,BELEN DE ANDAMARCA,desnutricion global,desnutricion grave (g),2005-10-01,0,2,0,0,0,2,2
90104,BELLA FLOR,desnutricion global,desnutricion grave (g),2005-10-01,0,1,0,1,0,2,2
50301,BETANZOS,desnutricion global,desnutricion grave (g),2005-10-01,8,8,2,4,10,12,22
31501,BOLIVAR,desnutricion global,desnutricion grave (g),2005-10-01,3,1,1,1,4,2,6
70401,BUENA VISTA,desnutricion global,desnutricion grave (g),2005-10-01,0,1,1,0,1,1,2
70703,CABEZAS,desnutricion global,desnutricion grave (g),2005-10-01,0,1,0,2,0,3,3
20905,CAIROMA,desnutricion global,desnutricion grave (g),2005-10-01,5,2,3,0,8,2,10
21003,CAJUATA,desnutricion global,desnutricion grave (g),2005-10-01,1,0,0,0,1,0,1
20303,CALACOTO,desnutricion global,desnutricion grave (g),2005-10-01,0,0,1,1,1,1,2
21304,CALAMARCA,desnutricion global,desnutricion grave (g),2005-10-01,3,1,0,1,3,2,5
10701,CAMARGO,desnutricion global,desnutricion grave (g),2005-10-01,7,5,1,1,8,6,14
70706,CAMIRI,desnutricion global,desnutricion grave (g),2005-10-01,0,1,1,1,1,2,3
30701,CAPINOTA,desnutricion global,desnutricion grave (g),2005-10-01,1,2,0,1,1,3,4
20302,CAQUIAVIRI,desnutricion global,desnutricion grave (g),2005-10-01,1,0,0,0,1,0,1
40102,CARACOLLO,desnutricion global,desnutricion grave (g),2005-10-01,1,0,0,0,1,0,1
22001,CARANAVI,desnutricion global,desnutricion grave (g),2005-10-01,1,4,2,0,3,4,7
50702,CARIPUYO,desnutricion global,desnutricion grave (g),2005-10-01,6,10,5,9,11,19,30
21803,CHACARILLA,desnutricion global,desnutricion grave (g),2005-10-01,0,1,0,0,0,1,1
40201,CHALLAPATA,desnutricion global,desnutricion grave (g),2005-10-01,8,0,0,1,8,1,9
50302,CHAQUI,desnutricion global,desnutricion grave (g),2005-10-01,0,0,2,1,2,1,3
70702,CHARAGUA,desnutricion global,desnutricion grave (g),2005-10-01,3,1,0,2,3,3,6
50202,CHAYANTA,desnutricion global,desnutricion grave (g),2005-10-01,3,6,2,0,5,6,11
40903,CHIPAYA,desnutricion global,desnutricion grave (g),2005-10-01,1,0,2,0,3,0,3
21101,CHULUMANI (V. DE LA LIBERTAD),desnutricion global,desnutricion grave (g),2005-10-01,0,1,0,1,0,2,2
20501,CHUMA,desnutricion global,desnutricion grave (g),2005-10-01,1,0,0,0,1,0,1
30801,CLIZA,desnutricion global,desnutricion grave (g),2005-10-01,3,0,1,1,4,1,5
90101,COBIJA,desnutricion global,desnutricion grave (g),2005-10-01,1,1,0,0,1,1,2
30101,COCHABAMBA,desnutricion global,desnutricion grave (g),2005-10-01,11,6,4,5,15,11,26
30905,COLCAPIRHUA,desnutricion global,desnutricion grave (g),2005-10-01,0,0,1,2,1,2,3
21307,COLLANA,desnutricion global,desnutricion grave (g),2005-10-01,1,0,2,0,3,0,3
31002,COLOMI,desnutricion global,desnutricion grave (g),2005-10-01,0,1,0,0,0,1,1
70603,COLPA BELGICA,desnutricion global,desnutricion grave (g),2005-10-01,1,0,0,0,1,0,1
50401,COLQUECHACA,desnutricion global,desnutricion grave (g),2005-10-01,7,5,5,6,12,11,23
21306,COLQUENCHA,desnutricion global,desnutricion grave (g),2005-10-01,0,1,0,0,0,1,1
21004,COLQUIRI,desnutricion global,desnutricion grave (g),2005-10-01,1,0,2,0,3,0,3
20304,COMANCHE,desnutricion global,desnutricion grave (g),2005-10-01,1,0,0,0,1,0,1
71301,COMARAPA,desnutricion global,desnutricion grave (g),2005-10-01,0,0,1,0,1,0,1
20605,COMBAYA,desnutricion global,desnutricion grave (g),2005-10-01,1,0,0,0,1,0,1
21701,COPACABANA,desnutricion global,desnutricion grave (g),2005-10-01,0,2,0,0,0,2,2
21402,CORIPATA,desnutricion global,desnutricion grave (g),2005-10-01,0,1,0,0,0,1,1
21401,COROICO,desnutricion global,desnutricion grave (g),2005-10-01,0,1,0,0,0,1,1
40301,CORQUE,desnutricion global,desnutricion grave (g),2005-10-01,0,1,0,0,0,1,1
50601,COTAGAITA,desnutricion global,desnutricion grave (g),2005-10-01,6,3,3,1,9,4,13
71106,CUATRO CAÑADAS,desnutricion global,desnutricion grave (g),2005-10-01,2,0,1,0,3,0,3
31405,CUCHUMUELA (V. G. VILLARROEL),desnutricion global,desnutricion grave (g),2005-10-01,1,0,0,0,1,0,1
10902,CULPINA,desnutricion global,desnutricion grave (g),2005-10-01,2,2,0,5,2,7,9
20804,DESAGUADERO,desnutricion global,desnutricion grave (g),2005-10-01,0,2,1,0,1,2,3
20105,EL ALTO,desnutricion global,desnutricion grave (g),2005-10-01,36,30,26,13,62,43,105
71503,EL PUENTE(STC),desnutricion global,desnutricion grave (g),2005-10-01,1,0,1,0,2,0,2
60502,EL PUENTE(TJA),desnutricion global,desnutricion grave (g),2005-10-01,1,0,0,1,1,1,2
60601,ENTRE RIOS,desnutricion global,desnutricion grave (g),2005-10-01,1,0,0,1,1,1,2
60601,ENTRE RIOS,desnutricion global,desnutricion grave (g),2005-10-01,0,1,0,1,0,2,2
41101,EUCALIPTUS,desnutricion global,desnutricion grave (g),2005-10-01,1,0,0,0,1,0,1
80402,EXALTACION,desnutricion global,desnutricion grave (g),2005-10-01,0,0,1,0,1,0,1
71004,FERNANDEZ ALONSO,desnutricion global,desnutricion grave (g),2005-10-01,1,0,0,0,1,0,1
71002,GENERAL SAAVEDRA,desnutricion global,desnutricion grave (g),2005-10-01,4,3,0,0,4,3,7
21601,GRAL. J.J. PEREZ (CHARAZANI),desnutricion global,desnutricion grave (g),2005-10-01,1,1,1,3,2,4,6
80202,GUAYARAMERIN,desnutricion global,desnutricion grave (g),2005-10-01,1,0,1,1,2,1,3
70705,GUTIERREZ,desnutricion global,desnutricion grave (g),2005-10-01,5,0,3,1,8,1,9
10502,HUACARETA,desnutricion global,desnutricion grave (g),2005-10-01,2,3,2,0,4,3,7
40701,HUANUNI,desnutricion global,desnutricion grave (g),2005-10-01,2,0,0,2,2,2,4
10304,ICLA,desnutricion global,desnutricion grave (g),2005-10-01,4,4,1,3,5,7,12
10703,INCAHUASI,desnutricion global,desnutricion grave (g),2005-10-01,10,6,0,3,10,9,19
21102,IRUPANA (VILLA DE LANZA),desnutricion global,desnutricion grave (g),2005-10-01,1,0,0,0,1,0,1
21501,IXIAMAS,desnutricion global,desnutricion grave (g),2005-10-01,0,1,0,0,0,1,1
20806,JESUS DE MACHACA,desnutricion global,desnutricion grave (g),2005-10-01,1,0,0,0,1,0,1
21105,LA ASUNTA,desnutricion global,desnutricion grave (g),2005-10-01,0,0,1,0,1,0,1
70104,LA GUARDIA,desnutricion global,desnutricion grave (g),2005-10-01,0,1,1,1,1,2,3
20101,LA PAZ,desnutricion global,desnutricion grave (g),2005-10-01,13,8,5,10,18,18,36
70701,LAGUNILLAS,desnutricion global,desnutricion grave (g),2005-10-01,1,0,0,0,1,0,1
21202,LAJA,desnutricion global,desnutricion grave (g),2005-10-01,1,0,0,0,1,0,1
21006,LICOMA PAMPA,desnutricion global,desnutricion grave (g),2005-10-01,1,0,0,0,1,0,1
50203,LLALLAGUA,desnutricion global,desnutricion grave (g),2005-10-01,3,2,2,1,5,3,8
20901,LURIBAY,desnutricion global,desnutricion grave (g),2005-10-01,2,1,0,2,2,3,5
40702,MACHACAMARCA,desnutricion global,desnutricion grave (g),2005-10-01,1,0,0,0,1,0,1
11003,MACHARETI,desnutricion global,desnutricion grave (g),2005-10-01,0,0,0,1,0,1,1
80801,MAGDALENA,desnutricion global,desnutricion grave (g),2005-10-01,0,1,0,0,0,1,1
20904,MALLA,desnutricion global,desnutricion grave (g),2005-10-01,0,1,1,0,1,1,2
20607,MAPIRI,desnutricion global,desnutricion grave (g),2005-10-01,0,2,0,1,0,3,3
71003,MINEROS,desnutricion global,desnutricion grave (g),2005-10-01,2,2,1,0,3,2,5
31301,MIZQUE,desnutricion global,desnutricion grave (g),2005-10-01,3,4,3,1,6,5,11
20402,MOCOMOCO,desnutricion global,desnutricion grave (g),2005-10-01,0,1,0,0,0,1,1
10303,MOJOCOYA,desnutricion global,desnutricion grave (g),2005-10-01,1,0,1,0,2,0,2
10501,MONTEAGUDO,desnutricion global,desnutricion grave (g),2005-10-01,1,4,0,3,1,7,8
71001,MONTERO,desnutricion global,desnutricion grave (g),2005-10-01,7,5,4,5,11,10,21
70803,MORO MORO,desnutricion global,desnutricion grave (g),2005-10-01,0,0,1,1,1,1,2
30302,MOROCHATA,desnutricion global,desnutricion grave (g),2005-10-01,0,2,2,1,2,3,5
90501,NUEVO MANOA (NUEVA ESPERANZA),desnutricion global,desnutricion grave (g),2005-10-01,0,0,1,0,1,0,1
50404,OCURI,desnutricion global,desnutricion grave (g),2005-10-01,4,4,1,3,5,7,12
30203,OMEREQUE,desnutricion global,desnutricion grave (g),2005-10-01,0,1,0,0,0,1,1
40101,ORURO,desnutricion global,desnutricion grave (g),2005-10-01,3,14,4,3,7,17,24
60201,PADCAYA,desnutricion global,desnutricion grave (g),2005-10-01,2,0,0,0,2,0,2
10401,PADILLA,desnutricion global,desnutricion grave (g),2005-10-01,0,0,0,2,0,2,2
20102,PALCA,desnutricion global,desnutricion grave (g),2005-10-01,1,0,0,0,1,0,1
21104,PALOS BLANCOS,desnutricion global,desnutricion grave (g),2005-10-01,3,2,3,1,6,3,9
40802,PAMPA AULLAGAS,desnutricion global,desnutricion grave (g),2005-10-01,1,0,0,0,1,0,1
70902,PAMPA GRANDE,desnutricion global,desnutricion grave (g),2005-10-01,1,1,0,0,1,1,2
20702,PELECHUCO,desnutricion global,desnutricion grave (g),2005-10-01,0,1,0,1,0,2,2
50403,POCOATA,desnutricion global,desnutricion grave (g),2005-10-01,4,5,2,7,6,12,18
31203,POCONA,desnutricion global,desnutricion grave (g),2005-10-01,2,1,0,1,2,2,4
51203,PORCO,desnutricion global,desnutricion grave (g),2005-10-01,1,1,0,0,1,1,2
10103,POROMA,desnutricion global,desnutricion grave (g),2005-10-01,6,2,1,1,7,3,10
70601,PORTACHUELO,desnutricion global,desnutricion grave (g),2005-10-01,0,1,0,0,0,1,1
90102,PORVENIR,desnutricion global,desnutricion grave (g),2005-10-01,0,1,0,0,0,1,1
50101,POTOSI,desnutricion global,desnutricion grave (g),2005-10-01,6,6,1,7,7,13,20
10302,PRESTO,desnutricion global,desnutricion grave (g),2005-10-01,0,6,2,3,2,9,11
21201,PUCARANI,desnutricion global,desnutricion grave (g),2005-10-01,0,1,1,0,1,1,2
20403,PUERTO CARABUCO,desnutricion global,desnutricion grave (g),2005-10-01,1,0,1,0,2,0,2
90301,PUERTO GONZALO MORENO,desnutricion global,desnutricion grave (g),2005-10-01,1,0,0,0,1,0,1
90201,PUERTO RICO,desnutricion global,desnutricion grave (g),2005-10-01,0,0,0,1,0,1,1
71401,PUERTO SUAREZ,desnutricion global,desnutricion grave (g),2005-10-01,2,1,0,2,2,3,5
31205,PUERTO VILLARROEL,desnutricion global,desnutricion grave (g),2005-10-01,3,10,5,1,8,11,19
51101,PUNA,desnutricion global,desnutricion grave (g),2005-10-01,8,7,5,0,13,7,20
30901,QUILLACOLLO,desnutricion global,desnutricion grave (g),2005-10-01,4,1,4,5,8,6,14
50402,RAVELO,desnutricion global,desnutricion grave (g),2005-10-01,8,9,4,4,12,13,25
80301,REYES,desnutricion global,desnutricion grave (g),2005-10-01,1,1,0,0,1,1,2
80201,RIBERALTA,desnutricion global,desnutricion grave (g),2005-10-01,13,31,4,18,17,49,66
31001,SACABA,desnutricion global,desnutricion grave (g),2005-10-01,2,0,0,1,2,1,3
30404,SACABAMBA,desnutricion global,desnutricion grave (g),2005-10-01,0,1,0,1,0,2,2
50701,SACACA,desnutricion global,desnutricion grave (g),2005-10-01,7,4,4,4,11,8,19
40801,SALINAS DE GARCI MENDOZA,desnutricion global,desnutricion grave (g),2005-10-01,2,1,0,0,2,1,3
70901,SAMAIPATA,desnutricion global,desnutricion grave (g),2005-10-01,1,2,0,1,1,3,4
71105,SAN ANTONIO DE LOMERIO,desnutricion global,desnutricion grave (g),2005-10-01,0,1,0,0,0,1,1
80302,SAN BORJA,desnutricion global,desnutricion grave (g),2005-10-01,2,1,6,4,8,5,13
21502,SAN BUENA VENTURA,desnutricion global,desnutricion grave (g),2005-10-01,0,1,0,0,0,1,1
70402,SAN CARLOS,desnutricion global,desnutricion grave (g),2005-10-01,1,0,0,0,1,0,1
80501,SAN IGNACIO,desnutricion global,desnutricion grave (g),2005-10-01,0,1,0,2,0,3,3
70301,SAN IGNACIO DE VELASCO,desnutricion global,desnutricion grave (g),2005-10-01,7,8,1,7,8,15,23
71102,SAN JAVIER(STC),desnutricion global,desnutricion grave (g),2005-10-01,0,2,0,0,0,2,2
80701,SAN JOAQUIN,desnutricion global,desnutricion grave (g),2005-10-01,1,0,0,0,1,0,1
71104,SAN JULIAN,desnutricion global,desnutricion grave (g),2005-10-01,3,0,1,0,4,0,4
90302,SAN LORENZO(PND),desnutricion global,desnutricion grave (g),2005-10-01,1,0,0,0,1,0,1
60501,SAN LORENZO(TJA),desnutricion global,desnutricion grave (g),2005-10-01,2,1,1,1,3,2,5
10702,SAN LUCAS,desnutricion global,desnutricion grave (g),2005-10-01,15,4,7,7,22,11,33
70302,SAN MIGUEL DE VELASCO,desnutricion global,desnutricion grave (g),2005-10-01,2,0,0,1,2,1,3
71005,SAN PEDRO,desnutricion global,desnutricion grave (g),2005-10-01,0,1,0,0,0,1,1
50501,SAN PEDRO DE BUENA VISTA,desnutricion global,desnutricion grave (g),2005-10-01,9,9,3,10,12,19,31
21801,SAN PEDRO DE CURAHUARA,desnutricion global,desnutricion grave (g),2005-10-01,0,1,0,0,0,1,1
21702,SAN PEDRO DE TIQUINA,desnutricion global,desnutricion grave (g),2005-10-01,1,0,0,0,1,0,1
90202,SAN PEDRO(PND),desnutricion global,desnutricion grave (g),2005-10-01,0,1,0,0,0,1,1
70303,SAN RAFAEL,desnutricion global,desnutricion grave (g),2005-10-01,1,0,0,0,1,0,1
80401,SANTA ANA,desnutricion global,desnutricion grave (g),2005-10-01,0,0,1,0,1,0,1
70101,SANTA CRUZ DE LA SIERRA,desnutricion global,desnutricion grave (g),2005-10-01,17,21,3,7,20,28,48
80303,SANTA ROSA,desnutricion global,desnutricion grave (g),2005-10-01,0,0,1,1,1,1,2
20308,SANTIAGO DE CALLAPA,desnutricion global,desnutricion grave (g),2005-10-01,0,0,0,3,0,3,3
21901,SANTIAGO DE MACHACA,desnutricion global,desnutricion grave (g),2005-10-01,0,1,0,0,0,1,1
90303,SENA,desnutricion global,desnutricion grave (g),2005-10-01,0,1,0,0,0,1,1
21301,SICA SICA (VILLA AROMA),desnutricion global,desnutricion grave (g),2005-10-01,0,0,0,2,0,2,2
30703,SICAYA,desnutricion global,desnutricion grave (g),2005-10-01,2,1,0,0,2,1,3
30902,SIPE SIPE,desnutricion global,desnutricion grave (g),2005-10-01,3,1,0,0,3,1,4
10403,SOPACHUY,desnutricion global,desnutricion grave (g),2005-10-01,2,5,1,3,3,8,11
40104,SORACACHI,desnutricion global,desnutricion grave (g),2005-10-01,0,0,2,1,2,1,3
10101,SUCRE,desnutricion global,desnutricion grave (g),2005-10-01,12,4,1,7,13,11,24
30602,TACOPAYA,desnutricion global,desnutricion grave (g),2005-10-01,1,5,0,0,1,5,6
31101,TAPACARI,desnutricion global,desnutricion grave (g),2005-10-01,3,7,0,2,3,9,12
10601,TARABUCO,desnutricion global,desnutricion grave (g),2005-10-01,11,10,3,4,14,14,28
30401,TARATA,desnutricion global,desnutricion grave (g),2005-10-01,1,1,0,0,1,1,2
60101,TARIJA,desnutricion global,desnutricion grave (g),2005-10-01,3,4,1,3,4,7,11
10202,TARVITA,desnutricion global,desnutricion grave (g),2005-10-01,1,1,0,0,1,1,2
20608,TEOPONTE,desnutricion global,desnutricion grave (g),2005-10-01,1,0,0,1,1,1,2
50102,TINGUIPAYA,desnutricion global,desnutricion grave (g),2005-10-01,3,10,4,5,7,15,22
20606,TIPUANI,desnutricion global,desnutricion grave (g),2005-10-01,1,0,0,0,1,0,1
30903,TIQUIPAYA,desnutricion global,desnutricion grave (g),2005-10-01,3,2,0,0,3,2,5
31601,TIRAQUE (CBBA),desnutricion global,desnutricion grave (g),2005-10-01,2,7,1,0,3,7,10
30802,TOCO,desnutricion global,desnutricion grave (g),2005-10-01,0,1,0,0,0,1,1
51202,TOMAVE,desnutricion global,desnutricion grave (g),2005-10-01,2,0,0,1,2,1,3
10402,TOMINA,desnutricion global,desnutricion grave (g),2005-10-01,1,0,0,1,1,1,2
50502,TORO TORO,desnutricion global,desnutricion grave (g),2005-10-01,5,4,1,1,6,5,11
31201,TOTORA(CBBA),desnutricion global,desnutricion grave (g),2005-10-01,2,1,2,1,4,2,6
41301,TOTORA(ORR),desnutricion global,desnutricion grave (g),2005-10-01,0,0,1,0,1,0,1
80101,TRINIDAD,desnutricion global,desnutricion grave (g),2005-10-01,5,1,1,0,6,1,7
50801,TUPIZA,desnutricion global,desnutricion grave (g),2005-10-01,3,0,0,0,3,0,3
21302,UMALA,desnutricion global,desnutricion grave (g),2005-10-01,0,0,0,1,0,1,1
50201,UNCIA,desnutricion global,desnutricion grave (g),2005-10-01,2,0,0,2,2,2,4
71502,URUBICHA,desnutricion global,desnutricion grave (g),2005-10-01,1,2,0,1,1,3,4
30502,VACAS,desnutricion global,desnutricion grave (g),2005-10-01,4,0,1,0,5,0,5
70801,VALLEGRANDE,desnutricion global,desnutricion grave (g),2005-10-01,0,3,1,0,1,3,4
20801,VIACHA,desnutricion global,desnutricion grave (g),2005-10-01,1,0,1,1,2,1,3
31302,VILA VILA,desnutricion global,desnutricion grave (g),2005-10-01,5,0,1,1,6,1,7
60303,VILLA MONTES,desnutricion global,desnutricion grave (g),2005-10-01,3,0,0,1,3,1,4
10801,VILLA SERRANO,desnutricion global,desnutricion grave (g),2005-10-01,9,2,0,2,9,4,13
31003,VILLA TUNARI,desnutricion global,desnutricion grave (g),2005-10-01,2,7,5,4,7,11,18
50602,VITICHI,desnutricion global,desnutricion grave (g),2005-10-01,0,2,0,0,0,2,2
70201,WARNES,desnutricion global,desnutricion grave (g),2005-10-01,0,1,1,0,1,1,2
20903,YACO,desnutricion global,desnutricion grave (g),2005-10-01,1,1,0,0,1,1,2
60301,YACUIBA,desnutricion global,desnutricion grave (g),2005-10-01,1,1,2,3,3,4,7
10602,YAMPARAEZ,desnutricion global,desnutricion grave (g),2005-10-01,5,3,0,2,5,5,10
21103,YANACACHI,desnutricion global,desnutricion grave (g),2005-10-01,2,0,0,0,2,0,2
70403,YAPACANI,desnutricion global,desnutricion grave (g),2005-10-01,0,1,1,1,1,2,3
10102,YOTALA,desnutricion global,desnutricion grave (g),2005-10-01,2,1,1,0,3,1,4
60402,YUNCHARA,desnutricion global,desnutricion grave (g),2005-10-01,1,1,0,0,1,1,2
10301,ZUDAÑEZ,desnutricion global,desnutricion grave (g),2005-10-01,2,0,2,2,4,2,6
51302,ACACIO,desnutricion global,desnutricion grave (g),2005-11-01,4,5,2,3,6,8,14
20201,ACHACACHI,desnutricion global,desnutricion grave (g),2005-11-01,0,1,0,0,0,1,1
30201,AIQUILE,desnutricion global,desnutricion grave (g),2005-11-01,0,0,1,1,1,1,2
31303,ALALAY,desnutricion global,desnutricion grave (g),2005-11-01,0,1,0,0,0,1,1
10404,ALCALA,desnutricion global,desnutricion grave (g),2005-11-01,0,1,0,2,0,3,3
20202,ANCORAIMES,desnutricion global,desnutricion grave (g),2005-11-01,2,0,1,1,3,1,4
41201,ANDAMARCA,desnutricion global,desnutricion grave (g),2005-11-01,0,1,0,0,0,1,1
30402,ANZALDO,desnutricion global,desnutricion grave (g),2005-11-01,1,0,0,0,1,0,1
20701,APOLO,desnutricion global,desnutricion grave (g),2005-11-01,0,0,0,1,0,1,1
51301,ARAMPAMPA,desnutricion global,desnutricion grave (g),2005-11-01,3,1,14,10,17,11,28
30501,ARANI,desnutricion global,desnutricion grave (g),2005-11-01,0,0,0,1,0,1,1
30403,ARBIETO,desnutricion global,desnutricion grave (g),2005-11-01,0,1,0,0,0,1,1
30601,ARQUE,desnutricion global,desnutricion grave (g),2005-11-01,3,0,0,0,3,0,3
50802,ATOCHA,desnutricion global,desnutricion grave (g),2005-11-01,0,1,0,0,0,1,1
20502,AYATA,desnutricion global,desnutricion grave (g),2005-11-01,0,2,1,0,1,2,3
21303,AYO AYO,desnutricion global,desnutricion grave (g),2005-11-01,0,2,0,0,0,2,2
30301,AYOPAYA (V. DE INDEPENDENCIA),desnutricion global,desnutricion grave (g),2005-11-01,0,6,1,1,1,7,8
10201,AZURDUY,desnutricion global,desnutricion grave (g),2005-11-01,3,6,2,2,5,8,13
21203,BATALLAS,desnutricion global,desnutricion grave (g),2005-11-01,0,1,1,0,1,1,2
80802,BAURES,desnutricion global,desnutricion grave (g),2005-11-01,0,1,0,0,0,1,1
50301,BETANZOS,desnutricion global,desnutricion grave (g),2005-11-01,8,9,3,7,11,16,27
31501,BOLIVAR,desnutricion global,desnutricion grave (g),2005-11-01,5,2,3,1,8,3,11
70703,CABEZAS,desnutricion global,desnutricion grave (g),2005-11-01,0,0,1,1,1,1,2
20905,CAIROMA,desnutricion global,desnutricion grave (g),2005-11-01,3,2,1,0,4,2,6
51102,"CAIZA ""D""",desnutricion global,desnutricion grave (g),2005-11-01,2,0,0,0,2,0,2
21003,CAJUATA,desnutricion global,desnutricion grave (g),2005-11-01,1,0,0,0,1,0,1
21304,CALAMARCA,desnutricion global,desnutricion grave (g),2005-11-01,4,0,1,0,5,0,5
10701,CAMARGO,desnutricion global,desnutricion grave (g),2005-11-01,5,0,0,0,5,0,5
70706,CAMIRI,desnutricion global,desnutricion grave (g),2005-11-01,4,1,3,4,7,5,12
30701,CAPINOTA,desnutricion global,desnutricion grave (g),2005-11-01,0,0,0,1,0,1,1
20302,CAQUIAVIRI,desnutricion global,desnutricion grave (g),2005-11-01,1,0,0,0,1,0,1
22001,CARANAVI,desnutricion global,desnutricion grave (g),2005-11-01,9,1,1,4,10,5,15
50702,CARIPUYO,desnutricion global,desnutricion grave (g),2005-11-01,7,10,4,4,11,14,25
21803,CHACARILLA,desnutricion global,desnutricion grave (g),2005-11-01,0,1,0,0,0,1,1
40201,CHALLAPATA,desnutricion global,desnutricion grave (g),2005-11-01,5,1,0,0,5,1,6
50302,CHAQUI,desnutricion global,desnutricion grave (g),2005-11-01,0,0,2,3,2,3,5
70702,CHARAGUA,desnutricion global,desnutricion grave (g),2005-11-01,2,1,1,2,3,3,6
50202,CHAYANTA,desnutricion global,desnutricion grave (g),2005-11-01,2,3,0,0,2,3,5
31204,CHIMORE,desnutricion global,desnutricion grave (g),2005-11-01,0,0,0,2,0,2,2
21101,CHULUMANI (V. DE LA LIBERTAD),desnutricion global,desnutricion grave (g),2005-11-01,1,2,0,0,1,2,3
20501,CHUMA,desnutricion global,desnutricion grave (g),2005-11-01,1,2,1,0,2,2,4
30801,CLIZA,desnutricion global,desnutricion grave (g),2005-11-01,5,0,1,1,6,1,7
90101,COBIJA,desnutricion global,desnutricion grave (g),2005-11-01,2,0,0,0,2,0,2
30101,COCHABAMBA,desnutricion global,desnutricion grave (g),2005-11-01,12,11,7,5,19,16,35
30905,COLCAPIRHUA,desnutricion global,desnutricion grave (g),2005-11-01,0,0,1,1,1,1,2
31002,COLOMI,desnutricion global,desnutricion grave (g),2005-11-01,4,2,1,0,5,2,7
50401,COLQUECHACA,desnutricion global,desnutricion grave (g),2005-11-01,7,7,5,18,12,25,37
21004,COLQUIRI,desnutricion global,desnutricion grave (g),2005-11-01,0,0,0,1,0,1,1
71301,COMARAPA,desnutricion global,desnutricion grave (g),2005-11-01,0,2,1,0,1,2,3
20605,COMBAYA,desnutricion global,desnutricion grave (g),2005-11-01,2,0,0,0,2,0,2
21701,COPACABANA,desnutricion global,desnutricion grave (g),2005-11-01,0,0,0,1,0,1,1
20301,CORO CORO,desnutricion global,desnutricion grave (g),2005-11-01,0,1,0,0,0,1,1
50601,COTAGAITA,desnutricion global,desnutricion grave (g),2005-11-01,4,5,3,2,7,7,14
71106,CUATRO CAÑADAS,desnutricion global,desnutricion grave (g),2005-11-01,4,0,0,1,4,1,5
10902,CULPINA,desnutricion global,desnutricion grave (g),2005-11-01,2,3,2,2,4,5,9
20105,EL ALTO,desnutricion global,desnutricion grave (g),2005-11-01,40,23,18,24,58,47,105
71503,EL PUENTE(STC),desnutricion global,desnutricion grave (g),2005-11-01,1,0,0,1,1,1,2
60502,EL PUENTE(TJA),desnutricion global,desnutricion grave (g),2005-11-01,0,1,0,1,0,2,2
70105,EL TORNO,desnutricion global,desnutricion grave (g),2005-11-01,1,0,0,1,1,1,2
10405,EL VILLAR,desnutricion global,desnutricion grave (g),2005-11-01,1,1,0,1,1,2,3
60601,ENTRE RIOS,desnutricion global,desnutricion grave (g),2005-11-01,2,1,1,0,3,1,4
60601,ENTRE RIOS,desnutricion global,desnutricion grave (g),2005-11-01,1,1,0,0,1,1,2
41101,EUCALIPTUS,desnutricion global,desnutricion grave (g),2005-11-01,0,0,1,1,1,1,2
90503,EUREKA (SANTOS MERCADO),desnutricion global,desnutricion grave (g),2005-11-01,0,1,0,1,0,2,2
80402,EXALTACION,desnutricion global,desnutricion grave (g),2005-11-01,0,0,1,0,1,0,1
71004,FERNANDEZ ALONSO,desnutricion global,desnutricion grave (g),2005-11-01,2,1,0,0,2,1,3
90203,FILADELFIA,desnutricion global,desnutricion grave (g),2005-11-01,0,0,1,0,1,0,1
71002,GENERAL SAAVEDRA,desnutricion global,desnutricion grave (g),2005-11-01,1,0,0,0,1,0,1
21601,GRAL. J.J. PEREZ (CHARAZANI),desnutricion global,desnutricion grave (g),2005-11-01,0,1,0,1,0,2,2
20602,GUANAY,desnutricion global,desnutricion grave (g),2005-11-01,1,0,0,0,1,0,1
80202,GUAYARAMERIN,desnutricion global,desnutricion grave (g),2005-11-01,3,4,0,3,3,7,10
70705,GUTIERREZ,desnutricion global,desnutricion grave (g),2005-11-01,3,0,1,1,4,1,5
10502,HUACARETA,desnutricion global,desnutricion grave (g),2005-11-01,0,0,2,0,2,0,2
40701,HUANUNI,desnutricion global,desnutricion grave (g),2005-11-01,1,1,0,0,1,1,2
80803,HUARACAJE,desnutricion global,desnutricion grave (g),2005-11-01,1,0,0,0,1,0,1
10304,ICLA,desnutricion global,desnutricion grave (g),2005-11-01,9,4,3,2,12,6,18
10703,INCAHUASI,desnutricion global,desnutricion grave (g),2005-11-01,5,1,3,10,8,11,19
21001,INQUISIVI,desnutricion global,desnutricion grave (g),2005-11-01,1,0,0,0,1,0,1
21102,IRUPANA (VILLA DE LANZA),desnutricion global,desnutricion grave (g),2005-11-01,0,1,0,0,0,1,1
21501,IXIAMAS,desnutricion global,desnutricion grave (g),2005-11-01,0,2,0,2,0,4,4
20806,JESUS DE MACHACA,desnutricion global,desnutricion grave (g),2005-11-01,2,0,0,0,2,0,2
21105,LA ASUNTA,desnutricion global,desnutricion grave (g),2005-11-01,1,2,1,1,2,3,5
70104,LA GUARDIA,desnutricion global,desnutricion grave (g),2005-11-01,0,3,3,0,3,3,6
20101,LA PAZ,desnutricion global,desnutricion grave (g),2005-11-01,14,8,4,7,18,15,33
70701,LAGUNILLAS,desnutricion global,desnutricion grave (g),2005-11-01,0,0,1,1,1,1,2
21202,LAJA,desnutricion global,desnutricion grave (g),2005-11-01,1,0,3,1,4,1,5
10903,LAS CARRERAS,desnutricion global,desnutricion grave (g),2005-11-01,0,0,1,0,1,0,1
50203,LLALLAGUA,desnutricion global,desnutricion grave (g),2005-11-01,2,2,3,4,5,6,11
20901,LURIBAY,desnutricion global,desnutricion grave (g),2005-11-01,2,2,0,0,2,2,4
40702,MACHACAMARCA,desnutricion global,desnutricion grave (g),2005-11-01,1,0,0,0,1,0,1
11003,MACHARETI,desnutricion global,desnutricion grave (g),2005-11-01,0,0,0,1,0,1,1
70903,MAIRANA,desnutricion global,desnutricion grave (g),2005-11-01,1,0,0,1,1,1,2
20904,MALLA,desnutricion global,desnutricion grave (g),2005-11-01,0,1,1,0,1,1,2
20607,MAPIRI,desnutricion global,desnutricion grave (g),2005-11-01,0,4,0,1,0,5,5
20103,MECAPACA,desnutricion global,desnutricion grave (g),2005-11-01,0,0,1,0,1,0,1
71003,MINEROS,desnutricion global,desnutricion grave (g),2005-11-01,3,1,1,0,4,1,5
31301,MIZQUE,desnutricion global,desnutricion grave (g),2005-11-01,0,0,2,0,2,0,2
20402,MOCOMOCO,desnutricion global,desnutricion grave (g),2005-11-01,1,0,0,0,1,0,1
10303,MOJOCOYA,desnutricion global,desnutricion grave (g),2005-11-01,1,0,0,0,1,0,1
10501,MONTEAGUDO,desnutricion global,desnutricion grave (g),2005-11-01,0,0,0,4,0,4,4
71001,MONTERO,desnutricion global,desnutricion grave (g),2005-11-01,12,7,0,1,12,8,20
30302,MOROCHATA,desnutricion global,desnutricion grave (g),2005-11-01,6,4,0,4,6,8,14
90501,NUEVO MANOA (NUEVA ESPERANZA),desnutricion global,desnutricion grave (g),2005-11-01,3,0,0,0,3,0,3
50404,OCURI,desnutricion global,desnutricion grave (g),2005-11-01,5,6,7,5,12,11,23
70202,OKINAWA,desnutricion global,desnutricion grave (g),2005-11-01,1,0,0,0,1,0,1
30203,OMEREQUE,desnutricion global,desnutricion grave (g),2005-11-01,1,0,0,0,1,0,1
40101,ORURO,desnutricion global,desnutricion grave (g),2005-11-01,6,7,2,3,8,10,18
60201,PADCAYA,desnutricion global,desnutricion grave (g),2005-11-01,3,0,0,0,3,0,3
10401,PADILLA,desnutricion global,desnutricion grave (g),2005-11-01,0,0,0,1,0,1,1
21104,PALOS BLANCOS,desnutricion global,desnutricion grave (g),2005-11-01,4,5,2,3,6,8,14
70902,PAMPA GRANDE,desnutricion global,desnutricion grave (g),2005-11-01,0,0,0,1,0,1,1
30202,PASORAPA,desnutricion global,desnutricion grave (g),2005-11-01,1,0,0,1,1,1,2
21305,PATACAMAYA,desnutricion global,desnutricion grave (g),2005-11-01,0,1,1,0,1,1,2
50403,POCOATA,desnutricion global,desnutricion grave (g),2005-11-01,7,4,3,2,10,6,16
31203,POCONA,desnutricion global,desnutricion grave (g),2005-11-01,3,0,2,1,5,1,6
31202,POJO (CBBA),desnutricion global,desnutricion grave (g),2005-11-01,1,3,0,0,1,3,4
51203,PORCO,desnutricion global,desnutricion grave (g),2005-11-01,2,1,0,0,2,1,3
10103,POROMA,desnutricion global,desnutricion grave (g),2005-11-01,8,7,5,9,13,16,29
90102,PORVENIR,desnutricion global,desnutricion grave (g),2005-11-01,1,0,0,0,1,0,1
50101,POTOSI,desnutricion global,desnutricion grave (g),2005-11-01,7,6,3,3,10,9,19
10302,PRESTO,desnutricion global,desnutricion grave (g),2005-11-01,3,4,2,1,5,5,10
21201,PUCARANI,desnutricion global,desnutricion grave (g),2005-11-01,0,0,0,1,0,1,1
20401,PUERTO ACOSTA,desnutricion global,desnutricion grave (g),2005-11-01,0,1,0,0,0,1,1
20403,PUERTO CARABUCO,desnutricion global,desnutricion grave (g),2005-11-01,0,0,0,1,0,1,1
90301,PUERTO GONZALO MORENO,desnutricion global,desnutricion grave (g),2005-11-01,0,1,0,5,0,6,6
31205,PUERTO VILLARROEL,desnutricion global,desnutricion grave (g),2005-11-01,7,6,1,2,8,8,16
51101,PUNA,desnutricion global,desnutricion grave (g),2005-11-01,7,2,2,1,9,3,12
30901,QUILLACOLLO,desnutricion global,desnutricion grave (g),2005-11-01,6,0,3,3,9,3,12
21002,QUIME,desnutricion global,desnutricion grave (g),2005-11-01,1,0,0,0,1,0,1
50402,RAVELO,desnutricion global,desnutricion grave (g),2005-11-01,12,7,8,13,20,20,40
80301,REYES,desnutricion global,desnutricion grave (g),2005-11-01,1,0,0,0,1,0,1
80201,RIBERALTA,desnutricion global,desnutricion grave (g),2005-11-01,18,29,11,10,29,39,68
80304,RURRENABAQUE,desnutricion global,desnutricion grave (g),2005-11-01,1,1,0,0,1,1,2
31001,SACABA,desnutricion global,desnutricion grave (g),2005-11-01,6,1,2,3,8,4,12
50701,SACACA,desnutricion global,desnutricion grave (g),2005-11-01,9,6,2,1,11,7,18
40801,SALINAS DE GARCI MENDOZA,desnutricion global,desnutricion grave (g),2005-11-01,0,1,1,0,1,1,2
71105,SAN ANTONIO DE LOMERIO,desnutricion global,desnutricion grave (g),2005-11-01,4,4,0,1,4,5,9
31403,SAN BENITO,desnutricion global,desnutricion grave (g),2005-11-01,1,0,3,0,4,0,4
80302,SAN BORJA,desnutricion global,desnutricion grave (g),2005-11-01,3,0,2,1,5,1,6
21502,SAN BUENA VENTURA,desnutricion global,desnutricion grave (g),2005-11-01,0,0,0,3,0,3,3
80501,SAN IGNACIO,desnutricion global,desnutricion grave (g),2005-11-01,3,2,0,1,3,3,6
70301,SAN IGNACIO DE VELASCO,desnutricion global,desnutricion grave (g),2005-11-01,5,6,0,1,5,7,12
71104,SAN JULIAN,desnutricion global,desnutricion grave (g),2005-11-01,1,2,1,2,2,4,6
90302,SAN LORENZO(PND),desnutricion global,desnutricion grave (g),2005-11-01,0,1,0,0,0,1,1
60501,SAN LORENZO(TJA),desnutricion global,desnutricion grave (g),2005-11-01,0,0,1,2,1,2,3
10702,SAN LUCAS,desnutricion global,desnutricion grave (g),2005-11-01,9,4,6,8,15,12,27
70302,SAN MIGUEL DE VELASCO,desnutricion global,desnutricion grave (g),2005-11-01,1,1,0,2,1,3,4
51001,SAN PABLO DE LIPEZ,desnutricion global,desnutricion grave (g),2005-11-01,1,0,0,0,1,0,1
50501,SAN PEDRO DE BUENA VISTA,desnutricion global,desnutricion grave (g),2005-11-01,7,5,5,6,12,11,23
80401,SANTA ANA,desnutricion global,desnutricion grave (g),2005-11-01,0,2,0,0,0,2,2
70101,SANTA CRUZ DE LA SIERRA,desnutricion global,desnutricion grave (g),2005-11-01,13,7,6,9,19,16,35
80303,SANTA ROSA,desnutricion global,desnutricion grave (g),2005-11-01,1,1,1,0,2,1,3
70602,SANTA ROSA DEL SARA,desnutricion global,desnutricion grave (g),2005-11-01,1,1,0,0,1,1,2
41401,SANTIAGO DE HUARI,desnutricion global,desnutricion grave (g),2005-11-01,0,0,1,0,1,0,1
21901,SANTIAGO DE MACHACA,desnutricion global,desnutricion grave (g),2005-11-01,0,1,0,0,0,1,1
40202,SANTUARIO DE QUILLACAS,desnutricion global,desnutricion grave (g),2005-11-01,1,0,0,0,1,0,1
90303,SENA,desnutricion global,desnutricion grave (g),2005-11-01,0,0,1,0,1,0,1
21301,SICA SICA (VILLA AROMA),desnutricion global,desnutricion grave (g),2005-11-01,2,0,1,0,3,0,3
30902,SIPE SIPE,desnutricion global,desnutricion grave (g),2005-11-01,5,0,2,3,7,3,10
10403,SOPACHUY,desnutricion global,desnutricion grave (g),2005-11-01,2,1,0,3,2,4,6
40104,SORACACHI,desnutricion global,desnutricion grave (g),2005-11-01,1,1,0,0,1,1,2
20601,SORATA,desnutricion global,desnutricion grave (g),2005-11-01,1,0,0,0,1,0,1
10101,SUCRE,desnutricion global,desnutricion grave (g),2005-11-01,5,7,2,4,7,11,18
31404,TACACHI,desnutricion global,desnutricion grave (g),2005-11-01,1,0,0,0,1,0,1
50303,TACOBAMBA,desnutricion global,desnutricion grave (g),2005-11-01,5,5,2,1,7,6,13
30602,TACOPAYA,desnutricion global,desnutricion grave (g),2005-11-01,1,3,0,3,1,6,7
31101,TAPACARI,desnutricion global,desnutricion grave (g),2005-11-01,6,0,5,6,11,6,17
10601,TARABUCO,desnutricion global,desnutricion grave (g),2005-11-01,14,14,7,7,21,21,42
30401,TARATA,desnutricion global,desnutricion grave (g),2005-11-01,1,2,0,0,1,2,3
60101,TARIJA,desnutricion global,desnutricion grave (g),2005-11-01,2,4,1,4,3,8,11
10202,TARVITA,desnutricion global,desnutricion grave (g),2005-11-01,4,5,1,2,5,7,12
20803,TIAWANACU,desnutricion global,desnutricion grave (g),2005-11-01,0,1,0,0,0,1,1
50102,TINGUIPAYA,desnutricion global,desnutricion grave (g),2005-11-01,12,10,3,1,15,11,26
30903,TIQUIPAYA,desnutricion global,desnutricion grave (g),2005-11-01,1,0,0,0,1,0,1
31601,TIRAQUE (CBBA),desnutricion global,desnutricion grave (g),2005-11-01,4,2,3,1,7,3,10
30802,TOCO,desnutricion global,desnutricion grave (g),2005-11-01,1,0,0,1,1,1,2
30803,TOLATA,desnutricion global,desnutricion grave (g),2005-11-01,0,0,2,0,2,0,2
10402,TOMINA,desnutricion global,desnutricion grave (g),2005-11-01,1,1,2,1,3,2,5
50502,TORO TORO,desnutricion global,desnutricion grave (g),2005-11-01,4,7,1,2,5,9,14
31201,TOTORA(CBBA),desnutricion global,desnutricion grave (g),2005-11-01,0,0,0,1,0,1,1
41301,TOTORA(ORR),desnutricion global,desnutricion grave (g),2005-11-01,1,0,1,0,2,0,2
80101,TRINIDAD,desnutricion global,desnutricion grave (g),2005-11-01,8,2,0,2,8,4,12
50801,TUPIZA,desnutricion global,desnutricion grave (g),2005-11-01,3,0,0,1,3,1,4
50201,UNCIA,desnutricion global,desnutricion grave (g),2005-11-01,0,0,2,1,2,1,3
60401,URIONDO (A. CONCEPCION),desnutricion global,desnutricion grave (g),2005-11-01,1,0,0,0,1,0,1
51201,UYUNI,desnutricion global,desnutricion grave (g),2005-11-01,1,0,0,0,1,0,1
30502,VACAS,desnutricion global,desnutricion grave (g),2005-11-01,5,0,0,1,5,1,6
70801,VALLEGRANDE,desnutricion global,desnutricion grave (g),2005-11-01,1,1,0,2,1,3,4
20801,VIACHA,desnutricion global,desnutricion grave (g),2005-11-01,3,1,0,1,3,2,5
31302,VILA VILA,desnutricion global,desnutricion grave (g),2005-11-01,0,0,1,0,1,0,1
60303,VILLA MONTES,desnutricion global,desnutricion grave (g),2005-11-01,3,1,0,1,3,2,5
90502,VILLA NUEVA (LOMA ALTA),desnutricion global,desnutricion grave (g),2005-11-01,1,1,0,0,1,1,2
31402,VILLA RIVERO,desnutricion global,desnutricion grave (g),2005-11-01,1,0,0,1,1,1,2
10801,VILLA SERRANO,desnutricion global,desnutricion grave (g),2005-11-01,4,1,1,1,5,2,7
31003,VILLA TUNARI,desnutricion global,desnutricion grave (g),2005-11-01,4,2,1,4,5,6,11
11001,VILLA VACA GUZMAN (MUYUPAMPA),desnutricion global,desnutricion grave (g),2005-11-01,0,1,0,0,0,1,1
51501,VILLAZON,desnutricion global,desnutricion grave (g),2005-11-01,1,2,1,0,2,2,4
30904,VINTO,desnutricion global,desnutricion grave (g),2005-11-01,1,1,1,1,2,2,4
50602,VITICHI,desnutricion global,desnutricion grave (g),2005-11-01,2,2,1,0,3,2,5
70201,WARNES,desnutricion global,desnutricion grave (g),2005-11-01,1,3,0,1,1,4,5
20903,YACO,desnutricion global,desnutricion grave (g),2005-11-01,1,2,2,1,3,3,6
60301,YACUIBA,desnutricion global,desnutricion grave (g),2005-11-01,1,2,1,1,2,3,5
10602,YAMPARAEZ,desnutricion global,desnutricion grave (g),2005-11-01,3,2,0,2,3,4,7
70403,YAPACANI,desnutricion global,desnutricion grave (g),2005-11-01,2,3,2,2,4,5,9
50103,YOCALLA,desnutricion global,desnutricion grave (g),2005-11-01,0,1,0,0,0,1,1
10102,YOTALA,desnutricion global,desnutricion grave (g),2005-11-01,2,3,0,0,2,3,5
60402,YUNCHARA,desnutricion global,desnutricion grave (g),2005-11-01,3,0,0,0,3,0,3
10301,ZUDAÑEZ,desnutricion global,desnutricion grave (g),2005-11-01,2,2,3,2,5,4,9
51302,ACACIO,desnutricion global,desnutricion grave (g),2005-12-01,2,0,0,0,2,0,2
20201,ACHACACHI,desnutricion global,desnutricion grave (g),2005-12-01,1,1,0,0,1,1,2
30201,AIQUILE,desnutricion global,desnutricion grave (g),2005-12-01,0,1,0,1,0,2,2
10404,ALCALA,desnutricion global,desnutricion grave (g),2005-12-01,1,1,0,5,1,6,7
41201,ANDAMARCA,desnutricion global,desnutricion grave (g),2005-12-01,2,0,0,0,2,0,2
40603,ANTEQUERA,desnutricion global,desnutricion grave (g),2005-12-01,0,1,0,0,0,1,1
20701,APOLO,desnutricion global,desnutricion grave (g),2005-12-01,3,0,0,0,3,0,3
51301,ARAMPAMPA,desnutricion global,desnutricion grave (g),2005-12-01,4,1,15,13,19,14,33
30501,ARANI,desnutricion global,desnutricion grave (g),2005-12-01,1,0,0,0,1,0,1
30403,ARBIETO,desnutricion global,desnutricion grave (g),2005-12-01,1,0,1,0,2,0,2
30601,ARQUE,desnutricion global,desnutricion grave (g),2005-12-01,1,1,1,1,2,2,4
50802,ATOCHA,desnutricion global,desnutricion grave (g),2005-12-01,1,1,0,3,1,4,5
20503,AUCAPATA,desnutricion global,desnutricion grave (g),2005-12-01,1,0,0,1,1,1,2
20502,AYATA,desnutricion global,desnutricion grave (g),2005-12-01,1,0,1,2,2,2,4
21303,AYO AYO,desnutricion global,desnutricion grave (g),2005-12-01,2,0,0,0,2,0,2
30301,AYOPAYA (V. DE INDEPENDENCIA),desnutricion global,desnutricion grave (g),2005-12-01,3,5,3,1,6,6,12
10201,AZURDUY,desnutricion global,desnutricion grave (g),2005-12-01,0,3,1,2,1,5,6
21203,BATALLAS,desnutricion global,desnutricion grave (g),2005-12-01,0,2,0,0,0,2,2
80802,BAURES,desnutricion global,desnutricion grave (g),2005-12-01,0,0,1,0,1,0,1
41202,BELEN DE ANDAMARCA,desnutricion global,desnutricion grave (g),2005-12-01,0,2,0,0,0,2,2
50301,BETANZOS,desnutricion global,desnutricion grave (g),2005-12-01,7,6,0,6,7,12,19
31501,BOLIVAR,desnutricion global,desnutricion grave (g),2005-12-01,3,4,0,1,3,5,8
70707,BOYUIBE,desnutricion global,desnutricion grave (g),2005-12-01,0,1,0,0,0,1,1
70703,CABEZAS,desnutricion global,desnutricion grave (g),2005-12-01,0,0,0,1,0,1,1
20905,CAIROMA,desnutricion global,desnutricion grave (g),2005-12-01,1,2,0,0,1,2,3
51102,"CAIZA ""D""",desnutricion global,desnutricion grave (g),2005-12-01,0,0,0,2,0,2,2
21304,CALAMARCA,desnutricion global,desnutricion grave (g),2005-12-01,4,2,0,0,4,2,6
10701,CAMARGO,desnutricion global,desnutricion grave (g),2005-12-01,2,1,0,2,2,3,5
10901,CAMATAQUI (C. VILLA ABECIA),desnutricion global,desnutricion grave (g),2005-12-01,2,1,1,0,3,1,4
70706,CAMIRI,desnutricion global,desnutricion grave (g),2005-12-01,1,3,1,0,2,3,5
30701,CAPINOTA,desnutricion global,desnutricion grave (g),2005-12-01,2,2,0,2,2,4,6
22001,CARANAVI,desnutricion global,desnutricion grave (g),2005-12-01,2,0,2,1,4,1,5
60302,CARAPARI,desnutricion global,desnutricion grave (g),2005-12-01,0,0,1,0,1,0,1
50702,CARIPUYO,desnutricion global,desnutricion grave (g),2005-12-01,0,2,2,3,2,5,7
40201,CHALLAPATA,desnutricion global,desnutricion grave (g),2005-12-01,1,1,0,0,1,1,2
50302,CHAQUI,desnutricion global,desnutricion grave (g),2005-12-01,0,1,2,1,2,2,4
70702,CHARAGUA,desnutricion global,desnutricion grave (g),2005-12-01,3,2,1,2,4,4,8
50202,CHAYANTA,desnutricion global,desnutricion grave (g),2005-12-01,4,1,1,1,5,2,7
31204,CHIMORE,desnutricion global,desnutricion grave (g),2005-12-01,0,0,0,1,0,1,1
40903,CHIPAYA,desnutricion global,desnutricion grave (g),2005-12-01,0,1,0,0,0,1,1
21101,CHULUMANI (V. DE LA LIBERTAD),desnutricion global,desnutricion grave (g),2005-12-01,0,0,1,0,1,0,1
20501,CHUMA,desnutricion global,desnutricion grave (g),2005-12-01,1,0,1,0,2,0,2
30801,CLIZA,desnutricion global,desnutricion grave (g),2005-12-01,5,1,0,0,5,1,6
90101,COBIJA,desnutricion global,desnutricion grave (g),2005-12-01,4,1,1,0,5,1,6
30101,COCHABAMBA,desnutricion global,desnutricion grave (g),2005-12-01,25,7,4,4,29,11,40
30905,COLCAPIRHUA,desnutricion global,desnutricion grave (g),2005-12-01,2,0,0,0,2,0,2
31002,COLOMI,desnutricion global,desnutricion grave (g),2005-12-01,2,5,2,1,4,6,10
50401,COLQUECHACA,desnutricion global,desnutricion grave (g),2005-12-01,1,1,3,2,4,3,7
21306,COLQUENCHA,desnutricion global,desnutricion grave (g),2005-12-01,0,0,0,1,0,1,1
21004,COLQUIRI,desnutricion global,desnutricion grave (g),2005-12-01,1,0,0,0,1,0,1
20304,COMANCHE,desnutricion global,desnutricion grave (g),2005-12-01,1,0,0,0,1,0,1
21701,COPACABANA,desnutricion global,desnutricion grave (g),2005-12-01,0,1,0,0,0,1,1
50601,COTAGAITA,desnutricion global,desnutricion grave (g),2005-12-01,2,4,0,2,2,6,8
71106,CUATRO CAÑADAS,desnutricion global,desnutricion grave (g),2005-12-01,0,0,1,0,1,0,1
10902,CULPINA,desnutricion global,desnutricion grave (g),2005-12-01,4,2,3,0,7,2,9
40401,CURAHUARA DE CARANGAS,desnutricion global,desnutricion grave (g),2005-12-01,0,1,0,0,0,1,1
20105,EL ALTO,desnutricion global,desnutricion grave (g),2005-12-01,32,21,7,14,39,35,74
60502,EL PUENTE(TJA),desnutricion global,desnutricion grave (g),2005-12-01,0,0,1,0,1,0,1
70105,EL TORNO,desnutricion global,desnutricion grave (g),2005-12-01,0,1,1,1,1,2,3
10405,EL VILLAR,desnutricion global,desnutricion grave (g),2005-12-01,1,0,0,1,1,1,2
60601,ENTRE RIOS,desnutricion global,desnutricion grave (g),2005-12-01,2,1,1,1,3,2,5
60601,ENTRE RIOS,desnutricion global,desnutricion grave (g),2005-12-01,10,1,1,0,11,1,12
90503,EUREKA (SANTOS MERCADO),desnutricion global,desnutricion grave (g),2005-12-01,0,1,0,0,0,1,1
71004,FERNANDEZ ALONSO,desnutricion global,desnutricion grave (g),2005-12-01,1,1,0,0,1,1,2
71002,GENERAL SAAVEDRA,desnutricion global,desnutricion grave (g),2005-12-01,0,2,1,0,1,2,3
21601,GRAL. J.J. PEREZ (CHARAZANI),desnutricion global,desnutricion grave (g),2005-12-01,1,0,0,0,1,0,1
80202,GUAYARAMERIN,desnutricion global,desnutricion grave (g),2005-12-01,1,1,0,0,1,1,2
70705,GUTIERREZ,desnutricion global,desnutricion grave (g),2005-12-01,6,4,3,5,9,9,18
10502,HUACARETA,desnutricion global,desnutricion grave (g),2005-12-01,0,1,2,0,2,1,3
40701,HUANUNI,desnutricion global,desnutricion grave (g),2005-12-01,2,0,0,0,2,0,2
10304,ICLA,desnutricion global,desnutricion grave (g),2005-12-01,7,3,2,2,9,5,14
10703,INCAHUASI,desnutricion global,desnutricion grave (g),2005-12-01,8,2,3,5,11,7,18
90402,INGAVI (HUMAITA),desnutricion global,desnutricion grave (g),2005-12-01,0,1,0,0,0,1,1
21001,INQUISIVI,desnutricion global,desnutricion grave (g),2005-12-01,0,1,0,1,0,2,2
21501,IXIAMAS,desnutricion global,desnutricion grave (g),2005-12-01,1,1,0,0,1,1,2
21105,LA ASUNTA,desnutricion global,desnutricion grave (g),2005-12-01,0,0,1,1,1,1,2
20101,LA PAZ,desnutricion global,desnutricion grave (g),2005-12-01,10,11,2,2,12,13,25
70701,LAGUNILLAS,desnutricion global,desnutricion grave (g),2005-12-01,1,1,0,0,1,1,2
50203,LLALLAGUA,desnutricion global,desnutricion grave (g),2005-12-01,3,4,1,2,4,6,10
20901,LURIBAY,desnutricion global,desnutricion grave (g),2005-12-01,3,0,0,1,3,1,4
11003,MACHARETI,desnutricion global,desnutricion grave (g),2005-12-01,0,0,0,1,0,1,1
80801,MAGDALENA,desnutricion global,desnutricion grave (g),2005-12-01,0,1,0,0,0,1,1
20607,MAPIRI,desnutricion global,desnutricion grave (g),2005-12-01,2,1,0,3,2,4,6
71003,MINEROS,desnutricion global,desnutricion grave (g),2005-12-01,2,1,0,0,2,1,3
31301,MIZQUE,desnutricion global,desnutricion grave (g),2005-12-01,4,3,2,1,6,4,10
20402,MOCOMOCO,desnutricion global,desnutricion grave (g),2005-12-01,0,1,1,0,1,1,2
10303,MOJOCOYA,desnutricion global,desnutricion grave (g),2005-12-01,1,1,0,0,1,1,2
10501,MONTEAGUDO,desnutricion global,desnutricion grave (g),2005-12-01,1,1,1,3,2,4,6
71001,MONTERO,desnutricion global,desnutricion grave (g),2005-12-01,12,11,1,4,13,15,28
70803,MORO MORO,desnutricion global,desnutricion grave (g),2005-12-01,1,0,0,0,1,0,1
30302,MOROCHATA,desnutricion global,desnutricion grave (g),2005-12-01,2,0,0,1,2,1,3
90501,NUEVO MANOA (NUEVA ESPERANZA),desnutricion global,desnutricion grave (g),2005-12-01,2,0,0,0,2,0,2
50404,OCURI,desnutricion global,desnutricion grave (g),2005-12-01,5,5,1,3,6,8,14
40101,ORURO,desnutricion global,desnutricion grave (g),2005-12-01,1,7,0,3,1,10,11
60201,PADCAYA,desnutricion global,desnutricion grave (g),2005-12-01,1,0,0,0,1,0,1
10401,PADILLA,desnutricion global,desnutricion grave (g),2005-12-01,3,0,1,3,4,3,7
21104,PALOS BLANCOS,desnutricion global,desnutricion grave (g),2005-12-01,3,1,0,4,3,5,8
70902,PAMPA GRANDE,desnutricion global,desnutricion grave (g),2005-12-01,2,3,0,0,2,3,5
30202,PASORAPA,desnutricion global,desnutricion grave (g),2005-12-01,1,0,0,0,1,0,1
50403,POCOATA,desnutricion global,desnutricion grave (g),2005-12-01,3,10,5,5,8,15,23
31203,POCONA,desnutricion global,desnutricion grave (g),2005-12-01,2,3,0,0,2,3,5
51203,PORCO,desnutricion global,desnutricion grave (g),2005-12-01,1,0,0,0,1,0,1
10103,POROMA,desnutricion global,desnutricion grave (g),2005-12-01,3,3,4,3,7,6,13
70601,PORTACHUELO,desnutricion global,desnutricion grave (g),2005-12-01,2,0,0,0,2,0,2
50101,POTOSI,desnutricion global,desnutricion grave (g),2005-12-01,12,6,2,2,14,8,22
10302,PRESTO,desnutricion global,desnutricion grave (g),2005-12-01,2,2,2,1,4,3,7
21201,PUCARANI,desnutricion global,desnutricion grave (g),2005-12-01,6,0,0,0,6,0,6
90301,PUERTO GONZALO MORENO,desnutricion global,desnutricion grave (g),2005-12-01,5,2,0,0,5,2,7
31205,PUERTO VILLARROEL,desnutricion global,desnutricion grave (g),2005-12-01,1,6,1,1,2,7,9
51101,PUNA,desnutricion global,desnutricion grave (g),2005-12-01,9,4,3,4,12,8,20
31401,PUNATA,desnutricion global,desnutricion grave (g),2005-12-01,1,1,2,0,3,1,4
30901,QUILLACOLLO,desnutricion global,desnutricion grave (g),2005-12-01,5,2,2,0,7,2,9
21002,QUIME,desnutricion global,desnutricion grave (g),2005-12-01,0,1,0,0,0,1,1
50402,RAVELO,desnutricion global,desnutricion grave (g),2005-12-01,11,7,10,11,21,18,39
80301,REYES,desnutricion global,desnutricion grave (g),2005-12-01,0,0,0,1,0,1,1
80201,RIBERALTA,desnutricion global,desnutricion grave (g),2005-12-01,13,14,4,3,17,17,34
31001,SACABA,desnutricion global,desnutricion grave (g),2005-12-01,1,3,0,3,1,6,7
50701,SACACA,desnutricion global,desnutricion grave (g),2005-12-01,10,6,6,2,16,8,24
71302,SAIPINA,desnutricion global,desnutricion grave (g),2005-12-01,1,1,0,0,1,1,2
70901,SAMAIPATA,desnutricion global,desnutricion grave (g),2005-12-01,1,0,1,0,2,0,2
71105,SAN ANTONIO DE LOMERIO,desnutricion global,desnutricion grave (g),2005-12-01,0,0,0,1,0,1,1
31403,SAN BENITO,desnutricion global,desnutricion grave (g),2005-12-01,0,1,0,0,0,1,1
80302,SAN BORJA,desnutricion global,desnutricion grave (g),2005-12-01,3,4,1,2,4,6,10
80501,SAN IGNACIO,desnutricion global,desnutricion grave (g),2005-12-01,0,2,1,2,1,4,5
70301,SAN IGNACIO DE VELASCO,desnutricion global,desnutricion grave (g),2005-12-01,1,8,3,3,4,11,15
71104,SAN JULIAN,desnutricion global,desnutricion grave (g),2005-12-01,0,1,0,0,0,1,1
90302,SAN LORENZO(PND),desnutricion global,desnutricion grave (g),2005-12-01,0,3,0,0,0,3,3
60501,SAN LORENZO(TJA),desnutricion global,desnutricion grave (g),2005-12-01,0,0,0,1,0,1,1
10702,SAN LUCAS,desnutricion global,desnutricion grave (g),2005-12-01,5,6,5,2,10,8,18
71005,SAN PEDRO,desnutricion global,desnutricion grave (g),2005-12-01,1,1,0,1,1,2,3
50501,SAN PEDRO DE BUENA VISTA,desnutricion global,desnutricion grave (g),2005-12-01,4,5,6,2,10,7,17
90202,SAN PEDRO(PND),desnutricion global,desnutricion grave (g),2005-12-01,0,1,0,0,0,1,1
70101,SANTA CRUZ DE LA SIERRA,desnutricion global,desnutricion grave (g),2005-12-01,24,20,8,14,32,34,66
80303,SANTA ROSA,desnutricion global,desnutricion grave (g),2005-12-01,0,3,1,0,1,3,4
30702,SANTIVAÑES,desnutricion global,desnutricion grave (g),2005-12-01,0,1,0,0,0,1,1
90303,SENA,desnutricion global,desnutricion grave (g),2005-12-01,1,0,0,0,1,0,1
21301,SICA SICA (VILLA AROMA),desnutricion global,desnutricion grave (g),2005-12-01,0,2,2,2,2,4,6
30703,SICAYA,desnutricion global,desnutricion grave (g),2005-12-01,2,0,0,0,2,0,2
30902,SIPE SIPE,desnutricion global,desnutricion grave (g),2005-12-01,5,1,1,0,6,1,7
10403,SOPACHUY,desnutricion global,desnutricion grave (g),2005-12-01,3,2,0,1,3,3,6
10101,SUCRE,desnutricion global,desnutricion grave (g),2005-12-01,4,1,2,2,6,3,9
50303,TACOBAMBA,desnutricion global,desnutricion grave (g),2005-12-01,1,2,0,1,1,3,4
30602,TACOPAYA,desnutricion global,desnutricion grave (g),2005-12-01,2,2,1,1,3,3,6
31101,TAPACARI,desnutricion global,desnutricion grave (g),2005-12-01,0,1,2,0,2,1,3
10601,TARABUCO,desnutricion global,desnutricion grave (g),2005-12-01,11,15,9,8,20,23,43
60101,TARIJA,desnutricion global,desnutricion grave (g),2005-12-01,4,6,4,5,8,11,19
10202,TARVITA,desnutricion global,desnutricion grave (g),2005-12-01,2,0,1,2,3,2,5
50102,TINGUIPAYA,desnutricion global,desnutricion grave (g),2005-12-01,4,6,1,6,5,12,17
20606,TIPUANI,desnutricion global,desnutricion grave (g),2005-12-01,0,3,0,0,0,3,3
31601,TIRAQUE (CBBA),desnutricion global,desnutricion grave (g),2005-12-01,4,2,1,0,5,2,7
51202,TOMAVE,desnutricion global,desnutricion grave (g),2005-12-01,0,1,0,0,0,1,1
10402,TOMINA,desnutricion global,desnutricion grave (g),2005-12-01,4,0,1,3,5,3,8
50502,TORO TORO,desnutricion global,desnutricion grave (g),2005-12-01,4,1,4,3,8,4,12
31201,TOTORA(CBBA),desnutricion global,desnutricion grave (g),2005-12-01,0,0,1,0,1,0,1
80101,TRINIDAD,desnutricion global,desnutricion grave (g),2005-12-01,4,4,4,2,8,6,14
50801,TUPIZA,desnutricion global,desnutricion grave (g),2005-12-01,3,0,1,0,4,0,4
50201,UNCIA,desnutricion global,desnutricion grave (g),2005-12-01,1,0,2,2,3,2,5
60401,URIONDO (A. CONCEPCION),desnutricion global,desnutricion grave (g),2005-12-01,0,0,0,2,0,2,2
51201,UYUNI,desnutricion global,desnutricion grave (g),2005-12-01,0,2,0,0,0,2,2
30502,VACAS,desnutricion global,desnutricion grave (g),2005-12-01,2,1,0,0,2,1,3
70801,VALLEGRANDE,desnutricion global,desnutricion grave (g),2005-12-01,0,3,1,2,1,5,6
20801,VIACHA,desnutricion global,desnutricion grave (g),2005-12-01,0,1,0,0,0,1,1
31302,VILA VILA,desnutricion global,desnutricion grave (g),2005-12-01,0,3,0,0,0,3,3
60303,VILLA MONTES,desnutricion global,desnutricion grave (g),2005-12-01,0,5,0,0,0,5,5
90502,VILLA NUEVA (LOMA ALTA),desnutricion global,desnutricion grave (g),2005-12-01,0,0,0,1,0,1,1
31402,VILLA RIVERO,desnutricion global,desnutricion grave (g),2005-12-01,1,0,0,0,1,0,1
10801,VILLA SERRANO,desnutricion global,desnutricion grave (g),2005-12-01,2,2,2,2,4,4,8
31003,VILLA TUNARI,desnutricion global,desnutricion grave (g),2005-12-01,1,4,5,2,6,6,12
11001,VILLA VACA GUZMAN (MUYUPAMPA),desnutricion global,desnutricion grave (g),2005-12-01,0,3,0,1,0,4,4
51501,VILLAZON,desnutricion global,desnutricion grave (g),2005-12-01,0,1,0,1,0,2,2
30904,VINTO,desnutricion global,desnutricion grave (g),2005-12-01,2,2,1,1,3,3,6
50602,VITICHI,desnutricion global,desnutricion grave (g),2005-12-01,0,1,0,0,0,1,1
70201,WARNES,desnutricion global,desnutricion grave (g),2005-12-01,0,6,0,1,0,7,7
20903,YACO,desnutricion global,desnutricion grave (g),2005-12-01,0,0,1,0,1,0,1
60301,YACUIBA,desnutricion global,desnutricion grave (g),2005-12-01,2,3,4,3,6,6,12
10602,YAMPARAEZ,desnutricion global,desnutricion grave (g),2005-12-01,3,2,1,1,4,3,7
70403,YAPACANI,desnutricion global,desnutricion grave (g),2005-12-01,4,2,0,2,4,4,8
50103,YOCALLA,desnutricion global,desnutricion grave (g),2005-12-01,0,1,0,0,0,1,1
10102,YOTALA,desnutricion global,desnutricion grave (g),2005-12-01,2,0,0,0,2,0,2
10301,ZUDAÑEZ,desnutricion global,desnutricion grave (g),2005-12-01,2,1,1,1,3,2,5
