codigo_municipio,municipio,grupo,variable,mes,totales_total-m,totales-1_total-f,totales-2_total
51302,ACACIO,salud sexual y reproductiva,hemorragia de la primera mitad del embarazo (< 22 sem) aborto,2015-01-01,1,0,1
30201,AIQUILE,salud sexual y reproductiva,hemorragia de la primera mitad del embarazo (< 22 sem) aborto,2015-01-01,3,0,3
30501,ARANI,salud sexual y reproductiva,hemorragia de la primera mitad del embarazo (< 22 sem) aborto,2015-01-01,5,0,5
71501,ASCENCION DE GUARAYOS,salud sexual y reproductiva,hemorragia de la primera mitad del embarazo (< 22 sem) aborto,2015-01-01,4,0,4
30301,AYOPAYA (V. DE INDEPENDENCIA),salud sexual y reproductiva,hemorragia de la primera mitad del embarazo (< 22 sem) aborto,2015-01-01,1,0,1
50301,BETANZOS,salud sexual y reproductiva,hemorragia de la primera mitad del embarazo (< 22 sem) aborto,2015-01-01,1,0,1
70707,BOYUIBE,salud sexual y reproductiva,hemorragia de la primera mitad del embarazo (< 22 sem) aborto,2015-01-01,1,0,1
20905,CAIROMA,salud sexual y reproductiva,hemorragia de la primera mitad del embarazo (< 22 sem) aborto,2015-01-01,0,1,1
51102,"CAIZA ""D""",salud sexual y reproductiva,hemorragia de la primera mitad del embarazo (< 22 sem) aborto,2015-01-01,0,2,2
10701,CAMARGO,salud sexual y reproductiva,hemorragia de la primera mitad del embarazo (< 22 sem) aborto,2015-01-01,2,0,2
70706,CAMIRI,salud sexual y reproductiva,hemorragia de la primera mitad del embarazo (< 22 sem) aborto,2015-01-01,13,10,23
30701,CAPINOTA,salud sexual y reproductiva,hemorragia de la primera mitad del embarazo (< 22 sem) aborto,2015-01-01,6,0,6
40102,CARACOLLO,salud sexual y reproductiva,hemorragia de la primera mitad del embarazo (< 22 sem) aborto,2015-01-01,0,2,2
60302,CARAPARI,salud sexual y reproductiva,hemorragia de la primera mitad del embarazo (< 22 sem) aborto,2015-01-01,1,1,2
50302,CHAQUI,salud sexual y reproductiva,hemorragia de la primera mitad del embarazo (< 22 sem) aborto,2015-01-01,0,1,1
70702,CHARAGUA,salud sexual y reproductiva,hemorragia de la primera mitad del embarazo (< 22 sem) aborto,2015-01-01,6,0,6
21101,CHULUMANI (V. DE LA LIBERTAD),salud sexual y reproductiva,hemorragia de la primera mitad del embarazo (< 22 sem) aborto,2015-01-01,1,0,1
30801,CLIZA,salud sexual y reproductiva,hemorragia de la primera mitad del embarazo (< 22 sem) aborto,2015-01-01,11,0,11
90101,COBIJA,salud sexual y reproductiva,hemorragia de la primera mitad del embarazo (< 22 sem) aborto,2015-01-01,29,0,29
30101,COCHABAMBA,salud sexual y reproductiva,hemorragia de la primera mitad del embarazo (< 22 sem) aborto,2015-01-01,165,3,168
21307,COLLANA,salud sexual y reproductiva,hemorragia de la primera mitad del embarazo (< 22 sem) aborto,2015-01-01,1,0,1
31002,COLOMI,salud sexual y reproductiva,hemorragia de la primera mitad del embarazo (< 22 sem) aborto,2015-01-01,10,0,10
50401,COLQUECHACA,salud sexual y reproductiva,hemorragia de la primera mitad del embarazo (< 22 sem) aborto,2015-01-01,0,1,1
71301,COMARAPA,salud sexual y reproductiva,hemorragia de la primera mitad del embarazo (< 22 sem) aborto,2015-01-01,4,0,4
71101,CONCEPCION,salud sexual y reproductiva,hemorragia de la primera mitad del embarazo (< 22 sem) aborto,2015-01-01,2,0,2
21401,COROICO,salud sexual y reproductiva,hemorragia de la primera mitad del embarazo (< 22 sem) aborto,2015-01-01,1,0,1
50601,COTAGAITA,salud sexual y reproductiva,hemorragia de la primera mitad del embarazo (< 22 sem) aborto,2015-01-01,0,1,1
71106,CUATRO CAÃ‘ADAS,salud sexual y reproductiva,hemorragia de la primera mitad del embarazo (< 22 sem) aborto,2015-01-01,6,0,6
10902,CULPINA,salud sexual y reproductiva,hemorragia de la primera mitad del embarazo (< 22 sem) aborto,2015-01-01,0,1,1
20105,EL ALTO,salud sexual y reproductiva,hemorragia de la primera mitad del embarazo (< 22 sem) aborto,2015-01-01,111,17,128
70105,EL TORNO,salud sexual y reproductiva,hemorragia de la primera mitad del embarazo (< 22 sem) aborto,2015-01-01,5,3,8
60601,ENTRE RIOS TRJ,salud sexual y reproductiva,hemorragia de la primera mitad del embarazo (< 22 sem) aborto,2015-01-01,0,1,1
20405,ESCOMA,salud sexual y reproductiva,hemorragia de la primera mitad del embarazo (< 22 sem) aborto,2015-01-01,0,1,1
90203,FILADELFIA,salud sexual y reproductiva,hemorragia de la primera mitad del embarazo (< 22 sem) aborto,2015-01-01,2,0,2
20602,GUANAY,salud sexual y reproductiva,hemorragia de la primera mitad del embarazo (< 22 sem) aborto,2015-01-01,0,1,1
40501,HUACHACALLA,salud sexual y reproductiva,hemorragia de la primera mitad del embarazo (< 22 sem) aborto,2015-01-01,0,1,1
40701,HUANUNI,salud sexual y reproductiva,hemorragia de la primera mitad del embarazo (< 22 sem) aborto,2015-01-01,0,1,1
21005,ICHOCA,salud sexual y reproductiva,hemorragia de la primera mitad del embarazo (< 22 sem) aborto,2015-01-01,1,0,1
21105,LA ASUNTA,salud sexual y reproductiva,hemorragia de la primera mitad del embarazo (< 22 sem) aborto,2015-01-01,10,1,11
70104,LA GUARDIA,salud sexual y reproductiva,hemorragia de la primera mitad del embarazo (< 22 sem) aborto,2015-01-01,14,5,19
20101,LA PAZ,salud sexual y reproductiva,hemorragia de la primera mitad del embarazo (< 22 sem) aborto,2015-01-01,153,2,155
21202,LAJA,salud sexual y reproductiva,hemorragia de la primera mitad del embarazo (< 22 sem) aborto,2015-01-01,3,2,5
11003,MACHARETI,salud sexual y reproductiva,hemorragia de la primera mitad del embarazo (< 22 sem) aborto,2015-01-01,1,0,1
80801,MAGDALENA,salud sexual y reproductiva,hemorragia de la primera mitad del embarazo (< 22 sem) aborto,2015-01-01,2,0,2
70903,MAIRANA,salud sexual y reproductiva,hemorragia de la primera mitad del embarazo (< 22 sem) aborto,2015-01-01,4,0,4
20607,MAPIRI,salud sexual y reproductiva,hemorragia de la primera mitad del embarazo (< 22 sem) aborto,2015-01-01,1,1,2
31301,MIZQUE,salud sexual y reproductiva,hemorragia de la primera mitad del embarazo (< 22 sem) aborto,2015-01-01,1,0,1
20402,MOCOMOCO,salud sexual y reproductiva,hemorragia de la primera mitad del embarazo (< 22 sem) aborto,2015-01-01,0,2,2
10303,MOJOCOYA,salud sexual y reproductiva,hemorragia de la primera mitad del embarazo (< 22 sem) aborto,2015-01-01,0,3,3
10501,MONTEAGUDO,salud sexual y reproductiva,hemorragia de la primera mitad del embarazo (< 22 sem) aborto,2015-01-01,10,3,13
71001,MONTERO,salud sexual y reproductiva,hemorragia de la primera mitad del embarazo (< 22 sem) aborto,2015-01-01,49,2,51
30302,MOROCHATA,salud sexual y reproductiva,hemorragia de la primera mitad del embarazo (< 22 sem) aborto,2015-01-01,1,0,1
40101,ORURO,salud sexual y reproductiva,hemorragia de la primera mitad del embarazo (< 22 sem) aborto,2015-01-01,6,4,10
10401,PADILLA,salud sexual y reproductiva,hemorragia de la primera mitad del embarazo (< 22 sem) aborto,2015-01-01,2,0,2
70902,PAMPA GRANDE,salud sexual y reproductiva,hemorragia de la primera mitad del embarazo (< 22 sem) aborto,2015-01-01,0,2,2
10103,POROMA,salud sexual y reproductiva,hemorragia de la primera mitad del embarazo (< 22 sem) aborto,2015-01-01,0,1,1
50101,POTOSI,salud sexual y reproductiva,hemorragia de la primera mitad del embarazo (< 22 sem) aborto,2015-01-01,20,1,21
10302,PRESTO,salud sexual y reproductiva,hemorragia de la primera mitad del embarazo (< 22 sem) aborto,2015-01-01,0,2,2
21201,PUCARANI,salud sexual y reproductiva,hemorragia de la primera mitad del embarazo (< 22 sem) aborto,2015-01-01,2,3,5
20401,PUERTO ACOSTA,salud sexual y reproductiva,hemorragia de la primera mitad del embarazo (< 22 sem) aborto,2015-01-01,0,1,1
90301,PUERTO GONZALO MORENO,salud sexual y reproductiva,hemorragia de la primera mitad del embarazo (< 22 sem) aborto,2015-01-01,0,1,1
21204,PUERTO PEREZ,salud sexual y reproductiva,hemorragia de la primera mitad del embarazo (< 22 sem) aborto,2015-01-01,0,1,1
90201,PUERTO RICO,salud sexual y reproductiva,hemorragia de la primera mitad del embarazo (< 22 sem) aborto,2015-01-01,2,2,4
71401,PUERTO SUAREZ,salud sexual y reproductiva,hemorragia de la primera mitad del embarazo (< 22 sem) aborto,2015-01-01,1,0,1
31205,PUERTO VILLARROEL,salud sexual y reproductiva,hemorragia de la primera mitad del embarazo (< 22 sem) aborto,2015-01-01,8,0,8
51101,PUNA,salud sexual y reproductiva,hemorragia de la primera mitad del embarazo (< 22 sem) aborto,2015-01-01,0,2,2
31401,PUNATA,salud sexual y reproductiva,hemorragia de la primera mitad del embarazo (< 22 sem) aborto,2015-01-01,25,0,25
30901,QUILLACOLLO,salud sexual y reproductiva,hemorragia de la primera mitad del embarazo (< 22 sem) aborto,2015-01-01,0,24,24
50402,RAVELO,salud sexual y reproductiva,hemorragia de la primera mitad del embarazo (< 22 sem) aborto,2015-01-01,2,0,2
80301,REYES,salud sexual y reproductiva,hemorragia de la primera mitad del embarazo (< 22 sem) aborto,2015-01-01,2,0,2
80201,RIBERALTA,salud sexual y reproductiva,hemorragia de la primera mitad del embarazo (< 22 sem) aborto,2015-01-01,18,11,29
70503,ROBORE,salud sexual y reproductiva,hemorragia de la primera mitad del embarazo (< 22 sem) aborto,2015-01-01,2,0,2
40901,SABAYA,salud sexual y reproductiva,hemorragia de la primera mitad del embarazo (< 22 sem) aborto,2015-01-01,0,1,1
31001,SACABA,salud sexual y reproductiva,hemorragia de la primera mitad del embarazo (< 22 sem) aborto,2015-01-01,37,10,47
50701,SACACA,salud sexual y reproductiva,hemorragia de la primera mitad del embarazo (< 22 sem) aborto,2015-01-01,1,0,1
40801,SALINAS DE GARCI MENDOZA,salud sexual y reproductiva,hemorragia de la primera mitad del embarazo (< 22 sem) aborto,2015-01-01,0,1,1
80302,SAN BORJA,salud sexual y reproductiva,hemorragia de la primera mitad del embarazo (< 22 sem) aborto,2015-01-01,23,1,24
70402,SAN CARLOS,salud sexual y reproductiva,hemorragia de la primera mitad del embarazo (< 22 sem) aborto,2015-01-01,3,7,10
80501,SAN IGNACIO,salud sexual y reproductiva,hemorragia de la primera mitad del embarazo (< 22 sem) aborto,2015-01-01,5,0,5
70301,SAN IGNACIO DE VELASCO,salud sexual y reproductiva,hemorragia de la primera mitad del embarazo (< 22 sem) aborto,2015-01-01,13,0,13
71104,SAN JULIAN,salud sexual y reproductiva,hemorragia de la primera mitad del embarazo (< 22 sem) aborto,2015-01-01,32,0,32
10702,SAN LUCAS,salud sexual y reproductiva,hemorragia de la primera mitad del embarazo (< 22 sem) aborto,2015-01-01,0,1,1
71201,SAN MATIAS,salud sexual y reproductiva,hemorragia de la primera mitad del embarazo (< 22 sem) aborto,2015-01-01,2,0,2
80401,SANTA ANA,salud sexual y reproductiva,hemorragia de la primera mitad del embarazo (< 22 sem) aborto,2015-01-01,4,0,4
70101,SANTA CRUZ DE LA SIERRA,salud sexual y reproductiva,hemorragia de la primera mitad del embarazo (< 22 sem) aborto,2015-01-01,407,97,504
20902,SAPAHAQUI,salud sexual y reproductiva,hemorragia de la primera mitad del embarazo (< 22 sem) aborto,2015-01-01,1,0,1
31602,SHINAOTA,salud sexual y reproductiva,hemorragia de la primera mitad del embarazo (< 22 sem) aborto,2015-01-01,11,1,12
21301,SICA SICA (VILLA AROMA),salud sexual y reproductiva,hemorragia de la primera mitad del embarazo (< 22 sem) aborto,2015-01-01,1,0,1
10101,SUCRE,salud sexual y reproductiva,hemorragia de la primera mitad del embarazo (< 22 sem) aborto,2015-01-01,91,8,99
60101,TARIJA,salud sexual y reproductiva,hemorragia de la primera mitad del embarazo (< 22 sem) aborto,2015-01-01,16,44,60
20803,TIAWANACU,salud sexual y reproductiva,hemorragia de la primera mitad del embarazo (< 22 sem) aborto,2015-01-01,0,1,1
31601,TIRAQUE (CBBA),salud sexual y reproductiva,hemorragia de la primera mitad del embarazo (< 22 sem) aborto,2015-01-01,2,0,2
31201,TOTORA(CBBA),salud sexual y reproductiva,hemorragia de la primera mitad del embarazo (< 22 sem) aborto,2015-01-01,3,0,3
70802,TRIGAL,salud sexual y reproductiva,hemorragia de la primera mitad del embarazo (< 22 sem) aborto,2015-01-01,0,1,1
80101,TRINIDAD,salud sexual y reproductiva,hemorragia de la primera mitad del embarazo (< 22 sem) aborto,2015-01-01,5,11,16
50801,TUPIZA,salud sexual y reproductiva,hemorragia de la primera mitad del embarazo (< 22 sem) aborto,2015-01-01,9,1,10
50201,UNCIA,salud sexual y reproductiva,hemorragia de la primera mitad del embarazo (< 22 sem) aborto,2015-01-01,0,4,4
51201,UYUNI,salud sexual y reproductiva,hemorragia de la primera mitad del embarazo (< 22 sem) aborto,2015-01-01,0,6,6
30502,VACAS,salud sexual y reproductiva,hemorragia de la primera mitad del embarazo (< 22 sem) aborto,2015-01-01,1,0,1
70801,VALLEGRANDE,salud sexual y reproductiva,hemorragia de la primera mitad del embarazo (< 22 sem) aborto,2015-01-01,1,0,1
20801,VIACHA,salud sexual y reproductiva,hemorragia de la primera mitad del embarazo (< 22 sem) aborto,2015-01-01,1,0,1
10704,VILLA CHARCAS,salud sexual y reproductiva,hemorragia de la primera mitad del embarazo (< 22 sem) aborto,2015-01-01,1,1,2
31003,VILLA TUNARI,salud sexual y reproductiva,hemorragia de la primera mitad del embarazo (< 22 sem) aborto,2015-01-01,34,0,34
51501,VILLAZON,salud sexual y reproductiva,hemorragia de la primera mitad del embarazo (< 22 sem) aborto,2015-01-01,3,4,7
70201,WARNES,salud sexual y reproductiva,hemorragia de la primera mitad del embarazo (< 22 sem) aborto,2015-01-01,20,0,20
60301,YACUIBA,salud sexual y reproductiva,hemorragia de la primera mitad del embarazo (< 22 sem) aborto,2015-01-01,1,9,10
10301,ZUDAÃ‘EZ,salud sexual y reproductiva,hemorragia de la primera mitad del embarazo (< 22 sem) aborto,2015-01-01,1,0,1
30201,AIQUILE,salud sexual y reproductiva,hemorragia de la primera mitad del embarazo (< 22 sem) aborto,2015-02-01,4,0,4
30501,ARANI,salud sexual y reproductiva,hemorragia de la primera mitad del embarazo (< 22 sem) aborto,2015-02-01,1,0,1
71501,ASCENCION DE GUARAYOS,salud sexual y reproductiva,hemorragia de la primera mitad del embarazo (< 22 sem) aborto,2015-02-01,14,0,14
21203,BATALLAS,salud sexual y reproductiva,hemorragia de la primera mitad del embarazo (< 22 sem) aborto,2015-02-01,2,0,2
50104,BELEN DE URMIRI,salud sexual y reproductiva,hemorragia de la primera mitad del embarazo (< 22 sem) aborto,2015-02-01,0,1,1
50301,BETANZOS,salud sexual y reproductiva,hemorragia de la primera mitad del embarazo (< 22 sem) aborto,2015-02-01,2,1,3
70707,BOYUIBE,salud sexual y reproductiva,hemorragia de la primera mitad del embarazo (< 22 sem) aborto,2015-02-01,1,0,1
10701,CAMARGO,salud sexual y reproductiva,hemorragia de la primera mitad del embarazo (< 22 sem) aborto,2015-02-01,4,0,4
70706,CAMIRI,salud sexual y reproductiva,hemorragia de la primera mitad del embarazo (< 22 sem) aborto,2015-02-01,8,0,8
30701,CAPINOTA,salud sexual y reproductiva,hemorragia de la primera mitad del embarazo (< 22 sem) aborto,2015-02-01,1,0,1
40102,CARACOLLO,salud sexual y reproductiva,hemorragia de la primera mitad del embarazo (< 22 sem) aborto,2015-02-01,3,0,3
60302,CARAPARI,salud sexual y reproductiva,hemorragia de la primera mitad del embarazo (< 22 sem) aborto,2015-02-01,2,0,2
50302,CHAQUI,salud sexual y reproductiva,hemorragia de la primera mitad del embarazo (< 22 sem) aborto,2015-02-01,0,2,2
70702,CHARAGUA,salud sexual y reproductiva,hemorragia de la primera mitad del embarazo (< 22 sem) aborto,2015-02-01,5,0,5
50202,CHAYANTA,salud sexual y reproductiva,hemorragia de la primera mitad del embarazo (< 22 sem) aborto,2015-02-01,0,1,1
21101,CHULUMANI (V. DE LA LIBERTAD),salud sexual y reproductiva,hemorragia de la primera mitad del embarazo (< 22 sem) aborto,2015-02-01,2,0,2
30801,CLIZA,salud sexual y reproductiva,hemorragia de la primera mitad del embarazo (< 22 sem) aborto,2015-02-01,8,0,8
90101,COBIJA,salud sexual y reproductiva,hemorragia de la primera mitad del embarazo (< 22 sem) aborto,2015-02-01,23,0,23
30303,COCAPATA,salud sexual y reproductiva,hemorragia de la primera mitad del embarazo (< 22 sem) aborto,2015-02-01,1,0,1
30101,COCHABAMBA,salud sexual y reproductiva,hemorragia de la primera mitad del embarazo (< 22 sem) aborto,2015-02-01,150,3,153
30905,COLCAPIRHUA,salud sexual y reproductiva,hemorragia de la primera mitad del embarazo (< 22 sem) aborto,2015-02-01,1,3,4
31002,COLOMI,salud sexual y reproductiva,hemorragia de la primera mitad del embarazo (< 22 sem) aborto,2015-02-01,1,0,1
50401,COLQUECHACA,salud sexual y reproductiva,hemorragia de la primera mitad del embarazo (< 22 sem) aborto,2015-02-01,0,1,1
71301,COMARAPA,salud sexual y reproductiva,hemorragia de la primera mitad del embarazo (< 22 sem) aborto,2015-02-01,5,1,6
71101,CONCEPCION,salud sexual y reproductiva,hemorragia de la primera mitad del embarazo (< 22 sem) aborto,2015-02-01,2,0,2
70102,COTOCA,salud sexual y reproductiva,hemorragia de la primera mitad del embarazo (< 22 sem) aborto,2015-02-01,1,0,1
71106,CUATRO CAÃ‘ADAS,salud sexual y reproductiva,hemorragia de la primera mitad del embarazo (< 22 sem) aborto,2015-02-01,1,0,1
10902,CULPINA,salud sexual y reproductiva,hemorragia de la primera mitad del embarazo (< 22 sem) aborto,2015-02-01,0,1,1
20105,EL ALTO,salud sexual y reproductiva,hemorragia de la primera mitad del embarazo (< 22 sem) aborto,2015-02-01,85,12,97
71503,EL PUENTE(STC),salud sexual y reproductiva,hemorragia de la primera mitad del embarazo (< 22 sem) aborto,2015-02-01,2,0,2
70105,EL TORNO,salud sexual y reproductiva,hemorragia de la primera mitad del embarazo (< 22 sem) aborto,2015-02-01,9,1,10
60601,ENTRE RIOS TRJ,salud sexual y reproductiva,hemorragia de la primera mitad del embarazo (< 22 sem) aborto,2015-02-01,1,0,1
31206,ENTRE RIOS CBBA,salud sexual y reproductiva,hemorragia de la primera mitad del embarazo (< 22 sem) aborto,2015-02-01,3,0,3
80202,GUAYARAMERIN,salud sexual y reproductiva,hemorragia de la primera mitad del embarazo (< 22 sem) aborto,2015-02-01,2,0,2
40701,HUANUNI,salud sexual y reproductiva,hemorragia de la primera mitad del embarazo (< 22 sem) aborto,2015-02-01,2,0,2
21105,LA ASUNTA,salud sexual y reproductiva,hemorragia de la primera mitad del embarazo (< 22 sem) aborto,2015-02-01,2,0,2
70104,LA GUARDIA,salud sexual y reproductiva,hemorragia de la primera mitad del embarazo (< 22 sem) aborto,2015-02-01,1,10,11
20101,LA PAZ,salud sexual y reproductiva,hemorragia de la primera mitad del embarazo (< 22 sem) aborto,2015-02-01,72,15,87
80801,MAGDALENA,salud sexual y reproductiva,hemorragia de la primera mitad del embarazo (< 22 sem) aborto,2015-02-01,0,1,1
70903,MAIRANA,salud sexual y reproductiva,hemorragia de la primera mitad del embarazo (< 22 sem) aborto,2015-02-01,5,0,5
20607,MAPIRI,salud sexual y reproductiva,hemorragia de la primera mitad del embarazo (< 22 sem) aborto,2015-02-01,2,0,2
71003,MINEROS,salud sexual y reproductiva,hemorragia de la primera mitad del embarazo (< 22 sem) aborto,2015-02-01,1,0,1
31301,MIZQUE,salud sexual y reproductiva,hemorragia de la primera mitad del embarazo (< 22 sem) aborto,2015-02-01,1,0,1
10303,MOJOCOYA,salud sexual y reproductiva,hemorragia de la primera mitad del embarazo (< 22 sem) aborto,2015-02-01,0,1,1
10501,MONTEAGUDO,salud sexual y reproductiva,hemorragia de la primera mitad del embarazo (< 22 sem) aborto,2015-02-01,2,0,2
71001,MONTERO,salud sexual y reproductiva,hemorragia de la primera mitad del embarazo (< 22 sem) aborto,2015-02-01,40,0,40
40101,ORURO,salud sexual y reproductiva,hemorragia de la primera mitad del embarazo (< 22 sem) aborto,2015-02-01,15,2,17
10401,PADILLA,salud sexual y reproductiva,hemorragia de la primera mitad del embarazo (< 22 sem) aborto,2015-02-01,4,0,4
70502,PAILON,salud sexual y reproductiva,hemorragia de la primera mitad del embarazo (< 22 sem) aborto,2015-02-01,6,0,6
70902,PAMPA GRANDE,salud sexual y reproductiva,hemorragia de la primera mitad del embarazo (< 22 sem) aborto,2015-02-01,0,2,2
50403,POCOATA,salud sexual y reproductiva,hemorragia de la primera mitad del embarazo (< 22 sem) aborto,2015-02-01,1,0,1
31203,POCONA,salud sexual y reproductiva,hemorragia de la primera mitad del embarazo (< 22 sem) aborto,2015-02-01,0,1,1
70601,PORTACHUELO,salud sexual y reproductiva,hemorragia de la primera mitad del embarazo (< 22 sem) aborto,2015-02-01,6,0,6
50101,POTOSI,salud sexual y reproductiva,hemorragia de la primera mitad del embarazo (< 22 sem) aborto,2015-02-01,17,4,21
10302,PRESTO,salud sexual y reproductiva,hemorragia de la primera mitad del embarazo (< 22 sem) aborto,2015-02-01,0,1,1
90301,PUERTO GONZALO MORENO,salud sexual y reproductiva,hemorragia de la primera mitad del embarazo (< 22 sem) aborto,2015-02-01,0,1,1
71401,PUERTO SUAREZ,salud sexual y reproductiva,hemorragia de la primera mitad del embarazo (< 22 sem) aborto,2015-02-01,3,3,6
31205,PUERTO VILLARROEL,salud sexual y reproductiva,hemorragia de la primera mitad del embarazo (< 22 sem) aborto,2015-02-01,8,0,8
31401,PUNATA,salud sexual y reproductiva,hemorragia de la primera mitad del embarazo (< 22 sem) aborto,2015-02-01,13,1,14
30901,QUILLACOLLO,salud sexual y reproductiva,hemorragia de la primera mitad del embarazo (< 22 sem) aborto,2015-02-01,0,60,60
21002,QUIME,salud sexual y reproductiva,hemorragia de la primera mitad del embarazo (< 22 sem) aborto,2015-02-01,0,1,1
50402,RAVELO,salud sexual y reproductiva,hemorragia de la primera mitad del embarazo (< 22 sem) aborto,2015-02-01,4,0,4
80301,REYES,salud sexual y reproductiva,hemorragia de la primera mitad del embarazo (< 22 sem) aborto,2015-02-01,8,0,8
80201,RIBERALTA,salud sexual y reproductiva,hemorragia de la primera mitad del embarazo (< 22 sem) aborto,2015-02-01,40,0,40
80304,RURRENABAQUE,salud sexual y reproductiva,hemorragia de la primera mitad del embarazo (< 22 sem) aborto,2015-02-01,13,0,13
31001,SACABA,salud sexual y reproductiva,hemorragia de la primera mitad del embarazo (< 22 sem) aborto,2015-02-01,51,0,51
30404,SACABAMBA,salud sexual y reproductiva,hemorragia de la primera mitad del embarazo (< 22 sem) aborto,2015-02-01,2,0,2
40801,SALINAS DE GARCI MENDOZA,salud sexual y reproductiva,hemorragia de la primera mitad del embarazo (< 22 sem) aborto,2015-02-01,1,2,3
70901,SAMAIPATA,salud sexual y reproductiva,hemorragia de la primera mitad del embarazo (< 22 sem) aborto,2015-02-01,2,0,2
20805,SAN ANDRES DE MACHACA,salud sexual y reproductiva,hemorragia de la primera mitad del embarazo (< 22 sem) aborto,2015-02-01,0,2,2
31403,SAN BENITO,salud sexual y reproductiva,hemorragia de la primera mitad del embarazo (< 22 sem) aborto,2015-02-01,1,0,1
80302,SAN BORJA,salud sexual y reproductiva,hemorragia de la primera mitad del embarazo (< 22 sem) aborto,2015-02-01,19,0,19
70402,SAN CARLOS,salud sexual y reproductiva,hemorragia de la primera mitad del embarazo (< 22 sem) aborto,2015-02-01,2,3,5
80501,SAN IGNACIO,salud sexual y reproductiva,hemorragia de la primera mitad del embarazo (< 22 sem) aborto,2015-02-01,2,0,2
70301,SAN IGNACIO DE VELASCO,salud sexual y reproductiva,hemorragia de la primera mitad del embarazo (< 22 sem) aborto,2015-02-01,18,0,18
71102,SAN JAVIER(STC),salud sexual y reproductiva,hemorragia de la primera mitad del embarazo (< 22 sem) aborto,2015-02-01,2,0,2
70404,SAN JUAN DE YAPACANI,salud sexual y reproductiva,hemorragia de la primera mitad del embarazo (< 22 sem) aborto,2015-02-01,1,0,1
71104,SAN JULIAN,salud sexual y reproductiva,hemorragia de la primera mitad del embarazo (< 22 sem) aborto,2015-02-01,25,2,27
10702,SAN LUCAS,salud sexual y reproductiva,hemorragia de la primera mitad del embarazo (< 22 sem) aborto,2015-02-01,2,0,2
71201,SAN MATIAS,salud sexual y reproductiva,hemorragia de la primera mitad del embarazo (< 22 sem) aborto,2015-02-01,2,0,2
70302,SAN MIGUEL DE VELASCO,salud sexual y reproductiva,hemorragia de la primera mitad del embarazo (< 22 sem) aborto,2015-02-01,3,0,3
50501,SAN PEDRO DE BUENA VISTA,salud sexual y reproductiva,hemorragia de la primera mitad del embarazo (< 22 sem) aborto,2015-02-01,1,0,1
80401,SANTA ANA,salud sexual y reproductiva,hemorragia de la primera mitad del embarazo (< 22 sem) aborto,2015-02-01,11,0,11
70101,SANTA CRUZ DE LA SIERRA,salud sexual y reproductiva,hemorragia de la primera mitad del embarazo (< 22 sem) aborto,2015-02-01,372,118,490
70602,SANTA ROSA DEL SARA,salud sexual y reproductiva,hemorragia de la primera mitad del embarazo (< 22 sem) aborto,2015-02-01,1,0,1
20902,SAPAHAQUI,salud sexual y reproductiva,hemorragia de la primera mitad del embarazo (< 22 sem) aborto,2015-02-01,1,0,1
31602,SHINAOTA,salud sexual y reproductiva,hemorragia de la primera mitad del embarazo (< 22 sem) aborto,2015-02-01,7,1,8
21301,SICA SICA (VILLA AROMA),salud sexual y reproductiva,hemorragia de la primera mitad del embarazo (< 22 sem) aborto,2015-02-01,0,1,1
10403,SOPACHUY,salud sexual y reproductiva,hemorragia de la primera mitad del embarazo (< 22 sem) aborto,2015-02-01,1,0,1
10101,SUCRE,salud sexual y reproductiva,hemorragia de la primera mitad del embarazo (< 22 sem) aborto,2015-02-01,98,2,100
10601,TARABUCO,salud sexual y reproductiva,hemorragia de la primera mitad del embarazo (< 22 sem) aborto,2015-02-01,4,0,4
60101,TARIJA,salud sexual y reproductiva,hemorragia de la primera mitad del embarazo (< 22 sem) aborto,2015-02-01,32,49,81
10202,TARVITA,salud sexual y reproductiva,hemorragia de la primera mitad del embarazo (< 22 sem) aborto,2015-02-01,1,1,2
20803,TIAWANACU,salud sexual y reproductiva,hemorragia de la primera mitad del embarazo (< 22 sem) aborto,2015-02-01,0,1,1
30903,TIQUIPAYA,salud sexual y reproductiva,hemorragia de la primera mitad del embarazo (< 22 sem) aborto,2015-02-01,2,2,4
31601,TIRAQUE (CBBA),salud sexual y reproductiva,hemorragia de la primera mitad del embarazo (< 22 sem) aborto,2015-02-01,2,0,2
30803,TOLATA,salud sexual y reproductiva,hemorragia de la primera mitad del embarazo (< 22 sem) aborto,2015-02-01,3,0,3
10402,TOMINA,salud sexual y reproductiva,hemorragia de la primera mitad del embarazo (< 22 sem) aborto,2015-02-01,1,0,1
31201,TOTORA(CBBA),salud sexual y reproductiva,hemorragia de la primera mitad del embarazo (< 22 sem) aborto,2015-02-01,1,0,1
41301,TOTORA(ORR),salud sexual y reproductiva,hemorragia de la primera mitad del embarazo (< 22 sem) aborto,2015-02-01,0,1,1
80101,TRINIDAD,salud sexual y reproductiva,hemorragia de la primera mitad del embarazo (< 22 sem) aborto,2015-02-01,22,6,28
50801,TUPIZA,salud sexual y reproductiva,hemorragia de la primera mitad del embarazo (< 22 sem) aborto,2015-02-01,10,0,10
50201,UNCIA,salud sexual y reproductiva,hemorragia de la primera mitad del embarazo (< 22 sem) aborto,2015-02-01,0,1,1
60401,URIONDO (A. CONCEPCION),salud sexual y reproductiva,hemorragia de la primera mitad del embarazo (< 22 sem) aborto,2015-02-01,0,1,1
51201,UYUNI,salud sexual y reproductiva,hemorragia de la primera mitad del embarazo (< 22 sem) aborto,2015-02-01,5,1,6
11001,VILLA VACA GUZMAN (MUYUPAMPA),salud sexual y reproductiva,hemorragia de la primera mitad del embarazo (< 22 sem) aborto,2015-02-01,0,1,1
51501,VILLAZON,salud sexual y reproductiva,hemorragia de la primera mitad del embarazo (< 22 sem) aborto,2015-02-01,12,10,22
30904,VINTO,salud sexual y reproductiva,hemorragia de la primera mitad del embarazo (< 22 sem) aborto,2015-02-01,0,2,2
70201,WARNES,salud sexual y reproductiva,hemorragia de la primera mitad del embarazo (< 22 sem) aborto,2015-02-01,5,0,5
20903,YACO,salud sexual y reproductiva,hemorragia de la primera mitad del embarazo (< 22 sem) aborto,2015-02-01,0,2,2
60301,YACUIBA,salud sexual y reproductiva,hemorragia de la primera mitad del embarazo (< 22 sem) aborto,2015-02-01,1,5,6
70403,YAPACANI,salud sexual y reproductiva,hemorragia de la primera mitad del embarazo (< 22 sem) aborto,2015-02-01,2,2,4
10102,YOTALA,salud sexual y reproductiva,hemorragia de la primera mitad del embarazo (< 22 sem) aborto,2015-02-01,1,0,1
10301,ZUDAÃ‘EZ,salud sexual y reproductiva,hemorragia de la primera mitad del embarazo (< 22 sem) aborto,2015-02-01,0,1,1
20201,ACHACACHI,salud sexual y reproductiva,hemorragia de la primera mitad del embarazo (< 22 sem) aborto,2015-03-01,1,0,1
30201,AIQUILE,salud sexual y reproductiva,hemorragia de la primera mitad del embarazo (< 22 sem) aborto,2015-03-01,7,0,7
40603,ANTEQUERA,salud sexual y reproductiva,hemorragia de la primera mitad del embarazo (< 22 sem) aborto,2015-03-01,1,0,1
30601,ARQUE,salud sexual y reproductiva,hemorragia de la primera mitad del embarazo (< 22 sem) aborto,2015-03-01,0,1,1
71501,ASCENCION DE GUARAYOS,salud sexual y reproductiva,hemorragia de la primera mitad del embarazo (< 22 sem) aborto,2015-03-01,7,0,7
30301,AYOPAYA (V. DE INDEPENDENCIA),salud sexual y reproductiva,hemorragia de la primera mitad del embarazo (< 22 sem) aborto,2015-03-01,2,3,5
50301,BETANZOS,salud sexual y reproductiva,hemorragia de la primera mitad del embarazo (< 22 sem) aborto,2015-03-01,5,1,6
51102,"CAIZA ""D""",salud sexual y reproductiva,hemorragia de la primera mitad del embarazo (< 22 sem) aborto,2015-03-01,0,1,1
21304,CALAMARCA,salud sexual y reproductiva,hemorragia de la primera mitad del embarazo (< 22 sem) aborto,2015-03-01,1,0,1
10701,CAMARGO,salud sexual y reproductiva,hemorragia de la primera mitad del embarazo (< 22 sem) aborto,2015-03-01,2,0,2
70706,CAMIRI,salud sexual y reproductiva,hemorragia de la primera mitad del embarazo (< 22 sem) aborto,2015-03-01,14,0,14
30701,CAPINOTA,salud sexual y reproductiva,hemorragia de la primera mitad del embarazo (< 22 sem) aborto,2015-03-01,4,0,4
40102,CARACOLLO,salud sexual y reproductiva,hemorragia de la primera mitad del embarazo (< 22 sem) aborto,2015-03-01,8,0,8
22001,CARANAVI,salud sexual y reproductiva,hemorragia de la primera mitad del embarazo (< 22 sem) aborto,2015-03-01,6,4,10
70702,CHARAGUA,salud sexual y reproductiva,hemorragia de la primera mitad del embarazo (< 22 sem) aborto,2015-03-01,5,0,5
31204,CHIMORE,salud sexual y reproductiva,hemorragia de la primera mitad del embarazo (< 22 sem) aborto,2015-03-01,1,0,1
50204,CHUQUIHUTA AYLLU JUCUMANI,salud sexual y reproductiva,hemorragia de la primera mitad del embarazo (< 22 sem) aborto,2015-03-01,2,1,3
30801,CLIZA,salud sexual y reproductiva,hemorragia de la primera mitad del embarazo (< 22 sem) aborto,2015-03-01,4,0,4
90101,COBIJA,salud sexual y reproductiva,hemorragia de la primera mitad del embarazo (< 22 sem) aborto,2015-03-01,53,0,53
30101,COCHABAMBA,salud sexual y reproductiva,hemorragia de la primera mitad del embarazo (< 22 sem) aborto,2015-03-01,217,1,218
50901,"COLCHA ""K""",salud sexual y reproductiva,hemorragia de la primera mitad del embarazo (< 22 sem) aborto,2015-03-01,0,2,2
31002,COLOMI,salud sexual y reproductiva,hemorragia de la primera mitad del embarazo (< 22 sem) aborto,2015-03-01,3,1,4
50401,COLQUECHACA,salud sexual y reproductiva,hemorragia de la primera mitad del embarazo (< 22 sem) aborto,2015-03-01,0,5,5
71301,COMARAPA,salud sexual y reproductiva,hemorragia de la primera mitad del embarazo (< 22 sem) aborto,2015-03-01,3,4,7
71101,CONCEPCION,salud sexual y reproductiva,hemorragia de la primera mitad del embarazo (< 22 sem) aborto,2015-03-01,4,0,4
71106,CUATRO CAÃ‘ADAS,salud sexual y reproductiva,hemorragia de la primera mitad del embarazo (< 22 sem) aborto,2015-03-01,1,0,1
10902,CULPINA,salud sexual y reproductiva,hemorragia de la primera mitad del embarazo (< 22 sem) aborto,2015-03-01,1,0,1
20105,EL ALTO,salud sexual y reproductiva,hemorragia de la primera mitad del embarazo (< 22 sem) aborto,2015-03-01,133,14,147
71503,EL PUENTE(STC),salud sexual y reproductiva,hemorragia de la primera mitad del embarazo (< 22 sem) aborto,2015-03-01,2,0,2
70105,EL TORNO,salud sexual y reproductiva,hemorragia de la primera mitad del embarazo (< 22 sem) aborto,2015-03-01,18,0,18
20405,ESCOMA,salud sexual y reproductiva,hemorragia de la primera mitad del embarazo (< 22 sem) aborto,2015-03-01,0,1,1
80202,GUAYARAMERIN,salud sexual y reproductiva,hemorragia de la primera mitad del embarazo (< 22 sem) aborto,2015-03-01,2,0,2
40701,HUANUNI,salud sexual y reproductiva,hemorragia de la primera mitad del embarazo (< 22 sem) aborto,2015-03-01,5,0,5
10703,INCAHUASI,salud sexual y reproductiva,hemorragia de la primera mitad del embarazo (< 22 sem) aborto,2015-03-01,1,0,1
21105,LA ASUNTA,salud sexual y reproductiva,hemorragia de la primera mitad del embarazo (< 22 sem) aborto,2015-03-01,15,1,16
70104,LA GUARDIA,salud sexual y reproductiva,hemorragia de la primera mitad del embarazo (< 22 sem) aborto,2015-03-01,0,10,10
20101,LA PAZ,salud sexual y reproductiva,hemorragia de la primera mitad del embarazo (< 22 sem) aborto,2015-03-01,107,27,134
80801,MAGDALENA,salud sexual y reproductiva,hemorragia de la primera mitad del embarazo (< 22 sem) aborto,2015-03-01,0,1,1
70903,MAIRANA,salud sexual y reproductiva,hemorragia de la primera mitad del embarazo (< 22 sem) aborto,2015-03-01,5,0,5
31301,MIZQUE,salud sexual y reproductiva,hemorragia de la primera mitad del embarazo (< 22 sem) aborto,2015-03-01,6,0,6
10501,MONTEAGUDO,salud sexual y reproductiva,hemorragia de la primera mitad del embarazo (< 22 sem) aborto,2015-03-01,5,0,5
71001,MONTERO,salud sexual y reproductiva,hemorragia de la primera mitad del embarazo (< 22 sem) aborto,2015-03-01,53,4,57
30302,MOROCHATA,salud sexual y reproductiva,hemorragia de la primera mitad del embarazo (< 22 sem) aborto,2015-03-01,1,0,1
40101,ORURO,salud sexual y reproductiva,hemorragia de la primera mitad del embarazo (< 22 sem) aborto,2015-03-01,30,2,32
10401,PADILLA,salud sexual y reproductiva,hemorragia de la primera mitad del embarazo (< 22 sem) aborto,2015-03-01,3,0,3
70502,PAILON,salud sexual y reproductiva,hemorragia de la primera mitad del embarazo (< 22 sem) aborto,2015-03-01,3,0,3
70902,PAMPA GRANDE,salud sexual y reproductiva,hemorragia de la primera mitad del embarazo (< 22 sem) aborto,2015-03-01,1,2,3
50403,POCOATA,salud sexual y reproductiva,hemorragia de la primera mitad del embarazo (< 22 sem) aborto,2015-03-01,1,0,1
70601,PORTACHUELO,salud sexual y reproductiva,hemorragia de la primera mitad del embarazo (< 22 sem) aborto,2015-03-01,0,1,1
50101,POTOSI,salud sexual y reproductiva,hemorragia de la primera mitad del embarazo (< 22 sem) aborto,2015-03-01,26,11,37
21201,PUCARANI,salud sexual y reproductiva,hemorragia de la primera mitad del embarazo (< 22 sem) aborto,2015-03-01,0,1,1
90201,PUERTO RICO,salud sexual y reproductiva,hemorragia de la primera mitad del embarazo (< 22 sem) aborto,2015-03-01,1,0,1
71401,PUERTO SUAREZ,salud sexual y reproductiva,hemorragia de la primera mitad del embarazo (< 22 sem) aborto,2015-03-01,4,0,4
51101,PUNA,salud sexual y reproductiva,hemorragia de la primera mitad del embarazo (< 22 sem) aborto,2015-03-01,0,1,1
31401,PUNATA,salud sexual y reproductiva,hemorragia de la primera mitad del embarazo (< 22 sem) aborto,2015-03-01,13,0,13
80301,REYES,salud sexual y reproductiva,hemorragia de la primera mitad del embarazo (< 22 sem) aborto,2015-03-01,6,0,6
80201,RIBERALTA,salud sexual y reproductiva,hemorragia de la primera mitad del embarazo (< 22 sem) aborto,2015-03-01,46,0,46
70503,ROBORE,salud sexual y reproductiva,hemorragia de la primera mitad del embarazo (< 22 sem) aborto,2015-03-01,5,0,5
80304,RURRENABAQUE,salud sexual y reproductiva,hemorragia de la primera mitad del embarazo (< 22 sem) aborto,2015-03-01,7,0,7
40901,SABAYA,salud sexual y reproductiva,hemorragia de la primera mitad del embarazo (< 22 sem) aborto,2015-03-01,1,0,1
31001,SACABA,salud sexual y reproductiva,hemorragia de la primera mitad del embarazo (< 22 sem) aborto,2015-03-01,11,44,55
30404,SACABAMBA,salud sexual y reproductiva,hemorragia de la primera mitad del embarazo (< 22 sem) aborto,2015-03-01,2,0,2
40801,SALINAS DE GARCI MENDOZA,salud sexual y reproductiva,hemorragia de la primera mitad del embarazo (< 22 sem) aborto,2015-03-01,0,3,3
70901,SAMAIPATA,salud sexual y reproductiva,hemorragia de la primera mitad del embarazo (< 22 sem) aborto,2015-03-01,2,0,2
80302,SAN BORJA,salud sexual y reproductiva,hemorragia de la primera mitad del embarazo (< 22 sem) aborto,2015-03-01,10,0,10
70402,SAN CARLOS,salud sexual y reproductiva,hemorragia de la primera mitad del embarazo (< 22 sem) aborto,2015-03-01,3,15,18
80501,SAN IGNACIO,salud sexual y reproductiva,hemorragia de la primera mitad del embarazo (< 22 sem) aborto,2015-03-01,8,1,9
70301,SAN IGNACIO DE VELASCO,salud sexual y reproductiva,hemorragia de la primera mitad del embarazo (< 22 sem) aborto,2015-03-01,22,0,22
71102,SAN JAVIER(STC),salud sexual y reproductiva,hemorragia de la primera mitad del embarazo (< 22 sem) aborto,2015-03-01,4,0,4
70404,SAN JUAN DE YAPACANI,salud sexual y reproductiva,hemorragia de la primera mitad del embarazo (< 22 sem) aborto,2015-03-01,1,0,1
71104,SAN JULIAN,salud sexual y reproductiva,hemorragia de la primera mitad del embarazo (< 22 sem) aborto,2015-03-01,36,0,36
90302,SAN LORENZO(PND),salud sexual y reproductiva,hemorragia de la primera mitad del embarazo (< 22 sem) aborto,2015-03-01,0,1,1
10702,SAN LUCAS,salud sexual y reproductiva,hemorragia de la primera mitad del embarazo (< 22 sem) aborto,2015-03-01,1,1,2
70302,SAN MIGUEL DE VELASCO,salud sexual y reproductiva,hemorragia de la primera mitad del embarazo (< 22 sem) aborto,2015-03-01,1,0,1
50501,SAN PEDRO DE BUENA VISTA,salud sexual y reproductiva,hemorragia de la primera mitad del embarazo (< 22 sem) aborto,2015-03-01,0,1,1
80401,SANTA ANA,salud sexual y reproductiva,hemorragia de la primera mitad del embarazo (< 22 sem) aborto,2015-03-01,6,0,6
70101,SANTA CRUZ DE LA SIERRA,salud sexual y reproductiva,hemorragia de la primera mitad del embarazo (< 22 sem) aborto,2015-03-01,429,112,541
21901,SANTIAGO DE MACHACA,salud sexual y reproductiva,hemorragia de la primera mitad del embarazo (< 22 sem) aborto,2015-03-01,1,0,1
20902,SAPAHAQUI,salud sexual y reproductiva,hemorragia de la primera mitad del embarazo (< 22 sem) aborto,2015-03-01,2,0,2
90303,SENA,salud sexual y reproductiva,hemorragia de la primera mitad del embarazo (< 22 sem) aborto,2015-03-01,1,0,1
31602,SHINAOTA,salud sexual y reproductiva,hemorragia de la primera mitad del embarazo (< 22 sem) aborto,2015-03-01,3,3,6
21301,SICA SICA (VILLA AROMA),salud sexual y reproductiva,hemorragia de la primera mitad del embarazo (< 22 sem) aborto,2015-03-01,0,1,1
10101,SUCRE,salud sexual y reproductiva,hemorragia de la primera mitad del embarazo (< 22 sem) aborto,2015-03-01,149,29,178
30602,TACOPAYA,salud sexual y reproductiva,hemorragia de la primera mitad del embarazo (< 22 sem) aborto,2015-03-01,0,1,1
10601,TARABUCO,salud sexual y reproductiva,hemorragia de la primera mitad del embarazo (< 22 sem) aborto,2015-03-01,6,0,6
20807,TARACO,salud sexual y reproductiva,hemorragia de la primera mitad del embarazo (< 22 sem) aborto,2015-03-01,2,0,2
60101,TARIJA,salud sexual y reproductiva,hemorragia de la primera mitad del embarazo (< 22 sem) aborto,2015-03-01,14,16,30
10202,TARVITA,salud sexual y reproductiva,hemorragia de la primera mitad del embarazo (< 22 sem) aborto,2015-03-01,0,1,1
30903,TIQUIPAYA,salud sexual y reproductiva,hemorragia de la primera mitad del embarazo (< 22 sem) aborto,2015-03-01,1,0,1
31601,TIRAQUE (CBBA),salud sexual y reproductiva,hemorragia de la primera mitad del embarazo (< 22 sem) aborto,2015-03-01,3,0,3
30802,TOCO,salud sexual y reproductiva,hemorragia de la primera mitad del embarazo (< 22 sem) aborto,2015-03-01,1,0,1
30803,TOLATA,salud sexual y reproductiva,hemorragia de la primera mitad del embarazo (< 22 sem) aborto,2015-03-01,1,0,1
10402,TOMINA,salud sexual y reproductiva,hemorragia de la primera mitad del embarazo (< 22 sem) aborto,2015-03-01,2,0,2
41301,TOTORA(ORR),salud sexual y reproductiva,hemorragia de la primera mitad del embarazo (< 22 sem) aborto,2015-03-01,1,0,1
80101,TRINIDAD,salud sexual y reproductiva,hemorragia de la primera mitad del embarazo (< 22 sem) aborto,2015-03-01,78,7,85
50801,TUPIZA,salud sexual y reproductiva,hemorragia de la primera mitad del embarazo (< 22 sem) aborto,2015-03-01,8,0,8
50201,UNCIA,salud sexual y reproductiva,hemorragia de la primera mitad del embarazo (< 22 sem) aborto,2015-03-01,2,0,2
51201,UYUNI,salud sexual y reproductiva,hemorragia de la primera mitad del embarazo (< 22 sem) aborto,2015-03-01,0,1,1
10704,VILLA CHARCAS,salud sexual y reproductiva,hemorragia de la primera mitad del embarazo (< 22 sem) aborto,2015-03-01,0,1,1
31402,VILLA RIVERO,salud sexual y reproductiva,hemorragia de la primera mitad del embarazo (< 22 sem) aborto,2015-03-01,1,0,1
31003,VILLA TUNARI,salud sexual y reproductiva,hemorragia de la primera mitad del embarazo (< 22 sem) aborto,2015-03-01,0,3,3
51501,VILLAZON,salud sexual y reproductiva,hemorragia de la primera mitad del embarazo (< 22 sem) aborto,2015-03-01,5,20,25
70201,WARNES,salud sexual y reproductiva,hemorragia de la primera mitad del embarazo (< 22 sem) aborto,2015-03-01,34,0,34
60301,YACUIBA,salud sexual y reproductiva,hemorragia de la primera mitad del embarazo (< 22 sem) aborto,2015-03-01,2,6,8
21103,YANACACHI,salud sexual y reproductiva,hemorragia de la primera mitad del embarazo (< 22 sem) aborto,2015-03-01,1,0,1
70403,YAPACANI,salud sexual y reproductiva,hemorragia de la primera mitad del embarazo (< 22 sem) aborto,2015-03-01,4,7,11
10102,YOTALA,salud sexual y reproductiva,hemorragia de la primera mitad del embarazo (< 22 sem) aborto,2015-03-01,1,0,1
30201,AIQUILE,salud sexual y reproductiva,hemorragia de la primera mitad del embarazo (< 22 sem) aborto,2015-04-01,5,0,5
40603,ANTEQUERA,salud sexual y reproductiva,hemorragia de la primera mitad del embarazo (< 22 sem) aborto,2015-04-01,1,0,1
30501,ARANI,salud sexual y reproductiva,hemorragia de la primera mitad del embarazo (< 22 sem) aborto,2015-04-01,1,0,1
30601,ARQUE,salud sexual y reproductiva,hemorragia de la primera mitad del embarazo (< 22 sem) aborto,2015-04-01,0,2,2
71501,ASCENCION DE GUARAYOS,salud sexual y reproductiva,hemorragia de la primera mitad del embarazo (< 22 sem) aborto,2015-04-01,1,0,1
50802,ATOCHA,salud sexual y reproductiva,hemorragia de la primera mitad del embarazo (< 22 sem) aborto,2015-04-01,3,0,3
30301,AYOPAYA (V. DE INDEPENDENCIA),salud sexual y reproductiva,hemorragia de la primera mitad del embarazo (< 22 sem) aborto,2015-04-01,1,0,1
60202,BERMEJO,salud sexual y reproductiva,hemorragia de la primera mitad del embarazo (< 22 sem) aborto,2015-04-01,1,0,1
50301,BETANZOS,salud sexual y reproductiva,hemorragia de la primera mitad del embarazo (< 22 sem) aborto,2015-04-01,1,0,1
10701,CAMARGO,salud sexual y reproductiva,hemorragia de la primera mitad del embarazo (< 22 sem) aborto,2015-04-01,3,0,3
70706,CAMIRI,salud sexual y reproductiva,hemorragia de la primera mitad del embarazo (< 22 sem) aborto,2015-04-01,22,0,22
30701,CAPINOTA,salud sexual y reproductiva,hemorragia de la primera mitad del embarazo (< 22 sem) aborto,2015-04-01,1,0,1
40102,CARACOLLO,salud sexual y reproductiva,hemorragia de la primera mitad del embarazo (< 22 sem) aborto,2015-04-01,6,1,7
22001,CARANAVI,salud sexual y reproductiva,hemorragia de la primera mitad del embarazo (< 22 sem) aborto,2015-04-01,12,0,12
60302,CARAPARI,salud sexual y reproductiva,hemorragia de la primera mitad del embarazo (< 22 sem) aborto,2015-04-01,1,0,1
71403,CARMEN RIVERO TORREZ,salud sexual y reproductiva,hemorragia de la primera mitad del embarazo (< 22 sem) aborto,2015-04-01,1,0,1
50302,CHAQUI,salud sexual y reproductiva,hemorragia de la primera mitad del embarazo (< 22 sem) aborto,2015-04-01,0,1,1
70702,CHARAGUA,salud sexual y reproductiva,hemorragia de la primera mitad del embarazo (< 22 sem) aborto,2015-04-01,1,1,2
50204,CHUQUIHUTA AYLLU JUCUMANI,salud sexual y reproductiva,hemorragia de la primera mitad del embarazo (< 22 sem) aborto,2015-04-01,1,0,1
30801,CLIZA,salud sexual y reproductiva,hemorragia de la primera mitad del embarazo (< 22 sem) aborto,2015-04-01,6,0,6
90101,COBIJA,salud sexual y reproductiva,hemorragia de la primera mitad del embarazo (< 22 sem) aborto,2015-04-01,24,0,24
30101,COCHABAMBA,salud sexual y reproductiva,hemorragia de la primera mitad del embarazo (< 22 sem) aborto,2015-04-01,195,2,197
50901,"COLCHA ""K""",salud sexual y reproductiva,hemorragia de la primera mitad del embarazo (< 22 sem) aborto,2015-04-01,0,1,1
31002,COLOMI,salud sexual y reproductiva,hemorragia de la primera mitad del embarazo (< 22 sem) aborto,2015-04-01,4,0,4
50401,COLQUECHACA,salud sexual y reproductiva,hemorragia de la primera mitad del embarazo (< 22 sem) aborto,2015-04-01,0,4,4
21306,COLQUENCHA,salud sexual y reproductiva,hemorragia de la primera mitad del embarazo (< 22 sem) aborto,2015-04-01,0,1,1
71301,COMARAPA,salud sexual y reproductiva,hemorragia de la primera mitad del embarazo (< 22 sem) aborto,2015-04-01,3,0,3
71101,CONCEPCION,salud sexual y reproductiva,hemorragia de la primera mitad del embarazo (< 22 sem) aborto,2015-04-01,3,0,3
40301,CORQUE,salud sexual y reproductiva,hemorragia de la primera mitad del embarazo (< 22 sem) aborto,2015-04-01,0,1,1
71106,CUATRO CAÃ‘ADAS,salud sexual y reproductiva,hemorragia de la primera mitad del embarazo (< 22 sem) aborto,2015-04-01,12,0,12
20105,EL ALTO,salud sexual y reproductiva,hemorragia de la primera mitad del embarazo (< 22 sem) aborto,2015-04-01,86,8,94
71503,EL PUENTE(STC),salud sexual y reproductiva,hemorragia de la primera mitad del embarazo (< 22 sem) aborto,2015-04-01,1,0,1
70105,EL TORNO,salud sexual y reproductiva,hemorragia de la primera mitad del embarazo (< 22 sem) aborto,2015-04-01,14,0,14
31206,ENTRE RIOS CBBA,salud sexual y reproductiva,hemorragia de la primera mitad del embarazo (< 22 sem) aborto,2015-04-01,3,0,3
20802,GUAQUI,salud sexual y reproductiva,hemorragia de la primera mitad del embarazo (< 22 sem) aborto,2015-04-01,0,1,1
80202,GUAYARAMERIN,salud sexual y reproductiva,hemorragia de la primera mitad del embarazo (< 22 sem) aborto,2015-04-01,3,0,3
20101,LA PAZ,salud sexual y reproductiva,hemorragia de la primera mitad del embarazo (< 22 sem) aborto,2015-04-01,132,10,142
21202,LAJA,salud sexual y reproductiva,hemorragia de la primera mitad del embarazo (< 22 sem) aborto,2015-04-01,0,1,1
80801,MAGDALENA,salud sexual y reproductiva,hemorragia de la primera mitad del embarazo (< 22 sem) aborto,2015-04-01,0,1,1
70903,MAIRANA,salud sexual y reproductiva,hemorragia de la primera mitad del embarazo (< 22 sem) aborto,2015-04-01,5,0,5
31301,MIZQUE,salud sexual y reproductiva,hemorragia de la primera mitad del embarazo (< 22 sem) aborto,2015-04-01,1,0,1
10501,MONTEAGUDO,salud sexual y reproductiva,hemorragia de la primera mitad del embarazo (< 22 sem) aborto,2015-04-01,5,0,5
71001,MONTERO,salud sexual y reproductiva,hemorragia de la primera mitad del embarazo (< 22 sem) aborto,2015-04-01,21,1,22
40101,ORURO,salud sexual y reproductiva,hemorragia de la primera mitad del embarazo (< 22 sem) aborto,2015-04-01,6,0,6
10401,PADILLA,salud sexual y reproductiva,hemorragia de la primera mitad del embarazo (< 22 sem) aborto,2015-04-01,7,0,7
70502,PAILON,salud sexual y reproductiva,hemorragia de la primera mitad del embarazo (< 22 sem) aborto,2015-04-01,3,0,3
70902,PAMPA GRANDE,salud sexual y reproductiva,hemorragia de la primera mitad del embarazo (< 22 sem) aborto,2015-04-01,0,4,4
50403,POCOATA,salud sexual y reproductiva,hemorragia de la primera mitad del embarazo (< 22 sem) aborto,2015-04-01,3,0,3
31203,POCONA,salud sexual y reproductiva,hemorragia de la primera mitad del embarazo (< 22 sem) aborto,2015-04-01,1,0,1
40601,POOPO,salud sexual y reproductiva,hemorragia de la primera mitad del embarazo (< 22 sem) aborto,2015-04-01,1,0,1
70601,PORTACHUELO,salud sexual y reproductiva,hemorragia de la primera mitad del embarazo (< 22 sem) aborto,2015-04-01,5,0,5
50101,POTOSI,salud sexual y reproductiva,hemorragia de la primera mitad del embarazo (< 22 sem) aborto,2015-04-01,34,3,37
10302,PRESTO,salud sexual y reproductiva,hemorragia de la primera mitad del embarazo (< 22 sem) aborto,2015-04-01,0,1,1
20403,PUERTO CARABUCO,salud sexual y reproductiva,hemorragia de la primera mitad del embarazo (< 22 sem) aborto,2015-04-01,1,0,1
90301,PUERTO GONZALO MORENO,salud sexual y reproductiva,hemorragia de la primera mitad del embarazo (< 22 sem) aborto,2015-04-01,0,1,1
90201,PUERTO RICO,salud sexual y reproductiva,hemorragia de la primera mitad del embarazo (< 22 sem) aborto,2015-04-01,1,1,2
71401,PUERTO SUAREZ,salud sexual y reproductiva,hemorragia de la primera mitad del embarazo (< 22 sem) aborto,2015-04-01,8,0,8
31205,PUERTO VILLARROEL,salud sexual y reproductiva,hemorragia de la primera mitad del embarazo (< 22 sem) aborto,2015-04-01,0,9,9
50402,RAVELO,salud sexual y reproductiva,hemorragia de la primera mitad del embarazo (< 22 sem) aborto,2015-04-01,0,1,1
80301,REYES,salud sexual y reproductiva,hemorragia de la primera mitad del embarazo (< 22 sem) aborto,2015-04-01,6,0,6
80201,RIBERALTA,salud sexual y reproductiva,hemorragia de la primera mitad del embarazo (< 22 sem) aborto,2015-04-01,39,0,39
70503,ROBORE,salud sexual y reproductiva,hemorragia de la primera mitad del embarazo (< 22 sem) aborto,2015-04-01,1,0,1
80304,RURRENABAQUE,salud sexual y reproductiva,hemorragia de la primera mitad del embarazo (< 22 sem) aborto,2015-04-01,16,0,16
31001,SACABA,salud sexual y reproductiva,hemorragia de la primera mitad del embarazo (< 22 sem) aborto,2015-04-01,40,0,40
70901,SAMAIPATA,salud sexual y reproductiva,hemorragia de la primera mitad del embarazo (< 22 sem) aborto,2015-04-01,1,0,1
80302,SAN BORJA,salud sexual y reproductiva,hemorragia de la primera mitad del embarazo (< 22 sem) aborto,2015-04-01,12,1,13
70402,SAN CARLOS,salud sexual y reproductiva,hemorragia de la primera mitad del embarazo (< 22 sem) aborto,2015-04-01,0,3,3
80501,SAN IGNACIO,salud sexual y reproductiva,hemorragia de la primera mitad del embarazo (< 22 sem) aborto,2015-04-01,4,0,4
70301,SAN IGNACIO DE VELASCO,salud sexual y reproductiva,hemorragia de la primera mitad del embarazo (< 22 sem) aborto,2015-04-01,16,0,16
71102,SAN JAVIER(STC),salud sexual y reproductiva,hemorragia de la primera mitad del embarazo (< 22 sem) aborto,2015-04-01,4,0,4
70404,SAN JUAN DE YAPACANI,salud sexual y reproductiva,hemorragia de la primera mitad del embarazo (< 22 sem) aborto,2015-04-01,2,0,2
71104,SAN JULIAN,salud sexual y reproductiva,hemorragia de la primera mitad del embarazo (< 22 sem) aborto,2015-04-01,20,0,20
10702,SAN LUCAS,salud sexual y reproductiva,hemorragia de la primera mitad del embarazo (< 22 sem) aborto,2015-04-01,3,1,4
70302,SAN MIGUEL DE VELASCO,salud sexual y reproductiva,hemorragia de la primera mitad del embarazo (< 22 sem) aborto,2015-04-01,3,0,3
50501,SAN PEDRO DE BUENA VISTA,salud sexual y reproductiva,hemorragia de la primera mitad del embarazo (< 22 sem) aborto,2015-04-01,0,1,1
80702,SAN RAMON BENI,salud sexual y reproductiva,hemorragia de la primera mitad del embarazo (< 22 sem) aborto,2015-04-01,1,0,1
80401,SANTA ANA,salud sexual y reproductiva,hemorragia de la primera mitad del embarazo (< 22 sem) aborto,2015-04-01,2,0,2
70101,SANTA CRUZ DE LA SIERRA,salud sexual y reproductiva,hemorragia de la primera mitad del embarazo (< 22 sem) aborto,2015-04-01,348,58,406
70602,SANTA ROSA DEL SARA,salud sexual y reproductiva,hemorragia de la primera mitad del embarazo (< 22 sem) aborto,2015-04-01,2,0,2
30702,SANTIVAÃ‘ES,salud sexual y reproductiva,hemorragia de la primera mitad del embarazo (< 22 sem) aborto,2015-04-01,0,1,1
31602,SHINAOTA,salud sexual y reproductiva,hemorragia de la primera mitad del embarazo (< 22 sem) aborto,2015-04-01,6,0,6
21301,SICA SICA (VILLA AROMA),salud sexual y reproductiva,hemorragia de la primera mitad del embarazo (< 22 sem) aborto,2015-04-01,1,3,4
10101,SUCRE,salud sexual y reproductiva,hemorragia de la primera mitad del embarazo (< 22 sem) aborto,2015-04-01,103,10,113
31101,TAPACARI,salud sexual y reproductiva,hemorragia de la primera mitad del embarazo (< 22 sem) aborto,2015-04-01,1,0,1
10601,TARABUCO,salud sexual y reproductiva,hemorragia de la primera mitad del embarazo (< 22 sem) aborto,2015-04-01,5,0,5
20807,TARACO,salud sexual y reproductiva,hemorragia de la primera mitad del embarazo (< 22 sem) aborto,2015-04-01,0,2,2
60101,TARIJA,salud sexual y reproductiva,hemorragia de la primera mitad del embarazo (< 22 sem) aborto,2015-04-01,4,15,19
10202,TARVITA,salud sexual y reproductiva,hemorragia de la primera mitad del embarazo (< 22 sem) aborto,2015-04-01,1,0,1
20606,TIPUANI,salud sexual y reproductiva,hemorragia de la primera mitad del embarazo (< 22 sem) aborto,2015-04-01,0,1,1
30903,TIQUIPAYA,salud sexual y reproductiva,hemorragia de la primera mitad del embarazo (< 22 sem) aborto,2015-04-01,0,1,1
31601,TIRAQUE (CBBA),salud sexual y reproductiva,hemorragia de la primera mitad del embarazo (< 22 sem) aborto,2015-04-01,3,0,3
51202,TOMAVE,salud sexual y reproductiva,hemorragia de la primera mitad del embarazo (< 22 sem) aborto,2015-04-01,0,1,1
10402,TOMINA,salud sexual y reproductiva,hemorragia de la primera mitad del embarazo (< 22 sem) aborto,2015-04-01,1,0,1
80101,TRINIDAD,salud sexual y reproductiva,hemorragia de la primera mitad del embarazo (< 22 sem) aborto,2015-04-01,59,2,61
50801,TUPIZA,salud sexual y reproductiva,hemorragia de la primera mitad del embarazo (< 22 sem) aborto,2015-04-01,15,0,15
50201,UNCIA,salud sexual y reproductiva,hemorragia de la primera mitad del embarazo (< 22 sem) aborto,2015-04-01,0,1,1
60303,VILLA MONTES,salud sexual y reproductiva,hemorragia de la primera mitad del embarazo (< 22 sem) aborto,2015-04-01,0,2,2
31402,VILLA RIVERO,salud sexual y reproductiva,hemorragia de la primera mitad del embarazo (< 22 sem) aborto,2015-04-01,3,0,3
31003,VILLA TUNARI,salud sexual y reproductiva,hemorragia de la primera mitad del embarazo (< 22 sem) aborto,2015-04-01,9,0,9
11001,VILLA VACA GUZMAN (MUYUPAMPA),salud sexual y reproductiva,hemorragia de la primera mitad del embarazo (< 22 sem) aborto,2015-04-01,2,0,2
51501,VILLAZON,salud sexual y reproductiva,hemorragia de la primera mitad del embarazo (< 22 sem) aborto,2015-04-01,5,0,5
70201,WARNES,salud sexual y reproductiva,hemorragia de la primera mitad del embarazo (< 22 sem) aborto,2015-04-01,12,0,12
60301,YACUIBA,salud sexual y reproductiva,hemorragia de la primera mitad del embarazo (< 22 sem) aborto,2015-04-01,3,9,12
70403,YAPACANI,salud sexual y reproductiva,hemorragia de la primera mitad del embarazo (< 22 sem) aborto,2015-04-01,2,15,17
30201,AIQUILE,salud sexual y reproductiva,hemorragia de la primera mitad del embarazo (< 22 sem) aborto,2015-05-01,7,0,7
30501,ARANI,salud sexual y reproductiva,hemorragia de la primera mitad del embarazo (< 22 sem) aborto,2015-05-01,1,0,1
71501,ASCENCION DE GUARAYOS,salud sexual y reproductiva,hemorragia de la primera mitad del embarazo (< 22 sem) aborto,2015-05-01,1,1,2
80802,BAURES,salud sexual y reproductiva,hemorragia de la primera mitad del embarazo (< 22 sem) aborto,2015-05-01,1,0,1
90104,BELLA FLOR,salud sexual y reproductiva,hemorragia de la primera mitad del embarazo (< 22 sem) aborto,2015-05-01,1,0,1
21304,CALAMARCA,salud sexual y reproductiva,hemorragia de la primera mitad del embarazo (< 22 sem) aborto,2015-05-01,0,1,1
10701,CAMARGO,salud sexual y reproductiva,hemorragia de la primera mitad del embarazo (< 22 sem) aborto,2015-05-01,8,0,8
70706,CAMIRI,salud sexual y reproductiva,hemorragia de la primera mitad del embarazo (< 22 sem) aborto,2015-05-01,16,1,17
30701,CAPINOTA,salud sexual y reproductiva,hemorragia de la primera mitad del embarazo (< 22 sem) aborto,2015-05-01,1,0,1
40102,CARACOLLO,salud sexual y reproductiva,hemorragia de la primera mitad del embarazo (< 22 sem) aborto,2015-05-01,2,0,2
71403,CARMEN RIVERO TORREZ,salud sexual y reproductiva,hemorragia de la primera mitad del embarazo (< 22 sem) aborto,2015-05-01,1,0,1
70702,CHARAGUA,salud sexual y reproductiva,hemorragia de la primera mitad del embarazo (< 22 sem) aborto,2015-05-01,2,0,2
21101,CHULUMANI (V. DE LA LIBERTAD),salud sexual y reproductiva,hemorragia de la primera mitad del embarazo (< 22 sem) aborto,2015-05-01,0,2,2
30801,CLIZA,salud sexual y reproductiva,hemorragia de la primera mitad del embarazo (< 22 sem) aborto,2015-05-01,7,0,7
90101,COBIJA,salud sexual y reproductiva,hemorragia de la primera mitad del embarazo (< 22 sem) aborto,2015-05-01,36,0,36
30101,COCHABAMBA,salud sexual y reproductiva,hemorragia de la primera mitad del embarazo (< 22 sem) aborto,2015-05-01,67,146,213
31002,COLOMI,salud sexual y reproductiva,hemorragia de la primera mitad del embarazo (< 22 sem) aborto,2015-05-01,3,0,3
50401,COLQUECHACA,salud sexual y reproductiva,hemorragia de la primera mitad del embarazo (< 22 sem) aborto,2015-05-01,0,1,1
71301,COMARAPA,salud sexual y reproductiva,hemorragia de la primera mitad del embarazo (< 22 sem) aborto,2015-05-01,4,0,4
71101,CONCEPCION,salud sexual y reproductiva,hemorragia de la primera mitad del embarazo (< 22 sem) aborto,2015-05-01,2,0,2
21401,COROICO,salud sexual y reproductiva,hemorragia de la primera mitad del embarazo (< 22 sem) aborto,2015-05-01,3,0,3
40301,CORQUE,salud sexual y reproductiva,hemorragia de la primera mitad del embarazo (< 22 sem) aborto,2015-05-01,1,0,1
71106,CUATRO CAÃ‘ADAS,salud sexual y reproductiva,hemorragia de la primera mitad del embarazo (< 22 sem) aborto,2015-05-01,6,0,6
10902,CULPINA,salud sexual y reproductiva,hemorragia de la primera mitad del embarazo (< 22 sem) aborto,2015-05-01,0,1,1
20105,EL ALTO,salud sexual y reproductiva,hemorragia de la primera mitad del embarazo (< 22 sem) aborto,2015-05-01,92,6,98
70105,EL TORNO,salud sexual y reproductiva,hemorragia de la primera mitad del embarazo (< 22 sem) aborto,2015-05-01,20,0,20
20405,ESCOMA,salud sexual y reproductiva,hemorragia de la primera mitad del embarazo (< 22 sem) aborto,2015-05-01,0,1,1
20802,GUAQUI,salud sexual y reproductiva,hemorragia de la primera mitad del embarazo (< 22 sem) aborto,2015-05-01,1,1,2
80202,GUAYARAMERIN,salud sexual y reproductiva,hemorragia de la primera mitad del embarazo (< 22 sem) aborto,2015-05-01,3,0,3
10502,HUACARETA,salud sexual y reproductiva,hemorragia de la primera mitad del embarazo (< 22 sem) aborto,2015-05-01,1,0,1
11002,HUACAYA (VILLA DE HUACAYA),salud sexual y reproductiva,hemorragia de la primera mitad del embarazo (< 22 sem) aborto,2015-05-01,1,0,1
40701,HUANUNI,salud sexual y reproductiva,hemorragia de la primera mitad del embarazo (< 22 sem) aborto,2015-05-01,5,0,5
10703,INCAHUASI,salud sexual y reproductiva,hemorragia de la primera mitad del embarazo (< 22 sem) aborto,2015-05-01,0,2,2
70104,LA GUARDIA,salud sexual y reproductiva,hemorragia de la primera mitad del embarazo (< 22 sem) aborto,2015-05-01,0,4,4
20101,LA PAZ,salud sexual y reproductiva,hemorragia de la primera mitad del embarazo (< 22 sem) aborto,2015-05-01,83,11,94
11003,MACHARETI,salud sexual y reproductiva,hemorragia de la primera mitad del embarazo (< 22 sem) aborto,2015-05-01,1,0,1
80801,MAGDALENA,salud sexual y reproductiva,hemorragia de la primera mitad del embarazo (< 22 sem) aborto,2015-05-01,0,1,1
70903,MAIRANA,salud sexual y reproductiva,hemorragia de la primera mitad del embarazo (< 22 sem) aborto,2015-05-01,4,0,4
20607,MAPIRI,salud sexual y reproductiva,hemorragia de la primera mitad del embarazo (< 22 sem) aborto,2015-05-01,1,1,2
10303,MOJOCOYA,salud sexual y reproductiva,hemorragia de la primera mitad del embarazo (< 22 sem) aborto,2015-05-01,0,1,1
10501,MONTEAGUDO,salud sexual y reproductiva,hemorragia de la primera mitad del embarazo (< 22 sem) aborto,2015-05-01,6,2,8
71001,MONTERO,salud sexual y reproductiva,hemorragia de la primera mitad del embarazo (< 22 sem) aborto,2015-05-01,20,0,20
30302,MOROCHATA,salud sexual y reproductiva,hemorragia de la primera mitad del embarazo (< 22 sem) aborto,2015-05-01,1,0,1
40101,ORURO,salud sexual y reproductiva,hemorragia de la primera mitad del embarazo (< 22 sem) aborto,2015-05-01,12,4,16
10401,PADILLA,salud sexual y reproductiva,hemorragia de la primera mitad del embarazo (< 22 sem) aborto,2015-05-01,5,0,5
70902,PAMPA GRANDE,salud sexual y reproductiva,hemorragia de la primera mitad del embarazo (< 22 sem) aborto,2015-05-01,1,2,3
10103,POROMA,salud sexual y reproductiva,hemorragia de la primera mitad del embarazo (< 22 sem) aborto,2015-05-01,1,20,21
70601,PORTACHUELO,salud sexual y reproductiva,hemorragia de la primera mitad del embarazo (< 22 sem) aborto,2015-05-01,2,0,2
50101,POTOSI,salud sexual y reproductiva,hemorragia de la primera mitad del embarazo (< 22 sem) aborto,2015-05-01,15,4,19
71401,PUERTO SUAREZ,salud sexual y reproductiva,hemorragia de la primera mitad del embarazo (< 22 sem) aborto,2015-05-01,6,0,6
31205,PUERTO VILLARROEL,salud sexual y reproductiva,hemorragia de la primera mitad del embarazo (< 22 sem) aborto,2015-05-01,1,5,6
31401,PUNATA,salud sexual y reproductiva,hemorragia de la primera mitad del embarazo (< 22 sem) aborto,2015-05-01,14,0,14
30901,QUILLACOLLO,salud sexual y reproductiva,hemorragia de la primera mitad del embarazo (< 22 sem) aborto,2015-05-01,76,0,76
80201,RIBERALTA,salud sexual y reproductiva,hemorragia de la primera mitad del embarazo (< 22 sem) aborto,2015-05-01,14,0,14
70503,ROBORE,salud sexual y reproductiva,hemorragia de la primera mitad del embarazo (< 22 sem) aborto,2015-05-01,4,0,4
80304,RURRENABAQUE,salud sexual y reproductiva,hemorragia de la primera mitad del embarazo (< 22 sem) aborto,2015-05-01,9,0,9
31001,SACABA,salud sexual y reproductiva,hemorragia de la primera mitad del embarazo (< 22 sem) aborto,2015-05-01,28,5,33
80302,SAN BORJA,salud sexual y reproductiva,hemorragia de la primera mitad del embarazo (< 22 sem) aborto,2015-05-01,8,0,8
70402,SAN CARLOS,salud sexual y reproductiva,hemorragia de la primera mitad del embarazo (< 22 sem) aborto,2015-05-01,6,1,7
80501,SAN IGNACIO,salud sexual y reproductiva,hemorragia de la primera mitad del embarazo (< 22 sem) aborto,2015-05-01,3,0,3
70301,SAN IGNACIO DE VELASCO,salud sexual y reproductiva,hemorragia de la primera mitad del embarazo (< 22 sem) aborto,2015-05-01,10,0,10
71102,SAN JAVIER(STC),salud sexual y reproductiva,hemorragia de la primera mitad del embarazo (< 22 sem) aborto,2015-05-01,0,1,1
70501,SAN JOSE DE CHIQUITOS,salud sexual y reproductiva,hemorragia de la primera mitad del embarazo (< 22 sem) aborto,2015-05-01,3,0,3
71104,SAN JULIAN,salud sexual y reproductiva,hemorragia de la primera mitad del embarazo (< 22 sem) aborto,2015-05-01,20,0,20
10702,SAN LUCAS,salud sexual y reproductiva,hemorragia de la primera mitad del embarazo (< 22 sem) aborto,2015-05-01,1,0,1
71201,SAN MATIAS,salud sexual y reproductiva,hemorragia de la primera mitad del embarazo (< 22 sem) aborto,2015-05-01,1,0,1
70302,SAN MIGUEL DE VELASCO,salud sexual y reproductiva,hemorragia de la primera mitad del embarazo (< 22 sem) aborto,2015-05-01,2,0,2
80401,SANTA ANA,salud sexual y reproductiva,hemorragia de la primera mitad del embarazo (< 22 sem) aborto,2015-05-01,7,0,7
70101,SANTA CRUZ DE LA SIERRA,salud sexual y reproductiva,hemorragia de la primera mitad del embarazo (< 22 sem) aborto,2015-05-01,267,69,336
90303,SENA,salud sexual y reproductiva,hemorragia de la primera mitad del embarazo (< 22 sem) aborto,2015-05-01,2,0,2
31602,SHINAOTA,salud sexual y reproductiva,hemorragia de la primera mitad del embarazo (< 22 sem) aborto,2015-05-01,6,0,6
40104,SORACACHI,salud sexual y reproductiva,hemorragia de la primera mitad del embarazo (< 22 sem) aborto,2015-05-01,1,0,1
10101,SUCRE,salud sexual y reproductiva,hemorragia de la primera mitad del embarazo (< 22 sem) aborto,2015-05-01,103,32,135
50303,TACOBAMBA,salud sexual y reproductiva,hemorragia de la primera mitad del embarazo (< 22 sem) aborto,2015-05-01,0,1,1
10601,TARABUCO,salud sexual y reproductiva,hemorragia de la primera mitad del embarazo (< 22 sem) aborto,2015-05-01,8,0,8
60101,TARIJA,salud sexual y reproductiva,hemorragia de la primera mitad del embarazo (< 22 sem) aborto,2015-05-01,0,2,2
10202,TARVITA,salud sexual y reproductiva,hemorragia de la primera mitad del embarazo (< 22 sem) aborto,2015-05-01,2,0,2
50102,TINGUIPAYA,salud sexual y reproductiva,hemorragia de la primera mitad del embarazo (< 22 sem) aborto,2015-05-01,0,1,1
20606,TIPUANI,salud sexual y reproductiva,hemorragia de la primera mitad del embarazo (< 22 sem) aborto,2015-05-01,1,0,1
30903,TIQUIPAYA,salud sexual y reproductiva,hemorragia de la primera mitad del embarazo (< 22 sem) aborto,2015-05-01,0,3,3
10402,TOMINA,salud sexual y reproductiva,hemorragia de la primera mitad del embarazo (< 22 sem) aborto,2015-05-01,0,1,1
31201,TOTORA(CBBA),salud sexual y reproductiva,hemorragia de la primera mitad del embarazo (< 22 sem) aborto,2015-05-01,1,0,1
80101,TRINIDAD,salud sexual y reproductiva,hemorragia de la primera mitad del embarazo (< 22 sem) aborto,2015-05-01,81,4,85
50801,TUPIZA,salud sexual y reproductiva,hemorragia de la primera mitad del embarazo (< 22 sem) aborto,2015-05-01,9,2,11
50201,UNCIA,salud sexual y reproductiva,hemorragia de la primera mitad del embarazo (< 22 sem) aborto,2015-05-01,2,0,2
60303,VILLA MONTES,salud sexual y reproductiva,hemorragia de la primera mitad del embarazo (< 22 sem) aborto,2015-05-01,0,1,1
31402,VILLA RIVERO,salud sexual y reproductiva,hemorragia de la primera mitad del embarazo (< 22 sem) aborto,2015-05-01,0,1,1
31003,VILLA TUNARI,salud sexual y reproductiva,hemorragia de la primera mitad del embarazo (< 22 sem) aborto,2015-05-01,2,0,2
11001,VILLA VACA GUZMAN (MUYUPAMPA),salud sexual y reproductiva,hemorragia de la primera mitad del embarazo (< 22 sem) aborto,2015-05-01,2,0,2
51501,VILLAZON,salud sexual y reproductiva,hemorragia de la primera mitad del embarazo (< 22 sem) aborto,2015-05-01,1,0,1
70201,WARNES,salud sexual y reproductiva,hemorragia de la primera mitad del embarazo (< 22 sem) aborto,2015-05-01,3,0,3
60301,YACUIBA,salud sexual y reproductiva,hemorragia de la primera mitad del embarazo (< 22 sem) aborto,2015-05-01,0,8,8
70403,YAPACANI,salud sexual y reproductiva,hemorragia de la primera mitad del embarazo (< 22 sem) aborto,2015-05-01,2,7,9
30201,AIQUILE,salud sexual y reproductiva,hemorragia de la primera mitad del embarazo (< 22 sem) aborto,2015-06-01,7,0,7
22002,ALTO BENI,salud sexual y reproductiva,hemorragia de la primera mitad del embarazo (< 22 sem) aborto,2015-06-01,1,0,1
71501,ASCENCION DE GUARAYOS,salud sexual y reproductiva,hemorragia de la primera mitad del embarazo (< 22 sem) aborto,2015-06-01,5,1,6
51102,"CAIZA ""D""",salud sexual y reproductiva,hemorragia de la primera mitad del embarazo (< 22 sem) aborto,2015-06-01,1,0,1
10701,CAMARGO,salud sexual y reproductiva,hemorragia de la primera mitad del embarazo (< 22 sem) aborto,2015-06-01,3,1,4
70706,CAMIRI,salud sexual y reproductiva,hemorragia de la primera mitad del embarazo (< 22 sem) aborto,2015-06-01,15,0,15
40102,CARACOLLO,salud sexual y reproductiva,hemorragia de la primera mitad del embarazo (< 22 sem) aborto,2015-06-01,7,0,7
71403,CARMEN RIVERO TORREZ,salud sexual y reproductiva,hemorragia de la primera mitad del embarazo (< 22 sem) aborto,2015-06-01,1,0,1
40201,CHALLAPATA,salud sexual y reproductiva,hemorragia de la primera mitad del embarazo (< 22 sem) aborto,2015-06-01,3,0,3
50302,CHAQUI,salud sexual y reproductiva,hemorragia de la primera mitad del embarazo (< 22 sem) aborto,2015-06-01,0,1,1
70702,CHARAGUA,salud sexual y reproductiva,hemorragia de la primera mitad del embarazo (< 22 sem) aborto,2015-06-01,6,0,6
31204,CHIMORE,salud sexual y reproductiva,hemorragia de la primera mitad del embarazo (< 22 sem) aborto,2015-06-01,4,0,4
21101,CHULUMANI (V. DE LA LIBERTAD),salud sexual y reproductiva,hemorragia de la primera mitad del embarazo (< 22 sem) aborto,2015-06-01,5,0,5
30801,CLIZA,salud sexual y reproductiva,hemorragia de la primera mitad del embarazo (< 22 sem) aborto,2015-06-01,11,0,11
90101,COBIJA,salud sexual y reproductiva,hemorragia de la primera mitad del embarazo (< 22 sem) aborto,2015-06-01,31,0,31
30101,COCHABAMBA,salud sexual y reproductiva,hemorragia de la primera mitad del embarazo (< 22 sem) aborto,2015-06-01,202,18,220
31002,COLOMI,salud sexual y reproductiva,hemorragia de la primera mitad del embarazo (< 22 sem) aborto,2015-06-01,1,0,1
50401,COLQUECHACA,salud sexual y reproductiva,hemorragia de la primera mitad del embarazo (< 22 sem) aborto,2015-06-01,0,1,1
71301,COMARAPA,salud sexual y reproductiva,hemorragia de la primera mitad del embarazo (< 22 sem) aborto,2015-06-01,7,0,7
71101,CONCEPCION,salud sexual y reproductiva,hemorragia de la primera mitad del embarazo (< 22 sem) aborto,2015-06-01,4,0,4
71106,CUATRO CAÃ‘ADAS,salud sexual y reproductiva,hemorragia de la primera mitad del embarazo (< 22 sem) aborto,2015-06-01,8,0,8
10902,CULPINA,salud sexual y reproductiva,hemorragia de la primera mitad del embarazo (< 22 sem) aborto,2015-06-01,1,5,6
20105,EL ALTO,salud sexual y reproductiva,hemorragia de la primera mitad del embarazo (< 22 sem) aborto,2015-06-01,132,10,142
70105,EL TORNO,salud sexual y reproductiva,hemorragia de la primera mitad del embarazo (< 22 sem) aborto,2015-06-01,10,3,13
20405,ESCOMA,salud sexual y reproductiva,hemorragia de la primera mitad del embarazo (< 22 sem) aborto,2015-06-01,0,1,1
41101,EUCALIPTUS,salud sexual y reproductiva,hemorragia de la primera mitad del embarazo (< 22 sem) aborto,2015-06-01,1,2,3
40501,HUACHACALLA,salud sexual y reproductiva,hemorragia de la primera mitad del embarazo (< 22 sem) aborto,2015-06-01,1,0,1
40701,HUANUNI,salud sexual y reproductiva,hemorragia de la primera mitad del embarazo (< 22 sem) aborto,2015-06-01,7,0,7
70104,LA GUARDIA,salud sexual y reproductiva,hemorragia de la primera mitad del embarazo (< 22 sem) aborto,2015-06-01,0,2,2
20101,LA PAZ,salud sexual y reproductiva,hemorragia de la primera mitad del embarazo (< 22 sem) aborto,2015-06-01,87,23,110
70701,LAGUNILLAS,salud sexual y reproductiva,hemorragia de la primera mitad del embarazo (< 22 sem) aborto,2015-06-01,0,1,1
11003,MACHARETI,salud sexual y reproductiva,hemorragia de la primera mitad del embarazo (< 22 sem) aborto,2015-06-01,1,0,1
70903,MAIRANA,salud sexual y reproductiva,hemorragia de la primera mitad del embarazo (< 22 sem) aborto,2015-06-01,8,0,8
31301,MIZQUE,salud sexual y reproductiva,hemorragia de la primera mitad del embarazo (< 22 sem) aborto,2015-06-01,2,0,2
10501,MONTEAGUDO,salud sexual y reproductiva,hemorragia de la primera mitad del embarazo (< 22 sem) aborto,2015-06-01,12,5,17
71001,MONTERO,salud sexual y reproductiva,hemorragia de la primera mitad del embarazo (< 22 sem) aborto,2015-06-01,20,0,20
40101,ORURO,salud sexual y reproductiva,hemorragia de la primera mitad del embarazo (< 22 sem) aborto,2015-06-01,15,2,17
10401,PADILLA,salud sexual y reproductiva,hemorragia de la primera mitad del embarazo (< 22 sem) aborto,2015-06-01,2,0,2
70502,PAILON,salud sexual y reproductiva,hemorragia de la primera mitad del embarazo (< 22 sem) aborto,2015-06-01,1,2,3
70902,PAMPA GRANDE,salud sexual y reproductiva,hemorragia de la primera mitad del embarazo (< 22 sem) aborto,2015-06-01,0,1,1
50403,POCOATA,salud sexual y reproductiva,hemorragia de la primera mitad del embarazo (< 22 sem) aborto,2015-06-01,0,1,1
31202,POJO (CBBA),salud sexual y reproductiva,hemorragia de la primera mitad del embarazo (< 22 sem) aborto,2015-06-01,3,0,3
40601,POOPO,salud sexual y reproductiva,hemorragia de la primera mitad del embarazo (< 22 sem) aborto,2015-06-01,2,0,2
10103,POROMA,salud sexual y reproductiva,hemorragia de la primera mitad del embarazo (< 22 sem) aborto,2015-06-01,0,1,1
70601,PORTACHUELO,salud sexual y reproductiva,hemorragia de la primera mitad del embarazo (< 22 sem) aborto,2015-06-01,4,0,4
50101,POTOSI,salud sexual y reproductiva,hemorragia de la primera mitad del embarazo (< 22 sem) aborto,2015-06-01,31,1,32
71401,PUERTO SUAREZ,salud sexual y reproductiva,hemorragia de la primera mitad del embarazo (< 22 sem) aborto,2015-06-01,8,0,8
31205,PUERTO VILLARROEL,salud sexual y reproductiva,hemorragia de la primera mitad del embarazo (< 22 sem) aborto,2015-06-01,1,13,14
51101,PUNA,salud sexual y reproductiva,hemorragia de la primera mitad del embarazo (< 22 sem) aborto,2015-06-01,3,0,3
31401,PUNATA,salud sexual y reproductiva,hemorragia de la primera mitad del embarazo (< 22 sem) aborto,2015-06-01,20,0,20
50402,RAVELO,salud sexual y reproductiva,hemorragia de la primera mitad del embarazo (< 22 sem) aborto,2015-06-01,1,1,2
80301,REYES,salud sexual y reproductiva,hemorragia de la primera mitad del embarazo (< 22 sem) aborto,2015-06-01,4,0,4
80201,RIBERALTA,salud sexual y reproductiva,hemorragia de la primera mitad del embarazo (< 22 sem) aborto,2015-06-01,56,0,56
70503,ROBORE,salud sexual y reproductiva,hemorragia de la primera mitad del embarazo (< 22 sem) aborto,2015-06-01,1,2,3
80304,RURRENABAQUE,salud sexual y reproductiva,hemorragia de la primera mitad del embarazo (< 22 sem) aborto,2015-06-01,19,0,19
31001,SACABA,salud sexual y reproductiva,hemorragia de la primera mitad del embarazo (< 22 sem) aborto,2015-06-01,43,0,43
70901,SAMAIPATA,salud sexual y reproductiva,hemorragia de la primera mitad del embarazo (< 22 sem) aborto,2015-06-01,2,0,2
80302,SAN BORJA,salud sexual y reproductiva,hemorragia de la primera mitad del embarazo (< 22 sem) aborto,2015-06-01,13,0,13
70402,SAN CARLOS,salud sexual y reproductiva,hemorragia de la primera mitad del embarazo (< 22 sem) aborto,2015-06-01,11,0,11
80501,SAN IGNACIO,salud sexual y reproductiva,hemorragia de la primera mitad del embarazo (< 22 sem) aborto,2015-06-01,4,0,4
70301,SAN IGNACIO DE VELASCO,salud sexual y reproductiva,hemorragia de la primera mitad del embarazo (< 22 sem) aborto,2015-06-01,15,0,15
71102,SAN JAVIER(STC),salud sexual y reproductiva,hemorragia de la primera mitad del embarazo (< 22 sem) aborto,2015-06-01,3,0,3
70501,SAN JOSE DE CHIQUITOS,salud sexual y reproductiva,hemorragia de la primera mitad del embarazo (< 22 sem) aborto,2015-06-01,4,0,4
70404,SAN JUAN DE YAPACANI,salud sexual y reproductiva,hemorragia de la primera mitad del embarazo (< 22 sem) aborto,2015-06-01,1,0,1
71104,SAN JULIAN,salud sexual y reproductiva,hemorragia de la primera mitad del embarazo (< 22 sem) aborto,2015-06-01,20,4,24
60501,SAN LORENZO(TJA),salud sexual y reproductiva,hemorragia de la primera mitad del embarazo (< 22 sem) aborto,2015-06-01,1,0,1
70302,SAN MIGUEL DE VELASCO,salud sexual y reproductiva,hemorragia de la primera mitad del embarazo (< 22 sem) aborto,2015-06-01,0,1,1
80702,SAN RAMON BENI,salud sexual y reproductiva,hemorragia de la primera mitad del embarazo (< 22 sem) aborto,2015-06-01,2,0,2
80401,SANTA ANA,salud sexual y reproductiva,hemorragia de la primera mitad del embarazo (< 22 sem) aborto,2015-06-01,4,0,4
70101,SANTA CRUZ DE LA SIERRA,salud sexual y reproductiva,hemorragia de la primera mitad del embarazo (< 22 sem) aborto,2015-06-01,343,72,415
90303,SENA,salud sexual y reproductiva,hemorragia de la primera mitad del embarazo (< 22 sem) aborto,2015-06-01,5,5,10
31602,SHINAOTA,salud sexual y reproductiva,hemorragia de la primera mitad del embarazo (< 22 sem) aborto,2015-06-01,7,0,7
21301,SICA SICA (VILLA AROMA),salud sexual y reproductiva,hemorragia de la primera mitad del embarazo (< 22 sem) aborto,2015-06-01,1,1,2
30902,SIPE SIPE,salud sexual y reproductiva,hemorragia de la primera mitad del embarazo (< 22 sem) aborto,2015-06-01,1,0,1
10101,SUCRE,salud sexual y reproductiva,hemorragia de la primera mitad del embarazo (< 22 sem) aborto,2015-06-01,161,6,167
10601,TARABUCO,salud sexual y reproductiva,hemorragia de la primera mitad del embarazo (< 22 sem) aborto,2015-06-01,7,0,7
60101,TARIJA,salud sexual y reproductiva,hemorragia de la primera mitad del embarazo (< 22 sem) aborto,2015-06-01,0,8,8
10202,TARVITA,salud sexual y reproductiva,hemorragia de la primera mitad del embarazo (< 22 sem) aborto,2015-06-01,1,0,1
20606,TIPUANI,salud sexual y reproductiva,hemorragia de la primera mitad del embarazo (< 22 sem) aborto,2015-06-01,6,2,8
31601,TIRAQUE (CBBA),salud sexual y reproductiva,hemorragia de la primera mitad del embarazo (< 22 sem) aborto,2015-06-01,3,0,3
51202,TOMAVE,salud sexual y reproductiva,hemorragia de la primera mitad del embarazo (< 22 sem) aborto,2015-06-01,0,1,1
10402,TOMINA,salud sexual y reproductiva,hemorragia de la primera mitad del embarazo (< 22 sem) aborto,2015-06-01,2,0,2
31201,TOTORA(CBBA),salud sexual y reproductiva,hemorragia de la primera mitad del embarazo (< 22 sem) aborto,2015-06-01,1,0,1
41301,TOTORA(ORR),salud sexual y reproductiva,hemorragia de la primera mitad del embarazo (< 22 sem) aborto,2015-06-01,0,1,1
80101,TRINIDAD,salud sexual y reproductiva,hemorragia de la primera mitad del embarazo (< 22 sem) aborto,2015-06-01,69,2,71
50801,TUPIZA,salud sexual y reproductiva,hemorragia de la primera mitad del embarazo (< 22 sem) aborto,2015-06-01,11,5,16
51201,UYUNI,salud sexual y reproductiva,hemorragia de la primera mitad del embarazo (< 22 sem) aborto,2015-06-01,0,1,1
31003,VILLA TUNARI,salud sexual y reproductiva,hemorragia de la primera mitad del embarazo (< 22 sem) aborto,2015-06-01,10,0,10
51501,VILLAZON,salud sexual y reproductiva,hemorragia de la primera mitad del embarazo (< 22 sem) aborto,2015-06-01,3,0,3
30904,VINTO,salud sexual y reproductiva,hemorragia de la primera mitad del embarazo (< 22 sem) aborto,2015-06-01,6,0,6
70201,WARNES,salud sexual y reproductiva,hemorragia de la primera mitad del embarazo (< 22 sem) aborto,2015-06-01,29,0,29
20903,YACO,salud sexual y reproductiva,hemorragia de la primera mitad del embarazo (< 22 sem) aborto,2015-06-01,0,1,1
60301,YACUIBA,salud sexual y reproductiva,hemorragia de la primera mitad del embarazo (< 22 sem) aborto,2015-06-01,2,11,13
70403,YAPACANI,salud sexual y reproductiva,hemorragia de la primera mitad del embarazo (< 22 sem) aborto,2015-06-01,4,7,11
51302,ACACIO,salud sexual y reproductiva,hemorragia de la primera mitad del embarazo (< 22 sem) aborto,2015-07-01,1,0,1
30201,AIQUILE,salud sexual y reproductiva,hemorragia de la primera mitad del embarazo (< 22 sem) aborto,2015-07-01,5,0,5
30301,AYOPAYA (V. DE INDEPENDENCIA),salud sexual y reproductiva,hemorragia de la primera mitad del embarazo (< 22 sem) aborto,2015-07-01,2,0,2
50301,BETANZOS,salud sexual y reproductiva,hemorragia de la primera mitad del embarazo (< 22 sem) aborto,2015-07-01,2,0,2
10701,CAMARGO,salud sexual y reproductiva,hemorragia de la primera mitad del embarazo (< 22 sem) aborto,2015-07-01,6,0,6
70706,CAMIRI,salud sexual y reproductiva,hemorragia de la primera mitad del embarazo (< 22 sem) aborto,2015-07-01,10,1,11
30701,CAPINOTA,salud sexual y reproductiva,hemorragia de la primera mitad del embarazo (< 22 sem) aborto,2015-07-01,1,0,1
40102,CARACOLLO,salud sexual y reproductiva,hemorragia de la primera mitad del embarazo (< 22 sem) aborto,2015-07-01,7,0,7
70702,CHARAGUA,salud sexual y reproductiva,hemorragia de la primera mitad del embarazo (< 22 sem) aborto,2015-07-01,1,0,1
21101,CHULUMANI (V. DE LA LIBERTAD),salud sexual y reproductiva,hemorragia de la primera mitad del embarazo (< 22 sem) aborto,2015-07-01,1,0,1
30801,CLIZA,salud sexual y reproductiva,hemorragia de la primera mitad del embarazo (< 22 sem) aborto,2015-07-01,4,3,7
90101,COBIJA,salud sexual y reproductiva,hemorragia de la primera mitad del embarazo (< 22 sem) aborto,2015-07-01,18,0,18
30101,COCHABAMBA,salud sexual y reproductiva,hemorragia de la primera mitad del embarazo (< 22 sem) aborto,2015-07-01,173,0,173
31002,COLOMI,salud sexual y reproductiva,hemorragia de la primera mitad del embarazo (< 22 sem) aborto,2015-07-01,3,0,3
71301,COMARAPA,salud sexual y reproductiva,hemorragia de la primera mitad del embarazo (< 22 sem) aborto,2015-07-01,4,0,4
71101,CONCEPCION,salud sexual y reproductiva,hemorragia de la primera mitad del embarazo (< 22 sem) aborto,2015-07-01,3,0,3
71106,CUATRO CAÃ‘ADAS,salud sexual y reproductiva,hemorragia de la primera mitad del embarazo (< 22 sem) aborto,2015-07-01,7,0,7
20105,EL ALTO,salud sexual y reproductiva,hemorragia de la primera mitad del embarazo (< 22 sem) aborto,2015-07-01,59,11,70
71503,EL PUENTE(STC),salud sexual y reproductiva,hemorragia de la primera mitad del embarazo (< 22 sem) aborto,2015-07-01,2,0,2
70105,EL TORNO,salud sexual y reproductiva,hemorragia de la primera mitad del embarazo (< 22 sem) aborto,2015-07-01,13,0,13
31206,ENTRE RIOS CBBA,salud sexual y reproductiva,hemorragia de la primera mitad del embarazo (< 22 sem) aborto,2015-07-01,0,3,3
41101,EUCALIPTUS,salud sexual y reproductiva,hemorragia de la primera mitad del embarazo (< 22 sem) aborto,2015-07-01,0,1,1
71004,FERNANDEZ ALONSO,salud sexual y reproductiva,hemorragia de la primera mitad del embarazo (< 22 sem) aborto,2015-07-01,1,0,1
80202,GUAYARAMERIN,salud sexual y reproductiva,hemorragia de la primera mitad del embarazo (< 22 sem) aborto,2015-07-01,3,1,4
70705,GUTIERREZ,salud sexual y reproductiva,hemorragia de la primera mitad del embarazo (< 22 sem) aborto,2015-07-01,10,0,10
10502,HUACARETA,salud sexual y reproductiva,hemorragia de la primera mitad del embarazo (< 22 sem) aborto,2015-07-01,0,1,1
40701,HUANUNI,salud sexual y reproductiva,hemorragia de la primera mitad del embarazo (< 22 sem) aborto,2015-07-01,8,0,8
10703,INCAHUASI,salud sexual y reproductiva,hemorragia de la primera mitad del embarazo (< 22 sem) aborto,2015-07-01,0,1,1
21501,IXIAMAS,salud sexual y reproductiva,hemorragia de la primera mitad del embarazo (< 22 sem) aborto,2015-07-01,0,1,1
21105,LA ASUNTA,salud sexual y reproductiva,hemorragia de la primera mitad del embarazo (< 22 sem) aborto,2015-07-01,13,0,13
70104,LA GUARDIA,salud sexual y reproductiva,hemorragia de la primera mitad del embarazo (< 22 sem) aborto,2015-07-01,3,10,13
20101,LA PAZ,salud sexual y reproductiva,hemorragia de la primera mitad del embarazo (< 22 sem) aborto,2015-07-01,37,51,88
70903,MAIRANA,salud sexual y reproductiva,hemorragia de la primera mitad del embarazo (< 22 sem) aborto,2015-07-01,4,0,4
10303,MOJOCOYA,salud sexual y reproductiva,hemorragia de la primera mitad del embarazo (< 22 sem) aborto,2015-07-01,0,1,1
10501,MONTEAGUDO,salud sexual y reproductiva,hemorragia de la primera mitad del embarazo (< 22 sem) aborto,2015-07-01,5,4,9
71001,MONTERO,salud sexual y reproductiva,hemorragia de la primera mitad del embarazo (< 22 sem) aborto,2015-07-01,40,1,41
30302,MOROCHATA,salud sexual y reproductiva,hemorragia de la primera mitad del embarazo (< 22 sem) aborto,2015-07-01,0,1,1
40101,ORURO,salud sexual y reproductiva,hemorragia de la primera mitad del embarazo (< 22 sem) aborto,2015-07-01,5,0,5
60201,PADCAYA,salud sexual y reproductiva,hemorragia de la primera mitad del embarazo (< 22 sem) aborto,2015-07-01,1,1,2
70502,PAILON,salud sexual y reproductiva,hemorragia de la primera mitad del embarazo (< 22 sem) aborto,2015-07-01,0,2,2
21104,PALOS BLANCOS,salud sexual y reproductiva,hemorragia de la primera mitad del embarazo (< 22 sem) aborto,2015-07-01,2,0,2
70902,PAMPA GRANDE,salud sexual y reproductiva,hemorragia de la primera mitad del embarazo (< 22 sem) aborto,2015-07-01,1,0,1
31203,POCONA,salud sexual y reproductiva,hemorragia de la primera mitad del embarazo (< 22 sem) aborto,2015-07-01,1,1,2
40601,POOPO,salud sexual y reproductiva,hemorragia de la primera mitad del embarazo (< 22 sem) aborto,2015-07-01,6,0,6
10103,POROMA,salud sexual y reproductiva,hemorragia de la primera mitad del embarazo (< 22 sem) aborto,2015-07-01,2,0,2
70601,PORTACHUELO,salud sexual y reproductiva,hemorragia de la primera mitad del embarazo (< 22 sem) aborto,2015-07-01,2,0,2
50101,POTOSI,salud sexual y reproductiva,hemorragia de la primera mitad del embarazo (< 22 sem) aborto,2015-07-01,12,0,12
21201,PUCARANI,salud sexual y reproductiva,hemorragia de la primera mitad del embarazo (< 22 sem) aborto,2015-07-01,0,1,1
90301,PUERTO GONZALO MORENO,salud sexual y reproductiva,hemorragia de la primera mitad del embarazo (< 22 sem) aborto,2015-07-01,1,0,1
90201,PUERTO RICO,salud sexual y reproductiva,hemorragia de la primera mitad del embarazo (< 22 sem) aborto,2015-07-01,1,0,1
71401,PUERTO SUAREZ,salud sexual y reproductiva,hemorragia de la primera mitad del embarazo (< 22 sem) aborto,2015-07-01,7,0,7
31205,PUERTO VILLARROEL,salud sexual y reproductiva,hemorragia de la primera mitad del embarazo (< 22 sem) aborto,2015-07-01,12,0,12
51101,PUNA,salud sexual y reproductiva,hemorragia de la primera mitad del embarazo (< 22 sem) aborto,2015-07-01,1,0,1
31401,PUNATA,salud sexual y reproductiva,hemorragia de la primera mitad del embarazo (< 22 sem) aborto,2015-07-01,14,0,14
30901,QUILLACOLLO,salud sexual y reproductiva,hemorragia de la primera mitad del embarazo (< 22 sem) aborto,2015-07-01,52,0,52
80301,REYES,salud sexual y reproductiva,hemorragia de la primera mitad del embarazo (< 22 sem) aborto,2015-07-01,3,1,4
80201,RIBERALTA,salud sexual y reproductiva,hemorragia de la primera mitad del embarazo (< 22 sem) aborto,2015-07-01,35,0,35
70503,ROBORE,salud sexual y reproductiva,hemorragia de la primera mitad del embarazo (< 22 sem) aborto,2015-07-01,2,0,2
80304,RURRENABAQUE,salud sexual y reproductiva,hemorragia de la primera mitad del embarazo (< 22 sem) aborto,2015-07-01,10,0,10
31001,SACABA,salud sexual y reproductiva,hemorragia de la primera mitad del embarazo (< 22 sem) aborto,2015-07-01,47,16,63
80302,SAN BORJA,salud sexual y reproductiva,hemorragia de la primera mitad del embarazo (< 22 sem) aborto,2015-07-01,15,1,16
70402,SAN CARLOS,salud sexual y reproductiva,hemorragia de la primera mitad del embarazo (< 22 sem) aborto,2015-07-01,5,0,5
80501,SAN IGNACIO,salud sexual y reproductiva,hemorragia de la primera mitad del embarazo (< 22 sem) aborto,2015-07-01,2,0,2
70301,SAN IGNACIO DE VELASCO,salud sexual y reproductiva,hemorragia de la primera mitad del embarazo (< 22 sem) aborto,2015-07-01,13,0,13
71102,SAN JAVIER(STC),salud sexual y reproductiva,hemorragia de la primera mitad del embarazo (< 22 sem) aborto,2015-07-01,1,0,1
70501,SAN JOSE DE CHIQUITOS,salud sexual y reproductiva,hemorragia de la primera mitad del embarazo (< 22 sem) aborto,2015-07-01,4,0,4
71104,SAN JULIAN,salud sexual y reproductiva,hemorragia de la primera mitad del embarazo (< 22 sem) aborto,2015-07-01,18,0,18
90302,SAN LORENZO(PND),salud sexual y reproductiva,hemorragia de la primera mitad del embarazo (< 22 sem) aborto,2015-07-01,1,0,1
10702,SAN LUCAS,salud sexual y reproductiva,hemorragia de la primera mitad del embarazo (< 22 sem) aborto,2015-07-01,3,3,6
70302,SAN MIGUEL DE VELASCO,salud sexual y reproductiva,hemorragia de la primera mitad del embarazo (< 22 sem) aborto,2015-07-01,2,2,4
71005,SAN PEDRO,salud sexual y reproductiva,hemorragia de la primera mitad del embarazo (< 22 sem) aborto,2015-07-01,1,0,1
80401,SANTA ANA,salud sexual y reproductiva,hemorragia de la primera mitad del embarazo (< 22 sem) aborto,2015-07-01,1,2,3
70101,SANTA CRUZ DE LA SIERRA,salud sexual y reproductiva,hemorragia de la primera mitad del embarazo (< 22 sem) aborto,2015-07-01,276,99,375
90303,SENA,salud sexual y reproductiva,hemorragia de la primera mitad del embarazo (< 22 sem) aborto,2015-07-01,0,1,1
31602,SHINAOTA,salud sexual y reproductiva,hemorragia de la primera mitad del embarazo (< 22 sem) aborto,2015-07-01,4,0,4
21301,SICA SICA (VILLA AROMA),salud sexual y reproductiva,hemorragia de la primera mitad del embarazo (< 22 sem) aborto,2015-07-01,1,0,1
10403,SOPACHUY,salud sexual y reproductiva,hemorragia de la primera mitad del embarazo (< 22 sem) aborto,2015-07-01,0,1,1
10101,SUCRE,salud sexual y reproductiva,hemorragia de la primera mitad del embarazo (< 22 sem) aborto,2015-07-01,107,5,112
50303,TACOBAMBA,salud sexual y reproductiva,hemorragia de la primera mitad del embarazo (< 22 sem) aborto,2015-07-01,0,2,2
10601,TARABUCO,salud sexual y reproductiva,hemorragia de la primera mitad del embarazo (< 22 sem) aborto,2015-07-01,0,4,4
60101,TARIJA,salud sexual y reproductiva,hemorragia de la primera mitad del embarazo (< 22 sem) aborto,2015-07-01,0,6,6
10202,TARVITA,salud sexual y reproductiva,hemorragia de la primera mitad del embarazo (< 22 sem) aborto,2015-07-01,0,1,1
20803,TIAWANACU,salud sexual y reproductiva,hemorragia de la primera mitad del embarazo (< 22 sem) aborto,2015-07-01,0,2,2
30903,TIQUIPAYA,salud sexual y reproductiva,hemorragia de la primera mitad del embarazo (< 22 sem) aborto,2015-07-01,1,0,1
51202,TOMAVE,salud sexual y reproductiva,hemorragia de la primera mitad del embarazo (< 22 sem) aborto,2015-07-01,0,1,1
10402,TOMINA,salud sexual y reproductiva,hemorragia de la primera mitad del embarazo (< 22 sem) aborto,2015-07-01,2,1,3
80101,TRINIDAD,salud sexual y reproductiva,hemorragia de la primera mitad del embarazo (< 22 sem) aborto,2015-07-01,15,0,15
50801,TUPIZA,salud sexual y reproductiva,hemorragia de la primera mitad del embarazo (< 22 sem) aborto,2015-07-01,13,0,13
51201,UYUNI,salud sexual y reproductiva,hemorragia de la primera mitad del embarazo (< 22 sem) aborto,2015-07-01,4,3,7
51501,VILLAZON,salud sexual y reproductiva,hemorragia de la primera mitad del embarazo (< 22 sem) aborto,2015-07-01,2,9,11
70201,WARNES,salud sexual y reproductiva,hemorragia de la primera mitad del embarazo (< 22 sem) aborto,2015-07-01,21,0,21
60301,YACUIBA,salud sexual y reproductiva,hemorragia de la primera mitad del embarazo (< 22 sem) aborto,2015-07-01,2,8,10
70403,YAPACANI,salud sexual y reproductiva,hemorragia de la primera mitad del embarazo (< 22 sem) aborto,2015-07-01,0,6,6
30201,AIQUILE,salud sexual y reproductiva,hemorragia de la primera mitad del embarazo (< 22 sem) aborto,2015-08-01,6,0,6
71501,ASCENCION DE GUARAYOS,salud sexual y reproductiva,hemorragia de la primera mitad del embarazo (< 22 sem) aborto,2015-08-01,6,0,6
30301,AYOPAYA (V. DE INDEPENDENCIA),salud sexual y reproductiva,hemorragia de la primera mitad del embarazo (< 22 sem) aborto,2015-08-01,3,0,3
50104,BELEN DE URMIRI,salud sexual y reproductiva,hemorragia de la primera mitad del embarazo (< 22 sem) aborto,2015-08-01,0,1,1
60202,BERMEJO,salud sexual y reproductiva,hemorragia de la primera mitad del embarazo (< 22 sem) aborto,2015-08-01,0,3,3
50301,BETANZOS,salud sexual y reproductiva,hemorragia de la primera mitad del embarazo (< 22 sem) aborto,2015-08-01,0,1,1
10701,CAMARGO,salud sexual y reproductiva,hemorragia de la primera mitad del embarazo (< 22 sem) aborto,2015-08-01,3,2,5
70706,CAMIRI,salud sexual y reproductiva,hemorragia de la primera mitad del embarazo (< 22 sem) aborto,2015-08-01,20,2,22
30701,CAPINOTA,salud sexual y reproductiva,hemorragia de la primera mitad del embarazo (< 22 sem) aborto,2015-08-01,4,1,5
40102,CARACOLLO,salud sexual y reproductiva,hemorragia de la primera mitad del embarazo (< 22 sem) aborto,2015-08-01,3,0,3
60302,CARAPARI,salud sexual y reproductiva,hemorragia de la primera mitad del embarazo (< 22 sem) aborto,2015-08-01,0,1,1
70702,CHARAGUA,salud sexual y reproductiva,hemorragia de la primera mitad del embarazo (< 22 sem) aborto,2015-08-01,4,0,4
21101,CHULUMANI (V. DE LA LIBERTAD),salud sexual y reproductiva,hemorragia de la primera mitad del embarazo (< 22 sem) aborto,2015-08-01,3,0,3
30801,CLIZA,salud sexual y reproductiva,hemorragia de la primera mitad del embarazo (< 22 sem) aborto,2015-08-01,6,0,6
90101,COBIJA,salud sexual y reproductiva,hemorragia de la primera mitad del embarazo (< 22 sem) aborto,2015-08-01,30,0,30
30101,COCHABAMBA,salud sexual y reproductiva,hemorragia de la primera mitad del embarazo (< 22 sem) aborto,2015-08-01,162,28,190
30905,COLCAPIRHUA,salud sexual y reproductiva,hemorragia de la primera mitad del embarazo (< 22 sem) aborto,2015-08-01,3,0,3
31002,COLOMI,salud sexual y reproductiva,hemorragia de la primera mitad del embarazo (< 22 sem) aborto,2015-08-01,1,0,1
50401,COLQUECHACA,salud sexual y reproductiva,hemorragia de la primera mitad del embarazo (< 22 sem) aborto,2015-08-01,0,2,2
71301,COMARAPA,salud sexual y reproductiva,hemorragia de la primera mitad del embarazo (< 22 sem) aborto,2015-08-01,6,0,6
71101,CONCEPCION,salud sexual y reproductiva,hemorragia de la primera mitad del embarazo (< 22 sem) aborto,2015-08-01,1,0,1
71106,CUATRO CAÃ‘ADAS,salud sexual y reproductiva,hemorragia de la primera mitad del embarazo (< 22 sem) aborto,2015-08-01,4,1,5
10902,CULPINA,salud sexual y reproductiva,hemorragia de la primera mitad del embarazo (< 22 sem) aborto,2015-08-01,0,1,1
20105,EL ALTO,salud sexual y reproductiva,hemorragia de la primera mitad del embarazo (< 22 sem) aborto,2015-08-01,97,8,105
71503,EL PUENTE(STC),salud sexual y reproductiva,hemorragia de la primera mitad del embarazo (< 22 sem) aborto,2015-08-01,1,0,1
70105,EL TORNO,salud sexual y reproductiva,hemorragia de la primera mitad del embarazo (< 22 sem) aborto,2015-08-01,17,0,17
60601,ENTRE RIOS TRJ,salud sexual y reproductiva,hemorragia de la primera mitad del embarazo (< 22 sem) aborto,2015-08-01,0,1,1
31206,ENTRE RIOS CBBA,salud sexual y reproductiva,hemorragia de la primera mitad del embarazo (< 22 sem) aborto,2015-08-01,5,1,6
20405,ESCOMA,salud sexual y reproductiva,hemorragia de la primera mitad del embarazo (< 22 sem) aborto,2015-08-01,0,1,1
80202,GUAYARAMERIN,salud sexual y reproductiva,hemorragia de la primera mitad del embarazo (< 22 sem) aborto,2015-08-01,0,5,5
40701,HUANUNI,salud sexual y reproductiva,hemorragia de la primera mitad del embarazo (< 22 sem) aborto,2015-08-01,9,0,9
21105,LA ASUNTA,salud sexual y reproductiva,hemorragia de la primera mitad del embarazo (< 22 sem) aborto,2015-08-01,4,0,4
70104,LA GUARDIA,salud sexual y reproductiva,hemorragia de la primera mitad del embarazo (< 22 sem) aborto,2015-08-01,0,15,15
20101,LA PAZ,salud sexual y reproductiva,hemorragia de la primera mitad del embarazo (< 22 sem) aborto,2015-08-01,49,58,107
11003,MACHARETI,salud sexual y reproductiva,hemorragia de la primera mitad del embarazo (< 22 sem) aborto,2015-08-01,0,1,1
80801,MAGDALENA,salud sexual y reproductiva,hemorragia de la primera mitad del embarazo (< 22 sem) aborto,2015-08-01,0,1,1
70903,MAIRANA,salud sexual y reproductiva,hemorragia de la primera mitad del embarazo (< 22 sem) aborto,2015-08-01,3,0,3
20607,MAPIRI,salud sexual y reproductiva,hemorragia de la primera mitad del embarazo (< 22 sem) aborto,2015-08-01,1,1,2
10501,MONTEAGUDO,salud sexual y reproductiva,hemorragia de la primera mitad del embarazo (< 22 sem) aborto,2015-08-01,5,5,10
71001,MONTERO,salud sexual y reproductiva,hemorragia de la primera mitad del embarazo (< 22 sem) aborto,2015-08-01,45,0,45
40101,ORURO,salud sexual y reproductiva,hemorragia de la primera mitad del embarazo (< 22 sem) aborto,2015-08-01,7,0,7
10401,PADILLA,salud sexual y reproductiva,hemorragia de la primera mitad del embarazo (< 22 sem) aborto,2015-08-01,3,0,3
70502,PAILON,salud sexual y reproductiva,hemorragia de la primera mitad del embarazo (< 22 sem) aborto,2015-08-01,2,1,3
40601,POOPO,salud sexual y reproductiva,hemorragia de la primera mitad del embarazo (< 22 sem) aborto,2015-08-01,0,2,2
10103,POROMA,salud sexual y reproductiva,hemorragia de la primera mitad del embarazo (< 22 sem) aborto,2015-08-01,1,0,1
70601,PORTACHUELO,salud sexual y reproductiva,hemorragia de la primera mitad del embarazo (< 22 sem) aborto,2015-08-01,5,0,5
50101,POTOSI,salud sexual y reproductiva,hemorragia de la primera mitad del embarazo (< 22 sem) aborto,2015-08-01,24,5,29
71401,PUERTO SUAREZ,salud sexual y reproductiva,hemorragia de la primera mitad del embarazo (< 22 sem) aborto,2015-08-01,5,0,5
31205,PUERTO VILLARROEL,salud sexual y reproductiva,hemorragia de la primera mitad del embarazo (< 22 sem) aborto,2015-08-01,31,0,31
51101,PUNA,salud sexual y reproductiva,hemorragia de la primera mitad del embarazo (< 22 sem) aborto,2015-08-01,1,0,1
31401,PUNATA,salud sexual y reproductiva,hemorragia de la primera mitad del embarazo (< 22 sem) aborto,2015-08-01,17,0,17
30901,QUILLACOLLO,salud sexual y reproductiva,hemorragia de la primera mitad del embarazo (< 22 sem) aborto,2015-08-01,83,1,84
80301,REYES,salud sexual y reproductiva,hemorragia de la primera mitad del embarazo (< 22 sem) aborto,2015-08-01,6,1,7
80201,RIBERALTA,salud sexual y reproductiva,hemorragia de la primera mitad del embarazo (< 22 sem) aborto,2015-08-01,57,0,57
70503,ROBORE,salud sexual y reproductiva,hemorragia de la primera mitad del embarazo (< 22 sem) aborto,2015-08-01,7,0,7
80304,RURRENABAQUE,salud sexual y reproductiva,hemorragia de la primera mitad del embarazo (< 22 sem) aborto,2015-08-01,14,0,14
31001,SACABA,salud sexual y reproductiva,hemorragia de la primera mitad del embarazo (< 22 sem) aborto,2015-08-01,41,10,51
70901,SAMAIPATA,salud sexual y reproductiva,hemorragia de la primera mitad del embarazo (< 22 sem) aborto,2015-08-01,1,0,1
80602,SAN ANDRES,salud sexual y reproductiva,hemorragia de la primera mitad del embarazo (< 22 sem) aborto,2015-08-01,0,1,1
80302,SAN BORJA,salud sexual y reproductiva,hemorragia de la primera mitad del embarazo (< 22 sem) aborto,2015-08-01,15,17,32
70402,SAN CARLOS,salud sexual y reproductiva,hemorragia de la primera mitad del embarazo (< 22 sem) aborto,2015-08-01,10,0,10
80501,SAN IGNACIO,salud sexual y reproductiva,hemorragia de la primera mitad del embarazo (< 22 sem) aborto,2015-08-01,5,0,5
70301,SAN IGNACIO DE VELASCO,salud sexual y reproductiva,hemorragia de la primera mitad del embarazo (< 22 sem) aborto,2015-08-01,6,15,21
80102,SAN JAVIER(BNI),salud sexual y reproductiva,hemorragia de la primera mitad del embarazo (< 22 sem) aborto,2015-08-01,1,0,1
70501,SAN JOSE DE CHIQUITOS,salud sexual y reproductiva,hemorragia de la primera mitad del embarazo (< 22 sem) aborto,2015-08-01,8,1,9
70404,SAN JUAN DE YAPACANI,salud sexual y reproductiva,hemorragia de la primera mitad del embarazo (< 22 sem) aborto,2015-08-01,2,1,3
71104,SAN JULIAN,salud sexual y reproductiva,hemorragia de la primera mitad del embarazo (< 22 sem) aborto,2015-08-01,22,0,22
10702,SAN LUCAS,salud sexual y reproductiva,hemorragia de la primera mitad del embarazo (< 22 sem) aborto,2015-08-01,2,2,4
71201,SAN MATIAS,salud sexual y reproductiva,hemorragia de la primera mitad del embarazo (< 22 sem) aborto,2015-08-01,2,0,2
80401,SANTA ANA,salud sexual y reproductiva,hemorragia de la primera mitad del embarazo (< 22 sem) aborto,2015-08-01,6,0,6
70101,SANTA CRUZ DE LA SIERRA,salud sexual y reproductiva,hemorragia de la primera mitad del embarazo (< 22 sem) aborto,2015-08-01,413,120,533
70602,SANTA ROSA DEL SARA,salud sexual y reproductiva,hemorragia de la primera mitad del embarazo (< 22 sem) aborto,2015-08-01,0,1,1
90303,SENA,salud sexual y reproductiva,hemorragia de la primera mitad del embarazo (< 22 sem) aborto,2015-08-01,0,1,1
31602,SHINAOTA,salud sexual y reproductiva,hemorragia de la primera mitad del embarazo (< 22 sem) aborto,2015-08-01,5,0,5
30902,SIPE SIPE,salud sexual y reproductiva,hemorragia de la primera mitad del embarazo (< 22 sem) aborto,2015-08-01,1,0,1
10403,SOPACHUY,salud sexual y reproductiva,hemorragia de la primera mitad del embarazo (< 22 sem) aborto,2015-08-01,2,0,2
40104,SORACACHI,salud sexual y reproductiva,hemorragia de la primera mitad del embarazo (< 22 sem) aborto,2015-08-01,1,0,1
10101,SUCRE,salud sexual y reproductiva,hemorragia de la primera mitad del embarazo (< 22 sem) aborto,2015-08-01,125,35,160
10601,TARABUCO,salud sexual y reproductiva,hemorragia de la primera mitad del embarazo (< 22 sem) aborto,2015-08-01,0,3,3
20807,TARACO,salud sexual y reproductiva,hemorragia de la primera mitad del embarazo (< 22 sem) aborto,2015-08-01,1,0,1
60101,TARIJA,salud sexual y reproductiva,hemorragia de la primera mitad del embarazo (< 22 sem) aborto,2015-08-01,5,8,13
10202,TARVITA,salud sexual y reproductiva,hemorragia de la primera mitad del embarazo (< 22 sem) aborto,2015-08-01,1,0,1
20803,TIAWANACU,salud sexual y reproductiva,hemorragia de la primera mitad del embarazo (< 22 sem) aborto,2015-08-01,1,2,3
50102,TINGUIPAYA,salud sexual y reproductiva,hemorragia de la primera mitad del embarazo (< 22 sem) aborto,2015-08-01,0,1,1
30903,TIQUIPAYA,salud sexual y reproductiva,hemorragia de la primera mitad del embarazo (< 22 sem) aborto,2015-08-01,6,0,6
30802,TOCO,salud sexual y reproductiva,hemorragia de la primera mitad del embarazo (< 22 sem) aborto,2015-08-01,1,0,1
10402,TOMINA,salud sexual y reproductiva,hemorragia de la primera mitad del embarazo (< 22 sem) aborto,2015-08-01,1,0,1
80101,TRINIDAD,salud sexual y reproductiva,hemorragia de la primera mitad del embarazo (< 22 sem) aborto,2015-08-01,48,0,48
50801,TUPIZA,salud sexual y reproductiva,hemorragia de la primera mitad del embarazo (< 22 sem) aborto,2015-08-01,14,0,14
60401,URIONDO (A. CONCEPCION),salud sexual y reproductiva,hemorragia de la primera mitad del embarazo (< 22 sem) aborto,2015-08-01,0,1,1
51201,UYUNI,salud sexual y reproductiva,hemorragia de la primera mitad del embarazo (< 22 sem) aborto,2015-08-01,17,0,17
31003,VILLA TUNARI,salud sexual y reproductiva,hemorragia de la primera mitad del embarazo (< 22 sem) aborto,2015-08-01,2,50,52
11001,VILLA VACA GUZMAN (MUYUPAMPA),salud sexual y reproductiva,hemorragia de la primera mitad del embarazo (< 22 sem) aborto,2015-08-01,3,0,3
51501,VILLAZON,salud sexual y reproductiva,hemorragia de la primera mitad del embarazo (< 22 sem) aborto,2015-08-01,7,3,10
70201,WARNES,salud sexual y reproductiva,hemorragia de la primera mitad del embarazo (< 22 sem) aborto,2015-08-01,15,1,16
60301,YACUIBA,salud sexual y reproductiva,hemorragia de la primera mitad del embarazo (< 22 sem) aborto,2015-08-01,3,5,8
70403,YAPACANI,salud sexual y reproductiva,hemorragia de la primera mitad del embarazo (< 22 sem) aborto,2015-08-01,1,3,4
10102,YOTALA,salud sexual y reproductiva,hemorragia de la primera mitad del embarazo (< 22 sem) aborto,2015-08-01,2,2,4
30201,AIQUILE,salud sexual y reproductiva,hemorragia de la primera mitad del embarazo (< 22 sem) aborto,2015-09-01,3,0,3
40603,ANTEQUERA,salud sexual y reproductiva,hemorragia de la primera mitad del embarazo (< 22 sem) aborto,2015-09-01,1,0,1
30403,ARBIETO,salud sexual y reproductiva,hemorragia de la primera mitad del embarazo (< 22 sem) aborto,2015-09-01,1,0,1
30301,AYOPAYA (V. DE INDEPENDENCIA),salud sexual y reproductiva,hemorragia de la primera mitad del embarazo (< 22 sem) aborto,2015-09-01,2,0,2
60202,BERMEJO,salud sexual y reproductiva,hemorragia de la primera mitad del embarazo (< 22 sem) aborto,2015-09-01,0,1,1
10701,CAMARGO,salud sexual y reproductiva,hemorragia de la primera mitad del embarazo (< 22 sem) aborto,2015-09-01,3,1,4
70706,CAMIRI,salud sexual y reproductiva,hemorragia de la primera mitad del embarazo (< 22 sem) aborto,2015-09-01,12,1,13
70702,CHARAGUA,salud sexual y reproductiva,hemorragia de la primera mitad del embarazo (< 22 sem) aborto,2015-09-01,5,0,5
21101,CHULUMANI (V. DE LA LIBERTAD),salud sexual y reproductiva,hemorragia de la primera mitad del embarazo (< 22 sem) aborto,2015-09-01,4,3,7
51103,CKOCHAS,salud sexual y reproductiva,hemorragia de la primera mitad del embarazo (< 22 sem) aborto,2015-09-01,0,1,1
30801,CLIZA,salud sexual y reproductiva,hemorragia de la primera mitad del embarazo (< 22 sem) aborto,2015-09-01,11,0,11
90101,COBIJA,salud sexual y reproductiva,hemorragia de la primera mitad del embarazo (< 22 sem) aborto,2015-09-01,17,0,17
30101,COCHABAMBA,salud sexual y reproductiva,hemorragia de la primera mitad del embarazo (< 22 sem) aborto,2015-09-01,183,2,185
30905,COLCAPIRHUA,salud sexual y reproductiva,hemorragia de la primera mitad del embarazo (< 22 sem) aborto,2015-09-01,3,0,3
31002,COLOMI,salud sexual y reproductiva,hemorragia de la primera mitad del embarazo (< 22 sem) aborto,2015-09-01,3,1,4
71301,COMARAPA,salud sexual y reproductiva,hemorragia de la primera mitad del embarazo (< 22 sem) aborto,2015-09-01,2,0,2
71101,CONCEPCION,salud sexual y reproductiva,hemorragia de la primera mitad del embarazo (< 22 sem) aborto,2015-09-01,4,0,4
70102,COTOCA,salud sexual y reproductiva,hemorragia de la primera mitad del embarazo (< 22 sem) aborto,2015-09-01,8,0,8
71106,CUATRO CAÃ‘ADAS,salud sexual y reproductiva,hemorragia de la primera mitad del embarazo (< 22 sem) aborto,2015-09-01,4,0,4
20105,EL ALTO,salud sexual y reproductiva,hemorragia de la primera mitad del embarazo (< 22 sem) aborto,2015-09-01,87,10,97
71503,EL PUENTE(STC),salud sexual y reproductiva,hemorragia de la primera mitad del embarazo (< 22 sem) aborto,2015-09-01,3,1,4
70105,EL TORNO,salud sexual y reproductiva,hemorragia de la primera mitad del embarazo (< 22 sem) aborto,2015-09-01,8,4,12
71004,FERNANDEZ ALONSO,salud sexual y reproductiva,hemorragia de la primera mitad del embarazo (< 22 sem) aborto,2015-09-01,1,0,1
80202,GUAYARAMERIN,salud sexual y reproductiva,hemorragia de la primera mitad del embarazo (< 22 sem) aborto,2015-09-01,2,0,2
40701,HUANUNI,salud sexual y reproductiva,hemorragia de la primera mitad del embarazo (< 22 sem) aborto,2015-09-01,2,1,3
21105,LA ASUNTA,salud sexual y reproductiva,hemorragia de la primera mitad del embarazo (< 22 sem) aborto,2015-09-01,11,0,11
70104,LA GUARDIA,salud sexual y reproductiva,hemorragia de la primera mitad del embarazo (< 22 sem) aborto,2015-09-01,0,12,12
20101,LA PAZ,salud sexual y reproductiva,hemorragia de la primera mitad del embarazo (< 22 sem) aborto,2015-09-01,40,51,91
80801,MAGDALENA,salud sexual y reproductiva,hemorragia de la primera mitad del embarazo (< 22 sem) aborto,2015-09-01,1,1,2
70903,MAIRANA,salud sexual y reproductiva,hemorragia de la primera mitad del embarazo (< 22 sem) aborto,2015-09-01,3,0,3
31301,MIZQUE,salud sexual y reproductiva,hemorragia de la primera mitad del embarazo (< 22 sem) aborto,2015-09-01,1,0,1
10501,MONTEAGUDO,salud sexual y reproductiva,hemorragia de la primera mitad del embarazo (< 22 sem) aborto,2015-09-01,0,1,1
71001,MONTERO,salud sexual y reproductiva,hemorragia de la primera mitad del embarazo (< 22 sem) aborto,2015-09-01,3,0,3
50404,OCURI,salud sexual y reproductiva,hemorragia de la primera mitad del embarazo (< 22 sem) aborto,2015-09-01,0,1,1
40101,ORURO,salud sexual y reproductiva,hemorragia de la primera mitad del embarazo (< 22 sem) aborto,2015-09-01,16,1,17
70502,PAILON,salud sexual y reproductiva,hemorragia de la primera mitad del embarazo (< 22 sem) aborto,2015-09-01,1,1,2
50403,POCOATA,salud sexual y reproductiva,hemorragia de la primera mitad del embarazo (< 22 sem) aborto,2015-09-01,1,0,1
31202,POJO (CBBA),salud sexual y reproductiva,hemorragia de la primera mitad del embarazo (< 22 sem) aborto,2015-09-01,1,0,1
70103,PORONGO,salud sexual y reproductiva,hemorragia de la primera mitad del embarazo (< 22 sem) aborto,2015-09-01,1,0,1
50101,POTOSI,salud sexual y reproductiva,hemorragia de la primera mitad del embarazo (< 22 sem) aborto,2015-09-01,32,3,35
71401,PUERTO SUAREZ,salud sexual y reproductiva,hemorragia de la primera mitad del embarazo (< 22 sem) aborto,2015-09-01,2,0,2
31205,PUERTO VILLARROEL,salud sexual y reproductiva,hemorragia de la primera mitad del embarazo (< 22 sem) aborto,2015-09-01,14,0,14
31401,PUNATA,salud sexual y reproductiva,hemorragia de la primera mitad del embarazo (< 22 sem) aborto,2015-09-01,20,0,20
50402,RAVELO,salud sexual y reproductiva,hemorragia de la primera mitad del embarazo (< 22 sem) aborto,2015-09-01,1,0,1
80301,REYES,salud sexual y reproductiva,hemorragia de la primera mitad del embarazo (< 22 sem) aborto,2015-09-01,3,1,4
80201,RIBERALTA,salud sexual y reproductiva,hemorragia de la primera mitad del embarazo (< 22 sem) aborto,2015-09-01,29,5,34
70503,ROBORE,salud sexual y reproductiva,hemorragia de la primera mitad del embarazo (< 22 sem) aborto,2015-09-01,2,0,2
80304,RURRENABAQUE,salud sexual y reproductiva,hemorragia de la primera mitad del embarazo (< 22 sem) aborto,2015-09-01,11,0,11
31001,SACABA,salud sexual y reproductiva,hemorragia de la primera mitad del embarazo (< 22 sem) aborto,2015-09-01,62,13,75
70901,SAMAIPATA,salud sexual y reproductiva,hemorragia de la primera mitad del embarazo (< 22 sem) aborto,2015-09-01,1,1,2
80302,SAN BORJA,salud sexual y reproductiva,hemorragia de la primera mitad del embarazo (< 22 sem) aborto,2015-09-01,1,0,1
70402,SAN CARLOS,salud sexual y reproductiva,hemorragia de la primera mitad del embarazo (< 22 sem) aborto,2015-09-01,8,0,8
80501,SAN IGNACIO,salud sexual y reproductiva,hemorragia de la primera mitad del embarazo (< 22 sem) aborto,2015-09-01,4,1,5
70301,SAN IGNACIO DE VELASCO,salud sexual y reproductiva,hemorragia de la primera mitad del embarazo (< 22 sem) aborto,2015-09-01,0,20,20
70501,SAN JOSE DE CHIQUITOS,salud sexual y reproductiva,hemorragia de la primera mitad del embarazo (< 22 sem) aborto,2015-09-01,5,0,5
70404,SAN JUAN DE YAPACANI,salud sexual y reproductiva,hemorragia de la primera mitad del embarazo (< 22 sem) aborto,2015-09-01,1,0,1
71104,SAN JULIAN,salud sexual y reproductiva,hemorragia de la primera mitad del embarazo (< 22 sem) aborto,2015-09-01,0,8,8
60501,SAN LORENZO(TJA),salud sexual y reproductiva,hemorragia de la primera mitad del embarazo (< 22 sem) aborto,2015-09-01,2,0,2
10702,SAN LUCAS,salud sexual y reproductiva,hemorragia de la primera mitad del embarazo (< 22 sem) aborto,2015-09-01,2,0,2
71201,SAN MATIAS,salud sexual y reproductiva,hemorragia de la primera mitad del embarazo (< 22 sem) aborto,2015-09-01,3,0,3
70302,SAN MIGUEL DE VELASCO,salud sexual y reproductiva,hemorragia de la primera mitad del embarazo (< 22 sem) aborto,2015-09-01,1,0,1
71005,SAN PEDRO,salud sexual y reproductiva,hemorragia de la primera mitad del embarazo (< 22 sem) aborto,2015-09-01,1,0,1
80702,SAN RAMON BENI,salud sexual y reproductiva,hemorragia de la primera mitad del embarazo (< 22 sem) aborto,2015-09-01,1,2,3
80401,SANTA ANA,salud sexual y reproductiva,hemorragia de la primera mitad del embarazo (< 22 sem) aborto,2015-09-01,8,0,8
70101,SANTA CRUZ DE LA SIERRA,salud sexual y reproductiva,hemorragia de la primera mitad del embarazo (< 22 sem) aborto,2015-09-01,307,109,416
31602,SHINAOTA,salud sexual y reproductiva,hemorragia de la primera mitad del embarazo (< 22 sem) aborto,2015-09-01,9,0,9
40104,SORACACHI,salud sexual y reproductiva,hemorragia de la primera mitad del embarazo (< 22 sem) aborto,2015-09-01,1,0,1
10101,SUCRE,salud sexual y reproductiva,hemorragia de la primera mitad del embarazo (< 22 sem) aborto,2015-09-01,100,9,109
10601,TARABUCO,salud sexual y reproductiva,hemorragia de la primera mitad del embarazo (< 22 sem) aborto,2015-09-01,0,1,1
60101,TARIJA,salud sexual y reproductiva,hemorragia de la primera mitad del embarazo (< 22 sem) aborto,2015-09-01,33,0,33
10202,TARVITA,salud sexual y reproductiva,hemorragia de la primera mitad del embarazo (< 22 sem) aborto,2015-09-01,1,0,1
20803,TIAWANACU,salud sexual y reproductiva,hemorragia de la primera mitad del embarazo (< 22 sem) aborto,2015-09-01,0,2,2
80101,TRINIDAD,salud sexual y reproductiva,hemorragia de la primera mitad del embarazo (< 22 sem) aborto,2015-09-01,69,0,69
50801,TUPIZA,salud sexual y reproductiva,hemorragia de la primera mitad del embarazo (< 22 sem) aborto,2015-09-01,14,0,14
71502,URUBICHA,salud sexual y reproductiva,hemorragia de la primera mitad del embarazo (< 22 sem) aborto,2015-09-01,0,1,1
51201,UYUNI,salud sexual y reproductiva,hemorragia de la primera mitad del embarazo (< 22 sem) aborto,2015-09-01,7,0,7
70801,VALLEGRANDE,salud sexual y reproductiva,hemorragia de la primera mitad del embarazo (< 22 sem) aborto,2015-09-01,1,0,1
10704,VILLA CHARCAS,salud sexual y reproductiva,hemorragia de la primera mitad del embarazo (< 22 sem) aborto,2015-09-01,0,1,1
31003,VILLA TUNARI,salud sexual y reproductiva,hemorragia de la primera mitad del embarazo (< 22 sem) aborto,2015-09-01,1,1,2
51501,VILLAZON,salud sexual y reproductiva,hemorragia de la primera mitad del embarazo (< 22 sem) aborto,2015-09-01,5,0,5
70201,WARNES,salud sexual y reproductiva,hemorragia de la primera mitad del embarazo (< 22 sem) aborto,2015-09-01,27,0,27
60301,YACUIBA,salud sexual y reproductiva,hemorragia de la primera mitad del embarazo (< 22 sem) aborto,2015-09-01,2,6,8
70403,YAPACANI,salud sexual y reproductiva,hemorragia de la primera mitad del embarazo (< 22 sem) aborto,2015-09-01,7,6,13
10102,YOTALA,salud sexual y reproductiva,hemorragia de la primera mitad del embarazo (< 22 sem) aborto,2015-09-01,1,0,1
10301,ZUDAÃ‘EZ,salud sexual y reproductiva,hemorragia de la primera mitad del embarazo (< 22 sem) aborto,2015-09-01,2,0,2
30201,AIQUILE,salud sexual y reproductiva,hemorragia de la primera mitad del embarazo (< 22 sem) aborto,2015-10-01,10,0,10
71501,ASCENCION DE GUARAYOS,salud sexual y reproductiva,hemorragia de la primera mitad del embarazo (< 22 sem) aborto,2015-10-01,0,2,2
10201,AZURDUY,salud sexual y reproductiva,hemorragia de la primera mitad del embarazo (< 22 sem) aborto,2015-10-01,0,2,2
60202,BERMEJO,salud sexual y reproductiva,hemorragia de la primera mitad del embarazo (< 22 sem) aborto,2015-10-01,2,2,4
10701,CAMARGO,salud sexual y reproductiva,hemorragia de la primera mitad del embarazo (< 22 sem) aborto,2015-10-01,0,1,1
70706,CAMIRI,salud sexual y reproductiva,hemorragia de la primera mitad del embarazo (< 22 sem) aborto,2015-10-01,23,2,25
30701,CAPINOTA,salud sexual y reproductiva,hemorragia de la primera mitad del embarazo (< 22 sem) aborto,2015-10-01,2,0,2
40102,CARACOLLO,salud sexual y reproductiva,hemorragia de la primera mitad del embarazo (< 22 sem) aborto,2015-10-01,0,2,2
40201,CHALLAPATA,salud sexual y reproductiva,hemorragia de la primera mitad del embarazo (< 22 sem) aborto,2015-10-01,1,0,1
70702,CHARAGUA,salud sexual y reproductiva,hemorragia de la primera mitad del embarazo (< 22 sem) aborto,2015-10-01,4,0,4
21101,CHULUMANI (V. DE LA LIBERTAD),salud sexual y reproductiva,hemorragia de la primera mitad del embarazo (< 22 sem) aborto,2015-10-01,2,0,2
51103,CKOCHAS,salud sexual y reproductiva,hemorragia de la primera mitad del embarazo (< 22 sem) aborto,2015-10-01,0,2,2
30801,CLIZA,salud sexual y reproductiva,hemorragia de la primera mitad del embarazo (< 22 sem) aborto,2015-10-01,14,0,14
90101,COBIJA,salud sexual y reproductiva,hemorragia de la primera mitad del embarazo (< 22 sem) aborto,2015-10-01,23,0,23
30101,COCHABAMBA,salud sexual y reproductiva,hemorragia de la primera mitad del embarazo (< 22 sem) aborto,2015-10-01,58,128,186
30905,COLCAPIRHUA,salud sexual y reproductiva,hemorragia de la primera mitad del embarazo (< 22 sem) aborto,2015-10-01,1,0,1
31002,COLOMI,salud sexual y reproductiva,hemorragia de la primera mitad del embarazo (< 22 sem) aborto,2015-10-01,1,0,1
71301,COMARAPA,salud sexual y reproductiva,hemorragia de la primera mitad del embarazo (< 22 sem) aborto,2015-10-01,10,0,10
71101,CONCEPCION,salud sexual y reproductiva,hemorragia de la primera mitad del embarazo (< 22 sem) aborto,2015-10-01,1,0,1
70102,COTOCA,salud sexual y reproductiva,hemorragia de la primera mitad del embarazo (< 22 sem) aborto,2015-10-01,5,0,5
71106,CUATRO CAÃ‘ADAS,salud sexual y reproductiva,hemorragia de la primera mitad del embarazo (< 22 sem) aborto,2015-10-01,2,0,2
20105,EL ALTO,salud sexual y reproductiva,hemorragia de la primera mitad del embarazo (< 22 sem) aborto,2015-10-01,77,13,90
70105,EL TORNO,salud sexual y reproductiva,hemorragia de la primera mitad del embarazo (< 22 sem) aborto,2015-10-01,6,6,12
20405,ESCOMA,salud sexual y reproductiva,hemorragia de la primera mitad del embarazo (< 22 sem) aborto,2015-10-01,0,2,2
71004,FERNANDEZ ALONSO,salud sexual y reproductiva,hemorragia de la primera mitad del embarazo (< 22 sem) aborto,2015-10-01,1,0,1
71002,GENERAL SAAVEDRA,salud sexual y reproductiva,hemorragia de la primera mitad del embarazo (< 22 sem) aborto,2015-10-01,0,1,1
80202,GUAYARAMERIN,salud sexual y reproductiva,hemorragia de la primera mitad del embarazo (< 22 sem) aborto,2015-10-01,3,1,4
40701,HUANUNI,salud sexual y reproductiva,hemorragia de la primera mitad del embarazo (< 22 sem) aborto,2015-10-01,5,0,5
10703,INCAHUASI,salud sexual y reproductiva,hemorragia de la primera mitad del embarazo (< 22 sem) aborto,2015-10-01,1,0,1
21105,LA ASUNTA,salud sexual y reproductiva,hemorragia de la primera mitad del embarazo (< 22 sem) aborto,2015-10-01,6,0,6
70104,LA GUARDIA,salud sexual y reproductiva,hemorragia de la primera mitad del embarazo (< 22 sem) aborto,2015-10-01,0,5,5
20101,LA PAZ,salud sexual y reproductiva,hemorragia de la primera mitad del embarazo (< 22 sem) aborto,2015-10-01,50,49,99
70701,LAGUNILLAS,salud sexual y reproductiva,hemorragia de la primera mitad del embarazo (< 22 sem) aborto,2015-10-01,0,1,1
21202,LAJA,salud sexual y reproductiva,hemorragia de la primera mitad del embarazo (< 22 sem) aborto,2015-10-01,0,1,1
11003,MACHARETI,salud sexual y reproductiva,hemorragia de la primera mitad del embarazo (< 22 sem) aborto,2015-10-01,2,0,2
70903,MAIRANA,salud sexual y reproductiva,hemorragia de la primera mitad del embarazo (< 22 sem) aborto,2015-10-01,5,0,5
10501,MONTEAGUDO,salud sexual y reproductiva,hemorragia de la primera mitad del embarazo (< 22 sem) aborto,2015-10-01,2,1,3
71001,MONTERO,salud sexual y reproductiva,hemorragia de la primera mitad del embarazo (< 22 sem) aborto,2015-10-01,5,0,5
30302,MOROCHATA,salud sexual y reproductiva,hemorragia de la primera mitad del embarazo (< 22 sem) aborto,2015-10-01,1,0,1
40101,ORURO,salud sexual y reproductiva,hemorragia de la primera mitad del embarazo (< 22 sem) aborto,2015-10-01,13,0,13
60201,PADCAYA,salud sexual y reproductiva,hemorragia de la primera mitad del embarazo (< 22 sem) aborto,2015-10-01,0,1,1
70502,PAILON,salud sexual y reproductiva,hemorragia de la primera mitad del embarazo (< 22 sem) aborto,2015-10-01,2,0,2
50403,POCOATA,salud sexual y reproductiva,hemorragia de la primera mitad del embarazo (< 22 sem) aborto,2015-10-01,0,1,1
31203,POCONA,salud sexual y reproductiva,hemorragia de la primera mitad del embarazo (< 22 sem) aborto,2015-10-01,0,1,1
31202,POJO (CBBA),salud sexual y reproductiva,hemorragia de la primera mitad del embarazo (< 22 sem) aborto,2015-10-01,1,0,1
10103,POROMA,salud sexual y reproductiva,hemorragia de la primera mitad del embarazo (< 22 sem) aborto,2015-10-01,0,1,1
70601,PORTACHUELO,salud sexual y reproductiva,hemorragia de la primera mitad del embarazo (< 22 sem) aborto,2015-10-01,2,0,2
50101,POTOSI,salud sexual y reproductiva,hemorragia de la primera mitad del embarazo (< 22 sem) aborto,2015-10-01,25,6,31
21201,PUCARANI,salud sexual y reproductiva,hemorragia de la primera mitad del embarazo (< 22 sem) aborto,2015-10-01,0,1,1
90201,PUERTO RICO,salud sexual y reproductiva,hemorragia de la primera mitad del embarazo (< 22 sem) aborto,2015-10-01,1,0,1
71401,PUERTO SUAREZ,salud sexual y reproductiva,hemorragia de la primera mitad del embarazo (< 22 sem) aborto,2015-10-01,12,0,12
31205,PUERTO VILLARROEL,salud sexual y reproductiva,hemorragia de la primera mitad del embarazo (< 22 sem) aborto,2015-10-01,12,0,12
51101,PUNA,salud sexual y reproductiva,hemorragia de la primera mitad del embarazo (< 22 sem) aborto,2015-10-01,1,0,1
31401,PUNATA,salud sexual y reproductiva,hemorragia de la primera mitad del embarazo (< 22 sem) aborto,2015-10-01,17,0,17
50402,RAVELO,salud sexual y reproductiva,hemorragia de la primera mitad del embarazo (< 22 sem) aborto,2015-10-01,1,0,1
80301,REYES,salud sexual y reproductiva,hemorragia de la primera mitad del embarazo (< 22 sem) aborto,2015-10-01,5,0,5
80201,RIBERALTA,salud sexual y reproductiva,hemorragia de la primera mitad del embarazo (< 22 sem) aborto,2015-10-01,31,3,34
80304,RURRENABAQUE,salud sexual y reproductiva,hemorragia de la primera mitad del embarazo (< 22 sem) aborto,2015-10-01,11,0,11
31001,SACABA,salud sexual y reproductiva,hemorragia de la primera mitad del embarazo (< 22 sem) aborto,2015-10-01,47,7,54
40801,SALINAS DE GARCI MENDOZA,salud sexual y reproductiva,hemorragia de la primera mitad del embarazo (< 22 sem) aborto,2015-10-01,1,0,1
70901,SAMAIPATA,salud sexual y reproductiva,hemorragia de la primera mitad del embarazo (< 22 sem) aborto,2015-10-01,1,0,1
21502,SAN BUENA VENTURA,salud sexual y reproductiva,hemorragia de la primera mitad del embarazo (< 22 sem) aborto,2015-10-01,0,1,1
70402,SAN CARLOS,salud sexual y reproductiva,hemorragia de la primera mitad del embarazo (< 22 sem) aborto,2015-10-01,4,0,4
80501,SAN IGNACIO,salud sexual y reproductiva,hemorragia de la primera mitad del embarazo (< 22 sem) aborto,2015-10-01,3,0,3
70301,SAN IGNACIO DE VELASCO,salud sexual y reproductiva,hemorragia de la primera mitad del embarazo (< 22 sem) aborto,2015-10-01,0,9,9
70501,SAN JOSE DE CHIQUITOS,salud sexual y reproductiva,hemorragia de la primera mitad del embarazo (< 22 sem) aborto,2015-10-01,4,1,5
70404,SAN JUAN DE YAPACANI,salud sexual y reproductiva,hemorragia de la primera mitad del embarazo (< 22 sem) aborto,2015-10-01,0,1,1
71104,SAN JULIAN,salud sexual y reproductiva,hemorragia de la primera mitad del embarazo (< 22 sem) aborto,2015-10-01,10,0,10
10702,SAN LUCAS,salud sexual y reproductiva,hemorragia de la primera mitad del embarazo (< 22 sem) aborto,2015-10-01,2,1,3
71201,SAN MATIAS,salud sexual y reproductiva,hemorragia de la primera mitad del embarazo (< 22 sem) aborto,2015-10-01,4,0,4
70303,SAN RAFAEL,salud sexual y reproductiva,hemorragia de la primera mitad del embarazo (< 22 sem) aborto,2015-10-01,2,0,2
80401,SANTA ANA,salud sexual y reproductiva,hemorragia de la primera mitad del embarazo (< 22 sem) aborto,2015-10-01,5,0,5
70101,SANTA CRUZ DE LA SIERRA,salud sexual y reproductiva,hemorragia de la primera mitad del embarazo (< 22 sem) aborto,2015-10-01,342,67,409
70602,SANTA ROSA DEL SARA,salud sexual y reproductiva,hemorragia de la primera mitad del embarazo (< 22 sem) aborto,2015-10-01,1,0,1
31602,SHINAOTA,salud sexual y reproductiva,hemorragia de la primera mitad del embarazo (< 22 sem) aborto,2015-10-01,7,0,7
10101,SUCRE,salud sexual y reproductiva,hemorragia de la primera mitad del embarazo (< 22 sem) aborto,2015-10-01,84,8,92
50303,TACOBAMBA,salud sexual y reproductiva,hemorragia de la primera mitad del embarazo (< 22 sem) aborto,2015-10-01,2,0,2
10601,TARABUCO,salud sexual y reproductiva,hemorragia de la primera mitad del embarazo (< 22 sem) aborto,2015-10-01,0,2,2
60101,TARIJA,salud sexual y reproductiva,hemorragia de la primera mitad del embarazo (< 22 sem) aborto,2015-10-01,67,0,67
20803,TIAWANACU,salud sexual y reproductiva,hemorragia de la primera mitad del embarazo (< 22 sem) aborto,2015-10-01,0,3,3
10402,TOMINA,salud sexual y reproductiva,hemorragia de la primera mitad del embarazo (< 22 sem) aborto,2015-10-01,1,0,1
31201,TOTORA(CBBA),salud sexual y reproductiva,hemorragia de la primera mitad del embarazo (< 22 sem) aborto,2015-10-01,2,0,2
80101,TRINIDAD,salud sexual y reproductiva,hemorragia de la primera mitad del embarazo (< 22 sem) aborto,2015-10-01,31,0,31
50801,TUPIZA,salud sexual y reproductiva,hemorragia de la primera mitad del embarazo (< 22 sem) aborto,2015-10-01,7,0,7
51201,UYUNI,salud sexual y reproductiva,hemorragia de la primera mitad del embarazo (< 22 sem) aborto,2015-10-01,7,0,7
10801,VILLA SERRANO,salud sexual y reproductiva,hemorragia de la primera mitad del embarazo (< 22 sem) aborto,2015-10-01,0,1,1
31003,VILLA TUNARI,salud sexual y reproductiva,hemorragia de la primera mitad del embarazo (< 22 sem) aborto,2015-10-01,32,3,35
51501,VILLAZON,salud sexual y reproductiva,hemorragia de la primera mitad del embarazo (< 22 sem) aborto,2015-10-01,0,4,4
30904,VINTO,salud sexual y reproductiva,hemorragia de la primera mitad del embarazo (< 22 sem) aborto,2015-10-01,1,0,1
70201,WARNES,salud sexual y reproductiva,hemorragia de la primera mitad del embarazo (< 22 sem) aborto,2015-10-01,40,0,40
60301,YACUIBA,salud sexual y reproductiva,hemorragia de la primera mitad del embarazo (< 22 sem) aborto,2015-10-01,2,22,24
70403,YAPACANI,salud sexual y reproductiva,hemorragia de la primera mitad del embarazo (< 22 sem) aborto,2015-10-01,7,1,8
20201,ACHACACHI,salud sexual y reproductiva,hemorragia de la primera mitad del embarazo (< 22 sem) aborto,2015-11-01,1,0,1
30201,AIQUILE,salud sexual y reproductiva,hemorragia de la primera mitad del embarazo (< 22 sem) aborto,2015-11-01,10,0,10
40603,ANTEQUERA,salud sexual y reproductiva,hemorragia de la primera mitad del embarazo (< 22 sem) aborto,2015-11-01,4,0,4
71501,ASCENCION DE GUARAYOS,salud sexual y reproductiva,hemorragia de la primera mitad del embarazo (< 22 sem) aborto,2015-11-01,0,1,1
30301,AYOPAYA (V. DE INDEPENDENCIA),salud sexual y reproductiva,hemorragia de la primera mitad del embarazo (< 22 sem) aborto,2015-11-01,1,0,1
20905,CAIROMA,salud sexual y reproductiva,hemorragia de la primera mitad del embarazo (< 22 sem) aborto,2015-11-01,0,1,1
10701,CAMARGO,salud sexual y reproductiva,hemorragia de la primera mitad del embarazo (< 22 sem) aborto,2015-11-01,1,1,2
70706,CAMIRI,salud sexual y reproductiva,hemorragia de la primera mitad del embarazo (< 22 sem) aborto,2015-11-01,15,0,15
30701,CAPINOTA,salud sexual y reproductiva,hemorragia de la primera mitad del embarazo (< 22 sem) aborto,2015-11-01,2,0,2
40102,CARACOLLO,salud sexual y reproductiva,hemorragia de la primera mitad del embarazo (< 22 sem) aborto,2015-11-01,7,2,9
70702,CHARAGUA,salud sexual y reproductiva,hemorragia de la primera mitad del embarazo (< 22 sem) aborto,2015-11-01,1,0,1
40903,CHIPAYA,salud sexual y reproductiva,hemorragia de la primera mitad del embarazo (< 22 sem) aborto,2015-11-01,0,1,1
21101,CHULUMANI (V. DE LA LIBERTAD),salud sexual y reproductiva,hemorragia de la primera mitad del embarazo (< 22 sem) aborto,2015-11-01,3,0,3
30801,CLIZA,salud sexual y reproductiva,hemorragia de la primera mitad del embarazo (< 22 sem) aborto,2015-11-01,9,0,9
90101,COBIJA,salud sexual y reproductiva,hemorragia de la primera mitad del embarazo (< 22 sem) aborto,2015-11-01,26,1,27
30101,COCHABAMBA,salud sexual y reproductiva,hemorragia de la primera mitad del embarazo (< 22 sem) aborto,2015-11-01,204,4,208
30905,COLCAPIRHUA,salud sexual y reproductiva,hemorragia de la primera mitad del embarazo (< 22 sem) aborto,2015-11-01,1,0,1
31002,COLOMI,salud sexual y reproductiva,hemorragia de la primera mitad del embarazo (< 22 sem) aborto,2015-11-01,4,1,5
71301,COMARAPA,salud sexual y reproductiva,hemorragia de la primera mitad del embarazo (< 22 sem) aborto,2015-11-01,1,3,4
71101,CONCEPCION,salud sexual y reproductiva,hemorragia de la primera mitad del embarazo (< 22 sem) aborto,2015-11-01,3,0,3
70102,COTOCA,salud sexual y reproductiva,hemorragia de la primera mitad del embarazo (< 22 sem) aborto,2015-11-01,9,0,9
71106,CUATRO CAÃ‘ADAS,salud sexual y reproductiva,hemorragia de la primera mitad del embarazo (< 22 sem) aborto,2015-11-01,5,2,7
20105,EL ALTO,salud sexual y reproductiva,hemorragia de la primera mitad del embarazo (< 22 sem) aborto,2015-11-01,128,3,131
70105,EL TORNO,salud sexual y reproductiva,hemorragia de la primera mitad del embarazo (< 22 sem) aborto,2015-11-01,3,3,6
20405,ESCOMA,salud sexual y reproductiva,hemorragia de la primera mitad del embarazo (< 22 sem) aborto,2015-11-01,0,1,1
80202,GUAYARAMERIN,salud sexual y reproductiva,hemorragia de la primera mitad del embarazo (< 22 sem) aborto,2015-11-01,1,0,1
40701,HUANUNI,salud sexual y reproductiva,hemorragia de la primera mitad del embarazo (< 22 sem) aborto,2015-11-01,5,0,5
10304,ICLA,salud sexual y reproductiva,hemorragia de la primera mitad del embarazo (< 22 sem) aborto,2015-11-01,1,0,1
10703,INCAHUASI,salud sexual y reproductiva,hemorragia de la primera mitad del embarazo (< 22 sem) aborto,2015-11-01,1,0,1
21105,LA ASUNTA,salud sexual y reproductiva,hemorragia de la primera mitad del embarazo (< 22 sem) aborto,2015-11-01,2,0,2
70104,LA GUARDIA,salud sexual y reproductiva,hemorragia de la primera mitad del embarazo (< 22 sem) aborto,2015-11-01,1,5,6
20101,LA PAZ,salud sexual y reproductiva,hemorragia de la primera mitad del embarazo (< 22 sem) aborto,2015-11-01,62,35,97
10903,LAS CARRERAS,salud sexual y reproductiva,hemorragia de la primera mitad del embarazo (< 22 sem) aborto,2015-11-01,1,0,1
80801,MAGDALENA,salud sexual y reproductiva,hemorragia de la primera mitad del embarazo (< 22 sem) aborto,2015-11-01,0,1,1
70903,MAIRANA,salud sexual y reproductiva,hemorragia de la primera mitad del embarazo (< 22 sem) aborto,2015-11-01,2,0,2
31301,MIZQUE,salud sexual y reproductiva,hemorragia de la primera mitad del embarazo (< 22 sem) aborto,2015-11-01,2,0,2
71001,MONTERO,salud sexual y reproductiva,hemorragia de la primera mitad del embarazo (< 22 sem) aborto,2015-11-01,7,0,7
30302,MOROCHATA,salud sexual y reproductiva,hemorragia de la primera mitad del embarazo (< 22 sem) aborto,2015-11-01,0,2,2
40101,ORURO,salud sexual y reproductiva,hemorragia de la primera mitad del embarazo (< 22 sem) aborto,2015-11-01,13,0,13
60201,PADCAYA,salud sexual y reproductiva,hemorragia de la primera mitad del embarazo (< 22 sem) aborto,2015-11-01,2,0,2
70502,PAILON,salud sexual y reproductiva,hemorragia de la primera mitad del embarazo (< 22 sem) aborto,2015-11-01,3,0,3
21104,PALOS BLANCOS,salud sexual y reproductiva,hemorragia de la primera mitad del embarazo (< 22 sem) aborto,2015-11-01,4,0,4
40602,PAZÃ‘A,salud sexual y reproductiva,hemorragia de la primera mitad del embarazo (< 22 sem) aborto,2015-11-01,1,0,1
10103,POROMA,salud sexual y reproductiva,hemorragia de la primera mitad del embarazo (< 22 sem) aborto,2015-11-01,1,0,1
50101,POTOSI,salud sexual y reproductiva,hemorragia de la primera mitad del embarazo (< 22 sem) aborto,2015-11-01,36,3,39
71401,PUERTO SUAREZ,salud sexual y reproductiva,hemorragia de la primera mitad del embarazo (< 22 sem) aborto,2015-11-01,4,0,4
31205,PUERTO VILLARROEL,salud sexual y reproductiva,hemorragia de la primera mitad del embarazo (< 22 sem) aborto,2015-11-01,0,20,20
31401,PUNATA,salud sexual y reproductiva,hemorragia de la primera mitad del embarazo (< 22 sem) aborto,2015-11-01,20,0,20
30901,QUILLACOLLO,salud sexual y reproductiva,hemorragia de la primera mitad del embarazo (< 22 sem) aborto,2015-11-01,81,0,81
80301,REYES,salud sexual y reproductiva,hemorragia de la primera mitad del embarazo (< 22 sem) aborto,2015-11-01,8,0,8
80201,RIBERALTA,salud sexual y reproductiva,hemorragia de la primera mitad del embarazo (< 22 sem) aborto,2015-11-01,17,0,17
70503,ROBORE,salud sexual y reproductiva,hemorragia de la primera mitad del embarazo (< 22 sem) aborto,2015-11-01,6,0,6
80304,RURRENABAQUE,salud sexual y reproductiva,hemorragia de la primera mitad del embarazo (< 22 sem) aborto,2015-11-01,13,0,13
31001,SACABA,salud sexual y reproductiva,hemorragia de la primera mitad del embarazo (< 22 sem) aborto,2015-11-01,42,7,49
40801,SALINAS DE GARCI MENDOZA,salud sexual y reproductiva,hemorragia de la primera mitad del embarazo (< 22 sem) aborto,2015-11-01,0,1,1
70901,SAMAIPATA,salud sexual y reproductiva,hemorragia de la primera mitad del embarazo (< 22 sem) aborto,2015-11-01,1,0,1
71105,SAN ANTONIO DE LOMERIO,salud sexual y reproductiva,hemorragia de la primera mitad del embarazo (< 22 sem) aborto,2015-11-01,1,0,1
70402,SAN CARLOS,salud sexual y reproductiva,hemorragia de la primera mitad del embarazo (< 22 sem) aborto,2015-11-01,3,0,3
80501,SAN IGNACIO,salud sexual y reproductiva,hemorragia de la primera mitad del embarazo (< 22 sem) aborto,2015-11-01,2,1,3
70301,SAN IGNACIO DE VELASCO,salud sexual y reproductiva,hemorragia de la primera mitad del embarazo (< 22 sem) aborto,2015-11-01,0,9,9
71102,SAN JAVIER(STC),salud sexual y reproductiva,hemorragia de la primera mitad del embarazo (< 22 sem) aborto,2015-11-01,1,0,1
70501,SAN JOSE DE CHIQUITOS,salud sexual y reproductiva,hemorragia de la primera mitad del embarazo (< 22 sem) aborto,2015-11-01,4,0,4
71104,SAN JULIAN,salud sexual y reproductiva,hemorragia de la primera mitad del embarazo (< 22 sem) aborto,2015-11-01,15,5,20
90302,SAN LORENZO(PND),salud sexual y reproductiva,hemorragia de la primera mitad del embarazo (< 22 sem) aborto,2015-11-01,0,1,1
71201,SAN MATIAS,salud sexual y reproductiva,hemorragia de la primera mitad del embarazo (< 22 sem) aborto,2015-11-01,0,1,1
70302,SAN MIGUEL DE VELASCO,salud sexual y reproductiva,hemorragia de la primera mitad del embarazo (< 22 sem) aborto,2015-11-01,2,0,2
80401,SANTA ANA,salud sexual y reproductiva,hemorragia de la primera mitad del embarazo (< 22 sem) aborto,2015-11-01,6,0,6
70101,SANTA CRUZ DE LA SIERRA,salud sexual y reproductiva,hemorragia de la primera mitad del embarazo (< 22 sem) aborto,2015-11-01,388,116,504
31602,SHINAOTA,salud sexual y reproductiva,hemorragia de la primera mitad del embarazo (< 22 sem) aborto,2015-11-01,3,0,3
40104,SORACACHI,salud sexual y reproductiva,hemorragia de la primera mitad del embarazo (< 22 sem) aborto,2015-11-01,1,0,1
10101,SUCRE,salud sexual y reproductiva,hemorragia de la primera mitad del embarazo (< 22 sem) aborto,2015-11-01,98,9,107
50303,TACOBAMBA,salud sexual y reproductiva,hemorragia de la primera mitad del embarazo (< 22 sem) aborto,2015-11-01,0,1,1
10601,TARABUCO,salud sexual y reproductiva,hemorragia de la primera mitad del embarazo (< 22 sem) aborto,2015-11-01,0,2,2
60101,TARIJA,salud sexual y reproductiva,hemorragia de la primera mitad del embarazo (< 22 sem) aborto,2015-11-01,75,0,75
10202,TARVITA,salud sexual y reproductiva,hemorragia de la primera mitad del embarazo (< 22 sem) aborto,2015-11-01,0,1,1
30802,TOCO,salud sexual y reproductiva,hemorragia de la primera mitad del embarazo (< 22 sem) aborto,2015-11-01,1,0,1
10402,TOMINA,salud sexual y reproductiva,hemorragia de la primera mitad del embarazo (< 22 sem) aborto,2015-11-01,0,2,2
80101,TRINIDAD,salud sexual y reproductiva,hemorragia de la primera mitad del embarazo (< 22 sem) aborto,2015-11-01,40,4,44
50801,TUPIZA,salud sexual y reproductiva,hemorragia de la primera mitad del embarazo (< 22 sem) aborto,2015-11-01,7,0,7
51201,UYUNI,salud sexual y reproductiva,hemorragia de la primera mitad del embarazo (< 22 sem) aborto,2015-11-01,5,0,5
31003,VILLA TUNARI,salud sexual y reproductiva,hemorragia de la primera mitad del embarazo (< 22 sem) aborto,2015-11-01,4,5,9
51501,VILLAZON,salud sexual y reproductiva,hemorragia de la primera mitad del embarazo (< 22 sem) aborto,2015-11-01,3,4,7
30904,VINTO,salud sexual y reproductiva,hemorragia de la primera mitad del embarazo (< 22 sem) aborto,2015-11-01,2,0,2
70201,WARNES,salud sexual y reproductiva,hemorragia de la primera mitad del embarazo (< 22 sem) aborto,2015-11-01,34,0,34
60301,YACUIBA,salud sexual y reproductiva,hemorragia de la primera mitad del embarazo (< 22 sem) aborto,2015-11-01,0,8,8
70403,YAPACANI,salud sexual y reproductiva,hemorragia de la primera mitad del embarazo (< 22 sem) aborto,2015-11-01,2,0,2
10102,YOTALA,salud sexual y reproductiva,hemorragia de la primera mitad del embarazo (< 22 sem) aborto,2015-11-01,3,0,3
30201,AIQUILE,salud sexual y reproductiva,hemorragia de la primera mitad del embarazo (< 22 sem) aborto,2015-12-01,2,0,2
71501,ASCENCION DE GUARAYOS,salud sexual y reproductiva,hemorragia de la primera mitad del embarazo (< 22 sem) aborto,2015-12-01,3,1,4
60202,BERMEJO,salud sexual y reproductiva,hemorragia de la primera mitad del embarazo (< 22 sem) aborto,2015-12-01,2,0,2
51102,"CAIZA ""D""",salud sexual y reproductiva,hemorragia de la primera mitad del embarazo (< 22 sem) aborto,2015-12-01,2,0,2
21304,CALAMARCA,salud sexual y reproductiva,hemorragia de la primera mitad del embarazo (< 22 sem) aborto,2015-12-01,0,1,1
10701,CAMARGO,salud sexual y reproductiva,hemorragia de la primera mitad del embarazo (< 22 sem) aborto,2015-12-01,2,1,3
70706,CAMIRI,salud sexual y reproductiva,hemorragia de la primera mitad del embarazo (< 22 sem) aborto,2015-12-01,16,1,17
30701,CAPINOTA,salud sexual y reproductiva,hemorragia de la primera mitad del embarazo (< 22 sem) aborto,2015-12-01,4,0,4
40102,CARACOLLO,salud sexual y reproductiva,hemorragia de la primera mitad del embarazo (< 22 sem) aborto,2015-12-01,2,2,4
22001,CARANAVI,salud sexual y reproductiva,hemorragia de la primera mitad del embarazo (< 22 sem) aborto,2015-12-01,1,0,1
50702,CARIPUYO,salud sexual y reproductiva,hemorragia de la primera mitad del embarazo (< 22 sem) aborto,2015-12-01,0,1,1
70702,CHARAGUA,salud sexual y reproductiva,hemorragia de la primera mitad del embarazo (< 22 sem) aborto,2015-12-01,1,0,1
21101,CHULUMANI (V. DE LA LIBERTAD),salud sexual y reproductiva,hemorragia de la primera mitad del embarazo (< 22 sem) aborto,2015-12-01,2,2,4
90101,COBIJA,salud sexual y reproductiva,hemorragia de la primera mitad del embarazo (< 22 sem) aborto,2015-12-01,25,0,25
30101,COCHABAMBA,salud sexual y reproductiva,hemorragia de la primera mitad del embarazo (< 22 sem) aborto,2015-12-01,212,36,248
30905,COLCAPIRHUA,salud sexual y reproductiva,hemorragia de la primera mitad del embarazo (< 22 sem) aborto,2015-12-01,1,0,1
31002,COLOMI,salud sexual y reproductiva,hemorragia de la primera mitad del embarazo (< 22 sem) aborto,2015-12-01,3,0,3
71301,COMARAPA,salud sexual y reproductiva,hemorragia de la primera mitad del embarazo (< 22 sem) aborto,2015-12-01,10,0,10
71101,CONCEPCION,salud sexual y reproductiva,hemorragia de la primera mitad del embarazo (< 22 sem) aborto,2015-12-01,2,0,2
70102,COTOCA,salud sexual y reproductiva,hemorragia de la primera mitad del embarazo (< 22 sem) aborto,2015-12-01,5,0,5
71106,CUATRO CAÃ‘ADAS,salud sexual y reproductiva,hemorragia de la primera mitad del embarazo (< 22 sem) aborto,2015-12-01,4,0,4
20105,EL ALTO,salud sexual y reproductiva,hemorragia de la primera mitad del embarazo (< 22 sem) aborto,2015-12-01,135,3,138
71503,EL PUENTE(STC),salud sexual y reproductiva,hemorragia de la primera mitad del embarazo (< 22 sem) aborto,2015-12-01,2,0,2
70105,EL TORNO,salud sexual y reproductiva,hemorragia de la primera mitad del embarazo (< 22 sem) aborto,2015-12-01,13,0,13
20405,ESCOMA,salud sexual y reproductiva,hemorragia de la primera mitad del embarazo (< 22 sem) aborto,2015-12-01,0,2,2
80202,GUAYARAMERIN,salud sexual y reproductiva,hemorragia de la primera mitad del embarazo (< 22 sem) aborto,2015-12-01,1,5,6
40701,HUANUNI,salud sexual y reproductiva,hemorragia de la primera mitad del embarazo (< 22 sem) aborto,2015-12-01,8,0,8
20806,JESUS DE MACHACA,salud sexual y reproductiva,hemorragia de la primera mitad del embarazo (< 22 sem) aborto,2015-12-01,0,1,1
21105,LA ASUNTA,salud sexual y reproductiva,hemorragia de la primera mitad del embarazo (< 22 sem) aborto,2015-12-01,7,0,7
70104,LA GUARDIA,salud sexual y reproductiva,hemorragia de la primera mitad del embarazo (< 22 sem) aborto,2015-12-01,0,11,11
20101,LA PAZ,salud sexual y reproductiva,hemorragia de la primera mitad del embarazo (< 22 sem) aborto,2015-12-01,51,38,89
70903,MAIRANA,salud sexual y reproductiva,hemorragia de la primera mitad del embarazo (< 22 sem) aborto,2015-12-01,3,2,5
10501,MONTEAGUDO,salud sexual y reproductiva,hemorragia de la primera mitad del embarazo (< 22 sem) aborto,2015-12-01,5,0,5
71001,MONTERO,salud sexual y reproductiva,hemorragia de la primera mitad del embarazo (< 22 sem) aborto,2015-12-01,1,0,1
30302,MOROCHATA,salud sexual y reproductiva,hemorragia de la primera mitad del embarazo (< 22 sem) aborto,2015-12-01,1,0,1
40101,ORURO,salud sexual y reproductiva,hemorragia de la primera mitad del embarazo (< 22 sem) aborto,2015-12-01,10,0,10
10401,PADILLA,salud sexual y reproductiva,hemorragia de la primera mitad del embarazo (< 22 sem) aborto,2015-12-01,1,0,1
70502,PAILON,salud sexual y reproductiva,hemorragia de la primera mitad del embarazo (< 22 sem) aborto,2015-12-01,1,0,1
50101,POTOSI,salud sexual y reproductiva,hemorragia de la primera mitad del embarazo (< 22 sem) aborto,2015-12-01,32,1,33
21201,PUCARANI,salud sexual y reproductiva,hemorragia de la primera mitad del embarazo (< 22 sem) aborto,2015-12-01,1,0,1
90301,PUERTO GONZALO MORENO,salud sexual y reproductiva,hemorragia de la primera mitad del embarazo (< 22 sem) aborto,2015-12-01,1,0,1
71401,PUERTO SUAREZ,salud sexual y reproductiva,hemorragia de la primera mitad del embarazo (< 22 sem) aborto,2015-12-01,6,0,6
31205,PUERTO VILLARROEL,salud sexual y reproductiva,hemorragia de la primera mitad del embarazo (< 22 sem) aborto,2015-12-01,0,30,30
31401,PUNATA,salud sexual y reproductiva,hemorragia de la primera mitad del embarazo (< 22 sem) aborto,2015-12-01,15,0,15
30901,QUILLACOLLO,salud sexual y reproductiva,hemorragia de la primera mitad del embarazo (< 22 sem) aborto,2015-12-01,68,0,68
80301,REYES,salud sexual y reproductiva,hemorragia de la primera mitad del embarazo (< 22 sem) aborto,2015-12-01,1,0,1
80201,RIBERALTA,salud sexual y reproductiva,hemorragia de la primera mitad del embarazo (< 22 sem) aborto,2015-12-01,17,0,17
70503,ROBORE,salud sexual y reproductiva,hemorragia de la primera mitad del embarazo (< 22 sem) aborto,2015-12-01,1,0,1
80304,RURRENABAQUE,salud sexual y reproductiva,hemorragia de la primera mitad del embarazo (< 22 sem) aborto,2015-12-01,4,0,4
31001,SACABA,salud sexual y reproductiva,hemorragia de la primera mitad del embarazo (< 22 sem) aborto,2015-12-01,49,3,52
80302,SAN BORJA,salud sexual y reproductiva,hemorragia de la primera mitad del embarazo (< 22 sem) aborto,2015-12-01,22,0,22
70402,SAN CARLOS,salud sexual y reproductiva,hemorragia de la primera mitad del embarazo (< 22 sem) aborto,2015-12-01,5,0,5
80501,SAN IGNACIO,salud sexual y reproductiva,hemorragia de la primera mitad del embarazo (< 22 sem) aborto,2015-12-01,5,0,5
70301,SAN IGNACIO DE VELASCO,salud sexual y reproductiva,hemorragia de la primera mitad del embarazo (< 22 sem) aborto,2015-12-01,1,10,11
70501,SAN JOSE DE CHIQUITOS,salud sexual y reproductiva,hemorragia de la primera mitad del embarazo (< 22 sem) aborto,2015-12-01,7,0,7
71104,SAN JULIAN,salud sexual y reproductiva,hemorragia de la primera mitad del embarazo (< 22 sem) aborto,2015-12-01,10,0,10
10702,SAN LUCAS,salud sexual y reproductiva,hemorragia de la primera mitad del embarazo (< 22 sem) aborto,2015-12-01,1,1,2
70302,SAN MIGUEL DE VELASCO,salud sexual y reproductiva,hemorragia de la primera mitad del embarazo (< 22 sem) aborto,2015-12-01,1,0,1
71005,SAN PEDRO,salud sexual y reproductiva,hemorragia de la primera mitad del embarazo (< 22 sem) aborto,2015-12-01,1,0,1
50501,SAN PEDRO DE BUENA VISTA,salud sexual y reproductiva,hemorragia de la primera mitad del embarazo (< 22 sem) aborto,2015-12-01,1,1,2
80702,SAN RAMON BENI,salud sexual y reproductiva,hemorragia de la primera mitad del embarazo (< 22 sem) aborto,2015-12-01,1,0,1
80401,SANTA ANA,salud sexual y reproductiva,hemorragia de la primera mitad del embarazo (< 22 sem) aborto,2015-12-01,4,0,4
70101,SANTA CRUZ DE LA SIERRA,salud sexual y reproductiva,hemorragia de la primera mitad del embarazo (< 22 sem) aborto,2015-12-01,293,128,421
21301,SICA SICA (VILLA AROMA),salud sexual y reproductiva,hemorragia de la primera mitad del embarazo (< 22 sem) aborto,2015-12-01,1,0,1
10101,SUCRE,salud sexual y reproductiva,hemorragia de la primera mitad del embarazo (< 22 sem) aborto,2015-12-01,104,7,111
50303,TACOBAMBA,salud sexual y reproductiva,hemorragia de la primera mitad del embarazo (< 22 sem) aborto,2015-12-01,1,0,1
30602,TACOPAYA,salud sexual y reproductiva,hemorragia de la primera mitad del embarazo (< 22 sem) aborto,2015-12-01,0,1,1
10601,TARABUCO,salud sexual y reproductiva,hemorragia de la primera mitad del embarazo (< 22 sem) aborto,2015-12-01,0,1,1
60101,TARIJA,salud sexual y reproductiva,hemorragia de la primera mitad del embarazo (< 22 sem) aborto,2015-12-01,72,0,72
41301,TOTORA(ORR),salud sexual y reproductiva,hemorragia de la primera mitad del embarazo (< 22 sem) aborto,2015-12-01,0,1,1
80101,TRINIDAD,salud sexual y reproductiva,hemorragia de la primera mitad del embarazo (< 22 sem) aborto,2015-12-01,40,0,40
50801,TUPIZA,salud sexual y reproductiva,hemorragia de la primera mitad del embarazo (< 22 sem) aborto,2015-12-01,8,0,8
50201,UNCIA,salud sexual y reproductiva,hemorragia de la primera mitad del embarazo (< 22 sem) aborto,2015-12-01,0,1,1
51201,UYUNI,salud sexual y reproductiva,hemorragia de la primera mitad del embarazo (< 22 sem) aborto,2015-12-01,20,0,20
31003,VILLA TUNARI,salud sexual y reproductiva,hemorragia de la primera mitad del embarazo (< 22 sem) aborto,2015-12-01,31,2,33
51501,VILLAZON,salud sexual y reproductiva,hemorragia de la primera mitad del embarazo (< 22 sem) aborto,2015-12-01,6,5,11
70201,WARNES,salud sexual y reproductiva,hemorragia de la primera mitad del embarazo (< 22 sem) aborto,2015-12-01,26,0,26
60301,YACUIBA,salud sexual y reproductiva,hemorragia de la primera mitad del embarazo (< 22 sem) aborto,2015-12-01,1,15,16
70403,YAPACANI,salud sexual y reproductiva,hemorragia de la primera mitad del embarazo (< 22 sem) aborto,2015-12-01,5,1,6
20201,ACHACACHI,salud sexual y reproductiva,hemorragia de la primera mitad del embarazo (< 22 sem) aborto,2016-01-01,0,1,1
30201,AIQUILE,salud sexual y reproductiva,hemorragia de la primera mitad del embarazo (< 22 sem) aborto,2016-01-01,5,0,5
22002,ALTO BENI,salud sexual y reproductiva,hemorragia de la primera mitad del embarazo (< 22 sem) aborto,2016-01-01,0,1,1
71501,ASCENCION DE GUARAYOS,salud sexual y reproductiva,hemorragia de la primera mitad del embarazo (< 22 sem) aborto,2016-01-01,0,1,1
70703,CABEZAS,salud sexual y reproductiva,hemorragia de la primera mitad del embarazo (< 22 sem) aborto,2016-01-01,0,2,2
51102,"CAIZA ""D""",salud sexual y reproductiva,hemorragia de la primera mitad del embarazo (< 22 sem) aborto,2016-01-01,0,1,1
10701,CAMARGO,salud sexual y reproductiva,hemorragia de la primera mitad del embarazo (< 22 sem) aborto,2016-01-01,5,2,7
70706,CAMIRI,salud sexual y reproductiva,hemorragia de la primera mitad del embarazo (< 22 sem) aborto,2016-01-01,11,0,11
30701,CAPINOTA,salud sexual y reproductiva,hemorragia de la primera mitad del embarazo (< 22 sem) aborto,2016-01-01,4,0,4
60302,CARAPARI,salud sexual y reproductiva,hemorragia de la primera mitad del embarazo (< 22 sem) aborto,2016-01-01,1,0,1
71403,CARMEN RIVERO TORREZ,salud sexual y reproductiva,hemorragia de la primera mitad del embarazo (< 22 sem) aborto,2016-01-01,0,1,1
40201,CHALLAPATA,salud sexual y reproductiva,hemorragia de la primera mitad del embarazo (< 22 sem) aborto,2016-01-01,1,0,1
70702,CHARAGUA,salud sexual y reproductiva,hemorragia de la primera mitad del embarazo (< 22 sem) aborto,2016-01-01,4,0,4
21101,CHULUMANI (V. DE LA LIBERTAD),salud sexual y reproductiva,hemorragia de la primera mitad del embarazo (< 22 sem) aborto,2016-01-01,2,0,2
51103,CKOCHAS,salud sexual y reproductiva,hemorragia de la primera mitad del embarazo (< 22 sem) aborto,2016-01-01,1,0,1
30801,CLIZA,salud sexual y reproductiva,hemorragia de la primera mitad del embarazo (< 22 sem) aborto,2016-01-01,5,0,5
90101,COBIJA,salud sexual y reproductiva,hemorragia de la primera mitad del embarazo (< 22 sem) aborto,2016-01-01,19,0,19
30101,COCHABAMBA,salud sexual y reproductiva,hemorragia de la primera mitad del embarazo (< 22 sem) aborto,2016-01-01,157,9,166
30905,COLCAPIRHUA,salud sexual y reproductiva,hemorragia de la primera mitad del embarazo (< 22 sem) aborto,2016-01-01,1,0,1
31002,COLOMI,salud sexual y reproductiva,hemorragia de la primera mitad del embarazo (< 22 sem) aborto,2016-01-01,1,0,1
50401,COLQUECHACA,salud sexual y reproductiva,hemorragia de la primera mitad del embarazo (< 22 sem) aborto,2016-01-01,3,0,3
71301,COMARAPA,salud sexual y reproductiva,hemorragia de la primera mitad del embarazo (< 22 sem) aborto,2016-01-01,5,0,5
40301,CORQUE,salud sexual y reproductiva,hemorragia de la primera mitad del embarazo (< 22 sem) aborto,2016-01-01,1,0,1
70102,COTOCA,salud sexual y reproductiva,hemorragia de la primera mitad del embarazo (< 22 sem) aborto,2016-01-01,3,1,4
71106,CUATRO CAÃ‘ADAS,salud sexual y reproductiva,hemorragia de la primera mitad del embarazo (< 22 sem) aborto,2016-01-01,2,0,2
20105,EL ALTO,salud sexual y reproductiva,hemorragia de la primera mitad del embarazo (< 22 sem) aborto,2016-01-01,94,3,97
70105,EL TORNO,salud sexual y reproductiva,hemorragia de la primera mitad del embarazo (< 22 sem) aborto,2016-01-01,3,0,3
20405,ESCOMA,salud sexual y reproductiva,hemorragia de la primera mitad del embarazo (< 22 sem) aborto,2016-01-01,0,3,3
80202,GUAYARAMERIN,salud sexual y reproductiva,hemorragia de la primera mitad del embarazo (< 22 sem) aborto,2016-01-01,13,0,13
40701,HUANUNI,salud sexual y reproductiva,hemorragia de la primera mitad del embarazo (< 22 sem) aborto,2016-01-01,3,0,3
21105,LA ASUNTA,salud sexual y reproductiva,hemorragia de la primera mitad del embarazo (< 22 sem) aborto,2016-01-01,11,0,11
70104,LA GUARDIA,salud sexual y reproductiva,hemorragia de la primera mitad del embarazo (< 22 sem) aborto,2016-01-01,0,1,1
20101,LA PAZ,salud sexual y reproductiva,hemorragia de la primera mitad del embarazo (< 22 sem) aborto,2016-01-01,48,2,50
21202,LAJA,salud sexual y reproductiva,hemorragia de la primera mitad del embarazo (< 22 sem) aborto,2016-01-01,0,1,1
70903,MAIRANA,salud sexual y reproductiva,hemorragia de la primera mitad del embarazo (< 22 sem) aborto,2016-01-01,2,0,2
31301,MIZQUE,salud sexual y reproductiva,hemorragia de la primera mitad del embarazo (< 22 sem) aborto,2016-01-01,1,0,1
10501,MONTEAGUDO,salud sexual y reproductiva,hemorragia de la primera mitad del embarazo (< 22 sem) aborto,2016-01-01,3,0,3
71001,MONTERO,salud sexual y reproductiva,hemorragia de la primera mitad del embarazo (< 22 sem) aborto,2016-01-01,4,1,5
40101,ORURO,salud sexual y reproductiva,hemorragia de la primera mitad del embarazo (< 22 sem) aborto,2016-01-01,5,0,5
10401,PADILLA,salud sexual y reproductiva,hemorragia de la primera mitad del embarazo (< 22 sem) aborto,2016-01-01,4,0,4
21802,PAPEL PAMPA,salud sexual y reproductiva,hemorragia de la primera mitad del embarazo (< 22 sem) aborto,2016-01-01,0,1,1
50403,POCOATA,salud sexual y reproductiva,hemorragia de la primera mitad del embarazo (< 22 sem) aborto,2016-01-01,1,0,1
10103,POROMA,salud sexual y reproductiva,hemorragia de la primera mitad del embarazo (< 22 sem) aborto,2016-01-01,1,0,1
70601,PORTACHUELO,salud sexual y reproductiva,hemorragia de la primera mitad del embarazo (< 22 sem) aborto,2016-01-01,3,0,3
50101,POTOSI,salud sexual y reproductiva,hemorragia de la primera mitad del embarazo (< 22 sem) aborto,2016-01-01,28,0,28
90301,PUERTO GONZALO MORENO,salud sexual y reproductiva,hemorragia de la primera mitad del embarazo (< 22 sem) aborto,2016-01-01,1,0,1
71401,PUERTO SUAREZ,salud sexual y reproductiva,hemorragia de la primera mitad del embarazo (< 22 sem) aborto,2016-01-01,9,0,9
31205,PUERTO VILLARROEL,salud sexual y reproductiva,hemorragia de la primera mitad del embarazo (< 22 sem) aborto,2016-01-01,11,0,11
31401,PUNATA,salud sexual y reproductiva,hemorragia de la primera mitad del embarazo (< 22 sem) aborto,2016-01-01,1,0,1
30901,QUILLACOLLO,salud sexual y reproductiva,hemorragia de la primera mitad del embarazo (< 22 sem) aborto,2016-01-01,59,0,59
50402,RAVELO,salud sexual y reproductiva,hemorragia de la primera mitad del embarazo (< 22 sem) aborto,2016-01-01,1,0,1
80301,REYES,salud sexual y reproductiva,hemorragia de la primera mitad del embarazo (< 22 sem) aborto,2016-01-01,1,0,1
80201,RIBERALTA,salud sexual y reproductiva,hemorragia de la primera mitad del embarazo (< 22 sem) aborto,2016-01-01,21,0,21
80304,RURRENABAQUE,salud sexual y reproductiva,hemorragia de la primera mitad del embarazo (< 22 sem) aborto,2016-01-01,8,0,8
31001,SACABA,salud sexual y reproductiva,hemorragia de la primera mitad del embarazo (< 22 sem) aborto,2016-01-01,52,6,58
70901,SAMAIPATA,salud sexual y reproductiva,hemorragia de la primera mitad del embarazo (< 22 sem) aborto,2016-01-01,1,0,1
70402,SAN CARLOS,salud sexual y reproductiva,hemorragia de la primera mitad del embarazo (< 22 sem) aborto,2016-01-01,3,1,4
70301,SAN IGNACIO DE VELASCO,salud sexual y reproductiva,hemorragia de la primera mitad del embarazo (< 22 sem) aborto,2016-01-01,0,10,10
71104,SAN JULIAN,salud sexual y reproductiva,hemorragia de la primera mitad del embarazo (< 22 sem) aborto,2016-01-01,15,0,15
10702,SAN LUCAS,salud sexual y reproductiva,hemorragia de la primera mitad del embarazo (< 22 sem) aborto,2016-01-01,2,0,2
70302,SAN MIGUEL DE VELASCO,salud sexual y reproductiva,hemorragia de la primera mitad del embarazo (< 22 sem) aborto,2016-01-01,3,0,3
80702,SAN RAMON BENI,salud sexual y reproductiva,hemorragia de la primera mitad del embarazo (< 22 sem) aborto,2016-01-01,1,0,1
71103,SAN RAMON SCZ,salud sexual y reproductiva,hemorragia de la primera mitad del embarazo (< 22 sem) aborto,2016-01-01,1,0,1
80401,SANTA ANA,salud sexual y reproductiva,hemorragia de la primera mitad del embarazo (< 22 sem) aborto,2016-01-01,13,0,13
70101,SANTA CRUZ DE LA SIERRA,salud sexual y reproductiva,hemorragia de la primera mitad del embarazo (< 22 sem) aborto,2016-01-01,345,93,438
90303,SENA,salud sexual y reproductiva,hemorragia de la primera mitad del embarazo (< 22 sem) aborto,2016-01-01,2,0,2
30703,SICAYA,salud sexual y reproductiva,hemorragia de la primera mitad del embarazo (< 22 sem) aborto,2016-01-01,1,0,1
10101,SUCRE,salud sexual y reproductiva,hemorragia de la primera mitad del embarazo (< 22 sem) aborto,2016-01-01,79,4,83
10601,TARABUCO,salud sexual y reproductiva,hemorragia de la primera mitad del embarazo (< 22 sem) aborto,2016-01-01,0,6,6
60101,TARIJA,salud sexual y reproductiva,hemorragia de la primera mitad del embarazo (< 22 sem) aborto,2016-01-01,36,0,36
20803,TIAWANACU,salud sexual y reproductiva,hemorragia de la primera mitad del embarazo (< 22 sem) aborto,2016-01-01,0,2,2
50102,TINGUIPAYA,salud sexual y reproductiva,hemorragia de la primera mitad del embarazo (< 22 sem) aborto,2016-01-01,0,1,1
80101,TRINIDAD,salud sexual y reproductiva,hemorragia de la primera mitad del embarazo (< 22 sem) aborto,2016-01-01,56,0,56
50801,TUPIZA,salud sexual y reproductiva,hemorragia de la primera mitad del embarazo (< 22 sem) aborto,2016-01-01,22,0,22
71502,URUBICHA,salud sexual y reproductiva,hemorragia de la primera mitad del embarazo (< 22 sem) aborto,2016-01-01,0,1,1
51201,UYUNI,salud sexual y reproductiva,hemorragia de la primera mitad del embarazo (< 22 sem) aborto,2016-01-01,16,0,16
31003,VILLA TUNARI,salud sexual y reproductiva,hemorragia de la primera mitad del embarazo (< 22 sem) aborto,2016-01-01,28,9,37
51501,VILLAZON,salud sexual y reproductiva,hemorragia de la primera mitad del embarazo (< 22 sem) aborto,2016-01-01,1,0,1
30904,VINTO,salud sexual y reproductiva,hemorragia de la primera mitad del embarazo (< 22 sem) aborto,2016-01-01,1,0,1
70201,WARNES,salud sexual y reproductiva,hemorragia de la primera mitad del embarazo (< 22 sem) aborto,2016-01-01,31,0,31
60301,YACUIBA,salud sexual y reproductiva,hemorragia de la primera mitad del embarazo (< 22 sem) aborto,2016-01-01,1,1,2
70403,YAPACANI,salud sexual y reproductiva,hemorragia de la primera mitad del embarazo (< 22 sem) aborto,2016-01-01,6,0,6
10102,YOTALA,salud sexual y reproductiva,hemorragia de la primera mitad del embarazo (< 22 sem) aborto,2016-01-01,1,0,1
10301,ZUDAÃ‘EZ,salud sexual y reproductiva,hemorragia de la primera mitad del embarazo (< 22 sem) aborto,2016-01-01,0,1,1
30201,AIQUILE,salud sexual y reproductiva,hemorragia de la primera mitad del embarazo (< 22 sem) aborto,2016-02-01,4,0,4
30402,ANZALDO,salud sexual y reproductiva,hemorragia de la primera mitad del embarazo (< 22 sem) aborto,2016-02-01,1,0,1
30501,ARANI,salud sexual y reproductiva,hemorragia de la primera mitad del embarazo (< 22 sem) aborto,2016-02-01,1,0,1
71501,ASCENCION DE GUARAYOS,salud sexual y reproductiva,hemorragia de la primera mitad del embarazo (< 22 sem) aborto,2016-02-01,8,0,8
70707,BOYUIBE,salud sexual y reproductiva,hemorragia de la primera mitad del embarazo (< 22 sem) aborto,2016-02-01,0,1,1
70703,CABEZAS,salud sexual y reproductiva,hemorragia de la primera mitad del embarazo (< 22 sem) aborto,2016-02-01,1,0,1
10701,CAMARGO,salud sexual y reproductiva,hemorragia de la primera mitad del embarazo (< 22 sem) aborto,2016-02-01,0,2,2
70706,CAMIRI,salud sexual y reproductiva,hemorragia de la primera mitad del embarazo (< 22 sem) aborto,2016-02-01,6,0,6
30701,CAPINOTA,salud sexual y reproductiva,hemorragia de la primera mitad del embarazo (< 22 sem) aborto,2016-02-01,0,3,3
22001,CARANAVI,salud sexual y reproductiva,hemorragia de la primera mitad del embarazo (< 22 sem) aborto,2016-02-01,22,0,22
70702,CHARAGUA,salud sexual y reproductiva,hemorragia de la primera mitad del embarazo (< 22 sem) aborto,2016-02-01,7,0,7
21101,CHULUMANI (V. DE LA LIBERTAD),salud sexual y reproductiva,hemorragia de la primera mitad del embarazo (< 22 sem) aborto,2016-02-01,4,0,4
30801,CLIZA,salud sexual y reproductiva,hemorragia de la primera mitad del embarazo (< 22 sem) aborto,2016-02-01,2,0,2
90101,COBIJA,salud sexual y reproductiva,hemorragia de la primera mitad del embarazo (< 22 sem) aborto,2016-02-01,25,0,25
30101,COCHABAMBA,salud sexual y reproductiva,hemorragia de la primera mitad del embarazo (< 22 sem) aborto,2016-02-01,155,18,173
30905,COLCAPIRHUA,salud sexual y reproductiva,hemorragia de la primera mitad del embarazo (< 22 sem) aborto,2016-02-01,6,6,12
31002,COLOMI,salud sexual y reproductiva,hemorragia de la primera mitad del embarazo (< 22 sem) aborto,2016-02-01,3,0,3
71301,COMARAPA,salud sexual y reproductiva,hemorragia de la primera mitad del embarazo (< 22 sem) aborto,2016-02-01,3,0,3
71101,CONCEPCION,salud sexual y reproductiva,hemorragia de la primera mitad del embarazo (< 22 sem) aborto,2016-02-01,4,0,4
21401,COROICO,salud sexual y reproductiva,hemorragia de la primera mitad del embarazo (< 22 sem) aborto,2016-02-01,10,0,10
20105,EL ALTO,salud sexual y reproductiva,hemorragia de la primera mitad del embarazo (< 22 sem) aborto,2016-02-01,41,6,47
71503,EL PUENTE(STC),salud sexual y reproductiva,hemorragia de la primera mitad del embarazo (< 22 sem) aborto,2016-02-01,2,0,2
60502,EL PUENTE(TJA),salud sexual y reproductiva,hemorragia de la primera mitad del embarazo (< 22 sem) aborto,2016-02-01,0,2,2
70105,EL TORNO,salud sexual y reproductiva,hemorragia de la primera mitad del embarazo (< 22 sem) aborto,2016-02-01,12,0,12
90203,FILADELFIA,salud sexual y reproductiva,hemorragia de la primera mitad del embarazo (< 22 sem) aborto,2016-02-01,2,0,2
80202,GUAYARAMERIN,salud sexual y reproductiva,hemorragia de la primera mitad del embarazo (< 22 sem) aborto,2016-02-01,14,1,15
40701,HUANUNI,salud sexual y reproductiva,hemorragia de la primera mitad del embarazo (< 22 sem) aborto,2016-02-01,5,0,5
20204,HUARINA,salud sexual y reproductiva,hemorragia de la primera mitad del embarazo (< 22 sem) aborto,2016-02-01,1,0,1
21501,IXIAMAS,salud sexual y reproductiva,hemorragia de la primera mitad del embarazo (< 22 sem) aborto,2016-02-01,1,0,1
20806,JESUS DE MACHACA,salud sexual y reproductiva,hemorragia de la primera mitad del embarazo (< 22 sem) aborto,2016-02-01,0,1,1
21105,LA ASUNTA,salud sexual y reproductiva,hemorragia de la primera mitad del embarazo (< 22 sem) aborto,2016-02-01,1,0,1
20101,LA PAZ,salud sexual y reproductiva,hemorragia de la primera mitad del embarazo (< 22 sem) aborto,2016-02-01,90,22,112
80801,MAGDALENA,salud sexual y reproductiva,hemorragia de la primera mitad del embarazo (< 22 sem) aborto,2016-02-01,0,1,1
70903,MAIRANA,salud sexual y reproductiva,hemorragia de la primera mitad del embarazo (< 22 sem) aborto,2016-02-01,2,0,2
20607,MAPIRI,salud sexual y reproductiva,hemorragia de la primera mitad del embarazo (< 22 sem) aborto,2016-02-01,1,0,1
10501,MONTEAGUDO,salud sexual y reproductiva,hemorragia de la primera mitad del embarazo (< 22 sem) aborto,2016-02-01,1,0,1
71001,MONTERO,salud sexual y reproductiva,hemorragia de la primera mitad del embarazo (< 22 sem) aborto,2016-02-01,0,4,4
50404,OCURI,salud sexual y reproductiva,hemorragia de la primera mitad del embarazo (< 22 sem) aborto,2016-02-01,0,1,1
40101,ORURO,salud sexual y reproductiva,hemorragia de la primera mitad del embarazo (< 22 sem) aborto,2016-02-01,8,2,10
10401,PADILLA,salud sexual y reproductiva,hemorragia de la primera mitad del embarazo (< 22 sem) aborto,2016-02-01,3,0,3
21104,PALOS BLANCOS,salud sexual y reproductiva,hemorragia de la primera mitad del embarazo (< 22 sem) aborto,2016-02-01,1,1,2
50403,POCOATA,salud sexual y reproductiva,hemorragia de la primera mitad del embarazo (< 22 sem) aborto,2016-02-01,1,2,3
31203,POCONA,salud sexual y reproductiva,hemorragia de la primera mitad del embarazo (< 22 sem) aborto,2016-02-01,1,0,1
70601,PORTACHUELO,salud sexual y reproductiva,hemorragia de la primera mitad del embarazo (< 22 sem) aborto,2016-02-01,4,0,4
50101,POTOSI,salud sexual y reproductiva,hemorragia de la primera mitad del embarazo (< 22 sem) aborto,2016-02-01,41,1,42
21201,PUCARANI,salud sexual y reproductiva,hemorragia de la primera mitad del embarazo (< 22 sem) aborto,2016-02-01,4,0,4
90301,PUERTO GONZALO MORENO,salud sexual y reproductiva,hemorragia de la primera mitad del embarazo (< 22 sem) aborto,2016-02-01,1,0,1
90201,PUERTO RICO,salud sexual y reproductiva,hemorragia de la primera mitad del embarazo (< 22 sem) aborto,2016-02-01,3,1,4
71401,PUERTO SUAREZ,salud sexual y reproductiva,hemorragia de la primera mitad del embarazo (< 22 sem) aborto,2016-02-01,5,0,5
31205,PUERTO VILLARROEL,salud sexual y reproductiva,hemorragia de la primera mitad del embarazo (< 22 sem) aborto,2016-02-01,13,0,13
51101,PUNA,salud sexual y reproductiva,hemorragia de la primera mitad del embarazo (< 22 sem) aborto,2016-02-01,1,0,1
30901,QUILLACOLLO,salud sexual y reproductiva,hemorragia de la primera mitad del embarazo (< 22 sem) aborto,2016-02-01,46,0,46
80301,REYES,salud sexual y reproductiva,hemorragia de la primera mitad del embarazo (< 22 sem) aborto,2016-02-01,4,0,4
80201,RIBERALTA,salud sexual y reproductiva,hemorragia de la primera mitad del embarazo (< 22 sem) aborto,2016-02-01,31,0,31
70503,ROBORE,salud sexual y reproductiva,hemorragia de la primera mitad del embarazo (< 22 sem) aborto,2016-02-01,5,0,5
80304,RURRENABAQUE,salud sexual y reproductiva,hemorragia de la primera mitad del embarazo (< 22 sem) aborto,2016-02-01,4,0,4
31001,SACABA,salud sexual y reproductiva,hemorragia de la primera mitad del embarazo (< 22 sem) aborto,2016-02-01,35,4,39
70901,SAMAIPATA,salud sexual y reproductiva,hemorragia de la primera mitad del embarazo (< 22 sem) aborto,2016-02-01,0,1,1
80302,SAN BORJA,salud sexual y reproductiva,hemorragia de la primera mitad del embarazo (< 22 sem) aborto,2016-02-01,24,0,24
70402,SAN CARLOS,salud sexual y reproductiva,hemorragia de la primera mitad del embarazo (< 22 sem) aborto,2016-02-01,1,0,1
80501,SAN IGNACIO,salud sexual y reproductiva,hemorragia de la primera mitad del embarazo (< 22 sem) aborto,2016-02-01,2,0,2
70301,SAN IGNACIO DE VELASCO,salud sexual y reproductiva,hemorragia de la primera mitad del embarazo (< 22 sem) aborto,2016-02-01,0,13,13
70501,SAN JOSE DE CHIQUITOS,salud sexual y reproductiva,hemorragia de la primera mitad del embarazo (< 22 sem) aborto,2016-02-01,9,0,9
71104,SAN JULIAN,salud sexual y reproductiva,hemorragia de la primera mitad del embarazo (< 22 sem) aborto,2016-02-01,24,0,24
10702,SAN LUCAS,salud sexual y reproductiva,hemorragia de la primera mitad del embarazo (< 22 sem) aborto,2016-02-01,0,1,1
71201,SAN MATIAS,salud sexual y reproductiva,hemorragia de la primera mitad del embarazo (< 22 sem) aborto,2016-02-01,2,0,2
70302,SAN MIGUEL DE VELASCO,salud sexual y reproductiva,hemorragia de la primera mitad del embarazo (< 22 sem) aborto,2016-02-01,1,0,1
71005,SAN PEDRO,salud sexual y reproductiva,hemorragia de la primera mitad del embarazo (< 22 sem) aborto,2016-02-01,2,0,2
70303,SAN RAFAEL,salud sexual y reproductiva,hemorragia de la primera mitad del embarazo (< 22 sem) aborto,2016-02-01,1,0,1
71103,SAN RAMON SCZ,salud sexual y reproductiva,hemorragia de la primera mitad del embarazo (< 22 sem) aborto,2016-02-01,3,0,3
80401,SANTA ANA,salud sexual y reproductiva,hemorragia de la primera mitad del embarazo (< 22 sem) aborto,2016-02-01,7,1,8
70101,SANTA CRUZ DE LA SIERRA,salud sexual y reproductiva,hemorragia de la primera mitad del embarazo (< 22 sem) aborto,2016-02-01,247,76,323
30702,SANTIVAÃ‘ES,salud sexual y reproductiva,hemorragia de la primera mitad del embarazo (< 22 sem) aborto,2016-02-01,1,0,1
31602,SHINAOTA,salud sexual y reproductiva,hemorragia de la primera mitad del embarazo (< 22 sem) aborto,2016-02-01,6,0,6
21301,SICA SICA (VILLA AROMA),salud sexual y reproductiva,hemorragia de la primera mitad del embarazo (< 22 sem) aborto,2016-02-01,1,0,1
10101,SUCRE,salud sexual y reproductiva,hemorragia de la primera mitad del embarazo (< 22 sem) aborto,2016-02-01,92,6,98
50303,TACOBAMBA,salud sexual y reproductiva,hemorragia de la primera mitad del embarazo (< 22 sem) aborto,2016-02-01,0,1,1
10601,TARABUCO,salud sexual y reproductiva,hemorragia de la primera mitad del embarazo (< 22 sem) aborto,2016-02-01,0,3,3
60101,TARIJA,salud sexual y reproductiva,hemorragia de la primera mitad del embarazo (< 22 sem) aborto,2016-02-01,38,0,38
10202,TARVITA,salud sexual y reproductiva,hemorragia de la primera mitad del embarazo (< 22 sem) aborto,2016-02-01,1,0,1
50102,TINGUIPAYA,salud sexual y reproductiva,hemorragia de la primera mitad del embarazo (< 22 sem) aborto,2016-02-01,0,1,1
20606,TIPUANI,salud sexual y reproductiva,hemorragia de la primera mitad del embarazo (< 22 sem) aborto,2016-02-01,1,0,1
30903,TIQUIPAYA,salud sexual y reproductiva,hemorragia de la primera mitad del embarazo (< 22 sem) aborto,2016-02-01,1,0,1
10402,TOMINA,salud sexual y reproductiva,hemorragia de la primera mitad del embarazo (< 22 sem) aborto,2016-02-01,0,2,2
80101,TRINIDAD,salud sexual y reproductiva,hemorragia de la primera mitad del embarazo (< 22 sem) aborto,2016-02-01,37,0,37
50801,TUPIZA,salud sexual y reproductiva,hemorragia de la primera mitad del embarazo (< 22 sem) aborto,2016-02-01,9,0,9
40402,TURCO,salud sexual y reproductiva,hemorragia de la primera mitad del embarazo (< 22 sem) aborto,2016-02-01,1,0,1
51201,UYUNI,salud sexual y reproductiva,hemorragia de la primera mitad del embarazo (< 22 sem) aborto,2016-02-01,0,15,15
31302,VILA VILA,salud sexual y reproductiva,hemorragia de la primera mitad del embarazo (< 22 sem) aborto,2016-02-01,0,1,1
31402,VILLA RIVERO,salud sexual y reproductiva,hemorragia de la primera mitad del embarazo (< 22 sem) aborto,2016-02-01,1,0,1
31003,VILLA TUNARI,salud sexual y reproductiva,hemorragia de la primera mitad del embarazo (< 22 sem) aborto,2016-02-01,26,1,27
51501,VILLAZON,salud sexual y reproductiva,hemorragia de la primera mitad del embarazo (< 22 sem) aborto,2016-02-01,6,4,10
70201,WARNES,salud sexual y reproductiva,hemorragia de la primera mitad del embarazo (< 22 sem) aborto,2016-02-01,21,0,21
60301,YACUIBA,salud sexual y reproductiva,hemorragia de la primera mitad del embarazo (< 22 sem) aborto,2016-02-01,2,3,5
21103,YANACACHI,salud sexual y reproductiva,hemorragia de la primera mitad del embarazo (< 22 sem) aborto,2016-02-01,1,0,1
70403,YAPACANI,salud sexual y reproductiva,hemorragia de la primera mitad del embarazo (< 22 sem) aborto,2016-02-01,17,0,17
10102,YOTALA,salud sexual y reproductiva,hemorragia de la primera mitad del embarazo (< 22 sem) aborto,2016-02-01,0,2,2
30201,AIQUILE,salud sexual y reproductiva,hemorragia de la primera mitad del embarazo (< 22 sem) aborto,2016-03-01,4,0,4
22002,ALTO BENI,salud sexual y reproductiva,hemorragia de la primera mitad del embarazo (< 22 sem) aborto,2016-03-01,1,0,1
30501,ARANI,salud sexual y reproductiva,hemorragia de la primera mitad del embarazo (< 22 sem) aborto,2016-03-01,2,0,2
30403,ARBIETO,salud sexual y reproductiva,hemorragia de la primera mitad del embarazo (< 22 sem) aborto,2016-03-01,3,0,3
71501,ASCENCION DE GUARAYOS,salud sexual y reproductiva,hemorragia de la primera mitad del embarazo (< 22 sem) aborto,2016-03-01,2,1,3
80802,BAURES,salud sexual y reproductiva,hemorragia de la primera mitad del embarazo (< 22 sem) aborto,2016-03-01,1,0,1
60202,BERMEJO,salud sexual y reproductiva,hemorragia de la primera mitad del embarazo (< 22 sem) aborto,2016-03-01,1,1,2
10701,CAMARGO,salud sexual y reproductiva,hemorragia de la primera mitad del embarazo (< 22 sem) aborto,2016-03-01,0,1,1
70706,CAMIRI,salud sexual y reproductiva,hemorragia de la primera mitad del embarazo (< 22 sem) aborto,2016-03-01,3,3,6
30701,CAPINOTA,salud sexual y reproductiva,hemorragia de la primera mitad del embarazo (< 22 sem) aborto,2016-03-01,0,1,1
22001,CARANAVI,salud sexual y reproductiva,hemorragia de la primera mitad del embarazo (< 22 sem) aborto,2016-03-01,29,0,29
40201,CHALLAPATA,salud sexual y reproductiva,hemorragia de la primera mitad del embarazo (< 22 sem) aborto,2016-03-01,1,0,1
70702,CHARAGUA,salud sexual y reproductiva,hemorragia de la primera mitad del embarazo (< 22 sem) aborto,2016-03-01,3,0,3
31204,CHIMORE,salud sexual y reproductiva,hemorragia de la primera mitad del embarazo (< 22 sem) aborto,2016-03-01,1,0,1
21101,CHULUMANI (V. DE LA LIBERTAD),salud sexual y reproductiva,hemorragia de la primera mitad del embarazo (< 22 sem) aborto,2016-03-01,7,0,7
20501,CHUMA,salud sexual y reproductiva,hemorragia de la primera mitad del embarazo (< 22 sem) aborto,2016-03-01,0,1,1
30801,CLIZA,salud sexual y reproductiva,hemorragia de la primera mitad del embarazo (< 22 sem) aborto,2016-03-01,9,0,9
90101,COBIJA,salud sexual y reproductiva,hemorragia de la primera mitad del embarazo (< 22 sem) aborto,2016-03-01,26,2,28
30303,COCAPATA,salud sexual y reproductiva,hemorragia de la primera mitad del embarazo (< 22 sem) aborto,2016-03-01,0,2,2
30101,COCHABAMBA,salud sexual y reproductiva,hemorragia de la primera mitad del embarazo (< 22 sem) aborto,2016-03-01,183,4,187
30905,COLCAPIRHUA,salud sexual y reproductiva,hemorragia de la primera mitad del embarazo (< 22 sem) aborto,2016-03-01,2,0,2
31002,COLOMI,salud sexual y reproductiva,hemorragia de la primera mitad del embarazo (< 22 sem) aborto,2016-03-01,3,0,3
71301,COMARAPA,salud sexual y reproductiva,hemorragia de la primera mitad del embarazo (< 22 sem) aborto,2016-03-01,7,0,7
71101,CONCEPCION,salud sexual y reproductiva,hemorragia de la primera mitad del embarazo (< 22 sem) aborto,2016-03-01,7,0,7
21401,COROICO,salud sexual y reproductiva,hemorragia de la primera mitad del embarazo (< 22 sem) aborto,2016-03-01,2,0,2
70102,COTOCA,salud sexual y reproductiva,hemorragia de la primera mitad del embarazo (< 22 sem) aborto,2016-03-01,6,2,8
31405,CUCHUMUELA (V. G. VILLARROEL),salud sexual y reproductiva,hemorragia de la primera mitad del embarazo (< 22 sem) aborto,2016-03-01,0,1,1
20804,DESAGUADERO,salud sexual y reproductiva,hemorragia de la primera mitad del embarazo (< 22 sem) aborto,2016-03-01,2,0,2
20105,EL ALTO,salud sexual y reproductiva,hemorragia de la primera mitad del embarazo (< 22 sem) aborto,2016-03-01,113,7,120
71503,EL PUENTE(STC),salud sexual y reproductiva,hemorragia de la primera mitad del embarazo (< 22 sem) aborto,2016-03-01,1,0,1
70105,EL TORNO,salud sexual y reproductiva,hemorragia de la primera mitad del embarazo (< 22 sem) aborto,2016-03-01,12,0,12
60601,ENTRE RIOS TRJ,salud sexual y reproductiva,hemorragia de la primera mitad del embarazo (< 22 sem) aborto,2016-03-01,1,0,1
20405,ESCOMA,salud sexual y reproductiva,hemorragia de la primera mitad del embarazo (< 22 sem) aborto,2016-03-01,1,0,1
80202,GUAYARAMERIN,salud sexual y reproductiva,hemorragia de la primera mitad del embarazo (< 22 sem) aborto,2016-03-01,5,1,6
40701,HUANUNI,salud sexual y reproductiva,hemorragia de la primera mitad del embarazo (< 22 sem) aborto,2016-03-01,6,0,6
21102,IRUPANA (VILLA DE LANZA),salud sexual y reproductiva,hemorragia de la primera mitad del embarazo (< 22 sem) aborto,2016-03-01,1,0,1
21105,LA ASUNTA,salud sexual y reproductiva,hemorragia de la primera mitad del embarazo (< 22 sem) aborto,2016-03-01,9,0,9
70104,LA GUARDIA,salud sexual y reproductiva,hemorragia de la primera mitad del embarazo (< 22 sem) aborto,2016-03-01,0,11,11
20101,LA PAZ,salud sexual y reproductiva,hemorragia de la primera mitad del embarazo (< 22 sem) aborto,2016-03-01,207,0,207
21202,LAJA,salud sexual y reproductiva,hemorragia de la primera mitad del embarazo (< 22 sem) aborto,2016-03-01,0,1,1
70903,MAIRANA,salud sexual y reproductiva,hemorragia de la primera mitad del embarazo (< 22 sem) aborto,2016-03-01,5,0,5
10501,MONTEAGUDO,salud sexual y reproductiva,hemorragia de la primera mitad del embarazo (< 22 sem) aborto,2016-03-01,2,2,4
71001,MONTERO,salud sexual y reproductiva,hemorragia de la primera mitad del embarazo (< 22 sem) aborto,2016-03-01,8,0,8
40101,ORURO,salud sexual y reproductiva,hemorragia de la primera mitad del embarazo (< 22 sem) aborto,2016-03-01,12,1,13
60201,PADCAYA,salud sexual y reproductiva,hemorragia de la primera mitad del embarazo (< 22 sem) aborto,2016-03-01,0,1,1
10401,PADILLA,salud sexual y reproductiva,hemorragia de la primera mitad del embarazo (< 22 sem) aborto,2016-03-01,3,0,3
70502,PAILON,salud sexual y reproductiva,hemorragia de la primera mitad del embarazo (< 22 sem) aborto,2016-03-01,1,0,1
30202,PASORAPA,salud sexual y reproductiva,hemorragia de la primera mitad del embarazo (< 22 sem) aborto,2016-03-01,0,1,1
21305,PATACAMAYA,salud sexual y reproductiva,hemorragia de la primera mitad del embarazo (< 22 sem) aborto,2016-03-01,1,0,1
31203,POCONA,salud sexual y reproductiva,hemorragia de la primera mitad del embarazo (< 22 sem) aborto,2016-03-01,1,0,1
70601,PORTACHUELO,salud sexual y reproductiva,hemorragia de la primera mitad del embarazo (< 22 sem) aborto,2016-03-01,4,0,4
50101,POTOSI,salud sexual y reproductiva,hemorragia de la primera mitad del embarazo (< 22 sem) aborto,2016-03-01,43,1,44
21201,PUCARANI,salud sexual y reproductiva,hemorragia de la primera mitad del embarazo (< 22 sem) aborto,2016-03-01,0,1,1
90301,PUERTO GONZALO MORENO,salud sexual y reproductiva,hemorragia de la primera mitad del embarazo (< 22 sem) aborto,2016-03-01,2,0,2
90201,PUERTO RICO,salud sexual y reproductiva,hemorragia de la primera mitad del embarazo (< 22 sem) aborto,2016-03-01,6,0,6
71401,PUERTO SUAREZ,salud sexual y reproductiva,hemorragia de la primera mitad del embarazo (< 22 sem) aborto,2016-03-01,19,0,19
31205,PUERTO VILLARROEL,salud sexual y reproductiva,hemorragia de la primera mitad del embarazo (< 22 sem) aborto,2016-03-01,3,7,10
51101,PUNA,salud sexual y reproductiva,hemorragia de la primera mitad del embarazo (< 22 sem) aborto,2016-03-01,1,1,2
31401,PUNATA,salud sexual y reproductiva,hemorragia de la primera mitad del embarazo (< 22 sem) aborto,2016-03-01,17,0,17
30901,QUILLACOLLO,salud sexual y reproductiva,hemorragia de la primera mitad del embarazo (< 22 sem) aborto,2016-03-01,74,0,74
50402,RAVELO,salud sexual y reproductiva,hemorragia de la primera mitad del embarazo (< 22 sem) aborto,2016-03-01,0,1,1
80301,REYES,salud sexual y reproductiva,hemorragia de la primera mitad del embarazo (< 22 sem) aborto,2016-03-01,3,0,3
80201,RIBERALTA,salud sexual y reproductiva,hemorragia de la primera mitad del embarazo (< 22 sem) aborto,2016-03-01,45,0,45
70503,ROBORE,salud sexual y reproductiva,hemorragia de la primera mitad del embarazo (< 22 sem) aborto,2016-03-01,5,0,5
80304,RURRENABAQUE,salud sexual y reproductiva,hemorragia de la primera mitad del embarazo (< 22 sem) aborto,2016-03-01,10,0,10
31001,SACABA,salud sexual y reproductiva,hemorragia de la primera mitad del embarazo (< 22 sem) aborto,2016-03-01,56,11,67
20805,SAN ANDRES DE MACHACA,salud sexual y reproductiva,hemorragia de la primera mitad del embarazo (< 22 sem) aborto,2016-03-01,1,0,1
80302,SAN BORJA,salud sexual y reproductiva,hemorragia de la primera mitad del embarazo (< 22 sem) aborto,2016-03-01,25,0,25
70402,SAN CARLOS,salud sexual y reproductiva,hemorragia de la primera mitad del embarazo (< 22 sem) aborto,2016-03-01,5,0,5
70301,SAN IGNACIO DE VELASCO,salud sexual y reproductiva,hemorragia de la primera mitad del embarazo (< 22 sem) aborto,2016-03-01,17,4,21
70501,SAN JOSE DE CHIQUITOS,salud sexual y reproductiva,hemorragia de la primera mitad del embarazo (< 22 sem) aborto,2016-03-01,5,0,5
71104,SAN JULIAN,salud sexual y reproductiva,hemorragia de la primera mitad del embarazo (< 22 sem) aborto,2016-03-01,15,0,15
10702,SAN LUCAS,salud sexual y reproductiva,hemorragia de la primera mitad del embarazo (< 22 sem) aborto,2016-03-01,5,4,9
71201,SAN MATIAS,salud sexual y reproductiva,hemorragia de la primera mitad del embarazo (< 22 sem) aborto,2016-03-01,1,0,1
70302,SAN MIGUEL DE VELASCO,salud sexual y reproductiva,hemorragia de la primera mitad del embarazo (< 22 sem) aborto,2016-03-01,3,0,3
71005,SAN PEDRO,salud sexual y reproductiva,hemorragia de la primera mitad del embarazo (< 22 sem) aborto,2016-03-01,1,0,1
50501,SAN PEDRO DE BUENA VISTA,salud sexual y reproductiva,hemorragia de la primera mitad del embarazo (< 22 sem) aborto,2016-03-01,1,0,1
80702,SAN RAMON BENI,salud sexual y reproductiva,hemorragia de la primera mitad del embarazo (< 22 sem) aborto,2016-03-01,1,1,2
71103,SAN RAMON SCZ,salud sexual y reproductiva,hemorragia de la primera mitad del embarazo (< 22 sem) aborto,2016-03-01,1,0,1
80401,SANTA ANA,salud sexual y reproductiva,hemorragia de la primera mitad del embarazo (< 22 sem) aborto,2016-03-01,2,1,3
70101,SANTA CRUZ DE LA SIERRA,salud sexual y reproductiva,hemorragia de la primera mitad del embarazo (< 22 sem) aborto,2016-03-01,260,113,373
20902,SAPAHAQUI,salud sexual y reproductiva,hemorragia de la primera mitad del embarazo (< 22 sem) aborto,2016-03-01,0,1,1
90303,SENA,salud sexual y reproductiva,hemorragia de la primera mitad del embarazo (< 22 sem) aborto,2016-03-01,5,0,5
31602,SHINAOTA,salud sexual y reproductiva,hemorragia de la primera mitad del embarazo (< 22 sem) aborto,2016-03-01,14,0,14
30703,SICAYA,salud sexual y reproductiva,hemorragia de la primera mitad del embarazo (< 22 sem) aborto,2016-03-01,1,0,1
10403,SOPACHUY,salud sexual y reproductiva,hemorragia de la primera mitad del embarazo (< 22 sem) aborto,2016-03-01,1,0,1
10101,SUCRE,salud sexual y reproductiva,hemorragia de la primera mitad del embarazo (< 22 sem) aborto,2016-03-01,110,7,117
10601,TARABUCO,salud sexual y reproductiva,hemorragia de la primera mitad del embarazo (< 22 sem) aborto,2016-03-01,0,4,4
60101,TARIJA,salud sexual y reproductiva,hemorragia de la primera mitad del embarazo (< 22 sem) aborto,2016-03-01,46,2,48
20803,TIAWANACU,salud sexual y reproductiva,hemorragia de la primera mitad del embarazo (< 22 sem) aborto,2016-03-01,0,2,2
30803,TOLATA,salud sexual y reproductiva,hemorragia de la primera mitad del embarazo (< 22 sem) aborto,2016-03-01,1,0,1
10402,TOMINA,salud sexual y reproductiva,hemorragia de la primera mitad del embarazo (< 22 sem) aborto,2016-03-01,0,1,1
31201,TOTORA(CBBA),salud sexual y reproductiva,hemorragia de la primera mitad del embarazo (< 22 sem) aborto,2016-03-01,4,0,4
80101,TRINIDAD,salud sexual y reproductiva,hemorragia de la primera mitad del embarazo (< 22 sem) aborto,2016-03-01,59,0,59
50801,TUPIZA,salud sexual y reproductiva,hemorragia de la primera mitad del embarazo (< 22 sem) aborto,2016-03-01,13,0,13
51201,UYUNI,salud sexual y reproductiva,hemorragia de la primera mitad del embarazo (< 22 sem) aborto,2016-03-01,0,10,10
30502,VACAS,salud sexual y reproductiva,hemorragia de la primera mitad del embarazo (< 22 sem) aborto,2016-03-01,1,1,2
31402,VILLA RIVERO,salud sexual y reproductiva,hemorragia de la primera mitad del embarazo (< 22 sem) aborto,2016-03-01,2,0,2
10801,VILLA SERRANO,salud sexual y reproductiva,hemorragia de la primera mitad del embarazo (< 22 sem) aborto,2016-03-01,0,1,1
31003,VILLA TUNARI,salud sexual y reproductiva,hemorragia de la primera mitad del embarazo (< 22 sem) aborto,2016-03-01,18,0,18
11001,VILLA VACA GUZMAN (MUYUPAMPA),salud sexual y reproductiva,hemorragia de la primera mitad del embarazo (< 22 sem) aborto,2016-03-01,1,1,2
51501,VILLAZON,salud sexual y reproductiva,hemorragia de la primera mitad del embarazo (< 22 sem) aborto,2016-03-01,11,7,18
70201,WARNES,salud sexual y reproductiva,hemorragia de la primera mitad del embarazo (< 22 sem) aborto,2016-03-01,29,0,29
60301,YACUIBA,salud sexual y reproductiva,hemorragia de la primera mitad del embarazo (< 22 sem) aborto,2016-03-01,5,1,6
70403,YAPACANI,salud sexual y reproductiva,hemorragia de la primera mitad del embarazo (< 22 sem) aborto,2016-03-01,11,0,11
10102,YOTALA,salud sexual y reproductiva,hemorragia de la primera mitad del embarazo (< 22 sem) aborto,2016-03-01,0,3,3
10301,ZUDAÃ‘EZ,salud sexual y reproductiva,hemorragia de la primera mitad del embarazo (< 22 sem) aborto,2016-03-01,1,0,1
30201,AIQUILE,salud sexual y reproductiva,hemorragia de la primera mitad del embarazo (< 22 sem) aborto,2016-04-01,4,0,4
22002,ALTO BENI,salud sexual y reproductiva,hemorragia de la primera mitad del embarazo (< 22 sem) aborto,2016-04-01,1,0,1
41201,ANDAMARCA,salud sexual y reproductiva,hemorragia de la primera mitad del embarazo (< 22 sem) aborto,2016-04-01,0,1,1
30501,ARANI,salud sexual y reproductiva,hemorragia de la primera mitad del embarazo (< 22 sem) aborto,2016-04-01,3,0,3
30403,ARBIETO,salud sexual y reproductiva,hemorragia de la primera mitad del embarazo (< 22 sem) aborto,2016-04-01,1,0,1
30601,ARQUE,salud sexual y reproductiva,hemorragia de la primera mitad del embarazo (< 22 sem) aborto,2016-04-01,2,0,2
71501,ASCENCION DE GUARAYOS,salud sexual y reproductiva,hemorragia de la primera mitad del embarazo (< 22 sem) aborto,2016-04-01,3,1,4
50802,ATOCHA,salud sexual y reproductiva,hemorragia de la primera mitad del embarazo (< 22 sem) aborto,2016-04-01,0,1,1
10701,CAMARGO,salud sexual y reproductiva,hemorragia de la primera mitad del embarazo (< 22 sem) aborto,2016-04-01,2,0,2
70706,CAMIRI,salud sexual y reproductiva,hemorragia de la primera mitad del embarazo (< 22 sem) aborto,2016-04-01,7,6,13
30701,CAPINOTA,salud sexual y reproductiva,hemorragia de la primera mitad del embarazo (< 22 sem) aborto,2016-04-01,2,0,2
22001,CARANAVI,salud sexual y reproductiva,hemorragia de la primera mitad del embarazo (< 22 sem) aborto,2016-04-01,20,0,20
70702,CHARAGUA,salud sexual y reproductiva,hemorragia de la primera mitad del embarazo (< 22 sem) aborto,2016-04-01,2,0,2
21101,CHULUMANI (V. DE LA LIBERTAD),salud sexual y reproductiva,hemorragia de la primera mitad del embarazo (< 22 sem) aborto,2016-04-01,5,0,5
30801,CLIZA,salud sexual y reproductiva,hemorragia de la primera mitad del embarazo (< 22 sem) aborto,2016-04-01,4,0,4
90101,COBIJA,salud sexual y reproductiva,hemorragia de la primera mitad del embarazo (< 22 sem) aborto,2016-04-01,18,0,18
30101,COCHABAMBA,salud sexual y reproductiva,hemorragia de la primera mitad del embarazo (< 22 sem) aborto,2016-04-01,162,8,170
31002,COLOMI,salud sexual y reproductiva,hemorragia de la primera mitad del embarazo (< 22 sem) aborto,2016-04-01,5,0,5
71301,COMARAPA,salud sexual y reproductiva,hemorragia de la primera mitad del embarazo (< 22 sem) aborto,2016-04-01,4,1,5
20605,COMBAYA,salud sexual y reproductiva,hemorragia de la primera mitad del embarazo (< 22 sem) aborto,2016-04-01,1,0,1
71101,CONCEPCION,salud sexual y reproductiva,hemorragia de la primera mitad del embarazo (< 22 sem) aborto,2016-04-01,2,0,2
21402,CORIPATA,salud sexual y reproductiva,hemorragia de la primera mitad del embarazo (< 22 sem) aborto,2016-04-01,2,0,2
21401,COROICO,salud sexual y reproductiva,hemorragia de la primera mitad del embarazo (< 22 sem) aborto,2016-04-01,4,0,4
50601,COTAGAITA,salud sexual y reproductiva,hemorragia de la primera mitad del embarazo (< 22 sem) aborto,2016-04-01,0,2,2
70102,COTOCA,salud sexual y reproductiva,hemorragia de la primera mitad del embarazo (< 22 sem) aborto,2016-04-01,8,0,8
20105,EL ALTO,salud sexual y reproductiva,hemorragia de la primera mitad del embarazo (< 22 sem) aborto,2016-04-01,137,1,138
70105,EL TORNO,salud sexual y reproductiva,hemorragia de la primera mitad del embarazo (< 22 sem) aborto,2016-04-01,23,0,23
20405,ESCOMA,salud sexual y reproductiva,hemorragia de la primera mitad del embarazo (< 22 sem) aborto,2016-04-01,0,2,2
80202,GUAYARAMERIN,salud sexual y reproductiva,hemorragia de la primera mitad del embarazo (< 22 sem) aborto,2016-04-01,0,1,1
10502,HUACARETA,salud sexual y reproductiva,hemorragia de la primera mitad del embarazo (< 22 sem) aborto,2016-04-01,0,2,2
40701,HUANUNI,salud sexual y reproductiva,hemorragia de la primera mitad del embarazo (< 22 sem) aborto,2016-04-01,6,0,6
20204,HUARINA,salud sexual y reproductiva,hemorragia de la primera mitad del embarazo (< 22 sem) aborto,2016-04-01,3,0,3
20206,HUATAJATA,salud sexual y reproductiva,hemorragia de la primera mitad del embarazo (< 22 sem) aborto,2016-04-01,0,1,1
21105,LA ASUNTA,salud sexual y reproductiva,hemorragia de la primera mitad del embarazo (< 22 sem) aborto,2016-04-01,3,3,6
70104,LA GUARDIA,salud sexual y reproductiva,hemorragia de la primera mitad del embarazo (< 22 sem) aborto,2016-04-01,5,6,11
20101,LA PAZ,salud sexual y reproductiva,hemorragia de la primera mitad del embarazo (< 22 sem) aborto,2016-04-01,173,1,174
80801,MAGDALENA,salud sexual y reproductiva,hemorragia de la primera mitad del embarazo (< 22 sem) aborto,2016-04-01,0,1,1
70903,MAIRANA,salud sexual y reproductiva,hemorragia de la primera mitad del embarazo (< 22 sem) aborto,2016-04-01,2,0,2
31301,MIZQUE,salud sexual y reproductiva,hemorragia de la primera mitad del embarazo (< 22 sem) aborto,2016-04-01,1,0,1
71001,MONTERO,salud sexual y reproductiva,hemorragia de la primera mitad del embarazo (< 22 sem) aborto,2016-04-01,5,0,5
50404,OCURI,salud sexual y reproductiva,hemorragia de la primera mitad del embarazo (< 22 sem) aborto,2016-04-01,1,2,3
40101,ORURO,salud sexual y reproductiva,hemorragia de la primera mitad del embarazo (< 22 sem) aborto,2016-04-01,14,0,14
10401,PADILLA,salud sexual y reproductiva,hemorragia de la primera mitad del embarazo (< 22 sem) aborto,2016-04-01,1,0,1
50403,POCOATA,salud sexual y reproductiva,hemorragia de la primera mitad del embarazo (< 22 sem) aborto,2016-04-01,0,2,2
31203,POCONA,salud sexual y reproductiva,hemorragia de la primera mitad del embarazo (< 22 sem) aborto,2016-04-01,1,0,1
70601,PORTACHUELO,salud sexual y reproductiva,hemorragia de la primera mitad del embarazo (< 22 sem) aborto,2016-04-01,3,0,3
50101,POTOSI,salud sexual y reproductiva,hemorragia de la primera mitad del embarazo (< 22 sem) aborto,2016-04-01,15,0,15
90301,PUERTO GONZALO MORENO,salud sexual y reproductiva,hemorragia de la primera mitad del embarazo (< 22 sem) aborto,2016-04-01,1,0,1
90201,PUERTO RICO,salud sexual y reproductiva,hemorragia de la primera mitad del embarazo (< 22 sem) aborto,2016-04-01,2,1,3
71401,PUERTO SUAREZ,salud sexual y reproductiva,hemorragia de la primera mitad del embarazo (< 22 sem) aborto,2016-04-01,8,0,8
31205,PUERTO VILLARROEL,salud sexual y reproductiva,hemorragia de la primera mitad del embarazo (< 22 sem) aborto,2016-04-01,0,25,25
51101,PUNA,salud sexual y reproductiva,hemorragia de la primera mitad del embarazo (< 22 sem) aborto,2016-04-01,0,1,1
31401,PUNATA,salud sexual y reproductiva,hemorragia de la primera mitad del embarazo (< 22 sem) aborto,2016-04-01,16,0,16
80301,REYES,salud sexual y reproductiva,hemorragia de la primera mitad del embarazo (< 22 sem) aborto,2016-04-01,4,0,4
80201,RIBERALTA,salud sexual y reproductiva,hemorragia de la primera mitad del embarazo (< 22 sem) aborto,2016-04-01,26,2,28
70503,ROBORE,salud sexual y reproductiva,hemorragia de la primera mitad del embarazo (< 22 sem) aborto,2016-04-01,2,0,2
80304,RURRENABAQUE,salud sexual y reproductiva,hemorragia de la primera mitad del embarazo (< 22 sem) aborto,2016-04-01,6,0,6
31001,SACABA,salud sexual y reproductiva,hemorragia de la primera mitad del embarazo (< 22 sem) aborto,2016-04-01,67,0,67
70901,SAMAIPATA,salud sexual y reproductiva,hemorragia de la primera mitad del embarazo (< 22 sem) aborto,2016-04-01,1,0,1
80302,SAN BORJA,salud sexual y reproductiva,hemorragia de la primera mitad del embarazo (< 22 sem) aborto,2016-04-01,32,0,32
70402,SAN CARLOS,salud sexual y reproductiva,hemorragia de la primera mitad del embarazo (< 22 sem) aborto,2016-04-01,1,0,1
70301,SAN IGNACIO DE VELASCO,salud sexual y reproductiva,hemorragia de la primera mitad del embarazo (< 22 sem) aborto,2016-04-01,10,0,10
70501,SAN JOSE DE CHIQUITOS,salud sexual y reproductiva,hemorragia de la primera mitad del embarazo (< 22 sem) aborto,2016-04-01,2,0,2
71104,SAN JULIAN,salud sexual y reproductiva,hemorragia de la primera mitad del embarazo (< 22 sem) aborto,2016-04-01,23,0,23
10702,SAN LUCAS,salud sexual y reproductiva,hemorragia de la primera mitad del embarazo (< 22 sem) aborto,2016-04-01,8,6,14
71201,SAN MATIAS,salud sexual y reproductiva,hemorragia de la primera mitad del embarazo (< 22 sem) aborto,2016-04-01,0,1,1
70302,SAN MIGUEL DE VELASCO,salud sexual y reproductiva,hemorragia de la primera mitad del embarazo (< 22 sem) aborto,2016-04-01,1,0,1
90202,SAN PEDRO(PND),salud sexual y reproductiva,hemorragia de la primera mitad del embarazo (< 22 sem) aborto,2016-04-01,1,0,1
80702,SAN RAMON BENI,salud sexual y reproductiva,hemorragia de la primera mitad del embarazo (< 22 sem) aborto,2016-04-01,2,0,2
71103,SAN RAMON SCZ,salud sexual y reproductiva,hemorragia de la primera mitad del embarazo (< 22 sem) aborto,2016-04-01,2,0,2
80401,SANTA ANA,salud sexual y reproductiva,hemorragia de la primera mitad del embarazo (< 22 sem) aborto,2016-04-01,6,1,7
70101,SANTA CRUZ DE LA SIERRA,salud sexual y reproductiva,hemorragia de la primera mitad del embarazo (< 22 sem) aborto,2016-04-01,167,68,235
30702,SANTIVAÃ‘ES,salud sexual y reproductiva,hemorragia de la primera mitad del embarazo (< 22 sem) aborto,2016-04-01,1,0,1
20902,SAPAHAQUI,salud sexual y reproductiva,hemorragia de la primera mitad del embarazo (< 22 sem) aborto,2016-04-01,2,0,2
31602,SHINAOTA,salud sexual y reproductiva,hemorragia de la primera mitad del embarazo (< 22 sem) aborto,2016-04-01,10,0,10
10101,SUCRE,salud sexual y reproductiva,hemorragia de la primera mitad del embarazo (< 22 sem) aborto,2016-04-01,84,8,92
50303,TACOBAMBA,salud sexual y reproductiva,hemorragia de la primera mitad del embarazo (< 22 sem) aborto,2016-04-01,0,1,1
10601,TARABUCO,salud sexual y reproductiva,hemorragia de la primera mitad del embarazo (< 22 sem) aborto,2016-04-01,0,4,4
20807,TARACO,salud sexual y reproductiva,hemorragia de la primera mitad del embarazo (< 22 sem) aborto,2016-04-01,0,1,1
60101,TARIJA,salud sexual y reproductiva,hemorragia de la primera mitad del embarazo (< 22 sem) aborto,2016-04-01,39,2,41
10202,TARVITA,salud sexual y reproductiva,hemorragia de la primera mitad del embarazo (< 22 sem) aborto,2016-04-01,2,0,2
30903,TIQUIPAYA,salud sexual y reproductiva,hemorragia de la primera mitad del embarazo (< 22 sem) aborto,2016-04-01,1,0,1
30803,TOLATA,salud sexual y reproductiva,hemorragia de la primera mitad del embarazo (< 22 sem) aborto,2016-04-01,2,0,2
31201,TOTORA(CBBA),salud sexual y reproductiva,hemorragia de la primera mitad del embarazo (< 22 sem) aborto,2016-04-01,2,0,2
80101,TRINIDAD,salud sexual y reproductiva,hemorragia de la primera mitad del embarazo (< 22 sem) aborto,2016-04-01,38,1,39
50801,TUPIZA,salud sexual y reproductiva,hemorragia de la primera mitad del embarazo (< 22 sem) aborto,2016-04-01,2,0,2
60401,URIONDO (A. CONCEPCION),salud sexual y reproductiva,hemorragia de la primera mitad del embarazo (< 22 sem) aborto,2016-04-01,1,0,1
51201,UYUNI,salud sexual y reproductiva,hemorragia de la primera mitad del embarazo (< 22 sem) aborto,2016-04-01,0,7,7
31402,VILLA RIVERO,salud sexual y reproductiva,hemorragia de la primera mitad del embarazo (< 22 sem) aborto,2016-04-01,1,0,1
10801,VILLA SERRANO,salud sexual y reproductiva,hemorragia de la primera mitad del embarazo (< 22 sem) aborto,2016-04-01,0,1,1
31003,VILLA TUNARI,salud sexual y reproductiva,hemorragia de la primera mitad del embarazo (< 22 sem) aborto,2016-04-01,35,9,44
11001,VILLA VACA GUZMAN (MUYUPAMPA),salud sexual y reproductiva,hemorragia de la primera mitad del embarazo (< 22 sem) aborto,2016-04-01,2,0,2
51501,VILLAZON,salud sexual y reproductiva,hemorragia de la primera mitad del embarazo (< 22 sem) aborto,2016-04-01,9,13,22
70201,WARNES,salud sexual y reproductiva,hemorragia de la primera mitad del embarazo (< 22 sem) aborto,2016-04-01,15,0,15
60301,YACUIBA,salud sexual y reproductiva,hemorragia de la primera mitad del embarazo (< 22 sem) aborto,2016-04-01,2,2,4
10602,YAMPARAEZ,salud sexual y reproductiva,hemorragia de la primera mitad del embarazo (< 22 sem) aborto,2016-04-01,1,0,1
21103,YANACACHI,salud sexual y reproductiva,hemorragia de la primera mitad del embarazo (< 22 sem) aborto,2016-04-01,1,0,1
70403,YAPACANI,salud sexual y reproductiva,hemorragia de la primera mitad del embarazo (< 22 sem) aborto,2016-04-01,5,0,5
10301,ZUDAÃ‘EZ,salud sexual y reproductiva,hemorragia de la primera mitad del embarazo (< 22 sem) aborto,2016-04-01,0,1,1
20104,ACHOCALLA,salud sexual y reproductiva,hemorragia de la primera mitad del embarazo (< 22 sem) aborto,2016-05-01,1,0,1
30201,AIQUILE,salud sexual y reproductiva,hemorragia de la primera mitad del embarazo (< 22 sem) aborto,2016-05-01,8,1,9
30501,ARANI,salud sexual y reproductiva,hemorragia de la primera mitad del embarazo (< 22 sem) aborto,2016-05-01,3,1,4
30403,ARBIETO,salud sexual y reproductiva,hemorragia de la primera mitad del embarazo (< 22 sem) aborto,2016-05-01,1,0,1
71501,ASCENCION DE GUARAYOS,salud sexual y reproductiva,hemorragia de la primera mitad del embarazo (< 22 sem) aborto,2016-05-01,2,2,4
60202,BERMEJO,salud sexual y reproductiva,hemorragia de la primera mitad del embarazo (< 22 sem) aborto,2016-05-01,1,1,2
21003,CAJUATA,salud sexual y reproductiva,hemorragia de la primera mitad del embarazo (< 22 sem) aborto,2016-05-01,1,0,1
10701,CAMARGO,salud sexual y reproductiva,hemorragia de la primera mitad del embarazo (< 22 sem) aborto,2016-05-01,0,5,5
70706,CAMIRI,salud sexual y reproductiva,hemorragia de la primera mitad del embarazo (< 22 sem) aborto,2016-05-01,9,0,9
30701,CAPINOTA,salud sexual y reproductiva,hemorragia de la primera mitad del embarazo (< 22 sem) aborto,2016-05-01,1,0,1
22001,CARANAVI,salud sexual y reproductiva,hemorragia de la primera mitad del embarazo (< 22 sem) aborto,2016-05-01,15,0,15
70702,CHARAGUA,salud sexual y reproductiva,hemorragia de la primera mitad del embarazo (< 22 sem) aborto,2016-05-01,2,0,2
31204,CHIMORE,salud sexual y reproductiva,hemorragia de la primera mitad del embarazo (< 22 sem) aborto,2016-05-01,4,0,4
21101,CHULUMANI (V. DE LA LIBERTAD),salud sexual y reproductiva,hemorragia de la primera mitad del embarazo (< 22 sem) aborto,2016-05-01,6,0,6
30801,CLIZA,salud sexual y reproductiva,hemorragia de la primera mitad del embarazo (< 22 sem) aborto,2016-05-01,11,0,11
90101,COBIJA,salud sexual y reproductiva,hemorragia de la primera mitad del embarazo (< 22 sem) aborto,2016-05-01,14,0,14
30101,COCHABAMBA,salud sexual y reproductiva,hemorragia de la primera mitad del embarazo (< 22 sem) aborto,2016-05-01,145,14,159
30905,COLCAPIRHUA,salud sexual y reproductiva,hemorragia de la primera mitad del embarazo (< 22 sem) aborto,2016-05-01,2,0,2
31002,COLOMI,salud sexual y reproductiva,hemorragia de la primera mitad del embarazo (< 22 sem) aborto,2016-05-01,2,0,2
21004,COLQUIRI,salud sexual y reproductiva,hemorragia de la primera mitad del embarazo (< 22 sem) aborto,2016-05-01,0,1,1
71301,COMARAPA,salud sexual y reproductiva,hemorragia de la primera mitad del embarazo (< 22 sem) aborto,2016-05-01,0,9,9
71101,CONCEPCION,salud sexual y reproductiva,hemorragia de la primera mitad del embarazo (< 22 sem) aborto,2016-05-01,2,1,3
21402,CORIPATA,salud sexual y reproductiva,hemorragia de la primera mitad del embarazo (< 22 sem) aborto,2016-05-01,1,0,1
50601,COTAGAITA,salud sexual y reproductiva,hemorragia de la primera mitad del embarazo (< 22 sem) aborto,2016-05-01,3,0,3
70102,COTOCA,salud sexual y reproductiva,hemorragia de la primera mitad del embarazo (< 22 sem) aborto,2016-05-01,6,0,6
20105,EL ALTO,salud sexual y reproductiva,hemorragia de la primera mitad del embarazo (< 22 sem) aborto,2016-05-01,84,9,93
71503,EL PUENTE(STC),salud sexual y reproductiva,hemorragia de la primera mitad del embarazo (< 22 sem) aborto,2016-05-01,0,1,1
60502,EL PUENTE(TJA),salud sexual y reproductiva,hemorragia de la primera mitad del embarazo (< 22 sem) aborto,2016-05-01,0,1,1
70105,EL TORNO,salud sexual y reproductiva,hemorragia de la primera mitad del embarazo (< 22 sem) aborto,2016-05-01,18,0,18
20405,ESCOMA,salud sexual y reproductiva,hemorragia de la primera mitad del embarazo (< 22 sem) aborto,2016-05-01,0,1,1
90203,FILADELFIA,salud sexual y reproductiva,hemorragia de la primera mitad del embarazo (< 22 sem) aborto,2016-05-01,0,1,1
20602,GUANAY,salud sexual y reproductiva,hemorragia de la primera mitad del embarazo (< 22 sem) aborto,2016-05-01,0,3,3
40701,HUANUNI,salud sexual y reproductiva,hemorragia de la primera mitad del embarazo (< 22 sem) aborto,2016-05-01,1,3,4
20204,HUARINA,salud sexual y reproductiva,hemorragia de la primera mitad del embarazo (< 22 sem) aborto,2016-05-01,3,0,3
10703,INCAHUASI,salud sexual y reproductiva,hemorragia de la primera mitad del embarazo (< 22 sem) aborto,2016-05-01,1,0,1
21102,IRUPANA (VILLA DE LANZA),salud sexual y reproductiva,hemorragia de la primera mitad del embarazo (< 22 sem) aborto,2016-05-01,0,1,1
21105,LA ASUNTA,salud sexual y reproductiva,hemorragia de la primera mitad del embarazo (< 22 sem) aborto,2016-05-01,6,0,6
70104,LA GUARDIA,salud sexual y reproductiva,hemorragia de la primera mitad del embarazo (< 22 sem) aborto,2016-05-01,0,2,2
20101,LA PAZ,salud sexual y reproductiva,hemorragia de la primera mitad del embarazo (< 22 sem) aborto,2016-05-01,85,0,85
21202,LAJA,salud sexual y reproductiva,hemorragia de la primera mitad del embarazo (< 22 sem) aborto,2016-05-01,0,1,1
50203,LLALLAGUA,salud sexual y reproductiva,hemorragia de la primera mitad del embarazo (< 22 sem) aborto,2016-05-01,1,0,1
80801,MAGDALENA,salud sexual y reproductiva,hemorragia de la primera mitad del embarazo (< 22 sem) aborto,2016-05-01,0,1,1
70903,MAIRANA,salud sexual y reproductiva,hemorragia de la primera mitad del embarazo (< 22 sem) aborto,2016-05-01,3,0,3
31301,MIZQUE,salud sexual y reproductiva,hemorragia de la primera mitad del embarazo (< 22 sem) aborto,2016-05-01,3,0,3
71001,MONTERO,salud sexual y reproductiva,hemorragia de la primera mitad del embarazo (< 22 sem) aborto,2016-05-01,1,0,1
30203,OMEREQUE,salud sexual y reproductiva,hemorragia de la primera mitad del embarazo (< 22 sem) aborto,2016-05-01,1,0,1
40101,ORURO,salud sexual y reproductiva,hemorragia de la primera mitad del embarazo (< 22 sem) aborto,2016-05-01,6,0,6
10401,PADILLA,salud sexual y reproductiva,hemorragia de la primera mitad del embarazo (< 22 sem) aborto,2016-05-01,2,0,2
70502,PAILON,salud sexual y reproductiva,hemorragia de la primera mitad del embarazo (< 22 sem) aborto,2016-05-01,2,0,2
21104,PALOS BLANCOS,salud sexual y reproductiva,hemorragia de la primera mitad del embarazo (< 22 sem) aborto,2016-05-01,1,0,1
30202,PASORAPA,salud sexual y reproductiva,hemorragia de la primera mitad del embarazo (< 22 sem) aborto,2016-05-01,1,0,1
10103,POROMA,salud sexual y reproductiva,hemorragia de la primera mitad del embarazo (< 22 sem) aborto,2016-05-01,2,0,2
70601,PORTACHUELO,salud sexual y reproductiva,hemorragia de la primera mitad del embarazo (< 22 sem) aborto,2016-05-01,6,0,6
50101,POTOSI,salud sexual y reproductiva,hemorragia de la primera mitad del embarazo (< 22 sem) aborto,2016-05-01,15,0,15
90201,PUERTO RICO,salud sexual y reproductiva,hemorragia de la primera mitad del embarazo (< 22 sem) aborto,2016-05-01,2,0,2
71401,PUERTO SUAREZ,salud sexual y reproductiva,hemorragia de la primera mitad del embarazo (< 22 sem) aborto,2016-05-01,5,0,5
31205,PUERTO VILLARROEL,salud sexual y reproductiva,hemorragia de la primera mitad del embarazo (< 22 sem) aborto,2016-05-01,0,27,27
51101,PUNA,salud sexual y reproductiva,hemorragia de la primera mitad del embarazo (< 22 sem) aborto,2016-05-01,2,0,2
31401,PUNATA,salud sexual y reproductiva,hemorragia de la primera mitad del embarazo (< 22 sem) aborto,2016-05-01,13,0,13
30901,QUILLACOLLO,salud sexual y reproductiva,hemorragia de la primera mitad del embarazo (< 22 sem) aborto,2016-05-01,56,0,56
50402,RAVELO,salud sexual y reproductiva,hemorragia de la primera mitad del embarazo (< 22 sem) aborto,2016-05-01,1,0,1
80201,RIBERALTA,salud sexual y reproductiva,hemorragia de la primera mitad del embarazo (< 22 sem) aborto,2016-05-01,30,1,31
70503,ROBORE,salud sexual y reproductiva,hemorragia de la primera mitad del embarazo (< 22 sem) aborto,2016-05-01,5,0,5
80304,RURRENABAQUE,salud sexual y reproductiva,hemorragia de la primera mitad del embarazo (< 22 sem) aborto,2016-05-01,6,0,6
31001,SACABA,salud sexual y reproductiva,hemorragia de la primera mitad del embarazo (< 22 sem) aborto,2016-05-01,49,0,49
31403,SAN BENITO,salud sexual y reproductiva,hemorragia de la primera mitad del embarazo (< 22 sem) aborto,2016-05-01,1,0,1
80302,SAN BORJA,salud sexual y reproductiva,hemorragia de la primera mitad del embarazo (< 22 sem) aborto,2016-05-01,19,0,19
70402,SAN CARLOS,salud sexual y reproductiva,hemorragia de la primera mitad del embarazo (< 22 sem) aborto,2016-05-01,5,0,5
80501,SAN IGNACIO,salud sexual y reproductiva,hemorragia de la primera mitad del embarazo (< 22 sem) aborto,2016-05-01,3,0,3
70301,SAN IGNACIO DE VELASCO,salud sexual y reproductiva,hemorragia de la primera mitad del embarazo (< 22 sem) aborto,2016-05-01,5,0,5
70501,SAN JOSE DE CHIQUITOS,salud sexual y reproductiva,hemorragia de la primera mitad del embarazo (< 22 sem) aborto,2016-05-01,4,0,4
71104,SAN JULIAN,salud sexual y reproductiva,hemorragia de la primera mitad del embarazo (< 22 sem) aborto,2016-05-01,11,0,11
10702,SAN LUCAS,salud sexual y reproductiva,hemorragia de la primera mitad del embarazo (< 22 sem) aborto,2016-05-01,1,3,4
70302,SAN MIGUEL DE VELASCO,salud sexual y reproductiva,hemorragia de la primera mitad del embarazo (< 22 sem) aborto,2016-05-01,1,0,1
71005,SAN PEDRO,salud sexual y reproductiva,hemorragia de la primera mitad del embarazo (< 22 sem) aborto,2016-05-01,0,1,1
50501,SAN PEDRO DE BUENA VISTA,salud sexual y reproductiva,hemorragia de la primera mitad del embarazo (< 22 sem) aborto,2016-05-01,0,1,1
71103,SAN RAMON SCZ,salud sexual y reproductiva,hemorragia de la primera mitad del embarazo (< 22 sem) aborto,2016-05-01,2,0,2
80401,SANTA ANA,salud sexual y reproductiva,hemorragia de la primera mitad del embarazo (< 22 sem) aborto,2016-05-01,2,0,2
70101,SANTA CRUZ DE LA SIERRA,salud sexual y reproductiva,hemorragia de la primera mitad del embarazo (< 22 sem) aborto,2016-05-01,269,88,357
20205,SANTIAGO DE HUATA,salud sexual y reproductiva,hemorragia de la primera mitad del embarazo (< 22 sem) aborto,2016-05-01,1,0,1
31602,SHINAOTA,salud sexual y reproductiva,hemorragia de la primera mitad del embarazo (< 22 sem) aborto,2016-05-01,20,0,20
10403,SOPACHUY,salud sexual y reproductiva,hemorragia de la primera mitad del embarazo (< 22 sem) aborto,2016-05-01,0,1,1
20601,SORATA,salud sexual y reproductiva,hemorragia de la primera mitad del embarazo (< 22 sem) aborto,2016-05-01,1,0,1
10101,SUCRE,salud sexual y reproductiva,hemorragia de la primera mitad del embarazo (< 22 sem) aborto,2016-05-01,78,1,79
30602,TACOPAYA,salud sexual y reproductiva,hemorragia de la primera mitad del embarazo (< 22 sem) aborto,2016-05-01,0,1,1
60101,TARIJA,salud sexual y reproductiva,hemorragia de la primera mitad del embarazo (< 22 sem) aborto,2016-05-01,47,0,47
10202,TARVITA,salud sexual y reproductiva,hemorragia de la primera mitad del embarazo (< 22 sem) aborto,2016-05-01,1,0,1
20803,TIAWANACU,salud sexual y reproductiva,hemorragia de la primera mitad del embarazo (< 22 sem) aborto,2016-05-01,0,1,1
31601,TIRAQUE (CBBA),salud sexual y reproductiva,hemorragia de la primera mitad del embarazo (< 22 sem) aborto,2016-05-01,1,0,1
30803,TOLATA,salud sexual y reproductiva,hemorragia de la primera mitad del embarazo (< 22 sem) aborto,2016-05-01,0,1,1
10402,TOMINA,salud sexual y reproductiva,hemorragia de la primera mitad del embarazo (< 22 sem) aborto,2016-05-01,0,1,1
31201,TOTORA(CBBA),salud sexual y reproductiva,hemorragia de la primera mitad del embarazo (< 22 sem) aborto,2016-05-01,1,0,1
41301,TOTORA(ORR),salud sexual y reproductiva,hemorragia de la primera mitad del embarazo (< 22 sem) aborto,2016-05-01,0,1,1
80101,TRINIDAD,salud sexual y reproductiva,hemorragia de la primera mitad del embarazo (< 22 sem) aborto,2016-05-01,20,1,21
50801,TUPIZA,salud sexual y reproductiva,hemorragia de la primera mitad del embarazo (< 22 sem) aborto,2016-05-01,3,0,3
10801,VILLA SERRANO,salud sexual y reproductiva,hemorragia de la primera mitad del embarazo (< 22 sem) aborto,2016-05-01,1,1,2
31003,VILLA TUNARI,salud sexual y reproductiva,hemorragia de la primera mitad del embarazo (< 22 sem) aborto,2016-05-01,23,0,23
11001,VILLA VACA GUZMAN (MUYUPAMPA),salud sexual y reproductiva,hemorragia de la primera mitad del embarazo (< 22 sem) aborto,2016-05-01,2,0,2
51501,VILLAZON,salud sexual y reproductiva,hemorragia de la primera mitad del embarazo (< 22 sem) aborto,2016-05-01,7,2,9
70201,WARNES,salud sexual y reproductiva,hemorragia de la primera mitad del embarazo (< 22 sem) aborto,2016-05-01,0,23,23
60301,YACUIBA,salud sexual y reproductiva,hemorragia de la primera mitad del embarazo (< 22 sem) aborto,2016-05-01,0,3,3
70403,YAPACANI,salud sexual y reproductiva,hemorragia de la primera mitad del embarazo (< 22 sem) aborto,2016-05-01,7,0,7
30201,AIQUILE,salud sexual y reproductiva,hemorragia de la primera mitad del embarazo (< 22 sem) aborto,2016-06-01,5,0,5
30501,ARANI,salud sexual y reproductiva,hemorragia de la primera mitad del embarazo (< 22 sem) aborto,2016-06-01,2,0,2
30403,ARBIETO,salud sexual y reproductiva,hemorragia de la primera mitad del embarazo (< 22 sem) aborto,2016-06-01,1,0,1
71501,ASCENCION DE GUARAYOS,salud sexual y reproductiva,hemorragia de la primera mitad del embarazo (< 22 sem) aborto,2016-06-01,5,3,8
60202,BERMEJO,salud sexual y reproductiva,hemorragia de la primera mitad del embarazo (< 22 sem) aborto,2016-06-01,0,2,2
50301,BETANZOS,salud sexual y reproductiva,hemorragia de la primera mitad del embarazo (< 22 sem) aborto,2016-06-01,0,1,1
10701,CAMARGO,salud sexual y reproductiva,hemorragia de la primera mitad del embarazo (< 22 sem) aborto,2016-06-01,2,0,2
70706,CAMIRI,salud sexual y reproductiva,hemorragia de la primera mitad del embarazo (< 22 sem) aborto,2016-06-01,14,0,14
30701,CAPINOTA,salud sexual y reproductiva,hemorragia de la primera mitad del embarazo (< 22 sem) aborto,2016-06-01,3,0,3
22001,CARANAVI,salud sexual y reproductiva,hemorragia de la primera mitad del embarazo (< 22 sem) aborto,2016-06-01,28,0,28
50302,CHAQUI,salud sexual y reproductiva,hemorragia de la primera mitad del embarazo (< 22 sem) aborto,2016-06-01,1,0,1
70702,CHARAGUA,salud sexual y reproductiva,hemorragia de la primera mitad del embarazo (< 22 sem) aborto,2016-06-01,5,0,5
31204,CHIMORE,salud sexual y reproductiva,hemorragia de la primera mitad del embarazo (< 22 sem) aborto,2016-06-01,1,0,1
21101,CHULUMANI (V. DE LA LIBERTAD),salud sexual y reproductiva,hemorragia de la primera mitad del embarazo (< 22 sem) aborto,2016-06-01,6,0,6
51103,CKOCHAS,salud sexual y reproductiva,hemorragia de la primera mitad del embarazo (< 22 sem) aborto,2016-06-01,0,2,2
30801,CLIZA,salud sexual y reproductiva,hemorragia de la primera mitad del embarazo (< 22 sem) aborto,2016-06-01,11,0,11
90101,COBIJA,salud sexual y reproductiva,hemorragia de la primera mitad del embarazo (< 22 sem) aborto,2016-06-01,27,0,27
30101,COCHABAMBA,salud sexual y reproductiva,hemorragia de la primera mitad del embarazo (< 22 sem) aborto,2016-06-01,173,7,180
30905,COLCAPIRHUA,salud sexual y reproductiva,hemorragia de la primera mitad del embarazo (< 22 sem) aborto,2016-06-01,2,0,2
31002,COLOMI,salud sexual y reproductiva,hemorragia de la primera mitad del embarazo (< 22 sem) aborto,2016-06-01,2,0,2
71301,COMARAPA,salud sexual y reproductiva,hemorragia de la primera mitad del embarazo (< 22 sem) aborto,2016-06-01,5,2,7
71101,CONCEPCION,salud sexual y reproductiva,hemorragia de la primera mitad del embarazo (< 22 sem) aborto,2016-06-01,2,0,2
40301,CORQUE,salud sexual y reproductiva,hemorragia de la primera mitad del embarazo (< 22 sem) aborto,2016-06-01,2,0,2
50601,COTAGAITA,salud sexual y reproductiva,hemorragia de la primera mitad del embarazo (< 22 sem) aborto,2016-06-01,2,0,2
70102,COTOCA,salud sexual y reproductiva,hemorragia de la primera mitad del embarazo (< 22 sem) aborto,2016-06-01,11,0,11
20105,EL ALTO,salud sexual y reproductiva,hemorragia de la primera mitad del embarazo (< 22 sem) aborto,2016-06-01,169,4,173
70105,EL TORNO,salud sexual y reproductiva,hemorragia de la primera mitad del embarazo (< 22 sem) aborto,2016-06-01,18,0,18
31206,ENTRE RIOS CBBA,salud sexual y reproductiva,hemorragia de la primera mitad del embarazo (< 22 sem) aborto,2016-06-01,1,0,1
20405,ESCOMA,salud sexual y reproductiva,hemorragia de la primera mitad del embarazo (< 22 sem) aborto,2016-06-01,0,4,4
40701,HUANUNI,salud sexual y reproductiva,hemorragia de la primera mitad del embarazo (< 22 sem) aborto,2016-06-01,8,0,8
20204,HUARINA,salud sexual y reproductiva,hemorragia de la primera mitad del embarazo (< 22 sem) aborto,2016-06-01,1,0,1
20806,JESUS DE MACHACA,salud sexual y reproductiva,hemorragia de la primera mitad del embarazo (< 22 sem) aborto,2016-06-01,0,1,1
21105,LA ASUNTA,salud sexual y reproductiva,hemorragia de la primera mitad del embarazo (< 22 sem) aborto,2016-06-01,15,0,15
70104,LA GUARDIA,salud sexual y reproductiva,hemorragia de la primera mitad del embarazo (< 22 sem) aborto,2016-06-01,0,19,19
20101,LA PAZ,salud sexual y reproductiva,hemorragia de la primera mitad del embarazo (< 22 sem) aborto,2016-06-01,149,4,153
21202,LAJA,salud sexual y reproductiva,hemorragia de la primera mitad del embarazo (< 22 sem) aborto,2016-06-01,0,1,1
80601,LORETO,salud sexual y reproductiva,hemorragia de la primera mitad del embarazo (< 22 sem) aborto,2016-06-01,0,1,1
40702,MACHACAMARCA,salud sexual y reproductiva,hemorragia de la primera mitad del embarazo (< 22 sem) aborto,2016-06-01,2,0,2
70903,MAIRANA,salud sexual y reproductiva,hemorragia de la primera mitad del embarazo (< 22 sem) aborto,2016-06-01,5,0,5
31301,MIZQUE,salud sexual y reproductiva,hemorragia de la primera mitad del embarazo (< 22 sem) aborto,2016-06-01,0,2,2
71001,MONTERO,salud sexual y reproductiva,hemorragia de la primera mitad del embarazo (< 22 sem) aborto,2016-06-01,2,0,2
40101,ORURO,salud sexual y reproductiva,hemorragia de la primera mitad del embarazo (< 22 sem) aborto,2016-06-01,6,0,6
70502,PAILON,salud sexual y reproductiva,hemorragia de la primera mitad del embarazo (< 22 sem) aborto,2016-06-01,1,0,1
31203,POCONA,salud sexual y reproductiva,hemorragia de la primera mitad del embarazo (< 22 sem) aborto,2016-06-01,1,0,1
10103,POROMA,salud sexual y reproductiva,hemorragia de la primera mitad del embarazo (< 22 sem) aborto,2016-06-01,1,0,1
70601,PORTACHUELO,salud sexual y reproductiva,hemorragia de la primera mitad del embarazo (< 22 sem) aborto,2016-06-01,1,0,1
50101,POTOSI,salud sexual y reproductiva,hemorragia de la primera mitad del embarazo (< 22 sem) aborto,2016-06-01,10,0,10
10302,PRESTO,salud sexual y reproductiva,hemorragia de la primera mitad del embarazo (< 22 sem) aborto,2016-06-01,0,1,1
21201,PUCARANI,salud sexual y reproductiva,hemorragia de la primera mitad del embarazo (< 22 sem) aborto,2016-06-01,1,0,1
90201,PUERTO RICO,salud sexual y reproductiva,hemorragia de la primera mitad del embarazo (< 22 sem) aborto,2016-06-01,1,0,1
71401,PUERTO SUAREZ,salud sexual y reproductiva,hemorragia de la primera mitad del embarazo (< 22 sem) aborto,2016-06-01,9,0,9
31205,PUERTO VILLARROEL,salud sexual y reproductiva,hemorragia de la primera mitad del embarazo (< 22 sem) aborto,2016-06-01,0,27,27
31401,PUNATA,salud sexual y reproductiva,hemorragia de la primera mitad del embarazo (< 22 sem) aborto,2016-06-01,10,0,10
30901,QUILLACOLLO,salud sexual y reproductiva,hemorragia de la primera mitad del embarazo (< 22 sem) aborto,2016-06-01,61,0,61
80301,REYES,salud sexual y reproductiva,hemorragia de la primera mitad del embarazo (< 22 sem) aborto,2016-06-01,3,0,3
80201,RIBERALTA,salud sexual y reproductiva,hemorragia de la primera mitad del embarazo (< 22 sem) aborto,2016-06-01,40,1,41
70503,ROBORE,salud sexual y reproductiva,hemorragia de la primera mitad del embarazo (< 22 sem) aborto,2016-06-01,3,0,3
80304,RURRENABAQUE,salud sexual y reproductiva,hemorragia de la primera mitad del embarazo (< 22 sem) aborto,2016-06-01,13,0,13
31001,SACABA,salud sexual y reproductiva,hemorragia de la primera mitad del embarazo (< 22 sem) aborto,2016-06-01,51,0,51
40801,SALINAS DE GARCI MENDOZA,salud sexual y reproductiva,hemorragia de la primera mitad del embarazo (< 22 sem) aborto,2016-06-01,0,1,1
80302,SAN BORJA,salud sexual y reproductiva,hemorragia de la primera mitad del embarazo (< 22 sem) aborto,2016-06-01,11,0,11
70402,SAN CARLOS,salud sexual y reproductiva,hemorragia de la primera mitad del embarazo (< 22 sem) aborto,2016-06-01,9,0,9
80501,SAN IGNACIO,salud sexual y reproductiva,hemorragia de la primera mitad del embarazo (< 22 sem) aborto,2016-06-01,3,0,3
70301,SAN IGNACIO DE VELASCO,salud sexual y reproductiva,hemorragia de la primera mitad del embarazo (< 22 sem) aborto,2016-06-01,2,0,2
70501,SAN JOSE DE CHIQUITOS,salud sexual y reproductiva,hemorragia de la primera mitad del embarazo (< 22 sem) aborto,2016-06-01,7,0,7
71104,SAN JULIAN,salud sexual y reproductiva,hemorragia de la primera mitad del embarazo (< 22 sem) aborto,2016-06-01,11,0,11
10702,SAN LUCAS,salud sexual y reproductiva,hemorragia de la primera mitad del embarazo (< 22 sem) aborto,2016-06-01,6,0,6
71201,SAN MATIAS,salud sexual y reproductiva,hemorragia de la primera mitad del embarazo (< 22 sem) aborto,2016-06-01,0,1,1
71103,SAN RAMON SCZ,salud sexual y reproductiva,hemorragia de la primera mitad del embarazo (< 22 sem) aborto,2016-06-01,3,0,3
80401,SANTA ANA,salud sexual y reproductiva,hemorragia de la primera mitad del embarazo (< 22 sem) aborto,2016-06-01,2,1,3
70101,SANTA CRUZ DE LA SIERRA,salud sexual y reproductiva,hemorragia de la primera mitad del embarazo (< 22 sem) aborto,2016-06-01,342,99,441
20902,SAPAHAQUI,salud sexual y reproductiva,hemorragia de la primera mitad del embarazo (< 22 sem) aborto,2016-06-01,1,1,2
90303,SENA,salud sexual y reproductiva,hemorragia de la primera mitad del embarazo (< 22 sem) aborto,2016-06-01,1,0,1
31602,SHINAOTA,salud sexual y reproductiva,hemorragia de la primera mitad del embarazo (< 22 sem) aborto,2016-06-01,9,0,9
10101,SUCRE,salud sexual y reproductiva,hemorragia de la primera mitad del embarazo (< 22 sem) aborto,2016-06-01,99,20,119
50303,TACOBAMBA,salud sexual y reproductiva,hemorragia de la primera mitad del embarazo (< 22 sem) aborto,2016-06-01,1,0,1
10601,TARABUCO,salud sexual y reproductiva,hemorragia de la primera mitad del embarazo (< 22 sem) aborto,2016-06-01,0,3,3
60101,TARIJA,salud sexual y reproductiva,hemorragia de la primera mitad del embarazo (< 22 sem) aborto,2016-06-01,50,0,50
20803,TIAWANACU,salud sexual y reproductiva,hemorragia de la primera mitad del embarazo (< 22 sem) aborto,2016-06-01,0,2,2
30903,TIQUIPAYA,salud sexual y reproductiva,hemorragia de la primera mitad del embarazo (< 22 sem) aborto,2016-06-01,1,0,1
30803,TOLATA,salud sexual y reproductiva,hemorragia de la primera mitad del embarazo (< 22 sem) aborto,2016-06-01,1,0,1
80101,TRINIDAD,salud sexual y reproductiva,hemorragia de la primera mitad del embarazo (< 22 sem) aborto,2016-06-01,20,0,20
50801,TUPIZA,salud sexual y reproductiva,hemorragia de la primera mitad del embarazo (< 22 sem) aborto,2016-06-01,8,1,9
51201,UYUNI,salud sexual y reproductiva,hemorragia de la primera mitad del embarazo (< 22 sem) aborto,2016-06-01,0,13,13
10704,VILLA CHARCAS,salud sexual y reproductiva,hemorragia de la primera mitad del embarazo (< 22 sem) aborto,2016-06-01,0,1,1
10801,VILLA SERRANO,salud sexual y reproductiva,hemorragia de la primera mitad del embarazo (< 22 sem) aborto,2016-06-01,0,1,1
31003,VILLA TUNARI,salud sexual y reproductiva,hemorragia de la primera mitad del embarazo (< 22 sem) aborto,2016-06-01,7,0,7
11001,VILLA VACA GUZMAN (MUYUPAMPA),salud sexual y reproductiva,hemorragia de la primera mitad del embarazo (< 22 sem) aborto,2016-06-01,1,0,1
51501,VILLAZON,salud sexual y reproductiva,hemorragia de la primera mitad del embarazo (< 22 sem) aborto,2016-06-01,9,2,11
70201,WARNES,salud sexual y reproductiva,hemorragia de la primera mitad del embarazo (< 22 sem) aborto,2016-06-01,30,3,33
70403,YAPACANI,salud sexual y reproductiva,hemorragia de la primera mitad del embarazo (< 22 sem) aborto,2016-06-01,12,1,13
10102,YOTALA,salud sexual y reproductiva,hemorragia de la primera mitad del embarazo (< 22 sem) aborto,2016-06-01,2,0,2
60402,YUNCHARA,salud sexual y reproductiva,hemorragia de la primera mitad del embarazo (< 22 sem) aborto,2016-06-01,0,1,1
30201,AIQUILE,salud sexual y reproductiva,hemorragia de la primera mitad del embarazo (< 22 sem) aborto,2016-07-01,3,0,3
71501,ASCENCION DE GUARAYOS,salud sexual y reproductiva,hemorragia de la primera mitad del embarazo (< 22 sem) aborto,2016-07-01,2,1,3
50802,ATOCHA,salud sexual y reproductiva,hemorragia de la primera mitad del embarazo (< 22 sem) aborto,2016-07-01,0,1,1
21203,BATALLAS,salud sexual y reproductiva,hemorragia de la primera mitad del embarazo (< 22 sem) aborto,2016-07-01,1,0,1
20905,CAIROMA,salud sexual y reproductiva,hemorragia de la primera mitad del embarazo (< 22 sem) aborto,2016-07-01,0,1,1
21304,CALAMARCA,salud sexual y reproductiva,hemorragia de la primera mitad del embarazo (< 22 sem) aborto,2016-07-01,0,1,1
10701,CAMARGO,salud sexual y reproductiva,hemorragia de la primera mitad del embarazo (< 22 sem) aborto,2016-07-01,0,8,8
70706,CAMIRI,salud sexual y reproductiva,hemorragia de la primera mitad del embarazo (< 22 sem) aborto,2016-07-01,2,0,2
30701,CAPINOTA,salud sexual y reproductiva,hemorragia de la primera mitad del embarazo (< 22 sem) aborto,2016-07-01,2,0,2
22001,CARANAVI,salud sexual y reproductiva,hemorragia de la primera mitad del embarazo (< 22 sem) aborto,2016-07-01,14,0,14
70702,CHARAGUA,salud sexual y reproductiva,hemorragia de la primera mitad del embarazo (< 22 sem) aborto,2016-07-01,2,0,2
21101,CHULUMANI (V. DE LA LIBERTAD),salud sexual y reproductiva,hemorragia de la primera mitad del embarazo (< 22 sem) aborto,2016-07-01,4,0,4
51103,CKOCHAS,salud sexual y reproductiva,hemorragia de la primera mitad del embarazo (< 22 sem) aborto,2016-07-01,0,1,1
30801,CLIZA,salud sexual y reproductiva,hemorragia de la primera mitad del embarazo (< 22 sem) aborto,2016-07-01,8,0,8
90101,COBIJA,salud sexual y reproductiva,hemorragia de la primera mitad del embarazo (< 22 sem) aborto,2016-07-01,31,0,31
30101,COCHABAMBA,salud sexual y reproductiva,hemorragia de la primera mitad del embarazo (< 22 sem) aborto,2016-07-01,150,68,218
30905,COLCAPIRHUA,salud sexual y reproductiva,hemorragia de la primera mitad del embarazo (< 22 sem) aborto,2016-07-01,2,0,2
31002,COLOMI,salud sexual y reproductiva,hemorragia de la primera mitad del embarazo (< 22 sem) aborto,2016-07-01,4,0,4
71301,COMARAPA,salud sexual y reproductiva,hemorragia de la primera mitad del embarazo (< 22 sem) aborto,2016-07-01,5,0,5
71101,CONCEPCION,salud sexual y reproductiva,hemorragia de la primera mitad del embarazo (< 22 sem) aborto,2016-07-01,5,0,5
50601,COTAGAITA,salud sexual y reproductiva,hemorragia de la primera mitad del embarazo (< 22 sem) aborto,2016-07-01,2,2,4
70102,COTOCA,salud sexual y reproductiva,hemorragia de la primera mitad del embarazo (< 22 sem) aborto,2016-07-01,2,0,2
10902,CULPINA,salud sexual y reproductiva,hemorragia de la primera mitad del embarazo (< 22 sem) aborto,2016-07-01,4,0,4
20105,EL ALTO,salud sexual y reproductiva,hemorragia de la primera mitad del embarazo (< 22 sem) aborto,2016-07-01,125,13,138
71503,EL PUENTE(STC),salud sexual y reproductiva,hemorragia de la primera mitad del embarazo (< 22 sem) aborto,2016-07-01,0,1,1
60502,EL PUENTE(TJA),salud sexual y reproductiva,hemorragia de la primera mitad del embarazo (< 22 sem) aborto,2016-07-01,1,0,1
70105,EL TORNO,salud sexual y reproductiva,hemorragia de la primera mitad del embarazo (< 22 sem) aborto,2016-07-01,10,6,16
31206,ENTRE RIOS CBBA,salud sexual y reproductiva,hemorragia de la primera mitad del embarazo (< 22 sem) aborto,2016-07-01,2,0,2
20405,ESCOMA,salud sexual y reproductiva,hemorragia de la primera mitad del embarazo (< 22 sem) aborto,2016-07-01,2,2,4
20602,GUANAY,salud sexual y reproductiva,hemorragia de la primera mitad del embarazo (< 22 sem) aborto,2016-07-01,0,7,7
80202,GUAYARAMERIN,salud sexual y reproductiva,hemorragia de la primera mitad del embarazo (< 22 sem) aborto,2016-07-01,1,3,4
40701,HUANUNI,salud sexual y reproductiva,hemorragia de la primera mitad del embarazo (< 22 sem) aborto,2016-07-01,5,1,6
20204,HUARINA,salud sexual y reproductiva,hemorragia de la primera mitad del embarazo (< 22 sem) aborto,2016-07-01,1,0,1
21105,LA ASUNTA,salud sexual y reproductiva,hemorragia de la primera mitad del embarazo (< 22 sem) aborto,2016-07-01,8,0,8
70104,LA GUARDIA,salud sexual y reproductiva,hemorragia de la primera mitad del embarazo (< 22 sem) aborto,2016-07-01,0,5,5
20101,LA PAZ,salud sexual y reproductiva,hemorragia de la primera mitad del embarazo (< 22 sem) aborto,2016-07-01,200,10,210
70903,MAIRANA,salud sexual y reproductiva,hemorragia de la primera mitad del embarazo (< 22 sem) aborto,2016-07-01,5,0,5
31301,MIZQUE,salud sexual y reproductiva,hemorragia de la primera mitad del embarazo (< 22 sem) aborto,2016-07-01,2,0,2
10303,MOJOCOYA,salud sexual y reproductiva,hemorragia de la primera mitad del embarazo (< 22 sem) aborto,2016-07-01,0,1,1
71001,MONTERO,salud sexual y reproductiva,hemorragia de la primera mitad del embarazo (< 22 sem) aborto,2016-07-01,1,0,1
30302,MOROCHATA,salud sexual y reproductiva,hemorragia de la primera mitad del embarazo (< 22 sem) aborto,2016-07-01,0,1,1
90401,NACEBE (SANTA ROSA DEL ABUNA),salud sexual y reproductiva,hemorragia de la primera mitad del embarazo (< 22 sem) aborto,2016-07-01,0,1,1
40101,ORURO,salud sexual y reproductiva,hemorragia de la primera mitad del embarazo (< 22 sem) aborto,2016-07-01,9,2,11
60201,PADCAYA,salud sexual y reproductiva,hemorragia de la primera mitad del embarazo (< 22 sem) aborto,2016-07-01,1,0,1
70502,PAILON,salud sexual y reproductiva,hemorragia de la primera mitad del embarazo (< 22 sem) aborto,2016-07-01,2,0,2
40601,POOPO,salud sexual y reproductiva,hemorragia de la primera mitad del embarazo (< 22 sem) aborto,2016-07-01,0,1,1
70601,PORTACHUELO,salud sexual y reproductiva,hemorragia de la primera mitad del embarazo (< 22 sem) aborto,2016-07-01,0,1,1
50101,POTOSI,salud sexual y reproductiva,hemorragia de la primera mitad del embarazo (< 22 sem) aborto,2016-07-01,29,0,29
90201,PUERTO RICO,salud sexual y reproductiva,hemorragia de la primera mitad del embarazo (< 22 sem) aborto,2016-07-01,2,0,2
71401,PUERTO SUAREZ,salud sexual y reproductiva,hemorragia de la primera mitad del embarazo (< 22 sem) aborto,2016-07-01,6,0,6
31205,PUERTO VILLARROEL,salud sexual y reproductiva,hemorragia de la primera mitad del embarazo (< 22 sem) aborto,2016-07-01,0,33,33
51101,PUNA,salud sexual y reproductiva,hemorragia de la primera mitad del embarazo (< 22 sem) aborto,2016-07-01,1,0,1
31401,PUNATA,salud sexual y reproductiva,hemorragia de la primera mitad del embarazo (< 22 sem) aborto,2016-07-01,19,0,19
30901,QUILLACOLLO,salud sexual y reproductiva,hemorragia de la primera mitad del embarazo (< 22 sem) aborto,2016-07-01,47,0,47
70904,QUIRUSILLAS,salud sexual y reproductiva,hemorragia de la primera mitad del embarazo (< 22 sem) aborto,2016-07-01,0,1,1
80301,REYES,salud sexual y reproductiva,hemorragia de la primera mitad del embarazo (< 22 sem) aborto,2016-07-01,1,0,1
80201,RIBERALTA,salud sexual y reproductiva,hemorragia de la primera mitad del embarazo (< 22 sem) aborto,2016-07-01,35,1,36
70503,ROBORE,salud sexual y reproductiva,hemorragia de la primera mitad del embarazo (< 22 sem) aborto,2016-07-01,6,0,6
31001,SACABA,salud sexual y reproductiva,hemorragia de la primera mitad del embarazo (< 22 sem) aborto,2016-07-01,58,0,58
40801,SALINAS DE GARCI MENDOZA,salud sexual y reproductiva,hemorragia de la primera mitad del embarazo (< 22 sem) aborto,2016-07-01,0,1,1
70901,SAMAIPATA,salud sexual y reproductiva,hemorragia de la primera mitad del embarazo (< 22 sem) aborto,2016-07-01,2,0,2
31403,SAN BENITO,salud sexual y reproductiva,hemorragia de la primera mitad del embarazo (< 22 sem) aborto,2016-07-01,0,1,1
80302,SAN BORJA,salud sexual y reproductiva,hemorragia de la primera mitad del embarazo (< 22 sem) aborto,2016-07-01,0,23,23
70402,SAN CARLOS,salud sexual y reproductiva,hemorragia de la primera mitad del embarazo (< 22 sem) aborto,2016-07-01,9,0,9
80501,SAN IGNACIO,salud sexual y reproductiva,hemorragia de la primera mitad del embarazo (< 22 sem) aborto,2016-07-01,5,0,5
70301,SAN IGNACIO DE VELASCO,salud sexual y reproductiva,hemorragia de la primera mitad del embarazo (< 22 sem) aborto,2016-07-01,8,0,8
70501,SAN JOSE DE CHIQUITOS,salud sexual y reproductiva,hemorragia de la primera mitad del embarazo (< 22 sem) aborto,2016-07-01,8,0,8
71104,SAN JULIAN,salud sexual y reproductiva,hemorragia de la primera mitad del embarazo (< 22 sem) aborto,2016-07-01,7,0,7
60501,SAN LORENZO(TJA),salud sexual y reproductiva,hemorragia de la primera mitad del embarazo (< 22 sem) aborto,2016-07-01,4,0,4
10702,SAN LUCAS,salud sexual y reproductiva,hemorragia de la primera mitad del embarazo (< 22 sem) aborto,2016-07-01,2,1,3
71201,SAN MATIAS,salud sexual y reproductiva,hemorragia de la primera mitad del embarazo (< 22 sem) aborto,2016-07-01,0,4,4
70302,SAN MIGUEL DE VELASCO,salud sexual y reproductiva,hemorragia de la primera mitad del embarazo (< 22 sem) aborto,2016-07-01,2,0,2
71005,SAN PEDRO,salud sexual y reproductiva,hemorragia de la primera mitad del embarazo (< 22 sem) aborto,2016-07-01,0,1,1
71103,SAN RAMON SCZ,salud sexual y reproductiva,hemorragia de la primera mitad del embarazo (< 22 sem) aborto,2016-07-01,3,0,3
80401,SANTA ANA,salud sexual y reproductiva,hemorragia de la primera mitad del embarazo (< 22 sem) aborto,2016-07-01,0,3,3
70101,SANTA CRUZ DE LA SIERRA,salud sexual y reproductiva,hemorragia de la primera mitad del embarazo (< 22 sem) aborto,2016-07-01,314,103,417
70602,SANTA ROSA DEL SARA,salud sexual y reproductiva,hemorragia de la primera mitad del embarazo (< 22 sem) aborto,2016-07-01,1,0,1
90303,SENA,salud sexual y reproductiva,hemorragia de la primera mitad del embarazo (< 22 sem) aborto,2016-07-01,1,0,1
31602,SHINAOTA,salud sexual y reproductiva,hemorragia de la primera mitad del embarazo (< 22 sem) aborto,2016-07-01,16,0,16
30902,SIPE SIPE,salud sexual y reproductiva,hemorragia de la primera mitad del embarazo (< 22 sem) aborto,2016-07-01,1,0,1
10403,SOPACHUY,salud sexual y reproductiva,hemorragia de la primera mitad del embarazo (< 22 sem) aborto,2016-07-01,0,2,2
10101,SUCRE,salud sexual y reproductiva,hemorragia de la primera mitad del embarazo (< 22 sem) aborto,2016-07-01,94,15,109
30602,TACOPAYA,salud sexual y reproductiva,hemorragia de la primera mitad del embarazo (< 22 sem) aborto,2016-07-01,1,0,1
31101,TAPACARI,salud sexual y reproductiva,hemorragia de la primera mitad del embarazo (< 22 sem) aborto,2016-07-01,1,0,1
10601,TARABUCO,salud sexual y reproductiva,hemorragia de la primera mitad del embarazo (< 22 sem) aborto,2016-07-01,0,1,1
60101,TARIJA,salud sexual y reproductiva,hemorragia de la primera mitad del embarazo (< 22 sem) aborto,2016-07-01,63,0,63
10202,TARVITA,salud sexual y reproductiva,hemorragia de la primera mitad del embarazo (< 22 sem) aborto,2016-07-01,0,1,1
20608,TEOPONTE,salud sexual y reproductiva,hemorragia de la primera mitad del embarazo (< 22 sem) aborto,2016-07-01,2,0,2
20803,TIAWANACU,salud sexual y reproductiva,hemorragia de la primera mitad del embarazo (< 22 sem) aborto,2016-07-01,0,3,3
20606,TIPUANI,salud sexual y reproductiva,hemorragia de la primera mitad del embarazo (< 22 sem) aborto,2016-07-01,2,0,2
31601,TIRAQUE (CBBA),salud sexual y reproductiva,hemorragia de la primera mitad del embarazo (< 22 sem) aborto,2016-07-01,1,0,1
80101,TRINIDAD,salud sexual y reproductiva,hemorragia de la primera mitad del embarazo (< 22 sem) aborto,2016-07-01,30,0,30
50801,TUPIZA,salud sexual y reproductiva,hemorragia de la primera mitad del embarazo (< 22 sem) aborto,2016-07-01,6,0,6
51201,UYUNI,salud sexual y reproductiva,hemorragia de la primera mitad del embarazo (< 22 sem) aborto,2016-07-01,0,6,6
10801,VILLA SERRANO,salud sexual y reproductiva,hemorragia de la primera mitad del embarazo (< 22 sem) aborto,2016-07-01,0,1,1
31003,VILLA TUNARI,salud sexual y reproductiva,hemorragia de la primera mitad del embarazo (< 22 sem) aborto,2016-07-01,30,0,30
11001,VILLA VACA GUZMAN (MUYUPAMPA),salud sexual y reproductiva,hemorragia de la primera mitad del embarazo (< 22 sem) aborto,2016-07-01,2,0,2
51501,VILLAZON,salud sexual y reproductiva,hemorragia de la primera mitad del embarazo (< 22 sem) aborto,2016-07-01,6,0,6
70201,WARNES,salud sexual y reproductiva,hemorragia de la primera mitad del embarazo (< 22 sem) aborto,2016-07-01,3,24,27
60301,YACUIBA,salud sexual y reproductiva,hemorragia de la primera mitad del embarazo (< 22 sem) aborto,2016-07-01,0,4,4
70403,YAPACANI,salud sexual y reproductiva,hemorragia de la primera mitad del embarazo (< 22 sem) aborto,2016-07-01,6,0,6
10102,YOTALA,salud sexual y reproductiva,hemorragia de la primera mitad del embarazo (< 22 sem) aborto,2016-07-01,1,0,1
30201,AIQUILE,salud sexual y reproductiva,hemorragia de la primera mitad del embarazo (< 22 sem) aborto,2016-08-01,6,0,6
30501,ARANI,salud sexual y reproductiva,hemorragia de la primera mitad del embarazo (< 22 sem) aborto,2016-08-01,2,0,2
30403,ARBIETO,salud sexual y reproductiva,hemorragia de la primera mitad del embarazo (< 22 sem) aborto,2016-08-01,1,0,1
30601,ARQUE,salud sexual y reproductiva,hemorragia de la primera mitad del embarazo (< 22 sem) aborto,2016-08-01,2,0,2
71501,ASCENCION DE GUARAYOS,salud sexual y reproductiva,hemorragia de la primera mitad del embarazo (< 22 sem) aborto,2016-08-01,9,11,20
60202,BERMEJO,salud sexual y reproductiva,hemorragia de la primera mitad del embarazo (< 22 sem) aborto,2016-08-01,0,1,1
50301,BETANZOS,salud sexual y reproductiva,hemorragia de la primera mitad del embarazo (< 22 sem) aborto,2016-08-01,1,0,1
21003,CAJUATA,salud sexual y reproductiva,hemorragia de la primera mitad del embarazo (< 22 sem) aborto,2016-08-01,0,1,1
10701,CAMARGO,salud sexual y reproductiva,hemorragia de la primera mitad del embarazo (< 22 sem) aborto,2016-08-01,0,3,3
70706,CAMIRI,salud sexual y reproductiva,hemorragia de la primera mitad del embarazo (< 22 sem) aborto,2016-08-01,20,0,20
30701,CAPINOTA,salud sexual y reproductiva,hemorragia de la primera mitad del embarazo (< 22 sem) aborto,2016-08-01,2,0,2
22001,CARANAVI,salud sexual y reproductiva,hemorragia de la primera mitad del embarazo (< 22 sem) aborto,2016-08-01,44,1,45
40201,CHALLAPATA,salud sexual y reproductiva,hemorragia de la primera mitad del embarazo (< 22 sem) aborto,2016-08-01,1,0,1
70702,CHARAGUA,salud sexual y reproductiva,hemorragia de la primera mitad del embarazo (< 22 sem) aborto,2016-08-01,5,0,5
31204,CHIMORE,salud sexual y reproductiva,hemorragia de la primera mitad del embarazo (< 22 sem) aborto,2016-08-01,1,0,1
21101,CHULUMANI (V. DE LA LIBERTAD),salud sexual y reproductiva,hemorragia de la primera mitad del embarazo (< 22 sem) aborto,2016-08-01,9,0,9
51103,CKOCHAS,salud sexual y reproductiva,hemorragia de la primera mitad del embarazo (< 22 sem) aborto,2016-08-01,2,1,3
30801,CLIZA,salud sexual y reproductiva,hemorragia de la primera mitad del embarazo (< 22 sem) aborto,2016-08-01,11,0,11
90101,COBIJA,salud sexual y reproductiva,hemorragia de la primera mitad del embarazo (< 22 sem) aborto,2016-08-01,15,7,22
30303,COCAPATA,salud sexual y reproductiva,hemorragia de la primera mitad del embarazo (< 22 sem) aborto,2016-08-01,0,1,1
30101,COCHABAMBA,salud sexual y reproductiva,hemorragia de la primera mitad del embarazo (< 22 sem) aborto,2016-08-01,265,16,281
30905,COLCAPIRHUA,salud sexual y reproductiva,hemorragia de la primera mitad del embarazo (< 22 sem) aborto,2016-08-01,2,1,3
31002,COLOMI,salud sexual y reproductiva,hemorragia de la primera mitad del embarazo (< 22 sem) aborto,2016-08-01,1,0,1
71301,COMARAPA,salud sexual y reproductiva,hemorragia de la primera mitad del embarazo (< 22 sem) aborto,2016-08-01,2,3,5
71101,CONCEPCION,salud sexual y reproductiva,hemorragia de la primera mitad del embarazo (< 22 sem) aborto,2016-08-01,4,0,4
50601,COTAGAITA,salud sexual y reproductiva,hemorragia de la primera mitad del embarazo (< 22 sem) aborto,2016-08-01,0,3,3
70102,COTOCA,salud sexual y reproductiva,hemorragia de la primera mitad del embarazo (< 22 sem) aborto,2016-08-01,8,0,8
10902,CULPINA,salud sexual y reproductiva,hemorragia de la primera mitad del embarazo (< 22 sem) aborto,2016-08-01,4,0,4
20105,EL ALTO,salud sexual y reproductiva,hemorragia de la primera mitad del embarazo (< 22 sem) aborto,2016-08-01,147,14,161
71503,EL PUENTE(STC),salud sexual y reproductiva,hemorragia de la primera mitad del embarazo (< 22 sem) aborto,2016-08-01,0,2,2
70105,EL TORNO,salud sexual y reproductiva,hemorragia de la primera mitad del embarazo (< 22 sem) aborto,2016-08-01,19,0,19
31206,ENTRE RIOS CBBA,salud sexual y reproductiva,hemorragia de la primera mitad del embarazo (< 22 sem) aborto,2016-08-01,2,0,2
20405,ESCOMA,salud sexual y reproductiva,hemorragia de la primera mitad del embarazo (< 22 sem) aborto,2016-08-01,2,1,3
71002,GENERAL SAAVEDRA,salud sexual y reproductiva,hemorragia de la primera mitad del embarazo (< 22 sem) aborto,2016-08-01,1,0,1
21601,GRAL. J.J. PEREZ (CHARAZANI),salud sexual y reproductiva,hemorragia de la primera mitad del embarazo (< 22 sem) aborto,2016-08-01,1,0,1
80202,GUAYARAMERIN,salud sexual y reproductiva,hemorragia de la primera mitad del embarazo (< 22 sem) aborto,2016-08-01,0,2,2
40701,HUANUNI,salud sexual y reproductiva,hemorragia de la primera mitad del embarazo (< 22 sem) aborto,2016-08-01,1,2,3
10703,INCAHUASI,salud sexual y reproductiva,hemorragia de la primera mitad del embarazo (< 22 sem) aborto,2016-08-01,1,1,2
21105,LA ASUNTA,salud sexual y reproductiva,hemorragia de la primera mitad del embarazo (< 22 sem) aborto,2016-08-01,2,0,2
70104,LA GUARDIA,salud sexual y reproductiva,hemorragia de la primera mitad del embarazo (< 22 sem) aborto,2016-08-01,2,9,11
20101,LA PAZ,salud sexual y reproductiva,hemorragia de la primera mitad del embarazo (< 22 sem) aborto,2016-08-01,213,1,214
70903,MAIRANA,salud sexual y reproductiva,hemorragia de la primera mitad del embarazo (< 22 sem) aborto,2016-08-01,11,0,11
20607,MAPIRI,salud sexual y reproductiva,hemorragia de la primera mitad del embarazo (< 22 sem) aborto,2016-08-01,0,4,4
31301,MIZQUE,salud sexual y reproductiva,hemorragia de la primera mitad del embarazo (< 22 sem) aborto,2016-08-01,0,1,1
10501,MONTEAGUDO,salud sexual y reproductiva,hemorragia de la primera mitad del embarazo (< 22 sem) aborto,2016-08-01,0,2,2
71001,MONTERO,salud sexual y reproductiva,hemorragia de la primera mitad del embarazo (< 22 sem) aborto,2016-08-01,10,6,16
40101,ORURO,salud sexual y reproductiva,hemorragia de la primera mitad del embarazo (< 22 sem) aborto,2016-08-01,11,0,11
70502,PAILON,salud sexual y reproductiva,hemorragia de la primera mitad del embarazo (< 22 sem) aborto,2016-08-01,10,0,10
20102,PALCA,salud sexual y reproductiva,hemorragia de la primera mitad del embarazo (< 22 sem) aborto,2016-08-01,1,0,1
21104,PALOS BLANCOS,salud sexual y reproductiva,hemorragia de la primera mitad del embarazo (< 22 sem) aborto,2016-08-01,7,0,7
50403,POCOATA,salud sexual y reproductiva,hemorragia de la primera mitad del embarazo (< 22 sem) aborto,2016-08-01,1,0,1
10103,POROMA,salud sexual y reproductiva,hemorragia de la primera mitad del embarazo (< 22 sem) aborto,2016-08-01,0,1,1
50101,POTOSI,salud sexual y reproductiva,hemorragia de la primera mitad del embarazo (< 22 sem) aborto,2016-08-01,26,0,26
10302,PRESTO,salud sexual y reproductiva,hemorragia de la primera mitad del embarazo (< 22 sem) aborto,2016-08-01,0,1,1
90301,PUERTO GONZALO MORENO,salud sexual y reproductiva,hemorragia de la primera mitad del embarazo (< 22 sem) aborto,2016-08-01,1,0,1
71402,PUERTO QUIJARRO,salud sexual y reproductiva,hemorragia de la primera mitad del embarazo (< 22 sem) aborto,2016-08-01,1,0,1
90201,PUERTO RICO,salud sexual y reproductiva,hemorragia de la primera mitad del embarazo (< 22 sem) aborto,2016-08-01,1,0,1
71401,PUERTO SUAREZ,salud sexual y reproductiva,hemorragia de la primera mitad del embarazo (< 22 sem) aborto,2016-08-01,6,0,6
31205,PUERTO VILLARROEL,salud sexual y reproductiva,hemorragia de la primera mitad del embarazo (< 22 sem) aborto,2016-08-01,0,25,25
31401,PUNATA,salud sexual y reproductiva,hemorragia de la primera mitad del embarazo (< 22 sem) aborto,2016-08-01,15,0,15
30901,QUILLACOLLO,salud sexual y reproductiva,hemorragia de la primera mitad del embarazo (< 22 sem) aborto,2016-08-01,68,0,68
21002,QUIME,salud sexual y reproductiva,hemorragia de la primera mitad del embarazo (< 22 sem) aborto,2016-08-01,2,0,2
80301,REYES,salud sexual y reproductiva,hemorragia de la primera mitad del embarazo (< 22 sem) aborto,2016-08-01,2,0,2
80201,RIBERALTA,salud sexual y reproductiva,hemorragia de la primera mitad del embarazo (< 22 sem) aborto,2016-08-01,31,13,44
70503,ROBORE,salud sexual y reproductiva,hemorragia de la primera mitad del embarazo (< 22 sem) aborto,2016-08-01,5,0,5
80304,RURRENABAQUE,salud sexual y reproductiva,hemorragia de la primera mitad del embarazo (< 22 sem) aborto,2016-08-01,13,1,14
31001,SACABA,salud sexual y reproductiva,hemorragia de la primera mitad del embarazo (< 22 sem) aborto,2016-08-01,39,0,39
70901,SAMAIPATA,salud sexual y reproductiva,hemorragia de la primera mitad del embarazo (< 22 sem) aborto,2016-08-01,2,0,2
80302,SAN BORJA,salud sexual y reproductiva,hemorragia de la primera mitad del embarazo (< 22 sem) aborto,2016-08-01,19,0,19
70402,SAN CARLOS,salud sexual y reproductiva,hemorragia de la primera mitad del embarazo (< 22 sem) aborto,2016-08-01,5,3,8
80501,SAN IGNACIO,salud sexual y reproductiva,hemorragia de la primera mitad del embarazo (< 22 sem) aborto,2016-08-01,6,0,6
70301,SAN IGNACIO DE VELASCO,salud sexual y reproductiva,hemorragia de la primera mitad del embarazo (< 22 sem) aborto,2016-08-01,10,0,10
71102,SAN JAVIER(STC),salud sexual y reproductiva,hemorragia de la primera mitad del embarazo (< 22 sem) aborto,2016-08-01,1,0,1
70501,SAN JOSE DE CHIQUITOS,salud sexual y reproductiva,hemorragia de la primera mitad del embarazo (< 22 sem) aborto,2016-08-01,4,0,4
71104,SAN JULIAN,salud sexual y reproductiva,hemorragia de la primera mitad del embarazo (< 22 sem) aborto,2016-08-01,21,0,21
10702,SAN LUCAS,salud sexual y reproductiva,hemorragia de la primera mitad del embarazo (< 22 sem) aborto,2016-08-01,1,2,3
70302,SAN MIGUEL DE VELASCO,salud sexual y reproductiva,hemorragia de la primera mitad del embarazo (< 22 sem) aborto,2016-08-01,2,0,2
80702,SAN RAMON BENI,salud sexual y reproductiva,hemorragia de la primera mitad del embarazo (< 22 sem) aborto,2016-08-01,1,0,1
71103,SAN RAMON SCZ,salud sexual y reproductiva,hemorragia de la primera mitad del embarazo (< 22 sem) aborto,2016-08-01,2,0,2
70101,SANTA CRUZ DE LA SIERRA,salud sexual y reproductiva,hemorragia de la primera mitad del embarazo (< 22 sem) aborto,2016-08-01,338,207,545
70602,SANTA ROSA DEL SARA,salud sexual y reproductiva,hemorragia de la primera mitad del embarazo (< 22 sem) aborto,2016-08-01,1,0,1
20902,SAPAHAQUI,salud sexual y reproductiva,hemorragia de la primera mitad del embarazo (< 22 sem) aborto,2016-08-01,1,0,1
90303,SENA,salud sexual y reproductiva,hemorragia de la primera mitad del embarazo (< 22 sem) aborto,2016-08-01,0,1,1
31602,SHINAOTA,salud sexual y reproductiva,hemorragia de la primera mitad del embarazo (< 22 sem) aborto,2016-08-01,20,0,20
21301,SICA SICA (VILLA AROMA),salud sexual y reproductiva,hemorragia de la primera mitad del embarazo (< 22 sem) aborto,2016-08-01,2,0,2
30902,SIPE SIPE,salud sexual y reproductiva,hemorragia de la primera mitad del embarazo (< 22 sem) aborto,2016-08-01,3,0,3
10101,SUCRE,salud sexual y reproductiva,hemorragia de la primera mitad del embarazo (< 22 sem) aborto,2016-08-01,163,10,173
30602,TACOPAYA,salud sexual y reproductiva,hemorragia de la primera mitad del embarazo (< 22 sem) aborto,2016-08-01,1,2,3
10601,TARABUCO,salud sexual y reproductiva,hemorragia de la primera mitad del embarazo (< 22 sem) aborto,2016-08-01,0,6,6
30401,TARATA,salud sexual y reproductiva,hemorragia de la primera mitad del embarazo (< 22 sem) aborto,2016-08-01,0,1,1
60101,TARIJA,salud sexual y reproductiva,hemorragia de la primera mitad del embarazo (< 22 sem) aborto,2016-08-01,80,0,80
20803,TIAWANACU,salud sexual y reproductiva,hemorragia de la primera mitad del embarazo (< 22 sem) aborto,2016-08-01,0,2,2
20606,TIPUANI,salud sexual y reproductiva,hemorragia de la primera mitad del embarazo (< 22 sem) aborto,2016-08-01,1,1,2
31601,TIRAQUE (CBBA),salud sexual y reproductiva,hemorragia de la primera mitad del embarazo (< 22 sem) aborto,2016-08-01,1,0,1
31201,TOTORA(CBBA),salud sexual y reproductiva,hemorragia de la primera mitad del embarazo (< 22 sem) aborto,2016-08-01,1,0,1
80101,TRINIDAD,salud sexual y reproductiva,hemorragia de la primera mitad del embarazo (< 22 sem) aborto,2016-08-01,67,8,75
50801,TUPIZA,salud sexual y reproductiva,hemorragia de la primera mitad del embarazo (< 22 sem) aborto,2016-08-01,10,0,10
51201,UYUNI,salud sexual y reproductiva,hemorragia de la primera mitad del embarazo (< 22 sem) aborto,2016-08-01,0,4,4
31302,VILA VILA,salud sexual y reproductiva,hemorragia de la primera mitad del embarazo (< 22 sem) aborto,2016-08-01,1,0,1
10704,VILLA CHARCAS,salud sexual y reproductiva,hemorragia de la primera mitad del embarazo (< 22 sem) aborto,2016-08-01,2,0,2
31402,VILLA RIVERO,salud sexual y reproductiva,hemorragia de la primera mitad del embarazo (< 22 sem) aborto,2016-08-01,1,0,1
31003,VILLA TUNARI,salud sexual y reproductiva,hemorragia de la primera mitad del embarazo (< 22 sem) aborto,2016-08-01,32,0,32
11001,VILLA VACA GUZMAN (MUYUPAMPA),salud sexual y reproductiva,hemorragia de la primera mitad del embarazo (< 22 sem) aborto,2016-08-01,2,0,2
51501,VILLAZON,salud sexual y reproductiva,hemorragia de la primera mitad del embarazo (< 22 sem) aborto,2016-08-01,18,0,18
30904,VINTO,salud sexual y reproductiva,hemorragia de la primera mitad del embarazo (< 22 sem) aborto,2016-08-01,1,0,1
70201,WARNES,salud sexual y reproductiva,hemorragia de la primera mitad del embarazo (< 22 sem) aborto,2016-08-01,15,7,22
60301,YACUIBA,salud sexual y reproductiva,hemorragia de la primera mitad del embarazo (< 22 sem) aborto,2016-08-01,3,0,3
70403,YAPACANI,salud sexual y reproductiva,hemorragia de la primera mitad del embarazo (< 22 sem) aborto,2016-08-01,25,0,25
10102,YOTALA,salud sexual y reproductiva,hemorragia de la primera mitad del embarazo (< 22 sem) aborto,2016-08-01,2,0,2
10301,ZUDAÃ‘EZ,salud sexual y reproductiva,hemorragia de la primera mitad del embarazo (< 22 sem) aborto,2016-08-01,0,2,2
30201,AIQUILE,salud sexual y reproductiva,hemorragia de la primera mitad del embarazo (< 22 sem) aborto,2016-09-01,10,0,10
30501,ARANI,salud sexual y reproductiva,hemorragia de la primera mitad del embarazo (< 22 sem) aborto,2016-09-01,3,0,3
30403,ARBIETO,salud sexual y reproductiva,hemorragia de la primera mitad del embarazo (< 22 sem) aborto,2016-09-01,0,2,2
30601,ARQUE,salud sexual y reproductiva,hemorragia de la primera mitad del embarazo (< 22 sem) aborto,2016-09-01,1,0,1
71501,ASCENCION DE GUARAYOS,salud sexual y reproductiva,hemorragia de la primera mitad del embarazo (< 22 sem) aborto,2016-09-01,0,12,12
70703,CABEZAS,salud sexual y reproductiva,hemorragia de la primera mitad del embarazo (< 22 sem) aborto,2016-09-01,0,1,1
10701,CAMARGO,salud sexual y reproductiva,hemorragia de la primera mitad del embarazo (< 22 sem) aborto,2016-09-01,0,2,2
70706,CAMIRI,salud sexual y reproductiva,hemorragia de la primera mitad del embarazo (< 22 sem) aborto,2016-09-01,14,0,14
30701,CAPINOTA,salud sexual y reproductiva,hemorragia de la primera mitad del embarazo (< 22 sem) aborto,2016-09-01,1,0,1
22001,CARANAVI,salud sexual y reproductiva,hemorragia de la primera mitad del embarazo (< 22 sem) aborto,2016-09-01,28,0,28
70702,CHARAGUA,salud sexual y reproductiva,hemorragia de la primera mitad del embarazo (< 22 sem) aborto,2016-09-01,4,0,4
21101,CHULUMANI (V. DE LA LIBERTAD),salud sexual y reproductiva,hemorragia de la primera mitad del embarazo (< 22 sem) aborto,2016-09-01,9,0,9
51103,CKOCHAS,salud sexual y reproductiva,hemorragia de la primera mitad del embarazo (< 22 sem) aborto,2016-09-01,1,0,1
30801,CLIZA,salud sexual y reproductiva,hemorragia de la primera mitad del embarazo (< 22 sem) aborto,2016-09-01,12,0,12
90101,COBIJA,salud sexual y reproductiva,hemorragia de la primera mitad del embarazo (< 22 sem) aborto,2016-09-01,29,0,29
30303,COCAPATA,salud sexual y reproductiva,hemorragia de la primera mitad del embarazo (< 22 sem) aborto,2016-09-01,1,0,1
30101,COCHABAMBA,salud sexual y reproductiva,hemorragia de la primera mitad del embarazo (< 22 sem) aborto,2016-09-01,164,12,176
30905,COLCAPIRHUA,salud sexual y reproductiva,hemorragia de la primera mitad del embarazo (< 22 sem) aborto,2016-09-01,1,0,1
31002,COLOMI,salud sexual y reproductiva,hemorragia de la primera mitad del embarazo (< 22 sem) aborto,2016-09-01,3,0,3
50401,COLQUECHACA,salud sexual y reproductiva,hemorragia de la primera mitad del embarazo (< 22 sem) aborto,2016-09-01,0,2,2
71301,COMARAPA,salud sexual y reproductiva,hemorragia de la primera mitad del embarazo (< 22 sem) aborto,2016-09-01,8,0,8
71101,CONCEPCION,salud sexual y reproductiva,hemorragia de la primera mitad del embarazo (< 22 sem) aborto,2016-09-01,5,0,5
21402,CORIPATA,salud sexual y reproductiva,hemorragia de la primera mitad del embarazo (< 22 sem) aborto,2016-09-01,1,0,1
50601,COTAGAITA,salud sexual y reproductiva,hemorragia de la primera mitad del embarazo (< 22 sem) aborto,2016-09-01,0,2,2
70102,COTOCA,salud sexual y reproductiva,hemorragia de la primera mitad del embarazo (< 22 sem) aborto,2016-09-01,4,0,4
20804,DESAGUADERO,salud sexual y reproductiva,hemorragia de la primera mitad del embarazo (< 22 sem) aborto,2016-09-01,0,1,1
20105,EL ALTO,salud sexual y reproductiva,hemorragia de la primera mitad del embarazo (< 22 sem) aborto,2016-09-01,91,12,103
70105,EL TORNO,salud sexual y reproductiva,hemorragia de la primera mitad del embarazo (< 22 sem) aborto,2016-09-01,21,0,21
31206,ENTRE RIOS CBBA,salud sexual y reproductiva,hemorragia de la primera mitad del embarazo (< 22 sem) aborto,2016-09-01,1,0,1
20405,ESCOMA,salud sexual y reproductiva,hemorragia de la primera mitad del embarazo (< 22 sem) aborto,2016-09-01,1,0,1
20602,GUANAY,salud sexual y reproductiva,hemorragia de la primera mitad del embarazo (< 22 sem) aborto,2016-09-01,4,0,4
80202,GUAYARAMERIN,salud sexual y reproductiva,hemorragia de la primera mitad del embarazo (< 22 sem) aborto,2016-09-01,0,4,4
40701,HUANUNI,salud sexual y reproductiva,hemorragia de la primera mitad del embarazo (< 22 sem) aborto,2016-09-01,2,0,2
20204,HUARINA,salud sexual y reproductiva,hemorragia de la primera mitad del embarazo (< 22 sem) aborto,2016-09-01,1,0,1
10304,ICLA,salud sexual y reproductiva,hemorragia de la primera mitad del embarazo (< 22 sem) aborto,2016-09-01,0,1,1
10703,INCAHUASI,salud sexual y reproductiva,hemorragia de la primera mitad del embarazo (< 22 sem) aborto,2016-09-01,0,2,2
20806,JESUS DE MACHACA,salud sexual y reproductiva,hemorragia de la primera mitad del embarazo (< 22 sem) aborto,2016-09-01,0,1,1
21105,LA ASUNTA,salud sexual y reproductiva,hemorragia de la primera mitad del embarazo (< 22 sem) aborto,2016-09-01,11,1,12
70104,LA GUARDIA,salud sexual y reproductiva,hemorragia de la primera mitad del embarazo (< 22 sem) aborto,2016-09-01,0,4,4
20101,LA PAZ,salud sexual y reproductiva,hemorragia de la primera mitad del embarazo (< 22 sem) aborto,2016-09-01,151,3,154
80801,MAGDALENA,salud sexual y reproductiva,hemorragia de la primera mitad del embarazo (< 22 sem) aborto,2016-09-01,0,5,5
70903,MAIRANA,salud sexual y reproductiva,hemorragia de la primera mitad del embarazo (< 22 sem) aborto,2016-09-01,7,0,7
20607,MAPIRI,salud sexual y reproductiva,hemorragia de la primera mitad del embarazo (< 22 sem) aborto,2016-09-01,1,3,4
71003,MINEROS,salud sexual y reproductiva,hemorragia de la primera mitad del embarazo (< 22 sem) aborto,2016-09-01,0,2,2
31301,MIZQUE,salud sexual y reproductiva,hemorragia de la primera mitad del embarazo (< 22 sem) aborto,2016-09-01,1,0,1
10303,MOJOCOYA,salud sexual y reproductiva,hemorragia de la primera mitad del embarazo (< 22 sem) aborto,2016-09-01,0,3,3
71001,MONTERO,salud sexual y reproductiva,hemorragia de la primera mitad del embarazo (< 22 sem) aborto,2016-09-01,2,2,4
30302,MOROCHATA,salud sexual y reproductiva,hemorragia de la primera mitad del embarazo (< 22 sem) aborto,2016-09-01,0,1,1
50404,OCURI,salud sexual y reproductiva,hemorragia de la primera mitad del embarazo (< 22 sem) aborto,2016-09-01,0,1,1
40101,ORURO,salud sexual y reproductiva,hemorragia de la primera mitad del embarazo (< 22 sem) aborto,2016-09-01,7,0,7
70502,PAILON,salud sexual y reproductiva,hemorragia de la primera mitad del embarazo (< 22 sem) aborto,2016-09-01,3,0,3
21104,PALOS BLANCOS,salud sexual y reproductiva,hemorragia de la primera mitad del embarazo (< 22 sem) aborto,2016-09-01,3,0,3
31203,POCONA,salud sexual y reproductiva,hemorragia de la primera mitad del embarazo (< 22 sem) aborto,2016-09-01,1,0,1
31202,POJO (CBBA),salud sexual y reproductiva,hemorragia de la primera mitad del embarazo (< 22 sem) aborto,2016-09-01,1,0,1
70601,PORTACHUELO,salud sexual y reproductiva,hemorragia de la primera mitad del embarazo (< 22 sem) aborto,2016-09-01,2,0,2
50101,POTOSI,salud sexual y reproductiva,hemorragia de la primera mitad del embarazo (< 22 sem) aborto,2016-09-01,23,0,23
21201,PUCARANI,salud sexual y reproductiva,hemorragia de la primera mitad del embarazo (< 22 sem) aborto,2016-09-01,1,0,1
90201,PUERTO RICO,salud sexual y reproductiva,hemorragia de la primera mitad del embarazo (< 22 sem) aborto,2016-09-01,0,1,1
71401,PUERTO SUAREZ,salud sexual y reproductiva,hemorragia de la primera mitad del embarazo (< 22 sem) aborto,2016-09-01,12,0,12
31205,PUERTO VILLARROEL,salud sexual y reproductiva,hemorragia de la primera mitad del embarazo (< 22 sem) aborto,2016-09-01,0,32,32
51101,PUNA,salud sexual y reproductiva,hemorragia de la primera mitad del embarazo (< 22 sem) aborto,2016-09-01,1,0,1
31401,PUNATA,salud sexual y reproductiva,hemorragia de la primera mitad del embarazo (< 22 sem) aborto,2016-09-01,21,0,21
30901,QUILLACOLLO,salud sexual y reproductiva,hemorragia de la primera mitad del embarazo (< 22 sem) aborto,2016-09-01,62,0,62
21002,QUIME,salud sexual y reproductiva,hemorragia de la primera mitad del embarazo (< 22 sem) aborto,2016-09-01,0,1,1
50402,RAVELO,salud sexual y reproductiva,hemorragia de la primera mitad del embarazo (< 22 sem) aborto,2016-09-01,1,0,1
80301,REYES,salud sexual y reproductiva,hemorragia de la primera mitad del embarazo (< 22 sem) aborto,2016-09-01,3,0,3
80201,RIBERALTA,salud sexual y reproductiva,hemorragia de la primera mitad del embarazo (< 22 sem) aborto,2016-09-01,27,0,27
80304,RURRENABAQUE,salud sexual y reproductiva,hemorragia de la primera mitad del embarazo (< 22 sem) aborto,2016-09-01,7,0,7
31001,SACABA,salud sexual y reproductiva,hemorragia de la primera mitad del embarazo (< 22 sem) aborto,2016-09-01,48,0,48
40801,SALINAS DE GARCI MENDOZA,salud sexual y reproductiva,hemorragia de la primera mitad del embarazo (< 22 sem) aborto,2016-09-01,1,0,1
70901,SAMAIPATA,salud sexual y reproductiva,hemorragia de la primera mitad del embarazo (< 22 sem) aborto,2016-09-01,1,0,1
80302,SAN BORJA,salud sexual y reproductiva,hemorragia de la primera mitad del embarazo (< 22 sem) aborto,2016-09-01,11,2,13
21502,SAN BUENA VENTURA,salud sexual y reproductiva,hemorragia de la primera mitad del embarazo (< 22 sem) aborto,2016-09-01,3,0,3
70402,SAN CARLOS,salud sexual y reproductiva,hemorragia de la primera mitad del embarazo (< 22 sem) aborto,2016-09-01,6,0,6
70301,SAN IGNACIO DE VELASCO,salud sexual y reproductiva,hemorragia de la primera mitad del embarazo (< 22 sem) aborto,2016-09-01,9,0,9
71102,SAN JAVIER(STC),salud sexual y reproductiva,hemorragia de la primera mitad del embarazo (< 22 sem) aborto,2016-09-01,1,0,1
70501,SAN JOSE DE CHIQUITOS,salud sexual y reproductiva,hemorragia de la primera mitad del embarazo (< 22 sem) aborto,2016-09-01,6,0,6
71104,SAN JULIAN,salud sexual y reproductiva,hemorragia de la primera mitad del embarazo (< 22 sem) aborto,2016-09-01,17,0,17
60501,SAN LORENZO(TJA),salud sexual y reproductiva,hemorragia de la primera mitad del embarazo (< 22 sem) aborto,2016-09-01,1,0,1
10702,SAN LUCAS,salud sexual y reproductiva,hemorragia de la primera mitad del embarazo (< 22 sem) aborto,2016-09-01,2,1,3
70302,SAN MIGUEL DE VELASCO,salud sexual y reproductiva,hemorragia de la primera mitad del embarazo (< 22 sem) aborto,2016-09-01,2,0,2
50501,SAN PEDRO DE BUENA VISTA,salud sexual y reproductiva,hemorragia de la primera mitad del embarazo (< 22 sem) aborto,2016-09-01,1,0,1
71103,SAN RAMON SCZ,salud sexual y reproductiva,hemorragia de la primera mitad del embarazo (< 22 sem) aborto,2016-09-01,1,0,1
80401,SANTA ANA,salud sexual y reproductiva,hemorragia de la primera mitad del embarazo (< 22 sem) aborto,2016-09-01,2,0,2
70101,SANTA CRUZ DE LA SIERRA,salud sexual y reproductiva,hemorragia de la primera mitad del embarazo (< 22 sem) aborto,2016-09-01,193,206,399
70602,SANTA ROSA DEL SARA,salud sexual y reproductiva,hemorragia de la primera mitad del embarazo (< 22 sem) aborto,2016-09-01,2,0,2
90303,SENA,salud sexual y reproductiva,hemorragia de la primera mitad del embarazo (< 22 sem) aborto,2016-09-01,1,0,1
31602,SHINAOTA,salud sexual y reproductiva,hemorragia de la primera mitad del embarazo (< 22 sem) aborto,2016-09-01,12,0,12
30703,SICAYA,salud sexual y reproductiva,hemorragia de la primera mitad del embarazo (< 22 sem) aborto,2016-09-01,1,0,1
30902,SIPE SIPE,salud sexual y reproductiva,hemorragia de la primera mitad del embarazo (< 22 sem) aborto,2016-09-01,3,0,3
10101,SUCRE,salud sexual y reproductiva,hemorragia de la primera mitad del embarazo (< 22 sem) aborto,2016-09-01,90,7,97
10601,TARABUCO,salud sexual y reproductiva,hemorragia de la primera mitad del embarazo (< 22 sem) aborto,2016-09-01,0,3,3
60101,TARIJA,salud sexual y reproductiva,hemorragia de la primera mitad del embarazo (< 22 sem) aborto,2016-09-01,57,1,58
20608,TEOPONTE,salud sexual y reproductiva,hemorragia de la primera mitad del embarazo (< 22 sem) aborto,2016-09-01,1,0,1
30903,TIQUIPAYA,salud sexual y reproductiva,hemorragia de la primera mitad del embarazo (< 22 sem) aborto,2016-09-01,3,0,3
31601,TIRAQUE (CBBA),salud sexual y reproductiva,hemorragia de la primera mitad del embarazo (< 22 sem) aborto,2016-09-01,3,0,3
30803,TOLATA,salud sexual y reproductiva,hemorragia de la primera mitad del embarazo (< 22 sem) aborto,2016-09-01,1,0,1
31201,TOTORA(CBBA),salud sexual y reproductiva,hemorragia de la primera mitad del embarazo (< 22 sem) aborto,2016-09-01,2,0,2
80101,TRINIDAD,salud sexual y reproductiva,hemorragia de la primera mitad del embarazo (< 22 sem) aborto,2016-09-01,88,0,88
50801,TUPIZA,salud sexual y reproductiva,hemorragia de la primera mitad del embarazo (< 22 sem) aborto,2016-09-01,10,0,10
51201,UYUNI,salud sexual y reproductiva,hemorragia de la primera mitad del embarazo (< 22 sem) aborto,2016-09-01,8,0,8
31302,VILA VILA,salud sexual y reproductiva,hemorragia de la primera mitad del embarazo (< 22 sem) aborto,2016-09-01,1,0,1
10801,VILLA SERRANO,salud sexual y reproductiva,hemorragia de la primera mitad del embarazo (< 22 sem) aborto,2016-09-01,0,1,1
31003,VILLA TUNARI,salud sexual y reproductiva,hemorragia de la primera mitad del embarazo (< 22 sem) aborto,2016-09-01,13,2,15
51501,VILLAZON,salud sexual y reproductiva,hemorragia de la primera mitad del embarazo (< 22 sem) aborto,2016-09-01,7,0,7
70201,WARNES,salud sexual y reproductiva,hemorragia de la primera mitad del embarazo (< 22 sem) aborto,2016-09-01,33,0,33
60301,YACUIBA,salud sexual y reproductiva,hemorragia de la primera mitad del embarazo (< 22 sem) aborto,2016-09-01,1,1,2
70403,YAPACANI,salud sexual y reproductiva,hemorragia de la primera mitad del embarazo (< 22 sem) aborto,2016-09-01,8,1,9
30201,AIQUILE,salud sexual y reproductiva,hemorragia de la primera mitad del embarazo (< 22 sem) aborto,2016-10-01,10,0,10
30402,ANZALDO,salud sexual y reproductiva,hemorragia de la primera mitad del embarazo (< 22 sem) aborto,2016-10-01,1,1,2
30403,ARBIETO,salud sexual y reproductiva,hemorragia de la primera mitad del embarazo (< 22 sem) aborto,2016-10-01,3,0,3
71501,ASCENCION DE GUARAYOS,salud sexual y reproductiva,hemorragia de la primera mitad del embarazo (< 22 sem) aborto,2016-10-01,1,20,21
60202,BERMEJO,salud sexual y reproductiva,hemorragia de la primera mitad del embarazo (< 22 sem) aborto,2016-10-01,1,1,2
10701,CAMARGO,salud sexual y reproductiva,hemorragia de la primera mitad del embarazo (< 22 sem) aborto,2016-10-01,0,1,1
70706,CAMIRI,salud sexual y reproductiva,hemorragia de la primera mitad del embarazo (< 22 sem) aborto,2016-10-01,26,0,26
30701,CAPINOTA,salud sexual y reproductiva,hemorragia de la primera mitad del embarazo (< 22 sem) aborto,2016-10-01,6,0,6
40102,CARACOLLO,salud sexual y reproductiva,hemorragia de la primera mitad del embarazo (< 22 sem) aborto,2016-10-01,1,0,1
22001,CARANAVI,salud sexual y reproductiva,hemorragia de la primera mitad del embarazo (< 22 sem) aborto,2016-10-01,25,0,25
70702,CHARAGUA,salud sexual y reproductiva,hemorragia de la primera mitad del embarazo (< 22 sem) aborto,2016-10-01,8,0,8
40302,CHOQUE COTA,salud sexual y reproductiva,hemorragia de la primera mitad del embarazo (< 22 sem) aborto,2016-10-01,0,1,1
21101,CHULUMANI (V. DE LA LIBERTAD),salud sexual y reproductiva,hemorragia de la primera mitad del embarazo (< 22 sem) aborto,2016-10-01,6,0,6
51103,CKOCHAS,salud sexual y reproductiva,hemorragia de la primera mitad del embarazo (< 22 sem) aborto,2016-10-01,0,1,1
30801,CLIZA,salud sexual y reproductiva,hemorragia de la primera mitad del embarazo (< 22 sem) aborto,2016-10-01,9,0,9
90101,COBIJA,salud sexual y reproductiva,hemorragia de la primera mitad del embarazo (< 22 sem) aborto,2016-10-01,28,0,28
30101,COCHABAMBA,salud sexual y reproductiva,hemorragia de la primera mitad del embarazo (< 22 sem) aborto,2016-10-01,159,73,232
30905,COLCAPIRHUA,salud sexual y reproductiva,hemorragia de la primera mitad del embarazo (< 22 sem) aborto,2016-10-01,1,0,1
31002,COLOMI,salud sexual y reproductiva,hemorragia de la primera mitad del embarazo (< 22 sem) aborto,2016-10-01,3,0,3
71301,COMARAPA,salud sexual y reproductiva,hemorragia de la primera mitad del embarazo (< 22 sem) aborto,2016-10-01,6,0,6
71101,CONCEPCION,salud sexual y reproductiva,hemorragia de la primera mitad del embarazo (< 22 sem) aborto,2016-10-01,1,0,1
21402,CORIPATA,salud sexual y reproductiva,hemorragia de la primera mitad del embarazo (< 22 sem) aborto,2016-10-01,2,0,2
21401,COROICO,salud sexual y reproductiva,hemorragia de la primera mitad del embarazo (< 22 sem) aborto,2016-10-01,0,1,1
70102,COTOCA,salud sexual y reproductiva,hemorragia de la primera mitad del embarazo (< 22 sem) aborto,2016-10-01,12,0,12
10902,CULPINA,salud sexual y reproductiva,hemorragia de la primera mitad del embarazo (< 22 sem) aborto,2016-10-01,4,2,6
20105,EL ALTO,salud sexual y reproductiva,hemorragia de la primera mitad del embarazo (< 22 sem) aborto,2016-10-01,170,22,192
60502,EL PUENTE(TJA),salud sexual y reproductiva,hemorragia de la primera mitad del embarazo (< 22 sem) aborto,2016-10-01,2,0,2
70105,EL TORNO,salud sexual y reproductiva,hemorragia de la primera mitad del embarazo (< 22 sem) aborto,2016-10-01,25,0,25
60601,ENTRE RIOS TRJ,salud sexual y reproductiva,hemorragia de la primera mitad del embarazo (< 22 sem) aborto,2016-10-01,0,1,1
31206,ENTRE RIOS CBBA,salud sexual y reproductiva,hemorragia de la primera mitad del embarazo (< 22 sem) aborto,2016-10-01,3,0,3
20405,ESCOMA,salud sexual y reproductiva,hemorragia de la primera mitad del embarazo (< 22 sem) aborto,2016-10-01,1,0,1
20602,GUANAY,salud sexual y reproductiva,hemorragia de la primera mitad del embarazo (< 22 sem) aborto,2016-10-01,0,4,4
80202,GUAYARAMERIN,salud sexual y reproductiva,hemorragia de la primera mitad del embarazo (< 22 sem) aborto,2016-10-01,1,1,2
40701,HUANUNI,salud sexual y reproductiva,hemorragia de la primera mitad del embarazo (< 22 sem) aborto,2016-10-01,1,0,1
21102,IRUPANA (VILLA DE LANZA),salud sexual y reproductiva,hemorragia de la primera mitad del embarazo (< 22 sem) aborto,2016-10-01,1,0,1
21105,LA ASUNTA,salud sexual y reproductiva,hemorragia de la primera mitad del embarazo (< 22 sem) aborto,2016-10-01,19,0,19
70104,LA GUARDIA,salud sexual y reproductiva,hemorragia de la primera mitad del embarazo (< 22 sem) aborto,2016-10-01,0,4,4
20101,LA PAZ,salud sexual y reproductiva,hemorragia de la primera mitad del embarazo (< 22 sem) aborto,2016-10-01,151,2,153
80801,MAGDALENA,salud sexual y reproductiva,hemorragia de la primera mitad del embarazo (< 22 sem) aborto,2016-10-01,0,1,1
70903,MAIRANA,salud sexual y reproductiva,hemorragia de la primera mitad del embarazo (< 22 sem) aborto,2016-10-01,4,0,4
20607,MAPIRI,salud sexual y reproductiva,hemorragia de la primera mitad del embarazo (< 22 sem) aborto,2016-10-01,0,1,1
10501,MONTEAGUDO,salud sexual y reproductiva,hemorragia de la primera mitad del embarazo (< 22 sem) aborto,2016-10-01,0,1,1
71001,MONTERO,salud sexual y reproductiva,hemorragia de la primera mitad del embarazo (< 22 sem) aborto,2016-10-01,3,0,3
30302,MOROCHATA,salud sexual y reproductiva,hemorragia de la primera mitad del embarazo (< 22 sem) aborto,2016-10-01,1,1,2
40101,ORURO,salud sexual y reproductiva,hemorragia de la primera mitad del embarazo (< 22 sem) aborto,2016-10-01,9,1,10
70502,PAILON,salud sexual y reproductiva,hemorragia de la primera mitad del embarazo (< 22 sem) aborto,2016-10-01,3,0,3
21104,PALOS BLANCOS,salud sexual y reproductiva,hemorragia de la primera mitad del embarazo (< 22 sem) aborto,2016-10-01,5,1,6
70601,PORTACHUELO,salud sexual y reproductiva,hemorragia de la primera mitad del embarazo (< 22 sem) aborto,2016-10-01,3,0,3
50101,POTOSI,salud sexual y reproductiva,hemorragia de la primera mitad del embarazo (< 22 sem) aborto,2016-10-01,32,0,32
90301,PUERTO GONZALO MORENO,salud sexual y reproductiva,hemorragia de la primera mitad del embarazo (< 22 sem) aborto,2016-10-01,1,0,1
90201,PUERTO RICO,salud sexual y reproductiva,hemorragia de la primera mitad del embarazo (< 22 sem) aborto,2016-10-01,1,1,2
71401,PUERTO SUAREZ,salud sexual y reproductiva,hemorragia de la primera mitad del embarazo (< 22 sem) aborto,2016-10-01,10,0,10
51101,PUNA,salud sexual y reproductiva,hemorragia de la primera mitad del embarazo (< 22 sem) aborto,2016-10-01,1,0,1
31401,PUNATA,salud sexual y reproductiva,hemorragia de la primera mitad del embarazo (< 22 sem) aborto,2016-10-01,14,0,14
30901,QUILLACOLLO,salud sexual y reproductiva,hemorragia de la primera mitad del embarazo (< 22 sem) aborto,2016-10-01,83,0,83
50402,RAVELO,salud sexual y reproductiva,hemorragia de la primera mitad del embarazo (< 22 sem) aborto,2016-10-01,1,0,1
80301,REYES,salud sexual y reproductiva,hemorragia de la primera mitad del embarazo (< 22 sem) aborto,2016-10-01,4,0,4
80201,RIBERALTA,salud sexual y reproductiva,hemorragia de la primera mitad del embarazo (< 22 sem) aborto,2016-10-01,19,0,19
70503,ROBORE,salud sexual y reproductiva,hemorragia de la primera mitad del embarazo (< 22 sem) aborto,2016-10-01,5,0,5
80304,RURRENABAQUE,salud sexual y reproductiva,hemorragia de la primera mitad del embarazo (< 22 sem) aborto,2016-10-01,15,0,15
31001,SACABA,salud sexual y reproductiva,hemorragia de la primera mitad del embarazo (< 22 sem) aborto,2016-10-01,61,4,65
70901,SAMAIPATA,salud sexual y reproductiva,hemorragia de la primera mitad del embarazo (< 22 sem) aborto,2016-10-01,1,0,1
80302,SAN BORJA,salud sexual y reproductiva,hemorragia de la primera mitad del embarazo (< 22 sem) aborto,2016-10-01,14,0,14
21502,SAN BUENA VENTURA,salud sexual y reproductiva,hemorragia de la primera mitad del embarazo (< 22 sem) aborto,2016-10-01,4,0,4
70301,SAN IGNACIO DE VELASCO,salud sexual y reproductiva,hemorragia de la primera mitad del embarazo (< 22 sem) aborto,2016-10-01,4,0,4
71102,SAN JAVIER(STC),salud sexual y reproductiva,hemorragia de la primera mitad del embarazo (< 22 sem) aborto,2016-10-01,3,0,3
70501,SAN JOSE DE CHIQUITOS,salud sexual y reproductiva,hemorragia de la primera mitad del embarazo (< 22 sem) aborto,2016-10-01,4,0,4
71104,SAN JULIAN,salud sexual y reproductiva,hemorragia de la primera mitad del embarazo (< 22 sem) aborto,2016-10-01,18,0,18
10702,SAN LUCAS,salud sexual y reproductiva,hemorragia de la primera mitad del embarazo (< 22 sem) aborto,2016-10-01,3,4,7
71201,SAN MATIAS,salud sexual y reproductiva,hemorragia de la primera mitad del embarazo (< 22 sem) aborto,2016-10-01,0,3,3
70302,SAN MIGUEL DE VELASCO,salud sexual y reproductiva,hemorragia de la primera mitad del embarazo (< 22 sem) aborto,2016-10-01,2,0,2
50501,SAN PEDRO DE BUENA VISTA,salud sexual y reproductiva,hemorragia de la primera mitad del embarazo (< 22 sem) aborto,2016-10-01,0,1,1
80401,SANTA ANA,salud sexual y reproductiva,hemorragia de la primera mitad del embarazo (< 22 sem) aborto,2016-10-01,1,0,1
70101,SANTA CRUZ DE LA SIERRA,salud sexual y reproductiva,hemorragia de la primera mitad del embarazo (< 22 sem) aborto,2016-10-01,305,123,428
30702,SANTIVAÃ‘ES,salud sexual y reproductiva,hemorragia de la primera mitad del embarazo (< 22 sem) aborto,2016-10-01,0,1,1
20902,SAPAHAQUI,salud sexual y reproductiva,hemorragia de la primera mitad del embarazo (< 22 sem) aborto,2016-10-01,1,0,1
90303,SENA,salud sexual y reproductiva,hemorragia de la primera mitad del embarazo (< 22 sem) aborto,2016-10-01,3,1,4
31602,SHINAOTA,salud sexual y reproductiva,hemorragia de la primera mitad del embarazo (< 22 sem) aborto,2016-10-01,11,0,11
21301,SICA SICA (VILLA AROMA),salud sexual y reproductiva,hemorragia de la primera mitad del embarazo (< 22 sem) aborto,2016-10-01,2,0,2
30703,SICAYA,salud sexual y reproductiva,hemorragia de la primera mitad del embarazo (< 22 sem) aborto,2016-10-01,1,0,1
30902,SIPE SIPE,salud sexual y reproductiva,hemorragia de la primera mitad del embarazo (< 22 sem) aborto,2016-10-01,3,0,3
10403,SOPACHUY,salud sexual y reproductiva,hemorragia de la primera mitad del embarazo (< 22 sem) aborto,2016-10-01,0,3,3
40104,SORACACHI,salud sexual y reproductiva,hemorragia de la primera mitad del embarazo (< 22 sem) aborto,2016-10-01,1,0,1
10101,SUCRE,salud sexual y reproductiva,hemorragia de la primera mitad del embarazo (< 22 sem) aborto,2016-10-01,87,6,93
50303,TACOBAMBA,salud sexual y reproductiva,hemorragia de la primera mitad del embarazo (< 22 sem) aborto,2016-10-01,0,1,1
30602,TACOPAYA,salud sexual y reproductiva,hemorragia de la primera mitad del embarazo (< 22 sem) aborto,2016-10-01,1,0,1
10601,TARABUCO,salud sexual y reproductiva,hemorragia de la primera mitad del embarazo (< 22 sem) aborto,2016-10-01,3,0,3
60101,TARIJA,salud sexual y reproductiva,hemorragia de la primera mitad del embarazo (< 22 sem) aborto,2016-10-01,57,0,57
10202,TARVITA,salud sexual y reproductiva,hemorragia de la primera mitad del embarazo (< 22 sem) aborto,2016-10-01,0,1,1
30903,TIQUIPAYA,salud sexual y reproductiva,hemorragia de la primera mitad del embarazo (< 22 sem) aborto,2016-10-01,2,0,2
31601,TIRAQUE (CBBA),salud sexual y reproductiva,hemorragia de la primera mitad del embarazo (< 22 sem) aborto,2016-10-01,3,0,3
30803,TOLATA,salud sexual y reproductiva,hemorragia de la primera mitad del embarazo (< 22 sem) aborto,2016-10-01,2,0,2
31201,TOTORA(CBBA),salud sexual y reproductiva,hemorragia de la primera mitad del embarazo (< 22 sem) aborto,2016-10-01,1,0,1
80101,TRINIDAD,salud sexual y reproductiva,hemorragia de la primera mitad del embarazo (< 22 sem) aborto,2016-10-01,59,0,59
50801,TUPIZA,salud sexual y reproductiva,hemorragia de la primera mitad del embarazo (< 22 sem) aborto,2016-10-01,13,0,13
51201,UYUNI,salud sexual y reproductiva,hemorragia de la primera mitad del embarazo (< 22 sem) aborto,2016-10-01,11,0,11
20801,VIACHA,salud sexual y reproductiva,hemorragia de la primera mitad del embarazo (< 22 sem) aborto,2016-10-01,0,1,1
31003,VILLA TUNARI,salud sexual y reproductiva,hemorragia de la primera mitad del embarazo (< 22 sem) aborto,2016-10-01,26,0,26
51501,VILLAZON,salud sexual y reproductiva,hemorragia de la primera mitad del embarazo (< 22 sem) aborto,2016-10-01,6,4,10
20306,WALDO BALLIVIAN,salud sexual y reproductiva,hemorragia de la primera mitad del embarazo (< 22 sem) aborto,2016-10-01,0,1,1
70201,WARNES,salud sexual y reproductiva,hemorragia de la primera mitad del embarazo (< 22 sem) aborto,2016-10-01,15,22,37
60301,YACUIBA,salud sexual y reproductiva,hemorragia de la primera mitad del embarazo (< 22 sem) aborto,2016-10-01,2,0,2
70403,YAPACANI,salud sexual y reproductiva,hemorragia de la primera mitad del embarazo (< 22 sem) aborto,2016-10-01,20,0,20
20201,ACHACACHI,salud sexual y reproductiva,hemorragia de la primera mitad del embarazo (< 22 sem) aborto,2016-11-01,1,0,1
30201,AIQUILE,salud sexual y reproductiva,hemorragia de la primera mitad del embarazo (< 22 sem) aborto,2016-11-01,5,0,5
30501,ARANI,salud sexual y reproductiva,hemorragia de la primera mitad del embarazo (< 22 sem) aborto,2016-11-01,1,0,1
30403,ARBIETO,salud sexual y reproductiva,hemorragia de la primera mitad del embarazo (< 22 sem) aborto,2016-11-01,1,1,2
71501,ASCENCION DE GUARAYOS,salud sexual y reproductiva,hemorragia de la primera mitad del embarazo (< 22 sem) aborto,2016-11-01,10,6,16
30301,AYOPAYA (V. DE INDEPENDENCIA),salud sexual y reproductiva,hemorragia de la primera mitad del embarazo (< 22 sem) aborto,2016-11-01,1,0,1
21203,BATALLAS,salud sexual y reproductiva,hemorragia de la primera mitad del embarazo (< 22 sem) aborto,2016-11-01,1,0,1
50301,BETANZOS,salud sexual y reproductiva,hemorragia de la primera mitad del embarazo (< 22 sem) aborto,2016-11-01,1,0,1
70706,CAMIRI,salud sexual y reproductiva,hemorragia de la primera mitad del embarazo (< 22 sem) aborto,2016-11-01,13,0,13
30701,CAPINOTA,salud sexual y reproductiva,hemorragia de la primera mitad del embarazo (< 22 sem) aborto,2016-11-01,4,0,4
22001,CARANAVI,salud sexual y reproductiva,hemorragia de la primera mitad del embarazo (< 22 sem) aborto,2016-11-01,32,0,32
70702,CHARAGUA,salud sexual y reproductiva,hemorragia de la primera mitad del embarazo (< 22 sem) aborto,2016-11-01,2,0,2
40903,CHIPAYA,salud sexual y reproductiva,hemorragia de la primera mitad del embarazo (< 22 sem) aborto,2016-11-01,1,0,1
21101,CHULUMANI (V. DE LA LIBERTAD),salud sexual y reproductiva,hemorragia de la primera mitad del embarazo (< 22 sem) aborto,2016-11-01,2,0,2
30801,CLIZA,salud sexual y reproductiva,hemorragia de la primera mitad del embarazo (< 22 sem) aborto,2016-11-01,15,0,15
90101,COBIJA,salud sexual y reproductiva,hemorragia de la primera mitad del embarazo (< 22 sem) aborto,2016-11-01,17,0,17
30303,COCAPATA,salud sexual y reproductiva,hemorragia de la primera mitad del embarazo (< 22 sem) aborto,2016-11-01,1,0,1
30101,COCHABAMBA,salud sexual y reproductiva,hemorragia de la primera mitad del embarazo (< 22 sem) aborto,2016-11-01,170,8,178
30905,COLCAPIRHUA,salud sexual y reproductiva,hemorragia de la primera mitad del embarazo (< 22 sem) aborto,2016-11-01,6,0,6
31002,COLOMI,salud sexual y reproductiva,hemorragia de la primera mitad del embarazo (< 22 sem) aborto,2016-11-01,2,0,2
50401,COLQUECHACA,salud sexual y reproductiva,hemorragia de la primera mitad del embarazo (< 22 sem) aborto,2016-11-01,0,3,3
71301,COMARAPA,salud sexual y reproductiva,hemorragia de la primera mitad del embarazo (< 22 sem) aborto,2016-11-01,2,0,2
71101,CONCEPCION,salud sexual y reproductiva,hemorragia de la primera mitad del embarazo (< 22 sem) aborto,2016-11-01,3,0,3
21701,COPACABANA,salud sexual y reproductiva,hemorragia de la primera mitad del embarazo (< 22 sem) aborto,2016-11-01,1,0,1
21401,COROICO,salud sexual y reproductiva,hemorragia de la primera mitad del embarazo (< 22 sem) aborto,2016-11-01,1,0,1
50601,COTAGAITA,salud sexual y reproductiva,hemorragia de la primera mitad del embarazo (< 22 sem) aborto,2016-11-01,0,1,1
70102,COTOCA,salud sexual y reproductiva,hemorragia de la primera mitad del embarazo (< 22 sem) aborto,2016-11-01,4,0,4
71106,CUATRO CAÃ‘ADAS,salud sexual y reproductiva,hemorragia de la primera mitad del embarazo (< 22 sem) aborto,2016-11-01,4,0,4
10902,CULPINA,salud sexual y reproductiva,hemorragia de la primera mitad del embarazo (< 22 sem) aborto,2016-11-01,3,0,3
20105,EL ALTO,salud sexual y reproductiva,hemorragia de la primera mitad del embarazo (< 22 sem) aborto,2016-11-01,143,7,150
70105,EL TORNO,salud sexual y reproductiva,hemorragia de la primera mitad del embarazo (< 22 sem) aborto,2016-11-01,24,0,24
31206,ENTRE RIOS CBBA,salud sexual y reproductiva,hemorragia de la primera mitad del embarazo (< 22 sem) aborto,2016-11-01,2,0,2
20602,GUANAY,salud sexual y reproductiva,hemorragia de la primera mitad del embarazo (< 22 sem) aborto,2016-11-01,0,12,12
80202,GUAYARAMERIN,salud sexual y reproductiva,hemorragia de la primera mitad del embarazo (< 22 sem) aborto,2016-11-01,1,0,1
70705,GUTIERREZ,salud sexual y reproductiva,hemorragia de la primera mitad del embarazo (< 22 sem) aborto,2016-11-01,1,0,1
11002,HUACAYA (VILLA DE HUACAYA),salud sexual y reproductiva,hemorragia de la primera mitad del embarazo (< 22 sem) aborto,2016-11-01,0,1,1
40701,HUANUNI,salud sexual y reproductiva,hemorragia de la primera mitad del embarazo (< 22 sem) aborto,2016-11-01,2,0,2
21105,LA ASUNTA,salud sexual y reproductiva,hemorragia de la primera mitad del embarazo (< 22 sem) aborto,2016-11-01,18,0,18
70104,LA GUARDIA,salud sexual y reproductiva,hemorragia de la primera mitad del embarazo (< 22 sem) aborto,2016-11-01,1,7,8
20101,LA PAZ,salud sexual y reproductiva,hemorragia de la primera mitad del embarazo (< 22 sem) aborto,2016-11-01,159,11,170
20901,LURIBAY,salud sexual y reproductiva,hemorragia de la primera mitad del embarazo (< 22 sem) aborto,2016-11-01,1,0,1
80801,MAGDALENA,salud sexual y reproductiva,hemorragia de la primera mitad del embarazo (< 22 sem) aborto,2016-11-01,0,1,1
70903,MAIRANA,salud sexual y reproductiva,hemorragia de la primera mitad del embarazo (< 22 sem) aborto,2016-11-01,6,2,8
20607,MAPIRI,salud sexual y reproductiva,hemorragia de la primera mitad del embarazo (< 22 sem) aborto,2016-11-01,0,1,1
31301,MIZQUE,salud sexual y reproductiva,hemorragia de la primera mitad del embarazo (< 22 sem) aborto,2016-11-01,3,0,3
20402,MOCOMOCO,salud sexual y reproductiva,hemorragia de la primera mitad del embarazo (< 22 sem) aborto,2016-11-01,0,1,1
71001,MONTERO,salud sexual y reproductiva,hemorragia de la primera mitad del embarazo (< 22 sem) aborto,2016-11-01,0,1,1
70803,MORO MORO,salud sexual y reproductiva,hemorragia de la primera mitad del embarazo (< 22 sem) aborto,2016-11-01,1,0,1
30302,MOROCHATA,salud sexual y reproductiva,hemorragia de la primera mitad del embarazo (< 22 sem) aborto,2016-11-01,1,0,1
70202,OKINAWA,salud sexual y reproductiva,hemorragia de la primera mitad del embarazo (< 22 sem) aborto,2016-11-01,1,0,1
40101,ORURO,salud sexual y reproductiva,hemorragia de la primera mitad del embarazo (< 22 sem) aborto,2016-11-01,16,0,16
60201,PADCAYA,salud sexual y reproductiva,hemorragia de la primera mitad del embarazo (< 22 sem) aborto,2016-11-01,0,1,1
70502,PAILON,salud sexual y reproductiva,hemorragia de la primera mitad del embarazo (< 22 sem) aborto,2016-11-01,5,0,5
21104,PALOS BLANCOS,salud sexual y reproductiva,hemorragia de la primera mitad del embarazo (< 22 sem) aborto,2016-11-01,5,0,5
30202,PASORAPA,salud sexual y reproductiva,hemorragia de la primera mitad del embarazo (< 22 sem) aborto,2016-11-01,1,0,1
50403,POCOATA,salud sexual y reproductiva,hemorragia de la primera mitad del embarazo (< 22 sem) aborto,2016-11-01,0,1,1
31203,POCONA,salud sexual y reproductiva,hemorragia de la primera mitad del embarazo (< 22 sem) aborto,2016-11-01,3,0,3
40601,POOPO,salud sexual y reproductiva,hemorragia de la primera mitad del embarazo (< 22 sem) aborto,2016-11-01,1,0,1
70601,PORTACHUELO,salud sexual y reproductiva,hemorragia de la primera mitad del embarazo (< 22 sem) aborto,2016-11-01,6,0,6
50101,POTOSI,salud sexual y reproductiva,hemorragia de la primera mitad del embarazo (< 22 sem) aborto,2016-11-01,23,1,24
21201,PUCARANI,salud sexual y reproductiva,hemorragia de la primera mitad del embarazo (< 22 sem) aborto,2016-11-01,1,0,1
90201,PUERTO RICO,salud sexual y reproductiva,hemorragia de la primera mitad del embarazo (< 22 sem) aborto,2016-11-01,2,1,3
71401,PUERTO SUAREZ,salud sexual y reproductiva,hemorragia de la primera mitad del embarazo (< 22 sem) aborto,2016-11-01,5,0,5
31205,PUERTO VILLARROEL,salud sexual y reproductiva,hemorragia de la primera mitad del embarazo (< 22 sem) aborto,2016-11-01,0,30,30
51101,PUNA,salud sexual y reproductiva,hemorragia de la primera mitad del embarazo (< 22 sem) aborto,2016-11-01,0,1,1
31401,PUNATA,salud sexual y reproductiva,hemorragia de la primera mitad del embarazo (< 22 sem) aborto,2016-11-01,18,0,18
80301,REYES,salud sexual y reproductiva,hemorragia de la primera mitad del embarazo (< 22 sem) aborto,2016-11-01,4,0,4
80201,RIBERALTA,salud sexual y reproductiva,hemorragia de la primera mitad del embarazo (< 22 sem) aborto,2016-11-01,35,0,35
70503,ROBORE,salud sexual y reproductiva,hemorragia de la primera mitad del embarazo (< 22 sem) aborto,2016-11-01,6,0,6
80304,RURRENABAQUE,salud sexual y reproductiva,hemorragia de la primera mitad del embarazo (< 22 sem) aborto,2016-11-01,3,0,3
31001,SACABA,salud sexual y reproductiva,hemorragia de la primera mitad del embarazo (< 22 sem) aborto,2016-11-01,40,0,40
50701,SACACA,salud sexual y reproductiva,hemorragia de la primera mitad del embarazo (< 22 sem) aborto,2016-11-01,0,1,1
40801,SALINAS DE GARCI MENDOZA,salud sexual y reproductiva,hemorragia de la primera mitad del embarazo (< 22 sem) aborto,2016-11-01,1,0,1
80302,SAN BORJA,salud sexual y reproductiva,hemorragia de la primera mitad del embarazo (< 22 sem) aborto,2016-11-01,11,0,11
21502,SAN BUENA VENTURA,salud sexual y reproductiva,hemorragia de la primera mitad del embarazo (< 22 sem) aborto,2016-11-01,7,0,7
70402,SAN CARLOS,salud sexual y reproductiva,hemorragia de la primera mitad del embarazo (< 22 sem) aborto,2016-11-01,5,0,5
80501,SAN IGNACIO,salud sexual y reproductiva,hemorragia de la primera mitad del embarazo (< 22 sem) aborto,2016-11-01,3,0,3
70301,SAN IGNACIO DE VELASCO,salud sexual y reproductiva,hemorragia de la primera mitad del embarazo (< 22 sem) aborto,2016-11-01,13,0,13
80102,SAN JAVIER(BNI),salud sexual y reproductiva,hemorragia de la primera mitad del embarazo (< 22 sem) aborto,2016-11-01,1,0,1
71102,SAN JAVIER(STC),salud sexual y reproductiva,hemorragia de la primera mitad del embarazo (< 22 sem) aborto,2016-11-01,2,0,2
70501,SAN JOSE DE CHIQUITOS,salud sexual y reproductiva,hemorragia de la primera mitad del embarazo (< 22 sem) aborto,2016-11-01,5,0,5
71104,SAN JULIAN,salud sexual y reproductiva,hemorragia de la primera mitad del embarazo (< 22 sem) aborto,2016-11-01,12,0,12
60501,SAN LORENZO(TJA),salud sexual y reproductiva,hemorragia de la primera mitad del embarazo (< 22 sem) aborto,2016-11-01,3,0,3
10702,SAN LUCAS,salud sexual y reproductiva,hemorragia de la primera mitad del embarazo (< 22 sem) aborto,2016-11-01,0,4,4
71201,SAN MATIAS,salud sexual y reproductiva,hemorragia de la primera mitad del embarazo (< 22 sem) aborto,2016-11-01,0,2,2
70302,SAN MIGUEL DE VELASCO,salud sexual y reproductiva,hemorragia de la primera mitad del embarazo (< 22 sem) aborto,2016-11-01,4,0,4
50501,SAN PEDRO DE BUENA VISTA,salud sexual y reproductiva,hemorragia de la primera mitad del embarazo (< 22 sem) aborto,2016-11-01,1,0,1
71103,SAN RAMON SCZ,salud sexual y reproductiva,hemorragia de la primera mitad del embarazo (< 22 sem) aborto,2016-11-01,5,0,5
80401,SANTA ANA,salud sexual y reproductiva,hemorragia de la primera mitad del embarazo (< 22 sem) aborto,2016-11-01,2,0,2
70101,SANTA CRUZ DE LA SIERRA,salud sexual y reproductiva,hemorragia de la primera mitad del embarazo (< 22 sem) aborto,2016-11-01,325,159,484
30702,SANTIVAÃ‘ES,salud sexual y reproductiva,hemorragia de la primera mitad del embarazo (< 22 sem) aborto,2016-11-01,1,0,1
20902,SAPAHAQUI,salud sexual y reproductiva,hemorragia de la primera mitad del embarazo (< 22 sem) aborto,2016-11-01,1,0,1
90303,SENA,salud sexual y reproductiva,hemorragia de la primera mitad del embarazo (< 22 sem) aborto,2016-11-01,2,0,2
31602,SHINAOTA,salud sexual y reproductiva,hemorragia de la primera mitad del embarazo (< 22 sem) aborto,2016-11-01,9,0,9
21301,SICA SICA (VILLA AROMA),salud sexual y reproductiva,hemorragia de la primera mitad del embarazo (< 22 sem) aborto,2016-11-01,1,0,1
30902,SIPE SIPE,salud sexual y reproductiva,hemorragia de la primera mitad del embarazo (< 22 sem) aborto,2016-11-01,4,0,4
10403,SOPACHUY,salud sexual y reproductiva,hemorragia de la primera mitad del embarazo (< 22 sem) aborto,2016-11-01,0,2,2
10101,SUCRE,salud sexual y reproductiva,hemorragia de la primera mitad del embarazo (< 22 sem) aborto,2016-11-01,101,10,111
50303,TACOBAMBA,salud sexual y reproductiva,hemorragia de la primera mitad del embarazo (< 22 sem) aborto,2016-11-01,0,1,1
30602,TACOPAYA,salud sexual y reproductiva,hemorragia de la primera mitad del embarazo (< 22 sem) aborto,2016-11-01,0,1,1
10601,TARABUCO,salud sexual y reproductiva,hemorragia de la primera mitad del embarazo (< 22 sem) aborto,2016-11-01,0,3,3
60101,TARIJA,salud sexual y reproductiva,hemorragia de la primera mitad del embarazo (< 22 sem) aborto,2016-11-01,79,0,79
10202,TARVITA,salud sexual y reproductiva,hemorragia de la primera mitad del embarazo (< 22 sem) aborto,2016-11-01,1,0,1
20608,TEOPONTE,salud sexual y reproductiva,hemorragia de la primera mitad del embarazo (< 22 sem) aborto,2016-11-01,1,0,1
20606,TIPUANI,salud sexual y reproductiva,hemorragia de la primera mitad del embarazo (< 22 sem) aborto,2016-11-01,1,0,1
30903,TIQUIPAYA,salud sexual y reproductiva,hemorragia de la primera mitad del embarazo (< 22 sem) aborto,2016-11-01,1,1,2
31601,TIRAQUE (CBBA),salud sexual y reproductiva,hemorragia de la primera mitad del embarazo (< 22 sem) aborto,2016-11-01,1,0,1
30803,TOLATA,salud sexual y reproductiva,hemorragia de la primera mitad del embarazo (< 22 sem) aborto,2016-11-01,0,2,2
31201,TOTORA(CBBA),salud sexual y reproductiva,hemorragia de la primera mitad del embarazo (< 22 sem) aborto,2016-11-01,1,0,1
41301,TOTORA(ORR),salud sexual y reproductiva,hemorragia de la primera mitad del embarazo (< 22 sem) aborto,2016-11-01,0,2,2
80101,TRINIDAD,salud sexual y reproductiva,hemorragia de la primera mitad del embarazo (< 22 sem) aborto,2016-11-01,49,1,50
50801,TUPIZA,salud sexual y reproductiva,hemorragia de la primera mitad del embarazo (< 22 sem) aborto,2016-11-01,13,0,13
50201,UNCIA,salud sexual y reproductiva,hemorragia de la primera mitad del embarazo (< 22 sem) aborto,2016-11-01,0,1,1
51201,UYUNI,salud sexual y reproductiva,hemorragia de la primera mitad del embarazo (< 22 sem) aborto,2016-11-01,16,0,16
31003,VILLA TUNARI,salud sexual y reproductiva,hemorragia de la primera mitad del embarazo (< 22 sem) aborto,2016-11-01,21,6,27
51501,VILLAZON,salud sexual y reproductiva,hemorragia de la primera mitad del embarazo (< 22 sem) aborto,2016-11-01,6,1,7
30904,VINTO,salud sexual y reproductiva,hemorragia de la primera mitad del embarazo (< 22 sem) aborto,2016-11-01,1,0,1
70201,WARNES,salud sexual y reproductiva,hemorragia de la primera mitad del embarazo (< 22 sem) aborto,2016-11-01,7,13,20
60301,YACUIBA,salud sexual y reproductiva,hemorragia de la primera mitad del embarazo (< 22 sem) aborto,2016-11-01,0,3,3
70403,YAPACANI,salud sexual y reproductiva,hemorragia de la primera mitad del embarazo (< 22 sem) aborto,2016-11-01,15,1,16
30201,AIQUILE,salud sexual y reproductiva,hemorragia de la primera mitad del embarazo (< 22 sem) aborto,2016-12-01,6,0,6
30402,ANZALDO,salud sexual y reproductiva,hemorragia de la primera mitad del embarazo (< 22 sem) aborto,2016-12-01,0,1,1
30501,ARANI,salud sexual y reproductiva,hemorragia de la primera mitad del embarazo (< 22 sem) aborto,2016-12-01,3,0,3
30403,ARBIETO,salud sexual y reproductiva,hemorragia de la primera mitad del embarazo (< 22 sem) aborto,2016-12-01,1,1,2
71501,ASCENCION DE GUARAYOS,salud sexual y reproductiva,hemorragia de la primera mitad del embarazo (< 22 sem) aborto,2016-12-01,8,2,10
50301,BETANZOS,salud sexual y reproductiva,hemorragia de la primera mitad del embarazo (< 22 sem) aborto,2016-12-01,2,0,2
20905,CAIROMA,salud sexual y reproductiva,hemorragia de la primera mitad del embarazo (< 22 sem) aborto,2016-12-01,2,0,2
10701,CAMARGO,salud sexual y reproductiva,hemorragia de la primera mitad del embarazo (< 22 sem) aborto,2016-12-01,1,0,1
70706,CAMIRI,salud sexual y reproductiva,hemorragia de la primera mitad del embarazo (< 22 sem) aborto,2016-12-01,18,0,18
30701,CAPINOTA,salud sexual y reproductiva,hemorragia de la primera mitad del embarazo (< 22 sem) aborto,2016-12-01,4,0,4
22001,CARANAVI,salud sexual y reproductiva,hemorragia de la primera mitad del embarazo (< 22 sem) aborto,2016-12-01,24,0,24
70702,CHARAGUA,salud sexual y reproductiva,hemorragia de la primera mitad del embarazo (< 22 sem) aborto,2016-12-01,7,0,7
21101,CHULUMANI (V. DE LA LIBERTAD),salud sexual y reproductiva,hemorragia de la primera mitad del embarazo (< 22 sem) aborto,2016-12-01,6,0,6
51103,CKOCHAS,salud sexual y reproductiva,hemorragia de la primera mitad del embarazo (< 22 sem) aborto,2016-12-01,0,1,1
30801,CLIZA,salud sexual y reproductiva,hemorragia de la primera mitad del embarazo (< 22 sem) aborto,2016-12-01,6,0,6
90101,COBIJA,salud sexual y reproductiva,hemorragia de la primera mitad del embarazo (< 22 sem) aborto,2016-12-01,22,0,22
30303,COCAPATA,salud sexual y reproductiva,hemorragia de la primera mitad del embarazo (< 22 sem) aborto,2016-12-01,0,1,1
30101,COCHABAMBA,salud sexual y reproductiva,hemorragia de la primera mitad del embarazo (< 22 sem) aborto,2016-12-01,123,62,185
30905,COLCAPIRHUA,salud sexual y reproductiva,hemorragia de la primera mitad del embarazo (< 22 sem) aborto,2016-12-01,7,0,7
31002,COLOMI,salud sexual y reproductiva,hemorragia de la primera mitad del embarazo (< 22 sem) aborto,2016-12-01,3,0,3
50401,COLQUECHACA,salud sexual y reproductiva,hemorragia de la primera mitad del embarazo (< 22 sem) aborto,2016-12-01,1,0,1
71301,COMARAPA,salud sexual y reproductiva,hemorragia de la primera mitad del embarazo (< 22 sem) aborto,2016-12-01,6,0,6
71101,CONCEPCION,salud sexual y reproductiva,hemorragia de la primera mitad del embarazo (< 22 sem) aborto,2016-12-01,1,0,1
21402,CORIPATA,salud sexual y reproductiva,hemorragia de la primera mitad del embarazo (< 22 sem) aborto,2016-12-01,1,0,1
21401,COROICO,salud sexual y reproductiva,hemorragia de la primera mitad del embarazo (< 22 sem) aborto,2016-12-01,1,0,1
70102,COTOCA,salud sexual y reproductiva,hemorragia de la primera mitad del embarazo (< 22 sem) aborto,2016-12-01,4,0,4
71106,CUATRO CAÃ‘ADAS,salud sexual y reproductiva,hemorragia de la primera mitad del embarazo (< 22 sem) aborto,2016-12-01,2,1,3
20105,EL ALTO,salud sexual y reproductiva,hemorragia de la primera mitad del embarazo (< 22 sem) aborto,2016-12-01,111,36,147
70105,EL TORNO,salud sexual y reproductiva,hemorragia de la primera mitad del embarazo (< 22 sem) aborto,2016-12-01,23,0,23
31206,ENTRE RIOS CBBA,salud sexual y reproductiva,hemorragia de la primera mitad del embarazo (< 22 sem) aborto,2016-12-01,2,0,2
90503,EUREKA (SANTOS MERCADO),salud sexual y reproductiva,hemorragia de la primera mitad del embarazo (< 22 sem) aborto,2016-12-01,0,1,1
80202,GUAYARAMERIN,salud sexual y reproductiva,hemorragia de la primera mitad del embarazo (< 22 sem) aborto,2016-12-01,1,1,2
40701,HUANUNI,salud sexual y reproductiva,hemorragia de la primera mitad del embarazo (< 22 sem) aborto,2016-12-01,7,0,7
21102,IRUPANA (VILLA DE LANZA),salud sexual y reproductiva,hemorragia de la primera mitad del embarazo (< 22 sem) aborto,2016-12-01,0,1,1
20806,JESUS DE MACHACA,salud sexual y reproductiva,hemorragia de la primera mitad del embarazo (< 22 sem) aborto,2016-12-01,1,0,1
21105,LA ASUNTA,salud sexual y reproductiva,hemorragia de la primera mitad del embarazo (< 22 sem) aborto,2016-12-01,5,0,5
70104,LA GUARDIA,salud sexual y reproductiva,hemorragia de la primera mitad del embarazo (< 22 sem) aborto,2016-12-01,0,6,6
20101,LA PAZ,salud sexual y reproductiva,hemorragia de la primera mitad del embarazo (< 22 sem) aborto,2016-12-01,90,35,125
80801,MAGDALENA,salud sexual y reproductiva,hemorragia de la primera mitad del embarazo (< 22 sem) aborto,2016-12-01,0,1,1
70903,MAIRANA,salud sexual y reproductiva,hemorragia de la primera mitad del embarazo (< 22 sem) aborto,2016-12-01,3,1,4
20607,MAPIRI,salud sexual y reproductiva,hemorragia de la primera mitad del embarazo (< 22 sem) aborto,2016-12-01,0,2,2
71003,MINEROS,salud sexual y reproductiva,hemorragia de la primera mitad del embarazo (< 22 sem) aborto,2016-12-01,1,0,1
31301,MIZQUE,salud sexual y reproductiva,hemorragia de la primera mitad del embarazo (< 22 sem) aborto,2016-12-01,4,1,5
10501,MONTEAGUDO,salud sexual y reproductiva,hemorragia de la primera mitad del embarazo (< 22 sem) aborto,2016-12-01,1,2,3
71001,MONTERO,salud sexual y reproductiva,hemorragia de la primera mitad del embarazo (< 22 sem) aborto,2016-12-01,10,1,11
50404,OCURI,salud sexual y reproductiva,hemorragia de la primera mitad del embarazo (< 22 sem) aborto,2016-12-01,1,0,1
40101,ORURO,salud sexual y reproductiva,hemorragia de la primera mitad del embarazo (< 22 sem) aborto,2016-12-01,7,2,9
70502,PAILON,salud sexual y reproductiva,hemorragia de la primera mitad del embarazo (< 22 sem) aborto,2016-12-01,2,0,2
70902,PAMPA GRANDE,salud sexual y reproductiva,hemorragia de la primera mitad del embarazo (< 22 sem) aborto,2016-12-01,0,1,1
40601,POOPO,salud sexual y reproductiva,hemorragia de la primera mitad del embarazo (< 22 sem) aborto,2016-12-01,1,0,1
70601,PORTACHUELO,salud sexual y reproductiva,hemorragia de la primera mitad del embarazo (< 22 sem) aborto,2016-12-01,4,0,4
50101,POTOSI,salud sexual y reproductiva,hemorragia de la primera mitad del embarazo (< 22 sem) aborto,2016-12-01,22,0,22
10302,PRESTO,salud sexual y reproductiva,hemorragia de la primera mitad del embarazo (< 22 sem) aborto,2016-12-01,1,0,1
90201,PUERTO RICO,salud sexual y reproductiva,hemorragia de la primera mitad del embarazo (< 22 sem) aborto,2016-12-01,1,0,1
71401,PUERTO SUAREZ,salud sexual y reproductiva,hemorragia de la primera mitad del embarazo (< 22 sem) aborto,2016-12-01,5,0,5
31205,PUERTO VILLARROEL,salud sexual y reproductiva,hemorragia de la primera mitad del embarazo (< 22 sem) aborto,2016-12-01,35,0,35
31401,PUNATA,salud sexual y reproductiva,hemorragia de la primera mitad del embarazo (< 22 sem) aborto,2016-12-01,15,0,15
30901,QUILLACOLLO,salud sexual y reproductiva,hemorragia de la primera mitad del embarazo (< 22 sem) aborto,2016-12-01,54,0,54
50402,RAVELO,salud sexual y reproductiva,hemorragia de la primera mitad del embarazo (< 22 sem) aborto,2016-12-01,1,1,2
80301,REYES,salud sexual y reproductiva,hemorragia de la primera mitad del embarazo (< 22 sem) aborto,2016-12-01,2,0,2
80201,RIBERALTA,salud sexual y reproductiva,hemorragia de la primera mitad del embarazo (< 22 sem) aborto,2016-12-01,17,4,21
70503,ROBORE,salud sexual y reproductiva,hemorragia de la primera mitad del embarazo (< 22 sem) aborto,2016-12-01,2,0,2
31001,SACABA,salud sexual y reproductiva,hemorragia de la primera mitad del embarazo (< 22 sem) aborto,2016-12-01,41,0,41
50701,SACACA,salud sexual y reproductiva,hemorragia de la primera mitad del embarazo (< 22 sem) aborto,2016-12-01,0,1,1
80302,SAN BORJA,salud sexual y reproductiva,hemorragia de la primera mitad del embarazo (< 22 sem) aborto,2016-12-01,12,0,12
21502,SAN BUENA VENTURA,salud sexual y reproductiva,hemorragia de la primera mitad del embarazo (< 22 sem) aborto,2016-12-01,4,0,4
70402,SAN CARLOS,salud sexual y reproductiva,hemorragia de la primera mitad del embarazo (< 22 sem) aborto,2016-12-01,6,1,7
80501,SAN IGNACIO,salud sexual y reproductiva,hemorragia de la primera mitad del embarazo (< 22 sem) aborto,2016-12-01,2,1,3
70301,SAN IGNACIO DE VELASCO,salud sexual y reproductiva,hemorragia de la primera mitad del embarazo (< 22 sem) aborto,2016-12-01,9,0,9
71102,SAN JAVIER(STC),salud sexual y reproductiva,hemorragia de la primera mitad del embarazo (< 22 sem) aborto,2016-12-01,1,0,1
70501,SAN JOSE DE CHIQUITOS,salud sexual y reproductiva,hemorragia de la primera mitad del embarazo (< 22 sem) aborto,2016-12-01,5,0,5
71104,SAN JULIAN,salud sexual y reproductiva,hemorragia de la primera mitad del embarazo (< 22 sem) aborto,2016-12-01,17,2,19
70302,SAN MIGUEL DE VELASCO,salud sexual y reproductiva,hemorragia de la primera mitad del embarazo (< 22 sem) aborto,2016-12-01,2,0,2
71005,SAN PEDRO,salud sexual y reproductiva,hemorragia de la primera mitad del embarazo (< 22 sem) aborto,2016-12-01,1,0,1
50501,SAN PEDRO DE BUENA VISTA,salud sexual y reproductiva,hemorragia de la primera mitad del embarazo (< 22 sem) aborto,2016-12-01,1,0,1
71103,SAN RAMON SCZ,salud sexual y reproductiva,hemorragia de la primera mitad del embarazo (< 22 sem) aborto,2016-12-01,3,0,3
70101,SANTA CRUZ DE LA SIERRA,salud sexual y reproductiva,hemorragia de la primera mitad del embarazo (< 22 sem) aborto,2016-12-01,301,103,404
20902,SAPAHAQUI,salud sexual y reproductiva,hemorragia de la primera mitad del embarazo (< 22 sem) aborto,2016-12-01,2,0,2
90303,SENA,salud sexual y reproductiva,hemorragia de la primera mitad del embarazo (< 22 sem) aborto,2016-12-01,2,0,2
31602,SHINAOTA,salud sexual y reproductiva,hemorragia de la primera mitad del embarazo (< 22 sem) aborto,2016-12-01,18,0,18
30902,SIPE SIPE,salud sexual y reproductiva,hemorragia de la primera mitad del embarazo (< 22 sem) aborto,2016-12-01,2,0,2
10403,SOPACHUY,salud sexual y reproductiva,hemorragia de la primera mitad del embarazo (< 22 sem) aborto,2016-12-01,0,1,1
20601,SORATA,salud sexual y reproductiva,hemorragia de la primera mitad del embarazo (< 22 sem) aborto,2016-12-01,2,0,2
10101,SUCRE,salud sexual y reproductiva,hemorragia de la primera mitad del embarazo (< 22 sem) aborto,2016-12-01,109,5,114
31101,TAPACARI,salud sexual y reproductiva,hemorragia de la primera mitad del embarazo (< 22 sem) aborto,2016-12-01,0,1,1
10601,TARABUCO,salud sexual y reproductiva,hemorragia de la primera mitad del embarazo (< 22 sem) aborto,2016-12-01,0,5,5
60101,TARIJA,salud sexual y reproductiva,hemorragia de la primera mitad del embarazo (< 22 sem) aborto,2016-12-01,77,2,79
10202,TARVITA,salud sexual y reproductiva,hemorragia de la primera mitad del embarazo (< 22 sem) aborto,2016-12-01,1,0,1
20608,TEOPONTE,salud sexual y reproductiva,hemorragia de la primera mitad del embarazo (< 22 sem) aborto,2016-12-01,1,1,2
20606,TIPUANI,salud sexual y reproductiva,hemorragia de la primera mitad del embarazo (< 22 sem) aborto,2016-12-01,1,0,1
80101,TRINIDAD,salud sexual y reproductiva,hemorragia de la primera mitad del embarazo (< 22 sem) aborto,2016-12-01,52,0,52
50801,TUPIZA,salud sexual y reproductiva,hemorragia de la primera mitad del embarazo (< 22 sem) aborto,2016-12-01,12,0,12
51201,UYUNI,salud sexual y reproductiva,hemorragia de la primera mitad del embarazo (< 22 sem) aborto,2016-12-01,0,1,1
70801,VALLEGRANDE,salud sexual y reproductiva,hemorragia de la primera mitad del embarazo (< 22 sem) aborto,2016-12-01,1,0,1
31302,VILA VILA,salud sexual y reproductiva,hemorragia de la primera mitad del embarazo (< 22 sem) aborto,2016-12-01,0,2,2
31003,VILLA TUNARI,salud sexual y reproductiva,hemorragia de la primera mitad del embarazo (< 22 sem) aborto,2016-12-01,16,2,18
51501,VILLAZON,salud sexual y reproductiva,hemorragia de la primera mitad del embarazo (< 22 sem) aborto,2016-12-01,11,0,11
70201,WARNES,salud sexual y reproductiva,hemorragia de la primera mitad del embarazo (< 22 sem) aborto,2016-12-01,6,14,20
60301,YACUIBA,salud sexual y reproductiva,hemorragia de la primera mitad del embarazo (< 22 sem) aborto,2016-12-01,0,2,2
70403,YAPACANI,salud sexual y reproductiva,hemorragia de la primera mitad del embarazo (< 22 sem) aborto,2016-12-01,19,0,19
20201,ACHACACHI,salud sexual y reproductiva,hemorragia de la primera mitad del embarazo (< 22 sem) aborto,2017-01-01,1,0,1
30201,AIQUILE,salud sexual y reproductiva,hemorragia de la primera mitad del embarazo (< 22 sem) aborto,2017-01-01,6,0,6
20202,ANCORAIMES,salud sexual y reproductiva,hemorragia de la primera mitad del embarazo (< 22 sem) aborto,2017-01-01,0,1,1
30402,ANZALDO,salud sexual y reproductiva,hemorragia de la primera mitad del embarazo (< 22 sem) aborto,2017-01-01,1,0,1
20701,APOLO,salud sexual y reproductiva,hemorragia de la primera mitad del embarazo (< 22 sem) aborto,2017-01-01,0,6,6
71501,ASCENCION DE GUARAYOS,salud sexual y reproductiva,hemorragia de la primera mitad del embarazo (< 22 sem) aborto,2017-01-01,14,6,20
60202,BERMEJO,salud sexual y reproductiva,hemorragia de la primera mitad del embarazo (< 22 sem) aborto,2017-01-01,0,1,1
21003,CAJUATA,salud sexual y reproductiva,hemorragia de la primera mitad del embarazo (< 22 sem) aborto,2017-01-01,3,0,3
10701,CAMARGO,salud sexual y reproductiva,hemorragia de la primera mitad del embarazo (< 22 sem) aborto,2017-01-01,0,4,4
70706,CAMIRI,salud sexual y reproductiva,hemorragia de la primera mitad del embarazo (< 22 sem) aborto,2017-01-01,10,0,10
22001,CARANAVI,salud sexual y reproductiva,hemorragia de la primera mitad del embarazo (< 22 sem) aborto,2017-01-01,26,0,26
70702,CHARAGUA,salud sexual y reproductiva,hemorragia de la primera mitad del embarazo (< 22 sem) aborto,2017-01-01,2,0,2
20203,CHUA COCANI,salud sexual y reproductiva,hemorragia de la primera mitad del embarazo (< 22 sem) aborto,2017-01-01,1,0,1
21101,CHULUMANI (V. DE LA LIBERTAD),salud sexual y reproductiva,hemorragia de la primera mitad del embarazo (< 22 sem) aborto,2017-01-01,7,0,7
30801,CLIZA,salud sexual y reproductiva,hemorragia de la primera mitad del embarazo (< 22 sem) aborto,2017-01-01,16,1,17
90101,COBIJA,salud sexual y reproductiva,hemorragia de la primera mitad del embarazo (< 22 sem) aborto,2017-01-01,20,0,20
30303,COCAPATA,salud sexual y reproductiva,hemorragia de la primera mitad del embarazo (< 22 sem) aborto,2017-01-01,1,0,1
30101,COCHABAMBA,salud sexual y reproductiva,hemorragia de la primera mitad del embarazo (< 22 sem) aborto,2017-01-01,186,17,203
30905,COLCAPIRHUA,salud sexual y reproductiva,hemorragia de la primera mitad del embarazo (< 22 sem) aborto,2017-01-01,2,0,2
50401,COLQUECHACA,salud sexual y reproductiva,hemorragia de la primera mitad del embarazo (< 22 sem) aborto,2017-01-01,1,0,1
71301,COMARAPA,salud sexual y reproductiva,hemorragia de la primera mitad del embarazo (< 22 sem) aborto,2017-01-01,3,0,3
71101,CONCEPCION,salud sexual y reproductiva,hemorragia de la primera mitad del embarazo (< 22 sem) aborto,2017-01-01,4,0,4
21402,CORIPATA,salud sexual y reproductiva,hemorragia de la primera mitad del embarazo (< 22 sem) aborto,2017-01-01,1,0,1
21401,COROICO,salud sexual y reproductiva,hemorragia de la primera mitad del embarazo (< 22 sem) aborto,2017-01-01,1,0,1
70102,COTOCA,salud sexual y reproductiva,hemorragia de la primera mitad del embarazo (< 22 sem) aborto,2017-01-01,4,0,4
71106,CUATRO CAÃ‘ADAS,salud sexual y reproductiva,hemorragia de la primera mitad del embarazo (< 22 sem) aborto,2017-01-01,6,0,6
10902,CULPINA,salud sexual y reproductiva,hemorragia de la primera mitad del embarazo (< 22 sem) aborto,2017-01-01,1,0,1
20105,EL ALTO,salud sexual y reproductiva,hemorragia de la primera mitad del embarazo (< 22 sem) aborto,2017-01-01,103,7,110
70105,EL TORNO,salud sexual y reproductiva,hemorragia de la primera mitad del embarazo (< 22 sem) aborto,2017-01-01,18,0,18
90203,FILADELFIA,salud sexual y reproductiva,hemorragia de la primera mitad del embarazo (< 22 sem) aborto,2017-01-01,0,1,1
20602,GUANAY,salud sexual y reproductiva,hemorragia de la primera mitad del embarazo (< 22 sem) aborto,2017-01-01,0,2,2
80202,GUAYARAMERIN,salud sexual y reproductiva,hemorragia de la primera mitad del embarazo (< 22 sem) aborto,2017-01-01,1,0,1
70705,GUTIERREZ,salud sexual y reproductiva,hemorragia de la primera mitad del embarazo (< 22 sem) aborto,2017-01-01,2,0,2
10502,HUACARETA,salud sexual y reproductiva,hemorragia de la primera mitad del embarazo (< 22 sem) aborto,2017-01-01,0,1,1
40701,HUANUNI,salud sexual y reproductiva,hemorragia de la primera mitad del embarazo (< 22 sem) aborto,2017-01-01,8,0,8
20206,HUATAJATA,salud sexual y reproductiva,hemorragia de la primera mitad del embarazo (< 22 sem) aborto,2017-01-01,1,1,2
21001,INQUISIVI,salud sexual y reproductiva,hemorragia de la primera mitad del embarazo (< 22 sem) aborto,2017-01-01,0,1,1
21102,IRUPANA (VILLA DE LANZA),salud sexual y reproductiva,hemorragia de la primera mitad del embarazo (< 22 sem) aborto,2017-01-01,0,1,1
70104,LA GUARDIA,salud sexual y reproductiva,hemorragia de la primera mitad del embarazo (< 22 sem) aborto,2017-01-01,2,2,4
20101,LA PAZ,salud sexual y reproductiva,hemorragia de la primera mitad del embarazo (< 22 sem) aborto,2017-01-01,151,18,169
10903,LAS CARRERAS,salud sexual y reproductiva,hemorragia de la primera mitad del embarazo (< 22 sem) aborto,2017-01-01,1,0,1
11003,MACHARETI,salud sexual y reproductiva,hemorragia de la primera mitad del embarazo (< 22 sem) aborto,2017-01-01,1,2,3
70903,MAIRANA,salud sexual y reproductiva,hemorragia de la primera mitad del embarazo (< 22 sem) aborto,2017-01-01,3,0,3
10501,MONTEAGUDO,salud sexual y reproductiva,hemorragia de la primera mitad del embarazo (< 22 sem) aborto,2017-01-01,5,0,5
71001,MONTERO,salud sexual y reproductiva,hemorragia de la primera mitad del embarazo (< 22 sem) aborto,2017-01-01,2,0,2
30302,MOROCHATA,salud sexual y reproductiva,hemorragia de la primera mitad del embarazo (< 22 sem) aborto,2017-01-01,1,1,2
40101,ORURO,salud sexual y reproductiva,hemorragia de la primera mitad del embarazo (< 22 sem) aborto,2017-01-01,9,2,11
70502,PAILON,salud sexual y reproductiva,hemorragia de la primera mitad del embarazo (< 22 sem) aborto,2017-01-01,2,0,2
21104,PALOS BLANCOS,salud sexual y reproductiva,hemorragia de la primera mitad del embarazo (< 22 sem) aborto,2017-01-01,4,0,4
70103,PORONGO,salud sexual y reproductiva,hemorragia de la primera mitad del embarazo (< 22 sem) aborto,2017-01-01,0,1,1
50101,POTOSI,salud sexual y reproductiva,hemorragia de la primera mitad del embarazo (< 22 sem) aborto,2017-01-01,24,0,24
21201,PUCARANI,salud sexual y reproductiva,hemorragia de la primera mitad del embarazo (< 22 sem) aborto,2017-01-01,1,1,2
71401,PUERTO SUAREZ,salud sexual y reproductiva,hemorragia de la primera mitad del embarazo (< 22 sem) aborto,2017-01-01,4,0,4
31205,PUERTO VILLARROEL,salud sexual y reproductiva,hemorragia de la primera mitad del embarazo (< 22 sem) aborto,2017-01-01,18,0,18
31401,PUNATA,salud sexual y reproductiva,hemorragia de la primera mitad del embarazo (< 22 sem) aborto,2017-01-01,18,0,18
30901,QUILLACOLLO,salud sexual y reproductiva,hemorragia de la primera mitad del embarazo (< 22 sem) aborto,2017-01-01,76,0,76
80301,REYES,salud sexual y reproductiva,hemorragia de la primera mitad del embarazo (< 22 sem) aborto,2017-01-01,2,0,2
80201,RIBERALTA,salud sexual y reproductiva,hemorragia de la primera mitad del embarazo (< 22 sem) aborto,2017-01-01,23,1,24
70503,ROBORE,salud sexual y reproductiva,hemorragia de la primera mitad del embarazo (< 22 sem) aborto,2017-01-01,9,0,9
31001,SACABA,salud sexual y reproductiva,hemorragia de la primera mitad del embarazo (< 22 sem) aborto,2017-01-01,4,6,10
30404,SACABAMBA,salud sexual y reproductiva,hemorragia de la primera mitad del embarazo (< 22 sem) aborto,2017-01-01,1,0,1
70901,SAMAIPATA,salud sexual y reproductiva,hemorragia de la primera mitad del embarazo (< 22 sem) aborto,2017-01-01,1,0,1
80302,SAN BORJA,salud sexual y reproductiva,hemorragia de la primera mitad del embarazo (< 22 sem) aborto,2017-01-01,8,0,8
21502,SAN BUENA VENTURA,salud sexual y reproductiva,hemorragia de la primera mitad del embarazo (< 22 sem) aborto,2017-01-01,3,0,3
70402,SAN CARLOS,salud sexual y reproductiva,hemorragia de la primera mitad del embarazo (< 22 sem) aborto,2017-01-01,7,0,7
70301,SAN IGNACIO DE VELASCO,salud sexual y reproductiva,hemorragia de la primera mitad del embarazo (< 22 sem) aborto,2017-01-01,7,0,7
70501,SAN JOSE DE CHIQUITOS,salud sexual y reproductiva,hemorragia de la primera mitad del embarazo (< 22 sem) aborto,2017-01-01,3,0,3
71104,SAN JULIAN,salud sexual y reproductiva,hemorragia de la primera mitad del embarazo (< 22 sem) aborto,2017-01-01,7,0,7
10702,SAN LUCAS,salud sexual y reproductiva,hemorragia de la primera mitad del embarazo (< 22 sem) aborto,2017-01-01,0,1,1
71201,SAN MATIAS,salud sexual y reproductiva,hemorragia de la primera mitad del embarazo (< 22 sem) aborto,2017-01-01,0,1,1
70302,SAN MIGUEL DE VELASCO,salud sexual y reproductiva,hemorragia de la primera mitad del embarazo (< 22 sem) aborto,2017-01-01,3,0,3
80702,SAN RAMON BENI,salud sexual y reproductiva,hemorragia de la primera mitad del embarazo (< 22 sem) aborto,2017-01-01,1,0,1
80401,SANTA ANA,salud sexual y reproductiva,hemorragia de la primera mitad del embarazo (< 22 sem) aborto,2017-01-01,12,1,13
70101,SANTA CRUZ DE LA SIERRA,salud sexual y reproductiva,hemorragia de la primera mitad del embarazo (< 22 sem) aborto,2017-01-01,391,96,487
70602,SANTA ROSA DEL SARA,salud sexual y reproductiva,hemorragia de la primera mitad del embarazo (< 22 sem) aborto,2017-01-01,0,1,1
90303,SENA,salud sexual y reproductiva,hemorragia de la primera mitad del embarazo (< 22 sem) aborto,2017-01-01,1,0,1
31602,SHINAOTA,salud sexual y reproductiva,hemorragia de la primera mitad del embarazo (< 22 sem) aborto,2017-01-01,15,0,15
30703,SICAYA,salud sexual y reproductiva,hemorragia de la primera mitad del embarazo (< 22 sem) aborto,2017-01-01,1,0,1
30902,SIPE SIPE,salud sexual y reproductiva,hemorragia de la primera mitad del embarazo (< 22 sem) aborto,2017-01-01,1,0,1
10101,SUCRE,salud sexual y reproductiva,hemorragia de la primera mitad del embarazo (< 22 sem) aborto,2017-01-01,136,15,151
30401,TARATA,salud sexual y reproductiva,hemorragia de la primera mitad del embarazo (< 22 sem) aborto,2017-01-01,0,1,1
60101,TARIJA,salud sexual y reproductiva,hemorragia de la primera mitad del embarazo (< 22 sem) aborto,2017-01-01,59,0,59
10202,TARVITA,salud sexual y reproductiva,hemorragia de la primera mitad del embarazo (< 22 sem) aborto,2017-01-01,1,2,3
20608,TEOPONTE,salud sexual y reproductiva,hemorragia de la primera mitad del embarazo (< 22 sem) aborto,2017-01-01,0,1,1
31601,TIRAQUE (CBBA),salud sexual y reproductiva,hemorragia de la primera mitad del embarazo (< 22 sem) aborto,2017-01-01,3,0,3
30802,TOCO,salud sexual y reproductiva,hemorragia de la primera mitad del embarazo (< 22 sem) aborto,2017-01-01,2,0,2
30803,TOLATA,salud sexual y reproductiva,hemorragia de la primera mitad del embarazo (< 22 sem) aborto,2017-01-01,1,0,1
10402,TOMINA,salud sexual y reproductiva,hemorragia de la primera mitad del embarazo (< 22 sem) aborto,2017-01-01,0,1,1
80101,TRINIDAD,salud sexual y reproductiva,hemorragia de la primera mitad del embarazo (< 22 sem) aborto,2017-01-01,26,1,27
50801,TUPIZA,salud sexual y reproductiva,hemorragia de la primera mitad del embarazo (< 22 sem) aborto,2017-01-01,6,0,6
51201,UYUNI,salud sexual y reproductiva,hemorragia de la primera mitad del embarazo (< 22 sem) aborto,2017-01-01,5,0,5
31302,VILA VILA,salud sexual y reproductiva,hemorragia de la primera mitad del embarazo (< 22 sem) aborto,2017-01-01,0,1,1
31402,VILLA RIVERO,salud sexual y reproductiva,hemorragia de la primera mitad del embarazo (< 22 sem) aborto,2017-01-01,0,2,2
31003,VILLA TUNARI,salud sexual y reproductiva,hemorragia de la primera mitad del embarazo (< 22 sem) aborto,2017-01-01,4,0,4
11001,VILLA VACA GUZMAN (MUYUPAMPA),salud sexual y reproductiva,hemorragia de la primera mitad del embarazo (< 22 sem) aborto,2017-01-01,1,0,1
51501,VILLAZON,salud sexual y reproductiva,hemorragia de la primera mitad del embarazo (< 22 sem) aborto,2017-01-01,8,0,8
70201,WARNES,salud sexual y reproductiva,hemorragia de la primera mitad del embarazo (< 22 sem) aborto,2017-01-01,0,10,10
60301,YACUIBA,salud sexual y reproductiva,hemorragia de la primera mitad del embarazo (< 22 sem) aborto,2017-01-01,0,2,2
70403,YAPACANI,salud sexual y reproductiva,hemorragia de la primera mitad del embarazo (< 22 sem) aborto,2017-01-01,20,0,20
30201,AIQUILE,salud sexual y reproductiva,hemorragia de la primera mitad del embarazo (< 22 sem) aborto,2017-02-01,1,0,1
40603,ANTEQUERA,salud sexual y reproductiva,hemorragia de la primera mitad del embarazo (< 22 sem) aborto,2017-02-01,1,0,1
30501,ARANI,salud sexual y reproductiva,hemorragia de la primera mitad del embarazo (< 22 sem) aborto,2017-02-01,2,0,2
30403,ARBIETO,salud sexual y reproductiva,hemorragia de la primera mitad del embarazo (< 22 sem) aborto,2017-02-01,1,0,1
71501,ASCENCION DE GUARAYOS,salud sexual y reproductiva,hemorragia de la primera mitad del embarazo (< 22 sem) aborto,2017-02-01,0,4,4
90104,BELLA FLOR,salud sexual y reproductiva,hemorragia de la primera mitad del embarazo (< 22 sem) aborto,2017-02-01,1,0,1
50301,BETANZOS,salud sexual y reproductiva,hemorragia de la primera mitad del embarazo (< 22 sem) aborto,2017-02-01,1,0,1
20905,CAIROMA,salud sexual y reproductiva,hemorragia de la primera mitad del embarazo (< 22 sem) aborto,2017-02-01,0,1,1
21003,CAJUATA,salud sexual y reproductiva,hemorragia de la primera mitad del embarazo (< 22 sem) aborto,2017-02-01,1,0,1
21304,CALAMARCA,salud sexual y reproductiva,hemorragia de la primera mitad del embarazo (< 22 sem) aborto,2017-02-01,1,0,1
10701,CAMARGO,salud sexual y reproductiva,hemorragia de la primera mitad del embarazo (< 22 sem) aborto,2017-02-01,0,6,6
70706,CAMIRI,salud sexual y reproductiva,hemorragia de la primera mitad del embarazo (< 22 sem) aborto,2017-02-01,16,7,23
30701,CAPINOTA,salud sexual y reproductiva,hemorragia de la primera mitad del embarazo (< 22 sem) aborto,2017-02-01,10,0,10
22001,CARANAVI,salud sexual y reproductiva,hemorragia de la primera mitad del embarazo (< 22 sem) aborto,2017-02-01,17,0,17
70702,CHARAGUA,salud sexual y reproductiva,hemorragia de la primera mitad del embarazo (< 22 sem) aborto,2017-02-01,1,0,1
31204,CHIMORE,salud sexual y reproductiva,hemorragia de la primera mitad del embarazo (< 22 sem) aborto,2017-02-01,3,0,3
21101,CHULUMANI (V. DE LA LIBERTAD),salud sexual y reproductiva,hemorragia de la primera mitad del embarazo (< 22 sem) aborto,2017-02-01,5,0,5
30801,CLIZA,salud sexual y reproductiva,hemorragia de la primera mitad del embarazo (< 22 sem) aborto,2017-02-01,23,0,23
90101,COBIJA,salud sexual y reproductiva,hemorragia de la primera mitad del embarazo (< 22 sem) aborto,2017-02-01,26,1,27
30303,COCAPATA,salud sexual y reproductiva,hemorragia de la primera mitad del embarazo (< 22 sem) aborto,2017-02-01,1,0,1
30101,COCHABAMBA,salud sexual y reproductiva,hemorragia de la primera mitad del embarazo (< 22 sem) aborto,2017-02-01,126,59,185
71301,COMARAPA,salud sexual y reproductiva,hemorragia de la primera mitad del embarazo (< 22 sem) aborto,2017-02-01,3,1,4
71101,CONCEPCION,salud sexual y reproductiva,hemorragia de la primera mitad del embarazo (< 22 sem) aborto,2017-02-01,1,0,1
21401,COROICO,salud sexual y reproductiva,hemorragia de la primera mitad del embarazo (< 22 sem) aborto,2017-02-01,1,0,1
50601,COTAGAITA,salud sexual y reproductiva,hemorragia de la primera mitad del embarazo (< 22 sem) aborto,2017-02-01,3,1,4
70102,COTOCA,salud sexual y reproductiva,hemorragia de la primera mitad del embarazo (< 22 sem) aborto,2017-02-01,5,0,5
71106,CUATRO CAÃ‘ADAS,salud sexual y reproductiva,hemorragia de la primera mitad del embarazo (< 22 sem) aborto,2017-02-01,1,1,2
70704,CUEVO,salud sexual y reproductiva,hemorragia de la primera mitad del embarazo (< 22 sem) aborto,2017-02-01,1,0,1
20105,EL ALTO,salud sexual y reproductiva,hemorragia de la primera mitad del embarazo (< 22 sem) aborto,2017-02-01,153,10,163
70105,EL TORNO,salud sexual y reproductiva,hemorragia de la primera mitad del embarazo (< 22 sem) aborto,2017-02-01,7,0,7
31206,ENTRE RIOS CBBA,salud sexual y reproductiva,hemorragia de la primera mitad del embarazo (< 22 sem) aborto,2017-02-01,3,0,3
80202,GUAYARAMERIN,salud sexual y reproductiva,hemorragia de la primera mitad del embarazo (< 22 sem) aborto,2017-02-01,2,1,3
40701,HUANUNI,salud sexual y reproductiva,hemorragia de la primera mitad del embarazo (< 22 sem) aborto,2017-02-01,3,0,3
20206,HUATAJATA,salud sexual y reproductiva,hemorragia de la primera mitad del embarazo (< 22 sem) aborto,2017-02-01,1,1,2
10703,INCAHUASI,salud sexual y reproductiva,hemorragia de la primera mitad del embarazo (< 22 sem) aborto,2017-02-01,0,1,1
21105,LA ASUNTA,salud sexual y reproductiva,hemorragia de la primera mitad del embarazo (< 22 sem) aborto,2017-02-01,2,0,2
70104,LA GUARDIA,salud sexual y reproductiva,hemorragia de la primera mitad del embarazo (< 22 sem) aborto,2017-02-01,2,0,2
20101,LA PAZ,salud sexual y reproductiva,hemorragia de la primera mitad del embarazo (< 22 sem) aborto,2017-02-01,137,30,167
80601,LORETO,salud sexual y reproductiva,hemorragia de la primera mitad del embarazo (< 22 sem) aborto,2017-02-01,0,1,1
70903,MAIRANA,salud sexual y reproductiva,hemorragia de la primera mitad del embarazo (< 22 sem) aborto,2017-02-01,8,0,8
20607,MAPIRI,salud sexual y reproductiva,hemorragia de la primera mitad del embarazo (< 22 sem) aborto,2017-02-01,4,0,4
31301,MIZQUE,salud sexual y reproductiva,hemorragia de la primera mitad del embarazo (< 22 sem) aborto,2017-02-01,7,2,9
10501,MONTEAGUDO,salud sexual y reproductiva,hemorragia de la primera mitad del embarazo (< 22 sem) aborto,2017-02-01,0,1,1
71001,MONTERO,salud sexual y reproductiva,hemorragia de la primera mitad del embarazo (< 22 sem) aborto,2017-02-01,0,5,5
40101,ORURO,salud sexual y reproductiva,hemorragia de la primera mitad del embarazo (< 22 sem) aborto,2017-02-01,11,1,12
70502,PAILON,salud sexual y reproductiva,hemorragia de la primera mitad del embarazo (< 22 sem) aborto,2017-02-01,9,1,10
21104,PALOS BLANCOS,salud sexual y reproductiva,hemorragia de la primera mitad del embarazo (< 22 sem) aborto,2017-02-01,1,0,1
50101,POTOSI,salud sexual y reproductiva,hemorragia de la primera mitad del embarazo (< 22 sem) aborto,2017-02-01,33,0,33
71401,PUERTO SUAREZ,salud sexual y reproductiva,hemorragia de la primera mitad del embarazo (< 22 sem) aborto,2017-02-01,3,0,3
31205,PUERTO VILLARROEL,salud sexual y reproductiva,hemorragia de la primera mitad del embarazo (< 22 sem) aborto,2017-02-01,27,0,27
31401,PUNATA,salud sexual y reproductiva,hemorragia de la primera mitad del embarazo (< 22 sem) aborto,2017-02-01,16,0,16
30901,QUILLACOLLO,salud sexual y reproductiva,hemorragia de la primera mitad del embarazo (< 22 sem) aborto,2017-02-01,79,0,79
80301,REYES,salud sexual y reproductiva,hemorragia de la primera mitad del embarazo (< 22 sem) aborto,2017-02-01,5,0,5
80201,RIBERALTA,salud sexual y reproductiva,hemorragia de la primera mitad del embarazo (< 22 sem) aborto,2017-02-01,9,0,9
70503,ROBORE,salud sexual y reproductiva,hemorragia de la primera mitad del embarazo (< 22 sem) aborto,2017-02-01,9,0,9
80304,RURRENABAQUE,salud sexual y reproductiva,hemorragia de la primera mitad del embarazo (< 22 sem) aborto,2017-02-01,3,0,3
31001,SACABA,salud sexual y reproductiva,hemorragia de la primera mitad del embarazo (< 22 sem) aborto,2017-02-01,18,0,18
71105,SAN ANTONIO DE LOMERIO,salud sexual y reproductiva,hemorragia de la primera mitad del embarazo (< 22 sem) aborto,2017-02-01,1,0,1
31403,SAN BENITO,salud sexual y reproductiva,hemorragia de la primera mitad del embarazo (< 22 sem) aborto,2017-02-01,1,0,1
80302,SAN BORJA,salud sexual y reproductiva,hemorragia de la primera mitad del embarazo (< 22 sem) aborto,2017-02-01,17,0,17
21502,SAN BUENA VENTURA,salud sexual y reproductiva,hemorragia de la primera mitad del embarazo (< 22 sem) aborto,2017-02-01,7,0,7
70402,SAN CARLOS,salud sexual y reproductiva,hemorragia de la primera mitad del embarazo (< 22 sem) aborto,2017-02-01,9,0,9
80501,SAN IGNACIO,salud sexual y reproductiva,hemorragia de la primera mitad del embarazo (< 22 sem) aborto,2017-02-01,1,0,1
70301,SAN IGNACIO DE VELASCO,salud sexual y reproductiva,hemorragia de la primera mitad del embarazo (< 22 sem) aborto,2017-02-01,19,0,19
70501,SAN JOSE DE CHIQUITOS,salud sexual y reproductiva,hemorragia de la primera mitad del embarazo (< 22 sem) aborto,2017-02-01,5,0,5
71104,SAN JULIAN,salud sexual y reproductiva,hemorragia de la primera mitad del embarazo (< 22 sem) aborto,2017-02-01,7,0,7
10702,SAN LUCAS,salud sexual y reproductiva,hemorragia de la primera mitad del embarazo (< 22 sem) aborto,2017-02-01,0,1,1
71201,SAN MATIAS,salud sexual y reproductiva,hemorragia de la primera mitad del embarazo (< 22 sem) aborto,2017-02-01,0,3,3
70302,SAN MIGUEL DE VELASCO,salud sexual y reproductiva,hemorragia de la primera mitad del embarazo (< 22 sem) aborto,2017-02-01,4,0,4
71005,SAN PEDRO,salud sexual y reproductiva,hemorragia de la primera mitad del embarazo (< 22 sem) aborto,2017-02-01,1,0,1
80702,SAN RAMON BENI,salud sexual y reproductiva,hemorragia de la primera mitad del embarazo (< 22 sem) aborto,2017-02-01,2,0,2
71103,SAN RAMON SCZ,salud sexual y reproductiva,hemorragia de la primera mitad del embarazo (< 22 sem) aborto,2017-02-01,1,0,1
80401,SANTA ANA,salud sexual y reproductiva,hemorragia de la primera mitad del embarazo (< 22 sem) aborto,2017-02-01,10,0,10
70101,SANTA CRUZ DE LA SIERRA,salud sexual y reproductiva,hemorragia de la primera mitad del embarazo (< 22 sem) aborto,2017-02-01,322,111,433
70602,SANTA ROSA DEL SARA,salud sexual y reproductiva,hemorragia de la primera mitad del embarazo (< 22 sem) aborto,2017-02-01,2,0,2
30702,SANTIVAÃ‘ES,salud sexual y reproductiva,hemorragia de la primera mitad del embarazo (< 22 sem) aborto,2017-02-01,4,0,4
20902,SAPAHAQUI,salud sexual y reproductiva,hemorragia de la primera mitad del embarazo (< 22 sem) aborto,2017-02-01,1,0,1
90303,SENA,salud sexual y reproductiva,hemorragia de la primera mitad del embarazo (< 22 sem) aborto,2017-02-01,1,0,1
31602,SHINAOTA,salud sexual y reproductiva,hemorragia de la primera mitad del embarazo (< 22 sem) aborto,2017-02-01,13,0,13
30902,SIPE SIPE,salud sexual y reproductiva,hemorragia de la primera mitad del embarazo (< 22 sem) aborto,2017-02-01,1,0,1
10403,SOPACHUY,salud sexual y reproductiva,hemorragia de la primera mitad del embarazo (< 22 sem) aborto,2017-02-01,0,1,1
10101,SUCRE,salud sexual y reproductiva,hemorragia de la primera mitad del embarazo (< 22 sem) aborto,2017-02-01,112,21,133
50303,TACOBAMBA,salud sexual y reproductiva,hemorragia de la primera mitad del embarazo (< 22 sem) aborto,2017-02-01,0,1,1
31101,TAPACARI,salud sexual y reproductiva,hemorragia de la primera mitad del embarazo (< 22 sem) aborto,2017-02-01,1,0,1
10601,TARABUCO,salud sexual y reproductiva,hemorragia de la primera mitad del embarazo (< 22 sem) aborto,2017-02-01,0,2,2
60101,TARIJA,salud sexual y reproductiva,hemorragia de la primera mitad del embarazo (< 22 sem) aborto,2017-02-01,72,0,72
10202,TARVITA,salud sexual y reproductiva,hemorragia de la primera mitad del embarazo (< 22 sem) aborto,2017-02-01,1,1,2
30903,TIQUIPAYA,salud sexual y reproductiva,hemorragia de la primera mitad del embarazo (< 22 sem) aborto,2017-02-01,1,0,1
31601,TIRAQUE (CBBA),salud sexual y reproductiva,hemorragia de la primera mitad del embarazo (< 22 sem) aborto,2017-02-01,1,0,1
80101,TRINIDAD,salud sexual y reproductiva,hemorragia de la primera mitad del embarazo (< 22 sem) aborto,2017-02-01,50,1,51
50801,TUPIZA,salud sexual y reproductiva,hemorragia de la primera mitad del embarazo (< 22 sem) aborto,2017-02-01,5,1,6
51201,UYUNI,salud sexual y reproductiva,hemorragia de la primera mitad del embarazo (< 22 sem) aborto,2017-02-01,2,0,2
30502,VACAS,salud sexual y reproductiva,hemorragia de la primera mitad del embarazo (< 22 sem) aborto,2017-02-01,1,0,1
70801,VALLEGRANDE,salud sexual y reproductiva,hemorragia de la primera mitad del embarazo (< 22 sem) aborto,2017-02-01,1,0,1
90502,VILLA NUEVA (LOMA ALTA),salud sexual y reproductiva,hemorragia de la primera mitad del embarazo (< 22 sem) aborto,2017-02-01,0,1,1
31402,VILLA RIVERO,salud sexual y reproductiva,hemorragia de la primera mitad del embarazo (< 22 sem) aborto,2017-02-01,2,0,2
31003,VILLA TUNARI,salud sexual y reproductiva,hemorragia de la primera mitad del embarazo (< 22 sem) aborto,2017-02-01,7,1,8
11001,VILLA VACA GUZMAN (MUYUPAMPA),salud sexual y reproductiva,hemorragia de la primera mitad del embarazo (< 22 sem) aborto,2017-02-01,3,0,3
51501,VILLAZON,salud sexual y reproductiva,hemorragia de la primera mitad del embarazo (< 22 sem) aborto,2017-02-01,16,1,17
70201,WARNES,salud sexual y reproductiva,hemorragia de la primera mitad del embarazo (< 22 sem) aborto,2017-02-01,0,20,20
60301,YACUIBA,salud sexual y reproductiva,hemorragia de la primera mitad del embarazo (< 22 sem) aborto,2017-02-01,0,1,1
70403,YAPACANI,salud sexual y reproductiva,hemorragia de la primera mitad del embarazo (< 22 sem) aborto,2017-02-01,8,0,8
30201,AIQUILE,salud sexual y reproductiva,hemorragia de la primera mitad del embarazo (< 22 sem) aborto,2017-03-01,3,0,3
30501,ARANI,salud sexual y reproductiva,hemorragia de la primera mitad del embarazo (< 22 sem) aborto,2017-03-01,2,0,2
30403,ARBIETO,salud sexual y reproductiva,hemorragia de la primera mitad del embarazo (< 22 sem) aborto,2017-03-01,5,0,5
71501,ASCENCION DE GUARAYOS,salud sexual y reproductiva,hemorragia de la primera mitad del embarazo (< 22 sem) aborto,2017-03-01,4,0,4
60202,BERMEJO,salud sexual y reproductiva,hemorragia de la primera mitad del embarazo (< 22 sem) aborto,2017-03-01,0,2,2
50301,BETANZOS,salud sexual y reproductiva,hemorragia de la primera mitad del embarazo (< 22 sem) aborto,2017-03-01,1,0,1
21003,CAJUATA,salud sexual y reproductiva,hemorragia de la primera mitad del embarazo (< 22 sem) aborto,2017-03-01,2,1,3
10701,CAMARGO,salud sexual y reproductiva,hemorragia de la primera mitad del embarazo (< 22 sem) aborto,2017-03-01,0,5,5
10901,CAMATAQUI (C. VILLA ABECIA),salud sexual y reproductiva,hemorragia de la primera mitad del embarazo (< 22 sem) aborto,2017-03-01,0,1,1
70706,CAMIRI,salud sexual y reproductiva,hemorragia de la primera mitad del embarazo (< 22 sem) aborto,2017-03-01,14,0,14
30701,CAPINOTA,salud sexual y reproductiva,hemorragia de la primera mitad del embarazo (< 22 sem) aborto,2017-03-01,8,0,8
40102,CARACOLLO,salud sexual y reproductiva,hemorragia de la primera mitad del embarazo (< 22 sem) aborto,2017-03-01,0,1,1
22001,CARANAVI,salud sexual y reproductiva,hemorragia de la primera mitad del embarazo (< 22 sem) aborto,2017-03-01,27,0,27
70702,CHARAGUA,salud sexual y reproductiva,hemorragia de la primera mitad del embarazo (< 22 sem) aborto,2017-03-01,5,0,5
21101,CHULUMANI (V. DE LA LIBERTAD),salud sexual y reproductiva,hemorragia de la primera mitad del embarazo (< 22 sem) aborto,2017-03-01,6,0,6
20501,CHUMA,salud sexual y reproductiva,hemorragia de la primera mitad del embarazo (< 22 sem) aborto,2017-03-01,1,0,1
51103,CKOCHAS,salud sexual y reproductiva,hemorragia de la primera mitad del embarazo (< 22 sem) aborto,2017-03-01,1,0,1
30801,CLIZA,salud sexual y reproductiva,hemorragia de la primera mitad del embarazo (< 22 sem) aborto,2017-03-01,25,0,25
90101,COBIJA,salud sexual y reproductiva,hemorragia de la primera mitad del embarazo (< 22 sem) aborto,2017-03-01,32,0,32
30101,COCHABAMBA,salud sexual y reproductiva,hemorragia de la primera mitad del embarazo (< 22 sem) aborto,2017-03-01,248,4,252
30905,COLCAPIRHUA,salud sexual y reproductiva,hemorragia de la primera mitad del embarazo (< 22 sem) aborto,2017-03-01,1,3,4
71301,COMARAPA,salud sexual y reproductiva,hemorragia de la primera mitad del embarazo (< 22 sem) aborto,2017-03-01,4,0,4
71101,CONCEPCION,salud sexual y reproductiva,hemorragia de la primera mitad del embarazo (< 22 sem) aborto,2017-03-01,5,0,5
21402,CORIPATA,salud sexual y reproductiva,hemorragia de la primera mitad del embarazo (< 22 sem) aborto,2017-03-01,2,0,2
70102,COTOCA,salud sexual y reproductiva,hemorragia de la primera mitad del embarazo (< 22 sem) aborto,2017-03-01,18,0,18
71106,CUATRO CAÃ‘ADAS,salud sexual y reproductiva,hemorragia de la primera mitad del embarazo (< 22 sem) aborto,2017-03-01,5,2,7
20105,EL ALTO,salud sexual y reproductiva,hemorragia de la primera mitad del embarazo (< 22 sem) aborto,2017-03-01,169,8,177
71503,EL PUENTE(STC),salud sexual y reproductiva,hemorragia de la primera mitad del embarazo (< 22 sem) aborto,2017-03-01,0,1,1
70105,EL TORNO,salud sexual y reproductiva,hemorragia de la primera mitad del embarazo (< 22 sem) aborto,2017-03-01,24,0,24
20405,ESCOMA,salud sexual y reproductiva,hemorragia de la primera mitad del embarazo (< 22 sem) aborto,2017-03-01,0,1,1
71004,FERNANDEZ ALONSO,salud sexual y reproductiva,hemorragia de la primera mitad del embarazo (< 22 sem) aborto,2017-03-01,1,0,1
80202,GUAYARAMERIN,salud sexual y reproductiva,hemorragia de la primera mitad del embarazo (< 22 sem) aborto,2017-03-01,3,0,3
70705,GUTIERREZ,salud sexual y reproductiva,hemorragia de la primera mitad del embarazo (< 22 sem) aborto,2017-03-01,0,1,1
40701,HUANUNI,salud sexual y reproductiva,hemorragia de la primera mitad del embarazo (< 22 sem) aborto,2017-03-01,6,0,6
21001,INQUISIVI,salud sexual y reproductiva,hemorragia de la primera mitad del embarazo (< 22 sem) aborto,2017-03-01,0,1,1
21105,LA ASUNTA,salud sexual y reproductiva,hemorragia de la primera mitad del embarazo (< 22 sem) aborto,2017-03-01,1,9,10
20101,LA PAZ,salud sexual y reproductiva,hemorragia de la primera mitad del embarazo (< 22 sem) aborto,2017-03-01,211,3,214
70903,MAIRANA,salud sexual y reproductiva,hemorragia de la primera mitad del embarazo (< 22 sem) aborto,2017-03-01,6,0,6
31301,MIZQUE,salud sexual y reproductiva,hemorragia de la primera mitad del embarazo (< 22 sem) aborto,2017-03-01,1,1,2
10501,MONTEAGUDO,salud sexual y reproductiva,hemorragia de la primera mitad del embarazo (< 22 sem) aborto,2017-03-01,2,4,6
71001,MONTERO,salud sexual y reproductiva,hemorragia de la primera mitad del embarazo (< 22 sem) aborto,2017-03-01,0,4,4
30302,MOROCHATA,salud sexual y reproductiva,hemorragia de la primera mitad del embarazo (< 22 sem) aborto,2017-03-01,2,0,2
50404,OCURI,salud sexual y reproductiva,hemorragia de la primera mitad del embarazo (< 22 sem) aborto,2017-03-01,3,0,3
30203,OMEREQUE,salud sexual y reproductiva,hemorragia de la primera mitad del embarazo (< 22 sem) aborto,2017-03-01,0,1,1
40101,ORURO,salud sexual y reproductiva,hemorragia de la primera mitad del embarazo (< 22 sem) aborto,2017-03-01,8,0,8
10401,PADILLA,salud sexual y reproductiva,hemorragia de la primera mitad del embarazo (< 22 sem) aborto,2017-03-01,0,1,1
70502,PAILON,salud sexual y reproductiva,hemorragia de la primera mitad del embarazo (< 22 sem) aborto,2017-03-01,3,0,3
31202,POJO (CBBA),salud sexual y reproductiva,hemorragia de la primera mitad del embarazo (< 22 sem) aborto,2017-03-01,0,1,1
40601,POOPO,salud sexual y reproductiva,hemorragia de la primera mitad del embarazo (< 22 sem) aborto,2017-03-01,2,0,2
50101,POTOSI,salud sexual y reproductiva,hemorragia de la primera mitad del embarazo (< 22 sem) aborto,2017-03-01,44,0,44
10302,PRESTO,salud sexual y reproductiva,hemorragia de la primera mitad del embarazo (< 22 sem) aborto,2017-03-01,0,1,1
90301,PUERTO GONZALO MORENO,salud sexual y reproductiva,hemorragia de la primera mitad del embarazo (< 22 sem) aborto,2017-03-01,1,0,1
90201,PUERTO RICO,salud sexual y reproductiva,hemorragia de la primera mitad del embarazo (< 22 sem) aborto,2017-03-01,0,2,2
71401,PUERTO SUAREZ,salud sexual y reproductiva,hemorragia de la primera mitad del embarazo (< 22 sem) aborto,2017-03-01,9,0,9
31205,PUERTO VILLARROEL,salud sexual y reproductiva,hemorragia de la primera mitad del embarazo (< 22 sem) aborto,2017-03-01,49,0,49
31401,PUNATA,salud sexual y reproductiva,hemorragia de la primera mitad del embarazo (< 22 sem) aborto,2017-03-01,18,0,18
30901,QUILLACOLLO,salud sexual y reproductiva,hemorragia de la primera mitad del embarazo (< 22 sem) aborto,2017-03-01,85,0,85
50402,RAVELO,salud sexual y reproductiva,hemorragia de la primera mitad del embarazo (< 22 sem) aborto,2017-03-01,0,1,1
80301,REYES,salud sexual y reproductiva,hemorragia de la primera mitad del embarazo (< 22 sem) aborto,2017-03-01,5,0,5
80201,RIBERALTA,salud sexual y reproductiva,hemorragia de la primera mitad del embarazo (< 22 sem) aborto,2017-03-01,17,0,17
70503,ROBORE,salud sexual y reproductiva,hemorragia de la primera mitad del embarazo (< 22 sem) aborto,2017-03-01,1,0,1
80304,RURRENABAQUE,salud sexual y reproductiva,hemorragia de la primera mitad del embarazo (< 22 sem) aborto,2017-03-01,10,0,10
31001,SACABA,salud sexual y reproductiva,hemorragia de la primera mitad del embarazo (< 22 sem) aborto,2017-03-01,31,1,32
70901,SAMAIPATA,salud sexual y reproductiva,hemorragia de la primera mitad del embarazo (< 22 sem) aborto,2017-03-01,1,0,1
80302,SAN BORJA,salud sexual y reproductiva,hemorragia de la primera mitad del embarazo (< 22 sem) aborto,2017-03-01,27,0,27
21502,SAN BUENA VENTURA,salud sexual y reproductiva,hemorragia de la primera mitad del embarazo (< 22 sem) aborto,2017-03-01,2,1,3
70402,SAN CARLOS,salud sexual y reproductiva,hemorragia de la primera mitad del embarazo (< 22 sem) aborto,2017-03-01,6,0,6
80501,SAN IGNACIO,salud sexual y reproductiva,hemorragia de la primera mitad del embarazo (< 22 sem) aborto,2017-03-01,1,0,1
70301,SAN IGNACIO DE VELASCO,salud sexual y reproductiva,hemorragia de la primera mitad del embarazo (< 22 sem) aborto,2017-03-01,8,0,8
71102,SAN JAVIER(STC),salud sexual y reproductiva,hemorragia de la primera mitad del embarazo (< 22 sem) aborto,2017-03-01,1,0,1
70501,SAN JOSE DE CHIQUITOS,salud sexual y reproductiva,hemorragia de la primera mitad del embarazo (< 22 sem) aborto,2017-03-01,4,0,4
71104,SAN JULIAN,salud sexual y reproductiva,hemorragia de la primera mitad del embarazo (< 22 sem) aborto,2017-03-01,9,0,9
10702,SAN LUCAS,salud sexual y reproductiva,hemorragia de la primera mitad del embarazo (< 22 sem) aborto,2017-03-01,0,1,1
71201,SAN MATIAS,salud sexual y reproductiva,hemorragia de la primera mitad del embarazo (< 22 sem) aborto,2017-03-01,0,3,3
71103,SAN RAMON SCZ,salud sexual y reproductiva,hemorragia de la primera mitad del embarazo (< 22 sem) aborto,2017-03-01,5,0,5
80401,SANTA ANA,salud sexual y reproductiva,hemorragia de la primera mitad del embarazo (< 22 sem) aborto,2017-03-01,9,0,9
70101,SANTA CRUZ DE LA SIERRA,salud sexual y reproductiva,hemorragia de la primera mitad del embarazo (< 22 sem) aborto,2017-03-01,363,114,477
70602,SANTA ROSA DEL SARA,salud sexual y reproductiva,hemorragia de la primera mitad del embarazo (< 22 sem) aborto,2017-03-01,0,1,1
30702,SANTIVAÃ‘ES,salud sexual y reproductiva,hemorragia de la primera mitad del embarazo (< 22 sem) aborto,2017-03-01,1,0,1
90303,SENA,salud sexual y reproductiva,hemorragia de la primera mitad del embarazo (< 22 sem) aborto,2017-03-01,4,0,4
31602,SHINAOTA,salud sexual y reproductiva,hemorragia de la primera mitad del embarazo (< 22 sem) aborto,2017-03-01,14,0,14
21301,SICA SICA (VILLA AROMA),salud sexual y reproductiva,hemorragia de la primera mitad del embarazo (< 22 sem) aborto,2017-03-01,1,0,1
30902,SIPE SIPE,salud sexual y reproductiva,hemorragia de la primera mitad del embarazo (< 22 sem) aborto,2017-03-01,1,0,1
40104,SORACACHI,salud sexual y reproductiva,hemorragia de la primera mitad del embarazo (< 22 sem) aborto,2017-03-01,0,1,1
10101,SUCRE,salud sexual y reproductiva,hemorragia de la primera mitad del embarazo (< 22 sem) aborto,2017-03-01,135,36,171
50303,TACOBAMBA,salud sexual y reproductiva,hemorragia de la primera mitad del embarazo (< 22 sem) aborto,2017-03-01,1,0,1
31101,TAPACARI,salud sexual y reproductiva,hemorragia de la primera mitad del embarazo (< 22 sem) aborto,2017-03-01,0,1,1
10601,TARABUCO,salud sexual y reproductiva,hemorragia de la primera mitad del embarazo (< 22 sem) aborto,2017-03-01,0,3,3
60101,TARIJA,salud sexual y reproductiva,hemorragia de la primera mitad del embarazo (< 22 sem) aborto,2017-03-01,85,2,87
20608,TEOPONTE,salud sexual y reproductiva,hemorragia de la primera mitad del embarazo (< 22 sem) aborto,2017-03-01,2,0,2
31601,TIRAQUE (CBBA),salud sexual y reproductiva,hemorragia de la primera mitad del embarazo (< 22 sem) aborto,2017-03-01,2,0,2
30802,TOCO,salud sexual y reproductiva,hemorragia de la primera mitad del embarazo (< 22 sem) aborto,2017-03-01,2,0,2
30803,TOLATA,salud sexual y reproductiva,hemorragia de la primera mitad del embarazo (< 22 sem) aborto,2017-03-01,1,0,1
80101,TRINIDAD,salud sexual y reproductiva,hemorragia de la primera mitad del embarazo (< 22 sem) aborto,2017-03-01,43,0,43
50801,TUPIZA,salud sexual y reproductiva,hemorragia de la primera mitad del embarazo (< 22 sem) aborto,2017-03-01,9,0,9
51201,UYUNI,salud sexual y reproductiva,hemorragia de la primera mitad del embarazo (< 22 sem) aborto,2017-03-01,7,0,7
20801,VIACHA,salud sexual y reproductiva,hemorragia de la primera mitad del embarazo (< 22 sem) aborto,2017-03-01,1,1,2
10801,VILLA SERRANO,salud sexual y reproductiva,hemorragia de la primera mitad del embarazo (< 22 sem) aborto,2017-03-01,0,1,1
31003,VILLA TUNARI,salud sexual y reproductiva,hemorragia de la primera mitad del embarazo (< 22 sem) aborto,2017-03-01,28,0,28
51501,VILLAZON,salud sexual y reproductiva,hemorragia de la primera mitad del embarazo (< 22 sem) aborto,2017-03-01,9,0,9
70201,WARNES,salud sexual y reproductiva,hemorragia de la primera mitad del embarazo (< 22 sem) aborto,2017-03-01,8,11,19
60301,YACUIBA,salud sexual y reproductiva,hemorragia de la primera mitad del embarazo (< 22 sem) aborto,2017-03-01,1,5,6
70403,YAPACANI,salud sexual y reproductiva,hemorragia de la primera mitad del embarazo (< 22 sem) aborto,2017-03-01,16,0,16
30201,AIQUILE,salud sexual y reproductiva,hemorragia de la primera mitad del embarazo (< 22 sem) aborto,2017-04-01,4,0,4
30402,ANZALDO,salud sexual y reproductiva,hemorragia de la primera mitad del embarazo (< 22 sem) aborto,2017-04-01,1,0,1
30403,ARBIETO,salud sexual y reproductiva,hemorragia de la primera mitad del embarazo (< 22 sem) aborto,2017-04-01,2,0,2
71501,ASCENCION DE GUARAYOS,salud sexual y reproductiva,hemorragia de la primera mitad del embarazo (< 22 sem) aborto,2017-04-01,5,1,6
60202,BERMEJO,salud sexual y reproductiva,hemorragia de la primera mitad del embarazo (< 22 sem) aborto,2017-04-01,0,2,2
10701,CAMARGO,salud sexual y reproductiva,hemorragia de la primera mitad del embarazo (< 22 sem) aborto,2017-04-01,0,1,1
70706,CAMIRI,salud sexual y reproductiva,hemorragia de la primera mitad del embarazo (< 22 sem) aborto,2017-04-01,7,0,7
30701,CAPINOTA,salud sexual y reproductiva,hemorragia de la primera mitad del embarazo (< 22 sem) aborto,2017-04-01,7,1,8
22001,CARANAVI,salud sexual y reproductiva,hemorragia de la primera mitad del embarazo (< 22 sem) aborto,2017-04-01,14,6,20
70702,CHARAGUA,salud sexual y reproductiva,hemorragia de la primera mitad del embarazo (< 22 sem) aborto,2017-04-01,2,0,2
21101,CHULUMANI (V. DE LA LIBERTAD),salud sexual y reproductiva,hemorragia de la primera mitad del embarazo (< 22 sem) aborto,2017-04-01,1,0,1
30801,CLIZA,salud sexual y reproductiva,hemorragia de la primera mitad del embarazo (< 22 sem) aborto,2017-04-01,10,0,10
90101,COBIJA,salud sexual y reproductiva,hemorragia de la primera mitad del embarazo (< 22 sem) aborto,2017-04-01,28,0,28
30101,COCHABAMBA,salud sexual y reproductiva,hemorragia de la primera mitad del embarazo (< 22 sem) aborto,2017-04-01,207,2,209
71301,COMARAPA,salud sexual y reproductiva,hemorragia de la primera mitad del embarazo (< 22 sem) aborto,2017-04-01,8,0,8
71101,CONCEPCION,salud sexual y reproductiva,hemorragia de la primera mitad del embarazo (< 22 sem) aborto,2017-04-01,1,0,1
21401,COROICO,salud sexual y reproductiva,hemorragia de la primera mitad del embarazo (< 22 sem) aborto,2017-04-01,1,0,1
50601,COTAGAITA,salud sexual y reproductiva,hemorragia de la primera mitad del embarazo (< 22 sem) aborto,2017-04-01,1,0,1
70102,COTOCA,salud sexual y reproductiva,hemorragia de la primera mitad del embarazo (< 22 sem) aborto,2017-04-01,6,0,6
20105,EL ALTO,salud sexual y reproductiva,hemorragia de la primera mitad del embarazo (< 22 sem) aborto,2017-04-01,140,6,146
70105,EL TORNO,salud sexual y reproductiva,hemorragia de la primera mitad del embarazo (< 22 sem) aborto,2017-04-01,10,0,10
31206,ENTRE RIOS CBBA,salud sexual y reproductiva,hemorragia de la primera mitad del embarazo (< 22 sem) aborto,2017-04-01,1,0,1
20405,ESCOMA,salud sexual y reproductiva,hemorragia de la primera mitad del embarazo (< 22 sem) aborto,2017-04-01,0,1,1
20602,GUANAY,salud sexual y reproductiva,hemorragia de la primera mitad del embarazo (< 22 sem) aborto,2017-04-01,1,1,2
20802,GUAQUI,salud sexual y reproductiva,hemorragia de la primera mitad del embarazo (< 22 sem) aborto,2017-04-01,0,1,1
80202,GUAYARAMERIN,salud sexual y reproductiva,hemorragia de la primera mitad del embarazo (< 22 sem) aborto,2017-04-01,0,3,3
40701,HUANUNI,salud sexual y reproductiva,hemorragia de la primera mitad del embarazo (< 22 sem) aborto,2017-04-01,2,0,2
10703,INCAHUASI,salud sexual y reproductiva,hemorragia de la primera mitad del embarazo (< 22 sem) aborto,2017-04-01,0,2,2
20806,JESUS DE MACHACA,salud sexual y reproductiva,hemorragia de la primera mitad del embarazo (< 22 sem) aborto,2017-04-01,0,1,1
20101,LA PAZ,salud sexual y reproductiva,hemorragia de la primera mitad del embarazo (< 22 sem) aborto,2017-04-01,208,4,212
80801,MAGDALENA,salud sexual y reproductiva,hemorragia de la primera mitad del embarazo (< 22 sem) aborto,2017-04-01,1,0,1
70903,MAIRANA,salud sexual y reproductiva,hemorragia de la primera mitad del embarazo (< 22 sem) aborto,2017-04-01,8,0,8
10501,MONTEAGUDO,salud sexual y reproductiva,hemorragia de la primera mitad del embarazo (< 22 sem) aborto,2017-04-01,1,3,4
71001,MONTERO,salud sexual y reproductiva,hemorragia de la primera mitad del embarazo (< 22 sem) aborto,2017-04-01,3,2,5
30302,MOROCHATA,salud sexual y reproductiva,hemorragia de la primera mitad del embarazo (< 22 sem) aborto,2017-04-01,0,1,1
40101,ORURO,salud sexual y reproductiva,hemorragia de la primera mitad del embarazo (< 22 sem) aborto,2017-04-01,7,0,7
70502,PAILON,salud sexual y reproductiva,hemorragia de la primera mitad del embarazo (< 22 sem) aborto,2017-04-01,1,0,1
30202,PASORAPA,salud sexual y reproductiva,hemorragia de la primera mitad del embarazo (< 22 sem) aborto,2017-04-01,0,1,1
31203,POCONA,salud sexual y reproductiva,hemorragia de la primera mitad del embarazo (< 22 sem) aborto,2017-04-01,1,0,1
50101,POTOSI,salud sexual y reproductiva,hemorragia de la primera mitad del embarazo (< 22 sem) aborto,2017-04-01,48,0,48
10302,PRESTO,salud sexual y reproductiva,hemorragia de la primera mitad del embarazo (< 22 sem) aborto,2017-04-01,0,1,1
71401,PUERTO SUAREZ,salud sexual y reproductiva,hemorragia de la primera mitad del embarazo (< 22 sem) aborto,2017-04-01,6,0,6
31205,PUERTO VILLARROEL,salud sexual y reproductiva,hemorragia de la primera mitad del embarazo (< 22 sem) aborto,2017-04-01,42,0,42
31401,PUNATA,salud sexual y reproductiva,hemorragia de la primera mitad del embarazo (< 22 sem) aborto,2017-04-01,8,0,8
30901,QUILLACOLLO,salud sexual y reproductiva,hemorragia de la primera mitad del embarazo (< 22 sem) aborto,2017-04-01,0,77,77
80301,REYES,salud sexual y reproductiva,hemorragia de la primera mitad del embarazo (< 22 sem) aborto,2017-04-01,1,0,1
80201,RIBERALTA,salud sexual y reproductiva,hemorragia de la primera mitad del embarazo (< 22 sem) aborto,2017-04-01,21,0,21
80304,RURRENABAQUE,salud sexual y reproductiva,hemorragia de la primera mitad del embarazo (< 22 sem) aborto,2017-04-01,12,0,12
31001,SACABA,salud sexual y reproductiva,hemorragia de la primera mitad del embarazo (< 22 sem) aborto,2017-04-01,15,9,24
30404,SACABAMBA,salud sexual y reproductiva,hemorragia de la primera mitad del embarazo (< 22 sem) aborto,2017-04-01,0,1,1
71105,SAN ANTONIO DE LOMERIO,salud sexual y reproductiva,hemorragia de la primera mitad del embarazo (< 22 sem) aborto,2017-04-01,1,0,1
31403,SAN BENITO,salud sexual y reproductiva,hemorragia de la primera mitad del embarazo (< 22 sem) aborto,2017-04-01,1,0,1
80302,SAN BORJA,salud sexual y reproductiva,hemorragia de la primera mitad del embarazo (< 22 sem) aborto,2017-04-01,16,0,16
21502,SAN BUENA VENTURA,salud sexual y reproductiva,hemorragia de la primera mitad del embarazo (< 22 sem) aborto,2017-04-01,3,0,3
70402,SAN CARLOS,salud sexual y reproductiva,hemorragia de la primera mitad del embarazo (< 22 sem) aborto,2017-04-01,6,2,8
70301,SAN IGNACIO DE VELASCO,salud sexual y reproductiva,hemorragia de la primera mitad del embarazo (< 22 sem) aborto,2017-04-01,5,0,5
70501,SAN JOSE DE CHIQUITOS,salud sexual y reproductiva,hemorragia de la primera mitad del embarazo (< 22 sem) aborto,2017-04-01,6,0,6
71104,SAN JULIAN,salud sexual y reproductiva,hemorragia de la primera mitad del embarazo (< 22 sem) aborto,2017-04-01,8,0,8
60501,SAN LORENZO(TJA),salud sexual y reproductiva,hemorragia de la primera mitad del embarazo (< 22 sem) aborto,2017-04-01,1,0,1
10702,SAN LUCAS,salud sexual y reproductiva,hemorragia de la primera mitad del embarazo (< 22 sem) aborto,2017-04-01,0,2,2
71201,SAN MATIAS,salud sexual y reproductiva,hemorragia de la primera mitad del embarazo (< 22 sem) aborto,2017-04-01,0,5,5
70302,SAN MIGUEL DE VELASCO,salud sexual y reproductiva,hemorragia de la primera mitad del embarazo (< 22 sem) aborto,2017-04-01,1,0,1
71103,SAN RAMON SCZ,salud sexual y reproductiva,hemorragia de la primera mitad del embarazo (< 22 sem) aborto,2017-04-01,3,0,3
80401,SANTA ANA,salud sexual y reproductiva,hemorragia de la primera mitad del embarazo (< 22 sem) aborto,2017-04-01,6,2,8
70101,SANTA CRUZ DE LA SIERRA,salud sexual y reproductiva,hemorragia de la primera mitad del embarazo (< 22 sem) aborto,2017-04-01,268,87,355
90303,SENA,salud sexual y reproductiva,hemorragia de la primera mitad del embarazo (< 22 sem) aborto,2017-04-01,3,0,3
31602,SHINAOTA,salud sexual y reproductiva,hemorragia de la primera mitad del embarazo (< 22 sem) aborto,2017-04-01,21,0,21
21301,SICA SICA (VILLA AROMA),salud sexual y reproductiva,hemorragia de la primera mitad del embarazo (< 22 sem) aborto,2017-04-01,1,0,1
30902,SIPE SIPE,salud sexual y reproductiva,hemorragia de la primera mitad del embarazo (< 22 sem) aborto,2017-04-01,2,0,2
10101,SUCRE,salud sexual y reproductiva,hemorragia de la primera mitad del embarazo (< 22 sem) aborto,2017-04-01,96,26,122
60101,TARIJA,salud sexual y reproductiva,hemorragia de la primera mitad del embarazo (< 22 sem) aborto,2017-04-01,57,0,57
10202,TARVITA,salud sexual y reproductiva,hemorragia de la primera mitad del embarazo (< 22 sem) aborto,2017-04-01,1,1,2
20608,TEOPONTE,salud sexual y reproductiva,hemorragia de la primera mitad del embarazo (< 22 sem) aborto,2017-04-01,0,2,2
20606,TIPUANI,salud sexual y reproductiva,hemorragia de la primera mitad del embarazo (< 22 sem) aborto,2017-04-01,1,0,1
30903,TIQUIPAYA,salud sexual y reproductiva,hemorragia de la primera mitad del embarazo (< 22 sem) aborto,2017-04-01,3,0,3
30802,TOCO,salud sexual y reproductiva,hemorragia de la primera mitad del embarazo (< 22 sem) aborto,2017-04-01,2,0,2
10402,TOMINA,salud sexual y reproductiva,hemorragia de la primera mitad del embarazo (< 22 sem) aborto,2017-04-01,1,0,1
41301,TOTORA(ORR),salud sexual y reproductiva,hemorragia de la primera mitad del embarazo (< 22 sem) aborto,2017-04-01,1,0,1
80101,TRINIDAD,salud sexual y reproductiva,hemorragia de la primera mitad del embarazo (< 22 sem) aborto,2017-04-01,31,1,32
50801,TUPIZA,salud sexual y reproductiva,hemorragia de la primera mitad del embarazo (< 22 sem) aborto,2017-04-01,3,0,3
51201,UYUNI,salud sexual y reproductiva,hemorragia de la primera mitad del embarazo (< 22 sem) aborto,2017-04-01,13,1,14
10801,VILLA SERRANO,salud sexual y reproductiva,hemorragia de la primera mitad del embarazo (< 22 sem) aborto,2017-04-01,0,2,2
31003,VILLA TUNARI,salud sexual y reproductiva,hemorragia de la primera mitad del embarazo (< 22 sem) aborto,2017-04-01,14,6,20
11001,VILLA VACA GUZMAN (MUYUPAMPA),salud sexual y reproductiva,hemorragia de la primera mitad del embarazo (< 22 sem) aborto,2017-04-01,1,0,1
51501,VILLAZON,salud sexual y reproductiva,hemorragia de la primera mitad del embarazo (< 22 sem) aborto,2017-04-01,16,0,16
70201,WARNES,salud sexual y reproductiva,hemorragia de la primera mitad del embarazo (< 22 sem) aborto,2017-04-01,31,0,31
60301,YACUIBA,salud sexual y reproductiva,hemorragia de la primera mitad del embarazo (< 22 sem) aborto,2017-04-01,1,0,1
70403,YAPACANI,salud sexual y reproductiva,hemorragia de la primera mitad del embarazo (< 22 sem) aborto,2017-04-01,18,0,18
30201,AIQUILE,salud sexual y reproductiva,hemorragia de la primera mitad del embarazo (< 22 sem) aborto,2017-05-01,6,0,6
30403,ARBIETO,salud sexual y reproductiva,hemorragia de la primera mitad del embarazo (< 22 sem) aborto,2017-05-01,2,0,2
71501,ASCENCION DE GUARAYOS,salud sexual y reproductiva,hemorragia de la primera mitad del embarazo (< 22 sem) aborto,2017-05-01,2,2,4
60202,BERMEJO,salud sexual y reproductiva,hemorragia de la primera mitad del embarazo (< 22 sem) aborto,2017-05-01,0,3,3
50301,BETANZOS,salud sexual y reproductiva,hemorragia de la primera mitad del embarazo (< 22 sem) aborto,2017-05-01,3,0,3
10701,CAMARGO,salud sexual y reproductiva,hemorragia de la primera mitad del embarazo (< 22 sem) aborto,2017-05-01,4,2,6
70706,CAMIRI,salud sexual y reproductiva,hemorragia de la primera mitad del embarazo (< 22 sem) aborto,2017-05-01,17,0,17
30701,CAPINOTA,salud sexual y reproductiva,hemorragia de la primera mitad del embarazo (< 22 sem) aborto,2017-05-01,5,0,5
22001,CARANAVI,salud sexual y reproductiva,hemorragia de la primera mitad del embarazo (< 22 sem) aborto,2017-05-01,44,0,44
40201,CHALLAPATA,salud sexual y reproductiva,hemorragia de la primera mitad del embarazo (< 22 sem) aborto,2017-05-01,1,1,2
70702,CHARAGUA,salud sexual y reproductiva,hemorragia de la primera mitad del embarazo (< 22 sem) aborto,2017-05-01,1,0,1
40903,CHIPAYA,salud sexual y reproductiva,hemorragia de la primera mitad del embarazo (< 22 sem) aborto,2017-05-01,0,1,1
21101,CHULUMANI (V. DE LA LIBERTAD),salud sexual y reproductiva,hemorragia de la primera mitad del embarazo (< 22 sem) aborto,2017-05-01,7,0,7
51103,CKOCHAS,salud sexual y reproductiva,hemorragia de la primera mitad del embarazo (< 22 sem) aborto,2017-05-01,1,0,1
30801,CLIZA,salud sexual y reproductiva,hemorragia de la primera mitad del embarazo (< 22 sem) aborto,2017-05-01,19,0,19
90101,COBIJA,salud sexual y reproductiva,hemorragia de la primera mitad del embarazo (< 22 sem) aborto,2017-05-01,30,0,30
30101,COCHABAMBA,salud sexual y reproductiva,hemorragia de la primera mitad del embarazo (< 22 sem) aborto,2017-05-01,211,5,216
30905,COLCAPIRHUA,salud sexual y reproductiva,hemorragia de la primera mitad del embarazo (< 22 sem) aborto,2017-05-01,4,2,6
50401,COLQUECHACA,salud sexual y reproductiva,hemorragia de la primera mitad del embarazo (< 22 sem) aborto,2017-05-01,0,1,1
71301,COMARAPA,salud sexual y reproductiva,hemorragia de la primera mitad del embarazo (< 22 sem) aborto,2017-05-01,4,0,4
71101,CONCEPCION,salud sexual y reproductiva,hemorragia de la primera mitad del embarazo (< 22 sem) aborto,2017-05-01,1,0,1
21402,CORIPATA,salud sexual y reproductiva,hemorragia de la primera mitad del embarazo (< 22 sem) aborto,2017-05-01,4,0,4
21401,COROICO,salud sexual y reproductiva,hemorragia de la primera mitad del embarazo (< 22 sem) aborto,2017-05-01,2,0,2
40301,CORQUE,salud sexual y reproductiva,hemorragia de la primera mitad del embarazo (< 22 sem) aborto,2017-05-01,1,0,1
70102,COTOCA,salud sexual y reproductiva,hemorragia de la primera mitad del embarazo (< 22 sem) aborto,2017-05-01,13,1,14
71106,CUATRO CAÃ‘ADAS,salud sexual y reproductiva,hemorragia de la primera mitad del embarazo (< 22 sem) aborto,2017-05-01,3,1,4
20105,EL ALTO,salud sexual y reproductiva,hemorragia de la primera mitad del embarazo (< 22 sem) aborto,2017-05-01,138,4,142
60502,EL PUENTE(TJA),salud sexual y reproductiva,hemorragia de la primera mitad del embarazo (< 22 sem) aborto,2017-05-01,0,1,1
70105,EL TORNO,salud sexual y reproductiva,hemorragia de la primera mitad del embarazo (< 22 sem) aborto,2017-05-01,21,0,21
31206,ENTRE RIOS CBBA,salud sexual y reproductiva,hemorragia de la primera mitad del embarazo (< 22 sem) aborto,2017-05-01,2,1,3
20405,ESCOMA,salud sexual y reproductiva,hemorragia de la primera mitad del embarazo (< 22 sem) aborto,2017-05-01,0,2,2
71004,FERNANDEZ ALONSO,salud sexual y reproductiva,hemorragia de la primera mitad del embarazo (< 22 sem) aborto,2017-05-01,0,1,1
80202,GUAYARAMERIN,salud sexual y reproductiva,hemorragia de la primera mitad del embarazo (< 22 sem) aborto,2017-05-01,2,2,4
40701,HUANUNI,salud sexual y reproductiva,hemorragia de la primera mitad del embarazo (< 22 sem) aborto,2017-05-01,1,0,1
21105,LA ASUNTA,salud sexual y reproductiva,hemorragia de la primera mitad del embarazo (< 22 sem) aborto,2017-05-01,0,1,1
70104,LA GUARDIA,salud sexual y reproductiva,hemorragia de la primera mitad del embarazo (< 22 sem) aborto,2017-05-01,0,1,1
20101,LA PAZ,salud sexual y reproductiva,hemorragia de la primera mitad del embarazo (< 22 sem) aborto,2017-05-01,244,0,244
21202,LAJA,salud sexual y reproductiva,hemorragia de la primera mitad del embarazo (< 22 sem) aborto,2017-05-01,0,1,1
11003,MACHARETI,salud sexual y reproductiva,hemorragia de la primera mitad del embarazo (< 22 sem) aborto,2017-05-01,1,0,1
80801,MAGDALENA,salud sexual y reproductiva,hemorragia de la primera mitad del embarazo (< 22 sem) aborto,2017-05-01,0,1,1
70903,MAIRANA,salud sexual y reproductiva,hemorragia de la primera mitad del embarazo (< 22 sem) aborto,2017-05-01,3,0,3
31301,MIZQUE,salud sexual y reproductiva,hemorragia de la primera mitad del embarazo (< 22 sem) aborto,2017-05-01,3,0,3
10501,MONTEAGUDO,salud sexual y reproductiva,hemorragia de la primera mitad del embarazo (< 22 sem) aborto,2017-05-01,5,3,8
71001,MONTERO,salud sexual y reproductiva,hemorragia de la primera mitad del embarazo (< 22 sem) aborto,2017-05-01,5,1,6
40101,ORURO,salud sexual y reproductiva,hemorragia de la primera mitad del embarazo (< 22 sem) aborto,2017-05-01,12,0,12
70502,PAILON,salud sexual y reproductiva,hemorragia de la primera mitad del embarazo (< 22 sem) aborto,2017-05-01,2,0,2
21104,PALOS BLANCOS,salud sexual y reproductiva,hemorragia de la primera mitad del embarazo (< 22 sem) aborto,2017-05-01,7,0,7
40602,PAZÃ‘A,salud sexual y reproductiva,hemorragia de la primera mitad del embarazo (< 22 sem) aborto,2017-05-01,1,0,1
50403,POCOATA,salud sexual y reproductiva,hemorragia de la primera mitad del embarazo (< 22 sem) aborto,2017-05-01,1,0,1
31203,POCONA,salud sexual y reproductiva,hemorragia de la primera mitad del embarazo (< 22 sem) aborto,2017-05-01,1,0,1
40601,POOPO,salud sexual y reproductiva,hemorragia de la primera mitad del embarazo (< 22 sem) aborto,2017-05-01,1,0,1
50101,POTOSI,salud sexual y reproductiva,hemorragia de la primera mitad del embarazo (< 22 sem) aborto,2017-05-01,38,4,42
21201,PUCARANI,salud sexual y reproductiva,hemorragia de la primera mitad del embarazo (< 22 sem) aborto,2017-05-01,1,0,1
90201,PUERTO RICO,salud sexual y reproductiva,hemorragia de la primera mitad del embarazo (< 22 sem) aborto,2017-05-01,0,1,1
71401,PUERTO SUAREZ,salud sexual y reproductiva,hemorragia de la primera mitad del embarazo (< 22 sem) aborto,2017-05-01,9,0,9
31205,PUERTO VILLARROEL,salud sexual y reproductiva,hemorragia de la primera mitad del embarazo (< 22 sem) aborto,2017-05-01,41,0,41
31401,PUNATA,salud sexual y reproductiva,hemorragia de la primera mitad del embarazo (< 22 sem) aborto,2017-05-01,11,0,11
30901,QUILLACOLLO,salud sexual y reproductiva,hemorragia de la primera mitad del embarazo (< 22 sem) aborto,2017-05-01,62,0,62
80301,REYES,salud sexual y reproductiva,hemorragia de la primera mitad del embarazo (< 22 sem) aborto,2017-05-01,2,0,2
80201,RIBERALTA,salud sexual y reproductiva,hemorragia de la primera mitad del embarazo (< 22 sem) aborto,2017-05-01,15,6,21
70503,ROBORE,salud sexual y reproductiva,hemorragia de la primera mitad del embarazo (< 22 sem) aborto,2017-05-01,4,0,4
80304,RURRENABAQUE,salud sexual y reproductiva,hemorragia de la primera mitad del embarazo (< 22 sem) aborto,2017-05-01,13,0,13
31001,SACABA,salud sexual y reproductiva,hemorragia de la primera mitad del embarazo (< 22 sem) aborto,2017-05-01,55,1,56
30404,SACABAMBA,salud sexual y reproductiva,hemorragia de la primera mitad del embarazo (< 22 sem) aborto,2017-05-01,1,0,1
80302,SAN BORJA,salud sexual y reproductiva,hemorragia de la primera mitad del embarazo (< 22 sem) aborto,2017-05-01,13,0,13
21502,SAN BUENA VENTURA,salud sexual y reproductiva,hemorragia de la primera mitad del embarazo (< 22 sem) aborto,2017-05-01,6,0,6
70402,SAN CARLOS,salud sexual y reproductiva,hemorragia de la primera mitad del embarazo (< 22 sem) aborto,2017-05-01,3,0,3
80501,SAN IGNACIO,salud sexual y reproductiva,hemorragia de la primera mitad del embarazo (< 22 sem) aborto,2017-05-01,4,0,4
70301,SAN IGNACIO DE VELASCO,salud sexual y reproductiva,hemorragia de la primera mitad del embarazo (< 22 sem) aborto,2017-05-01,4,0,4
80102,SAN JAVIER(BNI),salud sexual y reproductiva,hemorragia de la primera mitad del embarazo (< 22 sem) aborto,2017-05-01,1,0,1
71102,SAN JAVIER(STC),salud sexual y reproductiva,hemorragia de la primera mitad del embarazo (< 22 sem) aborto,2017-05-01,1,0,1
70501,SAN JOSE DE CHIQUITOS,salud sexual y reproductiva,hemorragia de la primera mitad del embarazo (< 22 sem) aborto,2017-05-01,3,0,3
71104,SAN JULIAN,salud sexual y reproductiva,hemorragia de la primera mitad del embarazo (< 22 sem) aborto,2017-05-01,9,0,9
10702,SAN LUCAS,salud sexual y reproductiva,hemorragia de la primera mitad del embarazo (< 22 sem) aborto,2017-05-01,1,0,1
70302,SAN MIGUEL DE VELASCO,salud sexual y reproductiva,hemorragia de la primera mitad del embarazo (< 22 sem) aborto,2017-05-01,0,1,1
21801,SAN PEDRO DE CURAHUARA,salud sexual y reproductiva,hemorragia de la primera mitad del embarazo (< 22 sem) aborto,2017-05-01,1,1,2
71103,SAN RAMON SCZ,salud sexual y reproductiva,hemorragia de la primera mitad del embarazo (< 22 sem) aborto,2017-05-01,4,0,4
80401,SANTA ANA,salud sexual y reproductiva,hemorragia de la primera mitad del embarazo (< 22 sem) aborto,2017-05-01,5,0,5
70101,SANTA CRUZ DE LA SIERRA,salud sexual y reproductiva,hemorragia de la primera mitad del embarazo (< 22 sem) aborto,2017-05-01,393,112,505
20902,SAPAHAQUI,salud sexual y reproductiva,hemorragia de la primera mitad del embarazo (< 22 sem) aborto,2017-05-01,1,0,1
31602,SHINAOTA,salud sexual y reproductiva,hemorragia de la primera mitad del embarazo (< 22 sem) aborto,2017-05-01,19,0,19
21301,SICA SICA (VILLA AROMA),salud sexual y reproductiva,hemorragia de la primera mitad del embarazo (< 22 sem) aborto,2017-05-01,1,1,2
30703,SICAYA,salud sexual y reproductiva,hemorragia de la primera mitad del embarazo (< 22 sem) aborto,2017-05-01,1,0,1
30902,SIPE SIPE,salud sexual y reproductiva,hemorragia de la primera mitad del embarazo (< 22 sem) aborto,2017-05-01,4,0,4
10403,SOPACHUY,salud sexual y reproductiva,hemorragia de la primera mitad del embarazo (< 22 sem) aborto,2017-05-01,1,1,2
10101,SUCRE,salud sexual y reproductiva,hemorragia de la primera mitad del embarazo (< 22 sem) aborto,2017-05-01,129,78,207
31404,TACACHI,salud sexual y reproductiva,hemorragia de la primera mitad del embarazo (< 22 sem) aborto,2017-05-01,1,0,1
30401,TARATA,salud sexual y reproductiva,hemorragia de la primera mitad del embarazo (< 22 sem) aborto,2017-05-01,0,1,1
60101,TARIJA,salud sexual y reproductiva,hemorragia de la primera mitad del embarazo (< 22 sem) aborto,2017-05-01,83,0,83
10202,TARVITA,salud sexual y reproductiva,hemorragia de la primera mitad del embarazo (< 22 sem) aborto,2017-05-01,0,2,2
20606,TIPUANI,salud sexual y reproductiva,hemorragia de la primera mitad del embarazo (< 22 sem) aborto,2017-05-01,1,0,1
80101,TRINIDAD,salud sexual y reproductiva,hemorragia de la primera mitad del embarazo (< 22 sem) aborto,2017-05-01,66,0,66
50801,TUPIZA,salud sexual y reproductiva,hemorragia de la primera mitad del embarazo (< 22 sem) aborto,2017-05-01,2,0,2
51201,UYUNI,salud sexual y reproductiva,hemorragia de la primera mitad del embarazo (< 22 sem) aborto,2017-05-01,6,6,12
30502,VACAS,salud sexual y reproductiva,hemorragia de la primera mitad del embarazo (< 22 sem) aborto,2017-05-01,1,0,1
20801,VIACHA,salud sexual y reproductiva,hemorragia de la primera mitad del embarazo (< 22 sem) aborto,2017-05-01,3,2,5
10704,VILLA CHARCAS,salud sexual y reproductiva,hemorragia de la primera mitad del embarazo (< 22 sem) aborto,2017-05-01,0,1,1
31402,VILLA RIVERO,salud sexual y reproductiva,hemorragia de la primera mitad del embarazo (< 22 sem) aborto,2017-05-01,1,0,1
10801,VILLA SERRANO,salud sexual y reproductiva,hemorragia de la primera mitad del embarazo (< 22 sem) aborto,2017-05-01,0,3,3
31003,VILLA TUNARI,salud sexual y reproductiva,hemorragia de la primera mitad del embarazo (< 22 sem) aborto,2017-05-01,17,0,17
51501,VILLAZON,salud sexual y reproductiva,hemorragia de la primera mitad del embarazo (< 22 sem) aborto,2017-05-01,18,1,19
30904,VINTO,salud sexual y reproductiva,hemorragia de la primera mitad del embarazo (< 22 sem) aborto,2017-05-01,5,0,5
70201,WARNES,salud sexual y reproductiva,hemorragia de la primera mitad del embarazo (< 22 sem) aborto,2017-05-01,30,6,36
60301,YACUIBA,salud sexual y reproductiva,hemorragia de la primera mitad del embarazo (< 22 sem) aborto,2017-05-01,1,4,5
70403,YAPACANI,salud sexual y reproductiva,hemorragia de la primera mitad del embarazo (< 22 sem) aborto,2017-05-01,11,1,12
20104,ACHOCALLA,salud sexual y reproductiva,hemorragia de la primera mitad del embarazo (< 22 sem) aborto,2017-06-01,1,0,1
30201,AIQUILE,salud sexual y reproductiva,hemorragia de la primera mitad del embarazo (< 22 sem) aborto,2017-06-01,4,0,4
20202,ANCORAIMES,salud sexual y reproductiva,hemorragia de la primera mitad del embarazo (< 22 sem) aborto,2017-06-01,0,1,1
30402,ANZALDO,salud sexual y reproductiva,hemorragia de la primera mitad del embarazo (< 22 sem) aborto,2017-06-01,1,0,1
30403,ARBIETO,salud sexual y reproductiva,hemorragia de la primera mitad del embarazo (< 22 sem) aborto,2017-06-01,3,0,3
71501,ASCENCION DE GUARAYOS,salud sexual y reproductiva,hemorragia de la primera mitad del embarazo (< 22 sem) aborto,2017-06-01,8,5,13
50301,BETANZOS,salud sexual y reproductiva,hemorragia de la primera mitad del embarazo (< 22 sem) aborto,2017-06-01,5,0,5
10701,CAMARGO,salud sexual y reproductiva,hemorragia de la primera mitad del embarazo (< 22 sem) aborto,2017-06-01,2,3,5
70706,CAMIRI,salud sexual y reproductiva,hemorragia de la primera mitad del embarazo (< 22 sem) aborto,2017-06-01,12,0,12
30701,CAPINOTA,salud sexual y reproductiva,hemorragia de la primera mitad del embarazo (< 22 sem) aborto,2017-06-01,5,0,5
22001,CARANAVI,salud sexual y reproductiva,hemorragia de la primera mitad del embarazo (< 22 sem) aborto,2017-06-01,18,0,18
21803,CHACARILLA,salud sexual y reproductiva,hemorragia de la primera mitad del embarazo (< 22 sem) aborto,2017-06-01,0,1,1
70702,CHARAGUA,salud sexual y reproductiva,hemorragia de la primera mitad del embarazo (< 22 sem) aborto,2017-06-01,3,0,3
21101,CHULUMANI (V. DE LA LIBERTAD),salud sexual y reproductiva,hemorragia de la primera mitad del embarazo (< 22 sem) aborto,2017-06-01,5,0,5
30801,CLIZA,salud sexual y reproductiva,hemorragia de la primera mitad del embarazo (< 22 sem) aborto,2017-06-01,6,0,6
90101,COBIJA,salud sexual y reproductiva,hemorragia de la primera mitad del embarazo (< 22 sem) aborto,2017-06-01,15,2,17
30101,COCHABAMBA,salud sexual y reproductiva,hemorragia de la primera mitad del embarazo (< 22 sem) aborto,2017-06-01,175,3,178
30905,COLCAPIRHUA,salud sexual y reproductiva,hemorragia de la primera mitad del embarazo (< 22 sem) aborto,2017-06-01,4,0,4
50401,COLQUECHACA,salud sexual y reproductiva,hemorragia de la primera mitad del embarazo (< 22 sem) aborto,2017-06-01,1,0,1
71301,COMARAPA,salud sexual y reproductiva,hemorragia de la primera mitad del embarazo (< 22 sem) aborto,2017-06-01,4,0,4
71101,CONCEPCION,salud sexual y reproductiva,hemorragia de la primera mitad del embarazo (< 22 sem) aborto,2017-06-01,4,0,4
21401,COROICO,salud sexual y reproductiva,hemorragia de la primera mitad del embarazo (< 22 sem) aborto,2017-06-01,1,0,1
50601,COTAGAITA,salud sexual y reproductiva,hemorragia de la primera mitad del embarazo (< 22 sem) aborto,2017-06-01,0,2,2
70102,COTOCA,salud sexual y reproductiva,hemorragia de la primera mitad del embarazo (< 22 sem) aborto,2017-06-01,1,4,5
71106,CUATRO CAÃ‘ADAS,salud sexual y reproductiva,hemorragia de la primera mitad del embarazo (< 22 sem) aborto,2017-06-01,0,1,1
10902,CULPINA,salud sexual y reproductiva,hemorragia de la primera mitad del embarazo (< 22 sem) aborto,2017-06-01,1,0,1
20105,EL ALTO,salud sexual y reproductiva,hemorragia de la primera mitad del embarazo (< 22 sem) aborto,2017-06-01,122,2,124
71503,EL PUENTE(STC),salud sexual y reproductiva,hemorragia de la primera mitad del embarazo (< 22 sem) aborto,2017-06-01,0,2,2
70105,EL TORNO,salud sexual y reproductiva,hemorragia de la primera mitad del embarazo (< 22 sem) aborto,2017-06-01,17,0,17
71004,FERNANDEZ ALONSO,salud sexual y reproductiva,hemorragia de la primera mitad del embarazo (< 22 sem) aborto,2017-06-01,0,1,1
20602,GUANAY,salud sexual y reproductiva,hemorragia de la primera mitad del embarazo (< 22 sem) aborto,2017-06-01,0,1,1
40701,HUANUNI,salud sexual y reproductiva,hemorragia de la primera mitad del embarazo (< 22 sem) aborto,2017-06-01,7,0,7
20204,HUARINA,salud sexual y reproductiva,hemorragia de la primera mitad del embarazo (< 22 sem) aborto,2017-06-01,1,0,1
20806,JESUS DE MACHACA,salud sexual y reproductiva,hemorragia de la primera mitad del embarazo (< 22 sem) aborto,2017-06-01,0,1,1
70104,LA GUARDIA,salud sexual y reproductiva,hemorragia de la primera mitad del embarazo (< 22 sem) aborto,2017-06-01,1,6,7
20101,LA PAZ,salud sexual y reproductiva,hemorragia de la primera mitad del embarazo (< 22 sem) aborto,2017-06-01,193,0,193
11003,MACHARETI,salud sexual y reproductiva,hemorragia de la primera mitad del embarazo (< 22 sem) aborto,2017-06-01,1,0,1
70903,MAIRANA,salud sexual y reproductiva,hemorragia de la primera mitad del embarazo (< 22 sem) aborto,2017-06-01,1,0,1
10501,MONTEAGUDO,salud sexual y reproductiva,hemorragia de la primera mitad del embarazo (< 22 sem) aborto,2017-06-01,0,9,9
30203,OMEREQUE,salud sexual y reproductiva,hemorragia de la primera mitad del embarazo (< 22 sem) aborto,2017-06-01,0,1,1
40101,ORURO,salud sexual y reproductiva,hemorragia de la primera mitad del embarazo (< 22 sem) aborto,2017-06-01,11,0,11
60201,PADCAYA,salud sexual y reproductiva,hemorragia de la primera mitad del embarazo (< 22 sem) aborto,2017-06-01,0,2,2
70502,PAILON,salud sexual y reproductiva,hemorragia de la primera mitad del embarazo (< 22 sem) aborto,2017-06-01,3,0,3
21104,PALOS BLANCOS,salud sexual y reproductiva,hemorragia de la primera mitad del embarazo (< 22 sem) aborto,2017-06-01,2,0,2
31203,POCONA,salud sexual y reproductiva,hemorragia de la primera mitad del embarazo (< 22 sem) aborto,2017-06-01,3,0,3
50101,POTOSI,salud sexual y reproductiva,hemorragia de la primera mitad del embarazo (< 22 sem) aborto,2017-06-01,25,0,25
10302,PRESTO,salud sexual y reproductiva,hemorragia de la primera mitad del embarazo (< 22 sem) aborto,2017-06-01,0,1,1
90201,PUERTO RICO,salud sexual y reproductiva,hemorragia de la primera mitad del embarazo (< 22 sem) aborto,2017-06-01,1,0,1
71401,PUERTO SUAREZ,salud sexual y reproductiva,hemorragia de la primera mitad del embarazo (< 22 sem) aborto,2017-06-01,4,0,4
31205,PUERTO VILLARROEL,salud sexual y reproductiva,hemorragia de la primera mitad del embarazo (< 22 sem) aborto,2017-06-01,26,0,26
51101,PUNA,salud sexual y reproductiva,hemorragia de la primera mitad del embarazo (< 22 sem) aborto,2017-06-01,1,0,1
31401,PUNATA,salud sexual y reproductiva,hemorragia de la primera mitad del embarazo (< 22 sem) aborto,2017-06-01,14,0,14
21002,QUIME,salud sexual y reproductiva,hemorragia de la primera mitad del embarazo (< 22 sem) aborto,2017-06-01,2,0,2
80301,REYES,salud sexual y reproductiva,hemorragia de la primera mitad del embarazo (< 22 sem) aborto,2017-06-01,1,0,1
80201,RIBERALTA,salud sexual y reproductiva,hemorragia de la primera mitad del embarazo (< 22 sem) aborto,2017-06-01,20,0,20
70503,ROBORE,salud sexual y reproductiva,hemorragia de la primera mitad del embarazo (< 22 sem) aborto,2017-06-01,4,0,4
80304,RURRENABAQUE,salud sexual y reproductiva,hemorragia de la primera mitad del embarazo (< 22 sem) aborto,2017-06-01,6,0,6
31001,SACABA,salud sexual y reproductiva,hemorragia de la primera mitad del embarazo (< 22 sem) aborto,2017-06-01,27,4,31
30404,SACABAMBA,salud sexual y reproductiva,hemorragia de la primera mitad del embarazo (< 22 sem) aborto,2017-06-01,1,0,1
80302,SAN BORJA,salud sexual y reproductiva,hemorragia de la primera mitad del embarazo (< 22 sem) aborto,2017-06-01,15,0,15
21502,SAN BUENA VENTURA,salud sexual y reproductiva,hemorragia de la primera mitad del embarazo (< 22 sem) aborto,2017-06-01,2,0,2
70402,SAN CARLOS,salud sexual y reproductiva,hemorragia de la primera mitad del embarazo (< 22 sem) aborto,2017-06-01,4,6,10
80501,SAN IGNACIO,salud sexual y reproductiva,hemorragia de la primera mitad del embarazo (< 22 sem) aborto,2017-06-01,3,0,3
70301,SAN IGNACIO DE VELASCO,salud sexual y reproductiva,hemorragia de la primera mitad del embarazo (< 22 sem) aborto,2017-06-01,5,0,5
70501,SAN JOSE DE CHIQUITOS,salud sexual y reproductiva,hemorragia de la primera mitad del embarazo (< 22 sem) aborto,2017-06-01,3,0,3
71104,SAN JULIAN,salud sexual y reproductiva,hemorragia de la primera mitad del embarazo (< 22 sem) aborto,2017-06-01,9,0,9
10702,SAN LUCAS,salud sexual y reproductiva,hemorragia de la primera mitad del embarazo (< 22 sem) aborto,2017-06-01,4,3,7
71201,SAN MATIAS,salud sexual y reproductiva,hemorragia de la primera mitad del embarazo (< 22 sem) aborto,2017-06-01,0,5,5
50501,SAN PEDRO DE BUENA VISTA,salud sexual y reproductiva,hemorragia de la primera mitad del embarazo (< 22 sem) aborto,2017-06-01,1,0,1
21702,SAN PEDRO DE TIQUINA,salud sexual y reproductiva,hemorragia de la primera mitad del embarazo (< 22 sem) aborto,2017-06-01,1,0,1
71103,SAN RAMON SCZ,salud sexual y reproductiva,hemorragia de la primera mitad del embarazo (< 22 sem) aborto,2017-06-01,2,1,3
80401,SANTA ANA,salud sexual y reproductiva,hemorragia de la primera mitad del embarazo (< 22 sem) aborto,2017-06-01,10,0,10
70101,SANTA CRUZ DE LA SIERRA,salud sexual y reproductiva,hemorragia de la primera mitad del embarazo (< 22 sem) aborto,2017-06-01,296,111,407
20902,SAPAHAQUI,salud sexual y reproductiva,hemorragia de la primera mitad del embarazo (< 22 sem) aborto,2017-06-01,1,0,1
31602,SHINAOTA,salud sexual y reproductiva,hemorragia de la primera mitad del embarazo (< 22 sem) aborto,2017-06-01,20,0,20
21301,SICA SICA (VILLA AROMA),salud sexual y reproductiva,hemorragia de la primera mitad del embarazo (< 22 sem) aborto,2017-06-01,1,1,2
30902,SIPE SIPE,salud sexual y reproductiva,hemorragia de la primera mitad del embarazo (< 22 sem) aborto,2017-06-01,1,0,1
10403,SOPACHUY,salud sexual y reproductiva,hemorragia de la primera mitad del embarazo (< 22 sem) aborto,2017-06-01,0,1,1
40104,SORACACHI,salud sexual y reproductiva,hemorragia de la primera mitad del embarazo (< 22 sem) aborto,2017-06-01,1,0,1
10101,SUCRE,salud sexual y reproductiva,hemorragia de la primera mitad del embarazo (< 22 sem) aborto,2017-06-01,74,38,112
60101,TARIJA,salud sexual y reproductiva,hemorragia de la primera mitad del embarazo (< 22 sem) aborto,2017-06-01,60,0,60
10202,TARVITA,salud sexual y reproductiva,hemorragia de la primera mitad del embarazo (< 22 sem) aborto,2017-06-01,0,3,3
20803,TIAWANACU,salud sexual y reproductiva,hemorragia de la primera mitad del embarazo (< 22 sem) aborto,2017-06-01,1,0,1
10402,TOMINA,salud sexual y reproductiva,hemorragia de la primera mitad del embarazo (< 22 sem) aborto,2017-06-01,1,0,1
31201,TOTORA(CBBA),salud sexual y reproductiva,hemorragia de la primera mitad del embarazo (< 22 sem) aborto,2017-06-01,2,0,2
80101,TRINIDAD,salud sexual y reproductiva,hemorragia de la primera mitad del embarazo (< 22 sem) aborto,2017-06-01,46,1,47
50801,TUPIZA,salud sexual y reproductiva,hemorragia de la primera mitad del embarazo (< 22 sem) aborto,2017-06-01,8,0,8
51201,UYUNI,salud sexual y reproductiva,hemorragia de la primera mitad del embarazo (< 22 sem) aborto,2017-06-01,2,0,2
30502,VACAS,salud sexual y reproductiva,hemorragia de la primera mitad del embarazo (< 22 sem) aborto,2017-06-01,1,0,1
70801,VALLEGRANDE,salud sexual y reproductiva,hemorragia de la primera mitad del embarazo (< 22 sem) aborto,2017-06-01,3,0,3
20801,VIACHA,salud sexual y reproductiva,hemorragia de la primera mitad del embarazo (< 22 sem) aborto,2017-06-01,0,1,1
10704,VILLA CHARCAS,salud sexual y reproductiva,hemorragia de la primera mitad del embarazo (< 22 sem) aborto,2017-06-01,0,1,1
31003,VILLA TUNARI,salud sexual y reproductiva,hemorragia de la primera mitad del embarazo (< 22 sem) aborto,2017-06-01,19,0,19
11001,VILLA VACA GUZMAN (MUYUPAMPA),salud sexual y reproductiva,hemorragia de la primera mitad del embarazo (< 22 sem) aborto,2017-06-01,2,0,2
51501,VILLAZON,salud sexual y reproductiva,hemorragia de la primera mitad del embarazo (< 22 sem) aborto,2017-06-01,10,0,10
30904,VINTO,salud sexual y reproductiva,hemorragia de la primera mitad del embarazo (< 22 sem) aborto,2017-06-01,18,0,18
50602,VITICHI,salud sexual y reproductiva,hemorragia de la primera mitad del embarazo (< 22 sem) aborto,2017-06-01,1,0,1
70201,WARNES,salud sexual y reproductiva,hemorragia de la primera mitad del embarazo (< 22 sem) aborto,2017-06-01,19,0,19
60301,YACUIBA,salud sexual y reproductiva,hemorragia de la primera mitad del embarazo (< 22 sem) aborto,2017-06-01,0,4,4
21103,YANACACHI,salud sexual y reproductiva,hemorragia de la primera mitad del embarazo (< 22 sem) aborto,2017-06-01,0,1,1
70403,YAPACANI,salud sexual y reproductiva,hemorragia de la primera mitad del embarazo (< 22 sem) aborto,2017-06-01,7,0,7
30201,AIQUILE,salud sexual y reproductiva,hemorragia de la primera mitad del embarazo (< 22 sem) aborto,2017-07-01,8,0,8
40603,ANTEQUERA,salud sexual y reproductiva,hemorragia de la primera mitad del embarazo (< 22 sem) aborto,2017-07-01,1,0,1
30403,ARBIETO,salud sexual y reproductiva,hemorragia de la primera mitad del embarazo (< 22 sem) aborto,2017-07-01,3,1,4
71501,ASCENCION DE GUARAYOS,salud sexual y reproductiva,hemorragia de la primera mitad del embarazo (< 22 sem) aborto,2017-07-01,1,6,7
50301,BETANZOS,salud sexual y reproductiva,hemorragia de la primera mitad del embarazo (< 22 sem) aborto,2017-07-01,14,0,14
10701,CAMARGO,salud sexual y reproductiva,hemorragia de la primera mitad del embarazo (< 22 sem) aborto,2017-07-01,1,0,1
70706,CAMIRI,salud sexual y reproductiva,hemorragia de la primera mitad del embarazo (< 22 sem) aborto,2017-07-01,9,0,9
30701,CAPINOTA,salud sexual y reproductiva,hemorragia de la primera mitad del embarazo (< 22 sem) aborto,2017-07-01,5,0,5
40102,CARACOLLO,salud sexual y reproductiva,hemorragia de la primera mitad del embarazo (< 22 sem) aborto,2017-07-01,3,0,3
22001,CARANAVI,salud sexual y reproductiva,hemorragia de la primera mitad del embarazo (< 22 sem) aborto,2017-07-01,18,0,18
70702,CHARAGUA,salud sexual y reproductiva,hemorragia de la primera mitad del embarazo (< 22 sem) aborto,2017-07-01,2,0,2
50202,CHAYANTA,salud sexual y reproductiva,hemorragia de la primera mitad del embarazo (< 22 sem) aborto,2017-07-01,1,0,1
21101,CHULUMANI (V. DE LA LIBERTAD),salud sexual y reproductiva,hemorragia de la primera mitad del embarazo (< 22 sem) aborto,2017-07-01,5,0,5
20501,CHUMA,salud sexual y reproductiva,hemorragia de la primera mitad del embarazo (< 22 sem) aborto,2017-07-01,1,0,1
30801,CLIZA,salud sexual y reproductiva,hemorragia de la primera mitad del embarazo (< 22 sem) aborto,2017-07-01,8,7,15
90101,COBIJA,salud sexual y reproductiva,hemorragia de la primera mitad del embarazo (< 22 sem) aborto,2017-07-01,12,0,12
30101,COCHABAMBA,salud sexual y reproductiva,hemorragia de la primera mitad del embarazo (< 22 sem) aborto,2017-07-01,212,3,215
30905,COLCAPIRHUA,salud sexual y reproductiva,hemorragia de la primera mitad del embarazo (< 22 sem) aborto,2017-07-01,5,2,7
71301,COMARAPA,salud sexual y reproductiva,hemorragia de la primera mitad del embarazo (< 22 sem) aborto,2017-07-01,6,0,6
71101,CONCEPCION,salud sexual y reproductiva,hemorragia de la primera mitad del embarazo (< 22 sem) aborto,2017-07-01,1,0,1
21402,CORIPATA,salud sexual y reproductiva,hemorragia de la primera mitad del embarazo (< 22 sem) aborto,2017-07-01,2,0,2
21401,COROICO,salud sexual y reproductiva,hemorragia de la primera mitad del embarazo (< 22 sem) aborto,2017-07-01,4,0,4
70102,COTOCA,salud sexual y reproductiva,hemorragia de la primera mitad del embarazo (< 22 sem) aborto,2017-07-01,24,0,24
71106,CUATRO CAÃ‘ADAS,salud sexual y reproductiva,hemorragia de la primera mitad del embarazo (< 22 sem) aborto,2017-07-01,5,0,5
10902,CULPINA,salud sexual y reproductiva,hemorragia de la primera mitad del embarazo (< 22 sem) aborto,2017-07-01,2,1,3
20105,EL ALTO,salud sexual y reproductiva,hemorragia de la primera mitad del embarazo (< 22 sem) aborto,2017-07-01,125,7,132
71503,EL PUENTE(STC),salud sexual y reproductiva,hemorragia de la primera mitad del embarazo (< 22 sem) aborto,2017-07-01,1,0,1
70105,EL TORNO,salud sexual y reproductiva,hemorragia de la primera mitad del embarazo (< 22 sem) aborto,2017-07-01,17,0,17
31206,ENTRE RIOS CBBA,salud sexual y reproductiva,hemorragia de la primera mitad del embarazo (< 22 sem) aborto,2017-07-01,0,1,1
20602,GUANAY,salud sexual y reproductiva,hemorragia de la primera mitad del embarazo (< 22 sem) aborto,2017-07-01,3,1,4
80202,GUAYARAMERIN,salud sexual y reproductiva,hemorragia de la primera mitad del embarazo (< 22 sem) aborto,2017-07-01,4,0,4
40701,HUANUNI,salud sexual y reproductiva,hemorragia de la primera mitad del embarazo (< 22 sem) aborto,2017-07-01,4,0,4
20204,HUARINA,salud sexual y reproductiva,hemorragia de la primera mitad del embarazo (< 22 sem) aborto,2017-07-01,0,1,1
10703,INCAHUASI,salud sexual y reproductiva,hemorragia de la primera mitad del embarazo (< 22 sem) aborto,2017-07-01,1,1,2
21001,INQUISIVI,salud sexual y reproductiva,hemorragia de la primera mitad del embarazo (< 22 sem) aborto,2017-07-01,0,1,1
70104,LA GUARDIA,salud sexual y reproductiva,hemorragia de la primera mitad del embarazo (< 22 sem) aborto,2017-07-01,0,5,5
20101,LA PAZ,salud sexual y reproductiva,hemorragia de la primera mitad del embarazo (< 22 sem) aborto,2017-07-01,217,5,222
70903,MAIRANA,salud sexual y reproductiva,hemorragia de la primera mitad del embarazo (< 22 sem) aborto,2017-07-01,4,0,4
31301,MIZQUE,salud sexual y reproductiva,hemorragia de la primera mitad del embarazo (< 22 sem) aborto,2017-07-01,1,0,1
10501,MONTEAGUDO,salud sexual y reproductiva,hemorragia de la primera mitad del embarazo (< 22 sem) aborto,2017-07-01,0,1,1
71001,MONTERO,salud sexual y reproductiva,hemorragia de la primera mitad del embarazo (< 22 sem) aborto,2017-07-01,0,3,3
30302,MOROCHATA,salud sexual y reproductiva,hemorragia de la primera mitad del embarazo (< 22 sem) aborto,2017-07-01,0,1,1
40101,ORURO,salud sexual y reproductiva,hemorragia de la primera mitad del embarazo (< 22 sem) aborto,2017-07-01,5,4,9
60201,PADCAYA,salud sexual y reproductiva,hemorragia de la primera mitad del embarazo (< 22 sem) aborto,2017-07-01,0,1,1
31203,POCONA,salud sexual y reproductiva,hemorragia de la primera mitad del embarazo (< 22 sem) aborto,2017-07-01,2,0,2
40601,POOPO,salud sexual y reproductiva,hemorragia de la primera mitad del embarazo (< 22 sem) aborto,2017-07-01,0,2,2
10103,POROMA,salud sexual y reproductiva,hemorragia de la primera mitad del embarazo (< 22 sem) aborto,2017-07-01,1,0,1
50101,POTOSI,salud sexual y reproductiva,hemorragia de la primera mitad del embarazo (< 22 sem) aborto,2017-07-01,21,0,21
10302,PRESTO,salud sexual y reproductiva,hemorragia de la primera mitad del embarazo (< 22 sem) aborto,2017-07-01,0,1,1
90301,PUERTO GONZALO MORENO,salud sexual y reproductiva,hemorragia de la primera mitad del embarazo (< 22 sem) aborto,2017-07-01,1,0,1
71401,PUERTO SUAREZ,salud sexual y reproductiva,hemorragia de la primera mitad del embarazo (< 22 sem) aborto,2017-07-01,5,0,5
31205,PUERTO VILLARROEL,salud sexual y reproductiva,hemorragia de la primera mitad del embarazo (< 22 sem) aborto,2017-07-01,22,0,22
31401,PUNATA,salud sexual y reproductiva,hemorragia de la primera mitad del embarazo (< 22 sem) aborto,2017-07-01,19,0,19
21002,QUIME,salud sexual y reproductiva,hemorragia de la primera mitad del embarazo (< 22 sem) aborto,2017-07-01,1,0,1
80301,REYES,salud sexual y reproductiva,hemorragia de la primera mitad del embarazo (< 22 sem) aborto,2017-07-01,3,0,3
80201,RIBERALTA,salud sexual y reproductiva,hemorragia de la primera mitad del embarazo (< 22 sem) aborto,2017-07-01,10,4,14
70503,ROBORE,salud sexual y reproductiva,hemorragia de la primera mitad del embarazo (< 22 sem) aborto,2017-07-01,2,0,2
80304,RURRENABAQUE,salud sexual y reproductiva,hemorragia de la primera mitad del embarazo (< 22 sem) aborto,2017-07-01,7,0,7
31001,SACABA,salud sexual y reproductiva,hemorragia de la primera mitad del embarazo (< 22 sem) aborto,2017-07-01,23,16,39
40801,SALINAS DE GARCI MENDOZA,salud sexual y reproductiva,hemorragia de la primera mitad del embarazo (< 22 sem) aborto,2017-07-01,1,0,1
80602,SAN ANDRES,salud sexual y reproductiva,hemorragia de la primera mitad del embarazo (< 22 sem) aborto,2017-07-01,1,0,1
80302,SAN BORJA,salud sexual y reproductiva,hemorragia de la primera mitad del embarazo (< 22 sem) aborto,2017-07-01,9,6,15
21502,SAN BUENA VENTURA,salud sexual y reproductiva,hemorragia de la primera mitad del embarazo (< 22 sem) aborto,2017-07-01,2,0,2
70402,SAN CARLOS,salud sexual y reproductiva,hemorragia de la primera mitad del embarazo (< 22 sem) aborto,2017-07-01,8,1,9
80501,SAN IGNACIO,salud sexual y reproductiva,hemorragia de la primera mitad del embarazo (< 22 sem) aborto,2017-07-01,5,0,5
70301,SAN IGNACIO DE VELASCO,salud sexual y reproductiva,hemorragia de la primera mitad del embarazo (< 22 sem) aborto,2017-07-01,13,0,13
70501,SAN JOSE DE CHIQUITOS,salud sexual y reproductiva,hemorragia de la primera mitad del embarazo (< 22 sem) aborto,2017-07-01,7,0,7
71104,SAN JULIAN,salud sexual y reproductiva,hemorragia de la primera mitad del embarazo (< 22 sem) aborto,2017-07-01,15,0,15
10702,SAN LUCAS,salud sexual y reproductiva,hemorragia de la primera mitad del embarazo (< 22 sem) aborto,2017-07-01,2,2,4
71201,SAN MATIAS,salud sexual y reproductiva,hemorragia de la primera mitad del embarazo (< 22 sem) aborto,2017-07-01,0,1,1
70302,SAN MIGUEL DE VELASCO,salud sexual y reproductiva,hemorragia de la primera mitad del embarazo (< 22 sem) aborto,2017-07-01,1,0,1
71005,SAN PEDRO,salud sexual y reproductiva,hemorragia de la primera mitad del embarazo (< 22 sem) aborto,2017-07-01,1,0,1
50501,SAN PEDRO DE BUENA VISTA,salud sexual y reproductiva,hemorragia de la primera mitad del embarazo (< 22 sem) aborto,2017-07-01,1,0,1
21702,SAN PEDRO DE TIQUINA,salud sexual y reproductiva,hemorragia de la primera mitad del embarazo (< 22 sem) aborto,2017-07-01,0,1,1
71103,SAN RAMON SCZ,salud sexual y reproductiva,hemorragia de la primera mitad del embarazo (< 22 sem) aborto,2017-07-01,1,0,1
80401,SANTA ANA,salud sexual y reproductiva,hemorragia de la primera mitad del embarazo (< 22 sem) aborto,2017-07-01,4,0,4
70101,SANTA CRUZ DE LA SIERRA,salud sexual y reproductiva,hemorragia de la primera mitad del embarazo (< 22 sem) aborto,2017-07-01,321,117,438
20902,SAPAHAQUI,salud sexual y reproductiva,hemorragia de la primera mitad del embarazo (< 22 sem) aborto,2017-07-01,3,0,3
31602,SHINAOTA,salud sexual y reproductiva,hemorragia de la primera mitad del embarazo (< 22 sem) aborto,2017-07-01,15,0,15
30902,SIPE SIPE,salud sexual y reproductiva,hemorragia de la primera mitad del embarazo (< 22 sem) aborto,2017-07-01,4,0,4
10403,SOPACHUY,salud sexual y reproductiva,hemorragia de la primera mitad del embarazo (< 22 sem) aborto,2017-07-01,0,1,1
10101,SUCRE,salud sexual y reproductiva,hemorragia de la primera mitad del embarazo (< 22 sem) aborto,2017-07-01,73,31,104
30602,TACOPAYA,salud sexual y reproductiva,hemorragia de la primera mitad del embarazo (< 22 sem) aborto,2017-07-01,0,2,2
31101,TAPACARI,salud sexual y reproductiva,hemorragia de la primera mitad del embarazo (< 22 sem) aborto,2017-07-01,2,0,2
60101,TARIJA,salud sexual y reproductiva,hemorragia de la primera mitad del embarazo (< 22 sem) aborto,2017-07-01,75,0,75
10202,TARVITA,salud sexual y reproductiva,hemorragia de la primera mitad del embarazo (< 22 sem) aborto,2017-07-01,1,1,2
20608,TEOPONTE,salud sexual y reproductiva,hemorragia de la primera mitad del embarazo (< 22 sem) aborto,2017-07-01,1,2,3
30903,TIQUIPAYA,salud sexual y reproductiva,hemorragia de la primera mitad del embarazo (< 22 sem) aborto,2017-07-01,2,0,2
30802,TOCO,salud sexual y reproductiva,hemorragia de la primera mitad del embarazo (< 22 sem) aborto,2017-07-01,1,0,1
30803,TOLATA,salud sexual y reproductiva,hemorragia de la primera mitad del embarazo (< 22 sem) aborto,2017-07-01,1,0,1
31201,TOTORA(CBBA),salud sexual y reproductiva,hemorragia de la primera mitad del embarazo (< 22 sem) aborto,2017-07-01,1,0,1
80101,TRINIDAD,salud sexual y reproductiva,hemorragia de la primera mitad del embarazo (< 22 sem) aborto,2017-07-01,69,1,70
50801,TUPIZA,salud sexual y reproductiva,hemorragia de la primera mitad del embarazo (< 22 sem) aborto,2017-07-01,12,0,12
40402,TURCO,salud sexual y reproductiva,hemorragia de la primera mitad del embarazo (< 22 sem) aborto,2017-07-01,1,0,1
51201,UYUNI,salud sexual y reproductiva,hemorragia de la primera mitad del embarazo (< 22 sem) aborto,2017-07-01,4,0,4
30502,VACAS,salud sexual y reproductiva,hemorragia de la primera mitad del embarazo (< 22 sem) aborto,2017-07-01,1,0,1
10704,VILLA CHARCAS,salud sexual y reproductiva,hemorragia de la primera mitad del embarazo (< 22 sem) aborto,2017-07-01,0,1,1
31003,VILLA TUNARI,salud sexual y reproductiva,hemorragia de la primera mitad del embarazo (< 22 sem) aborto,2017-07-01,12,0,12
11001,VILLA VACA GUZMAN (MUYUPAMPA),salud sexual y reproductiva,hemorragia de la primera mitad del embarazo (< 22 sem) aborto,2017-07-01,1,0,1
51501,VILLAZON,salud sexual y reproductiva,hemorragia de la primera mitad del embarazo (< 22 sem) aborto,2017-07-01,16,0,16
30904,VINTO,salud sexual y reproductiva,hemorragia de la primera mitad del embarazo (< 22 sem) aborto,2017-07-01,1,0,1
70201,WARNES,salud sexual y reproductiva,hemorragia de la primera mitad del embarazo (< 22 sem) aborto,2017-07-01,30,0,30
60301,YACUIBA,salud sexual y reproductiva,hemorragia de la primera mitad del embarazo (< 22 sem) aborto,2017-07-01,0,2,2
70403,YAPACANI,salud sexual y reproductiva,hemorragia de la primera mitad del embarazo (< 22 sem) aborto,2017-07-01,14,0,14
30201,AIQUILE,salud sexual y reproductiva,hemorragia de la primera mitad del embarazo (< 22 sem) aborto,2017-08-01,0,12,12
30402,ANZALDO,salud sexual y reproductiva,hemorragia de la primera mitad del embarazo (< 22 sem) aborto,2017-08-01,1,0,1
30601,ARQUE,salud sexual y reproductiva,hemorragia de la primera mitad del embarazo (< 22 sem) aborto,2017-08-01,1,0,1
71501,ASCENCION DE GUARAYOS,salud sexual y reproductiva,hemorragia de la primera mitad del embarazo (< 22 sem) aborto,2017-08-01,6,5,11
50802,ATOCHA,salud sexual y reproductiva,hemorragia de la primera mitad del embarazo (< 22 sem) aborto,2017-08-01,0,1,1
10201,AZURDUY,salud sexual y reproductiva,hemorragia de la primera mitad del embarazo (< 22 sem) aborto,2017-08-01,1,0,1
50301,BETANZOS,salud sexual y reproductiva,hemorragia de la primera mitad del embarazo (< 22 sem) aborto,2017-08-01,9,0,9
70707,BOYUIBE,salud sexual y reproductiva,hemorragia de la primera mitad del embarazo (< 22 sem) aborto,2017-08-01,1,0,1
21003,CAJUATA,salud sexual y reproductiva,hemorragia de la primera mitad del embarazo (< 22 sem) aborto,2017-08-01,1,1,2
10701,CAMARGO,salud sexual y reproductiva,hemorragia de la primera mitad del embarazo (< 22 sem) aborto,2017-08-01,5,3,8
70706,CAMIRI,salud sexual y reproductiva,hemorragia de la primera mitad del embarazo (< 22 sem) aborto,2017-08-01,16,0,16
30701,CAPINOTA,salud sexual y reproductiva,hemorragia de la primera mitad del embarazo (< 22 sem) aborto,2017-08-01,7,0,7
40102,CARACOLLO,salud sexual y reproductiva,hemorragia de la primera mitad del embarazo (< 22 sem) aborto,2017-08-01,4,0,4
22001,CARANAVI,salud sexual y reproductiva,hemorragia de la primera mitad del embarazo (< 22 sem) aborto,2017-08-01,23,0,23
40201,CHALLAPATA,salud sexual y reproductiva,hemorragia de la primera mitad del embarazo (< 22 sem) aborto,2017-08-01,2,0,2
70702,CHARAGUA,salud sexual y reproductiva,hemorragia de la primera mitad del embarazo (< 22 sem) aborto,2017-08-01,6,0,6
30801,CLIZA,salud sexual y reproductiva,hemorragia de la primera mitad del embarazo (< 22 sem) aborto,2017-08-01,5,5,10
90101,COBIJA,salud sexual y reproductiva,hemorragia de la primera mitad del embarazo (< 22 sem) aborto,2017-08-01,24,1,25
30303,COCAPATA,salud sexual y reproductiva,hemorragia de la primera mitad del embarazo (< 22 sem) aborto,2017-08-01,1,0,1
30101,COCHABAMBA,salud sexual y reproductiva,hemorragia de la primera mitad del embarazo (< 22 sem) aborto,2017-08-01,230,3,233
30905,COLCAPIRHUA,salud sexual y reproductiva,hemorragia de la primera mitad del embarazo (< 22 sem) aborto,2017-08-01,5,2,7
50401,COLQUECHACA,salud sexual y reproductiva,hemorragia de la primera mitad del embarazo (< 22 sem) aborto,2017-08-01,0,1,1
21004,COLQUIRI,salud sexual y reproductiva,hemorragia de la primera mitad del embarazo (< 22 sem) aborto,2017-08-01,0,1,1
71301,COMARAPA,salud sexual y reproductiva,hemorragia de la primera mitad del embarazo (< 22 sem) aborto,2017-08-01,9,0,9
71101,CONCEPCION,salud sexual y reproductiva,hemorragia de la primera mitad del embarazo (< 22 sem) aborto,2017-08-01,3,0,3
21401,COROICO,salud sexual y reproductiva,hemorragia de la primera mitad del embarazo (< 22 sem) aborto,2017-08-01,1,0,1
50601,COTAGAITA,salud sexual y reproductiva,hemorragia de la primera mitad del embarazo (< 22 sem) aborto,2017-08-01,0,2,2
70102,COTOCA,salud sexual y reproductiva,hemorragia de la primera mitad del embarazo (< 22 sem) aborto,2017-08-01,12,0,12
71106,CUATRO CAÃ‘ADAS,salud sexual y reproductiva,hemorragia de la primera mitad del embarazo (< 22 sem) aborto,2017-08-01,10,1,11
31405,CUCHUMUELA (V. G. VILLARROEL),salud sexual y reproductiva,hemorragia de la primera mitad del embarazo (< 22 sem) aborto,2017-08-01,1,0,1
10902,CULPINA,salud sexual y reproductiva,hemorragia de la primera mitad del embarazo (< 22 sem) aborto,2017-08-01,6,0,6
20105,EL ALTO,salud sexual y reproductiva,hemorragia de la primera mitad del embarazo (< 22 sem) aborto,2017-08-01,154,17,171
60502,EL PUENTE(TJA),salud sexual y reproductiva,hemorragia de la primera mitad del embarazo (< 22 sem) aborto,2017-08-01,1,0,1
70105,EL TORNO,salud sexual y reproductiva,hemorragia de la primera mitad del embarazo (< 22 sem) aborto,2017-08-01,16,0,16
71004,FERNANDEZ ALONSO,salud sexual y reproductiva,hemorragia de la primera mitad del embarazo (< 22 sem) aborto,2017-08-01,1,0,1
80202,GUAYARAMERIN,salud sexual y reproductiva,hemorragia de la primera mitad del embarazo (< 22 sem) aborto,2017-08-01,1,3,4
40701,HUANUNI,salud sexual y reproductiva,hemorragia de la primera mitad del embarazo (< 22 sem) aborto,2017-08-01,9,0,9
10304,ICLA,salud sexual y reproductiva,hemorragia de la primera mitad del embarazo (< 22 sem) aborto,2017-08-01,0,1,1
21102,IRUPANA (VILLA DE LANZA),salud sexual y reproductiva,hemorragia de la primera mitad del embarazo (< 22 sem) aborto,2017-08-01,2,0,2
21105,LA ASUNTA,salud sexual y reproductiva,hemorragia de la primera mitad del embarazo (< 22 sem) aborto,2017-08-01,1,0,1
70104,LA GUARDIA,salud sexual y reproductiva,hemorragia de la primera mitad del embarazo (< 22 sem) aborto,2017-08-01,1,16,17
20101,LA PAZ,salud sexual y reproductiva,hemorragia de la primera mitad del embarazo (< 22 sem) aborto,2017-08-01,242,6,248
11003,MACHARETI,salud sexual y reproductiva,hemorragia de la primera mitad del embarazo (< 22 sem) aborto,2017-08-01,1,0,1
80801,MAGDALENA,salud sexual y reproductiva,hemorragia de la primera mitad del embarazo (< 22 sem) aborto,2017-08-01,0,1,1
70903,MAIRANA,salud sexual y reproductiva,hemorragia de la primera mitad del embarazo (< 22 sem) aborto,2017-08-01,7,0,7
20607,MAPIRI,salud sexual y reproductiva,hemorragia de la primera mitad del embarazo (< 22 sem) aborto,2017-08-01,2,0,2
71001,MONTERO,salud sexual y reproductiva,hemorragia de la primera mitad del embarazo (< 22 sem) aborto,2017-08-01,0,2,2
30302,MOROCHATA,salud sexual y reproductiva,hemorragia de la primera mitad del embarazo (< 22 sem) aborto,2017-08-01,0,1,1
40101,ORURO,salud sexual y reproductiva,hemorragia de la primera mitad del embarazo (< 22 sem) aborto,2017-08-01,93,0,93
60201,PADCAYA,salud sexual y reproductiva,hemorragia de la primera mitad del embarazo (< 22 sem) aborto,2017-08-01,0,1,1
70502,PAILON,salud sexual y reproductiva,hemorragia de la primera mitad del embarazo (< 22 sem) aborto,2017-08-01,1,0,1
30202,PASORAPA,salud sexual y reproductiva,hemorragia de la primera mitad del embarazo (< 22 sem) aborto,2017-08-01,0,1,1
21305,PATACAMAYA,salud sexual y reproductiva,hemorragia de la primera mitad del embarazo (< 22 sem) aborto,2017-08-01,1,0,1
31202,POJO (CBBA),salud sexual y reproductiva,hemorragia de la primera mitad del embarazo (< 22 sem) aborto,2017-08-01,2,0,2
40601,POOPO,salud sexual y reproductiva,hemorragia de la primera mitad del embarazo (< 22 sem) aborto,2017-08-01,1,1,2
50101,POTOSI,salud sexual y reproductiva,hemorragia de la primera mitad del embarazo (< 22 sem) aborto,2017-08-01,36,0,36
90301,PUERTO GONZALO MORENO,salud sexual y reproductiva,hemorragia de la primera mitad del embarazo (< 22 sem) aborto,2017-08-01,1,0,1
90201,PUERTO RICO,salud sexual y reproductiva,hemorragia de la primera mitad del embarazo (< 22 sem) aborto,2017-08-01,1,0,1
71401,PUERTO SUAREZ,salud sexual y reproductiva,hemorragia de la primera mitad del embarazo (< 22 sem) aborto,2017-08-01,10,0,10
31205,PUERTO VILLARROEL,salud sexual y reproductiva,hemorragia de la primera mitad del embarazo (< 22 sem) aborto,2017-08-01,41,0,41
31401,PUNATA,salud sexual y reproductiva,hemorragia de la primera mitad del embarazo (< 22 sem) aborto,2017-08-01,20,0,20
80301,REYES,salud sexual y reproductiva,hemorragia de la primera mitad del embarazo (< 22 sem) aborto,2017-08-01,1,0,1
80201,RIBERALTA,salud sexual y reproductiva,hemorragia de la primera mitad del embarazo (< 22 sem) aborto,2017-08-01,11,19,30
70503,ROBORE,salud sexual y reproductiva,hemorragia de la primera mitad del embarazo (< 22 sem) aborto,2017-08-01,2,0,2
80304,RURRENABAQUE,salud sexual y reproductiva,hemorragia de la primera mitad del embarazo (< 22 sem) aborto,2017-08-01,9,0,9
31001,SACABA,salud sexual y reproductiva,hemorragia de la primera mitad del embarazo (< 22 sem) aborto,2017-08-01,44,0,44
80302,SAN BORJA,salud sexual y reproductiva,hemorragia de la primera mitad del embarazo (< 22 sem) aborto,2017-08-01,12,0,12
21502,SAN BUENA VENTURA,salud sexual y reproductiva,hemorragia de la primera mitad del embarazo (< 22 sem) aborto,2017-08-01,4,0,4
70402,SAN CARLOS,salud sexual y reproductiva,hemorragia de la primera mitad del embarazo (< 22 sem) aborto,2017-08-01,4,0,4
80501,SAN IGNACIO,salud sexual y reproductiva,hemorragia de la primera mitad del embarazo (< 22 sem) aborto,2017-08-01,2,0,2
70301,SAN IGNACIO DE VELASCO,salud sexual y reproductiva,hemorragia de la primera mitad del embarazo (< 22 sem) aborto,2017-08-01,10,0,10
70501,SAN JOSE DE CHIQUITOS,salud sexual y reproductiva,hemorragia de la primera mitad del embarazo (< 22 sem) aborto,2017-08-01,10,0,10
71104,SAN JULIAN,salud sexual y reproductiva,hemorragia de la primera mitad del embarazo (< 22 sem) aborto,2017-08-01,20,0,20
10702,SAN LUCAS,salud sexual y reproductiva,hemorragia de la primera mitad del embarazo (< 22 sem) aborto,2017-08-01,1,2,3
71201,SAN MATIAS,salud sexual y reproductiva,hemorragia de la primera mitad del embarazo (< 22 sem) aborto,2017-08-01,2,0,2
70302,SAN MIGUEL DE VELASCO,salud sexual y reproductiva,hemorragia de la primera mitad del embarazo (< 22 sem) aborto,2017-08-01,1,0,1
80702,SAN RAMON BENI,salud sexual y reproductiva,hemorragia de la primera mitad del embarazo (< 22 sem) aborto,2017-08-01,2,0,2
71103,SAN RAMON SCZ,salud sexual y reproductiva,hemorragia de la primera mitad del embarazo (< 22 sem) aborto,2017-08-01,2,3,5
80401,SANTA ANA,salud sexual y reproductiva,hemorragia de la primera mitad del embarazo (< 22 sem) aborto,2017-08-01,10,0,10
70101,SANTA CRUZ DE LA SIERRA,salud sexual y reproductiva,hemorragia de la primera mitad del embarazo (< 22 sem) aborto,2017-08-01,351,150,501
90303,SENA,salud sexual y reproductiva,hemorragia de la primera mitad del embarazo (< 22 sem) aborto,2017-08-01,1,1,2
31602,SHINAOTA,salud sexual y reproductiva,hemorragia de la primera mitad del embarazo (< 22 sem) aborto,2017-08-01,1,0,1
21301,SICA SICA (VILLA AROMA),salud sexual y reproductiva,hemorragia de la primera mitad del embarazo (< 22 sem) aborto,2017-08-01,3,0,3
30902,SIPE SIPE,salud sexual y reproductiva,hemorragia de la primera mitad del embarazo (< 22 sem) aborto,2017-08-01,2,0,2
10403,SOPACHUY,salud sexual y reproductiva,hemorragia de la primera mitad del embarazo (< 22 sem) aborto,2017-08-01,1,0,1
20601,SORATA,salud sexual y reproductiva,hemorragia de la primera mitad del embarazo (< 22 sem) aborto,2017-08-01,1,0,1
10101,SUCRE,salud sexual y reproductiva,hemorragia de la primera mitad del embarazo (< 22 sem) aborto,2017-08-01,101,62,163
30602,TACOPAYA,salud sexual y reproductiva,hemorragia de la primera mitad del embarazo (< 22 sem) aborto,2017-08-01,0,1,1
31101,TAPACARI,salud sexual y reproductiva,hemorragia de la primera mitad del embarazo (< 22 sem) aborto,2017-08-01,0,1,1
10601,TARABUCO,salud sexual y reproductiva,hemorragia de la primera mitad del embarazo (< 22 sem) aborto,2017-08-01,0,1,1
60101,TARIJA,salud sexual y reproductiva,hemorragia de la primera mitad del embarazo (< 22 sem) aborto,2017-08-01,81,2,83
20608,TEOPONTE,salud sexual y reproductiva,hemorragia de la primera mitad del embarazo (< 22 sem) aborto,2017-08-01,0,2,2
20606,TIPUANI,salud sexual y reproductiva,hemorragia de la primera mitad del embarazo (< 22 sem) aborto,2017-08-01,1,0,1
30903,TIQUIPAYA,salud sexual y reproductiva,hemorragia de la primera mitad del embarazo (< 22 sem) aborto,2017-08-01,1,0,1
31201,TOTORA(CBBA),salud sexual y reproductiva,hemorragia de la primera mitad del embarazo (< 22 sem) aborto,2017-08-01,4,0,4
80101,TRINIDAD,salud sexual y reproductiva,hemorragia de la primera mitad del embarazo (< 22 sem) aborto,2017-08-01,62,0,62
50801,TUPIZA,salud sexual y reproductiva,hemorragia de la primera mitad del embarazo (< 22 sem) aborto,2017-08-01,8,4,12
51201,UYUNI,salud sexual y reproductiva,hemorragia de la primera mitad del embarazo (< 22 sem) aborto,2017-08-01,17,0,17
70801,VALLEGRANDE,salud sexual y reproductiva,hemorragia de la primera mitad del embarazo (< 22 sem) aborto,2017-08-01,2,0,2
10704,VILLA CHARCAS,salud sexual y reproductiva,hemorragia de la primera mitad del embarazo (< 22 sem) aborto,2017-08-01,0,2,2
31003,VILLA TUNARI,salud sexual y reproductiva,hemorragia de la primera mitad del embarazo (< 22 sem) aborto,2017-08-01,4,1,5
11001,VILLA VACA GUZMAN (MUYUPAMPA),salud sexual y reproductiva,hemorragia de la primera mitad del embarazo (< 22 sem) aborto,2017-08-01,1,0,1
51501,VILLAZON,salud sexual y reproductiva,hemorragia de la primera mitad del embarazo (< 22 sem) aborto,2017-08-01,12,0,12
30904,VINTO,salud sexual y reproductiva,hemorragia de la primera mitad del embarazo (< 22 sem) aborto,2017-08-01,5,0,5
70201,WARNES,salud sexual y reproductiva,hemorragia de la primera mitad del embarazo (< 22 sem) aborto,2017-08-01,26,0,26
60301,YACUIBA,salud sexual y reproductiva,hemorragia de la primera mitad del embarazo (< 22 sem) aborto,2017-08-01,0,6,6
70403,YAPACANI,salud sexual y reproductiva,hemorragia de la primera mitad del embarazo (< 22 sem) aborto,2017-08-01,28,0,28
60402,YUNCHARA,salud sexual y reproductiva,hemorragia de la primera mitad del embarazo (< 22 sem) aborto,2017-08-01,1,0,1
30201,AIQUILE,salud sexual y reproductiva,hemorragia de la primera mitad del embarazo (< 22 sem) aborto,2017-09-01,9,2,11
40603,ANTEQUERA,salud sexual y reproductiva,hemorragia de la primera mitad del embarazo (< 22 sem) aborto,2017-09-01,0,1,1
30403,ARBIETO,salud sexual y reproductiva,hemorragia de la primera mitad del embarazo (< 22 sem) aborto,2017-09-01,3,1,4
30601,ARQUE,salud sexual y reproductiva,hemorragia de la primera mitad del embarazo (< 22 sem) aborto,2017-09-01,1,1,2
71501,ASCENCION DE GUARAYOS,salud sexual y reproductiva,hemorragia de la primera mitad del embarazo (< 22 sem) aborto,2017-09-01,6,2,8
10201,AZURDUY,salud sexual y reproductiva,hemorragia de la primera mitad del embarazo (< 22 sem) aborto,2017-09-01,1,0,1
50301,BETANZOS,salud sexual y reproductiva,hemorragia de la primera mitad del embarazo (< 22 sem) aborto,2017-09-01,7,0,7
31501,BOLIVAR,salud sexual y reproductiva,hemorragia de la primera mitad del embarazo (< 22 sem) aborto,2017-09-01,0,1,1
10701,CAMARGO,salud sexual y reproductiva,hemorragia de la primera mitad del embarazo (< 22 sem) aborto,2017-09-01,4,0,4
70706,CAMIRI,salud sexual y reproductiva,hemorragia de la primera mitad del embarazo (< 22 sem) aborto,2017-09-01,19,0,19
40102,CARACOLLO,salud sexual y reproductiva,hemorragia de la primera mitad del embarazo (< 22 sem) aborto,2017-09-01,5,0,5
22001,CARANAVI,salud sexual y reproductiva,hemorragia de la primera mitad del embarazo (< 22 sem) aborto,2017-09-01,19,1,20
40201,CHALLAPATA,salud sexual y reproductiva,hemorragia de la primera mitad del embarazo (< 22 sem) aborto,2017-09-01,2,0,2
70702,CHARAGUA,salud sexual y reproductiva,hemorragia de la primera mitad del embarazo (< 22 sem) aborto,2017-09-01,1,0,1
31204,CHIMORE,salud sexual y reproductiva,hemorragia de la primera mitad del embarazo (< 22 sem) aborto,2017-09-01,3,0,3
51103,CKOCHAS,salud sexual y reproductiva,hemorragia de la primera mitad del embarazo (< 22 sem) aborto,2017-09-01,0,1,1
30801,CLIZA,salud sexual y reproductiva,hemorragia de la primera mitad del embarazo (< 22 sem) aborto,2017-09-01,5,0,5
90101,COBIJA,salud sexual y reproductiva,hemorragia de la primera mitad del embarazo (< 22 sem) aborto,2017-09-01,18,0,18
30303,COCAPATA,salud sexual y reproductiva,hemorragia de la primera mitad del embarazo (< 22 sem) aborto,2017-09-01,0,1,1
30101,COCHABAMBA,salud sexual y reproductiva,hemorragia de la primera mitad del embarazo (< 22 sem) aborto,2017-09-01,181,9,190
30905,COLCAPIRHUA,salud sexual y reproductiva,hemorragia de la primera mitad del embarazo (< 22 sem) aborto,2017-09-01,3,1,4
50401,COLQUECHACA,salud sexual y reproductiva,hemorragia de la primera mitad del embarazo (< 22 sem) aborto,2017-09-01,0,1,1
71301,COMARAPA,salud sexual y reproductiva,hemorragia de la primera mitad del embarazo (< 22 sem) aborto,2017-09-01,3,0,3
71101,CONCEPCION,salud sexual y reproductiva,hemorragia de la primera mitad del embarazo (< 22 sem) aborto,2017-09-01,1,0,1
21401,COROICO,salud sexual y reproductiva,hemorragia de la primera mitad del embarazo (< 22 sem) aborto,2017-09-01,1,0,1
70102,COTOCA,salud sexual y reproductiva,hemorragia de la primera mitad del embarazo (< 22 sem) aborto,2017-09-01,0,1,1
71106,CUATRO CAÃ‘ADAS,salud sexual y reproductiva,hemorragia de la primera mitad del embarazo (< 22 sem) aborto,2017-09-01,1,0,1
10902,CULPINA,salud sexual y reproductiva,hemorragia de la primera mitad del embarazo (< 22 sem) aborto,2017-09-01,4,0,4
20105,EL ALTO,salud sexual y reproductiva,hemorragia de la primera mitad del embarazo (< 22 sem) aborto,2017-09-01,118,24,142
71503,EL PUENTE(STC),salud sexual y reproductiva,hemorragia de la primera mitad del embarazo (< 22 sem) aborto,2017-09-01,1,0,1
70105,EL TORNO,salud sexual y reproductiva,hemorragia de la primera mitad del embarazo (< 22 sem) aborto,2017-09-01,21,0,21
60601,ENTRE RIOS TRJ,salud sexual y reproductiva,hemorragia de la primera mitad del embarazo (< 22 sem) aborto,2017-09-01,0,2,2
31206,ENTRE RIOS CBBA,salud sexual y reproductiva,hemorragia de la primera mitad del embarazo (< 22 sem) aborto,2017-09-01,3,0,3
80402,EXALTACION,salud sexual y reproductiva,hemorragia de la primera mitad del embarazo (< 22 sem) aborto,2017-09-01,0,1,1
20602,GUANAY,salud sexual y reproductiva,hemorragia de la primera mitad del embarazo (< 22 sem) aborto,2017-09-01,1,0,1
40701,HUANUNI,salud sexual y reproductiva,hemorragia de la primera mitad del embarazo (< 22 sem) aborto,2017-09-01,2,0,2
10703,INCAHUASI,salud sexual y reproductiva,hemorragia de la primera mitad del embarazo (< 22 sem) aborto,2017-09-01,0,2,2
21501,IXIAMAS,salud sexual y reproductiva,hemorragia de la primera mitad del embarazo (< 22 sem) aborto,2017-09-01,1,1,2
21105,LA ASUNTA,salud sexual y reproductiva,hemorragia de la primera mitad del embarazo (< 22 sem) aborto,2017-09-01,1,0,1
70104,LA GUARDIA,salud sexual y reproductiva,hemorragia de la primera mitad del embarazo (< 22 sem) aborto,2017-09-01,0,8,8
20101,LA PAZ,salud sexual y reproductiva,hemorragia de la primera mitad del embarazo (< 22 sem) aborto,2017-09-01,199,6,205
80801,MAGDALENA,salud sexual y reproductiva,hemorragia de la primera mitad del embarazo (< 22 sem) aborto,2017-09-01,0,3,3
70903,MAIRANA,salud sexual y reproductiva,hemorragia de la primera mitad del embarazo (< 22 sem) aborto,2017-09-01,6,0,6
20607,MAPIRI,salud sexual y reproductiva,hemorragia de la primera mitad del embarazo (< 22 sem) aborto,2017-09-01,1,0,1
20402,MOCOMOCO,salud sexual y reproductiva,hemorragia de la primera mitad del embarazo (< 22 sem) aborto,2017-09-01,0,1,1
10501,MONTEAGUDO,salud sexual y reproductiva,hemorragia de la primera mitad del embarazo (< 22 sem) aborto,2017-09-01,2,0,2
71001,MONTERO,salud sexual y reproductiva,hemorragia de la primera mitad del embarazo (< 22 sem) aborto,2017-09-01,0,2,2
30302,MOROCHATA,salud sexual y reproductiva,hemorragia de la primera mitad del embarazo (< 22 sem) aborto,2017-09-01,0,2,2
50404,OCURI,salud sexual y reproductiva,hemorragia de la primera mitad del embarazo (< 22 sem) aborto,2017-09-01,5,0,5
30203,OMEREQUE,salud sexual y reproductiva,hemorragia de la primera mitad del embarazo (< 22 sem) aborto,2017-09-01,0,1,1
40101,ORURO,salud sexual y reproductiva,hemorragia de la primera mitad del embarazo (< 22 sem) aborto,2017-09-01,75,2,77
70502,PAILON,salud sexual y reproductiva,hemorragia de la primera mitad del embarazo (< 22 sem) aborto,2017-09-01,2,0,2
31203,POCONA,salud sexual y reproductiva,hemorragia de la primera mitad del embarazo (< 22 sem) aborto,2017-09-01,3,0,3
31202,POJO (CBBA),salud sexual y reproductiva,hemorragia de la primera mitad del embarazo (< 22 sem) aborto,2017-09-01,1,0,1
40601,POOPO,salud sexual y reproductiva,hemorragia de la primera mitad del embarazo (< 22 sem) aborto,2017-09-01,0,1,1
50101,POTOSI,salud sexual y reproductiva,hemorragia de la primera mitad del embarazo (< 22 sem) aborto,2017-09-01,31,0,31
71401,PUERTO SUAREZ,salud sexual y reproductiva,hemorragia de la primera mitad del embarazo (< 22 sem) aborto,2017-09-01,3,0,3
31205,PUERTO VILLARROEL,salud sexual y reproductiva,hemorragia de la primera mitad del embarazo (< 22 sem) aborto,2017-09-01,41,0,41
51101,PUNA,salud sexual y reproductiva,hemorragia de la primera mitad del embarazo (< 22 sem) aborto,2017-09-01,1,0,1
31401,PUNATA,salud sexual y reproductiva,hemorragia de la primera mitad del embarazo (< 22 sem) aborto,2017-09-01,15,0,15
80301,REYES,salud sexual y reproductiva,hemorragia de la primera mitad del embarazo (< 22 sem) aborto,2017-09-01,1,0,1
80201,RIBERALTA,salud sexual y reproductiva,hemorragia de la primera mitad del embarazo (< 22 sem) aborto,2017-09-01,4,11,15
70503,ROBORE,salud sexual y reproductiva,hemorragia de la primera mitad del embarazo (< 22 sem) aborto,2017-09-01,3,0,3
80304,RURRENABAQUE,salud sexual y reproductiva,hemorragia de la primera mitad del embarazo (< 22 sem) aborto,2017-09-01,7,0,7
31001,SACABA,salud sexual y reproductiva,hemorragia de la primera mitad del embarazo (< 22 sem) aborto,2017-09-01,44,0,44
80302,SAN BORJA,salud sexual y reproductiva,hemorragia de la primera mitad del embarazo (< 22 sem) aborto,2017-09-01,14,0,14
21502,SAN BUENA VENTURA,salud sexual y reproductiva,hemorragia de la primera mitad del embarazo (< 22 sem) aborto,2017-09-01,5,0,5
70402,SAN CARLOS,salud sexual y reproductiva,hemorragia de la primera mitad del embarazo (< 22 sem) aborto,2017-09-01,7,0,7
80501,SAN IGNACIO,salud sexual y reproductiva,hemorragia de la primera mitad del embarazo (< 22 sem) aborto,2017-09-01,1,0,1
70301,SAN IGNACIO DE VELASCO,salud sexual y reproductiva,hemorragia de la primera mitad del embarazo (< 22 sem) aborto,2017-09-01,9,0,9
70501,SAN JOSE DE CHIQUITOS,salud sexual y reproductiva,hemorragia de la primera mitad del embarazo (< 22 sem) aborto,2017-09-01,3,0,3
71104,SAN JULIAN,salud sexual y reproductiva,hemorragia de la primera mitad del embarazo (< 22 sem) aborto,2017-09-01,9,0,9
60501,SAN LORENZO(TJA),salud sexual y reproductiva,hemorragia de la primera mitad del embarazo (< 22 sem) aborto,2017-09-01,0,1,1
10702,SAN LUCAS,salud sexual y reproductiva,hemorragia de la primera mitad del embarazo (< 22 sem) aborto,2017-09-01,5,0,5
50501,SAN PEDRO DE BUENA VISTA,salud sexual y reproductiva,hemorragia de la primera mitad del embarazo (< 22 sem) aborto,2017-09-01,1,0,1
71103,SAN RAMON SCZ,salud sexual y reproductiva,hemorragia de la primera mitad del embarazo (< 22 sem) aborto,2017-09-01,4,0,4
80401,SANTA ANA,salud sexual y reproductiva,hemorragia de la primera mitad del embarazo (< 22 sem) aborto,2017-09-01,5,0,5
70101,SANTA CRUZ DE LA SIERRA,salud sexual y reproductiva,hemorragia de la primera mitad del embarazo (< 22 sem) aborto,2017-09-01,317,125,442
90303,SENA,salud sexual y reproductiva,hemorragia de la primera mitad del embarazo (< 22 sem) aborto,2017-09-01,0,3,3
31602,SHINAOTA,salud sexual y reproductiva,hemorragia de la primera mitad del embarazo (< 22 sem) aborto,2017-09-01,29,0,29
10101,SUCRE,salud sexual y reproductiva,hemorragia de la primera mitad del embarazo (< 22 sem) aborto,2017-09-01,55,66,121
30401,TARATA,salud sexual y reproductiva,hemorragia de la primera mitad del embarazo (< 22 sem) aborto,2017-09-01,3,0,3
60101,TARIJA,salud sexual y reproductiva,hemorragia de la primera mitad del embarazo (< 22 sem) aborto,2017-09-01,64,2,66
10202,TARVITA,salud sexual y reproductiva,hemorragia de la primera mitad del embarazo (< 22 sem) aborto,2017-09-01,2,0,2
20606,TIPUANI,salud sexual y reproductiva,hemorragia de la primera mitad del embarazo (< 22 sem) aborto,2017-09-01,1,1,2
10402,TOMINA,salud sexual y reproductiva,hemorragia de la primera mitad del embarazo (< 22 sem) aborto,2017-09-01,2,1,3
31201,TOTORA(CBBA),salud sexual y reproductiva,hemorragia de la primera mitad del embarazo (< 22 sem) aborto,2017-09-01,1,0,1
80101,TRINIDAD,salud sexual y reproductiva,hemorragia de la primera mitad del embarazo (< 22 sem) aborto,2017-09-01,43,0,43
50801,TUPIZA,salud sexual y reproductiva,hemorragia de la primera mitad del embarazo (< 22 sem) aborto,2017-09-01,12,0,12
51201,UYUNI,salud sexual y reproductiva,hemorragia de la primera mitad del embarazo (< 22 sem) aborto,2017-09-01,7,0,7
30502,VACAS,salud sexual y reproductiva,hemorragia de la primera mitad del embarazo (< 22 sem) aborto,2017-09-01,1,0,1
31003,VILLA TUNARI,salud sexual y reproductiva,hemorragia de la primera mitad del embarazo (< 22 sem) aborto,2017-09-01,3,0,3
51501,VILLAZON,salud sexual y reproductiva,hemorragia de la primera mitad del embarazo (< 22 sem) aborto,2017-09-01,12,0,12
30904,VINTO,salud sexual y reproductiva,hemorragia de la primera mitad del embarazo (< 22 sem) aborto,2017-09-01,7,0,7
70201,WARNES,salud sexual y reproductiva,hemorragia de la primera mitad del embarazo (< 22 sem) aborto,2017-09-01,22,2,24
60301,YACUIBA,salud sexual y reproductiva,hemorragia de la primera mitad del embarazo (< 22 sem) aborto,2017-09-01,0,4,4
70403,YAPACANI,salud sexual y reproductiva,hemorragia de la primera mitad del embarazo (< 22 sem) aborto,2017-09-01,18,0,18
30201,AIQUILE,salud sexual y reproductiva,hemorragia de la primera mitad del embarazo (< 22 sem) aborto,2017-10-01,9,0,9
10404,ALCALA,salud sexual y reproductiva,hemorragia de la primera mitad del embarazo (< 22 sem) aborto,2017-10-01,1,0,1
40603,ANTEQUERA,salud sexual y reproductiva,hemorragia de la primera mitad del embarazo (< 22 sem) aborto,2017-10-01,0,1,1
30501,ARANI,salud sexual y reproductiva,hemorragia de la primera mitad del embarazo (< 22 sem) aborto,2017-10-01,1,0,1
30403,ARBIETO,salud sexual y reproductiva,hemorragia de la primera mitad del embarazo (< 22 sem) aborto,2017-10-01,1,0,1
30601,ARQUE,salud sexual y reproductiva,hemorragia de la primera mitad del embarazo (< 22 sem) aborto,2017-10-01,1,0,1
71501,ASCENCION DE GUARAYOS,salud sexual y reproductiva,hemorragia de la primera mitad del embarazo (< 22 sem) aborto,2017-10-01,4,4,8
10201,AZURDUY,salud sexual y reproductiva,hemorragia de la primera mitad del embarazo (< 22 sem) aborto,2017-10-01,0,1,1
60202,BERMEJO,salud sexual y reproductiva,hemorragia de la primera mitad del embarazo (< 22 sem) aborto,2017-10-01,0,1,1
50301,BETANZOS,salud sexual y reproductiva,hemorragia de la primera mitad del embarazo (< 22 sem) aborto,2017-10-01,7,0,7
10701,CAMARGO,salud sexual y reproductiva,hemorragia de la primera mitad del embarazo (< 22 sem) aborto,2017-10-01,0,2,2
70706,CAMIRI,salud sexual y reproductiva,hemorragia de la primera mitad del embarazo (< 22 sem) aborto,2017-10-01,14,0,14
30701,CAPINOTA,salud sexual y reproductiva,hemorragia de la primera mitad del embarazo (< 22 sem) aborto,2017-10-01,5,0,5
40102,CARACOLLO,salud sexual y reproductiva,hemorragia de la primera mitad del embarazo (< 22 sem) aborto,2017-10-01,1,0,1
22001,CARANAVI,salud sexual y reproductiva,hemorragia de la primera mitad del embarazo (< 22 sem) aborto,2017-10-01,23,0,23
70702,CHARAGUA,salud sexual y reproductiva,hemorragia de la primera mitad del embarazo (< 22 sem) aborto,2017-10-01,3,0,3
31204,CHIMORE,salud sexual y reproductiva,hemorragia de la primera mitad del embarazo (< 22 sem) aborto,2017-10-01,1,0,1
21101,CHULUMANI (V. DE LA LIBERTAD),salud sexual y reproductiva,hemorragia de la primera mitad del embarazo (< 22 sem) aborto,2017-10-01,8,0,8
30801,CLIZA,salud sexual y reproductiva,hemorragia de la primera mitad del embarazo (< 22 sem) aborto,2017-10-01,7,0,7
90101,COBIJA,salud sexual y reproductiva,hemorragia de la primera mitad del embarazo (< 22 sem) aborto,2017-10-01,18,0,18
30101,COCHABAMBA,salud sexual y reproductiva,hemorragia de la primera mitad del embarazo (< 22 sem) aborto,2017-10-01,263,5,268
30905,COLCAPIRHUA,salud sexual y reproductiva,hemorragia de la primera mitad del embarazo (< 22 sem) aborto,2017-10-01,3,0,3
31002,COLOMI,salud sexual y reproductiva,hemorragia de la primera mitad del embarazo (< 22 sem) aborto,2017-10-01,1,0,1
71301,COMARAPA,salud sexual y reproductiva,hemorragia de la primera mitad del embarazo (< 22 sem) aborto,2017-10-01,7,0,7
21402,CORIPATA,salud sexual y reproductiva,hemorragia de la primera mitad del embarazo (< 22 sem) aborto,2017-10-01,1,0,1
50601,COTAGAITA,salud sexual y reproductiva,hemorragia de la primera mitad del embarazo (< 22 sem) aborto,2017-10-01,0,2,2
70102,COTOCA,salud sexual y reproductiva,hemorragia de la primera mitad del embarazo (< 22 sem) aborto,2017-10-01,4,3,7
71106,CUATRO CAÃ‘ADAS,salud sexual y reproductiva,hemorragia de la primera mitad del embarazo (< 22 sem) aborto,2017-10-01,3,0,3
10902,CULPINA,salud sexual y reproductiva,hemorragia de la primera mitad del embarazo (< 22 sem) aborto,2017-10-01,6,0,6
20105,EL ALTO,salud sexual y reproductiva,hemorragia de la primera mitad del embarazo (< 22 sem) aborto,2017-10-01,165,31,196
71503,EL PUENTE(STC),salud sexual y reproductiva,hemorragia de la primera mitad del embarazo (< 22 sem) aborto,2017-10-01,1,0,1
70105,EL TORNO,salud sexual y reproductiva,hemorragia de la primera mitad del embarazo (< 22 sem) aborto,2017-10-01,20,0,20
31206,ENTRE RIOS CBBA,salud sexual y reproductiva,hemorragia de la primera mitad del embarazo (< 22 sem) aborto,2017-10-01,6,0,6
80202,GUAYARAMERIN,salud sexual y reproductiva,hemorragia de la primera mitad del embarazo (< 22 sem) aborto,2017-10-01,2,0,2
40701,HUANUNI,salud sexual y reproductiva,hemorragia de la primera mitad del embarazo (< 22 sem) aborto,2017-10-01,3,2,5
70104,LA GUARDIA,salud sexual y reproductiva,hemorragia de la primera mitad del embarazo (< 22 sem) aborto,2017-10-01,0,14,14
20101,LA PAZ,salud sexual y reproductiva,hemorragia de la primera mitad del embarazo (< 22 sem) aborto,2017-10-01,185,12,197
70903,MAIRANA,salud sexual y reproductiva,hemorragia de la primera mitad del embarazo (< 22 sem) aborto,2017-10-01,4,0,4
20607,MAPIRI,salud sexual y reproductiva,hemorragia de la primera mitad del embarazo (< 22 sem) aborto,2017-10-01,1,0,1
31301,MIZQUE,salud sexual y reproductiva,hemorragia de la primera mitad del embarazo (< 22 sem) aborto,2017-10-01,1,0,1
10501,MONTEAGUDO,salud sexual y reproductiva,hemorragia de la primera mitad del embarazo (< 22 sem) aborto,2017-10-01,5,0,5
40101,ORURO,salud sexual y reproductiva,hemorragia de la primera mitad del embarazo (< 22 sem) aborto,2017-10-01,5,5,10
70502,PAILON,salud sexual y reproductiva,hemorragia de la primera mitad del embarazo (< 22 sem) aborto,2017-10-01,4,0,4
31203,POCONA,salud sexual y reproductiva,hemorragia de la primera mitad del embarazo (< 22 sem) aborto,2017-10-01,3,0,3
31202,POJO (CBBA),salud sexual y reproductiva,hemorragia de la primera mitad del embarazo (< 22 sem) aborto,2017-10-01,3,0,3
40601,POOPO,salud sexual y reproductiva,hemorragia de la primera mitad del embarazo (< 22 sem) aborto,2017-10-01,1,0,1
10103,POROMA,salud sexual y reproductiva,hemorragia de la primera mitad del embarazo (< 22 sem) aborto,2017-10-01,1,0,1
50101,POTOSI,salud sexual y reproductiva,hemorragia de la primera mitad del embarazo (< 22 sem) aborto,2017-10-01,23,3,26
71401,PUERTO SUAREZ,salud sexual y reproductiva,hemorragia de la primera mitad del embarazo (< 22 sem) aborto,2017-10-01,4,0,4
31205,PUERTO VILLARROEL,salud sexual y reproductiva,hemorragia de la primera mitad del embarazo (< 22 sem) aborto,2017-10-01,26,1,27
31401,PUNATA,salud sexual y reproductiva,hemorragia de la primera mitad del embarazo (< 22 sem) aborto,2017-10-01,9,0,9
30901,QUILLACOLLO,salud sexual y reproductiva,hemorragia de la primera mitad del embarazo (< 22 sem) aborto,2017-10-01,60,2,62
80301,REYES,salud sexual y reproductiva,hemorragia de la primera mitad del embarazo (< 22 sem) aborto,2017-10-01,1,0,1
80201,RIBERALTA,salud sexual y reproductiva,hemorragia de la primera mitad del embarazo (< 22 sem) aborto,2017-10-01,3,1,4
70503,ROBORE,salud sexual y reproductiva,hemorragia de la primera mitad del embarazo (< 22 sem) aborto,2017-10-01,3,0,3
80304,RURRENABAQUE,salud sexual y reproductiva,hemorragia de la primera mitad del embarazo (< 22 sem) aborto,2017-10-01,10,0,10
31001,SACABA,salud sexual y reproductiva,hemorragia de la primera mitad del embarazo (< 22 sem) aborto,2017-10-01,38,11,49
70901,SAMAIPATA,salud sexual y reproductiva,hemorragia de la primera mitad del embarazo (< 22 sem) aborto,2017-10-01,1,0,1
80302,SAN BORJA,salud sexual y reproductiva,hemorragia de la primera mitad del embarazo (< 22 sem) aborto,2017-10-01,13,0,13
21502,SAN BUENA VENTURA,salud sexual y reproductiva,hemorragia de la primera mitad del embarazo (< 22 sem) aborto,2017-10-01,6,0,6
70402,SAN CARLOS,salud sexual y reproductiva,hemorragia de la primera mitad del embarazo (< 22 sem) aborto,2017-10-01,2,1,3
80501,SAN IGNACIO,salud sexual y reproductiva,hemorragia de la primera mitad del embarazo (< 22 sem) aborto,2017-10-01,1,0,1
70301,SAN IGNACIO DE VELASCO,salud sexual y reproductiva,hemorragia de la primera mitad del embarazo (< 22 sem) aborto,2017-10-01,8,0,8
70501,SAN JOSE DE CHIQUITOS,salud sexual y reproductiva,hemorragia de la primera mitad del embarazo (< 22 sem) aborto,2017-10-01,8,0,8
71104,SAN JULIAN,salud sexual y reproductiva,hemorragia de la primera mitad del embarazo (< 22 sem) aborto,2017-10-01,16,0,16
10702,SAN LUCAS,salud sexual y reproductiva,hemorragia de la primera mitad del embarazo (< 22 sem) aborto,2017-10-01,1,0,1
71201,SAN MATIAS,salud sexual y reproductiva,hemorragia de la primera mitad del embarazo (< 22 sem) aborto,2017-10-01,0,2,2
70302,SAN MIGUEL DE VELASCO,salud sexual y reproductiva,hemorragia de la primera mitad del embarazo (< 22 sem) aborto,2017-10-01,2,0,2
80702,SAN RAMON BENI,salud sexual y reproductiva,hemorragia de la primera mitad del embarazo (< 22 sem) aborto,2017-10-01,1,0,1
80401,SANTA ANA,salud sexual y reproductiva,hemorragia de la primera mitad del embarazo (< 22 sem) aborto,2017-10-01,4,0,4
70101,SANTA CRUZ DE LA SIERRA,salud sexual y reproductiva,hemorragia de la primera mitad del embarazo (< 22 sem) aborto,2017-10-01,321,130,451
70602,SANTA ROSA DEL SARA,salud sexual y reproductiva,hemorragia de la primera mitad del embarazo (< 22 sem) aborto,2017-10-01,2,0,2
90303,SENA,salud sexual y reproductiva,hemorragia de la primera mitad del embarazo (< 22 sem) aborto,2017-10-01,1,0,1
31602,SHINAOTA,salud sexual y reproductiva,hemorragia de la primera mitad del embarazo (< 22 sem) aborto,2017-10-01,16,0,16
21301,SICA SICA (VILLA AROMA),salud sexual y reproductiva,hemorragia de la primera mitad del embarazo (< 22 sem) aborto,2017-10-01,2,0,2
10101,SUCRE,salud sexual y reproductiva,hemorragia de la primera mitad del embarazo (< 22 sem) aborto,2017-10-01,86,39,125
30602,TACOPAYA,salud sexual y reproductiva,hemorragia de la primera mitad del embarazo (< 22 sem) aborto,2017-10-01,2,1,3
30401,TARATA,salud sexual y reproductiva,hemorragia de la primera mitad del embarazo (< 22 sem) aborto,2017-10-01,3,1,4
60101,TARIJA,salud sexual y reproductiva,hemorragia de la primera mitad del embarazo (< 22 sem) aborto,2017-10-01,70,2,72
10202,TARVITA,salud sexual y reproductiva,hemorragia de la primera mitad del embarazo (< 22 sem) aborto,2017-10-01,0,1,1
20606,TIPUANI,salud sexual y reproductiva,hemorragia de la primera mitad del embarazo (< 22 sem) aborto,2017-10-01,1,0,1
30903,TIQUIPAYA,salud sexual y reproductiva,hemorragia de la primera mitad del embarazo (< 22 sem) aborto,2017-10-01,1,0,1
30802,TOCO,salud sexual y reproductiva,hemorragia de la primera mitad del embarazo (< 22 sem) aborto,2017-10-01,0,1,1
10402,TOMINA,salud sexual y reproductiva,hemorragia de la primera mitad del embarazo (< 22 sem) aborto,2017-10-01,1,1,2
31201,TOTORA(CBBA),salud sexual y reproductiva,hemorragia de la primera mitad del embarazo (< 22 sem) aborto,2017-10-01,3,1,4
80101,TRINIDAD,salud sexual y reproductiva,hemorragia de la primera mitad del embarazo (< 22 sem) aborto,2017-10-01,26,10,36
50801,TUPIZA,salud sexual y reproductiva,hemorragia de la primera mitad del embarazo (< 22 sem) aborto,2017-10-01,5,0,5
60401,URIONDO (A. CONCEPCION),salud sexual y reproductiva,hemorragia de la primera mitad del embarazo (< 22 sem) aborto,2017-10-01,1,0,1
51201,UYUNI,salud sexual y reproductiva,hemorragia de la primera mitad del embarazo (< 22 sem) aborto,2017-10-01,4,0,4
30502,VACAS,salud sexual y reproductiva,hemorragia de la primera mitad del embarazo (< 22 sem) aborto,2017-10-01,2,0,2
70801,VALLEGRANDE,salud sexual y reproductiva,hemorragia de la primera mitad del embarazo (< 22 sem) aborto,2017-10-01,3,0,3
20801,VIACHA,salud sexual y reproductiva,hemorragia de la primera mitad del embarazo (< 22 sem) aborto,2017-10-01,2,0,2
31003,VILLA TUNARI,salud sexual y reproductiva,hemorragia de la primera mitad del embarazo (< 22 sem) aborto,2017-10-01,7,0,7
51501,VILLAZON,salud sexual y reproductiva,hemorragia de la primera mitad del embarazo (< 22 sem) aborto,2017-10-01,12,0,12
30904,VINTO,salud sexual y reproductiva,hemorragia de la primera mitad del embarazo (< 22 sem) aborto,2017-10-01,11,0,11
70201,WARNES,salud sexual y reproductiva,hemorragia de la primera mitad del embarazo (< 22 sem) aborto,2017-10-01,14,16,30
60301,YACUIBA,salud sexual y reproductiva,hemorragia de la primera mitad del embarazo (< 22 sem) aborto,2017-10-01,5,0,5
70403,YAPACANI,salud sexual y reproductiva,hemorragia de la primera mitad del embarazo (< 22 sem) aborto,2017-10-01,11,0,11
10102,YOTALA,salud sexual y reproductiva,hemorragia de la primera mitad del embarazo (< 22 sem) aborto,2017-10-01,2,0,2
30201,AIQUILE,salud sexual y reproductiva,hemorragia de la primera mitad del embarazo (< 22 sem) aborto,2017-11-01,17,0,17
30403,ARBIETO,salud sexual y reproductiva,hemorragia de la primera mitad del embarazo (< 22 sem) aborto,2017-11-01,2,0,2
30601,ARQUE,salud sexual y reproductiva,hemorragia de la primera mitad del embarazo (< 22 sem) aborto,2017-11-01,2,0,2
71501,ASCENCION DE GUARAYOS,salud sexual y reproductiva,hemorragia de la primera mitad del embarazo (< 22 sem) aborto,2017-11-01,2,7,9
30301,AYOPAYA (V. DE INDEPENDENCIA),salud sexual y reproductiva,hemorragia de la primera mitad del embarazo (< 22 sem) aborto,2017-11-01,2,0,2
50301,BETANZOS,salud sexual y reproductiva,hemorragia de la primera mitad del embarazo (< 22 sem) aborto,2017-11-01,4,0,4
31501,BOLIVAR,salud sexual y reproductiva,hemorragia de la primera mitad del embarazo (< 22 sem) aborto,2017-11-01,1,0,1
21003,CAJUATA,salud sexual y reproductiva,hemorragia de la primera mitad del embarazo (< 22 sem) aborto,2017-11-01,1,0,1
10701,CAMARGO,salud sexual y reproductiva,hemorragia de la primera mitad del embarazo (< 22 sem) aborto,2017-11-01,2,1,3
70706,CAMIRI,salud sexual y reproductiva,hemorragia de la primera mitad del embarazo (< 22 sem) aborto,2017-11-01,12,6,18
30701,CAPINOTA,salud sexual y reproductiva,hemorragia de la primera mitad del embarazo (< 22 sem) aborto,2017-11-01,4,0,4
22001,CARANAVI,salud sexual y reproductiva,hemorragia de la primera mitad del embarazo (< 22 sem) aborto,2017-11-01,27,1,28
70702,CHARAGUA,salud sexual y reproductiva,hemorragia de la primera mitad del embarazo (< 22 sem) aborto,2017-11-01,1,0,1
31204,CHIMORE,salud sexual y reproductiva,hemorragia de la primera mitad del embarazo (< 22 sem) aborto,2017-11-01,5,0,5
21101,CHULUMANI (V. DE LA LIBERTAD),salud sexual y reproductiva,hemorragia de la primera mitad del embarazo (< 22 sem) aborto,2017-11-01,8,0,8
51103,CKOCHAS,salud sexual y reproductiva,hemorragia de la primera mitad del embarazo (< 22 sem) aborto,2017-11-01,1,0,1
30801,CLIZA,salud sexual y reproductiva,hemorragia de la primera mitad del embarazo (< 22 sem) aborto,2017-11-01,2,0,2
90101,COBIJA,salud sexual y reproductiva,hemorragia de la primera mitad del embarazo (< 22 sem) aborto,2017-11-01,34,0,34
30101,COCHABAMBA,salud sexual y reproductiva,hemorragia de la primera mitad del embarazo (< 22 sem) aborto,2017-11-01,221,9,230
30905,COLCAPIRHUA,salud sexual y reproductiva,hemorragia de la primera mitad del embarazo (< 22 sem) aborto,2017-11-01,5,5,10
21004,COLQUIRI,salud sexual y reproductiva,hemorragia de la primera mitad del embarazo (< 22 sem) aborto,2017-11-01,0,1,1
71301,COMARAPA,salud sexual y reproductiva,hemorragia de la primera mitad del embarazo (< 22 sem) aborto,2017-11-01,5,0,5
20301,CORO CORO,salud sexual y reproductiva,hemorragia de la primera mitad del embarazo (< 22 sem) aborto,2017-11-01,1,0,1
21401,COROICO,salud sexual y reproductiva,hemorragia de la primera mitad del embarazo (< 22 sem) aborto,2017-11-01,4,0,4
70102,COTOCA,salud sexual y reproductiva,hemorragia de la primera mitad del embarazo (< 22 sem) aborto,2017-11-01,17,0,17
71106,CUATRO CAÃ‘ADAS,salud sexual y reproductiva,hemorragia de la primera mitad del embarazo (< 22 sem) aborto,2017-11-01,1,0,1
10902,CULPINA,salud sexual y reproductiva,hemorragia de la primera mitad del embarazo (< 22 sem) aborto,2017-11-01,5,0,5
20105,EL ALTO,salud sexual y reproductiva,hemorragia de la primera mitad del embarazo (< 22 sem) aborto,2017-11-01,153,6,159
71503,EL PUENTE(STC),salud sexual y reproductiva,hemorragia de la primera mitad del embarazo (< 22 sem) aborto,2017-11-01,1,0,1
70105,EL TORNO,salud sexual y reproductiva,hemorragia de la primera mitad del embarazo (< 22 sem) aborto,2017-11-01,10,0,10
31206,ENTRE RIOS CBBA,salud sexual y reproductiva,hemorragia de la primera mitad del embarazo (< 22 sem) aborto,2017-11-01,5,0,5
80202,GUAYARAMERIN,salud sexual y reproductiva,hemorragia de la primera mitad del embarazo (< 22 sem) aborto,2017-11-01,1,0,1
40701,HUANUNI,salud sexual y reproductiva,hemorragia de la primera mitad del embarazo (< 22 sem) aborto,2017-11-01,7,0,7
70104,LA GUARDIA,salud sexual y reproductiva,hemorragia de la primera mitad del embarazo (< 22 sem) aborto,2017-11-01,0,16,16
20101,LA PAZ,salud sexual y reproductiva,hemorragia de la primera mitad del embarazo (< 22 sem) aborto,2017-11-01,237,1,238
70701,LAGUNILLAS,salud sexual y reproductiva,hemorragia de la primera mitad del embarazo (< 22 sem) aborto,2017-11-01,1,0,1
11003,MACHARETI,salud sexual y reproductiva,hemorragia de la primera mitad del embarazo (< 22 sem) aborto,2017-11-01,0,1,1
70903,MAIRANA,salud sexual y reproductiva,hemorragia de la primera mitad del embarazo (< 22 sem) aborto,2017-11-01,3,0,3
20607,MAPIRI,salud sexual y reproductiva,hemorragia de la primera mitad del embarazo (< 22 sem) aborto,2017-11-01,0,3,3
31301,MIZQUE,salud sexual y reproductiva,hemorragia de la primera mitad del embarazo (< 22 sem) aborto,2017-11-01,1,0,1
10501,MONTEAGUDO,salud sexual y reproductiva,hemorragia de la primera mitad del embarazo (< 22 sem) aborto,2017-11-01,0,1,1
71001,MONTERO,salud sexual y reproductiva,hemorragia de la primera mitad del embarazo (< 22 sem) aborto,2017-11-01,4,3,7
70803,MORO MORO,salud sexual y reproductiva,hemorragia de la primera mitad del embarazo (< 22 sem) aborto,2017-11-01,1,0,1
30302,MOROCHATA,salud sexual y reproductiva,hemorragia de la primera mitad del embarazo (< 22 sem) aborto,2017-11-01,0,4,4
90401,NACEBE (SANTA ROSA DEL ABUNA),salud sexual y reproductiva,hemorragia de la primera mitad del embarazo (< 22 sem) aborto,2017-11-01,1,0,1
50404,OCURI,salud sexual y reproductiva,hemorragia de la primera mitad del embarazo (< 22 sem) aborto,2017-11-01,3,0,3
40101,ORURO,salud sexual y reproductiva,hemorragia de la primera mitad del embarazo (< 22 sem) aborto,2017-11-01,105,2,107
60201,PADCAYA,salud sexual y reproductiva,hemorragia de la primera mitad del embarazo (< 22 sem) aborto,2017-11-01,0,1,1
10401,PADILLA,salud sexual y reproductiva,hemorragia de la primera mitad del embarazo (< 22 sem) aborto,2017-11-01,2,0,2
70502,PAILON,salud sexual y reproductiva,hemorragia de la primera mitad del embarazo (< 22 sem) aborto,2017-11-01,3,0,3
40602,PAZÃ‘A,salud sexual y reproductiva,hemorragia de la primera mitad del embarazo (< 22 sem) aborto,2017-11-01,0,1,1
31203,POCONA,salud sexual y reproductiva,hemorragia de la primera mitad del embarazo (< 22 sem) aborto,2017-11-01,3,0,3
31202,POJO (CBBA),salud sexual y reproductiva,hemorragia de la primera mitad del embarazo (< 22 sem) aborto,2017-11-01,3,0,3
50101,POTOSI,salud sexual y reproductiva,hemorragia de la primera mitad del embarazo (< 22 sem) aborto,2017-11-01,25,0,25
10302,PRESTO,salud sexual y reproductiva,hemorragia de la primera mitad del embarazo (< 22 sem) aborto,2017-11-01,0,1,1
90201,PUERTO RICO,salud sexual y reproductiva,hemorragia de la primera mitad del embarazo (< 22 sem) aborto,2017-11-01,1,0,1
71401,PUERTO SUAREZ,salud sexual y reproductiva,hemorragia de la primera mitad del embarazo (< 22 sem) aborto,2017-11-01,4,0,4
31205,PUERTO VILLARROEL,salud sexual y reproductiva,hemorragia de la primera mitad del embarazo (< 22 sem) aborto,2017-11-01,36,0,36
31401,PUNATA,salud sexual y reproductiva,hemorragia de la primera mitad del embarazo (< 22 sem) aborto,2017-11-01,14,0,14
30901,QUILLACOLLO,salud sexual y reproductiva,hemorragia de la primera mitad del embarazo (< 22 sem) aborto,2017-11-01,66,0,66
80201,RIBERALTA,salud sexual y reproductiva,hemorragia de la primera mitad del embarazo (< 22 sem) aborto,2017-11-01,3,0,3
70503,ROBORE,salud sexual y reproductiva,hemorragia de la primera mitad del embarazo (< 22 sem) aborto,2017-11-01,3,3,6
80304,RURRENABAQUE,salud sexual y reproductiva,hemorragia de la primera mitad del embarazo (< 22 sem) aborto,2017-11-01,10,0,10
31001,SACABA,salud sexual y reproductiva,hemorragia de la primera mitad del embarazo (< 22 sem) aborto,2017-11-01,60,10,70
80302,SAN BORJA,salud sexual y reproductiva,hemorragia de la primera mitad del embarazo (< 22 sem) aborto,2017-11-01,10,1,11
21502,SAN BUENA VENTURA,salud sexual y reproductiva,hemorragia de la primera mitad del embarazo (< 22 sem) aborto,2017-11-01,4,0,4
70402,SAN CARLOS,salud sexual y reproductiva,hemorragia de la primera mitad del embarazo (< 22 sem) aborto,2017-11-01,3,0,3
80501,SAN IGNACIO,salud sexual y reproductiva,hemorragia de la primera mitad del embarazo (< 22 sem) aborto,2017-11-01,4,0,4
70301,SAN IGNACIO DE VELASCO,salud sexual y reproductiva,hemorragia de la primera mitad del embarazo (< 22 sem) aborto,2017-11-01,6,1,7
70501,SAN JOSE DE CHIQUITOS,salud sexual y reproductiva,hemorragia de la primera mitad del embarazo (< 22 sem) aborto,2017-11-01,6,0,6
71104,SAN JULIAN,salud sexual y reproductiva,hemorragia de la primera mitad del embarazo (< 22 sem) aborto,2017-11-01,8,0,8
71201,SAN MATIAS,salud sexual y reproductiva,hemorragia de la primera mitad del embarazo (< 22 sem) aborto,2017-11-01,6,0,6
70302,SAN MIGUEL DE VELASCO,salud sexual y reproductiva,hemorragia de la primera mitad del embarazo (< 22 sem) aborto,2017-11-01,2,0,2
51001,SAN PABLO DE LIPEZ,salud sexual y reproductiva,hemorragia de la primera mitad del embarazo (< 22 sem) aborto,2017-11-01,0,2,2
80702,SAN RAMON BENI,salud sexual y reproductiva,hemorragia de la primera mitad del embarazo (< 22 sem) aborto,2017-11-01,1,0,1
71103,SAN RAMON SCZ,salud sexual y reproductiva,hemorragia de la primera mitad del embarazo (< 22 sem) aborto,2017-11-01,3,0,3
80401,SANTA ANA,salud sexual y reproductiva,hemorragia de la primera mitad del embarazo (< 22 sem) aborto,2017-11-01,13,0,13
70101,SANTA CRUZ DE LA SIERRA,salud sexual y reproductiva,hemorragia de la primera mitad del embarazo (< 22 sem) aborto,2017-11-01,368,124,492
70602,SANTA ROSA DEL SARA,salud sexual y reproductiva,hemorragia de la primera mitad del embarazo (< 22 sem) aborto,2017-11-01,1,0,1
90303,SENA,salud sexual y reproductiva,hemorragia de la primera mitad del embarazo (< 22 sem) aborto,2017-11-01,0,2,2
31602,SHINAOTA,salud sexual y reproductiva,hemorragia de la primera mitad del embarazo (< 22 sem) aborto,2017-11-01,19,0,19
21301,SICA SICA (VILLA AROMA),salud sexual y reproductiva,hemorragia de la primera mitad del embarazo (< 22 sem) aborto,2017-11-01,1,0,1
30902,SIPE SIPE,salud sexual y reproductiva,hemorragia de la primera mitad del embarazo (< 22 sem) aborto,2017-11-01,7,0,7
10101,SUCRE,salud sexual y reproductiva,hemorragia de la primera mitad del embarazo (< 22 sem) aborto,2017-11-01,119,23,142
31404,TACACHI,salud sexual y reproductiva,hemorragia de la primera mitad del embarazo (< 22 sem) aborto,2017-11-01,1,0,1
50303,TACOBAMBA,salud sexual y reproductiva,hemorragia de la primera mitad del embarazo (< 22 sem) aborto,2017-11-01,0,1,1
30602,TACOPAYA,salud sexual y reproductiva,hemorragia de la primera mitad del embarazo (< 22 sem) aborto,2017-11-01,1,0,1
51402,TAHUA,salud sexual y reproductiva,hemorragia de la primera mitad del embarazo (< 22 sem) aborto,2017-11-01,0,1,1
31101,TAPACARI,salud sexual y reproductiva,hemorragia de la primera mitad del embarazo (< 22 sem) aborto,2017-11-01,1,0,1
10601,TARABUCO,salud sexual y reproductiva,hemorragia de la primera mitad del embarazo (< 22 sem) aborto,2017-11-01,0,2,2
30401,TARATA,salud sexual y reproductiva,hemorragia de la primera mitad del embarazo (< 22 sem) aborto,2017-11-01,2,0,2
60101,TARIJA,salud sexual y reproductiva,hemorragia de la primera mitad del embarazo (< 22 sem) aborto,2017-11-01,73,3,76
20606,TIPUANI,salud sexual y reproductiva,hemorragia de la primera mitad del embarazo (< 22 sem) aborto,2017-11-01,1,0,1
30903,TIQUIPAYA,salud sexual y reproductiva,hemorragia de la primera mitad del embarazo (< 22 sem) aborto,2017-11-01,2,0,2
30802,TOCO,salud sexual y reproductiva,hemorragia de la primera mitad del embarazo (< 22 sem) aborto,2017-11-01,0,1,1
30803,TOLATA,salud sexual y reproductiva,hemorragia de la primera mitad del embarazo (< 22 sem) aborto,2017-11-01,1,0,1
10402,TOMINA,salud sexual y reproductiva,hemorragia de la primera mitad del embarazo (< 22 sem) aborto,2017-11-01,1,0,1
31201,TOTORA(CBBA),salud sexual y reproductiva,hemorragia de la primera mitad del embarazo (< 22 sem) aborto,2017-11-01,6,1,7
80101,TRINIDAD,salud sexual y reproductiva,hemorragia de la primera mitad del embarazo (< 22 sem) aborto,2017-11-01,60,7,67
50801,TUPIZA,salud sexual y reproductiva,hemorragia de la primera mitad del embarazo (< 22 sem) aborto,2017-11-01,8,0,8
51201,UYUNI,salud sexual y reproductiva,hemorragia de la primera mitad del embarazo (< 22 sem) aborto,2017-11-01,7,0,7
30502,VACAS,salud sexual y reproductiva,hemorragia de la primera mitad del embarazo (< 22 sem) aborto,2017-11-01,2,0,2
70801,VALLEGRANDE,salud sexual y reproductiva,hemorragia de la primera mitad del embarazo (< 22 sem) aborto,2017-11-01,1,0,1
60303,VILLA MONTES,salud sexual y reproductiva,hemorragia de la primera mitad del embarazo (< 22 sem) aborto,2017-11-01,0,9,9
90502,VILLA NUEVA (LOMA ALTA),salud sexual y reproductiva,hemorragia de la primera mitad del embarazo (< 22 sem) aborto,2017-11-01,0,1,1
31003,VILLA TUNARI,salud sexual y reproductiva,hemorragia de la primera mitad del embarazo (< 22 sem) aborto,2017-11-01,8,0,8
11001,VILLA VACA GUZMAN (MUYUPAMPA),salud sexual y reproductiva,hemorragia de la primera mitad del embarazo (< 22 sem) aborto,2017-11-01,1,1,2
51501,VILLAZON,salud sexual y reproductiva,hemorragia de la primera mitad del embarazo (< 22 sem) aborto,2017-11-01,8,0,8
30904,VINTO,salud sexual y reproductiva,hemorragia de la primera mitad del embarazo (< 22 sem) aborto,2017-11-01,6,0,6
70201,WARNES,salud sexual y reproductiva,hemorragia de la primera mitad del embarazo (< 22 sem) aborto,2017-11-01,23,6,29
60301,YACUIBA,salud sexual y reproductiva,hemorragia de la primera mitad del embarazo (< 22 sem) aborto,2017-11-01,5,1,6
70403,YAPACANI,salud sexual y reproductiva,hemorragia de la primera mitad del embarazo (< 22 sem) aborto,2017-11-01,20,1,21
20104,ACHOCALLA,salud sexual y reproductiva,hemorragia de la primera mitad del embarazo (< 22 sem) aborto,2017-12-01,1,0,1
30201,AIQUILE,salud sexual y reproductiva,hemorragia de la primera mitad del embarazo (< 22 sem) aborto,2017-12-01,13,0,13
10404,ALCALA,salud sexual y reproductiva,hemorragia de la primera mitad del embarazo (< 22 sem) aborto,2017-12-01,1,0,1
30601,ARQUE,salud sexual y reproductiva,hemorragia de la primera mitad del embarazo (< 22 sem) aborto,2017-12-01,1,0,1
71501,ASCENCION DE GUARAYOS,salud sexual y reproductiva,hemorragia de la primera mitad del embarazo (< 22 sem) aborto,2017-12-01,4,10,14
50802,ATOCHA,salud sexual y reproductiva,hemorragia de la primera mitad del embarazo (< 22 sem) aborto,2017-12-01,0,2,2
30301,AYOPAYA (V. DE INDEPENDENCIA),salud sexual y reproductiva,hemorragia de la primera mitad del embarazo (< 22 sem) aborto,2017-12-01,1,0,1
60202,BERMEJO,salud sexual y reproductiva,hemorragia de la primera mitad del embarazo (< 22 sem) aborto,2017-12-01,1,0,1
50301,BETANZOS,salud sexual y reproductiva,hemorragia de la primera mitad del embarazo (< 22 sem) aborto,2017-12-01,7,0,7
10701,CAMARGO,salud sexual y reproductiva,hemorragia de la primera mitad del embarazo (< 22 sem) aborto,2017-12-01,1,2,3
70706,CAMIRI,salud sexual y reproductiva,hemorragia de la primera mitad del embarazo (< 22 sem) aborto,2017-12-01,13,0,13
30701,CAPINOTA,salud sexual y reproductiva,hemorragia de la primera mitad del embarazo (< 22 sem) aborto,2017-12-01,3,0,3
40102,CARACOLLO,salud sexual y reproductiva,hemorragia de la primera mitad del embarazo (< 22 sem) aborto,2017-12-01,1,0,1
22001,CARANAVI,salud sexual y reproductiva,hemorragia de la primera mitad del embarazo (< 22 sem) aborto,2017-12-01,9,1,10
70702,CHARAGUA,salud sexual y reproductiva,hemorragia de la primera mitad del embarazo (< 22 sem) aborto,2017-12-01,5,0,5
31204,CHIMORE,salud sexual y reproductiva,hemorragia de la primera mitad del embarazo (< 22 sem) aborto,2017-12-01,2,0,2
21101,CHULUMANI (V. DE LA LIBERTAD),salud sexual y reproductiva,hemorragia de la primera mitad del embarazo (< 22 sem) aborto,2017-12-01,7,0,7
30801,CLIZA,salud sexual y reproductiva,hemorragia de la primera mitad del embarazo (< 22 sem) aborto,2017-12-01,9,0,9
90101,COBIJA,salud sexual y reproductiva,hemorragia de la primera mitad del embarazo (< 22 sem) aborto,2017-12-01,19,1,20
30303,COCAPATA,salud sexual y reproductiva,hemorragia de la primera mitad del embarazo (< 22 sem) aborto,2017-12-01,1,0,1
30101,COCHABAMBA,salud sexual y reproductiva,hemorragia de la primera mitad del embarazo (< 22 sem) aborto,2017-12-01,181,3,184
30905,COLCAPIRHUA,salud sexual y reproductiva,hemorragia de la primera mitad del embarazo (< 22 sem) aborto,2017-12-01,4,1,5
71301,COMARAPA,salud sexual y reproductiva,hemorragia de la primera mitad del embarazo (< 22 sem) aborto,2017-12-01,3,0,3
71101,CONCEPCION,salud sexual y reproductiva,hemorragia de la primera mitad del embarazo (< 22 sem) aborto,2017-12-01,1,0,1
20301,CORO CORO,salud sexual y reproductiva,hemorragia de la primera mitad del embarazo (< 22 sem) aborto,2017-12-01,1,0,1
50601,COTAGAITA,salud sexual y reproductiva,hemorragia de la primera mitad del embarazo (< 22 sem) aborto,2017-12-01,1,0,1
70102,COTOCA,salud sexual y reproductiva,hemorragia de la primera mitad del embarazo (< 22 sem) aborto,2017-12-01,12,0,12
71106,CUATRO CAÃ‘ADAS,salud sexual y reproductiva,hemorragia de la primera mitad del embarazo (< 22 sem) aborto,2017-12-01,3,0,3
10902,CULPINA,salud sexual y reproductiva,hemorragia de la primera mitad del embarazo (< 22 sem) aborto,2017-12-01,7,0,7
20105,EL ALTO,salud sexual y reproductiva,hemorragia de la primera mitad del embarazo (< 22 sem) aborto,2017-12-01,96,6,102
70105,EL TORNO,salud sexual y reproductiva,hemorragia de la primera mitad del embarazo (< 22 sem) aborto,2017-12-01,15,0,15
60601,ENTRE RIOS TRJ,salud sexual y reproductiva,hemorragia de la primera mitad del embarazo (< 22 sem) aborto,2017-12-01,1,0,1
31206,ENTRE RIOS CBBA,salud sexual y reproductiva,hemorragia de la primera mitad del embarazo (< 22 sem) aborto,2017-12-01,10,0,10
71004,FERNANDEZ ALONSO,salud sexual y reproductiva,hemorragia de la primera mitad del embarazo (< 22 sem) aborto,2017-12-01,1,0,1
80202,GUAYARAMERIN,salud sexual y reproductiva,hemorragia de la primera mitad del embarazo (< 22 sem) aborto,2017-12-01,3,0,3
40701,HUANUNI,salud sexual y reproductiva,hemorragia de la primera mitad del embarazo (< 22 sem) aborto,2017-12-01,3,1,4
10703,INCAHUASI,salud sexual y reproductiva,hemorragia de la primera mitad del embarazo (< 22 sem) aborto,2017-12-01,0,1,1
21105,LA ASUNTA,salud sexual y reproductiva,hemorragia de la primera mitad del embarazo (< 22 sem) aborto,2017-12-01,1,1,2
70104,LA GUARDIA,salud sexual y reproductiva,hemorragia de la primera mitad del embarazo (< 22 sem) aborto,2017-12-01,0,12,12
20101,LA PAZ,salud sexual y reproductiva,hemorragia de la primera mitad del embarazo (< 22 sem) aborto,2017-12-01,169,6,175
80801,MAGDALENA,salud sexual y reproductiva,hemorragia de la primera mitad del embarazo (< 22 sem) aborto,2017-12-01,1,1,2
70903,MAIRANA,salud sexual y reproductiva,hemorragia de la primera mitad del embarazo (< 22 sem) aborto,2017-12-01,9,0,9
10501,MONTEAGUDO,salud sexual y reproductiva,hemorragia de la primera mitad del embarazo (< 22 sem) aborto,2017-12-01,0,1,1
30302,MOROCHATA,salud sexual y reproductiva,hemorragia de la primera mitad del embarazo (< 22 sem) aborto,2017-12-01,0,2,2
50404,OCURI,salud sexual y reproductiva,hemorragia de la primera mitad del embarazo (< 22 sem) aborto,2017-12-01,1,0,1
40101,ORURO,salud sexual y reproductiva,hemorragia de la primera mitad del embarazo (< 22 sem) aborto,2017-12-01,28,6,34
10401,PADILLA,salud sexual y reproductiva,hemorragia de la primera mitad del embarazo (< 22 sem) aborto,2017-12-01,8,0,8
70502,PAILON,salud sexual y reproductiva,hemorragia de la primera mitad del embarazo (< 22 sem) aborto,2017-12-01,1,0,1
31202,POJO (CBBA),salud sexual y reproductiva,hemorragia de la primera mitad del embarazo (< 22 sem) aborto,2017-12-01,2,0,2
10103,POROMA,salud sexual y reproductiva,hemorragia de la primera mitad del embarazo (< 22 sem) aborto,2017-12-01,2,0,2
50101,POTOSI,salud sexual y reproductiva,hemorragia de la primera mitad del embarazo (< 22 sem) aborto,2017-12-01,14,0,14
90301,PUERTO GONZALO MORENO,salud sexual y reproductiva,hemorragia de la primera mitad del embarazo (< 22 sem) aborto,2017-12-01,1,0,1
90201,PUERTO RICO,salud sexual y reproductiva,hemorragia de la primera mitad del embarazo (< 22 sem) aborto,2017-12-01,2,1,3
31205,PUERTO VILLARROEL,salud sexual y reproductiva,hemorragia de la primera mitad del embarazo (< 22 sem) aborto,2017-12-01,20,0,20
31401,PUNATA,salud sexual y reproductiva,hemorragia de la primera mitad del embarazo (< 22 sem) aborto,2017-12-01,13,1,14
30901,QUILLACOLLO,salud sexual y reproductiva,hemorragia de la primera mitad del embarazo (< 22 sem) aborto,2017-12-01,55,0,55
70503,ROBORE,salud sexual y reproductiva,hemorragia de la primera mitad del embarazo (< 22 sem) aborto,2017-12-01,3,0,3
80304,RURRENABAQUE,salud sexual y reproductiva,hemorragia de la primera mitad del embarazo (< 22 sem) aborto,2017-12-01,7,0,7
31001,SACABA,salud sexual y reproductiva,hemorragia de la primera mitad del embarazo (< 22 sem) aborto,2017-12-01,36,4,40
80302,SAN BORJA,salud sexual y reproductiva,hemorragia de la primera mitad del embarazo (< 22 sem) aborto,2017-12-01,15,0,15
21502,SAN BUENA VENTURA,salud sexual y reproductiva,hemorragia de la primera mitad del embarazo (< 22 sem) aborto,2017-12-01,1,0,1
70402,SAN CARLOS,salud sexual y reproductiva,hemorragia de la primera mitad del embarazo (< 22 sem) aborto,2017-12-01,3,0,3
80501,SAN IGNACIO,salud sexual y reproductiva,hemorragia de la primera mitad del embarazo (< 22 sem) aborto,2017-12-01,1,0,1
70301,SAN IGNACIO DE VELASCO,salud sexual y reproductiva,hemorragia de la primera mitad del embarazo (< 22 sem) aborto,2017-12-01,2,0,2
70501,SAN JOSE DE CHIQUITOS,salud sexual y reproductiva,hemorragia de la primera mitad del embarazo (< 22 sem) aborto,2017-12-01,3,0,3
71104,SAN JULIAN,salud sexual y reproductiva,hemorragia de la primera mitad del embarazo (< 22 sem) aborto,2017-12-01,13,0,13
71201,SAN MATIAS,salud sexual y reproductiva,hemorragia de la primera mitad del embarazo (< 22 sem) aborto,2017-12-01,1,0,1
50501,SAN PEDRO DE BUENA VISTA,salud sexual y reproductiva,hemorragia de la primera mitad del embarazo (< 22 sem) aborto,2017-12-01,0,2,2
21702,SAN PEDRO DE TIQUINA,salud sexual y reproductiva,hemorragia de la primera mitad del embarazo (< 22 sem) aborto,2017-12-01,1,0,1
71103,SAN RAMON SCZ,salud sexual y reproductiva,hemorragia de la primera mitad del embarazo (< 22 sem) aborto,2017-12-01,1,0,1
80401,SANTA ANA,salud sexual y reproductiva,hemorragia de la primera mitad del embarazo (< 22 sem) aborto,2017-12-01,7,0,7
70101,SANTA CRUZ DE LA SIERRA,salud sexual y reproductiva,hemorragia de la primera mitad del embarazo (< 22 sem) aborto,2017-12-01,322,99,421
31602,SHINAOTA,salud sexual y reproductiva,hemorragia de la primera mitad del embarazo (< 22 sem) aborto,2017-12-01,2,0,2
10403,SOPACHUY,salud sexual y reproductiva,hemorragia de la primera mitad del embarazo (< 22 sem) aborto,2017-12-01,0,1,1
10101,SUCRE,salud sexual y reproductiva,hemorragia de la primera mitad del embarazo (< 22 sem) aborto,2017-12-01,76,16,92
10601,TARABUCO,salud sexual y reproductiva,hemorragia de la primera mitad del embarazo (< 22 sem) aborto,2017-12-01,0,2,2
60101,TARIJA,salud sexual y reproductiva,hemorragia de la primera mitad del embarazo (< 22 sem) aborto,2017-12-01,58,0,58
20606,TIPUANI,salud sexual y reproductiva,hemorragia de la primera mitad del embarazo (< 22 sem) aborto,2017-12-01,2,0,2
10402,TOMINA,salud sexual y reproductiva,hemorragia de la primera mitad del embarazo (< 22 sem) aborto,2017-12-01,0,2,2
31201,TOTORA(CBBA),salud sexual y reproductiva,hemorragia de la primera mitad del embarazo (< 22 sem) aborto,2017-12-01,4,1,5
80101,TRINIDAD,salud sexual y reproductiva,hemorragia de la primera mitad del embarazo (< 22 sem) aborto,2017-12-01,38,4,42
51201,UYUNI,salud sexual y reproductiva,hemorragia de la primera mitad del embarazo (< 22 sem) aborto,2017-12-01,4,0,4
20801,VIACHA,salud sexual y reproductiva,hemorragia de la primera mitad del embarazo (< 22 sem) aborto,2017-12-01,2,5,7
10801,VILLA SERRANO,salud sexual y reproductiva,hemorragia de la primera mitad del embarazo (< 22 sem) aborto,2017-12-01,0,1,1
31003,VILLA TUNARI,salud sexual y reproductiva,hemorragia de la primera mitad del embarazo (< 22 sem) aborto,2017-12-01,5,0,5
11001,VILLA VACA GUZMAN (MUYUPAMPA),salud sexual y reproductiva,hemorragia de la primera mitad del embarazo (< 22 sem) aborto,2017-12-01,0,1,1
51501,VILLAZON,salud sexual y reproductiva,hemorragia de la primera mitad del embarazo (< 22 sem) aborto,2017-12-01,7,1,8
30904,VINTO,salud sexual y reproductiva,hemorragia de la primera mitad del embarazo (< 22 sem) aborto,2017-12-01,5,0,5
70201,WARNES,salud sexual y reproductiva,hemorragia de la primera mitad del embarazo (< 22 sem) aborto,2017-12-01,0,4,4
60301,YACUIBA,salud sexual y reproductiva,hemorragia de la primera mitad del embarazo (< 22 sem) aborto,2017-12-01,0,3,3
70403,YAPACANI,salud sexual y reproductiva,hemorragia de la primera mitad del embarazo (< 22 sem) aborto,2017-12-01,8,1,9
10102,YOTALA,salud sexual y reproductiva,hemorragia de la primera mitad del embarazo (< 22 sem) aborto,2017-12-01,1,0,1
