codigo_municipio,municipio,grupo,variable,mes,total-H,total-M,TOTAL-H1,TOTAL-M1,TOTAL
51302,ACACIO,estado nutricional en menores de 5 anos,clasificacion a y b,2001-01-01,2,9,2,9,11
20201,ACHACACHI,estado nutricional en menores de 5 anos,clasificacion a y b,2001-01-01,7,25,7,25,32
20104,ACHOCALLA,estado nutricional en menores de 5 anos,clasificacion a y b,2001-01-01,3,10,3,10,13
30201,AIQUILE,estado nutricional en menores de 5 anos,clasificacion a y b,2001-01-01,7,11,7,11,18
31303,ALALAY,estado nutricional en menores de 5 anos,clasificacion a y b,2001-01-01,2,0,2,0,2
10404,ALCALA,estado nutricional en menores de 5 anos,clasificacion a y b,2001-01-01,1,17,1,17,18
20202,ANCORAIMES,estado nutricional en menores de 5 anos,clasificacion a y b,2001-01-01,7,12,7,12,19
41201,ANDAMARCA,estado nutricional en menores de 5 anos,clasificacion a y b,2001-01-01,2,1,2,1,3
40603,ANTEQUERA,estado nutricional en menores de 5 anos,clasificacion a y b,2001-01-01,3,8,3,8,11
20701,APOLO,estado nutricional en menores de 5 anos,clasificacion a y b,2001-01-01,12,2,12,2,14
51301,ARAMPAMPA,estado nutricional en menores de 5 anos,clasificacion a y b,2001-01-01,1,0,1,0,1
30501,ARANI,estado nutricional en menores de 5 anos,clasificacion a y b,2001-01-01,3,22,3,22,25
71501,ASCENCION DE GUARAYOS,estado nutricional en menores de 5 anos,clasificacion a y b,2001-01-01,1,6,1,6,7
50802,ATOCHA,estado nutricional en menores de 5 anos,clasificacion a y b,2001-01-01,1,3,1,3,4
20503,AUCAPATA,estado nutricional en menores de 5 anos,clasificacion a y b,2001-01-01,1,2,1,2,3
30301,AYOPAYA (V. DE INDEPENDENCIA),estado nutricional en menores de 5 anos,clasificacion a y b,2001-01-01,4,8,4,8,12
10201,AZURDUY,estado nutricional en menores de 5 anos,clasificacion a y b,2001-01-01,8,14,8,14,22
21203,BATALLAS,estado nutricional en menores de 5 anos,clasificacion a y b,2001-01-01,1,3,1,3,4
80802,BAURES,estado nutricional en menores de 5 anos,clasificacion a y b,2001-01-01,1,17,1,17,18
50104,BELEN DE URMIRI,estado nutricional en menores de 5 anos,clasificacion a y b,2001-01-01,3,2,3,2,5
90104,BELLA FLOR,estado nutricional en menores de 5 anos,clasificacion a y b,2001-01-01,1,5,1,5,6
60202,BERMEJO,estado nutricional en menores de 5 anos,clasificacion a y b,2001-01-01,19,87,19,87,106
50301,BETANZOS,estado nutricional en menores de 5 anos,clasificacion a y b,2001-01-01,17,40,17,40,57
31501,BOLIVAR,estado nutricional en menores de 5 anos,clasificacion a y b,2001-01-01,0,7,0,7,7
90103,BOLPEBRA,estado nutricional en menores de 5 anos,clasificacion a y b,2001-01-01,1,2,1,2,3
70707,BOYUIBE,estado nutricional en menores de 5 anos,clasificacion a y b,2001-01-01,1,11,1,11,12
70703,CABEZAS,estado nutricional en menores de 5 anos,clasificacion a y b,2001-01-01,3,5,3,5,8
20905,CAIROMA,estado nutricional en menores de 5 anos,clasificacion a y b,2001-01-01,6,0,6,0,6
51102,"CAIZA ""D""",estado nutricional en menores de 5 anos,clasificacion a y b,2001-01-01,0,2,0,2,2
21003,CAJUATA,estado nutricional en menores de 5 anos,clasificacion a y b,2001-01-01,8,28,8,28,36
21304,CALAMARCA,estado nutricional en menores de 5 anos,clasificacion a y b,2001-01-01,4,11,4,11,15
10701,CAMARGO,estado nutricional en menores de 5 anos,clasificacion a y b,2001-01-01,14,25,14,25,39
10901,CAMATAQUI (C. VILLA ABECIA),estado nutricional en menores de 5 anos,clasificacion a y b,2001-01-01,1,7,1,7,8
70706,CAMIRI,estado nutricional en menores de 5 anos,clasificacion a y b,2001-01-01,15,226,15,226,241
30701,CAPINOTA,estado nutricional en menores de 5 anos,clasificacion a y b,2001-01-01,28,24,28,24,52
20302,CAQUIAVIRI,estado nutricional en menores de 5 anos,clasificacion a y b,2001-01-01,0,2,0,2,2
40102,CARACOLLO,estado nutricional en menores de 5 anos,clasificacion a y b,2001-01-01,4,31,4,31,35
22001,CARANAVI,estado nutricional en menores de 5 anos,clasificacion a y b,2001-01-01,20,72,20,72,92
60302,CARAPARI,estado nutricional en menores de 5 anos,clasificacion a y b,2001-01-01,8,32,8,32,40
50702,CARIPUYO,estado nutricional en menores de 5 anos,clasificacion a y b,2001-01-01,0,1,0,1,1
21902,CATACORA,estado nutricional en menores de 5 anos,clasificacion a y b,2001-01-01,0,1,0,1,1
40201,CHALLAPATA,estado nutricional en menores de 5 anos,clasificacion a y b,2001-01-01,4,14,4,14,18
50302,CHAQUI,estado nutricional en menores de 5 anos,clasificacion a y b,2001-01-01,3,22,3,22,25
70702,CHARAGUA,estado nutricional en menores de 5 anos,clasificacion a y b,2001-01-01,28,49,28,49,77
20305,CHARAÃ‘A,estado nutricional en menores de 5 anos,clasificacion a y b,2001-01-01,2,1,2,1,3
50202,CHAYANTA,estado nutricional en menores de 5 anos,clasificacion a y b,2001-01-01,16,31,16,31,47
31204,CHIMORE,estado nutricional en menores de 5 anos,clasificacion a y b,2001-01-01,6,34,6,34,40
21101,CHULUMANI (V. DE LA LIBERTAD),estado nutricional en menores de 5 anos,clasificacion a y b,2001-01-01,6,17,6,17,23
20501,CHUMA,estado nutricional en menores de 5 anos,clasificacion a y b,2001-01-01,0,4,0,4,4
90101,COBIJA,estado nutricional en menores de 5 anos,clasificacion a y b,2001-01-01,30,93,30,93,123
30101,COCHABAMBA,estado nutricional en menores de 5 anos,clasificacion a y b,2001-01-01,1324,1255,1324,1255,2579
30905,COLCAPIRHUA,estado nutricional en menores de 5 anos,clasificacion a y b,2001-01-01,58,20,58,20,78
50901,"COLCHA ""K""",estado nutricional en menores de 5 anos,clasificacion a y b,2001-01-01,7,16,7,16,23
31002,COLOMI,estado nutricional en menores de 5 anos,clasificacion a y b,2001-01-01,10,29,10,29,39
70603,COLPA BELGICA,estado nutricional en menores de 5 anos,clasificacion a y b,2001-01-01,37,3,37,3,40
50401,COLQUECHACA,estado nutricional en menores de 5 anos,clasificacion a y b,2001-01-01,5,5,5,5,10
21306,COLQUENCHA,estado nutricional en menores de 5 anos,clasificacion a y b,2001-01-01,4,11,4,11,15
21004,COLQUIRI,estado nutricional en menores de 5 anos,clasificacion a y b,2001-01-01,7,42,7,42,49
20304,COMANCHE,estado nutricional en menores de 5 anos,clasificacion a y b,2001-01-01,0,2,0,2,2
71301,COMARAPA,estado nutricional en menores de 5 anos,clasificacion a y b,2001-01-01,0,3,0,3,3
20605,COMBAYA,estado nutricional en menores de 5 anos,clasificacion a y b,2001-01-01,0,3,0,3,3
71101,CONCEPCION,estado nutricional en menores de 5 anos,clasificacion a y b,2001-01-01,24,0,24,0,24
21701,COPACABANA,estado nutricional en menores de 5 anos,clasificacion a y b,2001-01-01,1,29,1,29,30
21402,CORIPATA,estado nutricional en menores de 5 anos,clasificacion a y b,2001-01-01,2,8,2,8,10
20301,CORO CORO,estado nutricional en menores de 5 anos,clasificacion a y b,2001-01-01,2,18,2,18,20
21401,COROICO,estado nutricional en menores de 5 anos,clasificacion a y b,2001-01-01,0,1,0,1,1
40301,CORQUE,estado nutricional en menores de 5 anos,clasificacion a y b,2001-01-01,0,5,0,5,5
50601,COTAGAITA,estado nutricional en menores de 5 anos,clasificacion a y b,2001-01-01,1,9,1,9,10
70704,CUEVO,estado nutricional en menores de 5 anos,clasificacion a y b,2001-01-01,17,15,17,15,32
10902,CULPINA,estado nutricional en menores de 5 anos,clasificacion a y b,2001-01-01,9,33,9,33,42
40401,CURAHUARA DE CARANGAS,estado nutricional en menores de 5 anos,clasificacion a y b,2001-01-01,0,6,0,6,6
20804,DESAGUADERO,estado nutricional en menores de 5 anos,clasificacion a y b,2001-01-01,1,7,1,7,8
20105,EL ALTO,estado nutricional en menores de 5 anos,clasificacion a y b,2001-01-01,390,650,390,650,1040
71503,EL PUENTE(STC),estado nutricional en menores de 5 anos,clasificacion a y b,2001-01-01,9,19,9,19,28
60502,EL PUENTE(TJA),estado nutricional en menores de 5 anos,clasificacion a y b,2001-01-01,0,17,0,17,17
70105,EL TORNO,estado nutricional en menores de 5 anos,clasificacion a y b,2001-01-01,30,115,30,115,145
10405,EL VILLAR,estado nutricional en menores de 5 anos,clasificacion a y b,2001-01-01,7,7,7,7,14
60601,ENTRE RIOS,estado nutricional en menores de 5 anos,clasificacion a y b,2001-01-01,16,41,16,41,57
41101,EUCALIPTUS,estado nutricional en menores de 5 anos,clasificacion a y b,2001-01-01,6,8,6,8,14
80402,EXALTACION,estado nutricional en menores de 5 anos,clasificacion a y b,2001-01-01,1,0,1,0,1
71002,GENERAL SAAVEDRA,estado nutricional en menores de 5 anos,clasificacion a y b,2001-01-01,81,39,81,39,120
21601,GRAL. J.J. PEREZ (CHARAZANI),estado nutricional en menores de 5 anos,clasificacion a y b,2001-01-01,1,0,1,0,1
20602,GUANAY,estado nutricional en menores de 5 anos,clasificacion a y b,2001-01-01,28,43,28,43,71
20802,GUAQUI,estado nutricional en menores de 5 anos,clasificacion a y b,2001-01-01,3,5,3,5,8
80202,GUAYARAMERIN,estado nutricional en menores de 5 anos,clasificacion a y b,2001-01-01,12,61,12,61,73
70705,GUTIERREZ,estado nutricional en menores de 5 anos,clasificacion a y b,2001-01-01,18,70,18,70,88
10502,HUACARETA,estado nutricional en menores de 5 anos,clasificacion a y b,2001-01-01,14,43,14,43,57
11002,HUACAYA (VILLA DE HUACAYA),estado nutricional en menores de 5 anos,clasificacion a y b,2001-01-01,8,14,8,14,22
40501,HUACHACALLA,estado nutricional en menores de 5 anos,clasificacion a y b,2001-01-01,0,3,0,3,3
40701,HUANUNI,estado nutricional en menores de 5 anos,clasificacion a y b,2001-01-01,2,7,2,7,9
80803,HUARACAJE,estado nutricional en menores de 5 anos,clasificacion a y b,2001-01-01,0,6,0,6,6
21005,ICHOCA,estado nutricional en menores de 5 anos,clasificacion a y b,2001-01-01,2,4,2,4,6
10304,ICLA,estado nutricional en menores de 5 anos,clasificacion a y b,2001-01-01,6,15,6,15,21
10703,INCAHUASI,estado nutricional en menores de 5 anos,clasificacion a y b,2001-01-01,3,23,3,23,26
21001,INQUISIVI,estado nutricional en menores de 5 anos,clasificacion a y b,2001-01-01,1,29,1,29,30
21102,IRUPANA (VILLA DE LANZA),estado nutricional en menores de 5 anos,clasificacion a y b,2001-01-01,7,64,7,64,71
21501,IXIAMAS,estado nutricional en menores de 5 anos,clasificacion a y b,2001-01-01,2,3,2,3,5
21105,LA ASUNTA,estado nutricional en menores de 5 anos,clasificacion a y b,2001-01-01,9,19,9,19,28
70104,LA GUARDIA,estado nutricional en menores de 5 anos,clasificacion a y b,2001-01-01,112,354,112,354,466
20101,LA PAZ,estado nutricional en menores de 5 anos,clasificacion a y b,2001-01-01,184,520,184,520,704
70701,LAGUNILLAS,estado nutricional en menores de 5 anos,clasificacion a y b,2001-01-01,11,13,11,13,24
21202,LAJA,estado nutricional en menores de 5 anos,clasificacion a y b,2001-01-01,3,8,3,8,11
10903,LAS CARRERAS,estado nutricional en menores de 5 anos,clasificacion a y b,2001-01-01,3,6,3,6,9
21006,LICOMA PAMPA,estado nutricional en menores de 5 anos,clasificacion a y b,2001-01-01,2,5,2,5,7
50203,LLALLAGUA,estado nutricional en menores de 5 anos,clasificacion a y b,2001-01-01,2,3,2,3,5
51401,LLICA,estado nutricional en menores de 5 anos,clasificacion a y b,2001-01-01,3,4,3,4,7
80601,LORETO,estado nutricional en menores de 5 anos,clasificacion a y b,2001-01-01,3,6,3,6,9
40702,MACHACAMARCA,estado nutricional en menores de 5 anos,clasificacion a y b,2001-01-01,0,14,0,14,14
11003,MACHARETI,estado nutricional en menores de 5 anos,clasificacion a y b,2001-01-01,33,38,33,38,71
80801,MAGDALENA,estado nutricional en menores de 5 anos,clasificacion a y b,2001-01-01,7,14,7,14,21
70903,MAIRANA,estado nutricional en menores de 5 anos,clasificacion a y b,2001-01-01,18,42,18,42,60
71003,MINEROS,estado nutricional en menores de 5 anos,clasificacion a y b,2001-01-01,54,176,54,176,230
31301,MIZQUE,estado nutricional en menores de 5 anos,clasificacion a y b,2001-01-01,8,2,8,2,10
20402,MOCOMOCO,estado nutricional en menores de 5 anos,clasificacion a y b,2001-01-01,2,9,2,9,11
10303,MOJOCOYA,estado nutricional en menores de 5 anos,clasificacion a y b,2001-01-01,6,18,6,18,24
10501,MONTEAGUDO,estado nutricional en menores de 5 anos,clasificacion a y b,2001-01-01,62,126,62,126,188
71001,MONTERO,estado nutricional en menores de 5 anos,clasificacion a y b,2001-01-01,77,280,77,280,357
70803,MORO MORO,estado nutricional en menores de 5 anos,clasificacion a y b,2001-01-01,1,10,1,10,11
30302,MOROCHATA,estado nutricional en menores de 5 anos,clasificacion a y b,2001-01-01,4,5,4,5,9
50404,OCURI,estado nutricional en menores de 5 anos,clasificacion a y b,2001-01-01,0,4,0,4,4
70202,OKINAWA,estado nutricional en menores de 5 anos,clasificacion a y b,2001-01-01,1,10,1,10,11
30203,OMEREQUE,estado nutricional en menores de 5 anos,clasificacion a y b,2001-01-01,0,20,0,20,20
40101,ORURO,estado nutricional en menores de 5 anos,clasificacion a y b,2001-01-01,70,218,70,218,288
60201,PADCAYA,estado nutricional en menores de 5 anos,clasificacion a y b,2001-01-01,16,47,16,47,63
10401,PADILLA,estado nutricional en menores de 5 anos,clasificacion a y b,2001-01-01,9,39,9,39,48
70502,PAILON,estado nutricional en menores de 5 anos,clasificacion a y b,2001-01-01,16,45,16,45,61
20102,PALCA,estado nutricional en menores de 5 anos,clasificacion a y b,2001-01-01,1,4,1,4,5
21104,PALOS BLANCOS,estado nutricional en menores de 5 anos,clasificacion a y b,2001-01-01,10,60,10,60,70
40802,PAMPA AULLAGAS,estado nutricional en menores de 5 anos,clasificacion a y b,2001-01-01,0,3,0,3,3
70902,PAMPA GRANDE,estado nutricional en menores de 5 anos,clasificacion a y b,2001-01-01,8,48,8,48,56
30202,PASORAPA,estado nutricional en menores de 5 anos,clasificacion a y b,2001-01-01,0,35,0,35,35
40602,PAZÃ‘A,estado nutricional en menores de 5 anos,clasificacion a y b,2001-01-01,3,3,3,3,6
20702,PELECHUCO,estado nutricional en menores de 5 anos,clasificacion a y b,2001-01-01,1,2,1,2,3
50403,POCOATA,estado nutricional en menores de 5 anos,clasificacion a y b,2001-01-01,3,16,3,16,19
31203,POCONA,estado nutricional en menores de 5 anos,clasificacion a y b,2001-01-01,14,21,14,21,35
31202,POJO (CBBA),estado nutricional en menores de 5 anos,clasificacion a y b,2001-01-01,32,79,32,79,111
40601,POOPO,estado nutricional en menores de 5 anos,clasificacion a y b,2001-01-01,4,1,4,1,5
51203,PORCO,estado nutricional en menores de 5 anos,clasificacion a y b,2001-01-01,5,9,5,9,14
10103,POROMA,estado nutricional en menores de 5 anos,clasificacion a y b,2001-01-01,30,32,30,32,62
70103,PORONGO,estado nutricional en menores de 5 anos,clasificacion a y b,2001-01-01,5,51,5,51,56
70601,PORTACHUELO,estado nutricional en menores de 5 anos,clasificacion a y b,2001-01-01,8,89,8,89,97
90102,PORVENIR,estado nutricional en menores de 5 anos,clasificacion a y b,2001-01-01,2,7,2,7,9
50101,POTOSI,estado nutricional en menores de 5 anos,clasificacion a y b,2001-01-01,28,107,28,107,135
10302,PRESTO,estado nutricional en menores de 5 anos,clasificacion a y b,2001-01-01,5,18,5,18,23
70805,PUCARA,estado nutricional en menores de 5 anos,clasificacion a y b,2001-01-01,0,3,0,3,3
21201,PUCARANI,estado nutricional en menores de 5 anos,clasificacion a y b,2001-01-01,7,13,7,13,20
20401,PUERTO ACOSTA,estado nutricional en menores de 5 anos,clasificacion a y b,2001-01-01,0,1,0,1,1
20403,PUERTO CARABUCO,estado nutricional en menores de 5 anos,clasificacion a y b,2001-01-01,5,10,5,10,15
21204,PUERTO PEREZ,estado nutricional en menores de 5 anos,clasificacion a y b,2001-01-01,0,7,0,7,7
71402,PUERTO QUIJARRO,estado nutricional en menores de 5 anos,clasificacion a y b,2001-01-01,10,53,10,53,63
90201,PUERTO RICO,estado nutricional en menores de 5 anos,clasificacion a y b,2001-01-01,4,18,4,18,22
71401,PUERTO SUAREZ,estado nutricional en menores de 5 anos,clasificacion a y b,2001-01-01,17,68,17,68,85
31205,PUERTO VILLARROEL,estado nutricional en menores de 5 anos,clasificacion a y b,2001-01-01,47,60,47,60,107
51101,PUNA,estado nutricional en menores de 5 anos,clasificacion a y b,2001-01-01,19,32,19,32,51
31401,PUNATA,estado nutricional en menores de 5 anos,clasificacion a y b,2001-01-01,14,50,14,50,64
20604,QUIABAYA,estado nutricional en menores de 5 anos,clasificacion a y b,2001-01-01,2,2,2,2,4
30901,QUILLACOLLO,estado nutricional en menores de 5 anos,clasificacion a y b,2001-01-01,3,2,3,2,5
21002,QUIME,estado nutricional en menores de 5 anos,clasificacion a y b,2001-01-01,4,21,4,21,25
70904,QUIRUSILLAS,estado nutricional en menores de 5 anos,clasificacion a y b,2001-01-01,7,3,7,3,10
50402,RAVELO,estado nutricional en menores de 5 anos,clasificacion a y b,2001-01-01,4,13,4,13,17
80301,REYES,estado nutricional en menores de 5 anos,clasificacion a y b,2001-01-01,6,44,6,44,50
80201,RIBERALTA,estado nutricional en menores de 5 anos,clasificacion a y b,2001-01-01,72,261,72,261,333
70503,ROBORE,estado nutricional en menores de 5 anos,clasificacion a y b,2001-01-01,8,52,8,52,60
80304,RURRENABAQUE,estado nutricional en menores de 5 anos,clasificacion a y b,2001-01-01,10,11,10,11,21
40901,SABAYA,estado nutricional en menores de 5 anos,clasificacion a y b,2001-01-01,1,6,1,6,7
31001,SACABA,estado nutricional en menores de 5 anos,clasificacion a y b,2001-01-01,84,16,84,16,100
50701,SACACA,estado nutricional en menores de 5 anos,clasificacion a y b,2001-01-01,4,6,4,6,10
71302,SAIPINA,estado nutricional en menores de 5 anos,clasificacion a y b,2001-01-01,29,17,29,17,46
40801,SALINAS DE GARCI MENDOZA,estado nutricional en menores de 5 anos,clasificacion a y b,2001-01-01,0,4,0,4,4
70901,SAMAIPATA,estado nutricional en menores de 5 anos,clasificacion a y b,2001-01-01,9,22,9,22,31
51601,SAN AGUSTIN,estado nutricional en menores de 5 anos,clasificacion a y b,2001-01-01,0,1,0,1,1
80602,SAN ANDRES,estado nutricional en menores de 5 anos,clasificacion a y b,2001-01-01,0,4,0,4,4
51003,SAN ANTONIO DE ESMORUCO,estado nutricional en menores de 5 anos,clasificacion a y b,2001-01-01,0,1,0,1,1
71105,SAN ANTONIO DE LOMERIO,estado nutricional en menores de 5 anos,clasificacion a y b,2001-01-01,10,21,10,21,31
31403,SAN BENITO,estado nutricional en menores de 5 anos,clasificacion a y b,2001-01-01,4,21,4,21,25
80302,SAN BORJA,estado nutricional en menores de 5 anos,clasificacion a y b,2001-01-01,38,113,38,113,151
21502,SAN BUENA VENTURA,estado nutricional en menores de 5 anos,clasificacion a y b,2001-01-01,6,40,6,40,46
80501,SAN IGNACIO,estado nutricional en menores de 5 anos,clasificacion a y b,2001-01-01,14,35,14,35,49
70301,SAN IGNACIO DE VELASCO,estado nutricional en menores de 5 anos,clasificacion a y b,2001-01-01,51,172,51,172,223
80102,SAN JAVIER(BNI),estado nutricional en menores de 5 anos,clasificacion a y b,2001-01-01,0,4,0,4,4
71102,SAN JAVIER(STC),estado nutricional en menores de 5 anos,clasificacion a y b,2001-01-01,20,83,20,83,103
80701,SAN JOAQUIN,estado nutricional en menores de 5 anos,clasificacion a y b,2001-01-01,4,18,4,18,22
70501,SAN JOSE DE CHIQUITOS,estado nutricional en menores de 5 anos,clasificacion a y b,2001-01-01,4,47,4,47,51
71104,SAN JULIAN,estado nutricional en menores de 5 anos,clasificacion a y b,2001-01-01,60,117,60,117,177
90302,SAN LORENZO(PND),estado nutricional en menores de 5 anos,clasificacion a y b,2001-01-01,1,0,1,0,1
60501,SAN LORENZO(TJA),estado nutricional en menores de 5 anos,clasificacion a y b,2001-01-01,1,4,1,4,5
10702,SAN LUCAS,estado nutricional en menores de 5 anos,clasificacion a y b,2001-01-01,26,41,26,41,67
71201,SAN MATIAS,estado nutricional en menores de 5 anos,clasificacion a y b,2001-01-01,4,34,4,34,38
70302,SAN MIGUEL DE VELASCO,estado nutricional en menores de 5 anos,clasificacion a y b,2001-01-01,8,5,8,5,13
51001,SAN PABLO DE LIPEZ,estado nutricional en menores de 5 anos,clasificacion a y b,2001-01-01,2,1,2,1,3
50501,SAN PEDRO DE BUENA VISTA,estado nutricional en menores de 5 anos,clasificacion a y b,2001-01-01,6,22,6,22,28
21801,SAN PEDRO DE CURAHUARA,estado nutricional en menores de 5 anos,clasificacion a y b,2001-01-01,2,9,2,9,11
50902,SAN PEDRO DE QUEMES,estado nutricional en menores de 5 anos,clasificacion a y b,2001-01-01,1,3,1,3,4
21702,SAN PEDRO DE TIQUINA,estado nutricional en menores de 5 anos,clasificacion a y b,2001-01-01,3,2,3,2,5
70303,SAN RAFAEL,estado nutricional en menores de 5 anos,clasificacion a y b,2001-01-01,7,16,7,16,23
80702,SAN RAMON,estado nutricional en menores de 5 anos,clasificacion a y b,2001-01-01,10,20,10,20,30
80702,SAN RAMON,estado nutricional en menores de 5 anos,clasificacion a y b,2001-01-01,5,33,5,33,38
70101,SANTA CRUZ DE LA SIERRA,estado nutricional en menores de 5 anos,clasificacion a y b,2001-01-01,440,751,440,751,1191
80303,SANTA ROSA,estado nutricional en menores de 5 anos,clasificacion a y b,2001-01-01,2,15,2,15,17
70602,SANTA ROSA DEL SARA,estado nutricional en menores de 5 anos,clasificacion a y b,2001-01-01,2,11,2,11,13
20308,SANTIAGO DE CALLAPA,estado nutricional en menores de 5 anos,clasificacion a y b,2001-01-01,0,2,0,2,2
41401,SANTIAGO DE HUARI,estado nutricional en menores de 5 anos,clasificacion a y b,2001-01-01,1,3,1,3,4
21901,SANTIAGO DE MACHACA,estado nutricional en menores de 5 anos,clasificacion a y b,2001-01-01,1,0,1,0,1
30702,SANTIVAÃ‘ES,estado nutricional en menores de 5 anos,clasificacion a y b,2001-01-01,8,10,8,10,18
40202,SANTUARIO DE QUILLACAS,estado nutricional en menores de 5 anos,clasificacion a y b,2001-01-01,0,7,0,7,7
21301,SICA SICA (VILLA AROMA),estado nutricional en menores de 5 anos,clasificacion a y b,2001-01-01,9,13,9,13,22
30703,SICAYA,estado nutricional en menores de 5 anos,clasificacion a y b,2001-01-01,2,4,2,4,6
30902,SIPE SIPE,estado nutricional en menores de 5 anos,clasificacion a y b,2001-01-01,31,100,31,100,131
10403,SOPACHUY,estado nutricional en menores de 5 anos,clasificacion a y b,2001-01-01,2,28,2,28,30
20601,SORATA,estado nutricional en menores de 5 anos,clasificacion a y b,2001-01-01,7,12,7,12,19
10101,SUCRE,estado nutricional en menores de 5 anos,clasificacion a y b,2001-01-01,93,410,93,410,503
31404,TACACHI,estado nutricional en menores de 5 anos,clasificacion a y b,2001-01-01,2,1,2,1,3
20603,TACACOMA,estado nutricional en menores de 5 anos,clasificacion a y b,2001-01-01,1,7,1,7,8
50303,TACOBAMBA,estado nutricional en menores de 5 anos,clasificacion a y b,2001-01-01,7,6,7,6,13
51402,TAHUA,estado nutricional en menores de 5 anos,clasificacion a y b,2001-01-01,1,0,1,0,1
31101,TAPACARI,estado nutricional en menores de 5 anos,clasificacion a y b,2001-01-01,5,6,5,6,11
10601,TARABUCO,estado nutricional en menores de 5 anos,clasificacion a y b,2001-01-01,20,42,20,42,62
60101,TARIJA,estado nutricional en menores de 5 anos,clasificacion a y b,2001-01-01,43,238,43,238,281
10202,TARVITA,estado nutricional en menores de 5 anos,clasificacion a y b,2001-01-01,10,27,10,27,37
20803,TIAWANACU,estado nutricional en menores de 5 anos,clasificacion a y b,2001-01-01,1,17,1,17,18
50102,TINGUIPAYA,estado nutricional en menores de 5 anos,clasificacion a y b,2001-01-01,2,0,2,0,2
20606,TIPUANI,estado nutricional en menores de 5 anos,clasificacion a y b,2001-01-01,6,6,6,6,12
30903,TIQUIPAYA,estado nutricional en menores de 5 anos,clasificacion a y b,2001-01-01,1,7,1,7,8
31601,TIRAQUE (CBBA),estado nutricional en menores de 5 anos,clasificacion a y b,2001-01-01,9,6,9,6,15
41502,TODOS SANTOS,estado nutricional en menores de 5 anos,clasificacion a y b,2001-01-01,1,1,1,1,2
41001,TOLEDO,estado nutricional en menores de 5 anos,clasificacion a y b,2001-01-01,8,2,8,2,10
51202,TOMAVE,estado nutricional en menores de 5 anos,clasificacion a y b,2001-01-01,2,1,2,1,3
10402,TOMINA,estado nutricional en menores de 5 anos,clasificacion a y b,2001-01-01,3,28,3,28,31
31201,TOTORA(CBBA),estado nutricional en menores de 5 anos,clasificacion a y b,2001-01-01,5,28,5,28,33
41301,TOTORA(ORR),estado nutricional en menores de 5 anos,clasificacion a y b,2001-01-01,1,0,1,0,1
70802,TRIGAL,estado nutricional en menores de 5 anos,clasificacion a y b,2001-01-01,0,4,0,4,4
80101,TRINIDAD,estado nutricional en menores de 5 anos,clasificacion a y b,2001-01-01,1,2,1,2,3
50801,TUPIZA,estado nutricional en menores de 5 anos,clasificacion a y b,2001-01-01,40,139,40,139,179
40402,TURCO,estado nutricional en menores de 5 anos,clasificacion a y b,2001-01-01,0,4,0,4,4
21302,UMALA,estado nutricional en menores de 5 anos,clasificacion a y b,2001-01-01,0,2,0,2,2
50201,UNCIA,estado nutricional en menores de 5 anos,clasificacion a y b,2001-01-01,2,13,2,13,15
60401,URIONDO (A. CONCEPCION),estado nutricional en menores de 5 anos,clasificacion a y b,2001-01-01,13,79,13,79,92
71502,URUBICHA,estado nutricional en menores de 5 anos,clasificacion a y b,2001-01-01,0,4,0,4,4
51201,UYUNI,estado nutricional en menores de 5 anos,clasificacion a y b,2001-01-01,10,11,10,11,21
30502,VACAS,estado nutricional en menores de 5 anos,clasificacion a y b,2001-01-01,3,0,3,0,3
70801,VALLEGRANDE,estado nutricional en menores de 5 anos,clasificacion a y b,2001-01-01,1,2,1,2,3
20801,VIACHA,estado nutricional en menores de 5 anos,clasificacion a y b,2001-01-01,22,52,22,52,74
31302,VILA VILA,estado nutricional en menores de 5 anos,clasificacion a y b,2001-01-01,6,2,6,2,8
60303,VILLA MONTES,estado nutricional en menores de 5 anos,clasificacion a y b,2001-01-01,20,86,20,86,106
31402,VILLA RIVERO,estado nutricional en menores de 5 anos,clasificacion a y b,2001-01-01,0,3,0,3,3
10801,VILLA SERRANO,estado nutricional en menores de 5 anos,clasificacion a y b,2001-01-01,7,30,7,30,37
31003,VILLA TUNARI,estado nutricional en menores de 5 anos,clasificacion a y b,2001-01-01,12,19,12,19,31
11001,VILLA VACA GUZMAN (MUYUPAMPA),estado nutricional en menores de 5 anos,clasificacion a y b,2001-01-01,23,66,23,66,89
51501,VILLAZON,estado nutricional en menores de 5 anos,clasificacion a y b,2001-01-01,7,73,7,73,80
50602,VITICHI,estado nutricional en menores de 5 anos,clasificacion a y b,2001-01-01,1,2,1,2,3
70201,WARNES,estado nutricional en menores de 5 anos,clasificacion a y b,2001-01-01,0,12,0,12,12
20903,YACO,estado nutricional en menores de 5 anos,clasificacion a y b,2001-01-01,5,4,5,4,9
60301,YACUIBA,estado nutricional en menores de 5 anos,clasificacion a y b,2001-01-01,72,232,72,232,304
10602,YAMPARAEZ,estado nutricional en menores de 5 anos,clasificacion a y b,2001-01-01,22,105,22,105,127
21103,YANACACHI,estado nutricional en menores de 5 anos,clasificacion a y b,2001-01-01,7,6,7,6,13
10102,YOTALA,estado nutricional en menores de 5 anos,clasificacion a y b,2001-01-01,6,38,6,38,44
60402,YUNCHARA,estado nutricional en menores de 5 anos,clasificacion a y b,2001-01-01,9,17,9,17,26
10301,ZUDAÃ‘EZ,estado nutricional en menores de 5 anos,clasificacion a y b,2001-01-01,11,13,11,13,24
51302,ACACIO,estado nutricional en menores de 5 anos,clasificacion a y b,2001-02-01,2,6,2,6,8
20201,ACHACACHI,estado nutricional en menores de 5 anos,clasificacion a y b,2001-02-01,16,60,16,60,76
20104,ACHOCALLA,estado nutricional en menores de 5 anos,clasificacion a y b,2001-02-01,1,9,1,9,10
30201,AIQUILE,estado nutricional en menores de 5 anos,clasificacion a y b,2001-02-01,3,18,3,18,21
31303,ALALAY,estado nutricional en menores de 5 anos,clasificacion a y b,2001-02-01,2,0,2,0,2
10404,ALCALA,estado nutricional en menores de 5 anos,clasificacion a y b,2001-02-01,2,12,2,12,14
20202,ANCORAIMES,estado nutricional en menores de 5 anos,clasificacion a y b,2001-02-01,8,11,8,11,19
41201,ANDAMARCA,estado nutricional en menores de 5 anos,clasificacion a y b,2001-02-01,2,3,2,3,5
40603,ANTEQUERA,estado nutricional en menores de 5 anos,clasificacion a y b,2001-02-01,2,5,2,5,7
30402,ANZALDO,estado nutricional en menores de 5 anos,clasificacion a y b,2001-02-01,3,5,3,5,8
20701,APOLO,estado nutricional en menores de 5 anos,clasificacion a y b,2001-02-01,15,5,15,5,20
51301,ARAMPAMPA,estado nutricional en menores de 5 anos,clasificacion a y b,2001-02-01,2,10,2,10,12
30501,ARANI,estado nutricional en menores de 5 anos,clasificacion a y b,2001-02-01,2,16,2,16,18
30403,ARBIETO,estado nutricional en menores de 5 anos,clasificacion a y b,2001-02-01,2,10,2,10,12
30601,ARQUE,estado nutricional en menores de 5 anos,clasificacion a y b,2001-02-01,0,2,0,2,2
71501,ASCENCION DE GUARAYOS,estado nutricional en menores de 5 anos,clasificacion a y b,2001-02-01,30,119,30,119,149
50802,ATOCHA,estado nutricional en menores de 5 anos,clasificacion a y b,2001-02-01,0,4,0,4,4
20503,AUCAPATA,estado nutricional en menores de 5 anos,clasificacion a y b,2001-02-01,4,5,4,5,9
20502,AYATA,estado nutricional en menores de 5 anos,clasificacion a y b,2001-02-01,0,2,0,2,2
30301,AYOPAYA (V. DE INDEPENDENCIA),estado nutricional en menores de 5 anos,clasificacion a y b,2001-02-01,9,30,9,30,39
10201,AZURDUY,estado nutricional en menores de 5 anos,clasificacion a y b,2001-02-01,10,17,10,17,27
21203,BATALLAS,estado nutricional en menores de 5 anos,clasificacion a y b,2001-02-01,4,6,4,6,10
80802,BAURES,estado nutricional en menores de 5 anos,clasificacion a y b,2001-02-01,1,18,1,18,19
50104,BELEN DE URMIRI,estado nutricional en menores de 5 anos,clasificacion a y b,2001-02-01,0,1,0,1,1
90104,BELLA FLOR,estado nutricional en menores de 5 anos,clasificacion a y b,2001-02-01,1,18,1,18,19
60202,BERMEJO,estado nutricional en menores de 5 anos,clasificacion a y b,2001-02-01,26,80,26,80,106
50301,BETANZOS,estado nutricional en menores de 5 anos,clasificacion a y b,2001-02-01,7,15,7,15,22
31501,BOLIVAR,estado nutricional en menores de 5 anos,clasificacion a y b,2001-02-01,5,1,5,1,6
90103,BOLPEBRA,estado nutricional en menores de 5 anos,clasificacion a y b,2001-02-01,0,3,0,3,3
70707,BOYUIBE,estado nutricional en menores de 5 anos,clasificacion a y b,2001-02-01,1,13,1,13,14
70703,CABEZAS,estado nutricional en menores de 5 anos,clasificacion a y b,2001-02-01,8,16,8,16,24
20905,CAIROMA,estado nutricional en menores de 5 anos,clasificacion a y b,2001-02-01,3,1,3,1,4
51102,"CAIZA ""D""",estado nutricional en menores de 5 anos,clasificacion a y b,2001-02-01,4,22,4,22,26
21003,CAJUATA,estado nutricional en menores de 5 anos,clasificacion a y b,2001-02-01,10,26,10,26,36
21304,CALAMARCA,estado nutricional en menores de 5 anos,clasificacion a y b,2001-02-01,4,4,4,4,8
10701,CAMARGO,estado nutricional en menores de 5 anos,clasificacion a y b,2001-02-01,17,30,17,30,47
10901,CAMATAQUI (C. VILLA ABECIA),estado nutricional en menores de 5 anos,clasificacion a y b,2001-02-01,4,4,4,4,8
70706,CAMIRI,estado nutricional en menores de 5 anos,clasificacion a y b,2001-02-01,7,92,7,92,99
30701,CAPINOTA,estado nutricional en menores de 5 anos,clasificacion a y b,2001-02-01,29,26,29,26,55
20302,CAQUIAVIRI,estado nutricional en menores de 5 anos,clasificacion a y b,2001-02-01,4,4,4,4,8
40102,CARACOLLO,estado nutricional en menores de 5 anos,clasificacion a y b,2001-02-01,13,33,13,33,46
22001,CARANAVI,estado nutricional en menores de 5 anos,clasificacion a y b,2001-02-01,17,77,17,77,94
60302,CARAPARI,estado nutricional en menores de 5 anos,clasificacion a y b,2001-02-01,6,20,6,20,26
50702,CARIPUYO,estado nutricional en menores de 5 anos,clasificacion a y b,2001-02-01,3,3,3,3,6
40201,CHALLAPATA,estado nutricional en menores de 5 anos,clasificacion a y b,2001-02-01,4,7,4,7,11
50302,CHAQUI,estado nutricional en menores de 5 anos,clasificacion a y b,2001-02-01,6,15,6,15,21
70702,CHARAGUA,estado nutricional en menores de 5 anos,clasificacion a y b,2001-02-01,50,68,50,68,118
20305,CHARAÃ‘A,estado nutricional en menores de 5 anos,clasificacion a y b,2001-02-01,0,1,0,1,1
50202,CHAYANTA,estado nutricional en menores de 5 anos,clasificacion a y b,2001-02-01,1,11,1,11,12
31204,CHIMORE,estado nutricional en menores de 5 anos,clasificacion a y b,2001-02-01,43,22,43,22,65
40903,CHIPAYA,estado nutricional en menores de 5 anos,clasificacion a y b,2001-02-01,0,1,0,1,1
40302,CHOQUE COTA,estado nutricional en menores de 5 anos,clasificacion a y b,2001-02-01,1,0,1,0,1
21101,CHULUMANI (V. DE LA LIBERTAD),estado nutricional en menores de 5 anos,clasificacion a y b,2001-02-01,8,26,8,26,34
20501,CHUMA,estado nutricional en menores de 5 anos,clasificacion a y b,2001-02-01,1,6,1,6,7
30801,CLIZA,estado nutricional en menores de 5 anos,clasificacion a y b,2001-02-01,12,15,12,15,27
90101,COBIJA,estado nutricional en menores de 5 anos,clasificacion a y b,2001-02-01,16,62,16,62,78
30101,COCHABAMBA,estado nutricional en menores de 5 anos,clasificacion a y b,2001-02-01,1146,957,1146,957,2103
40902,COIPASA,estado nutricional en menores de 5 anos,clasificacion a y b,2001-02-01,1,2,1,2,3
30905,COLCAPIRHUA,estado nutricional en menores de 5 anos,clasificacion a y b,2001-02-01,43,47,43,47,90
50901,"COLCHA ""K""",estado nutricional en menores de 5 anos,clasificacion a y b,2001-02-01,8,13,8,13,21
31002,COLOMI,estado nutricional en menores de 5 anos,clasificacion a y b,2001-02-01,8,9,8,9,17
70603,COLPA BELGICA,estado nutricional en menores de 5 anos,clasificacion a y b,2001-02-01,52,3,52,3,55
50401,COLQUECHACA,estado nutricional en menores de 5 anos,clasificacion a y b,2001-02-01,9,8,9,8,17
21306,COLQUENCHA,estado nutricional en menores de 5 anos,clasificacion a y b,2001-02-01,4,6,4,6,10
21004,COLQUIRI,estado nutricional en menores de 5 anos,clasificacion a y b,2001-02-01,1,22,1,22,23
20304,COMANCHE,estado nutricional en menores de 5 anos,clasificacion a y b,2001-02-01,1,2,1,2,3
71301,COMARAPA,estado nutricional en menores de 5 anos,clasificacion a y b,2001-02-01,6,35,6,35,41
71101,CONCEPCION,estado nutricional en menores de 5 anos,clasificacion a y b,2001-02-01,15,31,15,31,46
21701,COPACABANA,estado nutricional en menores de 5 anos,clasificacion a y b,2001-02-01,1,15,1,15,16
21402,CORIPATA,estado nutricional en menores de 5 anos,clasificacion a y b,2001-02-01,6,19,6,19,25
20301,CORO CORO,estado nutricional en menores de 5 anos,clasificacion a y b,2001-02-01,2,17,2,17,19
21401,COROICO,estado nutricional en menores de 5 anos,clasificacion a y b,2001-02-01,3,8,3,8,11
40301,CORQUE,estado nutricional en menores de 5 anos,clasificacion a y b,2001-02-01,0,1,0,1,1
50601,COTAGAITA,estado nutricional en menores de 5 anos,clasificacion a y b,2001-02-01,5,29,5,29,34
70102,COTOCA,estado nutricional en menores de 5 anos,clasificacion a y b,2001-02-01,15,67,15,67,82
70704,CUEVO,estado nutricional en menores de 5 anos,clasificacion a y b,2001-02-01,1,18,1,18,19
10902,CULPINA,estado nutricional en menores de 5 anos,clasificacion a y b,2001-02-01,8,30,8,30,38
40401,CURAHUARA DE CARANGAS,estado nutricional en menores de 5 anos,clasificacion a y b,2001-02-01,1,1,1,1,2
21602,CURVA,estado nutricional en menores de 5 anos,clasificacion a y b,2001-02-01,2,4,2,4,6
20804,DESAGUADERO,estado nutricional en menores de 5 anos,clasificacion a y b,2001-02-01,0,11,0,11,11
20105,EL ALTO,estado nutricional en menores de 5 anos,clasificacion a y b,2001-02-01,356,592,356,592,948
40103,EL CHORO,estado nutricional en menores de 5 anos,clasificacion a y b,2001-02-01,0,2,0,2,2
71503,EL PUENTE(STC),estado nutricional en menores de 5 anos,clasificacion a y b,2001-02-01,10,32,10,32,42
60502,EL PUENTE(TJA),estado nutricional en menores de 5 anos,clasificacion a y b,2001-02-01,4,6,4,6,10
70105,EL TORNO,estado nutricional en menores de 5 anos,clasificacion a y b,2001-02-01,22,78,22,78,100
10405,EL VILLAR,estado nutricional en menores de 5 anos,clasificacion a y b,2001-02-01,3,11,3,11,14
60601,ENTRE RIOS,estado nutricional en menores de 5 anos,clasificacion a y b,2001-02-01,14,38,14,38,52
41101,EUCALIPTUS,estado nutricional en menores de 5 anos,clasificacion a y b,2001-02-01,1,10,1,10,11
80402,EXALTACION,estado nutricional en menores de 5 anos,clasificacion a y b,2001-02-01,0,1,0,1,1
90203,FILADELFIA,estado nutricional en menores de 5 anos,clasificacion a y b,2001-02-01,4,4,4,4,8
71002,GENERAL SAAVEDRA,estado nutricional en menores de 5 anos,clasificacion a y b,2001-02-01,14,55,14,55,69
21601,GRAL. J.J. PEREZ (CHARAZANI),estado nutricional en menores de 5 anos,clasificacion a y b,2001-02-01,3,6,3,6,9
20602,GUANAY,estado nutricional en menores de 5 anos,clasificacion a y b,2001-02-01,4,34,4,34,38
20802,GUAQUI,estado nutricional en menores de 5 anos,clasificacion a y b,2001-02-01,1,6,1,6,7
80202,GUAYARAMERIN,estado nutricional en menores de 5 anos,clasificacion a y b,2001-02-01,4,63,4,63,67
70705,GUTIERREZ,estado nutricional en menores de 5 anos,clasificacion a y b,2001-02-01,17,51,17,51,68
10502,HUACARETA,estado nutricional en menores de 5 anos,clasificacion a y b,2001-02-01,11,39,11,39,50
11002,HUACAYA (VILLA DE HUACAYA),estado nutricional en menores de 5 anos,clasificacion a y b,2001-02-01,2,6,2,6,8
40501,HUACHACALLA,estado nutricional en menores de 5 anos,clasificacion a y b,2001-02-01,2,1,2,1,3
40701,HUANUNI,estado nutricional en menores de 5 anos,clasificacion a y b,2001-02-01,7,32,7,32,39
80803,HUARACAJE,estado nutricional en menores de 5 anos,clasificacion a y b,2001-02-01,4,8,4,8,12
41601,HUAYLLAMARCA,estado nutricional en menores de 5 anos,clasificacion a y b,2001-02-01,2,5,2,5,7
21005,ICHOCA,estado nutricional en menores de 5 anos,clasificacion a y b,2001-02-01,0,5,0,5,5
10304,ICLA,estado nutricional en menores de 5 anos,clasificacion a y b,2001-02-01,2,16,2,16,18
10703,INCAHUASI,estado nutricional en menores de 5 anos,clasificacion a y b,2001-02-01,5,29,5,29,34
21001,INQUISIVI,estado nutricional en menores de 5 anos,clasificacion a y b,2001-02-01,4,10,4,10,14
21102,IRUPANA (VILLA DE LANZA),estado nutricional en menores de 5 anos,clasificacion a y b,2001-02-01,11,65,11,65,76
21501,IXIAMAS,estado nutricional en menores de 5 anos,clasificacion a y b,2001-02-01,1,19,1,19,20
21105,LA ASUNTA,estado nutricional en menores de 5 anos,clasificacion a y b,2001-02-01,10,46,10,46,56
70104,LA GUARDIA,estado nutricional en menores de 5 anos,clasificacion a y b,2001-02-01,54,109,54,109,163
20101,LA PAZ,estado nutricional en menores de 5 anos,clasificacion a y b,2001-02-01,152,445,152,445,597
70701,LAGUNILLAS,estado nutricional en menores de 5 anos,clasificacion a y b,2001-02-01,5,45,5,45,50
21202,LAJA,estado nutricional en menores de 5 anos,clasificacion a y b,2001-02-01,4,19,4,19,23
10903,LAS CARRERAS,estado nutricional en menores de 5 anos,clasificacion a y b,2001-02-01,1,14,1,14,15
21006,LICOMA PAMPA,estado nutricional en menores de 5 anos,clasificacion a y b,2001-02-01,2,0,2,0,2
50203,LLALLAGUA,estado nutricional en menores de 5 anos,clasificacion a y b,2001-02-01,15,34,15,34,49
51401,LLICA,estado nutricional en menores de 5 anos,clasificacion a y b,2001-02-01,0,4,0,4,4
80601,LORETO,estado nutricional en menores de 5 anos,clasificacion a y b,2001-02-01,2,1,2,1,3
20901,LURIBAY,estado nutricional en menores de 5 anos,clasificacion a y b,2001-02-01,1,0,1,0,1
11003,MACHARETI,estado nutricional en menores de 5 anos,clasificacion a y b,2001-02-01,12,71,12,71,83
80801,MAGDALENA,estado nutricional en menores de 5 anos,clasificacion a y b,2001-02-01,1,5,1,5,6
70903,MAIRANA,estado nutricional en menores de 5 anos,clasificacion a y b,2001-02-01,8,34,8,34,42
20904,MALLA,estado nutricional en menores de 5 anos,clasificacion a y b,2001-02-01,1,0,1,0,1
71003,MINEROS,estado nutricional en menores de 5 anos,clasificacion a y b,2001-02-01,52,140,52,140,192
31301,MIZQUE,estado nutricional en menores de 5 anos,clasificacion a y b,2001-02-01,3,2,3,2,5
20402,MOCOMOCO,estado nutricional en menores de 5 anos,clasificacion a y b,2001-02-01,1,7,1,7,8
51002,MOJINETE,estado nutricional en menores de 5 anos,clasificacion a y b,2001-02-01,1,0,1,0,1
10303,MOJOCOYA,estado nutricional en menores de 5 anos,clasificacion a y b,2001-02-01,11,37,11,37,48
10501,MONTEAGUDO,estado nutricional en menores de 5 anos,clasificacion a y b,2001-02-01,23,118,23,118,141
71001,MONTERO,estado nutricional en menores de 5 anos,clasificacion a y b,2001-02-01,98,257,98,257,355
70803,MORO MORO,estado nutricional en menores de 5 anos,clasificacion a y b,2001-02-01,4,4,4,4,8
30302,MOROCHATA,estado nutricional en menores de 5 anos,clasificacion a y b,2001-02-01,6,6,6,6,12
50404,OCURI,estado nutricional en menores de 5 anos,clasificacion a y b,2001-02-01,3,9,3,9,12
70202,OKINAWA,estado nutricional en menores de 5 anos,clasificacion a y b,2001-02-01,5,10,5,10,15
30203,OMEREQUE,estado nutricional en menores de 5 anos,clasificacion a y b,2001-02-01,4,12,4,12,16
40101,ORURO,estado nutricional en menores de 5 anos,clasificacion a y b,2001-02-01,56,177,56,177,233
60201,PADCAYA,estado nutricional en menores de 5 anos,clasificacion a y b,2001-02-01,6,37,6,37,43
10401,PADILLA,estado nutricional en menores de 5 anos,clasificacion a y b,2001-02-01,8,34,8,34,42
70502,PAILON,estado nutricional en menores de 5 anos,clasificacion a y b,2001-02-01,12,30,12,30,42
21104,PALOS BLANCOS,estado nutricional en menores de 5 anos,clasificacion a y b,2001-02-01,12,59,12,59,71
40802,PAMPA AULLAGAS,estado nutricional en menores de 5 anos,clasificacion a y b,2001-02-01,0,1,0,1,1
70902,PAMPA GRANDE,estado nutricional en menores de 5 anos,clasificacion a y b,2001-02-01,10,34,10,34,44
30202,PASORAPA,estado nutricional en menores de 5 anos,clasificacion a y b,2001-02-01,0,1,0,1,1
40602,PAZÃ‘A,estado nutricional en menores de 5 anos,clasificacion a y b,2001-02-01,1,5,1,5,6
20702,PELECHUCO,estado nutricional en menores de 5 anos,clasificacion a y b,2001-02-01,1,3,1,3,4
50403,POCOATA,estado nutricional en menores de 5 anos,clasificacion a y b,2001-02-01,5,13,5,13,18
31203,POCONA,estado nutricional en menores de 5 anos,clasificacion a y b,2001-02-01,4,7,4,7,11
31202,POJO (CBBA),estado nutricional en menores de 5 anos,clasificacion a y b,2001-02-01,15,39,15,39,54
40601,POOPO,estado nutricional en menores de 5 anos,clasificacion a y b,2001-02-01,0,2,0,2,2
51203,PORCO,estado nutricional en menores de 5 anos,clasificacion a y b,2001-02-01,3,6,3,6,9
10103,POROMA,estado nutricional en menores de 5 anos,clasificacion a y b,2001-02-01,6,26,6,26,32
70103,PORONGO,estado nutricional en menores de 5 anos,clasificacion a y b,2001-02-01,3,45,3,45,48
70601,PORTACHUELO,estado nutricional en menores de 5 anos,clasificacion a y b,2001-02-01,18,53,18,53,71
90102,PORVENIR,estado nutricional en menores de 5 anos,clasificacion a y b,2001-02-01,1,11,1,11,12
50101,POTOSI,estado nutricional en menores de 5 anos,clasificacion a y b,2001-02-01,21,63,21,63,84
10302,PRESTO,estado nutricional en menores de 5 anos,clasificacion a y b,2001-02-01,2,19,2,19,21
21201,PUCARANI,estado nutricional en menores de 5 anos,clasificacion a y b,2001-02-01,8,33,8,33,41
20401,PUERTO ACOSTA,estado nutricional en menores de 5 anos,clasificacion a y b,2001-02-01,5,15,5,15,20
20403,PUERTO CARABUCO,estado nutricional en menores de 5 anos,clasificacion a y b,2001-02-01,13,16,13,16,29
90301,PUERTO GONZALO MORENO,estado nutricional en menores de 5 anos,clasificacion a y b,2001-02-01,0,6,0,6,6
21204,PUERTO PEREZ,estado nutricional en menores de 5 anos,clasificacion a y b,2001-02-01,0,7,0,7,7
71402,PUERTO QUIJARRO,estado nutricional en menores de 5 anos,clasificacion a y b,2001-02-01,9,22,9,22,31
80703,PUERTO SILES,estado nutricional en menores de 5 anos,clasificacion a y b,2001-02-01,1,0,1,0,1
71401,PUERTO SUAREZ,estado nutricional en menores de 5 anos,clasificacion a y b,2001-02-01,13,56,13,56,69
31205,PUERTO VILLARROEL,estado nutricional en menores de 5 anos,clasificacion a y b,2001-02-01,26,63,26,63,89
51101,PUNA,estado nutricional en menores de 5 anos,clasificacion a y b,2001-02-01,10,27,10,27,37
31401,PUNATA,estado nutricional en menores de 5 anos,clasificacion a y b,2001-02-01,10,25,10,25,35
20604,QUIABAYA,estado nutricional en menores de 5 anos,clasificacion a y b,2001-02-01,3,1,3,1,4
30901,QUILLACOLLO,estado nutricional en menores de 5 anos,clasificacion a y b,2001-02-01,10,13,10,13,23
21002,QUIME,estado nutricional en menores de 5 anos,clasificacion a y b,2001-02-01,0,10,0,10,10
70904,QUIRUSILLAS,estado nutricional en menores de 5 anos,clasificacion a y b,2001-02-01,3,0,3,0,3
50402,RAVELO,estado nutricional en menores de 5 anos,clasificacion a y b,2001-02-01,6,12,6,12,18
80301,REYES,estado nutricional en menores de 5 anos,clasificacion a y b,2001-02-01,3,18,3,18,21
80201,RIBERALTA,estado nutricional en menores de 5 anos,clasificacion a y b,2001-02-01,36,220,36,220,256
70503,ROBORE,estado nutricional en menores de 5 anos,clasificacion a y b,2001-02-01,6,45,6,45,51
80304,RURRENABAQUE,estado nutricional en menores de 5 anos,clasificacion a y b,2001-02-01,20,31,20,31,51
40901,SABAYA,estado nutricional en menores de 5 anos,clasificacion a y b,2001-02-01,0,4,0,4,4
31001,SACABA,estado nutricional en menores de 5 anos,clasificacion a y b,2001-02-01,67,61,67,61,128
30404,SACABAMBA,estado nutricional en menores de 5 anos,clasificacion a y b,2001-02-01,0,2,0,2,2
50701,SACACA,estado nutricional en menores de 5 anos,clasificacion a y b,2001-02-01,3,24,3,24,27
71302,SAIPINA,estado nutricional en menores de 5 anos,clasificacion a y b,2001-02-01,5,38,5,38,43
40801,SALINAS DE GARCI MENDOZA,estado nutricional en menores de 5 anos,clasificacion a y b,2001-02-01,0,3,0,3,3
70901,SAMAIPATA,estado nutricional en menores de 5 anos,clasificacion a y b,2001-02-01,5,23,5,23,28
51601,SAN AGUSTIN,estado nutricional en menores de 5 anos,clasificacion a y b,2001-02-01,0,2,0,2,2
80602,SAN ANDRES,estado nutricional en menores de 5 anos,clasificacion a y b,2001-02-01,4,5,4,5,9
71105,SAN ANTONIO DE LOMERIO,estado nutricional en menores de 5 anos,clasificacion a y b,2001-02-01,7,21,7,21,28
31403,SAN BENITO,estado nutricional en menores de 5 anos,clasificacion a y b,2001-02-01,6,14,6,14,20
80302,SAN BORJA,estado nutricional en menores de 5 anos,clasificacion a y b,2001-02-01,26,92,26,92,118
21502,SAN BUENA VENTURA,estado nutricional en menores de 5 anos,clasificacion a y b,2001-02-01,10,24,10,24,34
70402,SAN CARLOS,estado nutricional en menores de 5 anos,clasificacion a y b,2001-02-01,6,6,6,6,12
80501,SAN IGNACIO,estado nutricional en menores de 5 anos,clasificacion a y b,2001-02-01,7,30,7,30,37
70301,SAN IGNACIO DE VELASCO,estado nutricional en menores de 5 anos,clasificacion a y b,2001-02-01,34,77,34,77,111
80102,SAN JAVIER(BNI),estado nutricional en menores de 5 anos,clasificacion a y b,2001-02-01,0,15,0,15,15
80701,SAN JOAQUIN,estado nutricional en menores de 5 anos,clasificacion a y b,2001-02-01,5,33,5,33,38
70501,SAN JOSE DE CHIQUITOS,estado nutricional en menores de 5 anos,clasificacion a y b,2001-02-01,5,37,5,37,42
71104,SAN JULIAN,estado nutricional en menores de 5 anos,clasificacion a y b,2001-02-01,52,118,52,118,170
60501,SAN LORENZO(TJA),estado nutricional en menores de 5 anos,clasificacion a y b,2001-02-01,1,7,1,7,8
10702,SAN LUCAS,estado nutricional en menores de 5 anos,clasificacion a y b,2001-02-01,13,41,13,41,54
71201,SAN MATIAS,estado nutricional en menores de 5 anos,clasificacion a y b,2001-02-01,6,39,6,39,45
70302,SAN MIGUEL DE VELASCO,estado nutricional en menores de 5 anos,clasificacion a y b,2001-02-01,11,23,11,23,34
51001,SAN PABLO DE LIPEZ,estado nutricional en menores de 5 anos,clasificacion a y b,2001-02-01,1,0,1,0,1
50501,SAN PEDRO DE BUENA VISTA,estado nutricional en menores de 5 anos,clasificacion a y b,2001-02-01,5,18,5,18,23
50902,SAN PEDRO DE QUEMES,estado nutricional en menores de 5 anos,clasificacion a y b,2001-02-01,0,4,0,4,4
21702,SAN PEDRO DE TIQUINA,estado nutricional en menores de 5 anos,clasificacion a y b,2001-02-01,1,7,1,7,8
90202,SAN PEDRO(PND),estado nutricional en menores de 5 anos,clasificacion a y b,2001-02-01,1,2,1,2,3
70303,SAN RAFAEL,estado nutricional en menores de 5 anos,clasificacion a y b,2001-02-01,4,11,4,11,15
80702,SAN RAMON,estado nutricional en menores de 5 anos,clasificacion a y b,2001-02-01,2,17,2,17,19
80702,SAN RAMON,estado nutricional en menores de 5 anos,clasificacion a y b,2001-02-01,2,5,2,5,7
80401,SANTA ANA,estado nutricional en menores de 5 anos,clasificacion a y b,2001-02-01,48,41,48,41,89
70101,SANTA CRUZ DE LA SIERRA,estado nutricional en menores de 5 anos,clasificacion a y b,2001-02-01,272,410,272,410,682
80303,SANTA ROSA,estado nutricional en menores de 5 anos,clasificacion a y b,2001-02-01,9,2,9,2,11
70602,SANTA ROSA DEL SARA,estado nutricional en menores de 5 anos,clasificacion a y b,2001-02-01,0,8,0,8,8
41401,SANTIAGO DE HUARI,estado nutricional en menores de 5 anos,clasificacion a y b,2001-02-01,0,9,0,9,9
30702,SANTIVAÃ‘ES,estado nutricional en menores de 5 anos,clasificacion a y b,2001-02-01,5,2,5,2,7
40202,SANTUARIO DE QUILLACAS,estado nutricional en menores de 5 anos,clasificacion a y b,2001-02-01,0,5,0,5,5
21301,SICA SICA (VILLA AROMA),estado nutricional en menores de 5 anos,clasificacion a y b,2001-02-01,3,9,3,9,12
30703,SICAYA,estado nutricional en menores de 5 anos,clasificacion a y b,2001-02-01,3,7,3,7,10
30902,SIPE SIPE,estado nutricional en menores de 5 anos,clasificacion a y b,2001-02-01,24,112,24,112,136
10403,SOPACHUY,estado nutricional en menores de 5 anos,clasificacion a y b,2001-02-01,25,24,25,24,49
20601,SORATA,estado nutricional en menores de 5 anos,clasificacion a y b,2001-02-01,2,19,2,19,21
10101,SUCRE,estado nutricional en menores de 5 anos,clasificacion a y b,2001-02-01,96,369,96,369,465
31404,TACACHI,estado nutricional en menores de 5 anos,clasificacion a y b,2001-02-01,1,2,1,2,3
20603,TACACOMA,estado nutricional en menores de 5 anos,clasificacion a y b,2001-02-01,17,11,17,11,28
50303,TACOBAMBA,estado nutricional en menores de 5 anos,clasificacion a y b,2001-02-01,0,2,0,2,2
30602,TACOPAYA,estado nutricional en menores de 5 anos,clasificacion a y b,2001-02-01,0,11,0,11,11
51402,TAHUA,estado nutricional en menores de 5 anos,clasificacion a y b,2001-02-01,1,1,1,1,2
31101,TAPACARI,estado nutricional en menores de 5 anos,clasificacion a y b,2001-02-01,18,39,18,39,57
10601,TARABUCO,estado nutricional en menores de 5 anos,clasificacion a y b,2001-02-01,18,42,18,42,60
30401,TARATA,estado nutricional en menores de 5 anos,clasificacion a y b,2001-02-01,1,29,1,29,30
60101,TARIJA,estado nutricional en menores de 5 anos,clasificacion a y b,2001-02-01,50,240,50,240,290
10202,TARVITA,estado nutricional en menores de 5 anos,clasificacion a y b,2001-02-01,3,43,3,43,46
20803,TIAWANACU,estado nutricional en menores de 5 anos,clasificacion a y b,2001-02-01,0,22,0,22,22
50102,TINGUIPAYA,estado nutricional en menores de 5 anos,clasificacion a y b,2001-02-01,1,1,1,1,2
20606,TIPUANI,estado nutricional en menores de 5 anos,clasificacion a y b,2001-02-01,4,6,4,6,10
30903,TIQUIPAYA,estado nutricional en menores de 5 anos,clasificacion a y b,2001-02-01,18,43,18,43,61
31601,TIRAQUE (CBBA),estado nutricional en menores de 5 anos,clasificacion a y b,2001-02-01,10,25,10,25,35
30802,TOCO,estado nutricional en menores de 5 anos,clasificacion a y b,2001-02-01,0,4,0,4,4
41001,TOLEDO,estado nutricional en menores de 5 anos,clasificacion a y b,2001-02-01,1,9,1,9,10
51202,TOMAVE,estado nutricional en menores de 5 anos,clasificacion a y b,2001-02-01,6,7,6,7,13
10402,TOMINA,estado nutricional en menores de 5 anos,clasificacion a y b,2001-02-01,3,36,3,36,39
50502,TORO TORO,estado nutricional en menores de 5 anos,clasificacion a y b,2001-02-01,5,0,5,0,5
31201,TOTORA(CBBA),estado nutricional en menores de 5 anos,clasificacion a y b,2001-02-01,2,15,2,15,17
41301,TOTORA(ORR),estado nutricional en menores de 5 anos,clasificacion a y b,2001-02-01,2,3,2,3,5
70802,TRIGAL,estado nutricional en menores de 5 anos,clasificacion a y b,2001-02-01,1,3,1,3,4
80101,TRINIDAD,estado nutricional en menores de 5 anos,clasificacion a y b,2001-02-01,24,47,24,47,71
50801,TUPIZA,estado nutricional en menores de 5 anos,clasificacion a y b,2001-02-01,21,90,21,90,111
40402,TURCO,estado nutricional en menores de 5 anos,clasificacion a y b,2001-02-01,0,1,0,1,1
21302,UMALA,estado nutricional en menores de 5 anos,clasificacion a y b,2001-02-01,1,7,1,7,8
50201,UNCIA,estado nutricional en menores de 5 anos,clasificacion a y b,2001-02-01,3,36,3,36,39
60401,URIONDO (A. CONCEPCION),estado nutricional en menores de 5 anos,clasificacion a y b,2001-02-01,5,42,5,42,47
51201,UYUNI,estado nutricional en menores de 5 anos,clasificacion a y b,2001-02-01,4,12,4,12,16
30502,VACAS,estado nutricional en menores de 5 anos,clasificacion a y b,2001-02-01,2,1,2,1,3
70801,VALLEGRANDE,estado nutricional en menores de 5 anos,clasificacion a y b,2001-02-01,10,43,10,43,53
20801,VIACHA,estado nutricional en menores de 5 anos,clasificacion a y b,2001-02-01,13,43,13,43,56
31302,VILA VILA,estado nutricional en menores de 5 anos,clasificacion a y b,2001-02-01,7,5,7,5,12
60303,VILLA MONTES,estado nutricional en menores de 5 anos,clasificacion a y b,2001-02-01,32,35,32,35,67
31402,VILLA RIVERO,estado nutricional en menores de 5 anos,clasificacion a y b,2001-02-01,7,2,7,2,9
10801,VILLA SERRANO,estado nutricional en menores de 5 anos,clasificacion a y b,2001-02-01,6,30,6,30,36
31003,VILLA TUNARI,estado nutricional en menores de 5 anos,clasificacion a y b,2001-02-01,23,75,23,75,98
11001,VILLA VACA GUZMAN (MUYUPAMPA),estado nutricional en menores de 5 anos,clasificacion a y b,2001-02-01,15,60,15,60,75
51501,VILLAZON,estado nutricional en menores de 5 anos,clasificacion a y b,2001-02-01,9,41,9,41,50
50602,VITICHI,estado nutricional en menores de 5 anos,clasificacion a y b,2001-02-01,0,5,0,5,5
20306,WALDO BALLIVIAN,estado nutricional en menores de 5 anos,clasificacion a y b,2001-02-01,0,1,0,1,1
70201,WARNES,estado nutricional en menores de 5 anos,clasificacion a y b,2001-02-01,16,61,16,61,77
60301,YACUIBA,estado nutricional en menores de 5 anos,clasificacion a y b,2001-02-01,46,126,46,126,172
10602,YAMPARAEZ,estado nutricional en menores de 5 anos,clasificacion a y b,2001-02-01,12,43,12,43,55
21103,YANACACHI,estado nutricional en menores de 5 anos,clasificacion a y b,2001-02-01,6,8,6,8,14
50103,YOCALLA,estado nutricional en menores de 5 anos,clasificacion a y b,2001-02-01,6,7,6,7,13
10102,YOTALA,estado nutricional en menores de 5 anos,clasificacion a y b,2001-02-01,4,46,4,46,50
60402,YUNCHARA,estado nutricional en menores de 5 anos,clasificacion a y b,2001-02-01,2,17,2,17,19
10301,ZUDAÃ‘EZ,estado nutricional en menores de 5 anos,clasificacion a y b,2001-02-01,4,13,4,13,17
51302,ACACIO,estado nutricional en menores de 5 anos,clasificacion a y b,2001-03-01,0,3,0,3,3
20201,ACHACACHI,estado nutricional en menores de 5 anos,clasificacion a y b,2001-03-01,25,126,25,126,151
20104,ACHOCALLA,estado nutricional en menores de 5 anos,clasificacion a y b,2001-03-01,1,4,1,4,5
30201,AIQUILE,estado nutricional en menores de 5 anos,clasificacion a y b,2001-03-01,4,35,4,35,39
31303,ALALAY,estado nutricional en menores de 5 anos,clasificacion a y b,2001-03-01,5,2,5,2,7
10404,ALCALA,estado nutricional en menores de 5 anos,clasificacion a y b,2001-03-01,5,13,5,13,18
20202,ANCORAIMES,estado nutricional en menores de 5 anos,clasificacion a y b,2001-03-01,5,15,5,15,20
41201,ANDAMARCA,estado nutricional en menores de 5 anos,clasificacion a y b,2001-03-01,2,0,2,0,2
40603,ANTEQUERA,estado nutricional en menores de 5 anos,clasificacion a y b,2001-03-01,2,4,2,4,6
30402,ANZALDO,estado nutricional en menores de 5 anos,clasificacion a y b,2001-03-01,2,13,2,13,15
20701,APOLO,estado nutricional en menores de 5 anos,clasificacion a y b,2001-03-01,6,6,6,6,12
51301,ARAMPAMPA,estado nutricional en menores de 5 anos,clasificacion a y b,2001-03-01,3,5,3,5,8
30501,ARANI,estado nutricional en menores de 5 anos,clasificacion a y b,2001-03-01,7,14,7,14,21
30403,ARBIETO,estado nutricional en menores de 5 anos,clasificacion a y b,2001-03-01,0,1,0,1,1
50802,ATOCHA,estado nutricional en menores de 5 anos,clasificacion a y b,2001-03-01,1,7,1,7,8
20503,AUCAPATA,estado nutricional en menores de 5 anos,clasificacion a y b,2001-03-01,1,10,1,10,11
21303,AYO AYO,estado nutricional en menores de 5 anos,clasificacion a y b,2001-03-01,0,12,0,12,12
30301,AYOPAYA (V. DE INDEPENDENCIA),estado nutricional en menores de 5 anos,clasificacion a y b,2001-03-01,6,56,6,56,62
10201,AZURDUY,estado nutricional en menores de 5 anos,clasificacion a y b,2001-03-01,8,40,8,40,48
21203,BATALLAS,estado nutricional en menores de 5 anos,clasificacion a y b,2001-03-01,1,9,1,9,10
80802,BAURES,estado nutricional en menores de 5 anos,clasificacion a y b,2001-03-01,6,18,6,18,24
50104,BELEN DE URMIRI,estado nutricional en menores de 5 anos,clasificacion a y b,2001-03-01,0,1,0,1,1
90104,BELLA FLOR,estado nutricional en menores de 5 anos,clasificacion a y b,2001-03-01,1,9,1,9,10
60202,BERMEJO,estado nutricional en menores de 5 anos,clasificacion a y b,2001-03-01,11,20,11,20,31
50301,BETANZOS,estado nutricional en menores de 5 anos,clasificacion a y b,2001-03-01,3,23,3,23,26
31501,BOLIVAR,estado nutricional en menores de 5 anos,clasificacion a y b,2001-03-01,0,1,0,1,1
70707,BOYUIBE,estado nutricional en menores de 5 anos,clasificacion a y b,2001-03-01,6,24,6,24,30
70401,BUENA VISTA,estado nutricional en menores de 5 anos,clasificacion a y b,2001-03-01,33,22,33,22,55
70703,CABEZAS,estado nutricional en menores de 5 anos,clasificacion a y b,2001-03-01,3,13,3,13,16
20905,CAIROMA,estado nutricional en menores de 5 anos,clasificacion a y b,2001-03-01,3,1,3,1,4
51102,"CAIZA ""D""",estado nutricional en menores de 5 anos,clasificacion a y b,2001-03-01,2,20,2,20,22
21003,CAJUATA,estado nutricional en menores de 5 anos,clasificacion a y b,2001-03-01,9,39,9,39,48
21304,CALAMARCA,estado nutricional en menores de 5 anos,clasificacion a y b,2001-03-01,2,5,2,5,7
10701,CAMARGO,estado nutricional en menores de 5 anos,clasificacion a y b,2001-03-01,18,27,18,27,45
10901,CAMATAQUI (C. VILLA ABECIA),estado nutricional en menores de 5 anos,clasificacion a y b,2001-03-01,4,13,4,13,17
70706,CAMIRI,estado nutricional en menores de 5 anos,clasificacion a y b,2001-03-01,23,169,23,169,192
30701,CAPINOTA,estado nutricional en menores de 5 anos,clasificacion a y b,2001-03-01,26,31,26,31,57
20302,CAQUIAVIRI,estado nutricional en menores de 5 anos,clasificacion a y b,2001-03-01,2,14,2,14,16
40102,CARACOLLO,estado nutricional en menores de 5 anos,clasificacion a y b,2001-03-01,20,44,20,44,64
22001,CARANAVI,estado nutricional en menores de 5 anos,clasificacion a y b,2001-03-01,20,100,20,100,120
41503,CARANGAS,estado nutricional en menores de 5 anos,clasificacion a y b,2001-03-01,0,1,0,1,1
60302,CARAPARI,estado nutricional en menores de 5 anos,clasificacion a y b,2001-03-01,9,22,9,22,31
50702,CARIPUYO,estado nutricional en menores de 5 anos,clasificacion a y b,2001-03-01,2,4,2,4,6
21902,CATACORA,estado nutricional en menores de 5 anos,clasificacion a y b,2001-03-01,0,1,0,1,1
21803,CHACARILLA,estado nutricional en menores de 5 anos,clasificacion a y b,2001-03-01,0,3,0,3,3
40201,CHALLAPATA,estado nutricional en menores de 5 anos,clasificacion a y b,2001-03-01,3,7,3,7,10
50302,CHAQUI,estado nutricional en menores de 5 anos,clasificacion a y b,2001-03-01,4,4,4,4,8
70702,CHARAGUA,estado nutricional en menores de 5 anos,clasificacion a y b,2001-03-01,23,57,23,57,80
50202,CHAYANTA,estado nutricional en menores de 5 anos,clasificacion a y b,2001-03-01,7,3,7,3,10
31204,CHIMORE,estado nutricional en menores de 5 anos,clasificacion a y b,2001-03-01,8,19,8,19,27
40903,CHIPAYA,estado nutricional en menores de 5 anos,clasificacion a y b,2001-03-01,0,2,0,2,2
21101,CHULUMANI (V. DE LA LIBERTAD),estado nutricional en menores de 5 anos,clasificacion a y b,2001-03-01,5,9,5,9,14
20501,CHUMA,estado nutricional en menores de 5 anos,clasificacion a y b,2001-03-01,0,4,0,4,4
30801,CLIZA,estado nutricional en menores de 5 anos,clasificacion a y b,2001-03-01,0,12,0,12,12
90101,COBIJA,estado nutricional en menores de 5 anos,clasificacion a y b,2001-03-01,20,108,20,108,128
30101,COCHABAMBA,estado nutricional en menores de 5 anos,clasificacion a y b,2001-03-01,1135,1481,1135,1481,2616
40902,COIPASA,estado nutricional en menores de 5 anos,clasificacion a y b,2001-03-01,1,2,1,2,3
30905,COLCAPIRHUA,estado nutricional en menores de 5 anos,clasificacion a y b,2001-03-01,24,40,24,40,64
50901,"COLCHA ""K""",estado nutricional en menores de 5 anos,clasificacion a y b,2001-03-01,7,19,7,19,26
21307,COLLANA,estado nutricional en menores de 5 anos,clasificacion a y b,2001-03-01,0,1,0,1,1
31002,COLOMI,estado nutricional en menores de 5 anos,clasificacion a y b,2001-03-01,19,13,19,13,32
50401,COLQUECHACA,estado nutricional en menores de 5 anos,clasificacion a y b,2001-03-01,3,22,3,22,25
21306,COLQUENCHA,estado nutricional en menores de 5 anos,clasificacion a y b,2001-03-01,1,15,1,15,16
21004,COLQUIRI,estado nutricional en menores de 5 anos,clasificacion a y b,2001-03-01,6,35,6,35,41
20304,COMANCHE,estado nutricional en menores de 5 anos,clasificacion a y b,2001-03-01,1,4,1,4,5
71301,COMARAPA,estado nutricional en menores de 5 anos,clasificacion a y b,2001-03-01,4,5,4,5,9
20605,COMBAYA,estado nutricional en menores de 5 anos,clasificacion a y b,2001-03-01,1,4,1,4,5
71101,CONCEPCION,estado nutricional en menores de 5 anos,clasificacion a y b,2001-03-01,5,82,5,82,87
21701,COPACABANA,estado nutricional en menores de 5 anos,clasificacion a y b,2001-03-01,2,29,2,29,31
21402,CORIPATA,estado nutricional en menores de 5 anos,clasificacion a y b,2001-03-01,6,45,6,45,51
20301,CORO CORO,estado nutricional en menores de 5 anos,clasificacion a y b,2001-03-01,1,17,1,17,18
21401,COROICO,estado nutricional en menores de 5 anos,clasificacion a y b,2001-03-01,5,6,5,6,11
40301,CORQUE,estado nutricional en menores de 5 anos,clasificacion a y b,2001-03-01,0,4,0,4,4
50601,COTAGAITA,estado nutricional en menores de 5 anos,clasificacion a y b,2001-03-01,6,13,6,13,19
70102,COTOCA,estado nutricional en menores de 5 anos,clasificacion a y b,2001-03-01,8,21,8,21,29
70704,CUEVO,estado nutricional en menores de 5 anos,clasificacion a y b,2001-03-01,5,16,5,16,21
10902,CULPINA,estado nutricional en menores de 5 anos,clasificacion a y b,2001-03-01,10,50,10,50,60
21602,CURVA,estado nutricional en menores de 5 anos,clasificacion a y b,2001-03-01,1,1,1,1,2
20804,DESAGUADERO,estado nutricional en menores de 5 anos,clasificacion a y b,2001-03-01,0,11,0,11,11
20105,EL ALTO,estado nutricional en menores de 5 anos,clasificacion a y b,2001-03-01,295,639,295,639,934
40103,EL CHORO,estado nutricional en menores de 5 anos,clasificacion a y b,2001-03-01,2,5,2,5,7
71503,EL PUENTE(STC),estado nutricional en menores de 5 anos,clasificacion a y b,2001-03-01,9,18,9,18,27
60502,EL PUENTE(TJA),estado nutricional en menores de 5 anos,clasificacion a y b,2001-03-01,0,4,0,4,4
70105,EL TORNO,estado nutricional en menores de 5 anos,clasificacion a y b,2001-03-01,25,77,25,77,102
10405,EL VILLAR,estado nutricional en menores de 5 anos,clasificacion a y b,2001-03-01,4,9,4,9,13
60601,ENTRE RIOS,estado nutricional en menores de 5 anos,clasificacion a y b,2001-03-01,8,47,8,47,55
41101,EUCALIPTUS,estado nutricional en menores de 5 anos,clasificacion a y b,2001-03-01,4,11,4,11,15
80402,EXALTACION,estado nutricional en menores de 5 anos,clasificacion a y b,2001-03-01,1,1,1,1,2
90203,FILADELFIA,estado nutricional en menores de 5 anos,clasificacion a y b,2001-03-01,5,10,5,10,15
71002,GENERAL SAAVEDRA,estado nutricional en menores de 5 anos,clasificacion a y b,2001-03-01,14,84,14,84,98
21601,GRAL. J.J. PEREZ (CHARAZANI),estado nutricional en menores de 5 anos,clasificacion a y b,2001-03-01,1,7,1,7,8
20602,GUANAY,estado nutricional en menores de 5 anos,clasificacion a y b,2001-03-01,0,13,0,13,13
20802,GUAQUI,estado nutricional en menores de 5 anos,clasificacion a y b,2001-03-01,2,10,2,10,12
80202,GUAYARAMERIN,estado nutricional en menores de 5 anos,clasificacion a y b,2001-03-01,15,61,15,61,76
70705,GUTIERREZ,estado nutricional en menores de 5 anos,clasificacion a y b,2001-03-01,17,54,17,54,71
10502,HUACARETA,estado nutricional en menores de 5 anos,clasificacion a y b,2001-03-01,13,57,13,57,70
11002,HUACAYA (VILLA DE HUACAYA),estado nutricional en menores de 5 anos,clasificacion a y b,2001-03-01,0,2,0,2,2
40501,HUACHACALLA,estado nutricional en menores de 5 anos,clasificacion a y b,2001-03-01,0,4,0,4,4
40701,HUANUNI,estado nutricional en menores de 5 anos,clasificacion a y b,2001-03-01,5,22,5,22,27
80803,HUARACAJE,estado nutricional en menores de 5 anos,clasificacion a y b,2001-03-01,4,6,4,6,10
41601,HUAYLLAMARCA,estado nutricional en menores de 5 anos,clasificacion a y b,2001-03-01,1,4,1,4,5
21005,ICHOCA,estado nutricional en menores de 5 anos,clasificacion a y b,2001-03-01,1,4,1,4,5
10304,ICLA,estado nutricional en menores de 5 anos,clasificacion a y b,2001-03-01,1,26,1,26,27
10703,INCAHUASI,estado nutricional en menores de 5 anos,clasificacion a y b,2001-03-01,9,55,9,55,64
21001,INQUISIVI,estado nutricional en menores de 5 anos,clasificacion a y b,2001-03-01,4,16,4,16,20
21102,IRUPANA (VILLA DE LANZA),estado nutricional en menores de 5 anos,clasificacion a y b,2001-03-01,8,38,8,38,46
21501,IXIAMAS,estado nutricional en menores de 5 anos,clasificacion a y b,2001-03-01,3,17,3,17,20
21105,LA ASUNTA,estado nutricional en menores de 5 anos,clasificacion a y b,2001-03-01,20,37,20,37,57
70104,LA GUARDIA,estado nutricional en menores de 5 anos,clasificacion a y b,2001-03-01,69,153,69,153,222
20101,LA PAZ,estado nutricional en menores de 5 anos,clasificacion a y b,2001-03-01,197,438,197,438,635
41501,LA RIVERA,estado nutricional en menores de 5 anos,clasificacion a y b,2001-03-01,0,1,0,1,1
70701,LAGUNILLAS,estado nutricional en menores de 5 anos,clasificacion a y b,2001-03-01,16,21,16,21,37
21202,LAJA,estado nutricional en menores de 5 anos,clasificacion a y b,2001-03-01,4,27,4,27,31
10903,LAS CARRERAS,estado nutricional en menores de 5 anos,clasificacion a y b,2001-03-01,3,21,3,21,24
21006,LICOMA PAMPA,estado nutricional en menores de 5 anos,clasificacion a y b,2001-03-01,1,5,1,5,6
50203,LLALLAGUA,estado nutricional en menores de 5 anos,clasificacion a y b,2001-03-01,1,3,1,3,4
51401,LLICA,estado nutricional en menores de 5 anos,clasificacion a y b,2001-03-01,1,4,1,4,5
80601,LORETO,estado nutricional en menores de 5 anos,clasificacion a y b,2001-03-01,0,4,0,4,4
20901,LURIBAY,estado nutricional en menores de 5 anos,clasificacion a y b,2001-03-01,2,4,2,4,6
40702,MACHACAMARCA,estado nutricional en menores de 5 anos,clasificacion a y b,2001-03-01,1,6,1,6,7
11003,MACHARETI,estado nutricional en menores de 5 anos,clasificacion a y b,2001-03-01,12,63,12,63,75
80801,MAGDALENA,estado nutricional en menores de 5 anos,clasificacion a y b,2001-03-01,6,24,6,24,30
70903,MAIRANA,estado nutricional en menores de 5 anos,clasificacion a y b,2001-03-01,11,35,11,35,46
71003,MINEROS,estado nutricional en menores de 5 anos,clasificacion a y b,2001-03-01,54,144,54,144,198
31301,MIZQUE,estado nutricional en menores de 5 anos,clasificacion a y b,2001-03-01,25,23,25,23,48
20402,MOCOMOCO,estado nutricional en menores de 5 anos,clasificacion a y b,2001-03-01,7,8,7,8,15
51002,MOJINETE,estado nutricional en menores de 5 anos,clasificacion a y b,2001-03-01,1,1,1,1,2
10303,MOJOCOYA,estado nutricional en menores de 5 anos,clasificacion a y b,2001-03-01,5,41,5,41,46
10501,MONTEAGUDO,estado nutricional en menores de 5 anos,clasificacion a y b,2001-03-01,11,102,11,102,113
71001,MONTERO,estado nutricional en menores de 5 anos,clasificacion a y b,2001-03-01,71,369,71,369,440
70803,MORO MORO,estado nutricional en menores de 5 anos,clasificacion a y b,2001-03-01,1,5,1,5,6
30302,MOROCHATA,estado nutricional en menores de 5 anos,clasificacion a y b,2001-03-01,5,4,5,4,9
50404,OCURI,estado nutricional en menores de 5 anos,clasificacion a y b,2001-03-01,6,7,6,7,13
70202,OKINAWA,estado nutricional en menores de 5 anos,clasificacion a y b,2001-03-01,7,76,7,76,83
30203,OMEREQUE,estado nutricional en menores de 5 anos,clasificacion a y b,2001-03-01,10,26,10,26,36
40101,ORURO,estado nutricional en menores de 5 anos,clasificacion a y b,2001-03-01,55,234,55,234,289
60201,PADCAYA,estado nutricional en menores de 5 anos,clasificacion a y b,2001-03-01,8,44,8,44,52
10401,PADILLA,estado nutricional en menores de 5 anos,clasificacion a y b,2001-03-01,12,45,12,45,57
70502,PAILON,estado nutricional en menores de 5 anos,clasificacion a y b,2001-03-01,15,30,15,30,45
21104,PALOS BLANCOS,estado nutricional en menores de 5 anos,clasificacion a y b,2001-03-01,27,53,27,53,80
40802,PAMPA AULLAGAS,estado nutricional en menores de 5 anos,clasificacion a y b,2001-03-01,1,2,1,2,3
70902,PAMPA GRANDE,estado nutricional en menores de 5 anos,clasificacion a y b,2001-03-01,10,25,10,25,35
21802,PAPEL PAMPA,estado nutricional en menores de 5 anos,clasificacion a y b,2001-03-01,2,0,2,0,2
30202,PASORAPA,estado nutricional en menores de 5 anos,clasificacion a y b,2001-03-01,2,3,2,3,5
21305,PATACAMAYA,estado nutricional en menores de 5 anos,clasificacion a y b,2001-03-01,0,20,0,20,20
40602,PAZÃ‘A,estado nutricional en menores de 5 anos,clasificacion a y b,2001-03-01,1,2,1,2,3
20702,PELECHUCO,estado nutricional en menores de 5 anos,clasificacion a y b,2001-03-01,4,11,4,11,15
50403,POCOATA,estado nutricional en menores de 5 anos,clasificacion a y b,2001-03-01,11,25,11,25,36
31203,POCONA,estado nutricional en menores de 5 anos,clasificacion a y b,2001-03-01,5,29,5,29,34
31202,POJO (CBBA),estado nutricional en menores de 5 anos,clasificacion a y b,2001-03-01,38,64,38,64,102
40601,POOPO,estado nutricional en menores de 5 anos,clasificacion a y b,2001-03-01,0,3,0,3,3
51203,PORCO,estado nutricional en menores de 5 anos,clasificacion a y b,2001-03-01,3,18,3,18,21
10103,POROMA,estado nutricional en menores de 5 anos,clasificacion a y b,2001-03-01,10,55,10,55,65
70103,PORONGO,estado nutricional en menores de 5 anos,clasificacion a y b,2001-03-01,10,36,10,36,46
70601,PORTACHUELO,estado nutricional en menores de 5 anos,clasificacion a y b,2001-03-01,70,53,70,53,123
90102,PORVENIR,estado nutricional en menores de 5 anos,clasificacion a y b,2001-03-01,4,11,4,11,15
70804,POSTRER VALLE,estado nutricional en menores de 5 anos,clasificacion a y b,2001-03-01,7,2,7,2,9
50101,POTOSI,estado nutricional en menores de 5 anos,clasificacion a y b,2001-03-01,19,71,19,71,90
10302,PRESTO,estado nutricional en menores de 5 anos,clasificacion a y b,2001-03-01,1,25,1,25,26
21201,PUCARANI,estado nutricional en menores de 5 anos,clasificacion a y b,2001-03-01,7,38,7,38,45
20401,PUERTO ACOSTA,estado nutricional en menores de 5 anos,clasificacion a y b,2001-03-01,5,25,5,25,30
20403,PUERTO CARABUCO,estado nutricional en menores de 5 anos,clasificacion a y b,2001-03-01,14,12,14,12,26
21204,PUERTO PEREZ,estado nutricional en menores de 5 anos,clasificacion a y b,2001-03-01,0,4,0,4,4
71402,PUERTO QUIJARRO,estado nutricional en menores de 5 anos,clasificacion a y b,2001-03-01,7,55,7,55,62
90201,PUERTO RICO,estado nutricional en menores de 5 anos,clasificacion a y b,2001-03-01,3,8,3,8,11
71401,PUERTO SUAREZ,estado nutricional en menores de 5 anos,clasificacion a y b,2001-03-01,11,51,11,51,62
31205,PUERTO VILLARROEL,estado nutricional en menores de 5 anos,clasificacion a y b,2001-03-01,33,72,33,72,105
51101,PUNA,estado nutricional en menores de 5 anos,clasificacion a y b,2001-03-01,22,44,22,44,66
31401,PUNATA,estado nutricional en menores de 5 anos,clasificacion a y b,2001-03-01,13,71,13,71,84
20604,QUIABAYA,estado nutricional en menores de 5 anos,clasificacion a y b,2001-03-01,2,0,2,0,2
30901,QUILLACOLLO,estado nutricional en menores de 5 anos,clasificacion a y b,2001-03-01,7,24,7,24,31
21002,QUIME,estado nutricional en menores de 5 anos,clasificacion a y b,2001-03-01,1,5,1,5,6
70904,QUIRUSILLAS,estado nutricional en menores de 5 anos,clasificacion a y b,2001-03-01,1,1,1,1,2
50402,RAVELO,estado nutricional en menores de 5 anos,clasificacion a y b,2001-03-01,6,11,6,11,17
80301,REYES,estado nutricional en menores de 5 anos,clasificacion a y b,2001-03-01,5,27,5,27,32
80201,RIBERALTA,estado nutricional en menores de 5 anos,clasificacion a y b,2001-03-01,55,170,55,170,225
70503,ROBORE,estado nutricional en menores de 5 anos,clasificacion a y b,2001-03-01,7,37,7,37,44
80304,RURRENABAQUE,estado nutricional en menores de 5 anos,clasificacion a y b,2001-03-01,36,29,36,29,65
40901,SABAYA,estado nutricional en menores de 5 anos,clasificacion a y b,2001-03-01,0,4,0,4,4
31001,SACABA,estado nutricional en menores de 5 anos,clasificacion a y b,2001-03-01,27,57,27,57,84
30404,SACABAMBA,estado nutricional en menores de 5 anos,clasificacion a y b,2001-03-01,1,19,1,19,20
50701,SACACA,estado nutricional en menores de 5 anos,clasificacion a y b,2001-03-01,7,12,7,12,19
71302,SAIPINA,estado nutricional en menores de 5 anos,clasificacion a y b,2001-03-01,1,5,1,5,6
40801,SALINAS DE GARCI MENDOZA,estado nutricional en menores de 5 anos,clasificacion a y b,2001-03-01,0,12,0,12,12
70901,SAMAIPATA,estado nutricional en menores de 5 anos,clasificacion a y b,2001-03-01,6,44,6,44,50
51601,SAN AGUSTIN,estado nutricional en menores de 5 anos,clasificacion a y b,2001-03-01,3,2,3,2,5
80602,SAN ANDRES,estado nutricional en menores de 5 anos,clasificacion a y b,2001-03-01,0,10,0,10,10
71105,SAN ANTONIO DE LOMERIO,estado nutricional en menores de 5 anos,clasificacion a y b,2001-03-01,4,13,4,13,17
31403,SAN BENITO,estado nutricional en menores de 5 anos,clasificacion a y b,2001-03-01,6,16,6,16,22
80302,SAN BORJA,estado nutricional en menores de 5 anos,clasificacion a y b,2001-03-01,19,40,19,40,59
21502,SAN BUENA VENTURA,estado nutricional en menores de 5 anos,clasificacion a y b,2001-03-01,6,14,6,14,20
70402,SAN CARLOS,estado nutricional en menores de 5 anos,clasificacion a y b,2001-03-01,26,73,26,73,99
80501,SAN IGNACIO,estado nutricional en menores de 5 anos,clasificacion a y b,2001-03-01,9,24,9,24,33
70301,SAN IGNACIO DE VELASCO,estado nutricional en menores de 5 anos,clasificacion a y b,2001-03-01,24,96,24,96,120
80102,SAN JAVIER(BNI),estado nutricional en menores de 5 anos,clasificacion a y b,2001-03-01,1,9,1,9,10
71102,SAN JAVIER(STC),estado nutricional en menores de 5 anos,clasificacion a y b,2001-03-01,0,54,0,54,54
80701,SAN JOAQUIN,estado nutricional en menores de 5 anos,clasificacion a y b,2001-03-01,1,22,1,22,23
70501,SAN JOSE DE CHIQUITOS,estado nutricional en menores de 5 anos,clasificacion a y b,2001-03-01,9,35,9,35,44
71104,SAN JULIAN,estado nutricional en menores de 5 anos,clasificacion a y b,2001-03-01,46,139,46,139,185
90302,SAN LORENZO(PND),estado nutricional en menores de 5 anos,clasificacion a y b,2001-03-01,2,21,2,21,23
60501,SAN LORENZO(TJA),estado nutricional en menores de 5 anos,clasificacion a y b,2001-03-01,11,26,11,26,37
10702,SAN LUCAS,estado nutricional en menores de 5 anos,clasificacion a y b,2001-03-01,17,69,17,69,86
71201,SAN MATIAS,estado nutricional en menores de 5 anos,clasificacion a y b,2001-03-01,6,73,6,73,79
70302,SAN MIGUEL DE VELASCO,estado nutricional en menores de 5 anos,clasificacion a y b,2001-03-01,2,5,2,5,7
51001,SAN PABLO DE LIPEZ,estado nutricional en menores de 5 anos,clasificacion a y b,2001-03-01,2,4,2,4,6
50501,SAN PEDRO DE BUENA VISTA,estado nutricional en menores de 5 anos,clasificacion a y b,2001-03-01,13,34,13,34,47
21801,SAN PEDRO DE CURAHUARA,estado nutricional en menores de 5 anos,clasificacion a y b,2001-03-01,0,5,0,5,5
50902,SAN PEDRO DE QUEMES,estado nutricional en menores de 5 anos,clasificacion a y b,2001-03-01,0,2,0,2,2
21702,SAN PEDRO DE TIQUINA,estado nutricional en menores de 5 anos,clasificacion a y b,2001-03-01,2,10,2,10,12
70303,SAN RAFAEL,estado nutricional en menores de 5 anos,clasificacion a y b,2001-03-01,6,21,6,21,27
80702,SAN RAMON,estado nutricional en menores de 5 anos,clasificacion a y b,2001-03-01,18,34,18,34,52
80702,SAN RAMON,estado nutricional en menores de 5 anos,clasificacion a y b,2001-03-01,2,17,2,17,19
70101,SANTA CRUZ DE LA SIERRA,estado nutricional en menores de 5 anos,clasificacion a y b,2001-03-01,337,489,337,489,826
80303,SANTA ROSA,estado nutricional en menores de 5 anos,clasificacion a y b,2001-03-01,3,4,3,4,7
70602,SANTA ROSA DEL SARA,estado nutricional en menores de 5 anos,clasificacion a y b,2001-03-01,11,24,11,24,35
20308,SANTIAGO DE CALLAPA,estado nutricional en menores de 5 anos,clasificacion a y b,2001-03-01,1,5,1,5,6
41401,SANTIAGO DE HUARI,estado nutricional en menores de 5 anos,clasificacion a y b,2001-03-01,0,8,0,8,8
30702,SANTIVAÃ‘ES,estado nutricional en menores de 5 anos,clasificacion a y b,2001-03-01,1,9,1,9,10
40202,SANTUARIO DE QUILLACAS,estado nutricional en menores de 5 anos,clasificacion a y b,2001-03-01,2,3,2,3,5
20902,SAPAHAQUI,estado nutricional en menores de 5 anos,clasificacion a y b,2001-03-01,5,5,5,5,10
21301,SICA SICA (VILLA AROMA),estado nutricional en menores de 5 anos,clasificacion a y b,2001-03-01,5,14,5,14,19
30703,SICAYA,estado nutricional en menores de 5 anos,clasificacion a y b,2001-03-01,1,7,1,7,8
30902,SIPE SIPE,estado nutricional en menores de 5 anos,clasificacion a y b,2001-03-01,39,67,39,67,106
10403,SOPACHUY,estado nutricional en menores de 5 anos,clasificacion a y b,2001-03-01,2,25,2,25,27
20601,SORATA,estado nutricional en menores de 5 anos,clasificacion a y b,2001-03-01,3,27,3,27,30
10101,SUCRE,estado nutricional en menores de 5 anos,clasificacion a y b,2001-03-01,76,423,76,423,499
31404,TACACHI,estado nutricional en menores de 5 anos,clasificacion a y b,2001-03-01,0,3,0,3,3
20603,TACACOMA,estado nutricional en menores de 5 anos,clasificacion a y b,2001-03-01,0,10,0,10,10
50303,TACOBAMBA,estado nutricional en menores de 5 anos,clasificacion a y b,2001-03-01,2,4,2,4,6
30602,TACOPAYA,estado nutricional en menores de 5 anos,clasificacion a y b,2001-03-01,5,10,5,10,15
51402,TAHUA,estado nutricional en menores de 5 anos,clasificacion a y b,2001-03-01,0,2,0,2,2
31101,TAPACARI,estado nutricional en menores de 5 anos,clasificacion a y b,2001-03-01,11,13,11,13,24
10601,TARABUCO,estado nutricional en menores de 5 anos,clasificacion a y b,2001-03-01,27,41,27,41,68
30401,TARATA,estado nutricional en menores de 5 anos,clasificacion a y b,2001-03-01,6,19,6,19,25
60101,TARIJA,estado nutricional en menores de 5 anos,clasificacion a y b,2001-03-01,62,247,62,247,309
10202,TARVITA,estado nutricional en menores de 5 anos,clasificacion a y b,2001-03-01,13,34,13,34,47
20803,TIAWANACU,estado nutricional en menores de 5 anos,clasificacion a y b,2001-03-01,2,35,2,35,37
50102,TINGUIPAYA,estado nutricional en menores de 5 anos,clasificacion a y b,2001-03-01,2,13,2,13,15
20606,TIPUANI,estado nutricional en menores de 5 anos,clasificacion a y b,2001-03-01,12,14,12,14,26
30903,TIQUIPAYA,estado nutricional en menores de 5 anos,clasificacion a y b,2001-03-01,14,63,14,63,77
31601,TIRAQUE (CBBA),estado nutricional en menores de 5 anos,clasificacion a y b,2001-03-01,21,27,21,27,48
30802,TOCO,estado nutricional en menores de 5 anos,clasificacion a y b,2001-03-01,1,4,1,4,5
30803,TOLATA,estado nutricional en menores de 5 anos,clasificacion a y b,2001-03-01,0,5,0,5,5
41001,TOLEDO,estado nutricional en menores de 5 anos,clasificacion a y b,2001-03-01,1,7,1,7,8
51202,TOMAVE,estado nutricional en menores de 5 anos,clasificacion a y b,2001-03-01,3,8,3,8,11
10402,TOMINA,estado nutricional en menores de 5 anos,clasificacion a y b,2001-03-01,10,19,10,19,29
50502,TORO TORO,estado nutricional en menores de 5 anos,clasificacion a y b,2001-03-01,3,4,3,4,7
31201,TOTORA(CBBA),estado nutricional en menores de 5 anos,clasificacion a y b,2001-03-01,3,42,3,42,45
41301,TOTORA(ORR),estado nutricional en menores de 5 anos,clasificacion a y b,2001-03-01,1,5,1,5,6
70802,TRIGAL,estado nutricional en menores de 5 anos,clasificacion a y b,2001-03-01,0,3,0,3,3
80101,TRINIDAD,estado nutricional en menores de 5 anos,clasificacion a y b,2001-03-01,16,62,16,62,78
50801,TUPIZA,estado nutricional en menores de 5 anos,clasificacion a y b,2001-03-01,26,106,26,106,132
40402,TURCO,estado nutricional en menores de 5 anos,clasificacion a y b,2001-03-01,3,10,3,10,13
21302,UMALA,estado nutricional en menores de 5 anos,clasificacion a y b,2001-03-01,0,4,0,4,4
50201,UNCIA,estado nutricional en menores de 5 anos,clasificacion a y b,2001-03-01,19,52,19,52,71
60401,URIONDO (A. CONCEPCION),estado nutricional en menores de 5 anos,clasificacion a y b,2001-03-01,6,50,6,50,56
71502,URUBICHA,estado nutricional en menores de 5 anos,clasificacion a y b,2001-03-01,0,7,0,7,7
51201,UYUNI,estado nutricional en menores de 5 anos,clasificacion a y b,2001-03-01,10,25,10,25,35
30502,VACAS,estado nutricional en menores de 5 anos,clasificacion a y b,2001-03-01,0,6,0,6,6
70801,VALLEGRANDE,estado nutricional en menores de 5 anos,clasificacion a y b,2001-03-01,5,41,5,41,46
20801,VIACHA,estado nutricional en menores de 5 anos,clasificacion a y b,2001-03-01,22,62,22,62,84
31302,VILA VILA,estado nutricional en menores de 5 anos,clasificacion a y b,2001-03-01,11,13,11,13,24
60303,VILLA MONTES,estado nutricional en menores de 5 anos,clasificacion a y b,2001-03-01,15,33,15,33,48
31402,VILLA RIVERO,estado nutricional en menores de 5 anos,clasificacion a y b,2001-03-01,0,1,0,1,1
10801,VILLA SERRANO,estado nutricional en menores de 5 anos,clasificacion a y b,2001-03-01,9,54,9,54,63
31003,VILLA TUNARI,estado nutricional en menores de 5 anos,clasificacion a y b,2001-03-01,27,62,27,62,89
11001,VILLA VACA GUZMAN (MUYUPAMPA),estado nutricional en menores de 5 anos,clasificacion a y b,2001-03-01,15,37,15,37,52
51501,VILLAZON,estado nutricional en menores de 5 anos,clasificacion a y b,2001-03-01,22,88,22,88,110
50602,VITICHI,estado nutricional en menores de 5 anos,clasificacion a y b,2001-03-01,7,13,7,13,20
20306,WALDO BALLIVIAN,estado nutricional en menores de 5 anos,clasificacion a y b,2001-03-01,0,1,0,1,1
70201,WARNES,estado nutricional en menores de 5 anos,clasificacion a y b,2001-03-01,30,104,30,104,134
20903,YACO,estado nutricional en menores de 5 anos,clasificacion a y b,2001-03-01,1,4,1,4,5
60301,YACUIBA,estado nutricional en menores de 5 anos,clasificacion a y b,2001-03-01,49,153,49,153,202
10602,YAMPARAEZ,estado nutricional en menores de 5 anos,clasificacion a y b,2001-03-01,17,44,17,44,61
21103,YANACACHI,estado nutricional en menores de 5 anos,clasificacion a y b,2001-03-01,7,20,7,20,27
70403,YAPACANI,estado nutricional en menores de 5 anos,clasificacion a y b,2001-03-01,22,34,22,34,56
50103,YOCALLA,estado nutricional en menores de 5 anos,clasificacion a y b,2001-03-01,2,3,2,3,5
10102,YOTALA,estado nutricional en menores de 5 anos,clasificacion a y b,2001-03-01,5,60,5,60,65
60402,YUNCHARA,estado nutricional en menores de 5 anos,clasificacion a y b,2001-03-01,1,7,1,7,8
10301,ZUDAÃ‘EZ,estado nutricional en menores de 5 anos,clasificacion a y b,2001-03-01,6,21,6,21,27
51302,ACACIO,estado nutricional en menores de 5 anos,clasificacion a y b,2001-04-01,4,11,4,11,15
20201,ACHACACHI,estado nutricional en menores de 5 anos,clasificacion a y b,2001-04-01,21,89,21,89,110
20104,ACHOCALLA,estado nutricional en menores de 5 anos,clasificacion a y b,2001-04-01,4,23,4,23,27
30201,AIQUILE,estado nutricional en menores de 5 anos,clasificacion a y b,2001-04-01,7,19,7,19,26
31303,ALALAY,estado nutricional en menores de 5 anos,clasificacion a y b,2001-04-01,2,4,2,4,6
10404,ALCALA,estado nutricional en menores de 5 anos,clasificacion a y b,2001-04-01,2,10,2,10,12
20202,ANCORAIMES,estado nutricional en menores de 5 anos,clasificacion a y b,2001-04-01,11,17,11,17,28
41201,ANDAMARCA,estado nutricional en menores de 5 anos,clasificacion a y b,2001-04-01,3,1,3,1,4
40603,ANTEQUERA,estado nutricional en menores de 5 anos,clasificacion a y b,2001-04-01,1,5,1,5,6
30402,ANZALDO,estado nutricional en menores de 5 anos,clasificacion a y b,2001-04-01,0,6,0,6,6
20701,APOLO,estado nutricional en menores de 5 anos,clasificacion a y b,2001-04-01,12,1,12,1,13
51301,ARAMPAMPA,estado nutricional en menores de 5 anos,clasificacion a y b,2001-04-01,2,8,2,8,10
30501,ARANI,estado nutricional en menores de 5 anos,clasificacion a y b,2001-04-01,7,10,7,10,17
30403,ARBIETO,estado nutricional en menores de 5 anos,clasificacion a y b,2001-04-01,9,14,9,14,23
30601,ARQUE,estado nutricional en menores de 5 anos,clasificacion a y b,2001-04-01,1,4,1,4,5
71501,ASCENCION DE GUARAYOS,estado nutricional en menores de 5 anos,clasificacion a y b,2001-04-01,43,199,43,199,242
50802,ATOCHA,estado nutricional en menores de 5 anos,clasificacion a y b,2001-04-01,6,2,6,2,8
20503,AUCAPATA,estado nutricional en menores de 5 anos,clasificacion a y b,2001-04-01,1,1,1,1,2
20502,AYATA,estado nutricional en menores de 5 anos,clasificacion a y b,2001-04-01,0,1,0,1,1
21303,AYO AYO,estado nutricional en menores de 5 anos,clasificacion a y b,2001-04-01,3,12,3,12,15
30301,AYOPAYA (V. DE INDEPENDENCIA),estado nutricional en menores de 5 anos,clasificacion a y b,2001-04-01,8,16,8,16,24
10201,AZURDUY,estado nutricional en menores de 5 anos,clasificacion a y b,2001-04-01,4,16,4,16,20
21203,BATALLAS,estado nutricional en menores de 5 anos,clasificacion a y b,2001-04-01,3,45,3,45,48
80802,BAURES,estado nutricional en menores de 5 anos,clasificacion a y b,2001-04-01,1,14,1,14,15
41202,BELEN DE ANDAMARCA,estado nutricional en menores de 5 anos,clasificacion a y b,2001-04-01,1,0,1,0,1
50104,BELEN DE URMIRI,estado nutricional en menores de 5 anos,clasificacion a y b,2001-04-01,6,7,6,7,13
90104,BELLA FLOR,estado nutricional en menores de 5 anos,clasificacion a y b,2001-04-01,5,6,5,6,11
60202,BERMEJO,estado nutricional en menores de 5 anos,clasificacion a y b,2001-04-01,14,20,14,20,34
50301,BETANZOS,estado nutricional en menores de 5 anos,clasificacion a y b,2001-04-01,10,13,10,13,23
90103,BOLPEBRA,estado nutricional en menores de 5 anos,clasificacion a y b,2001-04-01,0,2,0,2,2
70707,BOYUIBE,estado nutricional en menores de 5 anos,clasificacion a y b,2001-04-01,4,18,4,18,22
70401,BUENA VISTA,estado nutricional en menores de 5 anos,clasificacion a y b,2001-04-01,23,45,23,45,68
70703,CABEZAS,estado nutricional en menores de 5 anos,clasificacion a y b,2001-04-01,13,44,13,44,57
51102,"CAIZA ""D""",estado nutricional en menores de 5 anos,clasificacion a y b,2001-04-01,3,8,3,8,11
21003,CAJUATA,estado nutricional en menores de 5 anos,clasificacion a y b,2001-04-01,0,11,0,11,11
20303,CALACOTO,estado nutricional en menores de 5 anos,clasificacion a y b,2001-04-01,0,1,0,1,1
21304,CALAMARCA,estado nutricional en menores de 5 anos,clasificacion a y b,2001-04-01,5,13,5,13,18
10701,CAMARGO,estado nutricional en menores de 5 anos,clasificacion a y b,2001-04-01,8,44,8,44,52
10901,CAMATAQUI (C. VILLA ABECIA),estado nutricional en menores de 5 anos,clasificacion a y b,2001-04-01,3,10,3,10,13
70706,CAMIRI,estado nutricional en menores de 5 anos,clasificacion a y b,2001-04-01,12,82,12,82,94
20302,CAQUIAVIRI,estado nutricional en menores de 5 anos,clasificacion a y b,2001-04-01,2,22,2,22,24
40102,CARACOLLO,estado nutricional en menores de 5 anos,clasificacion a y b,2001-04-01,13,46,13,46,59
22001,CARANAVI,estado nutricional en menores de 5 anos,clasificacion a y b,2001-04-01,30,148,30,148,178
60302,CARAPARI,estado nutricional en menores de 5 anos,clasificacion a y b,2001-04-01,4,29,4,29,33
50702,CARIPUYO,estado nutricional en menores de 5 anos,clasificacion a y b,2001-04-01,1,6,1,6,7
21902,CATACORA,estado nutricional en menores de 5 anos,clasificacion a y b,2001-04-01,0,2,0,2,2
40201,CHALLAPATA,estado nutricional en menores de 5 anos,clasificacion a y b,2001-04-01,3,21,3,21,24
50302,CHAQUI,estado nutricional en menores de 5 anos,clasificacion a y b,2001-04-01,8,19,8,19,27
70702,CHARAGUA,estado nutricional en menores de 5 anos,clasificacion a y b,2001-04-01,11,58,11,58,69
20305,CHARAÃ‘A,estado nutricional en menores de 5 anos,clasificacion a y b,2001-04-01,1,3,1,3,4
50202,CHAYANTA,estado nutricional en menores de 5 anos,clasificacion a y b,2001-04-01,1,0,1,0,1
31204,CHIMORE,estado nutricional en menores de 5 anos,clasificacion a y b,2001-04-01,8,23,8,23,31
21101,CHULUMANI (V. DE LA LIBERTAD),estado nutricional en menores de 5 anos,clasificacion a y b,2001-04-01,8,26,8,26,34
20501,CHUMA,estado nutricional en menores de 5 anos,clasificacion a y b,2001-04-01,2,0,2,0,2
30801,CLIZA,estado nutricional en menores de 5 anos,clasificacion a y b,2001-04-01,6,8,6,8,14
90101,COBIJA,estado nutricional en menores de 5 anos,clasificacion a y b,2001-04-01,28,80,28,80,108
30101,COCHABAMBA,estado nutricional en menores de 5 anos,clasificacion a y b,2001-04-01,1039,1377,1039,1377,2416
40902,COIPASA,estado nutricional en menores de 5 anos,clasificacion a y b,2001-04-01,0,2,0,2,2
30905,COLCAPIRHUA,estado nutricional en menores de 5 anos,clasificacion a y b,2001-04-01,41,52,41,52,93
50901,"COLCHA ""K""",estado nutricional en menores de 5 anos,clasificacion a y b,2001-04-01,3,14,3,14,17
31002,COLOMI,estado nutricional en menores de 5 anos,clasificacion a y b,2001-04-01,5,11,5,11,16
70603,COLPA BELGICA,estado nutricional en menores de 5 anos,clasificacion a y b,2001-04-01,4,0,4,0,4
50401,COLQUECHACA,estado nutricional en menores de 5 anos,clasificacion a y b,2001-04-01,2,14,2,14,16
21306,COLQUENCHA,estado nutricional en menores de 5 anos,clasificacion a y b,2001-04-01,5,10,5,10,15
21004,COLQUIRI,estado nutricional en menores de 5 anos,clasificacion a y b,2001-04-01,1,29,1,29,30
20304,COMANCHE,estado nutricional en menores de 5 anos,clasificacion a y b,2001-04-01,0,5,0,5,5
71301,COMARAPA,estado nutricional en menores de 5 anos,clasificacion a y b,2001-04-01,1,15,1,15,16
20605,COMBAYA,estado nutricional en menores de 5 anos,clasificacion a y b,2001-04-01,1,2,1,2,3
71101,CONCEPCION,estado nutricional en menores de 5 anos,clasificacion a y b,2001-04-01,20,101,20,101,121
21701,COPACABANA,estado nutricional en menores de 5 anos,clasificacion a y b,2001-04-01,0,20,0,20,20
21402,CORIPATA,estado nutricional en menores de 5 anos,clasificacion a y b,2001-04-01,7,34,7,34,41
20301,CORO CORO,estado nutricional en menores de 5 anos,clasificacion a y b,2001-04-01,7,28,7,28,35
21401,COROICO,estado nutricional en menores de 5 anos,clasificacion a y b,2001-04-01,6,18,6,18,24
40301,CORQUE,estado nutricional en menores de 5 anos,clasificacion a y b,2001-04-01,0,3,0,3,3
50601,COTAGAITA,estado nutricional en menores de 5 anos,clasificacion a y b,2001-04-01,8,39,8,39,47
31405,CUCHUMUELA (V. G. VILLARROEL),estado nutricional en menores de 5 anos,clasificacion a y b,2001-04-01,0,1,0,1,1
70704,CUEVO,estado nutricional en menores de 5 anos,clasificacion a y b,2001-04-01,7,18,7,18,25
10902,CULPINA,estado nutricional en menores de 5 anos,clasificacion a y b,2001-04-01,14,44,14,44,58
40401,CURAHUARA DE CARANGAS,estado nutricional en menores de 5 anos,clasificacion a y b,2001-04-01,1,0,1,0,1
21602,CURVA,estado nutricional en menores de 5 anos,clasificacion a y b,2001-04-01,0,3,0,3,3
20804,DESAGUADERO,estado nutricional en menores de 5 anos,clasificacion a y b,2001-04-01,0,6,0,6,6
20105,EL ALTO,estado nutricional en menores de 5 anos,clasificacion a y b,2001-04-01,434,810,434,810,1244
40103,EL CHORO,estado nutricional en menores de 5 anos,clasificacion a y b,2001-04-01,0,5,0,5,5
71503,EL PUENTE(STC),estado nutricional en menores de 5 anos,clasificacion a y b,2001-04-01,9,19,9,19,28
60502,EL PUENTE(TJA),estado nutricional en menores de 5 anos,clasificacion a y b,2001-04-01,4,3,4,3,7
70105,EL TORNO,estado nutricional en menores de 5 anos,clasificacion a y b,2001-04-01,15,22,15,22,37
10405,EL VILLAR,estado nutricional en menores de 5 anos,clasificacion a y b,2001-04-01,8,9,8,9,17
60601,ENTRE RIOS,estado nutricional en menores de 5 anos,clasificacion a y b,2001-04-01,8,34,8,34,42
40502,ESCARA,estado nutricional en menores de 5 anos,clasificacion a y b,2001-04-01,0,2,0,2,2
41101,EUCALIPTUS,estado nutricional en menores de 5 anos,clasificacion a y b,2001-04-01,1,13,1,13,14
80402,EXALTACION,estado nutricional en menores de 5 anos,clasificacion a y b,2001-04-01,1,5,1,5,6
90203,FILADELFIA,estado nutricional en menores de 5 anos,clasificacion a y b,2001-04-01,2,3,2,3,5
71002,GENERAL SAAVEDRA,estado nutricional en menores de 5 anos,clasificacion a y b,2001-04-01,14,57,14,57,71
21601,GRAL. J.J. PEREZ (CHARAZANI),estado nutricional en menores de 5 anos,clasificacion a y b,2001-04-01,2,4,2,4,6
20602,GUANAY,estado nutricional en menores de 5 anos,clasificacion a y b,2001-04-01,8,19,8,19,27
20802,GUAQUI,estado nutricional en menores de 5 anos,clasificacion a y b,2001-04-01,1,8,1,8,9
80202,GUAYARAMERIN,estado nutricional en menores de 5 anos,clasificacion a y b,2001-04-01,16,57,16,57,73
70705,GUTIERREZ,estado nutricional en menores de 5 anos,clasificacion a y b,2001-04-01,17,85,17,85,102
10502,HUACARETA,estado nutricional en menores de 5 anos,clasificacion a y b,2001-04-01,5,52,5,52,57
11002,HUACAYA (VILLA DE HUACAYA),estado nutricional en menores de 5 anos,clasificacion a y b,2001-04-01,7,14,7,14,21
40501,HUACHACALLA,estado nutricional en menores de 5 anos,clasificacion a y b,2001-04-01,0,3,0,3,3
40701,HUANUNI,estado nutricional en menores de 5 anos,clasificacion a y b,2001-04-01,3,7,3,7,10
80803,HUARACAJE,estado nutricional en menores de 5 anos,clasificacion a y b,2001-04-01,4,12,4,12,16
41601,HUAYLLAMARCA,estado nutricional en menores de 5 anos,clasificacion a y b,2001-04-01,0,3,0,3,3
21005,ICHOCA,estado nutricional en menores de 5 anos,clasificacion a y b,2001-04-01,0,3,0,3,3
10304,ICLA,estado nutricional en menores de 5 anos,clasificacion a y b,2001-04-01,5,12,5,12,17
10703,INCAHUASI,estado nutricional en menores de 5 anos,clasificacion a y b,2001-04-01,9,19,9,19,28
21001,INQUISIVI,estado nutricional en menores de 5 anos,clasificacion a y b,2001-04-01,0,11,0,11,11
21102,IRUPANA (VILLA DE LANZA),estado nutricional en menores de 5 anos,clasificacion a y b,2001-04-01,10,48,10,48,58
21501,IXIAMAS,estado nutricional en menores de 5 anos,clasificacion a y b,2001-04-01,6,31,6,31,37
21105,LA ASUNTA,estado nutricional en menores de 5 anos,clasificacion a y b,2001-04-01,5,36,5,36,41
20101,LA PAZ,estado nutricional en menores de 5 anos,clasificacion a y b,2001-04-01,157,375,157,375,532
41501,LA RIVERA,estado nutricional en menores de 5 anos,clasificacion a y b,2001-04-01,0,1,0,1,1
70701,LAGUNILLAS,estado nutricional en menores de 5 anos,clasificacion a y b,2001-04-01,15,32,15,32,47
21202,LAJA,estado nutricional en menores de 5 anos,clasificacion a y b,2001-04-01,0,23,0,23,23
10903,LAS CARRERAS,estado nutricional en menores de 5 anos,clasificacion a y b,2001-04-01,3,10,3,10,13
21006,LICOMA PAMPA,estado nutricional en menores de 5 anos,clasificacion a y b,2001-04-01,1,1,1,1,2
50203,LLALLAGUA,estado nutricional en menores de 5 anos,clasificacion a y b,2001-04-01,5,25,5,25,30
51401,LLICA,estado nutricional en menores de 5 anos,clasificacion a y b,2001-04-01,2,4,2,4,6
80601,LORETO,estado nutricional en menores de 5 anos,clasificacion a y b,2001-04-01,1,5,1,5,6
20901,LURIBAY,estado nutricional en menores de 5 anos,clasificacion a y b,2001-04-01,11,18,11,18,29
40702,MACHACAMARCA,estado nutricional en menores de 5 anos,clasificacion a y b,2001-04-01,1,10,1,10,11
11003,MACHARETI,estado nutricional en menores de 5 anos,clasificacion a y b,2001-04-01,10,62,10,62,72
80801,MAGDALENA,estado nutricional en menores de 5 anos,clasificacion a y b,2001-04-01,5,4,5,4,9
70903,MAIRANA,estado nutricional en menores de 5 anos,clasificacion a y b,2001-04-01,4,26,4,26,30
20103,MECAPACA,estado nutricional en menores de 5 anos,clasificacion a y b,2001-04-01,0,12,0,12,12
71003,MINEROS,estado nutricional en menores de 5 anos,clasificacion a y b,2001-04-01,55,165,55,165,220
31301,MIZQUE,estado nutricional en menores de 5 anos,clasificacion a y b,2001-04-01,20,20,20,20,40
20402,MOCOMOCO,estado nutricional en menores de 5 anos,clasificacion a y b,2001-04-01,2,6,2,6,8
51002,MOJINETE,estado nutricional en menores de 5 anos,clasificacion a y b,2001-04-01,0,1,0,1,1
10303,MOJOCOYA,estado nutricional en menores de 5 anos,clasificacion a y b,2001-04-01,13,38,13,38,51
10501,MONTEAGUDO,estado nutricional en menores de 5 anos,clasificacion a y b,2001-04-01,19,97,19,97,116
71001,MONTERO,estado nutricional en menores de 5 anos,clasificacion a y b,2001-04-01,130,277,130,277,407
70803,MORO MORO,estado nutricional en menores de 5 anos,clasificacion a y b,2001-04-01,0,7,0,7,7
30302,MOROCHATA,estado nutricional en menores de 5 anos,clasificacion a y b,2001-04-01,2,25,2,25,27
90501,NUEVO MANOA (NUEVA ESPERANZA),estado nutricional en menores de 5 anos,clasificacion a y b,2001-04-01,0,2,0,2,2
50404,OCURI,estado nutricional en menores de 5 anos,clasificacion a y b,2001-04-01,8,17,8,17,25
70202,OKINAWA,estado nutricional en menores de 5 anos,clasificacion a y b,2001-04-01,7,24,7,24,31
30203,OMEREQUE,estado nutricional en menores de 5 anos,clasificacion a y b,2001-04-01,1,14,1,14,15
40101,ORURO,estado nutricional en menores de 5 anos,clasificacion a y b,2001-04-01,44,193,44,193,237
60201,PADCAYA,estado nutricional en menores de 5 anos,clasificacion a y b,2001-04-01,8,41,8,41,49
10401,PADILLA,estado nutricional en menores de 5 anos,clasificacion a y b,2001-04-01,15,58,15,58,73
70502,PAILON,estado nutricional en menores de 5 anos,clasificacion a y b,2001-04-01,31,42,31,42,73
20102,PALCA,estado nutricional en menores de 5 anos,clasificacion a y b,2001-04-01,4,18,4,18,22
21104,PALOS BLANCOS,estado nutricional en menores de 5 anos,clasificacion a y b,2001-04-01,12,41,12,41,53
40802,PAMPA AULLAGAS,estado nutricional en menores de 5 anos,clasificacion a y b,2001-04-01,0,2,0,2,2
70902,PAMPA GRANDE,estado nutricional en menores de 5 anos,clasificacion a y b,2001-04-01,3,24,3,24,27
21802,PAPEL PAMPA,estado nutricional en menores de 5 anos,clasificacion a y b,2001-04-01,1,2,1,2,3
30202,PASORAPA,estado nutricional en menores de 5 anos,clasificacion a y b,2001-04-01,3,8,3,8,11
21305,PATACAMAYA,estado nutricional en menores de 5 anos,clasificacion a y b,2001-04-01,5,8,5,8,13
40602,PAZÃ‘A,estado nutricional en menores de 5 anos,clasificacion a y b,2001-04-01,0,1,0,1,1
20702,PELECHUCO,estado nutricional en menores de 5 anos,clasificacion a y b,2001-04-01,3,3,3,3,6
50403,POCOATA,estado nutricional en menores de 5 anos,clasificacion a y b,2001-04-01,7,22,7,22,29
31203,POCONA,estado nutricional en menores de 5 anos,clasificacion a y b,2001-04-01,0,5,0,5,5
31202,POJO (CBBA),estado nutricional en menores de 5 anos,clasificacion a y b,2001-04-01,31,53,31,53,84
51203,PORCO,estado nutricional en menores de 5 anos,clasificacion a y b,2001-04-01,2,6,2,6,8
10103,POROMA,estado nutricional en menores de 5 anos,clasificacion a y b,2001-04-01,3,21,3,21,24
70103,PORONGO,estado nutricional en menores de 5 anos,clasificacion a y b,2001-04-01,3,28,3,28,31
70601,PORTACHUELO,estado nutricional en menores de 5 anos,clasificacion a y b,2001-04-01,120,142,120,142,262
90102,PORVENIR,estado nutricional en menores de 5 anos,clasificacion a y b,2001-04-01,4,24,4,24,28
50101,POTOSI,estado nutricional en menores de 5 anos,clasificacion a y b,2001-04-01,29,105,29,105,134
10302,PRESTO,estado nutricional en menores de 5 anos,clasificacion a y b,2001-04-01,5,11,5,11,16
21201,PUCARANI,estado nutricional en menores de 5 anos,clasificacion a y b,2001-04-01,3,25,3,25,28
20401,PUERTO ACOSTA,estado nutricional en menores de 5 anos,clasificacion a y b,2001-04-01,9,20,9,20,29
20403,PUERTO CARABUCO,estado nutricional en menores de 5 anos,clasificacion a y b,2001-04-01,5,19,5,19,24
90301,PUERTO GONZALO MORENO,estado nutricional en menores de 5 anos,clasificacion a y b,2001-04-01,0,7,0,7,7
21204,PUERTO PEREZ,estado nutricional en menores de 5 anos,clasificacion a y b,2001-04-01,1,3,1,3,4
71402,PUERTO QUIJARRO,estado nutricional en menores de 5 anos,clasificacion a y b,2001-04-01,12,45,12,45,57
90201,PUERTO RICO,estado nutricional en menores de 5 anos,clasificacion a y b,2001-04-01,1,1,1,1,2
80703,PUERTO SILES,estado nutricional en menores de 5 anos,clasificacion a y b,2001-04-01,0,5,0,5,5
71401,PUERTO SUAREZ,estado nutricional en menores de 5 anos,clasificacion a y b,2001-04-01,13,29,13,29,42
31205,PUERTO VILLARROEL,estado nutricional en menores de 5 anos,clasificacion a y b,2001-04-01,22,67,22,67,89
51101,PUNA,estado nutricional en menores de 5 anos,clasificacion a y b,2001-04-01,25,45,25,45,70
31401,PUNATA,estado nutricional en menores de 5 anos,clasificacion a y b,2001-04-01,8,33,8,33,41
20604,QUIABAYA,estado nutricional en menores de 5 anos,clasificacion a y b,2001-04-01,3,3,3,3,6
30901,QUILLACOLLO,estado nutricional en menores de 5 anos,clasificacion a y b,2001-04-01,5,9,5,9,14
21002,QUIME,estado nutricional en menores de 5 anos,clasificacion a y b,2001-04-01,2,10,2,10,12
70904,QUIRUSILLAS,estado nutricional en menores de 5 anos,clasificacion a y b,2001-04-01,0,2,0,2,2
50402,RAVELO,estado nutricional en menores de 5 anos,clasificacion a y b,2001-04-01,10,24,10,24,34
80301,REYES,estado nutricional en menores de 5 anos,clasificacion a y b,2001-04-01,0,10,0,10,10
80201,RIBERALTA,estado nutricional en menores de 5 anos,clasificacion a y b,2001-04-01,61,131,61,131,192
70503,ROBORE,estado nutricional en menores de 5 anos,clasificacion a y b,2001-04-01,15,50,15,50,65
80304,RURRENABAQUE,estado nutricional en menores de 5 anos,clasificacion a y b,2001-04-01,15,11,15,11,26
40901,SABAYA,estado nutricional en menores de 5 anos,clasificacion a y b,2001-04-01,1,4,1,4,5
31001,SACABA,estado nutricional en menores de 5 anos,clasificacion a y b,2001-04-01,6,36,6,36,42
30404,SACABAMBA,estado nutricional en menores de 5 anos,clasificacion a y b,2001-04-01,1,4,1,4,5
50701,SACACA,estado nutricional en menores de 5 anos,clasificacion a y b,2001-04-01,4,13,4,13,17
71302,SAIPINA,estado nutricional en menores de 5 anos,clasificacion a y b,2001-04-01,1,0,1,0,1
40801,SALINAS DE GARCI MENDOZA,estado nutricional en menores de 5 anos,clasificacion a y b,2001-04-01,0,8,0,8,8
70901,SAMAIPATA,estado nutricional en menores de 5 anos,clasificacion a y b,2001-04-01,6,22,6,22,28
51601,SAN AGUSTIN,estado nutricional en menores de 5 anos,clasificacion a y b,2001-04-01,2,4,2,4,6
80602,SAN ANDRES,estado nutricional en menores de 5 anos,clasificacion a y b,2001-04-01,2,17,2,17,19
51003,SAN ANTONIO DE ESMORUCO,estado nutricional en menores de 5 anos,clasificacion a y b,2001-04-01,0,1,0,1,1
71105,SAN ANTONIO DE LOMERIO,estado nutricional en menores de 5 anos,clasificacion a y b,2001-04-01,2,12,2,12,14
31403,SAN BENITO,estado nutricional en menores de 5 anos,clasificacion a y b,2001-04-01,9,11,9,11,20
80302,SAN BORJA,estado nutricional en menores de 5 anos,clasificacion a y b,2001-04-01,17,46,17,46,63
21502,SAN BUENA VENTURA,estado nutricional en menores de 5 anos,clasificacion a y b,2001-04-01,5,17,5,17,22
70402,SAN CARLOS,estado nutricional en menores de 5 anos,clasificacion a y b,2001-04-01,27,53,27,53,80
80501,SAN IGNACIO,estado nutricional en menores de 5 anos,clasificacion a y b,2001-04-01,18,53,18,53,71
70301,SAN IGNACIO DE VELASCO,estado nutricional en menores de 5 anos,clasificacion a y b,2001-04-01,62,133,62,133,195
80102,SAN JAVIER(BNI),estado nutricional en menores de 5 anos,clasificacion a y b,2001-04-01,1,4,1,4,5
71102,SAN JAVIER(STC),estado nutricional en menores de 5 anos,clasificacion a y b,2001-04-01,25,21,25,21,46
80701,SAN JOAQUIN,estado nutricional en menores de 5 anos,clasificacion a y b,2001-04-01,2,20,2,20,22
70501,SAN JOSE DE CHIQUITOS,estado nutricional en menores de 5 anos,clasificacion a y b,2001-04-01,4,33,4,33,37
71104,SAN JULIAN,estado nutricional en menores de 5 anos,clasificacion a y b,2001-04-01,51,168,51,168,219
90302,SAN LORENZO(PND),estado nutricional en menores de 5 anos,clasificacion a y b,2001-04-01,0,38,0,38,38
60501,SAN LORENZO(TJA),estado nutricional en menores de 5 anos,clasificacion a y b,2001-04-01,5,13,5,13,18
10702,SAN LUCAS,estado nutricional en menores de 5 anos,clasificacion a y b,2001-04-01,11,68,11,68,79
71201,SAN MATIAS,estado nutricional en menores de 5 anos,clasificacion a y b,2001-04-01,5,22,5,22,27
70302,SAN MIGUEL DE VELASCO,estado nutricional en menores de 5 anos,clasificacion a y b,2001-04-01,10,17,10,17,27
51001,SAN PABLO DE LIPEZ,estado nutricional en menores de 5 anos,clasificacion a y b,2001-04-01,3,2,3,2,5
50501,SAN PEDRO DE BUENA VISTA,estado nutricional en menores de 5 anos,clasificacion a y b,2001-04-01,2,15,2,15,17
21801,SAN PEDRO DE CURAHUARA,estado nutricional en menores de 5 anos,clasificacion a y b,2001-04-01,1,15,1,15,16
21702,SAN PEDRO DE TIQUINA,estado nutricional en menores de 5 anos,clasificacion a y b,2001-04-01,0,4,0,4,4
70303,SAN RAFAEL,estado nutricional en menores de 5 anos,clasificacion a y b,2001-04-01,1,20,1,20,21
80702,SAN RAMON,estado nutricional en menores de 5 anos,clasificacion a y b,2001-04-01,7,72,7,72,79
80702,SAN RAMON,estado nutricional en menores de 5 anos,clasificacion a y b,2001-04-01,7,10,7,10,17
80401,SANTA ANA,estado nutricional en menores de 5 anos,clasificacion a y b,2001-04-01,26,42,26,42,68
70101,SANTA CRUZ DE LA SIERRA,estado nutricional en menores de 5 anos,clasificacion a y b,2001-04-01,336,711,336,711,1047
80303,SANTA ROSA,estado nutricional en menores de 5 anos,clasificacion a y b,2001-04-01,2,7,2,7,9
70602,SANTA ROSA DEL SARA,estado nutricional en menores de 5 anos,clasificacion a y b,2001-04-01,6,25,6,25,31
20308,SANTIAGO DE CALLAPA,estado nutricional en menores de 5 anos,clasificacion a y b,2001-04-01,0,8,0,8,8
41401,SANTIAGO DE HUARI,estado nutricional en menores de 5 anos,clasificacion a y b,2001-04-01,2,4,2,4,6
21901,SANTIAGO DE MACHACA,estado nutricional en menores de 5 anos,clasificacion a y b,2001-04-01,0,4,0,4,4
30702,SANTIVAÃ‘ES,estado nutricional en menores de 5 anos,clasificacion a y b,2001-04-01,2,5,2,5,7
40202,SANTUARIO DE QUILLACAS,estado nutricional en menores de 5 anos,clasificacion a y b,2001-04-01,0,3,0,3,3
20902,SAPAHAQUI,estado nutricional en menores de 5 anos,clasificacion a y b,2001-04-01,1,4,1,4,5
21301,SICA SICA (VILLA AROMA),estado nutricional en menores de 5 anos,clasificacion a y b,2001-04-01,2,31,2,31,33
30703,SICAYA,estado nutricional en menores de 5 anos,clasificacion a y b,2001-04-01,0,6,0,6,6
10403,SOPACHUY,estado nutricional en menores de 5 anos,clasificacion a y b,2001-04-01,4,25,4,25,29
20601,SORATA,estado nutricional en menores de 5 anos,clasificacion a y b,2001-04-01,5,10,5,10,15
10101,SUCRE,estado nutricional en menores de 5 anos,clasificacion a y b,2001-04-01,201,517,201,517,718
20603,TACACOMA,estado nutricional en menores de 5 anos,clasificacion a y b,2001-04-01,0,11,0,11,11
50303,TACOBAMBA,estado nutricional en menores de 5 anos,clasificacion a y b,2001-04-01,1,8,1,8,9
30602,TACOPAYA,estado nutricional en menores de 5 anos,clasificacion a y b,2001-04-01,5,9,5,9,14
51402,TAHUA,estado nutricional en menores de 5 anos,clasificacion a y b,2001-04-01,0,1,0,1,1
31101,TAPACARI,estado nutricional en menores de 5 anos,clasificacion a y b,2001-04-01,2,24,2,24,26
10601,TARABUCO,estado nutricional en menores de 5 anos,clasificacion a y b,2001-04-01,10,29,10,29,39
30401,TARATA,estado nutricional en menores de 5 anos,clasificacion a y b,2001-04-01,4,14,4,14,18
60101,TARIJA,estado nutricional en menores de 5 anos,clasificacion a y b,2001-04-01,56,205,56,205,261
10202,TARVITA,estado nutricional en menores de 5 anos,clasificacion a y b,2001-04-01,13,25,13,25,38
20803,TIAWANACU,estado nutricional en menores de 5 anos,clasificacion a y b,2001-04-01,2,29,2,29,31
50102,TINGUIPAYA,estado nutricional en menores de 5 anos,clasificacion a y b,2001-04-01,5,8,5,8,13
20606,TIPUANI,estado nutricional en menores de 5 anos,clasificacion a y b,2001-04-01,1,6,1,6,7
30903,TIQUIPAYA,estado nutricional en menores de 5 anos,clasificacion a y b,2001-04-01,2,16,2,16,18
31601,TIRAQUE (CBBA),estado nutricional en menores de 5 anos,clasificacion a y b,2001-04-01,14,13,14,13,27
30802,TOCO,estado nutricional en menores de 5 anos,clasificacion a y b,2001-04-01,0,2,0,2,2
30803,TOLATA,estado nutricional en menores de 5 anos,clasificacion a y b,2001-04-01,0,5,0,5,5
41001,TOLEDO,estado nutricional en menores de 5 anos,clasificacion a y b,2001-04-01,1,10,1,10,11
51202,TOMAVE,estado nutricional en menores de 5 anos,clasificacion a y b,2001-04-01,4,8,4,8,12
10402,TOMINA,estado nutricional en menores de 5 anos,clasificacion a y b,2001-04-01,5,25,5,25,30
50502,TORO TORO,estado nutricional en menores de 5 anos,clasificacion a y b,2001-04-01,1,2,1,2,3
31201,TOTORA(CBBA),estado nutricional en menores de 5 anos,clasificacion a y b,2001-04-01,22,41,22,41,63
41301,TOTORA(ORR),estado nutricional en menores de 5 anos,clasificacion a y b,2001-04-01,0,1,0,1,1
70802,TRIGAL,estado nutricional en menores de 5 anos,clasificacion a y b,2001-04-01,1,1,1,1,2
80101,TRINIDAD,estado nutricional en menores de 5 anos,clasificacion a y b,2001-04-01,29,84,29,84,113
50801,TUPIZA,estado nutricional en menores de 5 anos,clasificacion a y b,2001-04-01,22,82,22,82,104
40402,TURCO,estado nutricional en menores de 5 anos,clasificacion a y b,2001-04-01,0,2,0,2,2
21302,UMALA,estado nutricional en menores de 5 anos,clasificacion a y b,2001-04-01,0,2,0,2,2
50201,UNCIA,estado nutricional en menores de 5 anos,clasificacion a y b,2001-04-01,5,5,5,5,10
60401,URIONDO (A. CONCEPCION),estado nutricional en menores de 5 anos,clasificacion a y b,2001-04-01,10,59,10,59,69
71502,URUBICHA,estado nutricional en menores de 5 anos,clasificacion a y b,2001-04-01,0,5,0,5,5
51201,UYUNI,estado nutricional en menores de 5 anos,clasificacion a y b,2001-04-01,13,78,13,78,91
30502,VACAS,estado nutricional en menores de 5 anos,clasificacion a y b,2001-04-01,1,2,1,2,3
70801,VALLEGRANDE,estado nutricional en menores de 5 anos,clasificacion a y b,2001-04-01,3,56,3,56,59
20801,VIACHA,estado nutricional en menores de 5 anos,clasificacion a y b,2001-04-01,23,49,23,49,72
31302,VILA VILA,estado nutricional en menores de 5 anos,clasificacion a y b,2001-04-01,2,1,2,1,3
60303,VILLA MONTES,estado nutricional en menores de 5 anos,clasificacion a y b,2001-04-01,7,26,7,26,33
31402,VILLA RIVERO,estado nutricional en menores de 5 anos,clasificacion a y b,2001-04-01,5,1,5,1,6
10801,VILLA SERRANO,estado nutricional en menores de 5 anos,clasificacion a y b,2001-04-01,10,33,10,33,43
31003,VILLA TUNARI,estado nutricional en menores de 5 anos,clasificacion a y b,2001-04-01,12,12,12,12,24
11001,VILLA VACA GUZMAN (MUYUPAMPA),estado nutricional en menores de 5 anos,clasificacion a y b,2001-04-01,15,84,15,84,99
51501,VILLAZON,estado nutricional en menores de 5 anos,clasificacion a y b,2001-04-01,13,57,13,57,70
30904,VINTO,estado nutricional en menores de 5 anos,clasificacion a y b,2001-04-01,17,48,17,48,65
50602,VITICHI,estado nutricional en menores de 5 anos,clasificacion a y b,2001-04-01,3,22,3,22,25
20306,WALDO BALLIVIAN,estado nutricional en menores de 5 anos,clasificacion a y b,2001-04-01,3,2,3,2,5
70201,WARNES,estado nutricional en menores de 5 anos,clasificacion a y b,2001-04-01,25,67,25,67,92
20903,YACO,estado nutricional en menores de 5 anos,clasificacion a y b,2001-04-01,3,26,3,26,29
60301,YACUIBA,estado nutricional en menores de 5 anos,clasificacion a y b,2001-04-01,40,121,40,121,161
10602,YAMPARAEZ,estado nutricional en menores de 5 anos,clasificacion a y b,2001-04-01,9,39,9,39,48
21103,YANACACHI,estado nutricional en menores de 5 anos,clasificacion a y b,2001-04-01,7,24,7,24,31
70403,YAPACANI,estado nutricional en menores de 5 anos,clasificacion a y b,2001-04-01,14,31,14,31,45
50103,YOCALLA,estado nutricional en menores de 5 anos,clasificacion a y b,2001-04-01,0,8,0,8,8
10102,YOTALA,estado nutricional en menores de 5 anos,clasificacion a y b,2001-04-01,7,42,7,42,49
60402,YUNCHARA,estado nutricional en menores de 5 anos,clasificacion a y b,2001-04-01,3,5,3,5,8
10301,ZUDAÃ‘EZ,estado nutricional en menores de 5 anos,clasificacion a y b,2001-04-01,6,14,6,14,20
51302,ACACIO,estado nutricional en menores de 5 anos,clasificacion a y b,2001-05-01,2,6,2,6,8
20201,ACHACACHI,estado nutricional en menores de 5 anos,clasificacion a y b,2001-05-01,21,157,21,157,178
20104,ACHOCALLA,estado nutricional en menores de 5 anos,clasificacion a y b,2001-05-01,3,11,3,11,14
30201,AIQUILE,estado nutricional en menores de 5 anos,clasificacion a y b,2001-05-01,22,29,22,29,51
31303,ALALAY,estado nutricional en menores de 5 anos,clasificacion a y b,2001-05-01,2,0,2,0,2
10404,ALCALA,estado nutricional en menores de 5 anos,clasificacion a y b,2001-05-01,1,9,1,9,10
20202,ANCORAIMES,estado nutricional en menores de 5 anos,clasificacion a y b,2001-05-01,5,24,5,24,29
41201,ANDAMARCA,estado nutricional en menores de 5 anos,clasificacion a y b,2001-05-01,1,6,1,6,7
40603,ANTEQUERA,estado nutricional en menores de 5 anos,clasificacion a y b,2001-05-01,4,8,4,8,12
30402,ANZALDO,estado nutricional en menores de 5 anos,clasificacion a y b,2001-05-01,1,13,1,13,14
20701,APOLO,estado nutricional en menores de 5 anos,clasificacion a y b,2001-05-01,17,2,17,2,19
30501,ARANI,estado nutricional en menores de 5 anos,clasificacion a y b,2001-05-01,1,1,1,1,2
30403,ARBIETO,estado nutricional en menores de 5 anos,clasificacion a y b,2001-05-01,10,15,10,15,25
30601,ARQUE,estado nutricional en menores de 5 anos,clasificacion a y b,2001-05-01,2,2,2,2,4
71501,ASCENCION DE GUARAYOS,estado nutricional en menores de 5 anos,clasificacion a y b,2001-05-01,1,18,1,18,19
50802,ATOCHA,estado nutricional en menores de 5 anos,clasificacion a y b,2001-05-01,2,11,2,11,13
20503,AUCAPATA,estado nutricional en menores de 5 anos,clasificacion a y b,2001-05-01,3,3,3,3,6
20502,AYATA,estado nutricional en menores de 5 anos,clasificacion a y b,2001-05-01,3,1,3,1,4
21303,AYO AYO,estado nutricional en menores de 5 anos,clasificacion a y b,2001-05-01,9,1,9,1,10
30301,AYOPAYA (V. DE INDEPENDENCIA),estado nutricional en menores de 5 anos,clasificacion a y b,2001-05-01,6,21,6,21,27
10201,AZURDUY,estado nutricional en menores de 5 anos,clasificacion a y b,2001-05-01,8,25,8,25,33
21203,BATALLAS,estado nutricional en menores de 5 anos,clasificacion a y b,2001-05-01,6,38,6,38,44
80802,BAURES,estado nutricional en menores de 5 anos,clasificacion a y b,2001-05-01,1,19,1,19,20
41202,BELEN DE ANDAMARCA,estado nutricional en menores de 5 anos,clasificacion a y b,2001-05-01,1,2,1,2,3
50104,BELEN DE URMIRI,estado nutricional en menores de 5 anos,clasificacion a y b,2001-05-01,8,9,8,9,17
90104,BELLA FLOR,estado nutricional en menores de 5 anos,clasificacion a y b,2001-05-01,7,14,7,14,21
60202,BERMEJO,estado nutricional en menores de 5 anos,clasificacion a y b,2001-05-01,32,34,32,34,66
50301,BETANZOS,estado nutricional en menores de 5 anos,clasificacion a y b,2001-05-01,15,41,15,41,56
31501,BOLIVAR,estado nutricional en menores de 5 anos,clasificacion a y b,2001-05-01,0,2,0,2,2
90103,BOLPEBRA,estado nutricional en menores de 5 anos,clasificacion a y b,2001-05-01,2,9,2,9,11
70707,BOYUIBE,estado nutricional en menores de 5 anos,clasificacion a y b,2001-05-01,2,26,2,26,28
70401,BUENA VISTA,estado nutricional en menores de 5 anos,clasificacion a y b,2001-05-01,21,54,21,54,75
70703,CABEZAS,estado nutricional en menores de 5 anos,clasificacion a y b,2001-05-01,31,64,31,64,95
20905,CAIROMA,estado nutricional en menores de 5 anos,clasificacion a y b,2001-05-01,2,1,2,1,3
51102,"CAIZA ""D""",estado nutricional en menores de 5 anos,clasificacion a y b,2001-05-01,11,36,11,36,47
21003,CAJUATA,estado nutricional en menores de 5 anos,clasificacion a y b,2001-05-01,1,12,1,12,13
21304,CALAMARCA,estado nutricional en menores de 5 anos,clasificacion a y b,2001-05-01,6,8,6,8,14
10701,CAMARGO,estado nutricional en menores de 5 anos,clasificacion a y b,2001-05-01,19,25,19,25,44
10901,CAMATAQUI (C. VILLA ABECIA),estado nutricional en menores de 5 anos,clasificacion a y b,2001-05-01,3,7,3,7,10
70706,CAMIRI,estado nutricional en menores de 5 anos,clasificacion a y b,2001-05-01,9,151,9,151,160
30701,CAPINOTA,estado nutricional en menores de 5 anos,clasificacion a y b,2001-05-01,7,9,7,9,16
20302,CAQUIAVIRI,estado nutricional en menores de 5 anos,clasificacion a y b,2001-05-01,1,24,1,24,25
40102,CARACOLLO,estado nutricional en menores de 5 anos,clasificacion a y b,2001-05-01,18,34,18,34,52
22001,CARANAVI,estado nutricional en menores de 5 anos,clasificacion a y b,2001-05-01,44,122,44,122,166
41503,CARANGAS,estado nutricional en menores de 5 anos,clasificacion a y b,2001-05-01,0,1,0,1,1
60302,CARAPARI,estado nutricional en menores de 5 anos,clasificacion a y b,2001-05-01,6,42,6,42,48
50702,CARIPUYO,estado nutricional en menores de 5 anos,clasificacion a y b,2001-05-01,2,7,2,7,9
40201,CHALLAPATA,estado nutricional en menores de 5 anos,clasificacion a y b,2001-05-01,21,12,21,12,33
50302,CHAQUI,estado nutricional en menores de 5 anos,clasificacion a y b,2001-05-01,4,8,4,8,12
70702,CHARAGUA,estado nutricional en menores de 5 anos,clasificacion a y b,2001-05-01,21,129,21,129,150
20305,CHARAÃ‘A,estado nutricional en menores de 5 anos,clasificacion a y b,2001-05-01,0,2,0,2,2
50202,CHAYANTA,estado nutricional en menores de 5 anos,clasificacion a y b,2001-05-01,0,11,0,11,11
31204,CHIMORE,estado nutricional en menores de 5 anos,clasificacion a y b,2001-05-01,10,23,10,23,33
40302,CHOQUE COTA,estado nutricional en menores de 5 anos,clasificacion a y b,2001-05-01,1,2,1,2,3
21101,CHULUMANI (V. DE LA LIBERTAD),estado nutricional en menores de 5 anos,clasificacion a y b,2001-05-01,2,16,2,16,18
20501,CHUMA,estado nutricional en menores de 5 anos,clasificacion a y b,2001-05-01,5,6,5,6,11
30801,CLIZA,estado nutricional en menores de 5 anos,clasificacion a y b,2001-05-01,6,18,6,18,24
90101,COBIJA,estado nutricional en menores de 5 anos,clasificacion a y b,2001-05-01,22,69,22,69,91
30101,COCHABAMBA,estado nutricional en menores de 5 anos,clasificacion a y b,2001-05-01,109,367,109,367,476
40902,COIPASA,estado nutricional en menores de 5 anos,clasificacion a y b,2001-05-01,0,1,0,1,1
30905,COLCAPIRHUA,estado nutricional en menores de 5 anos,clasificacion a y b,2001-05-01,9,10,9,10,19
50901,"COLCHA ""K""",estado nutricional en menores de 5 anos,clasificacion a y b,2001-05-01,14,28,14,28,42
21307,COLLANA,estado nutricional en menores de 5 anos,clasificacion a y b,2001-05-01,1,0,1,0,1
31002,COLOMI,estado nutricional en menores de 5 anos,clasificacion a y b,2001-05-01,7,37,7,37,44
70603,COLPA BELGICA,estado nutricional en menores de 5 anos,clasificacion a y b,2001-05-01,20,33,20,33,53
50401,COLQUECHACA,estado nutricional en menores de 5 anos,clasificacion a y b,2001-05-01,1,26,1,26,27
21306,COLQUENCHA,estado nutricional en menores de 5 anos,clasificacion a y b,2001-05-01,3,31,3,31,34
21004,COLQUIRI,estado nutricional en menores de 5 anos,clasificacion a y b,2001-05-01,2,20,2,20,22
20304,COMANCHE,estado nutricional en menores de 5 anos,clasificacion a y b,2001-05-01,0,1,0,1,1
71301,COMARAPA,estado nutricional en menores de 5 anos,clasificacion a y b,2001-05-01,0,5,0,5,5
20605,COMBAYA,estado nutricional en menores de 5 anos,clasificacion a y b,2001-05-01,1,2,1,2,3
71101,CONCEPCION,estado nutricional en menores de 5 anos,clasificacion a y b,2001-05-01,12,70,12,70,82
21701,COPACABANA,estado nutricional en menores de 5 anos,clasificacion a y b,2001-05-01,1,31,1,31,32
21402,CORIPATA,estado nutricional en menores de 5 anos,clasificacion a y b,2001-05-01,0,10,0,10,10
20301,CORO CORO,estado nutricional en menores de 5 anos,clasificacion a y b,2001-05-01,3,14,3,14,17
21401,COROICO,estado nutricional en menores de 5 anos,clasificacion a y b,2001-05-01,1,9,1,9,10
40301,CORQUE,estado nutricional en menores de 5 anos,clasificacion a y b,2001-05-01,1,5,1,5,6
50601,COTAGAITA,estado nutricional en menores de 5 anos,clasificacion a y b,2001-05-01,12,26,12,26,38
70102,COTOCA,estado nutricional en menores de 5 anos,clasificacion a y b,2001-05-01,21,43,21,43,64
70704,CUEVO,estado nutricional en menores de 5 anos,clasificacion a y b,2001-05-01,8,26,8,26,34
10902,CULPINA,estado nutricional en menores de 5 anos,clasificacion a y b,2001-05-01,12,55,12,55,67
40401,CURAHUARA DE CARANGAS,estado nutricional en menores de 5 anos,clasificacion a y b,2001-05-01,4,1,4,1,5
20804,DESAGUADERO,estado nutricional en menores de 5 anos,clasificacion a y b,2001-05-01,1,5,1,5,6
20105,EL ALTO,estado nutricional en menores de 5 anos,clasificacion a y b,2001-05-01,451,931,451,931,1382
40103,EL CHORO,estado nutricional en menores de 5 anos,clasificacion a y b,2001-05-01,1,5,1,5,6
71503,EL PUENTE(STC),estado nutricional en menores de 5 anos,clasificacion a y b,2001-05-01,11,40,11,40,51
60502,EL PUENTE(TJA),estado nutricional en menores de 5 anos,clasificacion a y b,2001-05-01,1,5,1,5,6
70105,EL TORNO,estado nutricional en menores de 5 anos,clasificacion a y b,2001-05-01,44,111,44,111,155
10405,EL VILLAR,estado nutricional en menores de 5 anos,clasificacion a y b,2001-05-01,8,32,8,32,40
60601,ENTRE RIOS,estado nutricional en menores de 5 anos,clasificacion a y b,2001-05-01,11,69,11,69,80
41101,EUCALIPTUS,estado nutricional en menores de 5 anos,clasificacion a y b,2001-05-01,1,15,1,15,16
80402,EXALTACION,estado nutricional en menores de 5 anos,clasificacion a y b,2001-05-01,4,12,4,12,16
90203,FILADELFIA,estado nutricional en menores de 5 anos,clasificacion a y b,2001-05-01,2,13,2,13,15
71002,GENERAL SAAVEDRA,estado nutricional en menores de 5 anos,clasificacion a y b,2001-05-01,9,100,9,100,109
21601,GRAL. J.J. PEREZ (CHARAZANI),estado nutricional en menores de 5 anos,clasificacion a y b,2001-05-01,2,4,2,4,6
20602,GUANAY,estado nutricional en menores de 5 anos,clasificacion a y b,2001-05-01,14,45,14,45,59
20802,GUAQUI,estado nutricional en menores de 5 anos,clasificacion a y b,2001-05-01,0,9,0,9,9
80202,GUAYARAMERIN,estado nutricional en menores de 5 anos,clasificacion a y b,2001-05-01,35,56,35,56,91
70705,GUTIERREZ,estado nutricional en menores de 5 anos,clasificacion a y b,2001-05-01,31,107,31,107,138
10502,HUACARETA,estado nutricional en menores de 5 anos,clasificacion a y b,2001-05-01,6,46,6,46,52
11002,HUACAYA (VILLA DE HUACAYA),estado nutricional en menores de 5 anos,clasificacion a y b,2001-05-01,8,30,8,30,38
40501,HUACHACALLA,estado nutricional en menores de 5 anos,clasificacion a y b,2001-05-01,3,4,3,4,7
40701,HUANUNI,estado nutricional en menores de 5 anos,clasificacion a y b,2001-05-01,7,10,7,10,17
80803,HUARACAJE,estado nutricional en menores de 5 anos,clasificacion a y b,2001-05-01,3,16,3,16,19
21005,ICHOCA,estado nutricional en menores de 5 anos,clasificacion a y b,2001-05-01,2,2,2,2,4
10304,ICLA,estado nutricional en menores de 5 anos,clasificacion a y b,2001-05-01,11,11,11,11,22
10703,INCAHUASI,estado nutricional en menores de 5 anos,clasificacion a y b,2001-05-01,12,37,12,37,49
21001,INQUISIVI,estado nutricional en menores de 5 anos,clasificacion a y b,2001-05-01,4,8,4,8,12
21102,IRUPANA (VILLA DE LANZA),estado nutricional en menores de 5 anos,clasificacion a y b,2001-05-01,30,58,30,58,88
21501,IXIAMAS,estado nutricional en menores de 5 anos,clasificacion a y b,2001-05-01,2,33,2,33,35
21105,LA ASUNTA,estado nutricional en menores de 5 anos,clasificacion a y b,2001-05-01,6,29,6,29,35
70104,LA GUARDIA,estado nutricional en menores de 5 anos,clasificacion a y b,2001-05-01,63,254,63,254,317
20101,LA PAZ,estado nutricional en menores de 5 anos,clasificacion a y b,2001-05-01,259,606,259,606,865
41501,LA RIVERA,estado nutricional en menores de 5 anos,clasificacion a y b,2001-05-01,0,1,0,1,1
70701,LAGUNILLAS,estado nutricional en menores de 5 anos,clasificacion a y b,2001-05-01,3,13,3,13,16
21202,LAJA,estado nutricional en menores de 5 anos,clasificacion a y b,2001-05-01,5,35,5,35,40
10903,LAS CARRERAS,estado nutricional en menores de 5 anos,clasificacion a y b,2001-05-01,1,25,1,25,26
21006,LICOMA PAMPA,estado nutricional en menores de 5 anos,clasificacion a y b,2001-05-01,1,0,1,0,1
50203,LLALLAGUA,estado nutricional en menores de 5 anos,clasificacion a y b,2001-05-01,16,45,16,45,61
51401,LLICA,estado nutricional en menores de 5 anos,clasificacion a y b,2001-05-01,6,19,6,19,25
80601,LORETO,estado nutricional en menores de 5 anos,clasificacion a y b,2001-05-01,0,5,0,5,5
20901,LURIBAY,estado nutricional en menores de 5 anos,clasificacion a y b,2001-05-01,5,5,5,5,10
40702,MACHACAMARCA,estado nutricional en menores de 5 anos,clasificacion a y b,2001-05-01,2,8,2,8,10
11003,MACHARETI,estado nutricional en menores de 5 anos,clasificacion a y b,2001-05-01,9,76,9,76,85
80801,MAGDALENA,estado nutricional en menores de 5 anos,clasificacion a y b,2001-05-01,0,4,0,4,4
70903,MAIRANA,estado nutricional en menores de 5 anos,clasificacion a y b,2001-05-01,3,37,3,37,40
20103,MECAPACA,estado nutricional en menores de 5 anos,clasificacion a y b,2001-05-01,7,7,7,7,14
71003,MINEROS,estado nutricional en menores de 5 anos,clasificacion a y b,2001-05-01,42,194,42,194,236
31301,MIZQUE,estado nutricional en menores de 5 anos,clasificacion a y b,2001-05-01,45,19,45,19,64
20402,MOCOMOCO,estado nutricional en menores de 5 anos,clasificacion a y b,2001-05-01,5,12,5,12,17
51002,MOJINETE,estado nutricional en menores de 5 anos,clasificacion a y b,2001-05-01,0,1,0,1,1
10303,MOJOCOYA,estado nutricional en menores de 5 anos,clasificacion a y b,2001-05-01,3,15,3,15,18
10501,MONTEAGUDO,estado nutricional en menores de 5 anos,clasificacion a y b,2001-05-01,35,205,35,205,240
71001,MONTERO,estado nutricional en menores de 5 anos,clasificacion a y b,2001-05-01,138,453,138,453,591
70803,MORO MORO,estado nutricional en menores de 5 anos,clasificacion a y b,2001-05-01,3,6,3,6,9
30302,MOROCHATA,estado nutricional en menores de 5 anos,clasificacion a y b,2001-05-01,1,0,1,0,1
90401,NACEBE (SANTA ROSA DEL ABUNA),estado nutricional en menores de 5 anos,clasificacion a y b,2001-05-01,0,5,0,5,5
90501,NUEVO MANOA (NUEVA ESPERANZA),estado nutricional en menores de 5 anos,clasificacion a y b,2001-05-01,1,0,1,0,1
50404,OCURI,estado nutricional en menores de 5 anos,clasificacion a y b,2001-05-01,5,9,5,9,14
70202,OKINAWA,estado nutricional en menores de 5 anos,clasificacion a y b,2001-05-01,5,18,5,18,23
30203,OMEREQUE,estado nutricional en menores de 5 anos,clasificacion a y b,2001-05-01,4,27,4,27,31
40101,ORURO,estado nutricional en menores de 5 anos,clasificacion a y b,2001-05-01,73,252,73,252,325
60201,PADCAYA,estado nutricional en menores de 5 anos,clasificacion a y b,2001-05-01,18,54,18,54,72
10401,PADILLA,estado nutricional en menores de 5 anos,clasificacion a y b,2001-05-01,20,28,20,28,48
70502,PAILON,estado nutricional en menores de 5 anos,clasificacion a y b,2001-05-01,7,37,7,37,44
20102,PALCA,estado nutricional en menores de 5 anos,clasificacion a y b,2001-05-01,3,41,3,41,44
21104,PALOS BLANCOS,estado nutricional en menores de 5 anos,clasificacion a y b,2001-05-01,25,49,25,49,74
40802,PAMPA AULLAGAS,estado nutricional en menores de 5 anos,clasificacion a y b,2001-05-01,2,0,2,0,2
70902,PAMPA GRANDE,estado nutricional en menores de 5 anos,clasificacion a y b,2001-05-01,11,25,11,25,36
21802,PAPEL PAMPA,estado nutricional en menores de 5 anos,clasificacion a y b,2001-05-01,2,2,2,2,4
30202,PASORAPA,estado nutricional en menores de 5 anos,clasificacion a y b,2001-05-01,2,4,2,4,6
21305,PATACAMAYA,estado nutricional en menores de 5 anos,clasificacion a y b,2001-05-01,13,3,13,3,16
40602,PAZÃ‘A,estado nutricional en menores de 5 anos,clasificacion a y b,2001-05-01,2,3,2,3,5
20702,PELECHUCO,estado nutricional en menores de 5 anos,clasificacion a y b,2001-05-01,1,5,1,5,6
50403,POCOATA,estado nutricional en menores de 5 anos,clasificacion a y b,2001-05-01,8,20,8,20,28
31203,POCONA,estado nutricional en menores de 5 anos,clasificacion a y b,2001-05-01,3,5,3,5,8
31202,POJO (CBBA),estado nutricional en menores de 5 anos,clasificacion a y b,2001-05-01,89,89,89,89,178
40601,POOPO,estado nutricional en menores de 5 anos,clasificacion a y b,2001-05-01,0,3,0,3,3
51203,PORCO,estado nutricional en menores de 5 anos,clasificacion a y b,2001-05-01,1,19,1,19,20
10103,POROMA,estado nutricional en menores de 5 anos,clasificacion a y b,2001-05-01,14,20,14,20,34
70103,PORONGO,estado nutricional en menores de 5 anos,clasificacion a y b,2001-05-01,3,37,3,37,40
70601,PORTACHUELO,estado nutricional en menores de 5 anos,clasificacion a y b,2001-05-01,113,98,113,98,211
90102,PORVENIR,estado nutricional en menores de 5 anos,clasificacion a y b,2001-05-01,4,17,4,17,21
50101,POTOSI,estado nutricional en menores de 5 anos,clasificacion a y b,2001-05-01,44,124,44,124,168
10302,PRESTO,estado nutricional en menores de 5 anos,clasificacion a y b,2001-05-01,9,19,9,19,28
70805,PUCARA,estado nutricional en menores de 5 anos,clasificacion a y b,2001-05-01,0,1,0,1,1
21201,PUCARANI,estado nutricional en menores de 5 anos,clasificacion a y b,2001-05-01,4,40,4,40,44
20401,PUERTO ACOSTA,estado nutricional en menores de 5 anos,clasificacion a y b,2001-05-01,7,9,7,9,16
20403,PUERTO CARABUCO,estado nutricional en menores de 5 anos,clasificacion a y b,2001-05-01,1,17,1,17,18
90301,PUERTO GONZALO MORENO,estado nutricional en menores de 5 anos,clasificacion a y b,2001-05-01,0,1,0,1,1
21204,PUERTO PEREZ,estado nutricional en menores de 5 anos,clasificacion a y b,2001-05-01,1,3,1,3,4
71402,PUERTO QUIJARRO,estado nutricional en menores de 5 anos,clasificacion a y b,2001-05-01,13,48,13,48,61
90201,PUERTO RICO,estado nutricional en menores de 5 anos,clasificacion a y b,2001-05-01,0,5,0,5,5
80703,PUERTO SILES,estado nutricional en menores de 5 anos,clasificacion a y b,2001-05-01,1,1,1,1,2
71401,PUERTO SUAREZ,estado nutricional en menores de 5 anos,clasificacion a y b,2001-05-01,53,3,53,3,56
31205,PUERTO VILLARROEL,estado nutricional en menores de 5 anos,clasificacion a y b,2001-05-01,102,81,102,81,183
51101,PUNA,estado nutricional en menores de 5 anos,clasificacion a y b,2001-05-01,32,65,32,65,97
31401,PUNATA,estado nutricional en menores de 5 anos,clasificacion a y b,2001-05-01,26,20,26,20,46
20604,QUIABAYA,estado nutricional en menores de 5 anos,clasificacion a y b,2001-05-01,2,1,2,1,3
21002,QUIME,estado nutricional en menores de 5 anos,clasificacion a y b,2001-05-01,2,14,2,14,16
70904,QUIRUSILLAS,estado nutricional en menores de 5 anos,clasificacion a y b,2001-05-01,0,5,0,5,5
50402,RAVELO,estado nutricional en menores de 5 anos,clasificacion a y b,2001-05-01,6,12,6,12,18
80301,REYES,estado nutricional en menores de 5 anos,clasificacion a y b,2001-05-01,13,28,13,28,41
80201,RIBERALTA,estado nutricional en menores de 5 anos,clasificacion a y b,2001-05-01,89,163,89,163,252
70503,ROBORE,estado nutricional en menores de 5 anos,clasificacion a y b,2001-05-01,17,64,17,64,81
80304,RURRENABAQUE,estado nutricional en menores de 5 anos,clasificacion a y b,2001-05-01,45,45,45,45,90
40901,SABAYA,estado nutricional en menores de 5 anos,clasificacion a y b,2001-05-01,0,1,0,1,1
31001,SACABA,estado nutricional en menores de 5 anos,clasificacion a y b,2001-05-01,27,15,27,15,42
30404,SACABAMBA,estado nutricional en menores de 5 anos,clasificacion a y b,2001-05-01,0,1,0,1,1
50701,SACACA,estado nutricional en menores de 5 anos,clasificacion a y b,2001-05-01,6,24,6,24,30
71302,SAIPINA,estado nutricional en menores de 5 anos,clasificacion a y b,2001-05-01,2,2,2,2,4
40801,SALINAS DE GARCI MENDOZA,estado nutricional en menores de 5 anos,clasificacion a y b,2001-05-01,9,5,9,5,14
70901,SAMAIPATA,estado nutricional en menores de 5 anos,clasificacion a y b,2001-05-01,8,41,8,41,49
51601,SAN AGUSTIN,estado nutricional en menores de 5 anos,clasificacion a y b,2001-05-01,1,2,1,2,3
80602,SAN ANDRES,estado nutricional en menores de 5 anos,clasificacion a y b,2001-05-01,2,9,2,9,11
51003,SAN ANTONIO DE ESMORUCO,estado nutricional en menores de 5 anos,clasificacion a y b,2001-05-01,1,1,1,1,2
71105,SAN ANTONIO DE LOMERIO,estado nutricional en menores de 5 anos,clasificacion a y b,2001-05-01,8,29,8,29,37
31403,SAN BENITO,estado nutricional en menores de 5 anos,clasificacion a y b,2001-05-01,7,10,7,10,17
80302,SAN BORJA,estado nutricional en menores de 5 anos,clasificacion a y b,2001-05-01,17,39,17,39,56
21502,SAN BUENA VENTURA,estado nutricional en menores de 5 anos,clasificacion a y b,2001-05-01,6,28,6,28,34
70402,SAN CARLOS,estado nutricional en menores de 5 anos,clasificacion a y b,2001-05-01,44,50,44,50,94
80501,SAN IGNACIO,estado nutricional en menores de 5 anos,clasificacion a y b,2001-05-01,8,18,8,18,26
70301,SAN IGNACIO DE VELASCO,estado nutricional en menores de 5 anos,clasificacion a y b,2001-05-01,69,172,69,172,241
80102,SAN JAVIER(BNI),estado nutricional en menores de 5 anos,clasificacion a y b,2001-05-01,2,10,2,10,12
71102,SAN JAVIER(STC),estado nutricional en menores de 5 anos,clasificacion a y b,2001-05-01,30,53,30,53,83
80701,SAN JOAQUIN,estado nutricional en menores de 5 anos,clasificacion a y b,2001-05-01,4,17,4,17,21
70501,SAN JOSE DE CHIQUITOS,estado nutricional en menores de 5 anos,clasificacion a y b,2001-05-01,3,76,3,76,79
71104,SAN JULIAN,estado nutricional en menores de 5 anos,clasificacion a y b,2001-05-01,93,166,93,166,259
90302,SAN LORENZO(PND),estado nutricional en menores de 5 anos,clasificacion a y b,2001-05-01,0,3,0,3,3
60501,SAN LORENZO(TJA),estado nutricional en menores de 5 anos,clasificacion a y b,2001-05-01,7,21,7,21,28
10702,SAN LUCAS,estado nutricional en menores de 5 anos,clasificacion a y b,2001-05-01,23,74,23,74,97
71201,SAN MATIAS,estado nutricional en menores de 5 anos,clasificacion a y b,2001-05-01,8,28,8,28,36
70302,SAN MIGUEL DE VELASCO,estado nutricional en menores de 5 anos,clasificacion a y b,2001-05-01,18,13,18,13,31
51001,SAN PABLO DE LIPEZ,estado nutricional en menores de 5 anos,clasificacion a y b,2001-05-01,1,2,1,2,3
50501,SAN PEDRO DE BUENA VISTA,estado nutricional en menores de 5 anos,clasificacion a y b,2001-05-01,15,47,15,47,62
21801,SAN PEDRO DE CURAHUARA,estado nutricional en menores de 5 anos,clasificacion a y b,2001-05-01,0,4,0,4,4
21702,SAN PEDRO DE TIQUINA,estado nutricional en menores de 5 anos,clasificacion a y b,2001-05-01,3,18,3,18,21
70303,SAN RAFAEL,estado nutricional en menores de 5 anos,clasificacion a y b,2001-05-01,4,30,4,30,34
80702,SAN RAMON,estado nutricional en menores de 5 anos,clasificacion a y b,2001-05-01,8,42,8,42,50
80702,SAN RAMON,estado nutricional en menores de 5 anos,clasificacion a y b,2001-05-01,5,16,5,16,21
80401,SANTA ANA,estado nutricional en menores de 5 anos,clasificacion a y b,2001-05-01,20,39,20,39,59
70101,SANTA CRUZ DE LA SIERRA,estado nutricional en menores de 5 anos,clasificacion a y b,2001-05-01,484,770,484,770,1254
80303,SANTA ROSA,estado nutricional en menores de 5 anos,clasificacion a y b,2001-05-01,3,7,3,7,10
70602,SANTA ROSA DEL SARA,estado nutricional en menores de 5 anos,clasificacion a y b,2001-05-01,6,29,6,29,35
20308,SANTIAGO DE CALLAPA,estado nutricional en menores de 5 anos,clasificacion a y b,2001-05-01,1,1,1,1,2
41401,SANTIAGO DE HUARI,estado nutricional en menores de 5 anos,clasificacion a y b,2001-05-01,8,1,8,1,9
21901,SANTIAGO DE MACHACA,estado nutricional en menores de 5 anos,clasificacion a y b,2001-05-01,1,1,1,1,2
30702,SANTIVAÃ‘ES,estado nutricional en menores de 5 anos,clasificacion a y b,2001-05-01,1,0,1,0,1
40202,SANTUARIO DE QUILLACAS,estado nutricional en menores de 5 anos,clasificacion a y b,2001-05-01,0,3,0,3,3
20902,SAPAHAQUI,estado nutricional en menores de 5 anos,clasificacion a y b,2001-05-01,0,7,0,7,7
21301,SICA SICA (VILLA AROMA),estado nutricional en menores de 5 anos,clasificacion a y b,2001-05-01,4,10,4,10,14
30703,SICAYA,estado nutricional en menores de 5 anos,clasificacion a y b,2001-05-01,4,3,4,3,7
30902,SIPE SIPE,estado nutricional en menores de 5 anos,clasificacion a y b,2001-05-01,45,112,45,112,157
10403,SOPACHUY,estado nutricional en menores de 5 anos,clasificacion a y b,2001-05-01,5,10,5,10,15
20601,SORATA,estado nutricional en menores de 5 anos,clasificacion a y b,2001-05-01,5,29,5,29,34
10101,SUCRE,estado nutricional en menores de 5 anos,clasificacion a y b,2001-05-01,126,569,126,569,695
31404,TACACHI,estado nutricional en menores de 5 anos,clasificacion a y b,2001-05-01,0,3,0,3,3
20603,TACACOMA,estado nutricional en menores de 5 anos,clasificacion a y b,2001-05-01,1,8,1,8,9
50303,TACOBAMBA,estado nutricional en menores de 5 anos,clasificacion a y b,2001-05-01,5,11,5,11,16
30602,TACOPAYA,estado nutricional en menores de 5 anos,clasificacion a y b,2001-05-01,5,4,5,4,9
51402,TAHUA,estado nutricional en menores de 5 anos,clasificacion a y b,2001-05-01,0,3,0,3,3
31101,TAPACARI,estado nutricional en menores de 5 anos,clasificacion a y b,2001-05-01,1,13,1,13,14
10601,TARABUCO,estado nutricional en menores de 5 anos,clasificacion a y b,2001-05-01,12,45,12,45,57
30401,TARATA,estado nutricional en menores de 5 anos,clasificacion a y b,2001-05-01,5,32,5,32,37
60101,TARIJA,estado nutricional en menores de 5 anos,clasificacion a y b,2001-05-01,75,358,75,358,433
10202,TARVITA,estado nutricional en menores de 5 anos,clasificacion a y b,2001-05-01,10,41,10,41,51
20803,TIAWANACU,estado nutricional en menores de 5 anos,clasificacion a y b,2001-05-01,5,18,5,18,23
50102,TINGUIPAYA,estado nutricional en menores de 5 anos,clasificacion a y b,2001-05-01,4,5,4,5,9
20606,TIPUANI,estado nutricional en menores de 5 anos,clasificacion a y b,2001-05-01,17,7,17,7,24
30903,TIQUIPAYA,estado nutricional en menores de 5 anos,clasificacion a y b,2001-05-01,3,24,3,24,27
31601,TIRAQUE (CBBA),estado nutricional en menores de 5 anos,clasificacion a y b,2001-05-01,61,30,61,30,91
30802,TOCO,estado nutricional en menores de 5 anos,clasificacion a y b,2001-05-01,0,6,0,6,6
30803,TOLATA,estado nutricional en menores de 5 anos,clasificacion a y b,2001-05-01,0,3,0,3,3
41001,TOLEDO,estado nutricional en menores de 5 anos,clasificacion a y b,2001-05-01,6,11,6,11,17
51202,TOMAVE,estado nutricional en menores de 5 anos,clasificacion a y b,2001-05-01,9,13,9,13,22
10402,TOMINA,estado nutricional en menores de 5 anos,clasificacion a y b,2001-05-01,5,25,5,25,30
50502,TORO TORO,estado nutricional en menores de 5 anos,clasificacion a y b,2001-05-01,1,4,1,4,5
31201,TOTORA(CBBA),estado nutricional en menores de 5 anos,clasificacion a y b,2001-05-01,12,24,12,24,36
41301,TOTORA(ORR),estado nutricional en menores de 5 anos,clasificacion a y b,2001-05-01,2,3,2,3,5
70802,TRIGAL,estado nutricional en menores de 5 anos,clasificacion a y b,2001-05-01,2,5,2,5,7
80101,TRINIDAD,estado nutricional en menores de 5 anos,clasificacion a y b,2001-05-01,31,148,31,148,179
50801,TUPIZA,estado nutricional en menores de 5 anos,clasificacion a y b,2001-05-01,32,120,32,120,152
40402,TURCO,estado nutricional en menores de 5 anos,clasificacion a y b,2001-05-01,3,3,3,3,6
21302,UMALA,estado nutricional en menores de 5 anos,clasificacion a y b,2001-05-01,1,0,1,0,1
50201,UNCIA,estado nutricional en menores de 5 anos,clasificacion a y b,2001-05-01,6,52,6,52,58
60401,URIONDO (A. CONCEPCION),estado nutricional en menores de 5 anos,clasificacion a y b,2001-05-01,11,46,11,46,57
71502,URUBICHA,estado nutricional en menores de 5 anos,clasificacion a y b,2001-05-01,2,10,2,10,12
51201,UYUNI,estado nutricional en menores de 5 anos,clasificacion a y b,2001-05-01,17,68,17,68,85
30502,VACAS,estado nutricional en menores de 5 anos,clasificacion a y b,2001-05-01,0,2,0,2,2
70801,VALLEGRANDE,estado nutricional en menores de 5 anos,clasificacion a y b,2001-05-01,7,42,7,42,49
20801,VIACHA,estado nutricional en menores de 5 anos,clasificacion a y b,2001-05-01,27,77,27,77,104
31302,VILA VILA,estado nutricional en menores de 5 anos,clasificacion a y b,2001-05-01,6,2,6,2,8
60303,VILLA MONTES,estado nutricional en menores de 5 anos,clasificacion a y b,2001-05-01,10,45,10,45,55
90502,VILLA NUEVA (LOMA ALTA),estado nutricional en menores de 5 anos,clasificacion a y b,2001-05-01,0,2,0,2,2
31402,VILLA RIVERO,estado nutricional en menores de 5 anos,clasificacion a y b,2001-05-01,0,3,0,3,3
10801,VILLA SERRANO,estado nutricional en menores de 5 anos,clasificacion a y b,2001-05-01,5,24,5,24,29
31003,VILLA TUNARI,estado nutricional en menores de 5 anos,clasificacion a y b,2001-05-01,42,53,42,53,95
11001,VILLA VACA GUZMAN (MUYUPAMPA),estado nutricional en menores de 5 anos,clasificacion a y b,2001-05-01,11,68,11,68,79
51501,VILLAZON,estado nutricional en menores de 5 anos,clasificacion a y b,2001-05-01,28,97,28,97,125
30904,VINTO,estado nutricional en menores de 5 anos,clasificacion a y b,2001-05-01,19,33,19,33,52
50602,VITICHI,estado nutricional en menores de 5 anos,clasificacion a y b,2001-05-01,2,4,2,4,6
20306,WALDO BALLIVIAN,estado nutricional en menores de 5 anos,clasificacion a y b,2001-05-01,2,0,2,0,2
70201,WARNES,estado nutricional en menores de 5 anos,clasificacion a y b,2001-05-01,52,130,52,130,182
20903,YACO,estado nutricional en menores de 5 anos,clasificacion a y b,2001-05-01,4,48,4,48,52
60301,YACUIBA,estado nutricional en menores de 5 anos,clasificacion a y b,2001-05-01,74,301,74,301,375
10602,YAMPARAEZ,estado nutricional en menores de 5 anos,clasificacion a y b,2001-05-01,5,49,5,49,54
21103,YANACACHI,estado nutricional en menores de 5 anos,clasificacion a y b,2001-05-01,13,22,13,22,35
70403,YAPACANI,estado nutricional en menores de 5 anos,clasificacion a y b,2001-05-01,19,39,19,39,58
50103,YOCALLA,estado nutricional en menores de 5 anos,clasificacion a y b,2001-05-01,6,6,6,6,12
10102,YOTALA,estado nutricional en menores de 5 anos,clasificacion a y b,2001-05-01,9,38,9,38,47
60402,YUNCHARA,estado nutricional en menores de 5 anos,clasificacion a y b,2001-05-01,3,4,3,4,7
10301,ZUDAÃ‘EZ,estado nutricional en menores de 5 anos,clasificacion a y b,2001-05-01,9,24,9,24,33
51302,ACACIO,estado nutricional en menores de 5 anos,clasificacion a y b,2001-06-01,1,4,1,4,5
20201,ACHACACHI,estado nutricional en menores de 5 anos,clasificacion a y b,2001-06-01,18,99,18,99,117
20104,ACHOCALLA,estado nutricional en menores de 5 anos,clasificacion a y b,2001-06-01,4,19,4,19,23
30201,AIQUILE,estado nutricional en menores de 5 anos,clasificacion a y b,2001-06-01,21,31,21,31,52
31303,ALALAY,estado nutricional en menores de 5 anos,clasificacion a y b,2001-06-01,4,2,4,2,6
10404,ALCALA,estado nutricional en menores de 5 anos,clasificacion a y b,2001-06-01,3,20,3,20,23
20202,ANCORAIMES,estado nutricional en menores de 5 anos,clasificacion a y b,2001-06-01,7,25,7,25,32
41201,ANDAMARCA,estado nutricional en menores de 5 anos,clasificacion a y b,2001-06-01,1,2,1,2,3
30402,ANZALDO,estado nutricional en menores de 5 anos,clasificacion a y b,2001-06-01,6,10,6,10,16
20701,APOLO,estado nutricional en menores de 5 anos,clasificacion a y b,2001-06-01,14,1,14,1,15
51301,ARAMPAMPA,estado nutricional en menores de 5 anos,clasificacion a y b,2001-06-01,1,16,1,16,17
30501,ARANI,estado nutricional en menores de 5 anos,clasificacion a y b,2001-06-01,2,13,2,13,15
30403,ARBIETO,estado nutricional en menores de 5 anos,clasificacion a y b,2001-06-01,3,9,3,9,12
30601,ARQUE,estado nutricional en menores de 5 anos,clasificacion a y b,2001-06-01,0,1,0,1,1
71501,ASCENCION DE GUARAYOS,estado nutricional en menores de 5 anos,clasificacion a y b,2001-06-01,34,91,34,91,125
50802,ATOCHA,estado nutricional en menores de 5 anos,clasificacion a y b,2001-06-01,5,12,5,12,17
20503,AUCAPATA,estado nutricional en menores de 5 anos,clasificacion a y b,2001-06-01,3,3,3,3,6
21303,AYO AYO,estado nutricional en menores de 5 anos,clasificacion a y b,2001-06-01,4,12,4,12,16
30301,AYOPAYA (V. DE INDEPENDENCIA),estado nutricional en menores de 5 anos,clasificacion a y b,2001-06-01,6,26,6,26,32
10201,AZURDUY,estado nutricional en menores de 5 anos,clasificacion a y b,2001-06-01,11,35,11,35,46
21203,BATALLAS,estado nutricional en menores de 5 anos,clasificacion a y b,2001-06-01,4,57,4,57,61
80802,BAURES,estado nutricional en menores de 5 anos,clasificacion a y b,2001-06-01,0,20,0,20,20
50104,BELEN DE URMIRI,estado nutricional en menores de 5 anos,clasificacion a y b,2001-06-01,2,3,2,3,5
90104,BELLA FLOR,estado nutricional en menores de 5 anos,clasificacion a y b,2001-06-01,2,17,2,17,19
60202,BERMEJO,estado nutricional en menores de 5 anos,clasificacion a y b,2001-06-01,3,23,3,23,26
50301,BETANZOS,estado nutricional en menores de 5 anos,clasificacion a y b,2001-06-01,7,25,7,25,32
31501,BOLIVAR,estado nutricional en menores de 5 anos,clasificacion a y b,2001-06-01,0,1,0,1,1
90103,BOLPEBRA,estado nutricional en menores de 5 anos,clasificacion a y b,2001-06-01,3,1,3,1,4
70707,BOYUIBE,estado nutricional en menores de 5 anos,clasificacion a y b,2001-06-01,5,12,5,12,17
70401,BUENA VISTA,estado nutricional en menores de 5 anos,clasificacion a y b,2001-06-01,58,42,58,42,100
70703,CABEZAS,estado nutricional en menores de 5 anos,clasificacion a y b,2001-06-01,10,69,10,69,79
20905,CAIROMA,estado nutricional en menores de 5 anos,clasificacion a y b,2001-06-01,5,20,5,20,25
51102,"CAIZA ""D""",estado nutricional en menores de 5 anos,clasificacion a y b,2001-06-01,4,29,4,29,33
21003,CAJUATA,estado nutricional en menores de 5 anos,clasificacion a y b,2001-06-01,3,8,3,8,11
20303,CALACOTO,estado nutricional en menores de 5 anos,clasificacion a y b,2001-06-01,0,1,0,1,1
21304,CALAMARCA,estado nutricional en menores de 5 anos,clasificacion a y b,2001-06-01,14,8,14,8,22
10701,CAMARGO,estado nutricional en menores de 5 anos,clasificacion a y b,2001-06-01,14,43,14,43,57
10901,CAMATAQUI (C. VILLA ABECIA),estado nutricional en menores de 5 anos,clasificacion a y b,2001-06-01,4,8,4,8,12
70706,CAMIRI,estado nutricional en menores de 5 anos,clasificacion a y b,2001-06-01,64,80,64,80,144
30701,CAPINOTA,estado nutricional en menores de 5 anos,clasificacion a y b,2001-06-01,13,2,13,2,15
20302,CAQUIAVIRI,estado nutricional en menores de 5 anos,clasificacion a y b,2001-06-01,2,8,2,8,10
40102,CARACOLLO,estado nutricional en menores de 5 anos,clasificacion a y b,2001-06-01,1,17,1,17,18
22001,CARANAVI,estado nutricional en menores de 5 anos,clasificacion a y b,2001-06-01,102,68,102,68,170
60302,CARAPARI,estado nutricional en menores de 5 anos,clasificacion a y b,2001-06-01,7,61,7,61,68
50702,CARIPUYO,estado nutricional en menores de 5 anos,clasificacion a y b,2001-06-01,3,7,3,7,10
21803,CHACARILLA,estado nutricional en menores de 5 anos,clasificacion a y b,2001-06-01,1,1,1,1,2
40201,CHALLAPATA,estado nutricional en menores de 5 anos,clasificacion a y b,2001-06-01,4,0,4,0,4
50302,CHAQUI,estado nutricional en menores de 5 anos,clasificacion a y b,2001-06-01,5,8,5,8,13
70702,CHARAGUA,estado nutricional en menores de 5 anos,clasificacion a y b,2001-06-01,21,76,21,76,97
20305,CHARAÃ‘A,estado nutricional en menores de 5 anos,clasificacion a y b,2001-06-01,0,3,0,3,3
50202,CHAYANTA,estado nutricional en menores de 5 anos,clasificacion a y b,2001-06-01,4,8,4,8,12
31204,CHIMORE,estado nutricional en menores de 5 anos,clasificacion a y b,2001-06-01,15,32,15,32,47
40903,CHIPAYA,estado nutricional en menores de 5 anos,clasificacion a y b,2001-06-01,2,1,2,1,3
21101,CHULUMANI (V. DE LA LIBERTAD),estado nutricional en menores de 5 anos,clasificacion a y b,2001-06-01,7,8,7,8,15
20501,CHUMA,estado nutricional en menores de 5 anos,clasificacion a y b,2001-06-01,10,2,10,2,12
30801,CLIZA,estado nutricional en menores de 5 anos,clasificacion a y b,2001-06-01,4,12,4,12,16
90101,COBIJA,estado nutricional en menores de 5 anos,clasificacion a y b,2001-06-01,53,12,53,12,65
30101,COCHABAMBA,estado nutricional en menores de 5 anos,clasificacion a y b,2001-06-01,1245,1366,1245,1366,2611
40902,COIPASA,estado nutricional en menores de 5 anos,clasificacion a y b,2001-06-01,0,1,0,1,1
30905,COLCAPIRHUA,estado nutricional en menores de 5 anos,clasificacion a y b,2001-06-01,6,13,6,13,19
50901,"COLCHA ""K""",estado nutricional en menores de 5 anos,clasificacion a y b,2001-06-01,4,22,4,22,26
21307,COLLANA,estado nutricional en menores de 5 anos,clasificacion a y b,2001-06-01,1,0,1,0,1
31002,COLOMI,estado nutricional en menores de 5 anos,clasificacion a y b,2001-06-01,25,9,25,9,34
70603,COLPA BELGICA,estado nutricional en menores de 5 anos,clasificacion a y b,2001-06-01,29,24,29,24,53
50401,COLQUECHACA,estado nutricional en menores de 5 anos,clasificacion a y b,2001-06-01,9,20,9,20,29
21306,COLQUENCHA,estado nutricional en menores de 5 anos,clasificacion a y b,2001-06-01,8,10,8,10,18
21004,COLQUIRI,estado nutricional en menores de 5 anos,clasificacion a y b,2001-06-01,6,32,6,32,38
20304,COMANCHE,estado nutricional en menores de 5 anos,clasificacion a y b,2001-06-01,0,2,0,2,2
71301,COMARAPA,estado nutricional en menores de 5 anos,clasificacion a y b,2001-06-01,7,26,7,26,33
20605,COMBAYA,estado nutricional en menores de 5 anos,clasificacion a y b,2001-06-01,2,7,2,7,9
71101,CONCEPCION,estado nutricional en menores de 5 anos,clasificacion a y b,2001-06-01,25,61,25,61,86
21701,COPACABANA,estado nutricional en menores de 5 anos,clasificacion a y b,2001-06-01,0,26,0,26,26
21402,CORIPATA,estado nutricional en menores de 5 anos,clasificacion a y b,2001-06-01,12,44,12,44,56
20301,CORO CORO,estado nutricional en menores de 5 anos,clasificacion a y b,2001-06-01,4,12,4,12,16
21401,COROICO,estado nutricional en menores de 5 anos,clasificacion a y b,2001-06-01,23,7,23,7,30
40301,CORQUE,estado nutricional en menores de 5 anos,clasificacion a y b,2001-06-01,1,4,1,4,5
50601,COTAGAITA,estado nutricional en menores de 5 anos,clasificacion a y b,2001-06-01,6,33,6,33,39
70102,COTOCA,estado nutricional en menores de 5 anos,clasificacion a y b,2001-06-01,60,125,60,125,185
31405,CUCHUMUELA (V. G. VILLARROEL),estado nutricional en menores de 5 anos,clasificacion a y b,2001-06-01,0,4,0,4,4
70704,CUEVO,estado nutricional en menores de 5 anos,clasificacion a y b,2001-06-01,17,19,17,19,36
10902,CULPINA,estado nutricional en menores de 5 anos,clasificacion a y b,2001-06-01,4,49,4,49,53
40401,CURAHUARA DE CARANGAS,estado nutricional en menores de 5 anos,clasificacion a y b,2001-06-01,4,1,4,1,5
21602,CURVA,estado nutricional en menores de 5 anos,clasificacion a y b,2001-06-01,0,1,0,1,1
20804,DESAGUADERO,estado nutricional en menores de 5 anos,clasificacion a y b,2001-06-01,5,0,5,0,5
20105,EL ALTO,estado nutricional en menores de 5 anos,clasificacion a y b,2001-06-01,295,484,295,484,779
40103,EL CHORO,estado nutricional en menores de 5 anos,clasificacion a y b,2001-06-01,0,5,0,5,5
71503,EL PUENTE(STC),estado nutricional en menores de 5 anos,clasificacion a y b,2001-06-01,5,32,5,32,37
60502,EL PUENTE(TJA),estado nutricional en menores de 5 anos,clasificacion a y b,2001-06-01,0,3,0,3,3
70105,EL TORNO,estado nutricional en menores de 5 anos,clasificacion a y b,2001-06-01,46,104,46,104,150
10405,EL VILLAR,estado nutricional en menores de 5 anos,clasificacion a y b,2001-06-01,8,12,8,12,20
60601,ENTRE RIOS,estado nutricional en menores de 5 anos,clasificacion a y b,2001-06-01,8,41,8,41,49
41101,EUCALIPTUS,estado nutricional en menores de 5 anos,clasificacion a y b,2001-06-01,2,6,2,6,8
80402,EXALTACION,estado nutricional en menores de 5 anos,clasificacion a y b,2001-06-01,0,10,0,10,10
90203,FILADELFIA,estado nutricional en menores de 5 anos,clasificacion a y b,2001-06-01,3,5,3,5,8
71002,GENERAL SAAVEDRA,estado nutricional en menores de 5 anos,clasificacion a y b,2001-06-01,14,46,14,46,60
21601,GRAL. J.J. PEREZ (CHARAZANI),estado nutricional en menores de 5 anos,clasificacion a y b,2001-06-01,7,6,7,6,13
20602,GUANAY,estado nutricional en menores de 5 anos,clasificacion a y b,2001-06-01,24,62,24,62,86
20802,GUAQUI,estado nutricional en menores de 5 anos,clasificacion a y b,2001-06-01,0,11,0,11,11
80202,GUAYARAMERIN,estado nutricional en menores de 5 anos,clasificacion a y b,2001-06-01,14,32,14,32,46
70705,GUTIERREZ,estado nutricional en menores de 5 anos,clasificacion a y b,2001-06-01,31,135,31,135,166
10502,HUACARETA,estado nutricional en menores de 5 anos,clasificacion a y b,2001-06-01,4,56,4,56,60
11002,HUACAYA (VILLA DE HUACAYA),estado nutricional en menores de 5 anos,clasificacion a y b,2001-06-01,0,7,0,7,7
40501,HUACHACALLA,estado nutricional en menores de 5 anos,clasificacion a y b,2001-06-01,2,1,2,1,3
40701,HUANUNI,estado nutricional en menores de 5 anos,clasificacion a y b,2001-06-01,4,5,4,5,9
80803,HUARACAJE,estado nutricional en menores de 5 anos,clasificacion a y b,2001-06-01,1,17,1,17,18
21005,ICHOCA,estado nutricional en menores de 5 anos,clasificacion a y b,2001-06-01,1,0,1,0,1
10304,ICLA,estado nutricional en menores de 5 anos,clasificacion a y b,2001-06-01,16,13,16,13,29
10703,INCAHUASI,estado nutricional en menores de 5 anos,clasificacion a y b,2001-06-01,13,48,13,48,61
21001,INQUISIVI,estado nutricional en menores de 5 anos,clasificacion a y b,2001-06-01,5,15,5,15,20
21102,IRUPANA (VILLA DE LANZA),estado nutricional en menores de 5 anos,clasificacion a y b,2001-06-01,28,38,28,38,66
21501,IXIAMAS,estado nutricional en menores de 5 anos,clasificacion a y b,2001-06-01,16,27,16,27,43
21105,LA ASUNTA,estado nutricional en menores de 5 anos,clasificacion a y b,2001-06-01,19,15,19,15,34
70104,LA GUARDIA,estado nutricional en menores de 5 anos,clasificacion a y b,2001-06-01,46,242,46,242,288
20101,LA PAZ,estado nutricional en menores de 5 anos,clasificacion a y b,2001-06-01,299,415,299,415,714
41501,LA RIVERA,estado nutricional en menores de 5 anos,clasificacion a y b,2001-06-01,0,1,0,1,1
70701,LAGUNILLAS,estado nutricional en menores de 5 anos,clasificacion a y b,2001-06-01,9,34,9,34,43
21202,LAJA,estado nutricional en menores de 5 anos,clasificacion a y b,2001-06-01,2,24,2,24,26
10903,LAS CARRERAS,estado nutricional en menores de 5 anos,clasificacion a y b,2001-06-01,0,8,0,8,8
21006,LICOMA PAMPA,estado nutricional en menores de 5 anos,clasificacion a y b,2001-06-01,8,1,8,1,9
50203,LLALLAGUA,estado nutricional en menores de 5 anos,clasificacion a y b,2001-06-01,14,31,14,31,45
51401,LLICA,estado nutricional en menores de 5 anos,clasificacion a y b,2001-06-01,4,8,4,8,12
80601,LORETO,estado nutricional en menores de 5 anos,clasificacion a y b,2001-06-01,2,10,2,10,12
20901,LURIBAY,estado nutricional en menores de 5 anos,clasificacion a y b,2001-06-01,3,7,3,7,10
40702,MACHACAMARCA,estado nutricional en menores de 5 anos,clasificacion a y b,2001-06-01,9,3,9,3,12
11003,MACHARETI,estado nutricional en menores de 5 anos,clasificacion a y b,2001-06-01,13,87,13,87,100
80801,MAGDALENA,estado nutricional en menores de 5 anos,clasificacion a y b,2001-06-01,1,9,1,9,10
70903,MAIRANA,estado nutricional en menores de 5 anos,clasificacion a y b,2001-06-01,22,13,22,13,35
20103,MECAPACA,estado nutricional en menores de 5 anos,clasificacion a y b,2001-06-01,0,16,0,16,16
71003,MINEROS,estado nutricional en menores de 5 anos,clasificacion a y b,2001-06-01,40,121,40,121,161
31301,MIZQUE,estado nutricional en menores de 5 anos,clasificacion a y b,2001-06-01,38,18,38,18,56
20402,MOCOMOCO,estado nutricional en menores de 5 anos,clasificacion a y b,2001-06-01,6,11,6,11,17
10303,MOJOCOYA,estado nutricional en menores de 5 anos,clasificacion a y b,2001-06-01,9,50,9,50,59
10501,MONTEAGUDO,estado nutricional en menores de 5 anos,clasificacion a y b,2001-06-01,33,178,33,178,211
71001,MONTERO,estado nutricional en menores de 5 anos,clasificacion a y b,2001-06-01,52,212,52,212,264
70803,MORO MORO,estado nutricional en menores de 5 anos,clasificacion a y b,2001-06-01,2,2,2,2,4
30302,MOROCHATA,estado nutricional en menores de 5 anos,clasificacion a y b,2001-06-01,11,7,11,7,18
90401,NACEBE (SANTA ROSA DEL ABUNA),estado nutricional en menores de 5 anos,clasificacion a y b,2001-06-01,1,9,1,9,10
90501,NUEVO MANOA (NUEVA ESPERANZA),estado nutricional en menores de 5 anos,clasificacion a y b,2001-06-01,0,2,0,2,2
50404,OCURI,estado nutricional en menores de 5 anos,clasificacion a y b,2001-06-01,8,26,8,26,34
70202,OKINAWA,estado nutricional en menores de 5 anos,clasificacion a y b,2001-06-01,1,0,1,0,1
30203,OMEREQUE,estado nutricional en menores de 5 anos,clasificacion a y b,2001-06-01,2,26,2,26,28
40101,ORURO,estado nutricional en menores de 5 anos,clasificacion a y b,2001-06-01,66,225,66,225,291
60201,PADCAYA,estado nutricional en menores de 5 anos,clasificacion a y b,2001-06-01,15,29,15,29,44
10401,PADILLA,estado nutricional en menores de 5 anos,clasificacion a y b,2001-06-01,20,48,20,48,68
70502,PAILON,estado nutricional en menores de 5 anos,clasificacion a y b,2001-06-01,14,37,14,37,51
20102,PALCA,estado nutricional en menores de 5 anos,clasificacion a y b,2001-06-01,6,11,6,11,17
21104,PALOS BLANCOS,estado nutricional en menores de 5 anos,clasificacion a y b,2001-06-01,37,47,37,47,84
40802,PAMPA AULLAGAS,estado nutricional en menores de 5 anos,clasificacion a y b,2001-06-01,5,0,5,0,5
70902,PAMPA GRANDE,estado nutricional en menores de 5 anos,clasificacion a y b,2001-06-01,4,49,4,49,53
21802,PAPEL PAMPA,estado nutricional en menores de 5 anos,clasificacion a y b,2001-06-01,1,1,1,1,2
30202,PASORAPA,estado nutricional en menores de 5 anos,clasificacion a y b,2001-06-01,5,8,5,8,13
21305,PATACAMAYA,estado nutricional en menores de 5 anos,clasificacion a y b,2001-06-01,24,0,24,0,24
40602,PAZÃ‘A,estado nutricional en menores de 5 anos,clasificacion a y b,2001-06-01,0,2,0,2,2
20702,PELECHUCO,estado nutricional en menores de 5 anos,clasificacion a y b,2001-06-01,3,4,3,4,7
50403,POCOATA,estado nutricional en menores de 5 anos,clasificacion a y b,2001-06-01,6,21,6,21,27
31203,POCONA,estado nutricional en menores de 5 anos,clasificacion a y b,2001-06-01,5,8,5,8,13
31202,POJO (CBBA),estado nutricional en menores de 5 anos,clasificacion a y b,2001-06-01,49,67,49,67,116
40601,POOPO,estado nutricional en menores de 5 anos,clasificacion a y b,2001-06-01,2,2,2,2,4
51203,PORCO,estado nutricional en menores de 5 anos,clasificacion a y b,2001-06-01,3,19,3,19,22
10103,POROMA,estado nutricional en menores de 5 anos,clasificacion a y b,2001-06-01,4,21,4,21,25
70103,PORONGO,estado nutricional en menores de 5 anos,clasificacion a y b,2001-06-01,1,18,1,18,19
70601,PORTACHUELO,estado nutricional en menores de 5 anos,clasificacion a y b,2001-06-01,76,27,76,27,103
90102,PORVENIR,estado nutricional en menores de 5 anos,clasificacion a y b,2001-06-01,1,18,1,18,19
50101,POTOSI,estado nutricional en menores de 5 anos,clasificacion a y b,2001-06-01,50,170,50,170,220
10302,PRESTO,estado nutricional en menores de 5 anos,clasificacion a y b,2001-06-01,1,25,1,25,26
70805,PUCARA,estado nutricional en menores de 5 anos,clasificacion a y b,2001-06-01,1,0,1,0,1
21201,PUCARANI,estado nutricional en menores de 5 anos,clasificacion a y b,2001-06-01,12,31,12,31,43
20401,PUERTO ACOSTA,estado nutricional en menores de 5 anos,clasificacion a y b,2001-06-01,7,2,7,2,9
20403,PUERTO CARABUCO,estado nutricional en menores de 5 anos,clasificacion a y b,2001-06-01,23,18,23,18,41
21204,PUERTO PEREZ,estado nutricional en menores de 5 anos,clasificacion a y b,2001-06-01,0,3,0,3,3
71402,PUERTO QUIJARRO,estado nutricional en menores de 5 anos,clasificacion a y b,2001-06-01,40,5,40,5,45
90201,PUERTO RICO,estado nutricional en menores de 5 anos,clasificacion a y b,2001-06-01,0,4,0,4,4
80703,PUERTO SILES,estado nutricional en menores de 5 anos,clasificacion a y b,2001-06-01,1,3,1,3,4
71401,PUERTO SUAREZ,estado nutricional en menores de 5 anos,clasificacion a y b,2001-06-01,68,15,68,15,83
31205,PUERTO VILLARROEL,estado nutricional en menores de 5 anos,clasificacion a y b,2001-06-01,96,16,96,16,112
51101,PUNA,estado nutricional en menores de 5 anos,clasificacion a y b,2001-06-01,27,61,27,61,88
31401,PUNATA,estado nutricional en menores de 5 anos,clasificacion a y b,2001-06-01,22,42,22,42,64
20604,QUIABAYA,estado nutricional en menores de 5 anos,clasificacion a y b,2001-06-01,2,2,2,2,4
30901,QUILLACOLLO,estado nutricional en menores de 5 anos,clasificacion a y b,2001-06-01,28,39,28,39,67
21002,QUIME,estado nutricional en menores de 5 anos,clasificacion a y b,2001-06-01,12,17,12,17,29
70904,QUIRUSILLAS,estado nutricional en menores de 5 anos,clasificacion a y b,2001-06-01,3,2,3,2,5
50402,RAVELO,estado nutricional en menores de 5 anos,clasificacion a y b,2001-06-01,1,27,1,27,28
80301,REYES,estado nutricional en menores de 5 anos,clasificacion a y b,2001-06-01,6,19,6,19,25
80201,RIBERALTA,estado nutricional en menores de 5 anos,clasificacion a y b,2001-06-01,13,40,13,40,53
70503,ROBORE,estado nutricional en menores de 5 anos,clasificacion a y b,2001-06-01,11,34,11,34,45
80304,RURRENABAQUE,estado nutricional en menores de 5 anos,clasificacion a y b,2001-06-01,21,34,21,34,55
40901,SABAYA,estado nutricional en menores de 5 anos,clasificacion a y b,2001-06-01,2,3,2,3,5
31001,SACABA,estado nutricional en menores de 5 anos,clasificacion a y b,2001-06-01,58,25,58,25,83
30404,SACABAMBA,estado nutricional en menores de 5 anos,clasificacion a y b,2001-06-01,0,4,0,4,4
50701,SACACA,estado nutricional en menores de 5 anos,clasificacion a y b,2001-06-01,2,7,2,7,9
71302,SAIPINA,estado nutricional en menores de 5 anos,clasificacion a y b,2001-06-01,8,64,8,64,72
40801,SALINAS DE GARCI MENDOZA,estado nutricional en menores de 5 anos,clasificacion a y b,2001-06-01,0,1,0,1,1
70901,SAMAIPATA,estado nutricional en menores de 5 anos,clasificacion a y b,2001-06-01,4,27,4,27,31
51601,SAN AGUSTIN,estado nutricional en menores de 5 anos,clasificacion a y b,2001-06-01,1,7,1,7,8
51003,SAN ANTONIO DE ESMORUCO,estado nutricional en menores de 5 anos,clasificacion a y b,2001-06-01,0,1,0,1,1
71105,SAN ANTONIO DE LOMERIO,estado nutricional en menores de 5 anos,clasificacion a y b,2001-06-01,6,19,6,19,25
31403,SAN BENITO,estado nutricional en menores de 5 anos,clasificacion a y b,2001-06-01,5,9,5,9,14
80302,SAN BORJA,estado nutricional en menores de 5 anos,clasificacion a y b,2001-06-01,12,51,12,51,63
21502,SAN BUENA VENTURA,estado nutricional en menores de 5 anos,clasificacion a y b,2001-06-01,2,19,2,19,21
70402,SAN CARLOS,estado nutricional en menores de 5 anos,clasificacion a y b,2001-06-01,32,70,32,70,102
80501,SAN IGNACIO,estado nutricional en menores de 5 anos,clasificacion a y b,2001-06-01,5,44,5,44,49
70301,SAN IGNACIO DE VELASCO,estado nutricional en menores de 5 anos,clasificacion a y b,2001-06-01,56,184,56,184,240
80102,SAN JAVIER(BNI),estado nutricional en menores de 5 anos,clasificacion a y b,2001-06-01,0,8,0,8,8
71102,SAN JAVIER(STC),estado nutricional en menores de 5 anos,clasificacion a y b,2001-06-01,6,58,6,58,64
80701,SAN JOAQUIN,estado nutricional en menores de 5 anos,clasificacion a y b,2001-06-01,7,17,7,17,24
70501,SAN JOSE DE CHIQUITOS,estado nutricional en menores de 5 anos,clasificacion a y b,2001-06-01,31,15,31,15,46
71104,SAN JULIAN,estado nutricional en menores de 5 anos,clasificacion a y b,2001-06-01,114,464,114,464,578
90302,SAN LORENZO(PND),estado nutricional en menores de 5 anos,clasificacion a y b,2001-06-01,5,0,5,0,5
60501,SAN LORENZO(TJA),estado nutricional en menores de 5 anos,clasificacion a y b,2001-06-01,8,11,8,11,19
10702,SAN LUCAS,estado nutricional en menores de 5 anos,clasificacion a y b,2001-06-01,21,78,21,78,99
71201,SAN MATIAS,estado nutricional en menores de 5 anos,clasificacion a y b,2001-06-01,21,65,21,65,86
70302,SAN MIGUEL DE VELASCO,estado nutricional en menores de 5 anos,clasificacion a y b,2001-06-01,7,21,7,21,28
51001,SAN PABLO DE LIPEZ,estado nutricional en menores de 5 anos,clasificacion a y b,2001-06-01,2,0,2,0,2
50501,SAN PEDRO DE BUENA VISTA,estado nutricional en menores de 5 anos,clasificacion a y b,2001-06-01,5,44,5,44,49
21801,SAN PEDRO DE CURAHUARA,estado nutricional en menores de 5 anos,clasificacion a y b,2001-06-01,0,8,0,8,8
50902,SAN PEDRO DE QUEMES,estado nutricional en menores de 5 anos,clasificacion a y b,2001-06-01,2,1,2,1,3
21702,SAN PEDRO DE TIQUINA,estado nutricional en menores de 5 anos,clasificacion a y b,2001-06-01,2,7,2,7,9
90202,SAN PEDRO(PND),estado nutricional en menores de 5 anos,clasificacion a y b,2001-06-01,1,21,1,21,22
70303,SAN RAFAEL,estado nutricional en menores de 5 anos,clasificacion a y b,2001-06-01,18,14,18,14,32
80702,SAN RAMON,estado nutricional en menores de 5 anos,clasificacion a y b,2001-06-01,50,86,50,86,136
80702,SAN RAMON,estado nutricional en menores de 5 anos,clasificacion a y b,2001-06-01,3,6,3,6,9
70101,SANTA CRUZ DE LA SIERRA,estado nutricional en menores de 5 anos,clasificacion a y b,2001-06-01,696,833,696,833,1529
80303,SANTA ROSA,estado nutricional en menores de 5 anos,clasificacion a y b,2001-06-01,1,10,1,10,11
70602,SANTA ROSA DEL SARA,estado nutricional en menores de 5 anos,clasificacion a y b,2001-06-01,9,15,9,15,24
20308,SANTIAGO DE CALLAPA,estado nutricional en menores de 5 anos,clasificacion a y b,2001-06-01,1,2,1,2,3
41401,SANTIAGO DE HUARI,estado nutricional en menores de 5 anos,clasificacion a y b,2001-06-01,2,0,2,0,2
30702,SANTIVAÃ‘ES,estado nutricional en menores de 5 anos,clasificacion a y b,2001-06-01,0,3,0,3,3
40202,SANTUARIO DE QUILLACAS,estado nutricional en menores de 5 anos,clasificacion a y b,2001-06-01,2,1,2,1,3
20902,SAPAHAQUI,estado nutricional en menores de 5 anos,clasificacion a y b,2001-06-01,0,11,0,11,11
90303,SENA,estado nutricional en menores de 5 anos,clasificacion a y b,2001-06-01,0,4,0,4,4
21301,SICA SICA (VILLA AROMA),estado nutricional en menores de 5 anos,clasificacion a y b,2001-06-01,10,12,10,12,22
30703,SICAYA,estado nutricional en menores de 5 anos,clasificacion a y b,2001-06-01,3,3,3,3,6
30902,SIPE SIPE,estado nutricional en menores de 5 anos,clasificacion a y b,2001-06-01,17,48,17,48,65
10403,SOPACHUY,estado nutricional en menores de 5 anos,clasificacion a y b,2001-06-01,3,24,3,24,27
20601,SORATA,estado nutricional en menores de 5 anos,clasificacion a y b,2001-06-01,4,14,4,14,18
10101,SUCRE,estado nutricional en menores de 5 anos,clasificacion a y b,2001-06-01,91,450,91,450,541
31404,TACACHI,estado nutricional en menores de 5 anos,clasificacion a y b,2001-06-01,0,1,0,1,1
20603,TACACOMA,estado nutricional en menores de 5 anos,clasificacion a y b,2001-06-01,1,10,1,10,11
50303,TACOBAMBA,estado nutricional en menores de 5 anos,clasificacion a y b,2001-06-01,5,17,5,17,22
30602,TACOPAYA,estado nutricional en menores de 5 anos,clasificacion a y b,2001-06-01,1,3,1,3,4
51402,TAHUA,estado nutricional en menores de 5 anos,clasificacion a y b,2001-06-01,0,4,0,4,4
31101,TAPACARI,estado nutricional en menores de 5 anos,clasificacion a y b,2001-06-01,12,31,12,31,43
10601,TARABUCO,estado nutricional en menores de 5 anos,clasificacion a y b,2001-06-01,18,50,18,50,68
30401,TARATA,estado nutricional en menores de 5 anos,clasificacion a y b,2001-06-01,4,18,4,18,22
60101,TARIJA,estado nutricional en menores de 5 anos,clasificacion a y b,2001-06-01,68,227,68,227,295
10202,TARVITA,estado nutricional en menores de 5 anos,clasificacion a y b,2001-06-01,6,36,6,36,42
20803,TIAWANACU,estado nutricional en menores de 5 anos,clasificacion a y b,2001-06-01,11,5,11,5,16
50102,TINGUIPAYA,estado nutricional en menores de 5 anos,clasificacion a y b,2001-06-01,1,3,1,3,4
20606,TIPUANI,estado nutricional en menores de 5 anos,clasificacion a y b,2001-06-01,24,14,24,14,38
30903,TIQUIPAYA,estado nutricional en menores de 5 anos,clasificacion a y b,2001-06-01,10,15,10,15,25
31601,TIRAQUE (CBBA),estado nutricional en menores de 5 anos,clasificacion a y b,2001-06-01,41,51,41,51,92
30802,TOCO,estado nutricional en menores de 5 anos,clasificacion a y b,2001-06-01,0,2,0,2,2
30803,TOLATA,estado nutricional en menores de 5 anos,clasificacion a y b,2001-06-01,0,7,0,7,7
41001,TOLEDO,estado nutricional en menores de 5 anos,clasificacion a y b,2001-06-01,7,5,7,5,12
51202,TOMAVE,estado nutricional en menores de 5 anos,clasificacion a y b,2001-06-01,7,18,7,18,25
10402,TOMINA,estado nutricional en menores de 5 anos,clasificacion a y b,2001-06-01,8,38,8,38,46
31201,TOTORA(CBBA),estado nutricional en menores de 5 anos,clasificacion a y b,2001-06-01,3,29,3,29,32
41301,TOTORA(ORR),estado nutricional en menores de 5 anos,clasificacion a y b,2001-06-01,0,6,0,6,6
70802,TRIGAL,estado nutricional en menores de 5 anos,clasificacion a y b,2001-06-01,3,1,3,1,4
80101,TRINIDAD,estado nutricional en menores de 5 anos,clasificacion a y b,2001-06-01,23,81,23,81,104
50801,TUPIZA,estado nutricional en menores de 5 anos,clasificacion a y b,2001-06-01,18,81,18,81,99
40402,TURCO,estado nutricional en menores de 5 anos,clasificacion a y b,2001-06-01,9,6,9,6,15
21302,UMALA,estado nutricional en menores de 5 anos,clasificacion a y b,2001-06-01,0,8,0,8,8
50201,UNCIA,estado nutricional en menores de 5 anos,clasificacion a y b,2001-06-01,3,28,3,28,31
60401,URIONDO (A. CONCEPCION),estado nutricional en menores de 5 anos,clasificacion a y b,2001-06-01,7,50,7,50,57
71502,URUBICHA,estado nutricional en menores de 5 anos,clasificacion a y b,2001-06-01,1,0,1,0,1
51201,UYUNI,estado nutricional en menores de 5 anos,clasificacion a y b,2001-06-01,18,55,18,55,73
30502,VACAS,estado nutricional en menores de 5 anos,clasificacion a y b,2001-06-01,0,4,0,4,4
70801,VALLEGRANDE,estado nutricional en menores de 5 anos,clasificacion a y b,2001-06-01,32,41,32,41,73
20801,VIACHA,estado nutricional en menores de 5 anos,clasificacion a y b,2001-06-01,13,45,13,45,58
31302,VILA VILA,estado nutricional en menores de 5 anos,clasificacion a y b,2001-06-01,2,0,2,0,2
60303,VILLA MONTES,estado nutricional en menores de 5 anos,clasificacion a y b,2001-06-01,33,37,33,37,70
90502,VILLA NUEVA (LOMA ALTA),estado nutricional en menores de 5 anos,clasificacion a y b,2001-06-01,1,0,1,0,1
31402,VILLA RIVERO,estado nutricional en menores de 5 anos,clasificacion a y b,2001-06-01,0,8,0,8,8
10801,VILLA SERRANO,estado nutricional en menores de 5 anos,clasificacion a y b,2001-06-01,7,34,7,34,41
31003,VILLA TUNARI,estado nutricional en menores de 5 anos,clasificacion a y b,2001-06-01,50,34,50,34,84
11001,VILLA VACA GUZMAN (MUYUPAMPA),estado nutricional en menores de 5 anos,clasificacion a y b,2001-06-01,24,66,24,66,90
51501,VILLAZON,estado nutricional en menores de 5 anos,clasificacion a y b,2001-06-01,27,105,27,105,132
50602,VITICHI,estado nutricional en menores de 5 anos,clasificacion a y b,2001-06-01,3,24,3,24,27
70201,WARNES,estado nutricional en menores de 5 anos,clasificacion a y b,2001-06-01,44,65,44,65,109
20903,YACO,estado nutricional en menores de 5 anos,clasificacion a y b,2001-06-01,5,10,5,10,15
60301,YACUIBA,estado nutricional en menores de 5 anos,clasificacion a y b,2001-06-01,29,161,29,161,190
10602,YAMPARAEZ,estado nutricional en menores de 5 anos,clasificacion a y b,2001-06-01,11,33,11,33,44
21103,YANACACHI,estado nutricional en menores de 5 anos,clasificacion a y b,2001-06-01,4,0,4,0,4
70403,YAPACANI,estado nutricional en menores de 5 anos,clasificacion a y b,2001-06-01,43,90,43,90,133
50103,YOCALLA,estado nutricional en menores de 5 anos,clasificacion a y b,2001-06-01,2,8,2,8,10
10102,YOTALA,estado nutricional en menores de 5 anos,clasificacion a y b,2001-06-01,5,36,5,36,41
60402,YUNCHARA,estado nutricional en menores de 5 anos,clasificacion a y b,2001-06-01,6,10,6,10,16
10301,ZUDAÃ‘EZ,estado nutricional en menores de 5 anos,clasificacion a y b,2001-06-01,0,18,0,18,18
51302,ACACIO,estado nutricional en menores de 5 anos,clasificacion a y b,2001-07-01,3,5,3,5,8
20201,ACHACACHI,estado nutricional en menores de 5 anos,clasificacion a y b,2001-07-01,12,80,12,80,92
20104,ACHOCALLA,estado nutricional en menores de 5 anos,clasificacion a y b,2001-07-01,0,1,0,1,1
30201,AIQUILE,estado nutricional en menores de 5 anos,clasificacion a y b,2001-07-01,15,37,15,37,52
31303,ALALAY,estado nutricional en menores de 5 anos,clasificacion a y b,2001-07-01,5,2,5,2,7
10404,ALCALA,estado nutricional en menores de 5 anos,clasificacion a y b,2001-07-01,4,15,4,15,19
20202,ANCORAIMES,estado nutricional en menores de 5 anos,clasificacion a y b,2001-07-01,7,14,7,14,21
41201,ANDAMARCA,estado nutricional en menores de 5 anos,clasificacion a y b,2001-07-01,2,0,2,0,2
40603,ANTEQUERA,estado nutricional en menores de 5 anos,clasificacion a y b,2001-07-01,1,0,1,0,1
30402,ANZALDO,estado nutricional en menores de 5 anos,clasificacion a y b,2001-07-01,1,8,1,8,9
20701,APOLO,estado nutricional en menores de 5 anos,clasificacion a y b,2001-07-01,22,2,22,2,24
51301,ARAMPAMPA,estado nutricional en menores de 5 anos,clasificacion a y b,2001-07-01,0,3,0,3,3
30501,ARANI,estado nutricional en menores de 5 anos,clasificacion a y b,2001-07-01,4,19,4,19,23
30601,ARQUE,estado nutricional en menores de 5 anos,clasificacion a y b,2001-07-01,3,18,3,18,21
71501,ASCENCION DE GUARAYOS,estado nutricional en menores de 5 anos,clasificacion a y b,2001-07-01,2,6,2,6,8
50802,ATOCHA,estado nutricional en menores de 5 anos,clasificacion a y b,2001-07-01,6,15,6,15,21
21303,AYO AYO,estado nutricional en menores de 5 anos,clasificacion a y b,2001-07-01,0,3,0,3,3
30301,AYOPAYA (V. DE INDEPENDENCIA),estado nutricional en menores de 5 anos,clasificacion a y b,2001-07-01,34,23,34,23,57
10201,AZURDUY,estado nutricional en menores de 5 anos,clasificacion a y b,2001-07-01,8,9,8,9,17
21203,BATALLAS,estado nutricional en menores de 5 anos,clasificacion a y b,2001-07-01,2,43,2,43,45
80802,BAURES,estado nutricional en menores de 5 anos,clasificacion a y b,2001-07-01,10,5,10,5,15
41202,BELEN DE ANDAMARCA,estado nutricional en menores de 5 anos,clasificacion a y b,2001-07-01,1,0,1,0,1
50104,BELEN DE URMIRI,estado nutricional en menores de 5 anos,clasificacion a y b,2001-07-01,3,3,3,3,6
90104,BELLA FLOR,estado nutricional en menores de 5 anos,clasificacion a y b,2001-07-01,4,17,4,17,21
60202,BERMEJO,estado nutricional en menores de 5 anos,clasificacion a y b,2001-07-01,16,39,16,39,55
50301,BETANZOS,estado nutricional en menores de 5 anos,clasificacion a y b,2001-07-01,12,37,12,37,49
31501,BOLIVAR,estado nutricional en menores de 5 anos,clasificacion a y b,2001-07-01,0,1,0,1,1
90103,BOLPEBRA,estado nutricional en menores de 5 anos,clasificacion a y b,2001-07-01,1,3,1,3,4
70707,BOYUIBE,estado nutricional en menores de 5 anos,clasificacion a y b,2001-07-01,4,11,4,11,15
70401,BUENA VISTA,estado nutricional en menores de 5 anos,clasificacion a y b,2001-07-01,74,63,74,63,137
70703,CABEZAS,estado nutricional en menores de 5 anos,clasificacion a y b,2001-07-01,10,25,10,25,35
20905,CAIROMA,estado nutricional en menores de 5 anos,clasificacion a y b,2001-07-01,3,6,3,6,9
51102,"CAIZA ""D""",estado nutricional en menores de 5 anos,clasificacion a y b,2001-07-01,3,11,3,11,14
21003,CAJUATA,estado nutricional en menores de 5 anos,clasificacion a y b,2001-07-01,20,2,20,2,22
20303,CALACOTO,estado nutricional en menores de 5 anos,clasificacion a y b,2001-07-01,2,1,2,1,3
21304,CALAMARCA,estado nutricional en menores de 5 anos,clasificacion a y b,2001-07-01,8,8,8,8,16
10701,CAMARGO,estado nutricional en menores de 5 anos,clasificacion a y b,2001-07-01,9,27,9,27,36
10901,CAMATAQUI (C. VILLA ABECIA),estado nutricional en menores de 5 anos,clasificacion a y b,2001-07-01,8,12,8,12,20
70706,CAMIRI,estado nutricional en menores de 5 anos,clasificacion a y b,2001-07-01,116,41,116,41,157
30701,CAPINOTA,estado nutricional en menores de 5 anos,clasificacion a y b,2001-07-01,31,5,31,5,36
20302,CAQUIAVIRI,estado nutricional en menores de 5 anos,clasificacion a y b,2001-07-01,3,6,3,6,9
40102,CARACOLLO,estado nutricional en menores de 5 anos,clasificacion a y b,2001-07-01,5,29,5,29,34
22001,CARANAVI,estado nutricional en menores de 5 anos,clasificacion a y b,2001-07-01,106,63,106,63,169
60302,CARAPARI,estado nutricional en menores de 5 anos,clasificacion a y b,2001-07-01,12,27,12,27,39
50702,CARIPUYO,estado nutricional en menores de 5 anos,clasificacion a y b,2001-07-01,1,3,1,3,4
40201,CHALLAPATA,estado nutricional en menores de 5 anos,clasificacion a y b,2001-07-01,8,30,8,30,38
50302,CHAQUI,estado nutricional en menores de 5 anos,clasificacion a y b,2001-07-01,1,9,1,9,10
70702,CHARAGUA,estado nutricional en menores de 5 anos,clasificacion a y b,2001-07-01,19,79,19,79,98
50202,CHAYANTA,estado nutricional en menores de 5 anos,clasificacion a y b,2001-07-01,5,21,5,21,26
31204,CHIMORE,estado nutricional en menores de 5 anos,clasificacion a y b,2001-07-01,23,38,23,38,61
40302,CHOQUE COTA,estado nutricional en menores de 5 anos,clasificacion a y b,2001-07-01,1,5,1,5,6
21101,CHULUMANI (V. DE LA LIBERTAD),estado nutricional en menores de 5 anos,clasificacion a y b,2001-07-01,2,9,2,9,11
20501,CHUMA,estado nutricional en menores de 5 anos,clasificacion a y b,2001-07-01,4,3,4,3,7
30801,CLIZA,estado nutricional en menores de 5 anos,clasificacion a y b,2001-07-01,4,16,4,16,20
90101,COBIJA,estado nutricional en menores de 5 anos,clasificacion a y b,2001-07-01,105,26,105,26,131
30101,COCHABAMBA,estado nutricional en menores de 5 anos,clasificacion a y b,2001-07-01,1054,1286,1054,1286,2340
40902,COIPASA,estado nutricional en menores de 5 anos,clasificacion a y b,2001-07-01,0,1,0,1,1
30905,COLCAPIRHUA,estado nutricional en menores de 5 anos,clasificacion a y b,2001-07-01,10,1,10,1,11
50901,"COLCHA ""K""",estado nutricional en menores de 5 anos,clasificacion a y b,2001-07-01,3,5,3,5,8
21307,COLLANA,estado nutricional en menores de 5 anos,clasificacion a y b,2001-07-01,1,0,1,0,1
31002,COLOMI,estado nutricional en menores de 5 anos,clasificacion a y b,2001-07-01,19,23,19,23,42
50401,COLQUECHACA,estado nutricional en menores de 5 anos,clasificacion a y b,2001-07-01,6,7,6,7,13
21306,COLQUENCHA,estado nutricional en menores de 5 anos,clasificacion a y b,2001-07-01,4,5,4,5,9
21004,COLQUIRI,estado nutricional en menores de 5 anos,clasificacion a y b,2001-07-01,1,19,1,19,20
20304,COMANCHE,estado nutricional en menores de 5 anos,clasificacion a y b,2001-07-01,3,3,3,3,6
71301,COMARAPA,estado nutricional en menores de 5 anos,clasificacion a y b,2001-07-01,4,18,4,18,22
20605,COMBAYA,estado nutricional en menores de 5 anos,clasificacion a y b,2001-07-01,3,5,3,5,8
71101,CONCEPCION,estado nutricional en menores de 5 anos,clasificacion a y b,2001-07-01,14,14,14,14,28
21701,COPACABANA,estado nutricional en menores de 5 anos,clasificacion a y b,2001-07-01,5,20,5,20,25
21402,CORIPATA,estado nutricional en menores de 5 anos,clasificacion a y b,2001-07-01,4,25,4,25,29
20301,CORO CORO,estado nutricional en menores de 5 anos,clasificacion a y b,2001-07-01,2,15,2,15,17
21401,COROICO,estado nutricional en menores de 5 anos,clasificacion a y b,2001-07-01,10,7,10,7,17
40301,CORQUE,estado nutricional en menores de 5 anos,clasificacion a y b,2001-07-01,0,5,0,5,5
50601,COTAGAITA,estado nutricional en menores de 5 anos,clasificacion a y b,2001-07-01,12,29,12,29,41
70102,COTOCA,estado nutricional en menores de 5 anos,clasificacion a y b,2001-07-01,56,196,56,196,252
31405,CUCHUMUELA (V. G. VILLARROEL),estado nutricional en menores de 5 anos,clasificacion a y b,2001-07-01,0,1,0,1,1
70704,CUEVO,estado nutricional en menores de 5 anos,clasificacion a y b,2001-07-01,21,4,21,4,25
10902,CULPINA,estado nutricional en menores de 5 anos,clasificacion a y b,2001-07-01,8,73,8,73,81
40401,CURAHUARA DE CARANGAS,estado nutricional en menores de 5 anos,clasificacion a y b,2001-07-01,0,2,0,2,2
21602,CURVA,estado nutricional en menores de 5 anos,clasificacion a y b,2001-07-01,5,1,5,1,6
20804,DESAGUADERO,estado nutricional en menores de 5 anos,clasificacion a y b,2001-07-01,0,4,0,4,4
20105,EL ALTO,estado nutricional en menores de 5 anos,clasificacion a y b,2001-07-01,565,440,565,440,1005
40103,EL CHORO,estado nutricional en menores de 5 anos,clasificacion a y b,2001-07-01,0,1,0,1,1
71503,EL PUENTE(STC),estado nutricional en menores de 5 anos,clasificacion a y b,2001-07-01,23,53,23,53,76
60502,EL PUENTE(TJA),estado nutricional en menores de 5 anos,clasificacion a y b,2001-07-01,4,5,4,5,9
70105,EL TORNO,estado nutricional en menores de 5 anos,clasificacion a y b,2001-07-01,33,81,33,81,114
10405,EL VILLAR,estado nutricional en menores de 5 anos,clasificacion a y b,2001-07-01,2,16,2,16,18
60601,ENTRE RIOS,estado nutricional en menores de 5 anos,clasificacion a y b,2001-07-01,30,22,30,22,52
41101,EUCALIPTUS,estado nutricional en menores de 5 anos,clasificacion a y b,2001-07-01,1,9,1,9,10
71002,GENERAL SAAVEDRA,estado nutricional en menores de 5 anos,clasificacion a y b,2001-07-01,11,50,11,50,61
21601,GRAL. J.J. PEREZ (CHARAZANI),estado nutricional en menores de 5 anos,clasificacion a y b,2001-07-01,0,5,0,5,5
20602,GUANAY,estado nutricional en menores de 5 anos,clasificacion a y b,2001-07-01,24,60,24,60,84
20802,GUAQUI,estado nutricional en menores de 5 anos,clasificacion a y b,2001-07-01,0,3,0,3,3
80202,GUAYARAMERIN,estado nutricional en menores de 5 anos,clasificacion a y b,2001-07-01,29,85,29,85,114
70705,GUTIERREZ,estado nutricional en menores de 5 anos,clasificacion a y b,2001-07-01,34,52,34,52,86
10502,HUACARETA,estado nutricional en menores de 5 anos,clasificacion a y b,2001-07-01,12,37,12,37,49
40501,HUACHACALLA,estado nutricional en menores de 5 anos,clasificacion a y b,2001-07-01,5,1,5,1,6
40701,HUANUNI,estado nutricional en menores de 5 anos,clasificacion a y b,2001-07-01,7,5,7,5,12
80803,HUARACAJE,estado nutricional en menores de 5 anos,clasificacion a y b,2001-07-01,5,12,5,12,17
41601,HUAYLLAMARCA,estado nutricional en menores de 5 anos,clasificacion a y b,2001-07-01,0,3,0,3,3
10304,ICLA,estado nutricional en menores de 5 anos,clasificacion a y b,2001-07-01,17,39,17,39,56
10703,INCAHUASI,estado nutricional en menores de 5 anos,clasificacion a y b,2001-07-01,11,37,11,37,48
21001,INQUISIVI,estado nutricional en menores de 5 anos,clasificacion a y b,2001-07-01,8,10,8,10,18
21102,IRUPANA (VILLA DE LANZA),estado nutricional en menores de 5 anos,clasificacion a y b,2001-07-01,27,24,27,24,51
21501,IXIAMAS,estado nutricional en menores de 5 anos,clasificacion a y b,2001-07-01,10,35,10,35,45
21105,LA ASUNTA,estado nutricional en menores de 5 anos,clasificacion a y b,2001-07-01,19,11,19,11,30
70104,LA GUARDIA,estado nutricional en menores de 5 anos,clasificacion a y b,2001-07-01,29,203,29,203,232
20101,LA PAZ,estado nutricional en menores de 5 anos,clasificacion a y b,2001-07-01,378,477,378,477,855
70701,LAGUNILLAS,estado nutricional en menores de 5 anos,clasificacion a y b,2001-07-01,7,10,7,10,17
21202,LAJA,estado nutricional en menores de 5 anos,clasificacion a y b,2001-07-01,13,34,13,34,47
10903,LAS CARRERAS,estado nutricional en menores de 5 anos,clasificacion a y b,2001-07-01,1,26,1,26,27
21006,LICOMA PAMPA,estado nutricional en menores de 5 anos,clasificacion a y b,2001-07-01,5,1,5,1,6
50203,LLALLAGUA,estado nutricional en menores de 5 anos,clasificacion a y b,2001-07-01,16,24,16,24,40
51401,LLICA,estado nutricional en menores de 5 anos,clasificacion a y b,2001-07-01,1,10,1,10,11
80601,LORETO,estado nutricional en menores de 5 anos,clasificacion a y b,2001-07-01,1,6,1,6,7
20901,LURIBAY,estado nutricional en menores de 5 anos,clasificacion a y b,2001-07-01,1,8,1,8,9
40702,MACHACAMARCA,estado nutricional en menores de 5 anos,clasificacion a y b,2001-07-01,0,4,0,4,4
11003,MACHARETI,estado nutricional en menores de 5 anos,clasificacion a y b,2001-07-01,9,74,9,74,83
80801,MAGDALENA,estado nutricional en menores de 5 anos,clasificacion a y b,2001-07-01,3,6,3,6,9
70903,MAIRANA,estado nutricional en menores de 5 anos,clasificacion a y b,2001-07-01,31,12,31,12,43
20103,MECAPACA,estado nutricional en menores de 5 anos,clasificacion a y b,2001-07-01,2,8,2,8,10
71003,MINEROS,estado nutricional en menores de 5 anos,clasificacion a y b,2001-07-01,40,134,40,134,174
31301,MIZQUE,estado nutricional en menores de 5 anos,clasificacion a y b,2001-07-01,30,4,30,4,34
20402,MOCOMOCO,estado nutricional en menores de 5 anos,clasificacion a y b,2001-07-01,7,1,7,1,8
10303,MOJOCOYA,estado nutricional en menores de 5 anos,clasificacion a y b,2001-07-01,13,37,13,37,50
10501,MONTEAGUDO,estado nutricional en menores de 5 anos,clasificacion a y b,2001-07-01,39,159,39,159,198
71001,MONTERO,estado nutricional en menores de 5 anos,clasificacion a y b,2001-07-01,100,410,100,410,510
70803,MORO MORO,estado nutricional en menores de 5 anos,clasificacion a y b,2001-07-01,9,2,9,2,11
30302,MOROCHATA,estado nutricional en menores de 5 anos,clasificacion a y b,2001-07-01,5,2,5,2,7
90401,NACEBE (SANTA ROSA DEL ABUNA),estado nutricional en menores de 5 anos,clasificacion a y b,2001-07-01,2,9,2,9,11
50404,OCURI,estado nutricional en menores de 5 anos,clasificacion a y b,2001-07-01,5,19,5,19,24
70202,OKINAWA,estado nutricional en menores de 5 anos,clasificacion a y b,2001-07-01,2,13,2,13,15
30203,OMEREQUE,estado nutricional en menores de 5 anos,clasificacion a y b,2001-07-01,0,11,0,11,11
40101,ORURO,estado nutricional en menores de 5 anos,clasificacion a y b,2001-07-01,80,311,80,311,391
60201,PADCAYA,estado nutricional en menores de 5 anos,clasificacion a y b,2001-07-01,17,49,17,49,66
10401,PADILLA,estado nutricional en menores de 5 anos,clasificacion a y b,2001-07-01,13,33,13,33,46
70502,PAILON,estado nutricional en menores de 5 anos,clasificacion a y b,2001-07-01,18,92,18,92,110
20102,PALCA,estado nutricional en menores de 5 anos,clasificacion a y b,2001-07-01,4,3,4,3,7
21104,PALOS BLANCOS,estado nutricional en menores de 5 anos,clasificacion a y b,2001-07-01,45,18,45,18,63
40802,PAMPA AULLAGAS,estado nutricional en menores de 5 anos,clasificacion a y b,2001-07-01,2,0,2,0,2
70902,PAMPA GRANDE,estado nutricional en menores de 5 anos,clasificacion a y b,2001-07-01,3,12,3,12,15
21802,PAPEL PAMPA,estado nutricional en menores de 5 anos,clasificacion a y b,2001-07-01,0,2,0,2,2
30202,PASORAPA,estado nutricional en menores de 5 anos,clasificacion a y b,2001-07-01,3,5,3,5,8
21305,PATACAMAYA,estado nutricional en menores de 5 anos,clasificacion a y b,2001-07-01,21,2,21,2,23
40602,PAZÃ‘A,estado nutricional en menores de 5 anos,clasificacion a y b,2001-07-01,0,2,0,2,2
20702,PELECHUCO,estado nutricional en menores de 5 anos,clasificacion a y b,2001-07-01,2,1,2,1,3
50403,POCOATA,estado nutricional en menores de 5 anos,clasificacion a y b,2001-07-01,2,4,2,4,6
31203,POCONA,estado nutricional en menores de 5 anos,clasificacion a y b,2001-07-01,1,0,1,0,1
31202,POJO (CBBA),estado nutricional en menores de 5 anos,clasificacion a y b,2001-07-01,95,46,95,46,141
40601,POOPO,estado nutricional en menores de 5 anos,clasificacion a y b,2001-07-01,1,3,1,3,4
51203,PORCO,estado nutricional en menores de 5 anos,clasificacion a y b,2001-07-01,1,5,1,5,6
10103,POROMA,estado nutricional en menores de 5 anos,clasificacion a y b,2001-07-01,2,11,2,11,13
70103,PORONGO,estado nutricional en menores de 5 anos,clasificacion a y b,2001-07-01,2,21,2,21,23
70601,PORTACHUELO,estado nutricional en menores de 5 anos,clasificacion a y b,2001-07-01,51,49,51,49,100
90102,PORVENIR,estado nutricional en menores de 5 anos,clasificacion a y b,2001-07-01,5,4,5,4,9
70804,POSTRER VALLE,estado nutricional en menores de 5 anos,clasificacion a y b,2001-07-01,0,4,0,4,4
50101,POTOSI,estado nutricional en menores de 5 anos,clasificacion a y b,2001-07-01,34,87,34,87,121
10302,PRESTO,estado nutricional en menores de 5 anos,clasificacion a y b,2001-07-01,1,14,1,14,15
21201,PUCARANI,estado nutricional en menores de 5 anos,clasificacion a y b,2001-07-01,5,31,5,31,36
20401,PUERTO ACOSTA,estado nutricional en menores de 5 anos,clasificacion a y b,2001-07-01,12,7,12,7,19
20403,PUERTO CARABUCO,estado nutricional en menores de 5 anos,clasificacion a y b,2001-07-01,14,5,14,5,19
90301,PUERTO GONZALO MORENO,estado nutricional en menores de 5 anos,clasificacion a y b,2001-07-01,8,1,8,1,9
21204,PUERTO PEREZ,estado nutricional en menores de 5 anos,clasificacion a y b,2001-07-01,0,6,0,6,6
71402,PUERTO QUIJARRO,estado nutricional en menores de 5 anos,clasificacion a y b,2001-07-01,38,2,38,2,40
90201,PUERTO RICO,estado nutricional en menores de 5 anos,clasificacion a y b,2001-07-01,0,8,0,8,8
80703,PUERTO SILES,estado nutricional en menores de 5 anos,clasificacion a y b,2001-07-01,2,0,2,0,2
71401,PUERTO SUAREZ,estado nutricional en menores de 5 anos,clasificacion a y b,2001-07-01,67,8,67,8,75
31205,PUERTO VILLARROEL,estado nutricional en menores de 5 anos,clasificacion a y b,2001-07-01,56,31,56,31,87
51101,PUNA,estado nutricional en menores de 5 anos,clasificacion a y b,2001-07-01,18,27,18,27,45
31401,PUNATA,estado nutricional en menores de 5 anos,clasificacion a y b,2001-07-01,13,33,13,33,46
20604,QUIABAYA,estado nutricional en menores de 5 anos,clasificacion a y b,2001-07-01,2,0,2,0,2
30901,QUILLACOLLO,estado nutricional en menores de 5 anos,clasificacion a y b,2001-07-01,42,45,42,45,87
21002,QUIME,estado nutricional en menores de 5 anos,clasificacion a y b,2001-07-01,5,11,5,11,16
70904,QUIRUSILLAS,estado nutricional en menores de 5 anos,clasificacion a y b,2001-07-01,2,2,2,2,4
50402,RAVELO,estado nutricional en menores de 5 anos,clasificacion a y b,2001-07-01,4,6,4,6,10
80301,REYES,estado nutricional en menores de 5 anos,clasificacion a y b,2001-07-01,5,22,5,22,27
80201,RIBERALTA,estado nutricional en menores de 5 anos,clasificacion a y b,2001-07-01,67,158,67,158,225
70503,ROBORE,estado nutricional en menores de 5 anos,clasificacion a y b,2001-07-01,30,106,30,106,136
80304,RURRENABAQUE,estado nutricional en menores de 5 anos,clasificacion a y b,2001-07-01,37,37,37,37,74
40901,SABAYA,estado nutricional en menores de 5 anos,clasificacion a y b,2001-07-01,0,1,0,1,1
31001,SACABA,estado nutricional en menores de 5 anos,clasificacion a y b,2001-07-01,7,6,7,6,13
50701,SACACA,estado nutricional en menores de 5 anos,clasificacion a y b,2001-07-01,2,1,2,1,3
71302,SAIPINA,estado nutricional en menores de 5 anos,clasificacion a y b,2001-07-01,3,45,3,45,48
40801,SALINAS DE GARCI MENDOZA,estado nutricional en menores de 5 anos,clasificacion a y b,2001-07-01,2,4,2,4,6
70901,SAMAIPATA,estado nutricional en menores de 5 anos,clasificacion a y b,2001-07-01,2,6,2,6,8
51601,SAN AGUSTIN,estado nutricional en menores de 5 anos,clasificacion a y b,2001-07-01,1,5,1,5,6
80602,SAN ANDRES,estado nutricional en menores de 5 anos,clasificacion a y b,2001-07-01,2,7,2,7,9
51003,SAN ANTONIO DE ESMORUCO,estado nutricional en menores de 5 anos,clasificacion a y b,2001-07-01,1,1,1,1,2
71105,SAN ANTONIO DE LOMERIO,estado nutricional en menores de 5 anos,clasificacion a y b,2001-07-01,16,16,16,16,32
31403,SAN BENITO,estado nutricional en menores de 5 anos,clasificacion a y b,2001-07-01,0,5,0,5,5
80302,SAN BORJA,estado nutricional en menores de 5 anos,clasificacion a y b,2001-07-01,23,89,23,89,112
21502,SAN BUENA VENTURA,estado nutricional en menores de 5 anos,clasificacion a y b,2001-07-01,5,50,5,50,55
70402,SAN CARLOS,estado nutricional en menores de 5 anos,clasificacion a y b,2001-07-01,29,44,29,44,73
80501,SAN IGNACIO,estado nutricional en menores de 5 anos,clasificacion a y b,2001-07-01,6,45,6,45,51
70301,SAN IGNACIO DE VELASCO,estado nutricional en menores de 5 anos,clasificacion a y b,2001-07-01,135,94,135,94,229
80102,SAN JAVIER(BNI),estado nutricional en menores de 5 anos,clasificacion a y b,2001-07-01,2,18,2,18,20
71102,SAN JAVIER(STC),estado nutricional en menores de 5 anos,clasificacion a y b,2001-07-01,8,56,8,56,64
80701,SAN JOAQUIN,estado nutricional en menores de 5 anos,clasificacion a y b,2001-07-01,5,12,5,12,17
70501,SAN JOSE DE CHIQUITOS,estado nutricional en menores de 5 anos,clasificacion a y b,2001-07-01,21,12,21,12,33
71104,SAN JULIAN,estado nutricional en menores de 5 anos,clasificacion a y b,2001-07-01,53,93,53,93,146
60501,SAN LORENZO(TJA),estado nutricional en menores de 5 anos,clasificacion a y b,2001-07-01,4,2,4,2,6
10702,SAN LUCAS,estado nutricional en menores de 5 anos,clasificacion a y b,2001-07-01,15,63,15,63,78
71201,SAN MATIAS,estado nutricional en menores de 5 anos,clasificacion a y b,2001-07-01,10,35,10,35,45
70302,SAN MIGUEL DE VELASCO,estado nutricional en menores de 5 anos,clasificacion a y b,2001-07-01,13,14,13,14,27
51001,SAN PABLO DE LIPEZ,estado nutricional en menores de 5 anos,clasificacion a y b,2001-07-01,0,1,0,1,1
50501,SAN PEDRO DE BUENA VISTA,estado nutricional en menores de 5 anos,clasificacion a y b,2001-07-01,4,19,4,19,23
21801,SAN PEDRO DE CURAHUARA,estado nutricional en menores de 5 anos,clasificacion a y b,2001-07-01,0,3,0,3,3
50902,SAN PEDRO DE QUEMES,estado nutricional en menores de 5 anos,clasificacion a y b,2001-07-01,1,2,1,2,3
21702,SAN PEDRO DE TIQUINA,estado nutricional en menores de 5 anos,clasificacion a y b,2001-07-01,3,9,3,9,12
70303,SAN RAFAEL,estado nutricional en menores de 5 anos,clasificacion a y b,2001-07-01,10,0,10,0,10
80702,SAN RAMON,estado nutricional en menores de 5 anos,clasificacion a y b,2001-07-01,2,13,2,13,15
80401,SANTA ANA,estado nutricional en menores de 5 anos,clasificacion a y b,2001-07-01,2,7,2,7,9
70101,SANTA CRUZ DE LA SIERRA,estado nutricional en menores de 5 anos,clasificacion a y b,2001-07-01,989,1021,989,1021,2010
70602,SANTA ROSA DEL SARA,estado nutricional en menores de 5 anos,clasificacion a y b,2001-07-01,12,17,12,17,29
20308,SANTIAGO DE CALLAPA,estado nutricional en menores de 5 anos,clasificacion a y b,2001-07-01,0,6,0,6,6
41401,SANTIAGO DE HUARI,estado nutricional en menores de 5 anos,clasificacion a y b,2001-07-01,7,2,7,2,9
21901,SANTIAGO DE MACHACA,estado nutricional en menores de 5 anos,clasificacion a y b,2001-07-01,0,1,0,1,1
30702,SANTIVAÃ‘ES,estado nutricional en menores de 5 anos,clasificacion a y b,2001-07-01,5,1,5,1,6
40202,SANTUARIO DE QUILLACAS,estado nutricional en menores de 5 anos,clasificacion a y b,2001-07-01,1,1,1,1,2
20902,SAPAHAQUI,estado nutricional en menores de 5 anos,clasificacion a y b,2001-07-01,1,6,1,6,7
90303,SENA,estado nutricional en menores de 5 anos,clasificacion a y b,2001-07-01,0,11,0,11,11
21301,SICA SICA (VILLA AROMA),estado nutricional en menores de 5 anos,clasificacion a y b,2001-07-01,7,14,7,14,21
30902,SIPE SIPE,estado nutricional en menores de 5 anos,clasificacion a y b,2001-07-01,76,37,76,37,113
10403,SOPACHUY,estado nutricional en menores de 5 anos,clasificacion a y b,2001-07-01,4,21,4,21,25
20601,SORATA,estado nutricional en menores de 5 anos,clasificacion a y b,2001-07-01,5,17,5,17,22
10101,SUCRE,estado nutricional en menores de 5 anos,clasificacion a y b,2001-07-01,78,436,78,436,514
20603,TACACOMA,estado nutricional en menores de 5 anos,clasificacion a y b,2001-07-01,3,14,3,14,17
50303,TACOBAMBA,estado nutricional en menores de 5 anos,clasificacion a y b,2001-07-01,3,8,3,8,11
30602,TACOPAYA,estado nutricional en menores de 5 anos,clasificacion a y b,2001-07-01,0,3,0,3,3
51402,TAHUA,estado nutricional en menores de 5 anos,clasificacion a y b,2001-07-01,0,2,0,2,2
31101,TAPACARI,estado nutricional en menores de 5 anos,clasificacion a y b,2001-07-01,3,13,3,13,16
10601,TARABUCO,estado nutricional en menores de 5 anos,clasificacion a y b,2001-07-01,13,45,13,45,58
30401,TARATA,estado nutricional en menores de 5 anos,clasificacion a y b,2001-07-01,3,15,3,15,18
60101,TARIJA,estado nutricional en menores de 5 anos,clasificacion a y b,2001-07-01,121,289,121,289,410
10202,TARVITA,estado nutricional en menores de 5 anos,clasificacion a y b,2001-07-01,4,25,4,25,29
20803,TIAWANACU,estado nutricional en menores de 5 anos,clasificacion a y b,2001-07-01,18,3,18,3,21
50102,TINGUIPAYA,estado nutricional en menores de 5 anos,clasificacion a y b,2001-07-01,0,6,0,6,6
20606,TIPUANI,estado nutricional en menores de 5 anos,clasificacion a y b,2001-07-01,31,6,31,6,37
30903,TIQUIPAYA,estado nutricional en menores de 5 anos,clasificacion a y b,2001-07-01,24,38,24,38,62
31601,TIRAQUE (CBBA),estado nutricional en menores de 5 anos,clasificacion a y b,2001-07-01,65,42,65,42,107
30802,TOCO,estado nutricional en menores de 5 anos,clasificacion a y b,2001-07-01,0,6,0,6,6
30803,TOLATA,estado nutricional en menores de 5 anos,clasificacion a y b,2001-07-01,0,5,0,5,5
41001,TOLEDO,estado nutricional en menores de 5 anos,clasificacion a y b,2001-07-01,4,12,4,12,16
51202,TOMAVE,estado nutricional en menores de 5 anos,clasificacion a y b,2001-07-01,9,10,9,10,19
10402,TOMINA,estado nutricional en menores de 5 anos,clasificacion a y b,2001-07-01,4,25,4,25,29
50502,TORO TORO,estado nutricional en menores de 5 anos,clasificacion a y b,2001-07-01,1,2,1,2,3
31201,TOTORA(CBBA),estado nutricional en menores de 5 anos,clasificacion a y b,2001-07-01,8,8,8,8,16
41301,TOTORA(ORR),estado nutricional en menores de 5 anos,clasificacion a y b,2001-07-01,0,3,0,3,3
70802,TRIGAL,estado nutricional en menores de 5 anos,clasificacion a y b,2001-07-01,2,0,2,0,2
80101,TRINIDAD,estado nutricional en menores de 5 anos,clasificacion a y b,2001-07-01,40,106,40,106,146
50801,TUPIZA,estado nutricional en menores de 5 anos,clasificacion a y b,2001-07-01,20,96,20,96,116
40402,TURCO,estado nutricional en menores de 5 anos,clasificacion a y b,2001-07-01,6,4,6,4,10
21302,UMALA,estado nutricional en menores de 5 anos,clasificacion a y b,2001-07-01,0,2,0,2,2
50201,UNCIA,estado nutricional en menores de 5 anos,clasificacion a y b,2001-07-01,7,64,7,64,71
60401,URIONDO (A. CONCEPCION),estado nutricional en menores de 5 anos,clasificacion a y b,2001-07-01,3,33,3,33,36
71502,URUBICHA,estado nutricional en menores de 5 anos,clasificacion a y b,2001-07-01,3,0,3,0,3
51201,UYUNI,estado nutricional en menores de 5 anos,clasificacion a y b,2001-07-01,12,47,12,47,59
30502,VACAS,estado nutricional en menores de 5 anos,clasificacion a y b,2001-07-01,0,1,0,1,1
70801,VALLEGRANDE,estado nutricional en menores de 5 anos,clasificacion a y b,2001-07-01,43,33,43,33,76
20801,VIACHA,estado nutricional en menores de 5 anos,clasificacion a y b,2001-07-01,11,54,11,54,65
31302,VILA VILA,estado nutricional en menores de 5 anos,clasificacion a y b,2001-07-01,2,3,2,3,5
60303,VILLA MONTES,estado nutricional en menores de 5 anos,clasificacion a y b,2001-07-01,50,48,50,48,98
90502,VILLA NUEVA (LOMA ALTA),estado nutricional en menores de 5 anos,clasificacion a y b,2001-07-01,1,0,1,0,1
10801,VILLA SERRANO,estado nutricional en menores de 5 anos,clasificacion a y b,2001-07-01,8,47,8,47,55
31003,VILLA TUNARI,estado nutricional en menores de 5 anos,clasificacion a y b,2001-07-01,78,34,78,34,112
11001,VILLA VACA GUZMAN (MUYUPAMPA),estado nutricional en menores de 5 anos,clasificacion a y b,2001-07-01,13,43,13,43,56
51501,VILLAZON,estado nutricional en menores de 5 anos,clasificacion a y b,2001-07-01,17,99,17,99,116
30904,VINTO,estado nutricional en menores de 5 anos,clasificacion a y b,2001-07-01,40,6,40,6,46
50602,VITICHI,estado nutricional en menores de 5 anos,clasificacion a y b,2001-07-01,5,2,5,2,7
70201,WARNES,estado nutricional en menores de 5 anos,clasificacion a y b,2001-07-01,90,86,90,86,176
20903,YACO,estado nutricional en menores de 5 anos,clasificacion a y b,2001-07-01,0,5,0,5,5
60301,YACUIBA,estado nutricional en menores de 5 anos,clasificacion a y b,2001-07-01,52,243,52,243,295
10602,YAMPARAEZ,estado nutricional en menores de 5 anos,clasificacion a y b,2001-07-01,7,36,7,36,43
21103,YANACACHI,estado nutricional en menores de 5 anos,clasificacion a y b,2001-07-01,1,0,1,0,1
70403,YAPACANI,estado nutricional en menores de 5 anos,clasificacion a y b,2001-07-01,46,131,46,131,177
50103,YOCALLA,estado nutricional en menores de 5 anos,clasificacion a y b,2001-07-01,2,10,2,10,12
10102,YOTALA,estado nutricional en menores de 5 anos,clasificacion a y b,2001-07-01,12,34,12,34,46
60402,YUNCHARA,estado nutricional en menores de 5 anos,clasificacion a y b,2001-07-01,3,2,3,2,5
10301,ZUDAÃ‘EZ,estado nutricional en menores de 5 anos,clasificacion a y b,2001-07-01,12,11,12,11,23
51302,ACACIO,estado nutricional en menores de 5 anos,clasificacion a y b,2001-08-01,4,1,4,1,5
20201,ACHACACHI,estado nutricional en menores de 5 anos,clasificacion a y b,2001-08-01,30,108,30,108,138
20104,ACHOCALLA,estado nutricional en menores de 5 anos,clasificacion a y b,2001-08-01,3,9,3,9,12
30201,AIQUILE,estado nutricional en menores de 5 anos,clasificacion a y b,2001-08-01,11,19,11,19,30
31303,ALALAY,estado nutricional en menores de 5 anos,clasificacion a y b,2001-08-01,2,0,2,0,2
10404,ALCALA,estado nutricional en menores de 5 anos,clasificacion a y b,2001-08-01,5,26,5,26,31
20202,ANCORAIMES,estado nutricional en menores de 5 anos,clasificacion a y b,2001-08-01,6,25,6,25,31
41201,ANDAMARCA,estado nutricional en menores de 5 anos,clasificacion a y b,2001-08-01,0,1,0,1,1
30402,ANZALDO,estado nutricional en menores de 5 anos,clasificacion a y b,2001-08-01,1,3,1,3,4
20701,APOLO,estado nutricional en menores de 5 anos,clasificacion a y b,2001-08-01,32,2,32,2,34
51301,ARAMPAMPA,estado nutricional en menores de 5 anos,clasificacion a y b,2001-08-01,0,8,0,8,8
30501,ARANI,estado nutricional en menores de 5 anos,clasificacion a y b,2001-08-01,0,46,0,46,46
30403,ARBIETO,estado nutricional en menores de 5 anos,clasificacion a y b,2001-08-01,11,8,11,8,19
30601,ARQUE,estado nutricional en menores de 5 anos,clasificacion a y b,2001-08-01,2,4,2,4,6
71501,ASCENCION DE GUARAYOS,estado nutricional en menores de 5 anos,clasificacion a y b,2001-08-01,123,19,123,19,142
50802,ATOCHA,estado nutricional en menores de 5 anos,clasificacion a y b,2001-08-01,6,15,6,15,21
20503,AUCAPATA,estado nutricional en menores de 5 anos,clasificacion a y b,2001-08-01,0,6,0,6,6
20502,AYATA,estado nutricional en menores de 5 anos,clasificacion a y b,2001-08-01,5,0,5,0,5
21303,AYO AYO,estado nutricional en menores de 5 anos,clasificacion a y b,2001-08-01,5,10,5,10,15
30301,AYOPAYA (V. DE INDEPENDENCIA),estado nutricional en menores de 5 anos,clasificacion a y b,2001-08-01,24,17,24,17,41
10201,AZURDUY,estado nutricional en menores de 5 anos,clasificacion a y b,2001-08-01,14,5,14,5,19
21203,BATALLAS,estado nutricional en menores de 5 anos,clasificacion a y b,2001-08-01,8,101,8,101,109
80802,BAURES,estado nutricional en menores de 5 anos,clasificacion a y b,2001-08-01,4,2,4,2,6
41202,BELEN DE ANDAMARCA,estado nutricional en menores de 5 anos,clasificacion a y b,2001-08-01,0,1,0,1,1
50104,BELEN DE URMIRI,estado nutricional en menores de 5 anos,clasificacion a y b,2001-08-01,5,15,5,15,20
90104,BELLA FLOR,estado nutricional en menores de 5 anos,clasificacion a y b,2001-08-01,2,46,2,46,48
60202,BERMEJO,estado nutricional en menores de 5 anos,clasificacion a y b,2001-08-01,21,49,21,49,70
50301,BETANZOS,estado nutricional en menores de 5 anos,clasificacion a y b,2001-08-01,10,13,10,13,23
31501,BOLIVAR,estado nutricional en menores de 5 anos,clasificacion a y b,2001-08-01,5,0,5,0,5
90103,BOLPEBRA,estado nutricional en menores de 5 anos,clasificacion a y b,2001-08-01,0,2,0,2,2
70707,BOYUIBE,estado nutricional en menores de 5 anos,clasificacion a y b,2001-08-01,13,19,13,19,32
70401,BUENA VISTA,estado nutricional en menores de 5 anos,clasificacion a y b,2001-08-01,84,39,84,39,123
70703,CABEZAS,estado nutricional en menores de 5 anos,clasificacion a y b,2001-08-01,11,40,11,40,51
20905,CAIROMA,estado nutricional en menores de 5 anos,clasificacion a y b,2001-08-01,0,2,0,2,2
51102,"CAIZA ""D""",estado nutricional en menores de 5 anos,clasificacion a y b,2001-08-01,6,21,6,21,27
21003,CAJUATA,estado nutricional en menores de 5 anos,clasificacion a y b,2001-08-01,14,1,14,1,15
20303,CALACOTO,estado nutricional en menores de 5 anos,clasificacion a y b,2001-08-01,1,3,1,3,4
21304,CALAMARCA,estado nutricional en menores de 5 anos,clasificacion a y b,2001-08-01,5,4,5,4,9
10701,CAMARGO,estado nutricional en menores de 5 anos,clasificacion a y b,2001-08-01,15,22,15,22,37
10901,CAMATAQUI (C. VILLA ABECIA),estado nutricional en menores de 5 anos,clasificacion a y b,2001-08-01,2,18,2,18,20
70706,CAMIRI,estado nutricional en menores de 5 anos,clasificacion a y b,2001-08-01,107,65,107,65,172
30701,CAPINOTA,estado nutricional en menores de 5 anos,clasificacion a y b,2001-08-01,27,9,27,9,36
20302,CAQUIAVIRI,estado nutricional en menores de 5 anos,clasificacion a y b,2001-08-01,3,18,3,18,21
40102,CARACOLLO,estado nutricional en menores de 5 anos,clasificacion a y b,2001-08-01,11,12,11,12,23
22001,CARANAVI,estado nutricional en menores de 5 anos,clasificacion a y b,2001-08-01,126,81,126,81,207
60302,CARAPARI,estado nutricional en menores de 5 anos,clasificacion a y b,2001-08-01,11,20,11,20,31
50702,CARIPUYO,estado nutricional en menores de 5 anos,clasificacion a y b,2001-08-01,2,5,2,5,7
21902,CATACORA,estado nutricional en menores de 5 anos,clasificacion a y b,2001-08-01,2,1,2,1,3
21803,CHACARILLA,estado nutricional en menores de 5 anos,clasificacion a y b,2001-08-01,0,1,0,1,1
40201,CHALLAPATA,estado nutricional en menores de 5 anos,clasificacion a y b,2001-08-01,22,5,22,5,27
50302,CHAQUI,estado nutricional en menores de 5 anos,clasificacion a y b,2001-08-01,7,10,7,10,17
70702,CHARAGUA,estado nutricional en menores de 5 anos,clasificacion a y b,2001-08-01,14,63,14,63,77
50202,CHAYANTA,estado nutricional en menores de 5 anos,clasificacion a y b,2001-08-01,7,15,7,15,22
31204,CHIMORE,estado nutricional en menores de 5 anos,clasificacion a y b,2001-08-01,1,35,1,35,36
21101,CHULUMANI (V. DE LA LIBERTAD),estado nutricional en menores de 5 anos,clasificacion a y b,2001-08-01,9,34,9,34,43
30801,CLIZA,estado nutricional en menores de 5 anos,clasificacion a y b,2001-08-01,2,8,2,8,10
90101,COBIJA,estado nutricional en menores de 5 anos,clasificacion a y b,2001-08-01,76,30,76,30,106
30101,COCHABAMBA,estado nutricional en menores de 5 anos,clasificacion a y b,2001-08-01,1098,1210,1098,1210,2308
40902,COIPASA,estado nutricional en menores de 5 anos,clasificacion a y b,2001-08-01,0,1,0,1,1
30905,COLCAPIRHUA,estado nutricional en menores de 5 anos,clasificacion a y b,2001-08-01,31,28,31,28,59
50901,"COLCHA ""K""",estado nutricional en menores de 5 anos,clasificacion a y b,2001-08-01,10,23,10,23,33
21307,COLLANA,estado nutricional en menores de 5 anos,clasificacion a y b,2001-08-01,2,0,2,0,2
31002,COLOMI,estado nutricional en menores de 5 anos,clasificacion a y b,2001-08-01,34,33,34,33,67
70603,COLPA BELGICA,estado nutricional en menores de 5 anos,clasificacion a y b,2001-08-01,38,4,38,4,42
50401,COLQUECHACA,estado nutricional en menores de 5 anos,clasificacion a y b,2001-08-01,8,19,8,19,27
21306,COLQUENCHA,estado nutricional en menores de 5 anos,clasificacion a y b,2001-08-01,4,5,4,5,9
21004,COLQUIRI,estado nutricional en menores de 5 anos,clasificacion a y b,2001-08-01,15,19,15,19,34
20304,COMANCHE,estado nutricional en menores de 5 anos,clasificacion a y b,2001-08-01,0,2,0,2,2
71301,COMARAPA,estado nutricional en menores de 5 anos,clasificacion a y b,2001-08-01,0,19,0,19,19
20605,COMBAYA,estado nutricional en menores de 5 anos,clasificacion a y b,2001-08-01,3,3,3,3,6
71101,CONCEPCION,estado nutricional en menores de 5 anos,clasificacion a y b,2001-08-01,26,6,26,6,32
21701,COPACABANA,estado nutricional en menores de 5 anos,clasificacion a y b,2001-08-01,2,12,2,12,14
21402,CORIPATA,estado nutricional en menores de 5 anos,clasificacion a y b,2001-08-01,8,20,8,20,28
20301,CORO CORO,estado nutricional en menores de 5 anos,clasificacion a y b,2001-08-01,9,20,9,20,29
21401,COROICO,estado nutricional en menores de 5 anos,clasificacion a y b,2001-08-01,15,4,15,4,19
40301,CORQUE,estado nutricional en menores de 5 anos,clasificacion a y b,2001-08-01,2,4,2,4,6
50601,COTAGAITA,estado nutricional en menores de 5 anos,clasificacion a y b,2001-08-01,8,30,8,30,38
70102,COTOCA,estado nutricional en menores de 5 anos,clasificacion a y b,2001-08-01,57,197,57,197,254
31405,CUCHUMUELA (V. G. VILLARROEL),estado nutricional en menores de 5 anos,clasificacion a y b,2001-08-01,0,1,0,1,1
70704,CUEVO,estado nutricional en menores de 5 anos,clasificacion a y b,2001-08-01,15,5,15,5,20
10902,CULPINA,estado nutricional en menores de 5 anos,clasificacion a y b,2001-08-01,22,90,22,90,112
40401,CURAHUARA DE CARANGAS,estado nutricional en menores de 5 anos,clasificacion a y b,2001-08-01,0,1,0,1,1
21602,CURVA,estado nutricional en menores de 5 anos,clasificacion a y b,2001-08-01,6,0,6,0,6
20804,DESAGUADERO,estado nutricional en menores de 5 anos,clasificacion a y b,2001-08-01,0,5,0,5,5
20105,EL ALTO,estado nutricional en menores de 5 anos,clasificacion a y b,2001-08-01,628,592,628,592,1220
40103,EL CHORO,estado nutricional en menores de 5 anos,clasificacion a y b,2001-08-01,0,1,0,1,1
71503,EL PUENTE(STC),estado nutricional en menores de 5 anos,clasificacion a y b,2001-08-01,15,74,15,74,89
60502,EL PUENTE(TJA),estado nutricional en menores de 5 anos,clasificacion a y b,2001-08-01,2,2,2,2,4
70105,EL TORNO,estado nutricional en menores de 5 anos,clasificacion a y b,2001-08-01,33,74,33,74,107
10405,EL VILLAR,estado nutricional en menores de 5 anos,clasificacion a y b,2001-08-01,2,59,2,59,61
60601,ENTRE RIOS,estado nutricional en menores de 5 anos,clasificacion a y b,2001-08-01,17,24,17,24,41
41101,EUCALIPTUS,estado nutricional en menores de 5 anos,clasificacion a y b,2001-08-01,0,5,0,5,5
80402,EXALTACION,estado nutricional en menores de 5 anos,clasificacion a y b,2001-08-01,1,9,1,9,10
90203,FILADELFIA,estado nutricional en menores de 5 anos,clasificacion a y b,2001-08-01,1,3,1,3,4
71002,GENERAL SAAVEDRA,estado nutricional en menores de 5 anos,clasificacion a y b,2001-08-01,10,85,10,85,95
21601,GRAL. J.J. PEREZ (CHARAZANI),estado nutricional en menores de 5 anos,clasificacion a y b,2001-08-01,4,6,4,6,10
20602,GUANAY,estado nutricional en menores de 5 anos,clasificacion a y b,2001-08-01,7,41,7,41,48
20802,GUAQUI,estado nutricional en menores de 5 anos,clasificacion a y b,2001-08-01,1,8,1,8,9
80202,GUAYARAMERIN,estado nutricional en menores de 5 anos,clasificacion a y b,2001-08-01,47,89,47,89,136
70705,GUTIERREZ,estado nutricional en menores de 5 anos,clasificacion a y b,2001-08-01,33,56,33,56,89
10502,HUACARETA,estado nutricional en menores de 5 anos,clasificacion a y b,2001-08-01,2,45,2,45,47
40501,HUACHACALLA,estado nutricional en menores de 5 anos,clasificacion a y b,2001-08-01,1,0,1,0,1
40701,HUANUNI,estado nutricional en menores de 5 anos,clasificacion a y b,2001-08-01,13,8,13,8,21
80803,HUARACAJE,estado nutricional en menores de 5 anos,clasificacion a y b,2001-08-01,11,8,11,8,19
10304,ICLA,estado nutricional en menores de 5 anos,clasificacion a y b,2001-08-01,17,43,17,43,60
10703,INCAHUASI,estado nutricional en menores de 5 anos,clasificacion a y b,2001-08-01,22,39,22,39,61
21001,INQUISIVI,estado nutricional en menores de 5 anos,clasificacion a y b,2001-08-01,6,11,6,11,17
21102,IRUPANA (VILLA DE LANZA),estado nutricional en menores de 5 anos,clasificacion a y b,2001-08-01,13,26,13,26,39
21501,IXIAMAS,estado nutricional en menores de 5 anos,clasificacion a y b,2001-08-01,19,25,19,25,44
21105,LA ASUNTA,estado nutricional en menores de 5 anos,clasificacion a y b,2001-08-01,26,27,26,27,53
70104,LA GUARDIA,estado nutricional en menores de 5 anos,clasificacion a y b,2001-08-01,41,240,41,240,281
20101,LA PAZ,estado nutricional en menores de 5 anos,clasificacion a y b,2001-08-01,454,456,454,456,910
70701,LAGUNILLAS,estado nutricional en menores de 5 anos,clasificacion a y b,2001-08-01,23,21,23,21,44
21202,LAJA,estado nutricional en menores de 5 anos,clasificacion a y b,2001-08-01,9,30,9,30,39
10903,LAS CARRERAS,estado nutricional en menores de 5 anos,clasificacion a y b,2001-08-01,3,23,3,23,26
21006,LICOMA PAMPA,estado nutricional en menores de 5 anos,clasificacion a y b,2001-08-01,4,10,4,10,14
50203,LLALLAGUA,estado nutricional en menores de 5 anos,clasificacion a y b,2001-08-01,22,19,22,19,41
51401,LLICA,estado nutricional en menores de 5 anos,clasificacion a y b,2001-08-01,1,5,1,5,6
80601,LORETO,estado nutricional en menores de 5 anos,clasificacion a y b,2001-08-01,3,5,3,5,8
20901,LURIBAY,estado nutricional en menores de 5 anos,clasificacion a y b,2001-08-01,1,4,1,4,5
40702,MACHACAMARCA,estado nutricional en menores de 5 anos,clasificacion a y b,2001-08-01,10,1,10,1,11
11003,MACHARETI,estado nutricional en menores de 5 anos,clasificacion a y b,2001-08-01,13,106,13,106,119
80801,MAGDALENA,estado nutricional en menores de 5 anos,clasificacion a y b,2001-08-01,5,13,5,13,18
70903,MAIRANA,estado nutricional en menores de 5 anos,clasificacion a y b,2001-08-01,39,10,39,10,49
20103,MECAPACA,estado nutricional en menores de 5 anos,clasificacion a y b,2001-08-01,6,18,6,18,24
71003,MINEROS,estado nutricional en menores de 5 anos,clasificacion a y b,2001-08-01,33,152,33,152,185
31301,MIZQUE,estado nutricional en menores de 5 anos,clasificacion a y b,2001-08-01,36,11,36,11,47
20402,MOCOMOCO,estado nutricional en menores de 5 anos,clasificacion a y b,2001-08-01,5,3,5,3,8
51002,MOJINETE,estado nutricional en menores de 5 anos,clasificacion a y b,2001-08-01,0,1,0,1,1
10303,MOJOCOYA,estado nutricional en menores de 5 anos,clasificacion a y b,2001-08-01,0,37,0,37,37
10501,MONTEAGUDO,estado nutricional en menores de 5 anos,clasificacion a y b,2001-08-01,49,164,49,164,213
71001,MONTERO,estado nutricional en menores de 5 anos,clasificacion a y b,2001-08-01,175,580,175,580,755
70803,MORO MORO,estado nutricional en menores de 5 anos,clasificacion a y b,2001-08-01,15,8,15,8,23
30302,MOROCHATA,estado nutricional en menores de 5 anos,clasificacion a y b,2001-08-01,17,2,17,2,19
90401,NACEBE (SANTA ROSA DEL ABUNA),estado nutricional en menores de 5 anos,clasificacion a y b,2001-08-01,3,14,3,14,17
90501,NUEVO MANOA (NUEVA ESPERANZA),estado nutricional en menores de 5 anos,clasificacion a y b,2001-08-01,0,4,0,4,4
50404,OCURI,estado nutricional en menores de 5 anos,clasificacion a y b,2001-08-01,5,11,5,11,16
70202,OKINAWA,estado nutricional en menores de 5 anos,clasificacion a y b,2001-08-01,2,2,2,2,4
30203,OMEREQUE,estado nutricional en menores de 5 anos,clasificacion a y b,2001-08-01,2,22,2,22,24
40101,ORURO,estado nutricional en menores de 5 anos,clasificacion a y b,2001-08-01,98,378,98,378,476
60201,PADCAYA,estado nutricional en menores de 5 anos,clasificacion a y b,2001-08-01,8,24,8,24,32
10401,PADILLA,estado nutricional en menores de 5 anos,clasificacion a y b,2001-08-01,9,44,9,44,53
70502,PAILON,estado nutricional en menores de 5 anos,clasificacion a y b,2001-08-01,1,28,1,28,29
20102,PALCA,estado nutricional en menores de 5 anos,clasificacion a y b,2001-08-01,31,9,31,9,40
21104,PALOS BLANCOS,estado nutricional en menores de 5 anos,clasificacion a y b,2001-08-01,42,20,42,20,62
40802,PAMPA AULLAGAS,estado nutricional en menores de 5 anos,clasificacion a y b,2001-08-01,2,0,2,0,2
70902,PAMPA GRANDE,estado nutricional en menores de 5 anos,clasificacion a y b,2001-08-01,5,16,5,16,21
21802,PAPEL PAMPA,estado nutricional en menores de 5 anos,clasificacion a y b,2001-08-01,1,1,1,1,2
30202,PASORAPA,estado nutricional en menores de 5 anos,clasificacion a y b,2001-08-01,5,1,5,1,6
21305,PATACAMAYA,estado nutricional en menores de 5 anos,clasificacion a y b,2001-08-01,14,8,14,8,22
40602,PAZÃ‘A,estado nutricional en menores de 5 anos,clasificacion a y b,2001-08-01,1,2,1,2,3
20702,PELECHUCO,estado nutricional en menores de 5 anos,clasificacion a y b,2001-08-01,3,1,3,1,4
50403,POCOATA,estado nutricional en menores de 5 anos,clasificacion a y b,2001-08-01,11,14,11,14,25
31203,POCONA,estado nutricional en menores de 5 anos,clasificacion a y b,2001-08-01,5,6,5,6,11
31202,POJO (CBBA),estado nutricional en menores de 5 anos,clasificacion a y b,2001-08-01,92,72,92,72,164
40601,POOPO,estado nutricional en menores de 5 anos,clasificacion a y b,2001-08-01,0,3,0,3,3
51203,PORCO,estado nutricional en menores de 5 anos,clasificacion a y b,2001-08-01,9,13,9,13,22
10103,POROMA,estado nutricional en menores de 5 anos,clasificacion a y b,2001-08-01,2,18,2,18,20
70103,PORONGO,estado nutricional en menores de 5 anos,clasificacion a y b,2001-08-01,10,51,10,51,61
70601,PORTACHUELO,estado nutricional en menores de 5 anos,clasificacion a y b,2001-08-01,41,40,41,40,81
90102,PORVENIR,estado nutricional en menores de 5 anos,clasificacion a y b,2001-08-01,1,14,1,14,15
70804,POSTRER VALLE,estado nutricional en menores de 5 anos,clasificacion a y b,2001-08-01,14,4,14,4,18
50101,POTOSI,estado nutricional en menores de 5 anos,clasificacion a y b,2001-08-01,43,111,43,111,154
10302,PRESTO,estado nutricional en menores de 5 anos,clasificacion a y b,2001-08-01,6,25,6,25,31
70805,PUCARA,estado nutricional en menores de 5 anos,clasificacion a y b,2001-08-01,1,0,1,0,1
21201,PUCARANI,estado nutricional en menores de 5 anos,clasificacion a y b,2001-08-01,3,38,3,38,41
20401,PUERTO ACOSTA,estado nutricional en menores de 5 anos,clasificacion a y b,2001-08-01,16,5,16,5,21
20403,PUERTO CARABUCO,estado nutricional en menores de 5 anos,clasificacion a y b,2001-08-01,14,7,14,7,21
90301,PUERTO GONZALO MORENO,estado nutricional en menores de 5 anos,clasificacion a y b,2001-08-01,2,8,2,8,10
21204,PUERTO PEREZ,estado nutricional en menores de 5 anos,clasificacion a y b,2001-08-01,0,13,0,13,13
71402,PUERTO QUIJARRO,estado nutricional en menores de 5 anos,clasificacion a y b,2001-08-01,45,14,45,14,59
90201,PUERTO RICO,estado nutricional en menores de 5 anos,clasificacion a y b,2001-08-01,0,11,0,11,11
80703,PUERTO SILES,estado nutricional en menores de 5 anos,clasificacion a y b,2001-08-01,2,9,2,9,11
71401,PUERTO SUAREZ,estado nutricional en menores de 5 anos,clasificacion a y b,2001-08-01,78,6,78,6,84
31205,PUERTO VILLARROEL,estado nutricional en menores de 5 anos,clasificacion a y b,2001-08-01,104,68,104,68,172
51101,PUNA,estado nutricional en menores de 5 anos,clasificacion a y b,2001-08-01,25,59,25,59,84
31401,PUNATA,estado nutricional en menores de 5 anos,clasificacion a y b,2001-08-01,7,15,7,15,22
20604,QUIABAYA,estado nutricional en menores de 5 anos,clasificacion a y b,2001-08-01,5,1,5,1,6
30901,QUILLACOLLO,estado nutricional en menores de 5 anos,clasificacion a y b,2001-08-01,5,15,5,15,20
21002,QUIME,estado nutricional en menores de 5 anos,clasificacion a y b,2001-08-01,6,13,6,13,19
70904,QUIRUSILLAS,estado nutricional en menores de 5 anos,clasificacion a y b,2001-08-01,1,3,1,3,4
50402,RAVELO,estado nutricional en menores de 5 anos,clasificacion a y b,2001-08-01,11,20,11,20,31
80301,REYES,estado nutricional en menores de 5 anos,clasificacion a y b,2001-08-01,6,33,6,33,39
80201,RIBERALTA,estado nutricional en menores de 5 anos,clasificacion a y b,2001-08-01,95,220,95,220,315
70503,ROBORE,estado nutricional en menores de 5 anos,clasificacion a y b,2001-08-01,19,61,19,61,80
80304,RURRENABAQUE,estado nutricional en menores de 5 anos,clasificacion a y b,2001-08-01,66,75,66,75,141
40901,SABAYA,estado nutricional en menores de 5 anos,clasificacion a y b,2001-08-01,2,1,2,1,3
31001,SACABA,estado nutricional en menores de 5 anos,clasificacion a y b,2001-08-01,100,12,100,12,112
30404,SACABAMBA,estado nutricional en menores de 5 anos,clasificacion a y b,2001-08-01,1,6,1,6,7
50701,SACACA,estado nutricional en menores de 5 anos,clasificacion a y b,2001-08-01,4,4,4,4,8
71302,SAIPINA,estado nutricional en menores de 5 anos,clasificacion a y b,2001-08-01,10,6,10,6,16
40801,SALINAS DE GARCI MENDOZA,estado nutricional en menores de 5 anos,clasificacion a y b,2001-08-01,2,1,2,1,3
70901,SAMAIPATA,estado nutricional en menores de 5 anos,clasificacion a y b,2001-08-01,1,14,1,14,15
51601,SAN AGUSTIN,estado nutricional en menores de 5 anos,clasificacion a y b,2001-08-01,1,3,1,3,4
80602,SAN ANDRES,estado nutricional en menores de 5 anos,clasificacion a y b,2001-08-01,3,17,3,17,20
51003,SAN ANTONIO DE ESMORUCO,estado nutricional en menores de 5 anos,clasificacion a y b,2001-08-01,0,1,0,1,1
71105,SAN ANTONIO DE LOMERIO,estado nutricional en menores de 5 anos,clasificacion a y b,2001-08-01,14,3,14,3,17
31403,SAN BENITO,estado nutricional en menores de 5 anos,clasificacion a y b,2001-08-01,2,5,2,5,7
80302,SAN BORJA,estado nutricional en menores de 5 anos,clasificacion a y b,2001-08-01,34,91,34,91,125
21502,SAN BUENA VENTURA,estado nutricional en menores de 5 anos,clasificacion a y b,2001-08-01,7,16,7,16,23
70402,SAN CARLOS,estado nutricional en menores de 5 anos,clasificacion a y b,2001-08-01,23,71,23,71,94
80501,SAN IGNACIO,estado nutricional en menores de 5 anos,clasificacion a y b,2001-08-01,21,35,21,35,56
70301,SAN IGNACIO DE VELASCO,estado nutricional en menores de 5 anos,clasificacion a y b,2001-08-01,143,62,143,62,205
80102,SAN JAVIER(BNI),estado nutricional en menores de 5 anos,clasificacion a y b,2001-08-01,1,5,1,5,6
71102,SAN JAVIER(STC),estado nutricional en menores de 5 anos,clasificacion a y b,2001-08-01,27,78,27,78,105
80701,SAN JOAQUIN,estado nutricional en menores de 5 anos,clasificacion a y b,2001-08-01,5,16,5,16,21
70501,SAN JOSE DE CHIQUITOS,estado nutricional en menores de 5 anos,clasificacion a y b,2001-08-01,15,16,15,16,31
71104,SAN JULIAN,estado nutricional en menores de 5 anos,clasificacion a y b,2001-08-01,76,147,76,147,223
90302,SAN LORENZO(PND),estado nutricional en menores de 5 anos,clasificacion a y b,2001-08-01,4,7,4,7,11
60501,SAN LORENZO(TJA),estado nutricional en menores de 5 anos,clasificacion a y b,2001-08-01,10,6,10,6,16
10702,SAN LUCAS,estado nutricional en menores de 5 anos,clasificacion a y b,2001-08-01,18,80,18,80,98
71201,SAN MATIAS,estado nutricional en menores de 5 anos,clasificacion a y b,2001-08-01,15,46,15,46,61
70302,SAN MIGUEL DE VELASCO,estado nutricional en menores de 5 anos,clasificacion a y b,2001-08-01,7,27,7,27,34
51001,SAN PABLO DE LIPEZ,estado nutricional en menores de 5 anos,clasificacion a y b,2001-08-01,0,3,0,3,3
50501,SAN PEDRO DE BUENA VISTA,estado nutricional en menores de 5 anos,clasificacion a y b,2001-08-01,3,8,3,8,11
21801,SAN PEDRO DE CURAHUARA,estado nutricional en menores de 5 anos,clasificacion a y b,2001-08-01,3,2,3,2,5
50902,SAN PEDRO DE QUEMES,estado nutricional en menores de 5 anos,clasificacion a y b,2001-08-01,0,2,0,2,2
21702,SAN PEDRO DE TIQUINA,estado nutricional en menores de 5 anos,clasificacion a y b,2001-08-01,2,23,2,23,25
90202,SAN PEDRO(PND),estado nutricional en menores de 5 anos,clasificacion a y b,2001-08-01,2,1,2,1,3
70303,SAN RAFAEL,estado nutricional en menores de 5 anos,clasificacion a y b,2001-08-01,22,0,22,0,22
80702,SAN RAMON,estado nutricional en menores de 5 anos,clasificacion a y b,2001-08-01,50,84,50,84,134
80702,SAN RAMON,estado nutricional en menores de 5 anos,clasificacion a y b,2001-08-01,5,17,5,17,22
80401,SANTA ANA,estado nutricional en menores de 5 anos,clasificacion a y b,2001-08-01,5,13,5,13,18
70101,SANTA CRUZ DE LA SIERRA,estado nutricional en menores de 5 anos,clasificacion a y b,2001-08-01,1252,1018,1252,1018,2270
80303,SANTA ROSA,estado nutricional en menores de 5 anos,clasificacion a y b,2001-08-01,12,23,12,23,35
70602,SANTA ROSA DEL SARA,estado nutricional en menores de 5 anos,clasificacion a y b,2001-08-01,29,31,29,31,60
20308,SANTIAGO DE CALLAPA,estado nutricional en menores de 5 anos,clasificacion a y b,2001-08-01,0,1,0,1,1
41401,SANTIAGO DE HUARI,estado nutricional en menores de 5 anos,clasificacion a y b,2001-08-01,2,2,2,2,4
21901,SANTIAGO DE MACHACA,estado nutricional en menores de 5 anos,clasificacion a y b,2001-08-01,1,4,1,4,5
30702,SANTIVAÃ‘ES,estado nutricional en menores de 5 anos,clasificacion a y b,2001-08-01,17,0,17,0,17
40202,SANTUARIO DE QUILLACAS,estado nutricional en menores de 5 anos,clasificacion a y b,2001-08-01,3,1,3,1,4
20902,SAPAHAQUI,estado nutricional en menores de 5 anos,clasificacion a y b,2001-08-01,1,6,1,6,7
90303,SENA,estado nutricional en menores de 5 anos,clasificacion a y b,2001-08-01,0,4,0,4,4
21301,SICA SICA (VILLA AROMA),estado nutricional en menores de 5 anos,clasificacion a y b,2001-08-01,9,17,9,17,26
30703,SICAYA,estado nutricional en menores de 5 anos,clasificacion a y b,2001-08-01,3,5,3,5,8
30902,SIPE SIPE,estado nutricional en menores de 5 anos,clasificacion a y b,2001-08-01,154,49,154,49,203
10403,SOPACHUY,estado nutricional en menores de 5 anos,clasificacion a y b,2001-08-01,5,38,5,38,43
20601,SORATA,estado nutricional en menores de 5 anos,clasificacion a y b,2001-08-01,3,12,3,12,15
10101,SUCRE,estado nutricional en menores de 5 anos,clasificacion a y b,2001-08-01,107,481,107,481,588
20603,TACACOMA,estado nutricional en menores de 5 anos,clasificacion a y b,2001-08-01,2,10,2,10,12
50303,TACOBAMBA,estado nutricional en menores de 5 anos,clasificacion a y b,2001-08-01,11,15,11,15,26
30602,TACOPAYA,estado nutricional en menores de 5 anos,clasificacion a y b,2001-08-01,1,3,1,3,4
51402,TAHUA,estado nutricional en menores de 5 anos,clasificacion a y b,2001-08-01,0,1,0,1,1
31101,TAPACARI,estado nutricional en menores de 5 anos,clasificacion a y b,2001-08-01,8,19,8,19,27
10601,TARABUCO,estado nutricional en menores de 5 anos,clasificacion a y b,2001-08-01,25,41,25,41,66
30401,TARATA,estado nutricional en menores de 5 anos,clasificacion a y b,2001-08-01,3,15,3,15,18
60101,TARIJA,estado nutricional en menores de 5 anos,clasificacion a y b,2001-08-01,108,345,108,345,453
10202,TARVITA,estado nutricional en menores de 5 anos,clasificacion a y b,2001-08-01,10,20,10,20,30
20803,TIAWANACU,estado nutricional en menores de 5 anos,clasificacion a y b,2001-08-01,16,12,16,12,28
50102,TINGUIPAYA,estado nutricional en menores de 5 anos,clasificacion a y b,2001-08-01,1,6,1,6,7
20606,TIPUANI,estado nutricional en menores de 5 anos,clasificacion a y b,2001-08-01,24,8,24,8,32
30903,TIQUIPAYA,estado nutricional en menores de 5 anos,clasificacion a y b,2001-08-01,22,2,22,2,24
31601,TIRAQUE (CBBA),estado nutricional en menores de 5 anos,clasificacion a y b,2001-08-01,68,32,68,32,100
30802,TOCO,estado nutricional en menores de 5 anos,clasificacion a y b,2001-08-01,4,9,4,9,13
41502,TODOS SANTOS,estado nutricional en menores de 5 anos,clasificacion a y b,2001-08-01,1,0,1,0,1
30803,TOLATA,estado nutricional en menores de 5 anos,clasificacion a y b,2001-08-01,0,9,0,9,9
41001,TOLEDO,estado nutricional en menores de 5 anos,clasificacion a y b,2001-08-01,12,7,12,7,19
51202,TOMAVE,estado nutricional en menores de 5 anos,clasificacion a y b,2001-08-01,8,22,8,22,30
10402,TOMINA,estado nutricional en menores de 5 anos,clasificacion a y b,2001-08-01,4,18,4,18,22
31201,TOTORA(CBBA),estado nutricional en menores de 5 anos,clasificacion a y b,2001-08-01,10,32,10,32,42
41301,TOTORA(ORR),estado nutricional en menores de 5 anos,clasificacion a y b,2001-08-01,1,1,1,1,2
70802,TRIGAL,estado nutricional en menores de 5 anos,clasificacion a y b,2001-08-01,5,3,5,3,8
80101,TRINIDAD,estado nutricional en menores de 5 anos,clasificacion a y b,2001-08-01,48,120,48,120,168
50801,TUPIZA,estado nutricional en menores de 5 anos,clasificacion a y b,2001-08-01,22,113,22,113,135
40402,TURCO,estado nutricional en menores de 5 anos,clasificacion a y b,2001-08-01,1,0,1,0,1
21302,UMALA,estado nutricional en menores de 5 anos,clasificacion a y b,2001-08-01,0,6,0,6,6
50201,UNCIA,estado nutricional en menores de 5 anos,clasificacion a y b,2001-08-01,3,1,3,1,4
60401,URIONDO (A. CONCEPCION),estado nutricional en menores de 5 anos,clasificacion a y b,2001-08-01,16,69,16,69,85
71502,URUBICHA,estado nutricional en menores de 5 anos,clasificacion a y b,2001-08-01,10,29,10,29,39
51201,UYUNI,estado nutricional en menores de 5 anos,clasificacion a y b,2001-08-01,18,60,18,60,78
30502,VACAS,estado nutricional en menores de 5 anos,clasificacion a y b,2001-08-01,1,6,1,6,7
70801,VALLEGRANDE,estado nutricional en menores de 5 anos,clasificacion a y b,2001-08-01,59,45,59,45,104
20801,VIACHA,estado nutricional en menores de 5 anos,clasificacion a y b,2001-08-01,19,73,19,73,92
31302,VILA VILA,estado nutricional en menores de 5 anos,clasificacion a y b,2001-08-01,19,11,19,11,30
60303,VILLA MONTES,estado nutricional en menores de 5 anos,clasificacion a y b,2001-08-01,39,19,39,19,58
90502,VILLA NUEVA (LOMA ALTA),estado nutricional en menores de 5 anos,clasificacion a y b,2001-08-01,0,1,0,1,1
31402,VILLA RIVERO,estado nutricional en menores de 5 anos,clasificacion a y b,2001-08-01,1,3,1,3,4
10801,VILLA SERRANO,estado nutricional en menores de 5 anos,clasificacion a y b,2001-08-01,11,79,11,79,90
31003,VILLA TUNARI,estado nutricional en menores de 5 anos,clasificacion a y b,2001-08-01,96,45,96,45,141
11001,VILLA VACA GUZMAN (MUYUPAMPA),estado nutricional en menores de 5 anos,clasificacion a y b,2001-08-01,23,63,23,63,86
51501,VILLAZON,estado nutricional en menores de 5 anos,clasificacion a y b,2001-08-01,12,96,12,96,108
30904,VINTO,estado nutricional en menores de 5 anos,clasificacion a y b,2001-08-01,32,4,32,4,36
50602,VITICHI,estado nutricional en menores de 5 anos,clasificacion a y b,2001-08-01,4,15,4,15,19
70201,WARNES,estado nutricional en menores de 5 anos,clasificacion a y b,2001-08-01,95,92,95,92,187
20903,YACO,estado nutricional en menores de 5 anos,clasificacion a y b,2001-08-01,1,1,1,1,2
60301,YACUIBA,estado nutricional en menores de 5 anos,clasificacion a y b,2001-08-01,192,28,192,28,220
10602,YAMPARAEZ,estado nutricional en menores de 5 anos,clasificacion a y b,2001-08-01,12,33,12,33,45
21103,YANACACHI,estado nutricional en menores de 5 anos,clasificacion a y b,2001-08-01,11,6,11,6,17
70403,YAPACANI,estado nutricional en menores de 5 anos,clasificacion a y b,2001-08-01,83,65,83,65,148
50103,YOCALLA,estado nutricional en menores de 5 anos,clasificacion a y b,2001-08-01,2,5,2,5,7
10102,YOTALA,estado nutricional en menores de 5 anos,clasificacion a y b,2001-08-01,8,36,8,36,44
60402,YUNCHARA,estado nutricional en menores de 5 anos,clasificacion a y b,2001-08-01,5,8,5,8,13
10301,ZUDAÃ‘EZ,estado nutricional en menores de 5 anos,clasificacion a y b,2001-08-01,6,19,6,19,25
51302,ACACIO,estado nutricional en menores de 5 anos,clasificacion a y b,2001-09-01,3,2,3,2,5
20201,ACHACACHI,estado nutricional en menores de 5 anos,clasificacion a y b,2001-09-01,31,95,31,95,126
30201,AIQUILE,estado nutricional en menores de 5 anos,clasificacion a y b,2001-09-01,12,19,12,19,31
10404,ALCALA,estado nutricional en menores de 5 anos,clasificacion a y b,2001-09-01,5,11,5,11,16
20202,ANCORAIMES,estado nutricional en menores de 5 anos,clasificacion a y b,2001-09-01,8,20,8,20,28
41201,ANDAMARCA,estado nutricional en menores de 5 anos,clasificacion a y b,2001-09-01,0,2,0,2,2
30402,ANZALDO,estado nutricional en menores de 5 anos,clasificacion a y b,2001-09-01,2,9,2,9,11
20701,APOLO,estado nutricional en menores de 5 anos,clasificacion a y b,2001-09-01,12,2,12,2,14
51301,ARAMPAMPA,estado nutricional en menores de 5 anos,clasificacion a y b,2001-09-01,1,6,1,6,7
30501,ARANI,estado nutricional en menores de 5 anos,clasificacion a y b,2001-09-01,5,16,5,16,21
30403,ARBIETO,estado nutricional en menores de 5 anos,clasificacion a y b,2001-09-01,2,10,2,10,12
30601,ARQUE,estado nutricional en menores de 5 anos,clasificacion a y b,2001-09-01,6,2,6,2,8
71501,ASCENCION DE GUARAYOS,estado nutricional en menores de 5 anos,clasificacion a y b,2001-09-01,2,9,2,9,11
50802,ATOCHA,estado nutricional en menores de 5 anos,clasificacion a y b,2001-09-01,2,12,2,12,14
20503,AUCAPATA,estado nutricional en menores de 5 anos,clasificacion a y b,2001-09-01,8,2,8,2,10
20502,AYATA,estado nutricional en menores de 5 anos,clasificacion a y b,2001-09-01,4,0,4,0,4
21303,AYO AYO,estado nutricional en menores de 5 anos,clasificacion a y b,2001-09-01,2,14,2,14,16
30301,AYOPAYA (V. DE INDEPENDENCIA),estado nutricional en menores de 5 anos,clasificacion a y b,2001-09-01,21,10,21,10,31
10201,AZURDUY,estado nutricional en menores de 5 anos,clasificacion a y b,2001-09-01,9,12,9,12,21
21203,BATALLAS,estado nutricional en menores de 5 anos,clasificacion a y b,2001-09-01,9,76,9,76,85
80802,BAURES,estado nutricional en menores de 5 anos,clasificacion a y b,2001-09-01,5,3,5,3,8
50104,BELEN DE URMIRI,estado nutricional en menores de 5 anos,clasificacion a y b,2001-09-01,0,8,0,8,8
90104,BELLA FLOR,estado nutricional en menores de 5 anos,clasificacion a y b,2001-09-01,4,2,4,2,6
60202,BERMEJO,estado nutricional en menores de 5 anos,clasificacion a y b,2001-09-01,19,31,19,31,50
50301,BETANZOS,estado nutricional en menores de 5 anos,clasificacion a y b,2001-09-01,29,47,29,47,76
31501,BOLIVAR,estado nutricional en menores de 5 anos,clasificacion a y b,2001-09-01,4,1,4,1,5
90103,BOLPEBRA,estado nutricional en menores de 5 anos,clasificacion a y b,2001-09-01,0,2,0,2,2
70707,BOYUIBE,estado nutricional en menores de 5 anos,clasificacion a y b,2001-09-01,4,9,4,9,13
70401,BUENA VISTA,estado nutricional en menores de 5 anos,clasificacion a y b,2001-09-01,56,37,56,37,93
70703,CABEZAS,estado nutricional en menores de 5 anos,clasificacion a y b,2001-09-01,11,30,11,30,41
20905,CAIROMA,estado nutricional en menores de 5 anos,clasificacion a y b,2001-09-01,2,9,2,9,11
51102,"CAIZA ""D""",estado nutricional en menores de 5 anos,clasificacion a y b,2001-09-01,10,20,10,20,30
21003,CAJUATA,estado nutricional en menores de 5 anos,clasificacion a y b,2001-09-01,4,0,4,0,4
20303,CALACOTO,estado nutricional en menores de 5 anos,clasificacion a y b,2001-09-01,2,10,2,10,12
21304,CALAMARCA,estado nutricional en menores de 5 anos,clasificacion a y b,2001-09-01,5,8,5,8,13
10701,CAMARGO,estado nutricional en menores de 5 anos,clasificacion a y b,2001-09-01,6,21,6,21,27
10901,CAMATAQUI (C. VILLA ABECIA),estado nutricional en menores de 5 anos,clasificacion a y b,2001-09-01,1,26,1,26,27
70706,CAMIRI,estado nutricional en menores de 5 anos,clasificacion a y b,2001-09-01,85,52,85,52,137
30701,CAPINOTA,estado nutricional en menores de 5 anos,clasificacion a y b,2001-09-01,49,2,49,2,51
20302,CAQUIAVIRI,estado nutricional en menores de 5 anos,clasificacion a y b,2001-09-01,2,14,2,14,16
40102,CARACOLLO,estado nutricional en menores de 5 anos,clasificacion a y b,2001-09-01,16,9,16,9,25
22001,CARANAVI,estado nutricional en menores de 5 anos,clasificacion a y b,2001-09-01,102,96,102,96,198
60302,CARAPARI,estado nutricional en menores de 5 anos,clasificacion a y b,2001-09-01,1,14,1,14,15
50702,CARIPUYO,estado nutricional en menores de 5 anos,clasificacion a y b,2001-09-01,1,8,1,8,9
21902,CATACORA,estado nutricional en menores de 5 anos,clasificacion a y b,2001-09-01,0,1,0,1,1
40201,CHALLAPATA,estado nutricional en menores de 5 anos,clasificacion a y b,2001-09-01,18,6,18,6,24
50302,CHAQUI,estado nutricional en menores de 5 anos,clasificacion a y b,2001-09-01,2,14,2,14,16
70702,CHARAGUA,estado nutricional en menores de 5 anos,clasificacion a y b,2001-09-01,19,94,19,94,113
50202,CHAYANTA,estado nutricional en menores de 5 anos,clasificacion a y b,2001-09-01,0,4,0,4,4
31204,CHIMORE,estado nutricional en menores de 5 anos,clasificacion a y b,2001-09-01,14,31,14,31,45
21101,CHULUMANI (V. DE LA LIBERTAD),estado nutricional en menores de 5 anos,clasificacion a y b,2001-09-01,3,28,3,28,31
20501,CHUMA,estado nutricional en menores de 5 anos,clasificacion a y b,2001-09-01,5,1,5,1,6
30801,CLIZA,estado nutricional en menores de 5 anos,clasificacion a y b,2001-09-01,4,0,4,0,4
90101,COBIJA,estado nutricional en menores de 5 anos,clasificacion a y b,2001-09-01,78,18,78,18,96
30101,COCHABAMBA,estado nutricional en menores de 5 anos,clasificacion a y b,2001-09-01,1096,996,1096,996,2092
30905,COLCAPIRHUA,estado nutricional en menores de 5 anos,clasificacion a y b,2001-09-01,117,18,117,18,135
50901,"COLCHA ""K""",estado nutricional en menores de 5 anos,clasificacion a y b,2001-09-01,0,7,0,7,7
21307,COLLANA,estado nutricional en menores de 5 anos,clasificacion a y b,2001-09-01,4,0,4,0,4
31002,COLOMI,estado nutricional en menores de 5 anos,clasificacion a y b,2001-09-01,24,10,24,10,34
70603,COLPA BELGICA,estado nutricional en menores de 5 anos,clasificacion a y b,2001-09-01,33,4,33,4,37
50401,COLQUECHACA,estado nutricional en menores de 5 anos,clasificacion a y b,2001-09-01,10,47,10,47,57
21306,COLQUENCHA,estado nutricional en menores de 5 anos,clasificacion a y b,2001-09-01,6,2,6,2,8
21004,COLQUIRI,estado nutricional en menores de 5 anos,clasificacion a y b,2001-09-01,25,3,25,3,28
20304,COMANCHE,estado nutricional en menores de 5 anos,clasificacion a y b,2001-09-01,0,6,0,6,6
71301,COMARAPA,estado nutricional en menores de 5 anos,clasificacion a y b,2001-09-01,13,15,13,15,28
20605,COMBAYA,estado nutricional en menores de 5 anos,clasificacion a y b,2001-09-01,1,3,1,3,4
71101,CONCEPCION,estado nutricional en menores de 5 anos,clasificacion a y b,2001-09-01,24,15,24,15,39
21701,COPACABANA,estado nutricional en menores de 5 anos,clasificacion a y b,2001-09-01,7,11,7,11,18
21402,CORIPATA,estado nutricional en menores de 5 anos,clasificacion a y b,2001-09-01,3,35,3,35,38
20301,CORO CORO,estado nutricional en menores de 5 anos,clasificacion a y b,2001-09-01,4,5,4,5,9
21401,COROICO,estado nutricional en menores de 5 anos,clasificacion a y b,2001-09-01,17,2,17,2,19
40301,CORQUE,estado nutricional en menores de 5 anos,clasificacion a y b,2001-09-01,1,2,1,2,3
50601,COTAGAITA,estado nutricional en menores de 5 anos,clasificacion a y b,2001-09-01,10,20,10,20,30
70102,COTOCA,estado nutricional en menores de 5 anos,clasificacion a y b,2001-09-01,36,111,36,111,147
31405,CUCHUMUELA (V. G. VILLARROEL),estado nutricional en menores de 5 anos,clasificacion a y b,2001-09-01,3,0,3,0,3
70704,CUEVO,estado nutricional en menores de 5 anos,clasificacion a y b,2001-09-01,17,12,17,12,29
10902,CULPINA,estado nutricional en menores de 5 anos,clasificacion a y b,2001-09-01,13,36,13,36,49
21602,CURVA,estado nutricional en menores de 5 anos,clasificacion a y b,2001-09-01,3,2,3,2,5
20804,DESAGUADERO,estado nutricional en menores de 5 anos,clasificacion a y b,2001-09-01,2,4,2,4,6
20105,EL ALTO,estado nutricional en menores de 5 anos,clasificacion a y b,2001-09-01,437,451,437,451,888
40103,EL CHORO,estado nutricional en menores de 5 anos,clasificacion a y b,2001-09-01,0,4,0,4,4
71503,EL PUENTE(STC),estado nutricional en menores de 5 anos,clasificacion a y b,2001-09-01,22,59,22,59,81
60502,EL PUENTE(TJA),estado nutricional en menores de 5 anos,clasificacion a y b,2001-09-01,6,0,6,0,6
70105,EL TORNO,estado nutricional en menores de 5 anos,clasificacion a y b,2001-09-01,28,93,28,93,121
10405,EL VILLAR,estado nutricional en menores de 5 anos,clasificacion a y b,2001-09-01,4,60,4,60,64
60601,ENTRE RIOS,estado nutricional en menores de 5 anos,clasificacion a y b,2001-09-01,22,43,22,43,65
41101,EUCALIPTUS,estado nutricional en menores de 5 anos,clasificacion a y b,2001-09-01,2,22,2,22,24
80402,EXALTACION,estado nutricional en menores de 5 anos,clasificacion a y b,2001-09-01,1,4,1,4,5
90203,FILADELFIA,estado nutricional en menores de 5 anos,clasificacion a y b,2001-09-01,3,2,3,2,5
71002,GENERAL SAAVEDRA,estado nutricional en menores de 5 anos,clasificacion a y b,2001-09-01,7,78,7,78,85
21601,GRAL. J.J. PEREZ (CHARAZANI),estado nutricional en menores de 5 anos,clasificacion a y b,2001-09-01,4,0,4,0,4
20602,GUANAY,estado nutricional en menores de 5 anos,clasificacion a y b,2001-09-01,21,50,21,50,71
20802,GUAQUI,estado nutricional en menores de 5 anos,clasificacion a y b,2001-09-01,1,7,1,7,8
80202,GUAYARAMERIN,estado nutricional en menores de 5 anos,clasificacion a y b,2001-09-01,52,38,52,38,90
70705,GUTIERREZ,estado nutricional en menores de 5 anos,clasificacion a y b,2001-09-01,22,56,22,56,78
10502,HUACARETA,estado nutricional en menores de 5 anos,clasificacion a y b,2001-09-01,9,47,9,47,56
40501,HUACHACALLA,estado nutricional en menores de 5 anos,clasificacion a y b,2001-09-01,5,2,5,2,7
40701,HUANUNI,estado nutricional en menores de 5 anos,clasificacion a y b,2001-09-01,7,4,7,4,11
80803,HUARACAJE,estado nutricional en menores de 5 anos,clasificacion a y b,2001-09-01,8,6,8,6,14
10304,ICLA,estado nutricional en menores de 5 anos,clasificacion a y b,2001-09-01,19,20,19,20,39
10703,INCAHUASI,estado nutricional en menores de 5 anos,clasificacion a y b,2001-09-01,9,22,9,22,31
21001,INQUISIVI,estado nutricional en menores de 5 anos,clasificacion a y b,2001-09-01,2,15,2,15,17
21102,IRUPANA (VILLA DE LANZA),estado nutricional en menores de 5 anos,clasificacion a y b,2001-09-01,32,20,32,20,52
21501,IXIAMAS,estado nutricional en menores de 5 anos,clasificacion a y b,2001-09-01,27,10,27,10,37
21105,LA ASUNTA,estado nutricional en menores de 5 anos,clasificacion a y b,2001-09-01,26,33,26,33,59
70104,LA GUARDIA,estado nutricional en menores de 5 anos,clasificacion a y b,2001-09-01,32,152,32,152,184
20101,LA PAZ,estado nutricional en menores de 5 anos,clasificacion a y b,2001-09-01,364,409,364,409,773
70701,LAGUNILLAS,estado nutricional en menores de 5 anos,clasificacion a y b,2001-09-01,18,23,18,23,41
21202,LAJA,estado nutricional en menores de 5 anos,clasificacion a y b,2001-09-01,6,37,6,37,43
10903,LAS CARRERAS,estado nutricional en menores de 5 anos,clasificacion a y b,2001-09-01,2,9,2,9,11
50203,LLALLAGUA,estado nutricional en menores de 5 anos,clasificacion a y b,2001-09-01,7,31,7,31,38
51401,LLICA,estado nutricional en menores de 5 anos,clasificacion a y b,2001-09-01,3,5,3,5,8
80601,LORETO,estado nutricional en menores de 5 anos,clasificacion a y b,2001-09-01,5,16,5,16,21
20901,LURIBAY,estado nutricional en menores de 5 anos,clasificacion a y b,2001-09-01,4,11,4,11,15
40702,MACHACAMARCA,estado nutricional en menores de 5 anos,clasificacion a y b,2001-09-01,12,2,12,2,14
11003,MACHARETI,estado nutricional en menores de 5 anos,clasificacion a y b,2001-09-01,13,57,13,57,70
80801,MAGDALENA,estado nutricional en menores de 5 anos,clasificacion a y b,2001-09-01,8,16,8,16,24
70903,MAIRANA,estado nutricional en menores de 5 anos,clasificacion a y b,2001-09-01,27,11,27,11,38
20103,MECAPACA,estado nutricional en menores de 5 anos,clasificacion a y b,2001-09-01,5,14,5,14,19
71003,MINEROS,estado nutricional en menores de 5 anos,clasificacion a y b,2001-09-01,28,134,28,134,162
31301,MIZQUE,estado nutricional en menores de 5 anos,clasificacion a y b,2001-09-01,7,15,7,15,22
20402,MOCOMOCO,estado nutricional en menores de 5 anos,clasificacion a y b,2001-09-01,10,15,10,15,25
51002,MOJINETE,estado nutricional en menores de 5 anos,clasificacion a y b,2001-09-01,0,1,0,1,1
10303,MOJOCOYA,estado nutricional en menores de 5 anos,clasificacion a y b,2001-09-01,5,38,5,38,43
10501,MONTEAGUDO,estado nutricional en menores de 5 anos,clasificacion a y b,2001-09-01,34,138,34,138,172
71001,MONTERO,estado nutricional en menores de 5 anos,clasificacion a y b,2001-09-01,121,499,121,499,620
70803,MORO MORO,estado nutricional en menores de 5 anos,clasificacion a y b,2001-09-01,18,3,18,3,21
30302,MOROCHATA,estado nutricional en menores de 5 anos,clasificacion a y b,2001-09-01,24,4,24,4,28
90401,NACEBE (SANTA ROSA DEL ABUNA),estado nutricional en menores de 5 anos,clasificacion a y b,2001-09-01,0,10,0,10,10
50404,OCURI,estado nutricional en menores de 5 anos,clasificacion a y b,2001-09-01,5,5,5,5,10
70202,OKINAWA,estado nutricional en menores de 5 anos,clasificacion a y b,2001-09-01,3,7,3,7,10
30203,OMEREQUE,estado nutricional en menores de 5 anos,clasificacion a y b,2001-09-01,0,11,0,11,11
40101,ORURO,estado nutricional en menores de 5 anos,clasificacion a y b,2001-09-01,86,280,86,280,366
60201,PADCAYA,estado nutricional en menores de 5 anos,clasificacion a y b,2001-09-01,14,29,14,29,43
10401,PADILLA,estado nutricional en menores de 5 anos,clasificacion a y b,2001-09-01,8,40,8,40,48
70502,PAILON,estado nutricional en menores de 5 anos,clasificacion a y b,2001-09-01,9,62,9,62,71
20102,PALCA,estado nutricional en menores de 5 anos,clasificacion a y b,2001-09-01,10,3,10,3,13
21104,PALOS BLANCOS,estado nutricional en menores de 5 anos,clasificacion a y b,2001-09-01,47,19,47,19,66
40802,PAMPA AULLAGAS,estado nutricional en menores de 5 anos,clasificacion a y b,2001-09-01,4,0,4,0,4
70902,PAMPA GRANDE,estado nutricional en menores de 5 anos,clasificacion a y b,2001-09-01,11,3,11,3,14
21802,PAPEL PAMPA,estado nutricional en menores de 5 anos,clasificacion a y b,2001-09-01,1,3,1,3,4
30202,PASORAPA,estado nutricional en menores de 5 anos,clasificacion a y b,2001-09-01,3,8,3,8,11
21305,PATACAMAYA,estado nutricional en menores de 5 anos,clasificacion a y b,2001-09-01,18,5,18,5,23
40602,PAZÃ‘A,estado nutricional en menores de 5 anos,clasificacion a y b,2001-09-01,0,4,0,4,4
20702,PELECHUCO,estado nutricional en menores de 5 anos,clasificacion a y b,2001-09-01,3,0,3,0,3
50403,POCOATA,estado nutricional en menores de 5 anos,clasificacion a y b,2001-09-01,17,12,17,12,29
31203,POCONA,estado nutricional en menores de 5 anos,clasificacion a y b,2001-09-01,17,13,17,13,30
31202,POJO (CBBA),estado nutricional en menores de 5 anos,clasificacion a y b,2001-09-01,87,80,87,80,167
40601,POOPO,estado nutricional en menores de 5 anos,clasificacion a y b,2001-09-01,1,5,1,5,6
51203,PORCO,estado nutricional en menores de 5 anos,clasificacion a y b,2001-09-01,5,8,5,8,13
10103,POROMA,estado nutricional en menores de 5 anos,clasificacion a y b,2001-09-01,9,9,9,9,18
70103,PORONGO,estado nutricional en menores de 5 anos,clasificacion a y b,2001-09-01,3,36,3,36,39
70601,PORTACHUELO,estado nutricional en menores de 5 anos,clasificacion a y b,2001-09-01,29,31,29,31,60
90102,PORVENIR,estado nutricional en menores de 5 anos,clasificacion a y b,2001-09-01,3,6,3,6,9
70804,POSTRER VALLE,estado nutricional en menores de 5 anos,clasificacion a y b,2001-09-01,2,1,2,1,3
50101,POTOSI,estado nutricional en menores de 5 anos,clasificacion a y b,2001-09-01,38,94,38,94,132
10302,PRESTO,estado nutricional en menores de 5 anos,clasificacion a y b,2001-09-01,2,11,2,11,13
21201,PUCARANI,estado nutricional en menores de 5 anos,clasificacion a y b,2001-09-01,10,25,10,25,35
20403,PUERTO CARABUCO,estado nutricional en menores de 5 anos,clasificacion a y b,2001-09-01,27,6,27,6,33
90301,PUERTO GONZALO MORENO,estado nutricional en menores de 5 anos,clasificacion a y b,2001-09-01,1,12,1,12,13
21204,PUERTO PEREZ,estado nutricional en menores de 5 anos,clasificacion a y b,2001-09-01,3,10,3,10,13
71402,PUERTO QUIJARRO,estado nutricional en menores de 5 anos,clasificacion a y b,2001-09-01,46,4,46,4,50
90201,PUERTO RICO,estado nutricional en menores de 5 anos,clasificacion a y b,2001-09-01,2,19,2,19,21
80703,PUERTO SILES,estado nutricional en menores de 5 anos,clasificacion a y b,2001-09-01,1,0,1,0,1
71401,PUERTO SUAREZ,estado nutricional en menores de 5 anos,clasificacion a y b,2001-09-01,60,10,60,10,70
31205,PUERTO VILLARROEL,estado nutricional en menores de 5 anos,clasificacion a y b,2001-09-01,106,37,106,37,143
51101,PUNA,estado nutricional en menores de 5 anos,clasificacion a y b,2001-09-01,30,59,30,59,89
31401,PUNATA,estado nutricional en menores de 5 anos,clasificacion a y b,2001-09-01,1,24,1,24,25
20604,QUIABAYA,estado nutricional en menores de 5 anos,clasificacion a y b,2001-09-01,4,2,4,2,6
30901,QUILLACOLLO,estado nutricional en menores de 5 anos,clasificacion a y b,2001-09-01,15,19,15,19,34
21002,QUIME,estado nutricional en menores de 5 anos,clasificacion a y b,2001-09-01,1,13,1,13,14
70904,QUIRUSILLAS,estado nutricional en menores de 5 anos,clasificacion a y b,2001-09-01,1,9,1,9,10
50402,RAVELO,estado nutricional en menores de 5 anos,clasificacion a y b,2001-09-01,3,27,3,27,30
80301,REYES,estado nutricional en menores de 5 anos,clasificacion a y b,2001-09-01,9,39,9,39,48
80201,RIBERALTA,estado nutricional en menores de 5 anos,clasificacion a y b,2001-09-01,66,144,66,144,210
70503,ROBORE,estado nutricional en menores de 5 anos,clasificacion a y b,2001-09-01,20,56,20,56,76
80304,RURRENABAQUE,estado nutricional en menores de 5 anos,clasificacion a y b,2001-09-01,60,48,60,48,108
40901,SABAYA,estado nutricional en menores de 5 anos,clasificacion a y b,2001-09-01,1,1,1,1,2
31001,SACABA,estado nutricional en menores de 5 anos,clasificacion a y b,2001-09-01,63,18,63,18,81
30404,SACABAMBA,estado nutricional en menores de 5 anos,clasificacion a y b,2001-09-01,1,3,1,3,4
50701,SACACA,estado nutricional en menores de 5 anos,clasificacion a y b,2001-09-01,0,9,0,9,9
71302,SAIPINA,estado nutricional en menores de 5 anos,clasificacion a y b,2001-09-01,40,14,40,14,54
40801,SALINAS DE GARCI MENDOZA,estado nutricional en menores de 5 anos,clasificacion a y b,2001-09-01,2,1,2,1,3
70901,SAMAIPATA,estado nutricional en menores de 5 anos,clasificacion a y b,2001-09-01,4,19,4,19,23
51601,SAN AGUSTIN,estado nutricional en menores de 5 anos,clasificacion a y b,2001-09-01,0,2,0,2,2
80602,SAN ANDRES,estado nutricional en menores de 5 anos,clasificacion a y b,2001-09-01,0,14,0,14,14
51003,SAN ANTONIO DE ESMORUCO,estado nutricional en menores de 5 anos,clasificacion a y b,2001-09-01,0,2,0,2,2
71105,SAN ANTONIO DE LOMERIO,estado nutricional en menores de 5 anos,clasificacion a y b,2001-09-01,11,5,11,5,16
31403,SAN BENITO,estado nutricional en menores de 5 anos,clasificacion a y b,2001-09-01,3,1,3,1,4
80302,SAN BORJA,estado nutricional en menores de 5 anos,clasificacion a y b,2001-09-01,86,23,86,23,109
21502,SAN BUENA VENTURA,estado nutricional en menores de 5 anos,clasificacion a y b,2001-09-01,7,57,7,57,64
70402,SAN CARLOS,estado nutricional en menores de 5 anos,clasificacion a y b,2001-09-01,32,56,32,56,88
80501,SAN IGNACIO,estado nutricional en menores de 5 anos,clasificacion a y b,2001-09-01,21,35,21,35,56
70301,SAN IGNACIO DE VELASCO,estado nutricional en menores de 5 anos,clasificacion a y b,2001-09-01,149,80,149,80,229
80102,SAN JAVIER(BNI),estado nutricional en menores de 5 anos,clasificacion a y b,2001-09-01,2,13,2,13,15
71102,SAN JAVIER(STC),estado nutricional en menores de 5 anos,clasificacion a y b,2001-09-01,22,83,22,83,105
80701,SAN JOAQUIN,estado nutricional en menores de 5 anos,clasificacion a y b,2001-09-01,2,10,2,10,12
70501,SAN JOSE DE CHIQUITOS,estado nutricional en menores de 5 anos,clasificacion a y b,2001-09-01,20,19,20,19,39
71104,SAN JULIAN,estado nutricional en menores de 5 anos,clasificacion a y b,2001-09-01,74,80,74,80,154
90302,SAN LORENZO(PND),estado nutricional en menores de 5 anos,clasificacion a y b,2001-09-01,0,5,0,5,5
60501,SAN LORENZO(TJA),estado nutricional en menores de 5 anos,clasificacion a y b,2001-09-01,4,7,4,7,11
10702,SAN LUCAS,estado nutricional en menores de 5 anos,clasificacion a y b,2001-09-01,15,45,15,45,60
71201,SAN MATIAS,estado nutricional en menores de 5 anos,clasificacion a y b,2001-09-01,30,15,30,15,45
70302,SAN MIGUEL DE VELASCO,estado nutricional en menores de 5 anos,clasificacion a y b,2001-09-01,8,19,8,19,27
51001,SAN PABLO DE LIPEZ,estado nutricional en menores de 5 anos,clasificacion a y b,2001-09-01,3,3,3,3,6
50501,SAN PEDRO DE BUENA VISTA,estado nutricional en menores de 5 anos,clasificacion a y b,2001-09-01,0,15,0,15,15
21801,SAN PEDRO DE CURAHUARA,estado nutricional en menores de 5 anos,clasificacion a y b,2001-09-01,2,2,2,2,4
21702,SAN PEDRO DE TIQUINA,estado nutricional en menores de 5 anos,clasificacion a y b,2001-09-01,4,28,4,28,32
90202,SAN PEDRO(PND),estado nutricional en menores de 5 anos,clasificacion a y b,2001-09-01,0,1,0,1,1
70303,SAN RAFAEL,estado nutricional en menores de 5 anos,clasificacion a y b,2001-09-01,20,4,20,4,24
80702,SAN RAMON,estado nutricional en menores de 5 anos,clasificacion a y b,2001-09-01,2,8,2,8,10
80702,SAN RAMON,estado nutricional en menores de 5 anos,clasificacion a y b,2001-09-01,63,27,63,27,90
80401,SANTA ANA,estado nutricional en menores de 5 anos,clasificacion a y b,2001-09-01,5,14,5,14,19
70101,SANTA CRUZ DE LA SIERRA,estado nutricional en menores de 5 anos,clasificacion a y b,2001-09-01,800,674,800,674,1474
80303,SANTA ROSA,estado nutricional en menores de 5 anos,clasificacion a y b,2001-09-01,10,1,10,1,11
70602,SANTA ROSA DEL SARA,estado nutricional en menores de 5 anos,clasificacion a y b,2001-09-01,18,17,18,17,35
20308,SANTIAGO DE CALLAPA,estado nutricional en menores de 5 anos,clasificacion a y b,2001-09-01,1,1,1,1,2
41401,SANTIAGO DE HUARI,estado nutricional en menores de 5 anos,clasificacion a y b,2001-09-01,8,3,8,3,11
21901,SANTIAGO DE MACHACA,estado nutricional en menores de 5 anos,clasificacion a y b,2001-09-01,1,4,1,4,5
30702,SANTIVAÃ‘ES,estado nutricional en menores de 5 anos,clasificacion a y b,2001-09-01,6,0,6,0,6
40202,SANTUARIO DE QUILLACAS,estado nutricional en menores de 5 anos,clasificacion a y b,2001-09-01,3,1,3,1,4
20902,SAPAHAQUI,estado nutricional en menores de 5 anos,clasificacion a y b,2001-09-01,3,5,3,5,8
90303,SENA,estado nutricional en menores de 5 anos,clasificacion a y b,2001-09-01,0,3,0,3,3
21301,SICA SICA (VILLA AROMA),estado nutricional en menores de 5 anos,clasificacion a y b,2001-09-01,20,8,20,8,28
30703,SICAYA,estado nutricional en menores de 5 anos,clasificacion a y b,2001-09-01,4,2,4,2,6
30902,SIPE SIPE,estado nutricional en menores de 5 anos,clasificacion a y b,2001-09-01,99,15,99,15,114
10403,SOPACHUY,estado nutricional en menores de 5 anos,clasificacion a y b,2001-09-01,5,6,5,6,11
20601,SORATA,estado nutricional en menores de 5 anos,clasificacion a y b,2001-09-01,1,16,1,16,17
10101,SUCRE,estado nutricional en menores de 5 anos,clasificacion a y b,2001-09-01,81,283,81,283,364
20603,TACACOMA,estado nutricional en menores de 5 anos,clasificacion a y b,2001-09-01,0,2,0,2,2
50303,TACOBAMBA,estado nutricional en menores de 5 anos,clasificacion a y b,2001-09-01,13,11,13,11,24
30602,TACOPAYA,estado nutricional en menores de 5 anos,clasificacion a y b,2001-09-01,3,2,3,2,5
51402,TAHUA,estado nutricional en menores de 5 anos,clasificacion a y b,2001-09-01,0,2,0,2,2
31101,TAPACARI,estado nutricional en menores de 5 anos,clasificacion a y b,2001-09-01,10,17,10,17,27
10601,TARABUCO,estado nutricional en menores de 5 anos,clasificacion a y b,2001-09-01,16,44,16,44,60
30401,TARATA,estado nutricional en menores de 5 anos,clasificacion a y b,2001-09-01,2,12,2,12,14
60101,TARIJA,estado nutricional en menores de 5 anos,clasificacion a y b,2001-09-01,96,234,96,234,330
10202,TARVITA,estado nutricional en menores de 5 anos,clasificacion a y b,2001-09-01,11,13,11,13,24
20803,TIAWANACU,estado nutricional en menores de 5 anos,clasificacion a y b,2001-09-01,13,3,13,3,16
50102,TINGUIPAYA,estado nutricional en menores de 5 anos,clasificacion a y b,2001-09-01,10,9,10,9,19
20606,TIPUANI,estado nutricional en menores de 5 anos,clasificacion a y b,2001-09-01,10,3,10,3,13
30903,TIQUIPAYA,estado nutricional en menores de 5 anos,clasificacion a y b,2001-09-01,3,8,3,8,11
31601,TIRAQUE (CBBA),estado nutricional en menores de 5 anos,clasificacion a y b,2001-09-01,64,33,64,33,97
21703,TITO YUPANQUI (PARQUIPUJIO),estado nutricional en menores de 5 anos,clasificacion a y b,2001-09-01,0,2,0,2,2
30802,TOCO,estado nutricional en menores de 5 anos,clasificacion a y b,2001-09-01,0,4,0,4,4
30803,TOLATA,estado nutricional en menores de 5 anos,clasificacion a y b,2001-09-01,0,1,0,1,1
41001,TOLEDO,estado nutricional en menores de 5 anos,clasificacion a y b,2001-09-01,7,4,7,4,11
51202,TOMAVE,estado nutricional en menores de 5 anos,clasificacion a y b,2001-09-01,8,21,8,21,29
10402,TOMINA,estado nutricional en menores de 5 anos,clasificacion a y b,2001-09-01,9,18,9,18,27
50502,TORO TORO,estado nutricional en menores de 5 anos,clasificacion a y b,2001-09-01,0,2,0,2,2
31201,TOTORA(CBBA),estado nutricional en menores de 5 anos,clasificacion a y b,2001-09-01,7,15,7,15,22
41301,TOTORA(ORR),estado nutricional en menores de 5 anos,clasificacion a y b,2001-09-01,1,4,1,4,5
70802,TRIGAL,estado nutricional en menores de 5 anos,clasificacion a y b,2001-09-01,5,1,5,1,6
80101,TRINIDAD,estado nutricional en menores de 5 anos,clasificacion a y b,2001-09-01,58,135,58,135,193
50801,TUPIZA,estado nutricional en menores de 5 anos,clasificacion a y b,2001-09-01,10,67,10,67,77
40402,TURCO,estado nutricional en menores de 5 anos,clasificacion a y b,2001-09-01,1,0,1,0,1
21302,UMALA,estado nutricional en menores de 5 anos,clasificacion a y b,2001-09-01,3,4,3,4,7
50201,UNCIA,estado nutricional en menores de 5 anos,clasificacion a y b,2001-09-01,7,55,7,55,62
60401,URIONDO (A. CONCEPCION),estado nutricional en menores de 5 anos,clasificacion a y b,2001-09-01,11,47,11,47,58
71502,URUBICHA,estado nutricional en menores de 5 anos,clasificacion a y b,2001-09-01,5,20,5,20,25
51201,UYUNI,estado nutricional en menores de 5 anos,clasificacion a y b,2001-09-01,9,57,9,57,66
30502,VACAS,estado nutricional en menores de 5 anos,clasificacion a y b,2001-09-01,1,0,1,0,1
70801,VALLEGRANDE,estado nutricional en menores de 5 anos,clasificacion a y b,2001-09-01,21,45,21,45,66
20801,VIACHA,estado nutricional en menores de 5 anos,clasificacion a y b,2001-09-01,16,58,16,58,74
31302,VILA VILA,estado nutricional en menores de 5 anos,clasificacion a y b,2001-09-01,11,4,11,4,15
60303,VILLA MONTES,estado nutricional en menores de 5 anos,clasificacion a y b,2001-09-01,18,9,18,9,27
31402,VILLA RIVERO,estado nutricional en menores de 5 anos,clasificacion a y b,2001-09-01,1,2,1,2,3
10801,VILLA SERRANO,estado nutricional en menores de 5 anos,clasificacion a y b,2001-09-01,9,49,9,49,58
31003,VILLA TUNARI,estado nutricional en menores de 5 anos,clasificacion a y b,2001-09-01,102,37,102,37,139
11001,VILLA VACA GUZMAN (MUYUPAMPA),estado nutricional en menores de 5 anos,clasificacion a y b,2001-09-01,15,51,15,51,66
51501,VILLAZON,estado nutricional en menores de 5 anos,clasificacion a y b,2001-09-01,12,66,12,66,78
50602,VITICHI,estado nutricional en menores de 5 anos,clasificacion a y b,2001-09-01,6,9,6,9,15
70201,WARNES,estado nutricional en menores de 5 anos,clasificacion a y b,2001-09-01,104,34,104,34,138
20903,YACO,estado nutricional en menores de 5 anos,clasificacion a y b,2001-09-01,4,15,4,15,19
60301,YACUIBA,estado nutricional en menores de 5 anos,clasificacion a y b,2001-09-01,156,14,156,14,170
10602,YAMPARAEZ,estado nutricional en menores de 5 anos,clasificacion a y b,2001-09-01,7,34,7,34,41
21103,YANACACHI,estado nutricional en menores de 5 anos,clasificacion a y b,2001-09-01,5,10,5,10,15
70403,YAPACANI,estado nutricional en menores de 5 anos,clasificacion a y b,2001-09-01,92,55,92,55,147
50103,YOCALLA,estado nutricional en menores de 5 anos,clasificacion a y b,2001-09-01,2,8,2,8,10
10102,YOTALA,estado nutricional en menores de 5 anos,clasificacion a y b,2001-09-01,10,36,10,36,46
60402,YUNCHARA,estado nutricional en menores de 5 anos,clasificacion a y b,2001-09-01,7,3,7,3,10
10301,ZUDAÃ‘EZ,estado nutricional en menores de 5 anos,clasificacion a y b,2001-09-01,5,19,5,19,24
51302,ACACIO,estado nutricional en menores de 5 anos,clasificacion a y b,2001-10-01,4,4,4,4,8
20201,ACHACACHI,estado nutricional en menores de 5 anos,clasificacion a y b,2001-10-01,26,48,26,48,74
20104,ACHOCALLA,estado nutricional en menores de 5 anos,clasificacion a y b,2001-10-01,22,0,22,0,22
30201,AIQUILE,estado nutricional en menores de 5 anos,clasificacion a y b,2001-10-01,24,29,24,29,53
31303,ALALAY,estado nutricional en menores de 5 anos,clasificacion a y b,2001-10-01,0,7,0,7,7
10404,ALCALA,estado nutricional en menores de 5 anos,clasificacion a y b,2001-10-01,12,11,12,11,23
20202,ANCORAIMES,estado nutricional en menores de 5 anos,clasificacion a y b,2001-10-01,7,25,7,25,32
41201,ANDAMARCA,estado nutricional en menores de 5 anos,clasificacion a y b,2001-10-01,2,0,2,0,2
30402,ANZALDO,estado nutricional en menores de 5 anos,clasificacion a y b,2001-10-01,1,2,1,2,3
20701,APOLO,estado nutricional en menores de 5 anos,clasificacion a y b,2001-10-01,14,1,14,1,15
51301,ARAMPAMPA,estado nutricional en menores de 5 anos,clasificacion a y b,2001-10-01,3,11,3,11,14
30501,ARANI,estado nutricional en menores de 5 anos,clasificacion a y b,2001-10-01,5,7,5,7,12
30403,ARBIETO,estado nutricional en menores de 5 anos,clasificacion a y b,2001-10-01,4,12,4,12,16
30601,ARQUE,estado nutricional en menores de 5 anos,clasificacion a y b,2001-10-01,7,0,7,0,7
71501,ASCENCION DE GUARAYOS,estado nutricional en menores de 5 anos,clasificacion a y b,2001-10-01,89,40,89,40,129
50802,ATOCHA,estado nutricional en menores de 5 anos,clasificacion a y b,2001-10-01,4,19,4,19,23
20503,AUCAPATA,estado nutricional en menores de 5 anos,clasificacion a y b,2001-10-01,1,0,1,0,1
20502,AYATA,estado nutricional en menores de 5 anos,clasificacion a y b,2001-10-01,6,0,6,0,6
21303,AYO AYO,estado nutricional en menores de 5 anos,clasificacion a y b,2001-10-01,19,9,19,9,28
30301,AYOPAYA (V. DE INDEPENDENCIA),estado nutricional en menores de 5 anos,clasificacion a y b,2001-10-01,42,7,42,7,49
10201,AZURDUY,estado nutricional en menores de 5 anos,clasificacion a y b,2001-10-01,16,20,16,20,36
21203,BATALLAS,estado nutricional en menores de 5 anos,clasificacion a y b,2001-10-01,10,54,10,54,64
80802,BAURES,estado nutricional en menores de 5 anos,clasificacion a y b,2001-10-01,9,2,9,2,11
41202,BELEN DE ANDAMARCA,estado nutricional en menores de 5 anos,clasificacion a y b,2001-10-01,0,1,0,1,1
50104,BELEN DE URMIRI,estado nutricional en menores de 5 anos,clasificacion a y b,2001-10-01,2,8,2,8,10
90104,BELLA FLOR,estado nutricional en menores de 5 anos,clasificacion a y b,2001-10-01,7,8,7,8,15
60202,BERMEJO,estado nutricional en menores de 5 anos,clasificacion a y b,2001-10-01,22,39,22,39,61
50301,BETANZOS,estado nutricional en menores de 5 anos,clasificacion a y b,2001-10-01,14,18,14,18,32
31501,BOLIVAR,estado nutricional en menores de 5 anos,clasificacion a y b,2001-10-01,4,0,4,0,4
90103,BOLPEBRA,estado nutricional en menores de 5 anos,clasificacion a y b,2001-10-01,1,2,1,2,3
70707,BOYUIBE,estado nutricional en menores de 5 anos,clasificacion a y b,2001-10-01,1,23,1,23,24
70401,BUENA VISTA,estado nutricional en menores de 5 anos,clasificacion a y b,2001-10-01,63,29,63,29,92
70703,CABEZAS,estado nutricional en menores de 5 anos,clasificacion a y b,2001-10-01,48,86,48,86,134
20905,CAIROMA,estado nutricional en menores de 5 anos,clasificacion a y b,2001-10-01,1,1,1,1,2
51102,"CAIZA ""D""",estado nutricional en menores de 5 anos,clasificacion a y b,2001-10-01,9,15,9,15,24
21003,CAJUATA,estado nutricional en menores de 5 anos,clasificacion a y b,2001-10-01,10,1,10,1,11
21304,CALAMARCA,estado nutricional en menores de 5 anos,clasificacion a y b,2001-10-01,7,11,7,11,18
10701,CAMARGO,estado nutricional en menores de 5 anos,clasificacion a y b,2001-10-01,12,22,12,22,34
10901,CAMATAQUI (C. VILLA ABECIA),estado nutricional en menores de 5 anos,clasificacion a y b,2001-10-01,0,9,0,9,9
70706,CAMIRI,estado nutricional en menores de 5 anos,clasificacion a y b,2001-10-01,69,39,69,39,108
30701,CAPINOTA,estado nutricional en menores de 5 anos,clasificacion a y b,2001-10-01,41,10,41,10,51
20302,CAQUIAVIRI,estado nutricional en menores de 5 anos,clasificacion a y b,2001-10-01,21,5,21,5,26
40102,CARACOLLO,estado nutricional en menores de 5 anos,clasificacion a y b,2001-10-01,15,8,15,8,23
22001,CARANAVI,estado nutricional en menores de 5 anos,clasificacion a y b,2001-10-01,57,75,57,75,132
60302,CARAPARI,estado nutricional en menores de 5 anos,clasificacion a y b,2001-10-01,19,13,19,13,32
50702,CARIPUYO,estado nutricional en menores de 5 anos,clasificacion a y b,2001-10-01,2,4,2,4,6
21902,CATACORA,estado nutricional en menores de 5 anos,clasificacion a y b,2001-10-01,0,1,0,1,1
21803,CHACARILLA,estado nutricional en menores de 5 anos,clasificacion a y b,2001-10-01,0,1,0,1,1
40201,CHALLAPATA,estado nutricional en menores de 5 anos,clasificacion a y b,2001-10-01,6,17,6,17,23
50302,CHAQUI,estado nutricional en menores de 5 anos,clasificacion a y b,2001-10-01,0,16,0,16,16
70702,CHARAGUA,estado nutricional en menores de 5 anos,clasificacion a y b,2001-10-01,44,100,44,100,144
20305,CHARAÃ‘A,estado nutricional en menores de 5 anos,clasificacion a y b,2001-10-01,0,1,0,1,1
50202,CHAYANTA,estado nutricional en menores de 5 anos,clasificacion a y b,2001-10-01,3,7,3,7,10
31204,CHIMORE,estado nutricional en menores de 5 anos,clasificacion a y b,2001-10-01,39,36,39,36,75
40302,CHOQUE COTA,estado nutricional en menores de 5 anos,clasificacion a y b,2001-10-01,0,1,0,1,1
21101,CHULUMANI (V. DE LA LIBERTAD),estado nutricional en menores de 5 anos,clasificacion a y b,2001-10-01,7,6,7,6,13
20501,CHUMA,estado nutricional en menores de 5 anos,clasificacion a y b,2001-10-01,9,0,9,0,9
30801,CLIZA,estado nutricional en menores de 5 anos,clasificacion a y b,2001-10-01,0,3,0,3,3
90101,COBIJA,estado nutricional en menores de 5 anos,clasificacion a y b,2001-10-01,81,11,81,11,92
30101,COCHABAMBA,estado nutricional en menores de 5 anos,clasificacion a y b,2001-10-01,1321,395,1321,395,1716
40902,COIPASA,estado nutricional en menores de 5 anos,clasificacion a y b,2001-10-01,0,1,0,1,1
30905,COLCAPIRHUA,estado nutricional en menores de 5 anos,clasificacion a y b,2001-10-01,56,14,56,14,70
50901,"COLCHA ""K""",estado nutricional en menores de 5 anos,clasificacion a y b,2001-10-01,5,22,5,22,27
21307,COLLANA,estado nutricional en menores de 5 anos,clasificacion a y b,2001-10-01,2,0,2,0,2
31002,COLOMI,estado nutricional en menores de 5 anos,clasificacion a y b,2001-10-01,18,26,18,26,44
70603,COLPA BELGICA,estado nutricional en menores de 5 anos,clasificacion a y b,2001-10-01,24,1,24,1,25
50401,COLQUECHACA,estado nutricional en menores de 5 anos,clasificacion a y b,2001-10-01,1,2,1,2,3
21306,COLQUENCHA,estado nutricional en menores de 5 anos,clasificacion a y b,2001-10-01,10,4,10,4,14
21004,COLQUIRI,estado nutricional en menores de 5 anos,clasificacion a y b,2001-10-01,15,24,15,24,39
20304,COMANCHE,estado nutricional en menores de 5 anos,clasificacion a y b,2001-10-01,4,4,4,4,8
71301,COMARAPA,estado nutricional en menores de 5 anos,clasificacion a y b,2001-10-01,18,10,18,10,28
20605,COMBAYA,estado nutricional en menores de 5 anos,clasificacion a y b,2001-10-01,0,3,0,3,3
71101,CONCEPCION,estado nutricional en menores de 5 anos,clasificacion a y b,2001-10-01,21,27,21,27,48
21701,COPACABANA,estado nutricional en menores de 5 anos,clasificacion a y b,2001-10-01,0,19,0,19,19
21402,CORIPATA,estado nutricional en menores de 5 anos,clasificacion a y b,2001-10-01,9,16,9,16,25
20301,CORO CORO,estado nutricional en menores de 5 anos,clasificacion a y b,2001-10-01,10,6,10,6,16
21401,COROICO,estado nutricional en menores de 5 anos,clasificacion a y b,2001-10-01,14,2,14,2,16
40301,CORQUE,estado nutricional en menores de 5 anos,clasificacion a y b,2001-10-01,2,1,2,1,3
50601,COTAGAITA,estado nutricional en menores de 5 anos,clasificacion a y b,2001-10-01,10,21,10,21,31
70102,COTOCA,estado nutricional en menores de 5 anos,clasificacion a y b,2001-10-01,45,82,45,82,127
70704,CUEVO,estado nutricional en menores de 5 anos,clasificacion a y b,2001-10-01,8,5,8,5,13
10902,CULPINA,estado nutricional en menores de 5 anos,clasificacion a y b,2001-10-01,17,76,17,76,93
40401,CURAHUARA DE CARANGAS,estado nutricional en menores de 5 anos,clasificacion a y b,2001-10-01,3,1,3,1,4
21602,CURVA,estado nutricional en menores de 5 anos,clasificacion a y b,2001-10-01,4,0,4,0,4
20804,DESAGUADERO,estado nutricional en menores de 5 anos,clasificacion a y b,2001-10-01,1,9,1,9,10
20105,EL ALTO,estado nutricional en menores de 5 anos,clasificacion a y b,2001-10-01,535,446,535,446,981
40103,EL CHORO,estado nutricional en menores de 5 anos,clasificacion a y b,2001-10-01,1,0,1,0,1
71503,EL PUENTE(STC),estado nutricional en menores de 5 anos,clasificacion a y b,2001-10-01,13,34,13,34,47
60502,EL PUENTE(TJA),estado nutricional en menores de 5 anos,clasificacion a y b,2001-10-01,2,3,2,3,5
70105,EL TORNO,estado nutricional en menores de 5 anos,clasificacion a y b,2001-10-01,35,152,35,152,187
10405,EL VILLAR,estado nutricional en menores de 5 anos,clasificacion a y b,2001-10-01,3,58,3,58,61
60601,ENTRE RIOS,estado nutricional en menores de 5 anos,clasificacion a y b,2001-10-01,17,22,17,22,39
41101,EUCALIPTUS,estado nutricional en menores de 5 anos,clasificacion a y b,2001-10-01,3,12,3,12,15
80402,EXALTACION,estado nutricional en menores de 5 anos,clasificacion a y b,2001-10-01,3,4,3,4,7
90203,FILADELFIA,estado nutricional en menores de 5 anos,clasificacion a y b,2001-10-01,3,3,3,3,6
71002,GENERAL SAAVEDRA,estado nutricional en menores de 5 anos,clasificacion a y b,2001-10-01,18,76,18,76,94
21601,GRAL. J.J. PEREZ (CHARAZANI),estado nutricional en menores de 5 anos,clasificacion a y b,2001-10-01,6,0,6,0,6
20602,GUANAY,estado nutricional en menores de 5 anos,clasificacion a y b,2001-10-01,31,60,31,60,91
20802,GUAQUI,estado nutricional en menores de 5 anos,clasificacion a y b,2001-10-01,2,14,2,14,16
80202,GUAYARAMERIN,estado nutricional en menores de 5 anos,clasificacion a y b,2001-10-01,82,14,82,14,96
70705,GUTIERREZ,estado nutricional en menores de 5 anos,clasificacion a y b,2001-10-01,36,63,36,63,99
10502,HUACARETA,estado nutricional en menores de 5 anos,clasificacion a y b,2001-10-01,7,37,7,37,44
40501,HUACHACALLA,estado nutricional en menores de 5 anos,clasificacion a y b,2001-10-01,1,1,1,1,2
40701,HUANUNI,estado nutricional en menores de 5 anos,clasificacion a y b,2001-10-01,6,2,6,2,8
80803,HUARACAJE,estado nutricional en menores de 5 anos,clasificacion a y b,2001-10-01,11,4,11,4,15
21005,ICHOCA,estado nutricional en menores de 5 anos,clasificacion a y b,2001-10-01,0,1,0,1,1
10304,ICLA,estado nutricional en menores de 5 anos,clasificacion a y b,2001-10-01,17,13,17,13,30
10703,INCAHUASI,estado nutricional en menores de 5 anos,clasificacion a y b,2001-10-01,11,36,11,36,47
21001,INQUISIVI,estado nutricional en menores de 5 anos,clasificacion a y b,2001-10-01,6,11,6,11,17
21102,IRUPANA (VILLA DE LANZA),estado nutricional en menores de 5 anos,clasificacion a y b,2001-10-01,43,22,43,22,65
21501,IXIAMAS,estado nutricional en menores de 5 anos,clasificacion a y b,2001-10-01,32,14,32,14,46
21105,LA ASUNTA,estado nutricional en menores de 5 anos,clasificacion a y b,2001-10-01,15,25,15,25,40
70104,LA GUARDIA,estado nutricional en menores de 5 anos,clasificacion a y b,2001-10-01,48,173,48,173,221
20101,LA PAZ,estado nutricional en menores de 5 anos,clasificacion a y b,2001-10-01,458,404,458,404,862
70701,LAGUNILLAS,estado nutricional en menores de 5 anos,clasificacion a y b,2001-10-01,10,17,10,17,27
21202,LAJA,estado nutricional en menores de 5 anos,clasificacion a y b,2001-10-01,6,34,6,34,40
10903,LAS CARRERAS,estado nutricional en menores de 5 anos,clasificacion a y b,2001-10-01,2,6,2,6,8
50203,LLALLAGUA,estado nutricional en menores de 5 anos,clasificacion a y b,2001-10-01,16,14,16,14,30
51401,LLICA,estado nutricional en menores de 5 anos,clasificacion a y b,2001-10-01,0,6,0,6,6
80601,LORETO,estado nutricional en menores de 5 anos,clasificacion a y b,2001-10-01,0,8,0,8,8
20901,LURIBAY,estado nutricional en menores de 5 anos,clasificacion a y b,2001-10-01,5,15,5,15,20
40702,MACHACAMARCA,estado nutricional en menores de 5 anos,clasificacion a y b,2001-10-01,13,13,13,13,26
11003,MACHARETI,estado nutricional en menores de 5 anos,clasificacion a y b,2001-10-01,20,49,20,49,69
80801,MAGDALENA,estado nutricional en menores de 5 anos,clasificacion a y b,2001-10-01,7,8,7,8,15
70903,MAIRANA,estado nutricional en menores de 5 anos,clasificacion a y b,2001-10-01,48,17,48,17,65
20904,MALLA,estado nutricional en menores de 5 anos,clasificacion a y b,2001-10-01,0,2,0,2,2
20103,MECAPACA,estado nutricional en menores de 5 anos,clasificacion a y b,2001-10-01,11,20,11,20,31
71003,MINEROS,estado nutricional en menores de 5 anos,clasificacion a y b,2001-10-01,30,168,30,168,198
31301,MIZQUE,estado nutricional en menores de 5 anos,clasificacion a y b,2001-10-01,45,31,45,31,76
20402,MOCOMOCO,estado nutricional en menores de 5 anos,clasificacion a y b,2001-10-01,8,6,8,6,14
10303,MOJOCOYA,estado nutricional en menores de 5 anos,clasificacion a y b,2001-10-01,9,36,9,36,45
10501,MONTEAGUDO,estado nutricional en menores de 5 anos,clasificacion a y b,2001-10-01,27,88,27,88,115
71001,MONTERO,estado nutricional en menores de 5 anos,clasificacion a y b,2001-10-01,133,517,133,517,650
70803,MORO MORO,estado nutricional en menores de 5 anos,clasificacion a y b,2001-10-01,13,5,13,5,18
30302,MOROCHATA,estado nutricional en menores de 5 anos,clasificacion a y b,2001-10-01,26,4,26,4,30
90401,NACEBE (SANTA ROSA DEL ABUNA),estado nutricional en menores de 5 anos,clasificacion a y b,2001-10-01,1,2,1,2,3
90501,NUEVO MANOA (NUEVA ESPERANZA),estado nutricional en menores de 5 anos,clasificacion a y b,2001-10-01,0,4,0,4,4
50404,OCURI,estado nutricional en menores de 5 anos,clasificacion a y b,2001-10-01,10,10,10,10,20
70202,OKINAWA,estado nutricional en menores de 5 anos,clasificacion a y b,2001-10-01,2,14,2,14,16
30203,OMEREQUE,estado nutricional en menores de 5 anos,clasificacion a y b,2001-10-01,3,18,3,18,21
40101,ORURO,estado nutricional en menores de 5 anos,clasificacion a y b,2001-10-01,63,244,63,244,307
60201,PADCAYA,estado nutricional en menores de 5 anos,clasificacion a y b,2001-10-01,21,27,21,27,48
10401,PADILLA,estado nutricional en menores de 5 anos,clasificacion a y b,2001-10-01,12,41,12,41,53
70502,PAILON,estado nutricional en menores de 5 anos,clasificacion a y b,2001-10-01,21,91,21,91,112
20102,PALCA,estado nutricional en menores de 5 anos,clasificacion a y b,2001-10-01,38,3,38,3,41
21104,PALOS BLANCOS,estado nutricional en menores de 5 anos,clasificacion a y b,2001-10-01,21,15,21,15,36
70902,PAMPA GRANDE,estado nutricional en menores de 5 anos,clasificacion a y b,2001-10-01,23,5,23,5,28
21802,PAPEL PAMPA,estado nutricional en menores de 5 anos,clasificacion a y b,2001-10-01,1,2,1,2,3
30202,PASORAPA,estado nutricional en menores de 5 anos,clasificacion a y b,2001-10-01,2,16,2,16,18
21305,PATACAMAYA,estado nutricional en menores de 5 anos,clasificacion a y b,2001-10-01,24,6,24,6,30
40602,PAZÃ‘A,estado nutricional en menores de 5 anos,clasificacion a y b,2001-10-01,1,2,1,2,3
20702,PELECHUCO,estado nutricional en menores de 5 anos,clasificacion a y b,2001-10-01,2,0,2,0,2
50403,POCOATA,estado nutricional en menores de 5 anos,clasificacion a y b,2001-10-01,14,11,14,11,25
31203,POCONA,estado nutricional en menores de 5 anos,clasificacion a y b,2001-10-01,0,5,0,5,5
31202,POJO (CBBA),estado nutricional en menores de 5 anos,clasificacion a y b,2001-10-01,87,90,87,90,177
40601,POOPO,estado nutricional en menores de 5 anos,clasificacion a y b,2001-10-01,0,6,0,6,6
51203,PORCO,estado nutricional en menores de 5 anos,clasificacion a y b,2001-10-01,2,11,2,11,13
10103,POROMA,estado nutricional en menores de 5 anos,clasificacion a y b,2001-10-01,7,24,7,24,31
70103,PORONGO,estado nutricional en menores de 5 anos,clasificacion a y b,2001-10-01,8,42,8,42,50
70601,PORTACHUELO,estado nutricional en menores de 5 anos,clasificacion a y b,2001-10-01,38,28,38,28,66
90102,PORVENIR,estado nutricional en menores de 5 anos,clasificacion a y b,2001-10-01,4,9,4,9,13
70804,POSTRER VALLE,estado nutricional en menores de 5 anos,clasificacion a y b,2001-10-01,8,2,8,2,10
50101,POTOSI,estado nutricional en menores de 5 anos,clasificacion a y b,2001-10-01,38,100,38,100,138
10302,PRESTO,estado nutricional en menores de 5 anos,clasificacion a y b,2001-10-01,11,20,11,20,31
21201,PUCARANI,estado nutricional en menores de 5 anos,clasificacion a y b,2001-10-01,9,12,9,12,21
20401,PUERTO ACOSTA,estado nutricional en menores de 5 anos,clasificacion a y b,2001-10-01,26,8,26,8,34
20403,PUERTO CARABUCO,estado nutricional en menores de 5 anos,clasificacion a y b,2001-10-01,25,3,25,3,28
90301,PUERTO GONZALO MORENO,estado nutricional en menores de 5 anos,clasificacion a y b,2001-10-01,1,5,1,5,6
21204,PUERTO PEREZ,estado nutricional en menores de 5 anos,clasificacion a y b,2001-10-01,2,7,2,7,9
71402,PUERTO QUIJARRO,estado nutricional en menores de 5 anos,clasificacion a y b,2001-10-01,38,5,38,5,43
90201,PUERTO RICO,estado nutricional en menores de 5 anos,clasificacion a y b,2001-10-01,4,2,4,2,6
80703,PUERTO SILES,estado nutricional en menores de 5 anos,clasificacion a y b,2001-10-01,0,1,0,1,1
71401,PUERTO SUAREZ,estado nutricional en menores de 5 anos,clasificacion a y b,2001-10-01,63,4,63,4,67
31205,PUERTO VILLARROEL,estado nutricional en menores de 5 anos,clasificacion a y b,2001-10-01,107,32,107,32,139
51101,PUNA,estado nutricional en menores de 5 anos,clasificacion a y b,2001-10-01,18,38,18,38,56
31401,PUNATA,estado nutricional en menores de 5 anos,clasificacion a y b,2001-10-01,0,13,0,13,13
20604,QUIABAYA,estado nutricional en menores de 5 anos,clasificacion a y b,2001-10-01,4,6,4,6,10
30901,QUILLACOLLO,estado nutricional en menores de 5 anos,clasificacion a y b,2001-10-01,28,6,28,6,34
21002,QUIME,estado nutricional en menores de 5 anos,clasificacion a y b,2001-10-01,4,9,4,9,13
70904,QUIRUSILLAS,estado nutricional en menores de 5 anos,clasificacion a y b,2001-10-01,4,1,4,1,5
50402,RAVELO,estado nutricional en menores de 5 anos,clasificacion a y b,2001-10-01,6,17,6,17,23
80301,REYES,estado nutricional en menores de 5 anos,clasificacion a y b,2001-10-01,46,7,46,7,53
80201,RIBERALTA,estado nutricional en menores de 5 anos,clasificacion a y b,2001-10-01,180,116,180,116,296
70503,ROBORE,estado nutricional en menores de 5 anos,clasificacion a y b,2001-10-01,11,41,11,41,52
80304,RURRENABAQUE,estado nutricional en menores de 5 anos,clasificacion a y b,2001-10-01,59,44,59,44,103
31001,SACABA,estado nutricional en menores de 5 anos,clasificacion a y b,2001-10-01,123,17,123,17,140
30404,SACABAMBA,estado nutricional en menores de 5 anos,clasificacion a y b,2001-10-01,5,4,5,4,9
50701,SACACA,estado nutricional en menores de 5 anos,clasificacion a y b,2001-10-01,4,14,4,14,18
71302,SAIPINA,estado nutricional en menores de 5 anos,clasificacion a y b,2001-10-01,66,14,66,14,80
40801,SALINAS DE GARCI MENDOZA,estado nutricional en menores de 5 anos,clasificacion a y b,2001-10-01,5,4,5,4,9
70901,SAMAIPATA,estado nutricional en menores de 5 anos,clasificacion a y b,2001-10-01,26,8,26,8,34
51601,SAN AGUSTIN,estado nutricional en menores de 5 anos,clasificacion a y b,2001-10-01,0,4,0,4,4
80602,SAN ANDRES,estado nutricional en menores de 5 anos,clasificacion a y b,2001-10-01,4,5,4,5,9
71105,SAN ANTONIO DE LOMERIO,estado nutricional en menores de 5 anos,clasificacion a y b,2001-10-01,10,4,10,4,14
31403,SAN BENITO,estado nutricional en menores de 5 anos,clasificacion a y b,2001-10-01,1,8,1,8,9
80302,SAN BORJA,estado nutricional en menores de 5 anos,clasificacion a y b,2001-10-01,114,18,114,18,132
21502,SAN BUENA VENTURA,estado nutricional en menores de 5 anos,clasificacion a y b,2001-10-01,37,8,37,8,45
70402,SAN CARLOS,estado nutricional en menores de 5 anos,clasificacion a y b,2001-10-01,40,50,40,50,90
80501,SAN IGNACIO,estado nutricional en menores de 5 anos,clasificacion a y b,2001-10-01,25,75,25,75,100
70301,SAN IGNACIO DE VELASCO,estado nutricional en menores de 5 anos,clasificacion a y b,2001-10-01,196,47,196,47,243
80102,SAN JAVIER(BNI),estado nutricional en menores de 5 anos,clasificacion a y b,2001-10-01,4,12,4,12,16
71102,SAN JAVIER(STC),estado nutricional en menores de 5 anos,clasificacion a y b,2001-10-01,47,2,47,2,49
80701,SAN JOAQUIN,estado nutricional en menores de 5 anos,clasificacion a y b,2001-10-01,4,22,4,22,26
70501,SAN JOSE DE CHIQUITOS,estado nutricional en menores de 5 anos,clasificacion a y b,2001-10-01,18,5,18,5,23
71104,SAN JULIAN,estado nutricional en menores de 5 anos,clasificacion a y b,2001-10-01,113,63,113,63,176
90302,SAN LORENZO(PND),estado nutricional en menores de 5 anos,clasificacion a y b,2001-10-01,2,3,2,3,5
60501,SAN LORENZO(TJA),estado nutricional en menores de 5 anos,clasificacion a y b,2001-10-01,2,9,2,9,11
10702,SAN LUCAS,estado nutricional en menores de 5 anos,clasificacion a y b,2001-10-01,28,52,28,52,80
71201,SAN MATIAS,estado nutricional en menores de 5 anos,clasificacion a y b,2001-10-01,43,12,43,12,55
70302,SAN MIGUEL DE VELASCO,estado nutricional en menores de 5 anos,clasificacion a y b,2001-10-01,11,8,11,8,19
51001,SAN PABLO DE LIPEZ,estado nutricional en menores de 5 anos,clasificacion a y b,2001-10-01,2,1,2,1,3
50501,SAN PEDRO DE BUENA VISTA,estado nutricional en menores de 5 anos,clasificacion a y b,2001-10-01,3,13,3,13,16
21801,SAN PEDRO DE CURAHUARA,estado nutricional en menores de 5 anos,clasificacion a y b,2001-10-01,3,5,3,5,8
50902,SAN PEDRO DE QUEMES,estado nutricional en menores de 5 anos,clasificacion a y b,2001-10-01,1,0,1,0,1
21702,SAN PEDRO DE TIQUINA,estado nutricional en menores de 5 anos,clasificacion a y b,2001-10-01,5,21,5,21,26
70303,SAN RAFAEL,estado nutricional en menores de 5 anos,clasificacion a y b,2001-10-01,21,4,21,4,25
80702,SAN RAMON,estado nutricional en menores de 5 anos,clasificacion a y b,2001-10-01,4,14,4,14,18
80401,SANTA ANA,estado nutricional en menores de 5 anos,clasificacion a y b,2001-10-01,22,21,22,21,43
70101,SANTA CRUZ DE LA SIERRA,estado nutricional en menores de 5 anos,clasificacion a y b,2001-10-01,887,568,887,568,1455
80303,SANTA ROSA,estado nutricional en menores de 5 anos,clasificacion a y b,2001-10-01,11,2,11,2,13
70602,SANTA ROSA DEL SARA,estado nutricional en menores de 5 anos,clasificacion a y b,2001-10-01,7,9,7,9,16
20308,SANTIAGO DE CALLAPA,estado nutricional en menores de 5 anos,clasificacion a y b,2001-10-01,1,6,1,6,7
41401,SANTIAGO DE HUARI,estado nutricional en menores de 5 anos,clasificacion a y b,2001-10-01,6,1,6,1,7
21901,SANTIAGO DE MACHACA,estado nutricional en menores de 5 anos,clasificacion a y b,2001-10-01,6,4,6,4,10
30702,SANTIVAÃ‘ES,estado nutricional en menores de 5 anos,clasificacion a y b,2001-10-01,8,1,8,1,9
40202,SANTUARIO DE QUILLACAS,estado nutricional en menores de 5 anos,clasificacion a y b,2001-10-01,1,1,1,1,2
20902,SAPAHAQUI,estado nutricional en menores de 5 anos,clasificacion a y b,2001-10-01,1,12,1,12,13
90303,SENA,estado nutricional en menores de 5 anos,clasificacion a y b,2001-10-01,2,3,2,3,5
21301,SICA SICA (VILLA AROMA),estado nutricional en menores de 5 anos,clasificacion a y b,2001-10-01,13,20,13,20,33
30703,SICAYA,estado nutricional en menores de 5 anos,clasificacion a y b,2001-10-01,4,3,4,3,7
30902,SIPE SIPE,estado nutricional en menores de 5 anos,clasificacion a y b,2001-10-01,139,37,139,37,176
10403,SOPACHUY,estado nutricional en menores de 5 anos,clasificacion a y b,2001-10-01,12,21,12,21,33
20601,SORATA,estado nutricional en menores de 5 anos,clasificacion a y b,2001-10-01,4,5,4,5,9
10101,SUCRE,estado nutricional en menores de 5 anos,clasificacion a y b,2001-10-01,88,290,88,290,378
31404,TACACHI,estado nutricional en menores de 5 anos,clasificacion a y b,2001-10-01,0,5,0,5,5
20603,TACACOMA,estado nutricional en menores de 5 anos,clasificacion a y b,2001-10-01,15,15,15,15,30
50303,TACOBAMBA,estado nutricional en menores de 5 anos,clasificacion a y b,2001-10-01,5,18,5,18,23
30602,TACOPAYA,estado nutricional en menores de 5 anos,clasificacion a y b,2001-10-01,5,2,5,2,7
51402,TAHUA,estado nutricional en menores de 5 anos,clasificacion a y b,2001-10-01,0,2,0,2,2
31101,TAPACARI,estado nutricional en menores de 5 anos,clasificacion a y b,2001-10-01,3,35,3,35,38
10601,TARABUCO,estado nutricional en menores de 5 anos,clasificacion a y b,2001-10-01,32,49,32,49,81
30401,TARATA,estado nutricional en menores de 5 anos,clasificacion a y b,2001-10-01,6,17,6,17,23
60101,TARIJA,estado nutricional en menores de 5 anos,clasificacion a y b,2001-10-01,161,259,161,259,420
10202,TARVITA,estado nutricional en menores de 5 anos,clasificacion a y b,2001-10-01,5,11,5,11,16
20803,TIAWANACU,estado nutricional en menores de 5 anos,clasificacion a y b,2001-10-01,17,4,17,4,21
50102,TINGUIPAYA,estado nutricional en menores de 5 anos,clasificacion a y b,2001-10-01,8,3,8,3,11
20606,TIPUANI,estado nutricional en menores de 5 anos,clasificacion a y b,2001-10-01,12,9,12,9,21
30903,TIQUIPAYA,estado nutricional en menores de 5 anos,clasificacion a y b,2001-10-01,2,12,2,12,14
31601,TIRAQUE (CBBA),estado nutricional en menores de 5 anos,clasificacion a y b,2001-10-01,54,39,54,39,93
30802,TOCO,estado nutricional en menores de 5 anos,clasificacion a y b,2001-10-01,0,3,0,3,3
41502,TODOS SANTOS,estado nutricional en menores de 5 anos,clasificacion a y b,2001-10-01,2,0,2,0,2
30803,TOLATA,estado nutricional en menores de 5 anos,clasificacion a y b,2001-10-01,0,4,0,4,4
41001,TOLEDO,estado nutricional en menores de 5 anos,clasificacion a y b,2001-10-01,7,5,7,5,12
51202,TOMAVE,estado nutricional en menores de 5 anos,clasificacion a y b,2001-10-01,13,12,13,12,25
10402,TOMINA,estado nutricional en menores de 5 anos,clasificacion a y b,2001-10-01,10,23,10,23,33
50502,TORO TORO,estado nutricional en menores de 5 anos,clasificacion a y b,2001-10-01,1,3,1,3,4
31201,TOTORA(CBBA),estado nutricional en menores de 5 anos,clasificacion a y b,2001-10-01,20,20,20,20,40
41301,TOTORA(ORR),estado nutricional en menores de 5 anos,clasificacion a y b,2001-10-01,1,4,1,4,5
70802,TRIGAL,estado nutricional en menores de 5 anos,clasificacion a y b,2001-10-01,2,4,2,4,6
80101,TRINIDAD,estado nutricional en menores de 5 anos,clasificacion a y b,2001-10-01,98,171,98,171,269
50801,TUPIZA,estado nutricional en menores de 5 anos,clasificacion a y b,2001-10-01,26,86,26,86,112
40402,TURCO,estado nutricional en menores de 5 anos,clasificacion a y b,2001-10-01,6,3,6,3,9
21302,UMALA,estado nutricional en menores de 5 anos,clasificacion a y b,2001-10-01,0,16,0,16,16
50201,UNCIA,estado nutricional en menores de 5 anos,clasificacion a y b,2001-10-01,4,46,4,46,50
60401,URIONDO (A. CONCEPCION),estado nutricional en menores de 5 anos,clasificacion a y b,2001-10-01,8,44,8,44,52
71502,URUBICHA,estado nutricional en menores de 5 anos,clasificacion a y b,2001-10-01,12,6,12,6,18
51201,UYUNI,estado nutricional en menores de 5 anos,clasificacion a y b,2001-10-01,4,30,4,30,34
30502,VACAS,estado nutricional en menores de 5 anos,clasificacion a y b,2001-10-01,1,5,1,5,6
70801,VALLEGRANDE,estado nutricional en menores de 5 anos,clasificacion a y b,2001-10-01,46,59,46,59,105
20801,VIACHA,estado nutricional en menores de 5 anos,clasificacion a y b,2001-10-01,31,74,31,74,105
31302,VILA VILA,estado nutricional en menores de 5 anos,clasificacion a y b,2001-10-01,2,12,2,12,14
60303,VILLA MONTES,estado nutricional en menores de 5 anos,clasificacion a y b,2001-10-01,36,12,36,12,48
90502,VILLA NUEVA (LOMA ALTA),estado nutricional en menores de 5 anos,clasificacion a y b,2001-10-01,0,2,0,2,2
31402,VILLA RIVERO,estado nutricional en menores de 5 anos,clasificacion a y b,2001-10-01,3,3,3,3,6
10801,VILLA SERRANO,estado nutricional en menores de 5 anos,clasificacion a y b,2001-10-01,7,44,7,44,51
31003,VILLA TUNARI,estado nutricional en menores de 5 anos,clasificacion a y b,2001-10-01,89,86,89,86,175
11001,VILLA VACA GUZMAN (MUYUPAMPA),estado nutricional en menores de 5 anos,clasificacion a y b,2001-10-01,17,52,17,52,69
51501,VILLAZON,estado nutricional en menores de 5 anos,clasificacion a y b,2001-10-01,20,71,20,71,91
30904,VINTO,estado nutricional en menores de 5 anos,clasificacion a y b,2001-10-01,109,13,109,13,122
50602,VITICHI,estado nutricional en menores de 5 anos,clasificacion a y b,2001-10-01,5,15,5,15,20
70201,WARNES,estado nutricional en menores de 5 anos,clasificacion a y b,2001-10-01,132,67,132,67,199
20903,YACO,estado nutricional en menores de 5 anos,clasificacion a y b,2001-10-01,5,45,5,45,50
60301,YACUIBA,estado nutricional en menores de 5 anos,clasificacion a y b,2001-10-01,94,14,94,14,108
10602,YAMPARAEZ,estado nutricional en menores de 5 anos,clasificacion a y b,2001-10-01,5,33,5,33,38
21103,YANACACHI,estado nutricional en menores de 5 anos,clasificacion a y b,2001-10-01,11,13,11,13,24
70403,YAPACANI,estado nutricional en menores de 5 anos,clasificacion a y b,2001-10-01,102,59,102,59,161
50103,YOCALLA,estado nutricional en menores de 5 anos,clasificacion a y b,2001-10-01,2,5,2,5,7
10102,YOTALA,estado nutricional en menores de 5 anos,clasificacion a y b,2001-10-01,11,34,11,34,45
60402,YUNCHARA,estado nutricional en menores de 5 anos,clasificacion a y b,2001-10-01,1,0,1,0,1
10301,ZUDAÃ‘EZ,estado nutricional en menores de 5 anos,clasificacion a y b,2001-10-01,4,16,4,16,20
51302,ACACIO,estado nutricional en menores de 5 anos,clasificacion a y b,2001-11-01,2,9,2,9,11
20201,ACHACACHI,estado nutricional en menores de 5 anos,clasificacion a y b,2001-11-01,33,112,33,112,145
20104,ACHOCALLA,estado nutricional en menores de 5 anos,clasificacion a y b,2001-11-01,7,3,7,3,10
30201,AIQUILE,estado nutricional en menores de 5 anos,clasificacion a y b,2001-11-01,1,0,1,0,1
31303,ALALAY,estado nutricional en menores de 5 anos,clasificacion a y b,2001-11-01,1,1,1,1,2
10404,ALCALA,estado nutricional en menores de 5 anos,clasificacion a y b,2001-11-01,4,16,4,16,20
20202,ANCORAIMES,estado nutricional en menores de 5 anos,clasificacion a y b,2001-11-01,10,16,10,16,26
41201,ANDAMARCA,estado nutricional en menores de 5 anos,clasificacion a y b,2001-11-01,1,1,1,1,2
30402,ANZALDO,estado nutricional en menores de 5 anos,clasificacion a y b,2001-11-01,3,5,3,5,8
20701,APOLO,estado nutricional en menores de 5 anos,clasificacion a y b,2001-11-01,17,1,17,1,18
51301,ARAMPAMPA,estado nutricional en menores de 5 anos,clasificacion a y b,2001-11-01,4,22,4,22,26
30501,ARANI,estado nutricional en menores de 5 anos,clasificacion a y b,2001-11-01,1,9,1,9,10
30403,ARBIETO,estado nutricional en menores de 5 anos,clasificacion a y b,2001-11-01,3,12,3,12,15
30601,ARQUE,estado nutricional en menores de 5 anos,clasificacion a y b,2001-11-01,5,1,5,1,6
71501,ASCENCION DE GUARAYOS,estado nutricional en menores de 5 anos,clasificacion a y b,2001-11-01,0,8,0,8,8
50802,ATOCHA,estado nutricional en menores de 5 anos,clasificacion a y b,2001-11-01,2,16,2,16,18
20503,AUCAPATA,estado nutricional en menores de 5 anos,clasificacion a y b,2001-11-01,4,0,4,0,4
20502,AYATA,estado nutricional en menores de 5 anos,clasificacion a y b,2001-11-01,1,1,1,1,2
21303,AYO AYO,estado nutricional en menores de 5 anos,clasificacion a y b,2001-11-01,19,2,19,2,21
30301,AYOPAYA (V. DE INDEPENDENCIA),estado nutricional en menores de 5 anos,clasificacion a y b,2001-11-01,33,14,33,14,47
10201,AZURDUY,estado nutricional en menores de 5 anos,clasificacion a y b,2001-11-01,8,19,8,19,27
21203,BATALLAS,estado nutricional en menores de 5 anos,clasificacion a y b,2001-11-01,6,52,6,52,58
80802,BAURES,estado nutricional en menores de 5 anos,clasificacion a y b,2001-11-01,6,2,6,2,8
50104,BELEN DE URMIRI,estado nutricional en menores de 5 anos,clasificacion a y b,2001-11-01,2,2,2,2,4
90104,BELLA FLOR,estado nutricional en menores de 5 anos,clasificacion a y b,2001-11-01,4,6,4,6,10
60202,BERMEJO,estado nutricional en menores de 5 anos,clasificacion a y b,2001-11-01,9,42,9,42,51
50301,BETANZOS,estado nutricional en menores de 5 anos,clasificacion a y b,2001-11-01,18,51,18,51,69
31501,BOLIVAR,estado nutricional en menores de 5 anos,clasificacion a y b,2001-11-01,3,2,3,2,5
90103,BOLPEBRA,estado nutricional en menores de 5 anos,clasificacion a y b,2001-11-01,1,1,1,1,2
70707,BOYUIBE,estado nutricional en menores de 5 anos,clasificacion a y b,2001-11-01,1,14,1,14,15
70401,BUENA VISTA,estado nutricional en menores de 5 anos,clasificacion a y b,2001-11-01,64,40,64,40,104
70703,CABEZAS,estado nutricional en menores de 5 anos,clasificacion a y b,2001-11-01,14,56,14,56,70
20905,CAIROMA,estado nutricional en menores de 5 anos,clasificacion a y b,2001-11-01,0,5,0,5,5
51102,"CAIZA ""D""",estado nutricional en menores de 5 anos,clasificacion a y b,2001-11-01,5,3,5,3,8
21003,CAJUATA,estado nutricional en menores de 5 anos,clasificacion a y b,2001-11-01,7,0,7,0,7
21304,CALAMARCA,estado nutricional en menores de 5 anos,clasificacion a y b,2001-11-01,4,31,4,31,35
10701,CAMARGO,estado nutricional en menores de 5 anos,clasificacion a y b,2001-11-01,21,21,21,21,42
10901,CAMATAQUI (C. VILLA ABECIA),estado nutricional en menores de 5 anos,clasificacion a y b,2001-11-01,5,19,5,19,24
70706,CAMIRI,estado nutricional en menores de 5 anos,clasificacion a y b,2001-11-01,65,43,65,43,108
30701,CAPINOTA,estado nutricional en menores de 5 anos,clasificacion a y b,2001-11-01,35,8,35,8,43
20302,CAQUIAVIRI,estado nutricional en menores de 5 anos,clasificacion a y b,2001-11-01,13,3,13,3,16
40102,CARACOLLO,estado nutricional en menores de 5 anos,clasificacion a y b,2001-11-01,15,17,15,17,32
22001,CARANAVI,estado nutricional en menores de 5 anos,clasificacion a y b,2001-11-01,75,72,75,72,147
41503,CARANGAS,estado nutricional en menores de 5 anos,clasificacion a y b,2001-11-01,0,1,0,1,1
60302,CARAPARI,estado nutricional en menores de 5 anos,clasificacion a y b,2001-11-01,12,10,12,10,22
50702,CARIPUYO,estado nutricional en menores de 5 anos,clasificacion a y b,2001-11-01,8,13,8,13,21
21803,CHACARILLA,estado nutricional en menores de 5 anos,clasificacion a y b,2001-11-01,0,2,0,2,2
40201,CHALLAPATA,estado nutricional en menores de 5 anos,clasificacion a y b,2001-11-01,4,5,4,5,9
50302,CHAQUI,estado nutricional en menores de 5 anos,clasificacion a y b,2001-11-01,1,6,1,6,7
70702,CHARAGUA,estado nutricional en menores de 5 anos,clasificacion a y b,2001-11-01,24,79,24,79,103
20305,CHARAÃ‘A,estado nutricional en menores de 5 anos,clasificacion a y b,2001-11-01,0,2,0,2,2
50202,CHAYANTA,estado nutricional en menores de 5 anos,clasificacion a y b,2001-11-01,3,32,3,32,35
31204,CHIMORE,estado nutricional en menores de 5 anos,clasificacion a y b,2001-11-01,12,22,12,22,34
40302,CHOQUE COTA,estado nutricional en menores de 5 anos,clasificacion a y b,2001-11-01,1,1,1,1,2
21101,CHULUMANI (V. DE LA LIBERTAD),estado nutricional en menores de 5 anos,clasificacion a y b,2001-11-01,0,2,0,2,2
20501,CHUMA,estado nutricional en menores de 5 anos,clasificacion a y b,2001-11-01,13,2,13,2,15
30801,CLIZA,estado nutricional en menores de 5 anos,clasificacion a y b,2001-11-01,1,11,1,11,12
90101,COBIJA,estado nutricional en menores de 5 anos,clasificacion a y b,2001-11-01,114,29,114,29,143
30101,COCHABAMBA,estado nutricional en menores de 5 anos,clasificacion a y b,2001-11-01,1367,957,1367,957,2324
30905,COLCAPIRHUA,estado nutricional en menores de 5 anos,clasificacion a y b,2001-11-01,45,8,45,8,53
50901,"COLCHA ""K""",estado nutricional en menores de 5 anos,clasificacion a y b,2001-11-01,14,16,14,16,30
21307,COLLANA,estado nutricional en menores de 5 anos,clasificacion a y b,2001-11-01,5,0,5,0,5
31002,COLOMI,estado nutricional en menores de 5 anos,clasificacion a y b,2001-11-01,34,19,34,19,53
70603,COLPA BELGICA,estado nutricional en menores de 5 anos,clasificacion a y b,2001-11-01,19,1,19,1,20
50401,COLQUECHACA,estado nutricional en menores de 5 anos,clasificacion a y b,2001-11-01,6,10,6,10,16
21306,COLQUENCHA,estado nutricional en menores de 5 anos,clasificacion a y b,2001-11-01,9,3,9,3,12
21004,COLQUIRI,estado nutricional en menores de 5 anos,clasificacion a y b,2001-11-01,5,17,5,17,22
20304,COMANCHE,estado nutricional en menores de 5 anos,clasificacion a y b,2001-11-01,4,7,4,7,11
71301,COMARAPA,estado nutricional en menores de 5 anos,clasificacion a y b,2001-11-01,50,29,50,29,79
20605,COMBAYA,estado nutricional en menores de 5 anos,clasificacion a y b,2001-11-01,0,1,0,1,1
71101,CONCEPCION,estado nutricional en menores de 5 anos,clasificacion a y b,2001-11-01,12,24,12,24,36
21701,COPACABANA,estado nutricional en menores de 5 anos,clasificacion a y b,2001-11-01,6,9,6,9,15
21402,CORIPATA,estado nutricional en menores de 5 anos,clasificacion a y b,2001-11-01,8,34,8,34,42
21401,COROICO,estado nutricional en menores de 5 anos,clasificacion a y b,2001-11-01,17,4,17,4,21
40301,CORQUE,estado nutricional en menores de 5 anos,clasificacion a y b,2001-11-01,4,2,4,2,6
50601,COTAGAITA,estado nutricional en menores de 5 anos,clasificacion a y b,2001-11-01,7,44,7,44,51
70102,COTOCA,estado nutricional en menores de 5 anos,clasificacion a y b,2001-11-01,16,42,16,42,58
31405,CUCHUMUELA (V. G. VILLARROEL),estado nutricional en menores de 5 anos,clasificacion a y b,2001-11-01,1,0,1,0,1
70704,CUEVO,estado nutricional en menores de 5 anos,clasificacion a y b,2001-11-01,9,13,9,13,22
10902,CULPINA,estado nutricional en menores de 5 anos,clasificacion a y b,2001-11-01,13,65,13,65,78
40401,CURAHUARA DE CARANGAS,estado nutricional en menores de 5 anos,clasificacion a y b,2001-11-01,1,2,1,2,3
20804,DESAGUADERO,estado nutricional en menores de 5 anos,clasificacion a y b,2001-11-01,2,4,2,4,6
20105,EL ALTO,estado nutricional en menores de 5 anos,clasificacion a y b,2001-11-01,507,420,507,420,927
40103,EL CHORO,estado nutricional en menores de 5 anos,clasificacion a y b,2001-11-01,1,3,1,3,4
71503,EL PUENTE(STC),estado nutricional en menores de 5 anos,clasificacion a y b,2001-11-01,11,18,11,18,29
60502,EL PUENTE(TJA),estado nutricional en menores de 5 anos,clasificacion a y b,2001-11-01,0,4,0,4,4
70105,EL TORNO,estado nutricional en menores de 5 anos,clasificacion a y b,2001-11-01,34,123,34,123,157
10405,EL VILLAR,estado nutricional en menores de 5 anos,clasificacion a y b,2001-11-01,4,12,4,12,16
60601,ENTRE RIOS,estado nutricional en menores de 5 anos,clasificacion a y b,2001-11-01,14,20,14,20,34
41101,EUCALIPTUS,estado nutricional en menores de 5 anos,clasificacion a y b,2001-11-01,1,13,1,13,14
80402,EXALTACION,estado nutricional en menores de 5 anos,clasificacion a y b,2001-11-01,0,4,0,4,4
71002,GENERAL SAAVEDRA,estado nutricional en menores de 5 anos,clasificacion a y b,2001-11-01,6,58,6,58,64
21601,GRAL. J.J. PEREZ (CHARAZANI),estado nutricional en menores de 5 anos,clasificacion a y b,2001-11-01,11,4,11,4,15
20602,GUANAY,estado nutricional en menores de 5 anos,clasificacion a y b,2001-11-01,14,42,14,42,56
20802,GUAQUI,estado nutricional en menores de 5 anos,clasificacion a y b,2001-11-01,3,11,3,11,14
80202,GUAYARAMERIN,estado nutricional en menores de 5 anos,clasificacion a y b,2001-11-01,66,8,66,8,74
70705,GUTIERREZ,estado nutricional en menores de 5 anos,clasificacion a y b,2001-11-01,30,70,30,70,100
10502,HUACARETA,estado nutricional en menores de 5 anos,clasificacion a y b,2001-11-01,4,47,4,47,51
11002,HUACAYA (VILLA DE HUACAYA),estado nutricional en menores de 5 anos,clasificacion a y b,2001-11-01,3,3,3,3,6
40501,HUACHACALLA,estado nutricional en menores de 5 anos,clasificacion a y b,2001-11-01,1,2,1,2,3
40701,HUANUNI,estado nutricional en menores de 5 anos,clasificacion a y b,2001-11-01,4,3,4,3,7
80803,HUARACAJE,estado nutricional en menores de 5 anos,clasificacion a y b,2001-11-01,11,4,11,4,15
21005,ICHOCA,estado nutricional en menores de 5 anos,clasificacion a y b,2001-11-01,0,1,0,1,1
10304,ICLA,estado nutricional en menores de 5 anos,clasificacion a y b,2001-11-01,21,8,21,8,29
10703,INCAHUASI,estado nutricional en menores de 5 anos,clasificacion a y b,2001-11-01,13,17,13,17,30
90402,INGAVI (HUMAITA),estado nutricional en menores de 5 anos,clasificacion a y b,2001-11-01,2,5,2,5,7
21001,INQUISIVI,estado nutricional en menores de 5 anos,clasificacion a y b,2001-11-01,1,9,1,9,10
21102,IRUPANA (VILLA DE LANZA),estado nutricional en menores de 5 anos,clasificacion a y b,2001-11-01,10,36,10,36,46
21501,IXIAMAS,estado nutricional en menores de 5 anos,clasificacion a y b,2001-11-01,24,5,24,5,29
21105,LA ASUNTA,estado nutricional en menores de 5 anos,clasificacion a y b,2001-11-01,22,3,22,3,25
70104,LA GUARDIA,estado nutricional en menores de 5 anos,clasificacion a y b,2001-11-01,34,162,34,162,196
20101,LA PAZ,estado nutricional en menores de 5 anos,clasificacion a y b,2001-11-01,449,343,449,343,792
70701,LAGUNILLAS,estado nutricional en menores de 5 anos,clasificacion a y b,2001-11-01,13,13,13,13,26
21202,LAJA,estado nutricional en menores de 5 anos,clasificacion a y b,2001-11-01,8,35,8,35,43
10903,LAS CARRERAS,estado nutricional en menores de 5 anos,clasificacion a y b,2001-11-01,2,6,2,6,8
50203,LLALLAGUA,estado nutricional en menores de 5 anos,clasificacion a y b,2001-11-01,19,49,19,49,68
51401,LLICA,estado nutricional en menores de 5 anos,clasificacion a y b,2001-11-01,2,8,2,8,10
80601,LORETO,estado nutricional en menores de 5 anos,clasificacion a y b,2001-11-01,1,3,1,3,4
20901,LURIBAY,estado nutricional en menores de 5 anos,clasificacion a y b,2001-11-01,6,25,6,25,31
40702,MACHACAMARCA,estado nutricional en menores de 5 anos,clasificacion a y b,2001-11-01,6,20,6,20,26
11003,MACHARETI,estado nutricional en menores de 5 anos,clasificacion a y b,2001-11-01,14,49,14,49,63
80801,MAGDALENA,estado nutricional en menores de 5 anos,clasificacion a y b,2001-11-01,5,10,5,10,15
70903,MAIRANA,estado nutricional en menores de 5 anos,clasificacion a y b,2001-11-01,33,29,33,29,62
20103,MECAPACA,estado nutricional en menores de 5 anos,clasificacion a y b,2001-11-01,8,11,8,11,19
71003,MINEROS,estado nutricional en menores de 5 anos,clasificacion a y b,2001-11-01,29,134,29,134,163
31301,MIZQUE,estado nutricional en menores de 5 anos,clasificacion a y b,2001-11-01,4,9,4,9,13
20402,MOCOMOCO,estado nutricional en menores de 5 anos,clasificacion a y b,2001-11-01,6,20,6,20,26
10303,MOJOCOYA,estado nutricional en menores de 5 anos,clasificacion a y b,2001-11-01,0,18,0,18,18
10501,MONTEAGUDO,estado nutricional en menores de 5 anos,clasificacion a y b,2001-11-01,40,103,40,103,143
71001,MONTERO,estado nutricional en menores de 5 anos,clasificacion a y b,2001-11-01,118,462,118,462,580
70803,MORO MORO,estado nutricional en menores de 5 anos,clasificacion a y b,2001-11-01,12,3,12,3,15
30302,MOROCHATA,estado nutricional en menores de 5 anos,clasificacion a y b,2001-11-01,12,3,12,3,15
90401,NACEBE (SANTA ROSA DEL ABUNA),estado nutricional en menores de 5 anos,clasificacion a y b,2001-11-01,0,6,0,6,6
50404,OCURI,estado nutricional en menores de 5 anos,clasificacion a y b,2001-11-01,11,8,11,8,19
70202,OKINAWA,estado nutricional en menores de 5 anos,clasificacion a y b,2001-11-01,19,0,19,0,19
30203,OMEREQUE,estado nutricional en menores de 5 anos,clasificacion a y b,2001-11-01,8,13,8,13,21
40101,ORURO,estado nutricional en menores de 5 anos,clasificacion a y b,2001-11-01,85,328,85,328,413
60201,PADCAYA,estado nutricional en menores de 5 anos,clasificacion a y b,2001-11-01,14,27,14,27,41
10401,PADILLA,estado nutricional en menores de 5 anos,clasificacion a y b,2001-11-01,12,42,12,42,54
70502,PAILON,estado nutricional en menores de 5 anos,clasificacion a y b,2001-11-01,11,38,11,38,49
20102,PALCA,estado nutricional en menores de 5 anos,clasificacion a y b,2001-11-01,33,10,33,10,43
21104,PALOS BLANCOS,estado nutricional en menores de 5 anos,clasificacion a y b,2001-11-01,51,43,51,43,94
70902,PAMPA GRANDE,estado nutricional en menores de 5 anos,clasificacion a y b,2001-11-01,11,6,11,6,17
21802,PAPEL PAMPA,estado nutricional en menores de 5 anos,clasificacion a y b,2001-11-01,5,2,5,2,7
30202,PASORAPA,estado nutricional en menores de 5 anos,clasificacion a y b,2001-11-01,7,2,7,2,9
21305,PATACAMAYA,estado nutricional en menores de 5 anos,clasificacion a y b,2001-11-01,25,2,25,2,27
40602,PAZÃ‘A,estado nutricional en menores de 5 anos,clasificacion a y b,2001-11-01,0,2,0,2,2
20702,PELECHUCO,estado nutricional en menores de 5 anos,clasificacion a y b,2001-11-01,1,0,1,0,1
50403,POCOATA,estado nutricional en menores de 5 anos,clasificacion a y b,2001-11-01,20,11,20,11,31
31203,POCONA,estado nutricional en menores de 5 anos,clasificacion a y b,2001-11-01,7,7,7,7,14
31202,POJO (CBBA),estado nutricional en menores de 5 anos,clasificacion a y b,2001-11-01,71,48,71,48,119
40601,POOPO,estado nutricional en menores de 5 anos,clasificacion a y b,2001-11-01,2,2,2,2,4
51203,PORCO,estado nutricional en menores de 5 anos,clasificacion a y b,2001-11-01,9,9,9,9,18
10103,POROMA,estado nutricional en menores de 5 anos,clasificacion a y b,2001-11-01,9,29,9,29,38
70103,PORONGO,estado nutricional en menores de 5 anos,clasificacion a y b,2001-11-01,7,46,7,46,53
70601,PORTACHUELO,estado nutricional en menores de 5 anos,clasificacion a y b,2001-11-01,42,30,42,30,72
90102,PORVENIR,estado nutricional en menores de 5 anos,clasificacion a y b,2001-11-01,3,12,3,12,15
50101,POTOSI,estado nutricional en menores de 5 anos,clasificacion a y b,2001-11-01,28,62,28,62,90
70805,PUCARA,estado nutricional en menores de 5 anos,clasificacion a y b,2001-11-01,0,3,0,3,3
21201,PUCARANI,estado nutricional en menores de 5 anos,clasificacion a y b,2001-11-01,3,32,3,32,35
20401,PUERTO ACOSTA,estado nutricional en menores de 5 anos,clasificacion a y b,2001-11-01,29,4,29,4,33
20403,PUERTO CARABUCO,estado nutricional en menores de 5 anos,clasificacion a y b,2001-11-01,12,0,12,0,12
90301,PUERTO GONZALO MORENO,estado nutricional en menores de 5 anos,clasificacion a y b,2001-11-01,1,8,1,8,9
21204,PUERTO PEREZ,estado nutricional en menores de 5 anos,clasificacion a y b,2001-11-01,1,15,1,15,16
71402,PUERTO QUIJARRO,estado nutricional en menores de 5 anos,clasificacion a y b,2001-11-01,55,4,55,4,59
90201,PUERTO RICO,estado nutricional en menores de 5 anos,clasificacion a y b,2001-11-01,3,8,3,8,11
80703,PUERTO SILES,estado nutricional en menores de 5 anos,clasificacion a y b,2001-11-01,2,3,2,3,5
71401,PUERTO SUAREZ,estado nutricional en menores de 5 anos,clasificacion a y b,2001-11-01,56,6,56,6,62
31205,PUERTO VILLARROEL,estado nutricional en menores de 5 anos,clasificacion a y b,2001-11-01,87,25,87,25,112
51101,PUNA,estado nutricional en menores de 5 anos,clasificacion a y b,2001-11-01,6,17,6,17,23
31401,PUNATA,estado nutricional en menores de 5 anos,clasificacion a y b,2001-11-01,4,9,4,9,13
20604,QUIABAYA,estado nutricional en menores de 5 anos,clasificacion a y b,2001-11-01,1,8,1,8,9
30901,QUILLACOLLO,estado nutricional en menores de 5 anos,clasificacion a y b,2001-11-01,28,6,28,6,34
21002,QUIME,estado nutricional en menores de 5 anos,clasificacion a y b,2001-11-01,1,21,1,21,22
70904,QUIRUSILLAS,estado nutricional en menores de 5 anos,clasificacion a y b,2001-11-01,5,0,5,0,5
50402,RAVELO,estado nutricional en menores de 5 anos,clasificacion a y b,2001-11-01,9,6,9,6,15
80301,REYES,estado nutricional en menores de 5 anos,clasificacion a y b,2001-11-01,7,16,7,16,23
80201,RIBERALTA,estado nutricional en menores de 5 anos,clasificacion a y b,2001-11-01,206,68,206,68,274
70503,ROBORE,estado nutricional en menores de 5 anos,clasificacion a y b,2001-11-01,9,67,9,67,76
80304,RURRENABAQUE,estado nutricional en menores de 5 anos,clasificacion a y b,2001-11-01,57,65,57,65,122
40901,SABAYA,estado nutricional en menores de 5 anos,clasificacion a y b,2001-11-01,1,0,1,0,1
31001,SACABA,estado nutricional en menores de 5 anos,clasificacion a y b,2001-11-01,54,21,54,21,75
30404,SACABAMBA,estado nutricional en menores de 5 anos,clasificacion a y b,2001-11-01,2,7,2,7,9
50701,SACACA,estado nutricional en menores de 5 anos,clasificacion a y b,2001-11-01,2,13,2,13,15
71302,SAIPINA,estado nutricional en menores de 5 anos,clasificacion a y b,2001-11-01,49,31,49,31,80
40801,SALINAS DE GARCI MENDOZA,estado nutricional en menores de 5 anos,clasificacion a y b,2001-11-01,2,1,2,1,3
70901,SAMAIPATA,estado nutricional en menores de 5 anos,clasificacion a y b,2001-11-01,33,7,33,7,40
51601,SAN AGUSTIN,estado nutricional en menores de 5 anos,clasificacion a y b,2001-11-01,1,6,1,6,7
80602,SAN ANDRES,estado nutricional en menores de 5 anos,clasificacion a y b,2001-11-01,1,5,1,5,6
51003,SAN ANTONIO DE ESMORUCO,estado nutricional en menores de 5 anos,clasificacion a y b,2001-11-01,0,4,0,4,4
71105,SAN ANTONIO DE LOMERIO,estado nutricional en menores de 5 anos,clasificacion a y b,2001-11-01,6,1,6,1,7
31403,SAN BENITO,estado nutricional en menores de 5 anos,clasificacion a y b,2001-11-01,1,19,1,19,20
80302,SAN BORJA,estado nutricional en menores de 5 anos,clasificacion a y b,2001-11-01,109,19,109,19,128
21502,SAN BUENA VENTURA,estado nutricional en menores de 5 anos,clasificacion a y b,2001-11-01,33,20,33,20,53
70402,SAN CARLOS,estado nutricional en menores de 5 anos,clasificacion a y b,2001-11-01,25,3,25,3,28
80501,SAN IGNACIO,estado nutricional en menores de 5 anos,clasificacion a y b,2001-11-01,24,63,24,63,87
70301,SAN IGNACIO DE VELASCO,estado nutricional en menores de 5 anos,clasificacion a y b,2001-11-01,162,32,162,32,194
80102,SAN JAVIER(BNI),estado nutricional en menores de 5 anos,clasificacion a y b,2001-11-01,3,15,3,15,18
71102,SAN JAVIER(STC),estado nutricional en menores de 5 anos,clasificacion a y b,2001-11-01,31,19,31,19,50
80701,SAN JOAQUIN,estado nutricional en menores de 5 anos,clasificacion a y b,2001-11-01,1,11,1,11,12
70501,SAN JOSE DE CHIQUITOS,estado nutricional en menores de 5 anos,clasificacion a y b,2001-11-01,7,3,7,3,10
71104,SAN JULIAN,estado nutricional en menores de 5 anos,clasificacion a y b,2001-11-01,97,57,97,57,154
90302,SAN LORENZO(PND),estado nutricional en menores de 5 anos,clasificacion a y b,2001-11-01,2,1,2,1,3
60501,SAN LORENZO(TJA),estado nutricional en menores de 5 anos,clasificacion a y b,2001-11-01,30,18,30,18,48
10702,SAN LUCAS,estado nutricional en menores de 5 anos,clasificacion a y b,2001-11-01,17,40,17,40,57
71201,SAN MATIAS,estado nutricional en menores de 5 anos,clasificacion a y b,2001-11-01,33,16,33,16,49
70302,SAN MIGUEL DE VELASCO,estado nutricional en menores de 5 anos,clasificacion a y b,2001-11-01,32,8,32,8,40
51001,SAN PABLO DE LIPEZ,estado nutricional en menores de 5 anos,clasificacion a y b,2001-11-01,0,6,0,6,6
50501,SAN PEDRO DE BUENA VISTA,estado nutricional en menores de 5 anos,clasificacion a y b,2001-11-01,6,23,6,23,29
21801,SAN PEDRO DE CURAHUARA,estado nutricional en menores de 5 anos,clasificacion a y b,2001-11-01,0,10,0,10,10
50902,SAN PEDRO DE QUEMES,estado nutricional en menores de 5 anos,clasificacion a y b,2001-11-01,0,2,0,2,2
21702,SAN PEDRO DE TIQUINA,estado nutricional en menores de 5 anos,clasificacion a y b,2001-11-01,3,23,3,23,26
70303,SAN RAFAEL,estado nutricional en menores de 5 anos,clasificacion a y b,2001-11-01,17,6,17,6,23
80702,SAN RAMON,estado nutricional en menores de 5 anos,clasificacion a y b,2001-11-01,50,88,50,88,138
80702,SAN RAMON,estado nutricional en menores de 5 anos,clasificacion a y b,2001-11-01,5,9,5,9,14
80401,SANTA ANA,estado nutricional en menores de 5 anos,clasificacion a y b,2001-11-01,4,20,4,20,24
70101,SANTA CRUZ DE LA SIERRA,estado nutricional en menores de 5 anos,clasificacion a y b,2001-11-01,924,570,924,570,1494
80303,SANTA ROSA,estado nutricional en menores de 5 anos,clasificacion a y b,2001-11-01,5,2,5,2,7
70602,SANTA ROSA DEL SARA,estado nutricional en menores de 5 anos,clasificacion a y b,2001-11-01,12,20,12,20,32
41401,SANTIAGO DE HUARI,estado nutricional en menores de 5 anos,clasificacion a y b,2001-11-01,3,0,3,0,3
21901,SANTIAGO DE MACHACA,estado nutricional en menores de 5 anos,clasificacion a y b,2001-11-01,0,2,0,2,2
30702,SANTIVAÃ‘ES,estado nutricional en menores de 5 anos,clasificacion a y b,2001-11-01,4,1,4,1,5
20902,SAPAHAQUI,estado nutricional en menores de 5 anos,clasificacion a y b,2001-11-01,3,5,3,5,8
90303,SENA,estado nutricional en menores de 5 anos,clasificacion a y b,2001-11-01,1,0,1,0,1
21301,SICA SICA (VILLA AROMA),estado nutricional en menores de 5 anos,clasificacion a y b,2001-11-01,17,10,17,10,27
30703,SICAYA,estado nutricional en menores de 5 anos,clasificacion a y b,2001-11-01,1,3,1,3,4
30902,SIPE SIPE,estado nutricional en menores de 5 anos,clasificacion a y b,2001-11-01,99,30,99,30,129
10403,SOPACHUY,estado nutricional en menores de 5 anos,clasificacion a y b,2001-11-01,9,14,9,14,23
20601,SORATA,estado nutricional en menores de 5 anos,clasificacion a y b,2001-11-01,7,32,7,32,39
10101,SUCRE,estado nutricional en menores de 5 anos,clasificacion a y b,2001-11-01,67,296,67,296,363
20603,TACACOMA,estado nutricional en menores de 5 anos,clasificacion a y b,2001-11-01,14,13,14,13,27
50303,TACOBAMBA,estado nutricional en menores de 5 anos,clasificacion a y b,2001-11-01,10,20,10,20,30
30602,TACOPAYA,estado nutricional en menores de 5 anos,clasificacion a y b,2001-11-01,0,4,0,4,4
51402,TAHUA,estado nutricional en menores de 5 anos,clasificacion a y b,2001-11-01,0,2,0,2,2
31101,TAPACARI,estado nutricional en menores de 5 anos,clasificacion a y b,2001-11-01,12,25,12,25,37
10601,TARABUCO,estado nutricional en menores de 5 anos,clasificacion a y b,2001-11-01,36,32,36,32,68
30401,TARATA,estado nutricional en menores de 5 anos,clasificacion a y b,2001-11-01,2,16,2,16,18
60101,TARIJA,estado nutricional en menores de 5 anos,clasificacion a y b,2001-11-01,205,474,205,474,679
10202,TARVITA,estado nutricional en menores de 5 anos,clasificacion a y b,2001-11-01,5,7,5,7,12
20803,TIAWANACU,estado nutricional en menores de 5 anos,clasificacion a y b,2001-11-01,10,3,10,3,13
50102,TINGUIPAYA,estado nutricional en menores de 5 anos,clasificacion a y b,2001-11-01,10,5,10,5,15
20606,TIPUANI,estado nutricional en menores de 5 anos,clasificacion a y b,2001-11-01,27,1,27,1,28
30903,TIQUIPAYA,estado nutricional en menores de 5 anos,clasificacion a y b,2001-11-01,2,18,2,18,20
31601,TIRAQUE (CBBA),estado nutricional en menores de 5 anos,clasificacion a y b,2001-11-01,55,52,55,52,107
30802,TOCO,estado nutricional en menores de 5 anos,clasificacion a y b,2001-11-01,1,5,1,5,6
41001,TOLEDO,estado nutricional en menores de 5 anos,clasificacion a y b,2001-11-01,14,3,14,3,17
51202,TOMAVE,estado nutricional en menores de 5 anos,clasificacion a y b,2001-11-01,6,10,6,10,16
10402,TOMINA,estado nutricional en menores de 5 anos,clasificacion a y b,2001-11-01,10,37,10,37,47
50502,TORO TORO,estado nutricional en menores de 5 anos,clasificacion a y b,2001-11-01,3,5,3,5,8
31201,TOTORA(CBBA),estado nutricional en menores de 5 anos,clasificacion a y b,2001-11-01,15,13,15,13,28
41301,TOTORA(ORR),estado nutricional en menores de 5 anos,clasificacion a y b,2001-11-01,1,4,1,4,5
70802,TRIGAL,estado nutricional en menores de 5 anos,clasificacion a y b,2001-11-01,1,1,1,1,2
80101,TRINIDAD,estado nutricional en menores de 5 anos,clasificacion a y b,2001-11-01,143,180,143,180,323
50801,TUPIZA,estado nutricional en menores de 5 anos,clasificacion a y b,2001-11-01,23,79,23,79,102
40402,TURCO,estado nutricional en menores de 5 anos,clasificacion a y b,2001-11-01,7,0,7,0,7
21302,UMALA,estado nutricional en menores de 5 anos,clasificacion a y b,2001-11-01,1,1,1,1,2
50201,UNCIA,estado nutricional en menores de 5 anos,clasificacion a y b,2001-11-01,10,70,10,70,80
60401,URIONDO (A. CONCEPCION),estado nutricional en menores de 5 anos,clasificacion a y b,2001-11-01,11,32,11,32,43
71502,URUBICHA,estado nutricional en menores de 5 anos,clasificacion a y b,2001-11-01,0,11,0,11,11
51201,UYUNI,estado nutricional en menores de 5 anos,clasificacion a y b,2001-11-01,6,19,6,19,25
30502,VACAS,estado nutricional en menores de 5 anos,clasificacion a y b,2001-11-01,1,9,1,9,10
70801,VALLEGRANDE,estado nutricional en menores de 5 anos,clasificacion a y b,2001-11-01,34,57,34,57,91
20801,VIACHA,estado nutricional en menores de 5 anos,clasificacion a y b,2001-11-01,24,60,24,60,84
31302,VILA VILA,estado nutricional en menores de 5 anos,clasificacion a y b,2001-11-01,3,5,3,5,8
60303,VILLA MONTES,estado nutricional en menores de 5 anos,clasificacion a y b,2001-11-01,18,7,18,7,25
90502,VILLA NUEVA (LOMA ALTA),estado nutricional en menores de 5 anos,clasificacion a y b,2001-11-01,2,0,2,0,2
31402,VILLA RIVERO,estado nutricional en menores de 5 anos,clasificacion a y b,2001-11-01,0,13,0,13,13
10801,VILLA SERRANO,estado nutricional en menores de 5 anos,clasificacion a y b,2001-11-01,11,28,11,28,39
31003,VILLA TUNARI,estado nutricional en menores de 5 anos,clasificacion a y b,2001-11-01,51,58,51,58,109
11001,VILLA VACA GUZMAN (MUYUPAMPA),estado nutricional en menores de 5 anos,clasificacion a y b,2001-11-01,15,40,15,40,55
51501,VILLAZON,estado nutricional en menores de 5 anos,clasificacion a y b,2001-11-01,26,84,26,84,110
30904,VINTO,estado nutricional en menores de 5 anos,clasificacion a y b,2001-11-01,64,8,64,8,72
50602,VITICHI,estado nutricional en menores de 5 anos,clasificacion a y b,2001-11-01,5,8,5,8,13
70201,WARNES,estado nutricional en menores de 5 anos,clasificacion a y b,2001-11-01,104,50,104,50,154
20903,YACO,estado nutricional en menores de 5 anos,clasificacion a y b,2001-11-01,5,18,5,18,23
60301,YACUIBA,estado nutricional en menores de 5 anos,clasificacion a y b,2001-11-01,144,13,144,13,157
10602,YAMPARAEZ,estado nutricional en menores de 5 anos,clasificacion a y b,2001-11-01,9,28,9,28,37
21103,YANACACHI,estado nutricional en menores de 5 anos,clasificacion a y b,2001-11-01,10,3,10,3,13
70403,YAPACANI,estado nutricional en menores de 5 anos,clasificacion a y b,2001-11-01,120,40,120,40,160
50103,YOCALLA,estado nutricional en menores de 5 anos,clasificacion a y b,2001-11-01,1,0,1,0,1
10102,YOTALA,estado nutricional en menores de 5 anos,clasificacion a y b,2001-11-01,8,39,8,39,47
60402,YUNCHARA,estado nutricional en menores de 5 anos,clasificacion a y b,2001-11-01,1,0,1,0,1
10301,ZUDAÃ‘EZ,estado nutricional en menores de 5 anos,clasificacion a y b,2001-11-01,5,19,5,19,24
51302,ACACIO,estado nutricional en menores de 5 anos,clasificacion a y b,2001-12-01,4,2,4,2,6
20201,ACHACACHI,estado nutricional en menores de 5 anos,clasificacion a y b,2001-12-01,12,51,12,51,63
20104,ACHOCALLA,estado nutricional en menores de 5 anos,clasificacion a y b,2001-12-01,6,1,6,1,7
30201,AIQUILE,estado nutricional en menores de 5 anos,clasificacion a y b,2001-12-01,1,3,1,3,4
10404,ALCALA,estado nutricional en menores de 5 anos,clasificacion a y b,2001-12-01,4,7,4,7,11
20202,ANCORAIMES,estado nutricional en menores de 5 anos,clasificacion a y b,2001-12-01,4,14,4,14,18
41201,ANDAMARCA,estado nutricional en menores de 5 anos,clasificacion a y b,2001-12-01,2,1,2,1,3
30402,ANZALDO,estado nutricional en menores de 5 anos,clasificacion a y b,2001-12-01,1,4,1,4,5
20701,APOLO,estado nutricional en menores de 5 anos,clasificacion a y b,2001-12-01,12,0,12,0,12
51301,ARAMPAMPA,estado nutricional en menores de 5 anos,clasificacion a y b,2001-12-01,1,2,1,2,3
30501,ARANI,estado nutricional en menores de 5 anos,clasificacion a y b,2001-12-01,4,2,4,2,6
30403,ARBIETO,estado nutricional en menores de 5 anos,clasificacion a y b,2001-12-01,3,5,3,5,8
30601,ARQUE,estado nutricional en menores de 5 anos,clasificacion a y b,2001-12-01,4,1,4,1,5
71501,ASCENCION DE GUARAYOS,estado nutricional en menores de 5 anos,clasificacion a y b,2001-12-01,62,25,62,25,87
50802,ATOCHA,estado nutricional en menores de 5 anos,clasificacion a y b,2001-12-01,1,6,1,6,7
20503,AUCAPATA,estado nutricional en menores de 5 anos,clasificacion a y b,2001-12-01,5,0,5,0,5
20502,AYATA,estado nutricional en menores de 5 anos,clasificacion a y b,2001-12-01,2,2,2,2,4
21303,AYO AYO,estado nutricional en menores de 5 anos,clasificacion a y b,2001-12-01,18,1,18,1,19
30301,AYOPAYA (V. DE INDEPENDENCIA),estado nutricional en menores de 5 anos,clasificacion a y b,2001-12-01,7,1,7,1,8
10201,AZURDUY,estado nutricional en menores de 5 anos,clasificacion a y b,2001-12-01,7,12,7,12,19
21203,BATALLAS,estado nutricional en menores de 5 anos,clasificacion a y b,2001-12-01,8,56,8,56,64
80802,BAURES,estado nutricional en menores de 5 anos,clasificacion a y b,2001-12-01,8,13,8,13,21
50104,BELEN DE URMIRI,estado nutricional en menores de 5 anos,clasificacion a y b,2001-12-01,5,2,5,2,7
90104,BELLA FLOR,estado nutricional en menores de 5 anos,clasificacion a y b,2001-12-01,6,9,6,9,15
60202,BERMEJO,estado nutricional en menores de 5 anos,clasificacion a y b,2001-12-01,9,24,9,24,33
50301,BETANZOS,estado nutricional en menores de 5 anos,clasificacion a y b,2001-12-01,11,19,11,19,30
31501,BOLIVAR,estado nutricional en menores de 5 anos,clasificacion a y b,2001-12-01,2,5,2,5,7
70707,BOYUIBE,estado nutricional en menores de 5 anos,clasificacion a y b,2001-12-01,4,11,4,11,15
70401,BUENA VISTA,estado nutricional en menores de 5 anos,clasificacion a y b,2001-12-01,83,19,83,19,102
70703,CABEZAS,estado nutricional en menores de 5 anos,clasificacion a y b,2001-12-01,14,26,14,26,40
20905,CAIROMA,estado nutricional en menores de 5 anos,clasificacion a y b,2001-12-01,0,2,0,2,2
51102,"CAIZA ""D""",estado nutricional en menores de 5 anos,clasificacion a y b,2001-12-01,4,5,4,5,9
21003,CAJUATA,estado nutricional en menores de 5 anos,clasificacion a y b,2001-12-01,6,0,6,0,6
20303,CALACOTO,estado nutricional en menores de 5 anos,clasificacion a y b,2001-12-01,0,3,0,3,3
21304,CALAMARCA,estado nutricional en menores de 5 anos,clasificacion a y b,2001-12-01,1,9,1,9,10
10701,CAMARGO,estado nutricional en menores de 5 anos,clasificacion a y b,2001-12-01,16,15,16,15,31
10901,CAMATAQUI (C. VILLA ABECIA),estado nutricional en menores de 5 anos,clasificacion a y b,2001-12-01,1,3,1,3,4
70706,CAMIRI,estado nutricional en menores de 5 anos,clasificacion a y b,2001-12-01,65,36,65,36,101
30701,CAPINOTA,estado nutricional en menores de 5 anos,clasificacion a y b,2001-12-01,32,7,32,7,39
20302,CAQUIAVIRI,estado nutricional en menores de 5 anos,clasificacion a y b,2001-12-01,10,1,10,1,11
40102,CARACOLLO,estado nutricional en menores de 5 anos,clasificacion a y b,2001-12-01,6,2,6,2,8
22001,CARANAVI,estado nutricional en menores de 5 anos,clasificacion a y b,2001-12-01,83,27,83,27,110
60302,CARAPARI,estado nutricional en menores de 5 anos,clasificacion a y b,2001-12-01,8,16,8,16,24
50702,CARIPUYO,estado nutricional en menores de 5 anos,clasificacion a y b,2001-12-01,0,3,0,3,3
40201,CHALLAPATA,estado nutricional en menores de 5 anos,clasificacion a y b,2001-12-01,8,4,8,4,12
50302,CHAQUI,estado nutricional en menores de 5 anos,clasificacion a y b,2001-12-01,6,23,6,23,29
70702,CHARAGUA,estado nutricional en menores de 5 anos,clasificacion a y b,2001-12-01,16,83,16,83,99
50202,CHAYANTA,estado nutricional en menores de 5 anos,clasificacion a y b,2001-12-01,6,9,6,9,15
31204,CHIMORE,estado nutricional en menores de 5 anos,clasificacion a y b,2001-12-01,18,14,18,14,32
40302,CHOQUE COTA,estado nutricional en menores de 5 anos,clasificacion a y b,2001-12-01,0,1,0,1,1
21101,CHULUMANI (V. DE LA LIBERTAD),estado nutricional en menores de 5 anos,clasificacion a y b,2001-12-01,8,7,8,7,15
20501,CHUMA,estado nutricional en menores de 5 anos,clasificacion a y b,2001-12-01,2,1,2,1,3
30801,CLIZA,estado nutricional en menores de 5 anos,clasificacion a y b,2001-12-01,2,12,2,12,14
90101,COBIJA,estado nutricional en menores de 5 anos,clasificacion a y b,2001-12-01,47,13,47,13,60
30101,COCHABAMBA,estado nutricional en menores de 5 anos,clasificacion a y b,2001-12-01,1253,934,1253,934,2187
40902,COIPASA,estado nutricional en menores de 5 anos,clasificacion a y b,2001-12-01,1,1,1,1,2
30905,COLCAPIRHUA,estado nutricional en menores de 5 anos,clasificacion a y b,2001-12-01,61,14,61,14,75
50901,"COLCHA ""K""",estado nutricional en menores de 5 anos,clasificacion a y b,2001-12-01,6,11,6,11,17
21307,COLLANA,estado nutricional en menores de 5 anos,clasificacion a y b,2001-12-01,0,1,0,1,1
31002,COLOMI,estado nutricional en menores de 5 anos,clasificacion a y b,2001-12-01,25,12,25,12,37
70603,COLPA BELGICA,estado nutricional en menores de 5 anos,clasificacion a y b,2001-12-01,54,0,54,0,54
50401,COLQUECHACA,estado nutricional en menores de 5 anos,clasificacion a y b,2001-12-01,4,6,4,6,10
21306,COLQUENCHA,estado nutricional en menores de 5 anos,clasificacion a y b,2001-12-01,7,1,7,1,8
21004,COLQUIRI,estado nutricional en menores de 5 anos,clasificacion a y b,2001-12-01,12,17,12,17,29
20304,COMANCHE,estado nutricional en menores de 5 anos,clasificacion a y b,2001-12-01,1,2,1,2,3
71301,COMARAPA,estado nutricional en menores de 5 anos,clasificacion a y b,2001-12-01,27,9,27,9,36
20605,COMBAYA,estado nutricional en menores de 5 anos,clasificacion a y b,2001-12-01,2,1,2,1,3
71101,CONCEPCION,estado nutricional en menores de 5 anos,clasificacion a y b,2001-12-01,7,13,7,13,20
21701,COPACABANA,estado nutricional en menores de 5 anos,clasificacion a y b,2001-12-01,3,12,3,12,15
21402,CORIPATA,estado nutricional en menores de 5 anos,clasificacion a y b,2001-12-01,5,29,5,29,34
20301,CORO CORO,estado nutricional en menores de 5 anos,clasificacion a y b,2001-12-01,10,9,10,9,19
21401,COROICO,estado nutricional en menores de 5 anos,clasificacion a y b,2001-12-01,13,2,13,2,15
40301,CORQUE,estado nutricional en menores de 5 anos,clasificacion a y b,2001-12-01,3,0,3,0,3
50601,COTAGAITA,estado nutricional en menores de 5 anos,clasificacion a y b,2001-12-01,7,21,7,21,28
70102,COTOCA,estado nutricional en menores de 5 anos,clasificacion a y b,2001-12-01,21,93,21,93,114
31405,CUCHUMUELA (V. G. VILLARROEL),estado nutricional en menores de 5 anos,clasificacion a y b,2001-12-01,2,2,2,2,4
70704,CUEVO,estado nutricional en menores de 5 anos,clasificacion a y b,2001-12-01,11,1,11,1,12
10902,CULPINA,estado nutricional en menores de 5 anos,clasificacion a y b,2001-12-01,11,41,11,41,52
40401,CURAHUARA DE CARANGAS,estado nutricional en menores de 5 anos,clasificacion a y b,2001-12-01,1,0,1,0,1
21602,CURVA,estado nutricional en menores de 5 anos,clasificacion a y b,2001-12-01,1,0,1,0,1
20804,DESAGUADERO,estado nutricional en menores de 5 anos,clasificacion a y b,2001-12-01,0,5,0,5,5
20105,EL ALTO,estado nutricional en menores de 5 anos,clasificacion a y b,2001-12-01,432,312,432,312,744
71503,EL PUENTE(STC),estado nutricional en menores de 5 anos,clasificacion a y b,2001-12-01,16,14,16,14,30
60502,EL PUENTE(TJA),estado nutricional en menores de 5 anos,clasificacion a y b,2001-12-01,2,7,2,7,9
70105,EL TORNO,estado nutricional en menores de 5 anos,clasificacion a y b,2001-12-01,23,74,23,74,97
10405,EL VILLAR,estado nutricional en menores de 5 anos,clasificacion a y b,2001-12-01,5,13,5,13,18
60601,ENTRE RIOS,estado nutricional en menores de 5 anos,clasificacion a y b,2001-12-01,16,21,16,21,37
41101,EUCALIPTUS,estado nutricional en menores de 5 anos,clasificacion a y b,2001-12-01,1,1,1,1,2
80402,EXALTACION,estado nutricional en menores de 5 anos,clasificacion a y b,2001-12-01,2,4,2,4,6
90203,FILADELFIA,estado nutricional en menores de 5 anos,clasificacion a y b,2001-12-01,2,9,2,9,11
71002,GENERAL SAAVEDRA,estado nutricional en menores de 5 anos,clasificacion a y b,2001-12-01,17,77,17,77,94
21601,GRAL. J.J. PEREZ (CHARAZANI),estado nutricional en menores de 5 anos,clasificacion a y b,2001-12-01,0,1,0,1,1
20602,GUANAY,estado nutricional en menores de 5 anos,clasificacion a y b,2001-12-01,17,46,17,46,63
20802,GUAQUI,estado nutricional en menores de 5 anos,clasificacion a y b,2001-12-01,1,8,1,8,9
80202,GUAYARAMERIN,estado nutricional en menores de 5 anos,clasificacion a y b,2001-12-01,56,11,56,11,67
70705,GUTIERREZ,estado nutricional en menores de 5 anos,clasificacion a y b,2001-12-01,40,62,40,62,102
10502,HUACARETA,estado nutricional en menores de 5 anos,clasificacion a y b,2001-12-01,4,45,4,45,49
11002,HUACAYA (VILLA DE HUACAYA),estado nutricional en menores de 5 anos,clasificacion a y b,2001-12-01,0,1,0,1,1
40501,HUACHACALLA,estado nutricional en menores de 5 anos,clasificacion a y b,2001-12-01,0,1,0,1,1
40701,HUANUNI,estado nutricional en menores de 5 anos,clasificacion a y b,2001-12-01,5,0,5,0,5
80803,HUARACAJE,estado nutricional en menores de 5 anos,clasificacion a y b,2001-12-01,13,8,13,8,21
10304,ICLA,estado nutricional en menores de 5 anos,clasificacion a y b,2001-12-01,14,16,14,16,30
10703,INCAHUASI,estado nutricional en menores de 5 anos,clasificacion a y b,2001-12-01,3,9,3,9,12
21001,INQUISIVI,estado nutricional en menores de 5 anos,clasificacion a y b,2001-12-01,1,7,1,7,8
21102,IRUPANA (VILLA DE LANZA),estado nutricional en menores de 5 anos,clasificacion a y b,2001-12-01,4,31,4,31,35
21501,IXIAMAS,estado nutricional en menores de 5 anos,clasificacion a y b,2001-12-01,16,8,16,8,24
21105,LA ASUNTA,estado nutricional en menores de 5 anos,clasificacion a y b,2001-12-01,18,12,18,12,30
70104,LA GUARDIA,estado nutricional en menores de 5 anos,clasificacion a y b,2001-12-01,28,107,28,107,135
20101,LA PAZ,estado nutricional en menores de 5 anos,clasificacion a y b,2001-12-01,405,376,405,376,781
70701,LAGUNILLAS,estado nutricional en menores de 5 anos,clasificacion a y b,2001-12-01,14,16,14,16,30
21202,LAJA,estado nutricional en menores de 5 anos,clasificacion a y b,2001-12-01,4,19,4,19,23
10903,LAS CARRERAS,estado nutricional en menores de 5 anos,clasificacion a y b,2001-12-01,0,19,0,19,19
50203,LLALLAGUA,estado nutricional en menores de 5 anos,clasificacion a y b,2001-12-01,6,13,6,13,19
51401,LLICA,estado nutricional en menores de 5 anos,clasificacion a y b,2001-12-01,0,2,0,2,2
80601,LORETO,estado nutricional en menores de 5 anos,clasificacion a y b,2001-12-01,1,7,1,7,8
20901,LURIBAY,estado nutricional en menores de 5 anos,clasificacion a y b,2001-12-01,5,15,5,15,20
40702,MACHACAMARCA,estado nutricional en menores de 5 anos,clasificacion a y b,2001-12-01,15,9,15,9,24
11003,MACHARETI,estado nutricional en menores de 5 anos,clasificacion a y b,2001-12-01,13,57,13,57,70
80801,MAGDALENA,estado nutricional en menores de 5 anos,clasificacion a y b,2001-12-01,5,3,5,3,8
70903,MAIRANA,estado nutricional en menores de 5 anos,clasificacion a y b,2001-12-01,41,7,41,7,48
20103,MECAPACA,estado nutricional en menores de 5 anos,clasificacion a y b,2001-12-01,1,3,1,3,4
71003,MINEROS,estado nutricional en menores de 5 anos,clasificacion a y b,2001-12-01,27,147,27,147,174
31301,MIZQUE,estado nutricional en menores de 5 anos,clasificacion a y b,2001-12-01,5,4,5,4,9
20402,MOCOMOCO,estado nutricional en menores de 5 anos,clasificacion a y b,2001-12-01,4,5,4,5,9
51002,MOJINETE,estado nutricional en menores de 5 anos,clasificacion a y b,2001-12-01,0,1,0,1,1
10303,MOJOCOYA,estado nutricional en menores de 5 anos,clasificacion a y b,2001-12-01,7,44,7,44,51
10501,MONTEAGUDO,estado nutricional en menores de 5 anos,clasificacion a y b,2001-12-01,35,143,35,143,178
71001,MONTERO,estado nutricional en menores de 5 anos,clasificacion a y b,2001-12-01,75,298,75,298,373
70803,MORO MORO,estado nutricional en menores de 5 anos,clasificacion a y b,2001-12-01,10,4,10,4,14
30302,MOROCHATA,estado nutricional en menores de 5 anos,clasificacion a y b,2001-12-01,9,9,9,9,18
90401,NACEBE (SANTA ROSA DEL ABUNA),estado nutricional en menores de 5 anos,clasificacion a y b,2001-12-01,2,0,2,0,2
90501,NUEVO MANOA (NUEVA ESPERANZA),estado nutricional en menores de 5 anos,clasificacion a y b,2001-12-01,2,0,2,0,2
50404,OCURI,estado nutricional en menores de 5 anos,clasificacion a y b,2001-12-01,8,9,8,9,17
70202,OKINAWA,estado nutricional en menores de 5 anos,clasificacion a y b,2001-12-01,34,8,34,8,42
30203,OMEREQUE,estado nutricional en menores de 5 anos,clasificacion a y b,2001-12-01,0,13,0,13,13
40101,ORURO,estado nutricional en menores de 5 anos,clasificacion a y b,2001-12-01,64,222,64,222,286
60201,PADCAYA,estado nutricional en menores de 5 anos,clasificacion a y b,2001-12-01,19,22,19,22,41
10401,PADILLA,estado nutricional en menores de 5 anos,clasificacion a y b,2001-12-01,9,42,9,42,51
70502,PAILON,estado nutricional en menores de 5 anos,clasificacion a y b,2001-12-01,1,4,1,4,5
20102,PALCA,estado nutricional en menores de 5 anos,clasificacion a y b,2001-12-01,30,9,30,9,39
21104,PALOS BLANCOS,estado nutricional en menores de 5 anos,clasificacion a y b,2001-12-01,16,9,16,9,25
40802,PAMPA AULLAGAS,estado nutricional en menores de 5 anos,clasificacion a y b,2001-12-01,1,0,1,0,1
70902,PAMPA GRANDE,estado nutricional en menores de 5 anos,clasificacion a y b,2001-12-01,9,14,9,14,23
21802,PAPEL PAMPA,estado nutricional en menores de 5 anos,clasificacion a y b,2001-12-01,0,6,0,6,6
30202,PASORAPA,estado nutricional en menores de 5 anos,clasificacion a y b,2001-12-01,1,3,1,3,4
21305,PATACAMAYA,estado nutricional en menores de 5 anos,clasificacion a y b,2001-12-01,21,6,21,6,27
40602,PAZÃ‘A,estado nutricional en menores de 5 anos,clasificacion a y b,2001-12-01,2,0,2,0,2
20702,PELECHUCO,estado nutricional en menores de 5 anos,clasificacion a y b,2001-12-01,0,1,0,1,1
50403,POCOATA,estado nutricional en menores de 5 anos,clasificacion a y b,2001-12-01,9,11,9,11,20
31203,POCONA,estado nutricional en menores de 5 anos,clasificacion a y b,2001-12-01,4,0,4,0,4
31202,POJO (CBBA),estado nutricional en menores de 5 anos,clasificacion a y b,2001-12-01,75,54,75,54,129
40601,POOPO,estado nutricional en menores de 5 anos,clasificacion a y b,2001-12-01,0,2,0,2,2
51203,PORCO,estado nutricional en menores de 5 anos,clasificacion a y b,2001-12-01,2,7,2,7,9
10103,POROMA,estado nutricional en menores de 5 anos,clasificacion a y b,2001-12-01,1,17,1,17,18
70103,PORONGO,estado nutricional en menores de 5 anos,clasificacion a y b,2001-12-01,3,19,3,19,22
70601,PORTACHUELO,estado nutricional en menores de 5 anos,clasificacion a y b,2001-12-01,41,3,41,3,44
90102,PORVENIR,estado nutricional en menores de 5 anos,clasificacion a y b,2001-12-01,2,8,2,8,10
70804,POSTRER VALLE,estado nutricional en menores de 5 anos,clasificacion a y b,2001-12-01,12,12,12,12,24
50101,POTOSI,estado nutricional en menores de 5 anos,clasificacion a y b,2001-12-01,35,55,35,55,90
10302,PRESTO,estado nutricional en menores de 5 anos,clasificacion a y b,2001-12-01,5,15,5,15,20
21201,PUCARANI,estado nutricional en menores de 5 anos,clasificacion a y b,2001-12-01,5,21,5,21,26
20401,PUERTO ACOSTA,estado nutricional en menores de 5 anos,clasificacion a y b,2001-12-01,14,6,14,6,20
20403,PUERTO CARABUCO,estado nutricional en menores de 5 anos,clasificacion a y b,2001-12-01,16,1,16,1,17
90301,PUERTO GONZALO MORENO,estado nutricional en menores de 5 anos,clasificacion a y b,2001-12-01,2,5,2,5,7
21204,PUERTO PEREZ,estado nutricional en menores de 5 anos,clasificacion a y b,2001-12-01,1,2,1,2,3
71402,PUERTO QUIJARRO,estado nutricional en menores de 5 anos,clasificacion a y b,2001-12-01,38,2,38,2,40
90201,PUERTO RICO,estado nutricional en menores de 5 anos,clasificacion a y b,2001-12-01,2,2,2,2,4
80703,PUERTO SILES,estado nutricional en menores de 5 anos,clasificacion a y b,2001-12-01,2,12,2,12,14
71401,PUERTO SUAREZ,estado nutricional en menores de 5 anos,clasificacion a y b,2001-12-01,54,9,54,9,63
31205,PUERTO VILLARROEL,estado nutricional en menores de 5 anos,clasificacion a y b,2001-12-01,68,26,68,26,94
51101,PUNA,estado nutricional en menores de 5 anos,clasificacion a y b,2001-12-01,9,48,9,48,57
31401,PUNATA,estado nutricional en menores de 5 anos,clasificacion a y b,2001-12-01,0,11,0,11,11
20604,QUIABAYA,estado nutricional en menores de 5 anos,clasificacion a y b,2001-12-01,1,2,1,2,3
30901,QUILLACOLLO,estado nutricional en menores de 5 anos,clasificacion a y b,2001-12-01,18,2,18,2,20
21002,QUIME,estado nutricional en menores de 5 anos,clasificacion a y b,2001-12-01,3,18,3,18,21
50402,RAVELO,estado nutricional en menores de 5 anos,clasificacion a y b,2001-12-01,2,17,2,17,19
80201,RIBERALTA,estado nutricional en menores de 5 anos,clasificacion a y b,2001-12-01,186,63,186,63,249
70503,ROBORE,estado nutricional en menores de 5 anos,clasificacion a y b,2001-12-01,8,25,8,25,33
80304,RURRENABAQUE,estado nutricional en menores de 5 anos,clasificacion a y b,2001-12-01,4,12,4,12,16
40901,SABAYA,estado nutricional en menores de 5 anos,clasificacion a y b,2001-12-01,1,1,1,1,2
31001,SACABA,estado nutricional en menores de 5 anos,clasificacion a y b,2001-12-01,72,4,72,4,76
30404,SACABAMBA,estado nutricional en menores de 5 anos,clasificacion a y b,2001-12-01,1,2,1,2,3
50701,SACACA,estado nutricional en menores de 5 anos,clasificacion a y b,2001-12-01,1,8,1,8,9
71302,SAIPINA,estado nutricional en menores de 5 anos,clasificacion a y b,2001-12-01,43,27,43,27,70
40801,SALINAS DE GARCI MENDOZA,estado nutricional en menores de 5 anos,clasificacion a y b,2001-12-01,2,2,2,2,4
70901,SAMAIPATA,estado nutricional en menores de 5 anos,clasificacion a y b,2001-12-01,32,6,32,6,38
51601,SAN AGUSTIN,estado nutricional en menores de 5 anos,clasificacion a y b,2001-12-01,1,3,1,3,4
80602,SAN ANDRES,estado nutricional en menores de 5 anos,clasificacion a y b,2001-12-01,4,1,4,1,5
71105,SAN ANTONIO DE LOMERIO,estado nutricional en menores de 5 anos,clasificacion a y b,2001-12-01,10,9,10,9,19
31403,SAN BENITO,estado nutricional en menores de 5 anos,clasificacion a y b,2001-12-01,0,3,0,3,3
80302,SAN BORJA,estado nutricional en menores de 5 anos,clasificacion a y b,2001-12-01,56,21,56,21,77
21502,SAN BUENA VENTURA,estado nutricional en menores de 5 anos,clasificacion a y b,2001-12-01,10,15,10,15,25
70402,SAN CARLOS,estado nutricional en menores de 5 anos,clasificacion a y b,2001-12-01,3,8,3,8,11
80501,SAN IGNACIO,estado nutricional en menores de 5 anos,clasificacion a y b,2001-12-01,18,29,18,29,47
70301,SAN IGNACIO DE VELASCO,estado nutricional en menores de 5 anos,clasificacion a y b,2001-12-01,128,26,128,26,154
80102,SAN JAVIER(BNI),estado nutricional en menores de 5 anos,clasificacion a y b,2001-12-01,1,6,1,6,7
71102,SAN JAVIER(STC),estado nutricional en menores de 5 anos,clasificacion a y b,2001-12-01,47,2,47,2,49
80701,SAN JOAQUIN,estado nutricional en menores de 5 anos,clasificacion a y b,2001-12-01,2,8,2,8,10
70501,SAN JOSE DE CHIQUITOS,estado nutricional en menores de 5 anos,clasificacion a y b,2001-12-01,13,7,13,7,20
71104,SAN JULIAN,estado nutricional en menores de 5 anos,clasificacion a y b,2001-12-01,76,102,76,102,178
90302,SAN LORENZO(PND),estado nutricional en menores de 5 anos,clasificacion a y b,2001-12-01,4,1,4,1,5
60501,SAN LORENZO(TJA),estado nutricional en menores de 5 anos,clasificacion a y b,2001-12-01,2,5,2,5,7
10702,SAN LUCAS,estado nutricional en menores de 5 anos,clasificacion a y b,2001-12-01,8,31,8,31,39
71201,SAN MATIAS,estado nutricional en menores de 5 anos,clasificacion a y b,2001-12-01,21,11,21,11,32
70302,SAN MIGUEL DE VELASCO,estado nutricional en menores de 5 anos,clasificacion a y b,2001-12-01,16,2,16,2,18
51001,SAN PABLO DE LIPEZ,estado nutricional en menores de 5 anos,clasificacion a y b,2001-12-01,2,1,2,1,3
50501,SAN PEDRO DE BUENA VISTA,estado nutricional en menores de 5 anos,clasificacion a y b,2001-12-01,3,4,3,4,7
21801,SAN PEDRO DE CURAHUARA,estado nutricional en menores de 5 anos,clasificacion a y b,2001-12-01,3,2,3,2,5
21702,SAN PEDRO DE TIQUINA,estado nutricional en menores de 5 anos,clasificacion a y b,2001-12-01,4,10,4,10,14
70303,SAN RAFAEL,estado nutricional en menores de 5 anos,clasificacion a y b,2001-12-01,13,5,13,5,18
80702,SAN RAMON,estado nutricional en menores de 5 anos,clasificacion a y b,2001-12-01,50,56,50,56,106
80702,SAN RAMON,estado nutricional en menores de 5 anos,clasificacion a y b,2001-12-01,1,5,1,5,6
80401,SANTA ANA,estado nutricional en menores de 5 anos,clasificacion a y b,2001-12-01,75,65,75,65,140
70101,SANTA CRUZ DE LA SIERRA,estado nutricional en menores de 5 anos,clasificacion a y b,2001-12-01,468,525,468,525,993
80303,SANTA ROSA,estado nutricional en menores de 5 anos,clasificacion a y b,2001-12-01,15,3,15,3,18
70602,SANTA ROSA DEL SARA,estado nutricional en menores de 5 anos,clasificacion a y b,2001-12-01,3,11,3,11,14
41401,SANTIAGO DE HUARI,estado nutricional en menores de 5 anos,clasificacion a y b,2001-12-01,10,1,10,1,11
30702,SANTIVAÃ‘ES,estado nutricional en menores de 5 anos,clasificacion a y b,2001-12-01,2,0,2,0,2
20902,SAPAHAQUI,estado nutricional en menores de 5 anos,clasificacion a y b,2001-12-01,5,4,5,4,9
21301,SICA SICA (VILLA AROMA),estado nutricional en menores de 5 anos,clasificacion a y b,2001-12-01,4,13,4,13,17
30703,SICAYA,estado nutricional en menores de 5 anos,clasificacion a y b,2001-12-01,0,5,0,5,5
30902,SIPE SIPE,estado nutricional en menores de 5 anos,clasificacion a y b,2001-12-01,67,30,67,30,97
10403,SOPACHUY,estado nutricional en menores de 5 anos,clasificacion a y b,2001-12-01,11,8,11,8,19
20601,SORATA,estado nutricional en menores de 5 anos,clasificacion a y b,2001-12-01,2,14,2,14,16
10101,SUCRE,estado nutricional en menores de 5 anos,clasificacion a y b,2001-12-01,79,209,79,209,288
31404,TACACHI,estado nutricional en menores de 5 anos,clasificacion a y b,2001-12-01,0,1,0,1,1
20603,TACACOMA,estado nutricional en menores de 5 anos,clasificacion a y b,2001-12-01,4,11,4,11,15
50303,TACOBAMBA,estado nutricional en menores de 5 anos,clasificacion a y b,2001-12-01,9,9,9,9,18
51402,TAHUA,estado nutricional en menores de 5 anos,clasificacion a y b,2001-12-01,0,3,0,3,3
31101,TAPACARI,estado nutricional en menores de 5 anos,clasificacion a y b,2001-12-01,5,7,5,7,12
10601,TARABUCO,estado nutricional en menores de 5 anos,clasificacion a y b,2001-12-01,18,41,18,41,59
30401,TARATA,estado nutricional en menores de 5 anos,clasificacion a y b,2001-12-01,3,14,3,14,17
60101,TARIJA,estado nutricional en menores de 5 anos,clasificacion a y b,2001-12-01,119,257,119,257,376
10202,TARVITA,estado nutricional en menores de 5 anos,clasificacion a y b,2001-12-01,8,27,8,27,35
20803,TIAWANACU,estado nutricional en menores de 5 anos,clasificacion a y b,2001-12-01,8,6,8,6,14
50102,TINGUIPAYA,estado nutricional en menores de 5 anos,clasificacion a y b,2001-12-01,5,8,5,8,13
20606,TIPUANI,estado nutricional en menores de 5 anos,clasificacion a y b,2001-12-01,22,1,22,1,23
30903,TIQUIPAYA,estado nutricional en menores de 5 anos,clasificacion a y b,2001-12-01,0,8,0,8,8
31601,TIRAQUE (CBBA),estado nutricional en menores de 5 anos,clasificacion a y b,2001-12-01,52,32,52,32,84
30803,TOLATA,estado nutricional en menores de 5 anos,clasificacion a y b,2001-12-01,0,1,0,1,1
41001,TOLEDO,estado nutricional en menores de 5 anos,clasificacion a y b,2001-12-01,6,1,6,1,7
51202,TOMAVE,estado nutricional en menores de 5 anos,clasificacion a y b,2001-12-01,6,12,6,12,18
10402,TOMINA,estado nutricional en menores de 5 anos,clasificacion a y b,2001-12-01,12,22,12,22,34
50502,TORO TORO,estado nutricional en menores de 5 anos,clasificacion a y b,2001-12-01,4,7,4,7,11
31201,TOTORA(CBBA),estado nutricional en menores de 5 anos,clasificacion a y b,2001-12-01,31,24,31,24,55
41301,TOTORA(ORR),estado nutricional en menores de 5 anos,clasificacion a y b,2001-12-01,3,6,3,6,9
70802,TRIGAL,estado nutricional en menores de 5 anos,clasificacion a y b,2001-12-01,2,0,2,0,2
80101,TRINIDAD,estado nutricional en menores de 5 anos,clasificacion a y b,2001-12-01,113,166,113,166,279
50801,TUPIZA,estado nutricional en menores de 5 anos,clasificacion a y b,2001-12-01,29,98,29,98,127
40402,TURCO,estado nutricional en menores de 5 anos,clasificacion a y b,2001-12-01,3,1,3,1,4
21302,UMALA,estado nutricional en menores de 5 anos,clasificacion a y b,2001-12-01,1,2,1,2,3
50201,UNCIA,estado nutricional en menores de 5 anos,clasificacion a y b,2001-12-01,2,57,2,57,59
60401,URIONDO (A. CONCEPCION),estado nutricional en menores de 5 anos,clasificacion a y b,2001-12-01,18,27,18,27,45
71502,URUBICHA,estado nutricional en menores de 5 anos,clasificacion a y b,2001-12-01,12,23,12,23,35
51201,UYUNI,estado nutricional en menores de 5 anos,clasificacion a y b,2001-12-01,7,25,7,25,32
30502,VACAS,estado nutricional en menores de 5 anos,clasificacion a y b,2001-12-01,1,2,1,2,3
70801,VALLEGRANDE,estado nutricional en menores de 5 anos,clasificacion a y b,2001-12-01,41,52,41,52,93
20801,VIACHA,estado nutricional en menores de 5 anos,clasificacion a y b,2001-12-01,17,65,17,65,82
31302,VILA VILA,estado nutricional en menores de 5 anos,clasificacion a y b,2001-12-01,0,7,0,7,7
60303,VILLA MONTES,estado nutricional en menores de 5 anos,clasificacion a y b,2001-12-01,17,11,17,11,28
90502,VILLA NUEVA (LOMA ALTA),estado nutricional en menores de 5 anos,clasificacion a y b,2001-12-01,1,0,1,0,1
31402,VILLA RIVERO,estado nutricional en menores de 5 anos,clasificacion a y b,2001-12-01,3,2,3,2,5
10801,VILLA SERRANO,estado nutricional en menores de 5 anos,clasificacion a y b,2001-12-01,5,24,5,24,29
31003,VILLA TUNARI,estado nutricional en menores de 5 anos,clasificacion a y b,2001-12-01,57,61,57,61,118
11001,VILLA VACA GUZMAN (MUYUPAMPA),estado nutricional en menores de 5 anos,clasificacion a y b,2001-12-01,22,33,22,33,55
51501,VILLAZON,estado nutricional en menores de 5 anos,clasificacion a y b,2001-12-01,22,101,22,101,123
30904,VINTO,estado nutricional en menores de 5 anos,clasificacion a y b,2001-12-01,43,7,43,7,50
50602,VITICHI,estado nutricional en menores de 5 anos,clasificacion a y b,2001-12-01,9,10,9,10,19
70201,WARNES,estado nutricional en menores de 5 anos,clasificacion a y b,2001-12-01,70,35,70,35,105
20903,YACO,estado nutricional en menores de 5 anos,clasificacion a y b,2001-12-01,2,7,2,7,9
60301,YACUIBA,estado nutricional en menores de 5 anos,clasificacion a y b,2001-12-01,172,36,172,36,208
10602,YAMPARAEZ,estado nutricional en menores de 5 anos,clasificacion a y b,2001-12-01,10,31,10,31,41
21103,YANACACHI,estado nutricional en menores de 5 anos,clasificacion a y b,2001-12-01,7,13,7,13,20
70403,YAPACANI,estado nutricional en menores de 5 anos,clasificacion a y b,2001-12-01,57,29,57,29,86
50103,YOCALLA,estado nutricional en menores de 5 anos,clasificacion a y b,2001-12-01,1,0,1,0,1
10102,YOTALA,estado nutricional en menores de 5 anos,clasificacion a y b,2001-12-01,7,51,7,51,58
60402,YUNCHARA,estado nutricional en menores de 5 anos,clasificacion a y b,2001-12-01,3,6,3,6,9
10301,ZUDAÃ‘EZ,estado nutricional en menores de 5 anos,clasificacion a y b,2001-12-01,8,23,8,23,31
51302,ACACIO,estado nutricional en menores de 5 anos,clasificacion a y b,2002-01-01,1,7,1,7,8
20201,ACHACACHI,estado nutricional en menores de 5 anos,clasificacion a y b,2002-01-01,11,39,11,39,50
20104,ACHOCALLA,estado nutricional en menores de 5 anos,clasificacion a y b,2002-01-01,17,2,17,2,19
30201,AIQUILE,estado nutricional en menores de 5 anos,clasificacion a y b,2002-01-01,3,6,3,6,9
10404,ALCALA,estado nutricional en menores de 5 anos,clasificacion a y b,2002-01-01,3,12,3,12,15
20202,ANCORAIMES,estado nutricional en menores de 5 anos,clasificacion a y b,2002-01-01,4,14,4,14,18
41201,ANDAMARCA,estado nutricional en menores de 5 anos,clasificacion a y b,2002-01-01,4,0,4,0,4
40603,ANTEQUERA,estado nutricional en menores de 5 anos,clasificacion a y b,2002-01-01,1,0,1,0,1
30402,ANZALDO,estado nutricional en menores de 5 anos,clasificacion a y b,2002-01-01,0,3,0,3,3
20701,APOLO,estado nutricional en menores de 5 anos,clasificacion a y b,2002-01-01,14,0,14,0,14
51301,ARAMPAMPA,estado nutricional en menores de 5 anos,clasificacion a y b,2002-01-01,4,4,4,4,8
30501,ARANI,estado nutricional en menores de 5 anos,clasificacion a y b,2002-01-01,2,16,2,16,18
30403,ARBIETO,estado nutricional en menores de 5 anos,clasificacion a y b,2002-01-01,3,14,3,14,17
50802,ATOCHA,estado nutricional en menores de 5 anos,clasificacion a y b,2002-01-01,2,5,2,5,7
20502,AYATA,estado nutricional en menores de 5 anos,clasificacion a y b,2002-01-01,2,0,2,0,2
21303,AYO AYO,estado nutricional en menores de 5 anos,clasificacion a y b,2002-01-01,15,4,15,4,19
30301,AYOPAYA (V. DE INDEPENDENCIA),estado nutricional en menores de 5 anos,clasificacion a y b,2002-01-01,19,2,19,2,21
10201,AZURDUY,estado nutricional en menores de 5 anos,clasificacion a y b,2002-01-01,5,21,5,21,26
21203,BATALLAS,estado nutricional en menores de 5 anos,clasificacion a y b,2002-01-01,1,14,1,14,15
80802,BAURES,estado nutricional en menores de 5 anos,clasificacion a y b,2002-01-01,9,14,9,14,23
50104,BELEN DE URMIRI,estado nutricional en menores de 5 anos,clasificacion a y b,2002-01-01,1,1,1,1,2
90104,BELLA FLOR,estado nutricional en menores de 5 anos,clasificacion a y b,2002-01-01,10,0,10,0,10
60202,BERMEJO,estado nutricional en menores de 5 anos,clasificacion a y b,2002-01-01,6,36,6,36,42
50301,BETANZOS,estado nutricional en menores de 5 anos,clasificacion a y b,2002-01-01,25,64,25,64,89
31501,BOLIVAR,estado nutricional en menores de 5 anos,clasificacion a y b,2002-01-01,7,1,7,1,8
90103,BOLPEBRA,estado nutricional en menores de 5 anos,clasificacion a y b,2002-01-01,2,1,2,1,3
70707,BOYUIBE,estado nutricional en menores de 5 anos,clasificacion a y b,2002-01-01,3,7,3,7,10
70401,BUENA VISTA,estado nutricional en menores de 5 anos,clasificacion a y b,2002-01-01,121,24,121,24,145
70703,CABEZAS,estado nutricional en menores de 5 anos,clasificacion a y b,2002-01-01,21,31,21,31,52
20905,CAIROMA,estado nutricional en menores de 5 anos,clasificacion a y b,2002-01-01,4,6,4,6,10
51102,"CAIZA ""D""",estado nutricional en menores de 5 anos,clasificacion a y b,2002-01-01,10,13,10,13,23
21003,CAJUATA,estado nutricional en menores de 5 anos,clasificacion a y b,2002-01-01,10,2,10,2,12
21304,CALAMARCA,estado nutricional en menores de 5 anos,clasificacion a y b,2002-01-01,8,6,8,6,14
10701,CAMARGO,estado nutricional en menores de 5 anos,clasificacion a y b,2002-01-01,19,31,19,31,50
10901,CAMATAQUI (C. VILLA ABECIA),estado nutricional en menores de 5 anos,clasificacion a y b,2002-01-01,4,6,4,6,10
70706,CAMIRI,estado nutricional en menores de 5 anos,clasificacion a y b,2002-01-01,74,31,74,31,105
30701,CAPINOTA,estado nutricional en menores de 5 anos,clasificacion a y b,2002-01-01,45,1,45,1,46
20302,CAQUIAVIRI,estado nutricional en menores de 5 anos,clasificacion a y b,2002-01-01,17,7,17,7,24
40102,CARACOLLO,estado nutricional en menores de 5 anos,clasificacion a y b,2002-01-01,22,9,22,9,31
22001,CARANAVI,estado nutricional en menores de 5 anos,clasificacion a y b,2002-01-01,75,42,75,42,117
41503,CARANGAS,estado nutricional en menores de 5 anos,clasificacion a y b,2002-01-01,0,1,0,1,1
60302,CARAPARI,estado nutricional en menores de 5 anos,clasificacion a y b,2002-01-01,18,23,18,23,41
50702,CARIPUYO,estado nutricional en menores de 5 anos,clasificacion a y b,2002-01-01,4,4,4,4,8
40201,CHALLAPATA,estado nutricional en menores de 5 anos,clasificacion a y b,2002-01-01,11,14,11,14,25
50302,CHAQUI,estado nutricional en menores de 5 anos,clasificacion a y b,2002-01-01,3,34,3,34,37
70702,CHARAGUA,estado nutricional en menores de 5 anos,clasificacion a y b,2002-01-01,27,77,27,77,104
31204,CHIMORE,estado nutricional en menores de 5 anos,clasificacion a y b,2002-01-01,8,15,8,15,23
21101,CHULUMANI (V. DE LA LIBERTAD),estado nutricional en menores de 5 anos,clasificacion a y b,2002-01-01,11,8,11,8,19
20501,CHUMA,estado nutricional en menores de 5 anos,clasificacion a y b,2002-01-01,2,5,2,5,7
30801,CLIZA,estado nutricional en menores de 5 anos,clasificacion a y b,2002-01-01,2,25,2,25,27
90101,COBIJA,estado nutricional en menores de 5 anos,clasificacion a y b,2002-01-01,85,4,85,4,89
30101,COCHABAMBA,estado nutricional en menores de 5 anos,clasificacion a y b,2002-01-01,309,195,309,195,504
30905,COLCAPIRHUA,estado nutricional en menores de 5 anos,clasificacion a y b,2002-01-01,39,29,39,29,68
50901,"COLCHA ""K""",estado nutricional en menores de 5 anos,clasificacion a y b,2002-01-01,3,14,3,14,17
21307,COLLANA,estado nutricional en menores de 5 anos,clasificacion a y b,2002-01-01,1,0,1,0,1
31002,COLOMI,estado nutricional en menores de 5 anos,clasificacion a y b,2002-01-01,8,3,8,3,11
50401,COLQUECHACA,estado nutricional en menores de 5 anos,clasificacion a y b,2002-01-01,2,1,2,1,3
21306,COLQUENCHA,estado nutricional en menores de 5 anos,clasificacion a y b,2002-01-01,13,3,13,3,16
21004,COLQUIRI,estado nutricional en menores de 5 anos,clasificacion a y b,2002-01-01,8,5,8,5,13
20304,COMANCHE,estado nutricional en menores de 5 anos,clasificacion a y b,2002-01-01,1,2,1,2,3
71301,COMARAPA,estado nutricional en menores de 5 anos,clasificacion a y b,2002-01-01,18,12,18,12,30
20605,COMBAYA,estado nutricional en menores de 5 anos,clasificacion a y b,2002-01-01,0,12,0,12,12
71101,CONCEPCION,estado nutricional en menores de 5 anos,clasificacion a y b,2002-01-01,11,30,11,30,41
21701,COPACABANA,estado nutricional en menores de 5 anos,clasificacion a y b,2002-01-01,8,13,8,13,21
21402,CORIPATA,estado nutricional en menores de 5 anos,clasificacion a y b,2002-01-01,9,14,9,14,23
20301,CORO CORO,estado nutricional en menores de 5 anos,clasificacion a y b,2002-01-01,8,6,8,6,14
21401,COROICO,estado nutricional en menores de 5 anos,clasificacion a y b,2002-01-01,12,4,12,4,16
40301,CORQUE,estado nutricional en menores de 5 anos,clasificacion a y b,2002-01-01,5,3,5,3,8
50601,COTAGAITA,estado nutricional en menores de 5 anos,clasificacion a y b,2002-01-01,21,26,21,26,47
70102,COTOCA,estado nutricional en menores de 5 anos,clasificacion a y b,2002-01-01,125,63,125,63,188
31405,CUCHUMUELA (V. G. VILLARROEL),estado nutricional en menores de 5 anos,clasificacion a y b,2002-01-01,1,3,1,3,4
70704,CUEVO,estado nutricional en menores de 5 anos,clasificacion a y b,2002-01-01,26,4,26,4,30
10902,CULPINA,estado nutricional en menores de 5 anos,clasificacion a y b,2002-01-01,17,48,17,48,65
40401,CURAHUARA DE CARANGAS,estado nutricional en menores de 5 anos,clasificacion a y b,2002-01-01,6,1,6,1,7
20804,DESAGUADERO,estado nutricional en menores de 5 anos,clasificacion a y b,2002-01-01,0,5,0,5,5
20105,EL ALTO,estado nutricional en menores de 5 anos,clasificacion a y b,2002-01-01,565,448,565,448,1013
40103,EL CHORO,estado nutricional en menores de 5 anos,clasificacion a y b,2002-01-01,4,0,4,0,4
71503,EL PUENTE(STC),estado nutricional en menores de 5 anos,clasificacion a y b,2002-01-01,20,27,20,27,47
60502,EL PUENTE(TJA),estado nutricional en menores de 5 anos,clasificacion a y b,2002-01-01,0,6,0,6,6
70105,EL TORNO,estado nutricional en menores de 5 anos,clasificacion a y b,2002-01-01,99,94,99,94,193
10405,EL VILLAR,estado nutricional en menores de 5 anos,clasificacion a y b,2002-01-01,1,17,1,17,18
60601,ENTRE RIOS,estado nutricional en menores de 5 anos,clasificacion a y b,2002-01-01,38,19,38,19,57
41101,EUCALIPTUS,estado nutricional en menores de 5 anos,clasificacion a y b,2002-01-01,2,4,2,4,6
80402,EXALTACION,estado nutricional en menores de 5 anos,clasificacion a y b,2002-01-01,1,4,1,4,5
90203,FILADELFIA,estado nutricional en menores de 5 anos,clasificacion a y b,2002-01-01,2,3,2,3,5
71002,GENERAL SAAVEDRA,estado nutricional en menores de 5 anos,clasificacion a y b,2002-01-01,23,67,23,67,90
21601,GRAL. J.J. PEREZ (CHARAZANI),estado nutricional en menores de 5 anos,clasificacion a y b,2002-01-01,3,4,3,4,7
20602,GUANAY,estado nutricional en menores de 5 anos,clasificacion a y b,2002-01-01,18,82,18,82,100
20802,GUAQUI,estado nutricional en menores de 5 anos,clasificacion a y b,2002-01-01,2,3,2,3,5
80202,GUAYARAMERIN,estado nutricional en menores de 5 anos,clasificacion a y b,2002-01-01,84,27,84,27,111
70705,GUTIERREZ,estado nutricional en menores de 5 anos,clasificacion a y b,2002-01-01,33,87,33,87,120
10502,HUACARETA,estado nutricional en menores de 5 anos,clasificacion a y b,2002-01-01,7,56,7,56,63
11002,HUACAYA (VILLA DE HUACAYA),estado nutricional en menores de 5 anos,clasificacion a y b,2002-01-01,4,4,4,4,8
40501,HUACHACALLA,estado nutricional en menores de 5 anos,clasificacion a y b,2002-01-01,0,2,0,2,2
80803,HUARACAJE,estado nutricional en menores de 5 anos,clasificacion a y b,2002-01-01,2,1,2,1,3
21005,ICHOCA,estado nutricional en menores de 5 anos,clasificacion a y b,2002-01-01,1,1,1,1,2
10304,ICLA,estado nutricional en menores de 5 anos,clasificacion a y b,2002-01-01,11,5,11,5,16
10703,INCAHUASI,estado nutricional en menores de 5 anos,clasificacion a y b,2002-01-01,2,21,2,21,23
21001,INQUISIVI,estado nutricional en menores de 5 anos,clasificacion a y b,2002-01-01,12,7,12,7,19
21102,IRUPANA (VILLA DE LANZA),estado nutricional en menores de 5 anos,clasificacion a y b,2002-01-01,32,26,32,26,58
21501,IXIAMAS,estado nutricional en menores de 5 anos,clasificacion a y b,2002-01-01,33,16,33,16,49
21105,LA ASUNTA,estado nutricional en menores de 5 anos,clasificacion a y b,2002-01-01,23,16,23,16,39
70104,LA GUARDIA,estado nutricional en menores de 5 anos,clasificacion a y b,2002-01-01,114,76,114,76,190
20101,LA PAZ,estado nutricional en menores de 5 anos,clasificacion a y b,2002-01-01,460,345,460,345,805
70701,LAGUNILLAS,estado nutricional en menores de 5 anos,clasificacion a y b,2002-01-01,11,14,11,14,25
21202,LAJA,estado nutricional en menores de 5 anos,clasificacion a y b,2002-01-01,4,27,4,27,31
10903,LAS CARRERAS,estado nutricional en menores de 5 anos,clasificacion a y b,2002-01-01,1,4,1,4,5
51401,LLICA,estado nutricional en menores de 5 anos,clasificacion a y b,2002-01-01,1,4,1,4,5
80601,LORETO,estado nutricional en menores de 5 anos,clasificacion a y b,2002-01-01,2,8,2,8,10
20901,LURIBAY,estado nutricional en menores de 5 anos,clasificacion a y b,2002-01-01,3,9,3,9,12
40702,MACHACAMARCA,estado nutricional en menores de 5 anos,clasificacion a y b,2002-01-01,10,4,10,4,14
11003,MACHARETI,estado nutricional en menores de 5 anos,clasificacion a y b,2002-01-01,11,33,11,33,44
80801,MAGDALENA,estado nutricional en menores de 5 anos,clasificacion a y b,2002-01-01,16,23,16,23,39
70903,MAIRANA,estado nutricional en menores de 5 anos,clasificacion a y b,2002-01-01,55,11,55,11,66
20103,MECAPACA,estado nutricional en menores de 5 anos,clasificacion a y b,2002-01-01,2,13,2,13,15
71003,MINEROS,estado nutricional en menores de 5 anos,clasificacion a y b,2002-01-01,40,124,40,124,164
31301,MIZQUE,estado nutricional en menores de 5 anos,clasificacion a y b,2002-01-01,3,3,3,3,6
20402,MOCOMOCO,estado nutricional en menores de 5 anos,clasificacion a y b,2002-01-01,6,5,6,5,11
10303,MOJOCOYA,estado nutricional en menores de 5 anos,clasificacion a y b,2002-01-01,42,10,42,10,52
10501,MONTEAGUDO,estado nutricional en menores de 5 anos,clasificacion a y b,2002-01-01,43,60,43,60,103
71001,MONTERO,estado nutricional en menores de 5 anos,clasificacion a y b,2002-01-01,57,422,57,422,479
70803,MORO MORO,estado nutricional en menores de 5 anos,clasificacion a y b,2002-01-01,9,5,9,5,14
30302,MOROCHATA,estado nutricional en menores de 5 anos,clasificacion a y b,2002-01-01,3,1,3,1,4
90401,NACEBE (SANTA ROSA DEL ABUNA),estado nutricional en menores de 5 anos,clasificacion a y b,2002-01-01,0,4,0,4,4
50404,OCURI,estado nutricional en menores de 5 anos,clasificacion a y b,2002-01-01,4,6,4,6,10
70202,OKINAWA,estado nutricional en menores de 5 anos,clasificacion a y b,2002-01-01,5,2,5,2,7
30203,OMEREQUE,estado nutricional en menores de 5 anos,clasificacion a y b,2002-01-01,1,1,1,1,2
40101,ORURO,estado nutricional en menores de 5 anos,clasificacion a y b,2002-01-01,90,281,90,281,371
60201,PADCAYA,estado nutricional en menores de 5 anos,clasificacion a y b,2002-01-01,25,29,25,29,54
10401,PADILLA,estado nutricional en menores de 5 anos,clasificacion a y b,2002-01-01,11,34,11,34,45
70502,PAILON,estado nutricional en menores de 5 anos,clasificacion a y b,2002-01-01,19,66,19,66,85
20102,PALCA,estado nutricional en menores de 5 anos,clasificacion a y b,2002-01-01,23,3,23,3,26
21104,PALOS BLANCOS,estado nutricional en menores de 5 anos,clasificacion a y b,2002-01-01,27,18,27,18,45
40802,PAMPA AULLAGAS,estado nutricional en menores de 5 anos,clasificacion a y b,2002-01-01,9,2,9,2,11
70902,PAMPA GRANDE,estado nutricional en menores de 5 anos,clasificacion a y b,2002-01-01,19,8,19,8,27
21802,PAPEL PAMPA,estado nutricional en menores de 5 anos,clasificacion a y b,2002-01-01,3,2,3,2,5
30202,PASORAPA,estado nutricional en menores de 5 anos,clasificacion a y b,2002-01-01,12,5,12,5,17
21305,PATACAMAYA,estado nutricional en menores de 5 anos,clasificacion a y b,2002-01-01,25,9,25,9,34
40602,PAZÃ‘A,estado nutricional en menores de 5 anos,clasificacion a y b,2002-01-01,0,3,0,3,3
20702,PELECHUCO,estado nutricional en menores de 5 anos,clasificacion a y b,2002-01-01,3,0,3,0,3
50403,POCOATA,estado nutricional en menores de 5 anos,clasificacion a y b,2002-01-01,17,11,17,11,28
31203,POCONA,estado nutricional en menores de 5 anos,clasificacion a y b,2002-01-01,3,4,3,4,7
31202,POJO (CBBA),estado nutricional en menores de 5 anos,clasificacion a y b,2002-01-01,67,39,67,39,106
40601,POOPO,estado nutricional en menores de 5 anos,clasificacion a y b,2002-01-01,1,0,1,0,1
51203,PORCO,estado nutricional en menores de 5 anos,clasificacion a y b,2002-01-01,2,8,2,8,10
10103,POROMA,estado nutricional en menores de 5 anos,clasificacion a y b,2002-01-01,6,12,6,12,18
70103,PORONGO,estado nutricional en menores de 5 anos,clasificacion a y b,2002-01-01,6,41,6,41,47
70601,PORTACHUELO,estado nutricional en menores de 5 anos,clasificacion a y b,2002-01-01,105,71,105,71,176
90102,PORVENIR,estado nutricional en menores de 5 anos,clasificacion a y b,2002-01-01,21,6,21,6,27
70804,POSTRER VALLE,estado nutricional en menores de 5 anos,clasificacion a y b,2002-01-01,2,12,2,12,14
50101,POTOSI,estado nutricional en menores de 5 anos,clasificacion a y b,2002-01-01,36,58,36,58,94
10302,PRESTO,estado nutricional en menores de 5 anos,clasificacion a y b,2002-01-01,33,2,33,2,35
21201,PUCARANI,estado nutricional en menores de 5 anos,clasificacion a y b,2002-01-01,7,14,7,14,21
20401,PUERTO ACOSTA,estado nutricional en menores de 5 anos,clasificacion a y b,2002-01-01,19,2,19,2,21
20403,PUERTO CARABUCO,estado nutricional en menores de 5 anos,clasificacion a y b,2002-01-01,23,2,23,2,25
90301,PUERTO GONZALO MORENO,estado nutricional en menores de 5 anos,clasificacion a y b,2002-01-01,2,0,2,0,2
21204,PUERTO PEREZ,estado nutricional en menores de 5 anos,clasificacion a y b,2002-01-01,1,4,1,4,5
71402,PUERTO QUIJARRO,estado nutricional en menores de 5 anos,clasificacion a y b,2002-01-01,60,9,60,9,69
90201,PUERTO RICO,estado nutricional en menores de 5 anos,clasificacion a y b,2002-01-01,6,0,6,0,6
71401,PUERTO SUAREZ,estado nutricional en menores de 5 anos,clasificacion a y b,2002-01-01,74,10,74,10,84
31205,PUERTO VILLARROEL,estado nutricional en menores de 5 anos,clasificacion a y b,2002-01-01,119,63,119,63,182
51101,PUNA,estado nutricional en menores de 5 anos,clasificacion a y b,2002-01-01,11,32,11,32,43
31401,PUNATA,estado nutricional en menores de 5 anos,clasificacion a y b,2002-01-01,7,0,7,0,7
20604,QUIABAYA,estado nutricional en menores de 5 anos,clasificacion a y b,2002-01-01,3,0,3,0,3
30901,QUILLACOLLO,estado nutricional en menores de 5 anos,clasificacion a y b,2002-01-01,20,31,20,31,51
21002,QUIME,estado nutricional en menores de 5 anos,clasificacion a y b,2002-01-01,7,18,7,18,25
70904,QUIRUSILLAS,estado nutricional en menores de 5 anos,clasificacion a y b,2002-01-01,2,0,2,0,2
50402,RAVELO,estado nutricional en menores de 5 anos,clasificacion a y b,2002-01-01,7,11,7,11,18
80301,REYES,estado nutricional en menores de 5 anos,clasificacion a y b,2002-01-01,26,6,26,6,32
80201,RIBERALTA,estado nutricional en menores de 5 anos,clasificacion a y b,2002-01-01,200,81,200,81,281
70503,ROBORE,estado nutricional en menores de 5 anos,clasificacion a y b,2002-01-01,10,53,10,53,63
80304,RURRENABAQUE,estado nutricional en menores de 5 anos,clasificacion a y b,2002-01-01,44,36,44,36,80
40901,SABAYA,estado nutricional en menores de 5 anos,clasificacion a y b,2002-01-01,2,0,2,0,2
31001,SACABA,estado nutricional en menores de 5 anos,clasificacion a y b,2002-01-01,55,21,55,21,76
30404,SACABAMBA,estado nutricional en menores de 5 anos,clasificacion a y b,2002-01-01,1,1,1,1,2
50701,SACACA,estado nutricional en menores de 5 anos,clasificacion a y b,2002-01-01,10,14,10,14,24
71302,SAIPINA,estado nutricional en menores de 5 anos,clasificacion a y b,2002-01-01,58,18,58,18,76
40801,SALINAS DE GARCI MENDOZA,estado nutricional en menores de 5 anos,clasificacion a y b,2002-01-01,3,0,3,0,3
70901,SAMAIPATA,estado nutricional en menores de 5 anos,clasificacion a y b,2002-01-01,31,6,31,6,37
51601,SAN AGUSTIN,estado nutricional en menores de 5 anos,clasificacion a y b,2002-01-01,0,1,0,1,1
71105,SAN ANTONIO DE LOMERIO,estado nutricional en menores de 5 anos,clasificacion a y b,2002-01-01,21,4,21,4,25
31403,SAN BENITO,estado nutricional en menores de 5 anos,clasificacion a y b,2002-01-01,1,0,1,0,1
80302,SAN BORJA,estado nutricional en menores de 5 anos,clasificacion a y b,2002-01-01,81,33,81,33,114
21502,SAN BUENA VENTURA,estado nutricional en menores de 5 anos,clasificacion a y b,2002-01-01,10,4,10,4,14
70402,SAN CARLOS,estado nutricional en menores de 5 anos,clasificacion a y b,2002-01-01,10,1,10,1,11
80501,SAN IGNACIO,estado nutricional en menores de 5 anos,clasificacion a y b,2002-01-01,29,28,29,28,57
70301,SAN IGNACIO DE VELASCO,estado nutricional en menores de 5 anos,clasificacion a y b,2002-01-01,170,27,170,27,197
80102,SAN JAVIER(BNI),estado nutricional en menores de 5 anos,clasificacion a y b,2002-01-01,1,0,1,0,1
71102,SAN JAVIER(STC),estado nutricional en menores de 5 anos,clasificacion a y b,2002-01-01,27,25,27,25,52
80701,SAN JOAQUIN,estado nutricional en menores de 5 anos,clasificacion a y b,2002-01-01,7,13,7,13,20
70501,SAN JOSE DE CHIQUITOS,estado nutricional en menores de 5 anos,clasificacion a y b,2002-01-01,15,7,15,7,22
71104,SAN JULIAN,estado nutricional en menores de 5 anos,clasificacion a y b,2002-01-01,84,45,84,45,129
90302,SAN LORENZO(PND),estado nutricional en menores de 5 anos,clasificacion a y b,2002-01-01,1,3,1,3,4
60501,SAN LORENZO(TJA),estado nutricional en menores de 5 anos,clasificacion a y b,2002-01-01,2,8,2,8,10
10702,SAN LUCAS,estado nutricional en menores de 5 anos,clasificacion a y b,2002-01-01,21,64,21,64,85
71201,SAN MATIAS,estado nutricional en menores de 5 anos,clasificacion a y b,2002-01-01,31,12,31,12,43
70302,SAN MIGUEL DE VELASCO,estado nutricional en menores de 5 anos,clasificacion a y b,2002-01-01,32,15,32,15,47
51001,SAN PABLO DE LIPEZ,estado nutricional en menores de 5 anos,clasificacion a y b,2002-01-01,1,5,1,5,6
50501,SAN PEDRO DE BUENA VISTA,estado nutricional en menores de 5 anos,clasificacion a y b,2002-01-01,2,5,2,5,7
21801,SAN PEDRO DE CURAHUARA,estado nutricional en menores de 5 anos,clasificacion a y b,2002-01-01,2,11,2,11,13
21702,SAN PEDRO DE TIQUINA,estado nutricional en menores de 5 anos,clasificacion a y b,2002-01-01,6,22,6,22,28
90202,SAN PEDRO(PND),estado nutricional en menores de 5 anos,clasificacion a y b,2002-01-01,2,0,2,0,2
70303,SAN RAFAEL,estado nutricional en menores de 5 anos,clasificacion a y b,2002-01-01,14,0,14,0,14
80702,SAN RAMON,estado nutricional en menores de 5 anos,clasificacion a y b,2002-01-01,0,12,0,12,12
80702,SAN RAMON,estado nutricional en menores de 5 anos,clasificacion a y b,2002-01-01,48,90,48,90,138
80401,SANTA ANA,estado nutricional en menores de 5 anos,clasificacion a y b,2002-01-01,105,22,105,22,127
70101,SANTA CRUZ DE LA SIERRA,estado nutricional en menores de 5 anos,clasificacion a y b,2002-01-01,637,628,637,628,1265
80303,SANTA ROSA,estado nutricional en menores de 5 anos,clasificacion a y b,2002-01-01,10,2,10,2,12
70602,SANTA ROSA DEL SARA,estado nutricional en menores de 5 anos,clasificacion a y b,2002-01-01,15,29,15,29,44
41401,SANTIAGO DE HUARI,estado nutricional en menores de 5 anos,clasificacion a y b,2002-01-01,5,3,5,3,8
21901,SANTIAGO DE MACHACA,estado nutricional en menores de 5 anos,clasificacion a y b,2002-01-01,1,0,1,0,1
30702,SANTIVAÃ‘ES,estado nutricional en menores de 5 anos,clasificacion a y b,2002-01-01,4,1,4,1,5
40202,SANTUARIO DE QUILLACAS,estado nutricional en menores de 5 anos,clasificacion a y b,2002-01-01,0,1,0,1,1
20902,SAPAHAQUI,estado nutricional en menores de 5 anos,clasificacion a y b,2002-01-01,1,2,1,2,3
90303,SENA,estado nutricional en menores de 5 anos,clasificacion a y b,2002-01-01,2,18,2,18,20
21301,SICA SICA (VILLA AROMA),estado nutricional en menores de 5 anos,clasificacion a y b,2002-01-01,11,5,11,5,16
30703,SICAYA,estado nutricional en menores de 5 anos,clasificacion a y b,2002-01-01,1,0,1,0,1
30902,SIPE SIPE,estado nutricional en menores de 5 anos,clasificacion a y b,2002-01-01,97,58,97,58,155
10403,SOPACHUY,estado nutricional en menores de 5 anos,clasificacion a y b,2002-01-01,4,16,4,16,20
20601,SORATA,estado nutricional en menores de 5 anos,clasificacion a y b,2002-01-01,1,9,1,9,10
10101,SUCRE,estado nutricional en menores de 5 anos,clasificacion a y b,2002-01-01,99,316,99,316,415
31404,TACACHI,estado nutricional en menores de 5 anos,clasificacion a y b,2002-01-01,2,1,2,1,3
20603,TACACOMA,estado nutricional en menores de 5 anos,clasificacion a y b,2002-01-01,0,6,0,6,6
50303,TACOBAMBA,estado nutricional en menores de 5 anos,clasificacion a y b,2002-01-01,5,17,5,17,22
30602,TACOPAYA,estado nutricional en menores de 5 anos,clasificacion a y b,2002-01-01,10,10,10,10,20
51402,TAHUA,estado nutricional en menores de 5 anos,clasificacion a y b,2002-01-01,0,2,0,2,2
31101,TAPACARI,estado nutricional en menores de 5 anos,clasificacion a y b,2002-01-01,3,15,3,15,18
10601,TARABUCO,estado nutricional en menores de 5 anos,clasificacion a y b,2002-01-01,16,48,16,48,64
30401,TARATA,estado nutricional en menores de 5 anos,clasificacion a y b,2002-01-01,5,26,5,26,31
60101,TARIJA,estado nutricional en menores de 5 anos,clasificacion a y b,2002-01-01,150,197,150,197,347
10202,TARVITA,estado nutricional en menores de 5 anos,clasificacion a y b,2002-01-01,22,14,22,14,36
20803,TIAWANACU,estado nutricional en menores de 5 anos,clasificacion a y b,2002-01-01,13,2,13,2,15
50102,TINGUIPAYA,estado nutricional en menores de 5 anos,clasificacion a y b,2002-01-01,3,2,3,2,5
20606,TIPUANI,estado nutricional en menores de 5 anos,clasificacion a y b,2002-01-01,12,4,12,4,16
30903,TIQUIPAYA,estado nutricional en menores de 5 anos,clasificacion a y b,2002-01-01,1,18,1,18,19
31601,TIRAQUE (CBBA),estado nutricional en menores de 5 anos,clasificacion a y b,2002-01-01,50,24,50,24,74
30802,TOCO,estado nutricional en menores de 5 anos,clasificacion a y b,2002-01-01,0,1,0,1,1
41502,TODOS SANTOS,estado nutricional en menores de 5 anos,clasificacion a y b,2002-01-01,0,1,0,1,1
41001,TOLEDO,estado nutricional en menores de 5 anos,clasificacion a y b,2002-01-01,16,2,16,2,18
51202,TOMAVE,estado nutricional en menores de 5 anos,clasificacion a y b,2002-01-01,4,21,4,21,25
10402,TOMINA,estado nutricional en menores de 5 anos,clasificacion a y b,2002-01-01,16,21,16,21,37
50502,TORO TORO,estado nutricional en menores de 5 anos,clasificacion a y b,2002-01-01,5,15,5,15,20
31201,TOTORA(CBBA),estado nutricional en menores de 5 anos,clasificacion a y b,2002-01-01,19,28,19,28,47
41301,TOTORA(ORR),estado nutricional en menores de 5 anos,clasificacion a y b,2002-01-01,2,5,2,5,7
70802,TRIGAL,estado nutricional en menores de 5 anos,clasificacion a y b,2002-01-01,4,0,4,0,4
80101,TRINIDAD,estado nutricional en menores de 5 anos,clasificacion a y b,2002-01-01,64,94,64,94,158
50801,TUPIZA,estado nutricional en menores de 5 anos,clasificacion a y b,2002-01-01,17,98,17,98,115
40402,TURCO,estado nutricional en menores de 5 anos,clasificacion a y b,2002-01-01,6,0,6,0,6
60401,URIONDO (A. CONCEPCION),estado nutricional en menores de 5 anos,clasificacion a y b,2002-01-01,24,26,24,26,50
71502,URUBICHA,estado nutricional en menores de 5 anos,clasificacion a y b,2002-01-01,2,17,2,17,19
51201,UYUNI,estado nutricional en menores de 5 anos,clasificacion a y b,2002-01-01,6,11,6,11,17
30502,VACAS,estado nutricional en menores de 5 anos,clasificacion a y b,2002-01-01,1,0,1,0,1
70801,VALLEGRANDE,estado nutricional en menores de 5 anos,clasificacion a y b,2002-01-01,37,53,37,53,90
20801,VIACHA,estado nutricional en menores de 5 anos,clasificacion a y b,2002-01-01,21,46,21,46,67
31302,VILA VILA,estado nutricional en menores de 5 anos,clasificacion a y b,2002-01-01,4,0,4,0,4
60303,VILLA MONTES,estado nutricional en menores de 5 anos,clasificacion a y b,2002-01-01,35,9,35,9,44
31402,VILLA RIVERO,estado nutricional en menores de 5 anos,clasificacion a y b,2002-01-01,0,7,0,7,7
10801,VILLA SERRANO,estado nutricional en menores de 5 anos,clasificacion a y b,2002-01-01,10,26,10,26,36
31003,VILLA TUNARI,estado nutricional en menores de 5 anos,clasificacion a y b,2002-01-01,50,66,50,66,116
11001,VILLA VACA GUZMAN (MUYUPAMPA),estado nutricional en menores de 5 anos,clasificacion a y b,2002-01-01,14,34,14,34,48
51501,VILLAZON,estado nutricional en menores de 5 anos,clasificacion a y b,2002-01-01,28,104,28,104,132
30904,VINTO,estado nutricional en menores de 5 anos,clasificacion a y b,2002-01-01,41,45,41,45,86
50602,VITICHI,estado nutricional en menores de 5 anos,clasificacion a y b,2002-01-01,5,18,5,18,23
20306,WALDO BALLIVIAN,estado nutricional en menores de 5 anos,clasificacion a y b,2002-01-01,2,0,2,0,2
70201,WARNES,estado nutricional en menores de 5 anos,clasificacion a y b,2002-01-01,97,49,97,49,146
20903,YACO,estado nutricional en menores de 5 anos,clasificacion a y b,2002-01-01,3,14,3,14,17
60301,YACUIBA,estado nutricional en menores de 5 anos,clasificacion a y b,2002-01-01,64,4,64,4,68
10602,YAMPARAEZ,estado nutricional en menores de 5 anos,clasificacion a y b,2002-01-01,51,7,51,7,58
21103,YANACACHI,estado nutricional en menores de 5 anos,clasificacion a y b,2002-01-01,25,4,25,4,29
70403,YAPACANI,estado nutricional en menores de 5 anos,clasificacion a y b,2002-01-01,107,41,107,41,148
50103,YOCALLA,estado nutricional en menores de 5 anos,clasificacion a y b,2002-01-01,0,8,0,8,8
10102,YOTALA,estado nutricional en menores de 5 anos,clasificacion a y b,2002-01-01,34,6,34,6,40
60402,YUNCHARA,estado nutricional en menores de 5 anos,clasificacion a y b,2002-01-01,7,4,7,4,11
10301,ZUDAÃ‘EZ,estado nutricional en menores de 5 anos,clasificacion a y b,2002-01-01,35,5,35,5,40
51302,ACACIO,estado nutricional en menores de 5 anos,clasificacion a y b,2002-02-01,4,10,4,10,14
20201,ACHACACHI,estado nutricional en menores de 5 anos,clasificacion a y b,2002-02-01,38,58,38,58,96
20104,ACHOCALLA,estado nutricional en menores de 5 anos,clasificacion a y b,2002-02-01,0,3,0,3,3
30201,AIQUILE,estado nutricional en menores de 5 anos,clasificacion a y b,2002-02-01,3,0,3,0,3
31303,ALALAY,estado nutricional en menores de 5 anos,clasificacion a y b,2002-02-01,0,1,0,1,1
10404,ALCALA,estado nutricional en menores de 5 anos,clasificacion a y b,2002-02-01,19,4,19,4,23
20202,ANCORAIMES,estado nutricional en menores de 5 anos,clasificacion a y b,2002-02-01,15,5,15,5,20
41201,ANDAMARCA,estado nutricional en menores de 5 anos,clasificacion a y b,2002-02-01,2,0,2,0,2
30402,ANZALDO,estado nutricional en menores de 5 anos,clasificacion a y b,2002-02-01,1,4,1,4,5
20701,APOLO,estado nutricional en menores de 5 anos,clasificacion a y b,2002-02-01,22,0,22,0,22
51301,ARAMPAMPA,estado nutricional en menores de 5 anos,clasificacion a y b,2002-02-01,2,7,2,7,9
30501,ARANI,estado nutricional en menores de 5 anos,clasificacion a y b,2002-02-01,3,9,3,9,12
30403,ARBIETO,estado nutricional en menores de 5 anos,clasificacion a y b,2002-02-01,0,2,0,2,2
71501,ASCENCION DE GUARAYOS,estado nutricional en menores de 5 anos,clasificacion a y b,2002-02-01,47,35,47,35,82
50802,ATOCHA,estado nutricional en menores de 5 anos,clasificacion a y b,2002-02-01,3,8,3,8,11
21303,AYO AYO,estado nutricional en menores de 5 anos,clasificacion a y b,2002-02-01,7,2,7,2,9
30301,AYOPAYA (V. DE INDEPENDENCIA),estado nutricional en menores de 5 anos,clasificacion a y b,2002-02-01,7,1,7,1,8
10201,AZURDUY,estado nutricional en menores de 5 anos,clasificacion a y b,2002-02-01,15,17,15,17,32
21203,BATALLAS,estado nutricional en menores de 5 anos,clasificacion a y b,2002-02-01,5,30,5,30,35
80802,BAURES,estado nutricional en menores de 5 anos,clasificacion a y b,2002-02-01,10,7,10,7,17
50104,BELEN DE URMIRI,estado nutricional en menores de 5 anos,clasificacion a y b,2002-02-01,2,4,2,4,6
90104,BELLA FLOR,estado nutricional en menores de 5 anos,clasificacion a y b,2002-02-01,7,6,7,6,13
60202,BERMEJO,estado nutricional en menores de 5 anos,clasificacion a y b,2002-02-01,11,44,11,44,55
50301,BETANZOS,estado nutricional en menores de 5 anos,clasificacion a y b,2002-02-01,12,11,12,11,23
31501,BOLIVAR,estado nutricional en menores de 5 anos,clasificacion a y b,2002-02-01,3,6,3,6,9
90103,BOLPEBRA,estado nutricional en menores de 5 anos,clasificacion a y b,2002-02-01,2,0,2,0,2
70707,BOYUIBE,estado nutricional en menores de 5 anos,clasificacion a y b,2002-02-01,8,24,8,24,32
70401,BUENA VISTA,estado nutricional en menores de 5 anos,clasificacion a y b,2002-02-01,89,17,89,17,106
70703,CABEZAS,estado nutricional en menores de 5 anos,clasificacion a y b,2002-02-01,16,48,16,48,64
20905,CAIROMA,estado nutricional en menores de 5 anos,clasificacion a y b,2002-02-01,0,5,0,5,5
51102,"CAIZA ""D""",estado nutricional en menores de 5 anos,clasificacion a y b,2002-02-01,15,16,15,16,31
21003,CAJUATA,estado nutricional en menores de 5 anos,clasificacion a y b,2002-02-01,8,0,8,0,8
20303,CALACOTO,estado nutricional en menores de 5 anos,clasificacion a y b,2002-02-01,1,0,1,0,1
21304,CALAMARCA,estado nutricional en menores de 5 anos,clasificacion a y b,2002-02-01,6,7,6,7,13
10701,CAMARGO,estado nutricional en menores de 5 anos,clasificacion a y b,2002-02-01,12,13,12,13,25
10901,CAMATAQUI (C. VILLA ABECIA),estado nutricional en menores de 5 anos,clasificacion a y b,2002-02-01,0,3,0,3,3
70706,CAMIRI,estado nutricional en menores de 5 anos,clasificacion a y b,2002-02-01,63,38,63,38,101
30701,CAPINOTA,estado nutricional en menores de 5 anos,clasificacion a y b,2002-02-01,3,2,3,2,5
20302,CAQUIAVIRI,estado nutricional en menores de 5 anos,clasificacion a y b,2002-02-01,13,3,13,3,16
40102,CARACOLLO,estado nutricional en menores de 5 anos,clasificacion a y b,2002-02-01,22,17,22,17,39
22001,CARANAVI,estado nutricional en menores de 5 anos,clasificacion a y b,2002-02-01,96,30,96,30,126
60302,CARAPARI,estado nutricional en menores de 5 anos,clasificacion a y b,2002-02-01,20,15,20,15,35
50702,CARIPUYO,estado nutricional en menores de 5 anos,clasificacion a y b,2002-02-01,4,3,4,3,7
40201,CHALLAPATA,estado nutricional en menores de 5 anos,clasificacion a y b,2002-02-01,15,2,15,2,17
50302,CHAQUI,estado nutricional en menores de 5 anos,clasificacion a y b,2002-02-01,2,3,2,3,5
70702,CHARAGUA,estado nutricional en menores de 5 anos,clasificacion a y b,2002-02-01,18,71,18,71,89
31204,CHIMORE,estado nutricional en menores de 5 anos,clasificacion a y b,2002-02-01,7,3,7,3,10
40302,CHOQUE COTA,estado nutricional en menores de 5 anos,clasificacion a y b,2002-02-01,1,0,1,0,1
21101,CHULUMANI (V. DE LA LIBERTAD),estado nutricional en menores de 5 anos,clasificacion a y b,2002-02-01,8,3,8,3,11
20501,CHUMA,estado nutricional en menores de 5 anos,clasificacion a y b,2002-02-01,3,1,3,1,4
30801,CLIZA,estado nutricional en menores de 5 anos,clasificacion a y b,2002-02-01,6,10,6,10,16
90101,COBIJA,estado nutricional en menores de 5 anos,clasificacion a y b,2002-02-01,40,10,40,10,50
30101,COCHABAMBA,estado nutricional en menores de 5 anos,clasificacion a y b,2002-02-01,1156,885,1156,885,2041
40902,COIPASA,estado nutricional en menores de 5 anos,clasificacion a y b,2002-02-01,0,1,0,1,1
30905,COLCAPIRHUA,estado nutricional en menores de 5 anos,clasificacion a y b,2002-02-01,24,19,24,19,43
50901,"COLCHA ""K""",estado nutricional en menores de 5 anos,clasificacion a y b,2002-02-01,1,7,1,7,8
21307,COLLANA,estado nutricional en menores de 5 anos,clasificacion a y b,2002-02-01,1,0,1,0,1
31002,COLOMI,estado nutricional en menores de 5 anos,clasificacion a y b,2002-02-01,16,3,16,3,19
50401,COLQUECHACA,estado nutricional en menores de 5 anos,clasificacion a y b,2002-02-01,1,2,1,2,3
21306,COLQUENCHA,estado nutricional en menores de 5 anos,clasificacion a y b,2002-02-01,4,2,4,2,6
21004,COLQUIRI,estado nutricional en menores de 5 anos,clasificacion a y b,2002-02-01,8,9,8,9,17
20304,COMANCHE,estado nutricional en menores de 5 anos,clasificacion a y b,2002-02-01,4,1,4,1,5
71301,COMARAPA,estado nutricional en menores de 5 anos,clasificacion a y b,2002-02-01,11,9,11,9,20
20605,COMBAYA,estado nutricional en menores de 5 anos,clasificacion a y b,2002-02-01,1,5,1,5,6
71101,CONCEPCION,estado nutricional en menores de 5 anos,clasificacion a y b,2002-02-01,4,39,4,39,43
21701,COPACABANA,estado nutricional en menores de 5 anos,clasificacion a y b,2002-02-01,8,8,8,8,16
21402,CORIPATA,estado nutricional en menores de 5 anos,clasificacion a y b,2002-02-01,12,13,12,13,25
20301,CORO CORO,estado nutricional en menores de 5 anos,clasificacion a y b,2002-02-01,7,1,7,1,8
21401,COROICO,estado nutricional en menores de 5 anos,clasificacion a y b,2002-02-01,4,6,4,6,10
40301,CORQUE,estado nutricional en menores de 5 anos,clasificacion a y b,2002-02-01,4,1,4,1,5
50601,COTAGAITA,estado nutricional en menores de 5 anos,clasificacion a y b,2002-02-01,11,14,11,14,25
70102,COTOCA,estado nutricional en menores de 5 anos,clasificacion a y b,2002-02-01,90,64,90,64,154
31405,CUCHUMUELA (V. G. VILLARROEL),estado nutricional en menores de 5 anos,clasificacion a y b,2002-02-01,0,2,0,2,2
70704,CUEVO,estado nutricional en menores de 5 anos,clasificacion a y b,2002-02-01,24,0,24,0,24
10902,CULPINA,estado nutricional en menores de 5 anos,clasificacion a y b,2002-02-01,3,48,3,48,51
40401,CURAHUARA DE CARANGAS,estado nutricional en menores de 5 anos,clasificacion a y b,2002-02-01,2,0,2,0,2
21602,CURVA,estado nutricional en menores de 5 anos,clasificacion a y b,2002-02-01,4,0,4,0,4
20804,DESAGUADERO,estado nutricional en menores de 5 anos,clasificacion a y b,2002-02-01,1,6,1,6,7
20105,EL ALTO,estado nutricional en menores de 5 anos,clasificacion a y b,2002-02-01,348,241,348,241,589
40103,EL CHORO,estado nutricional en menores de 5 anos,clasificacion a y b,2002-02-01,3,0,3,0,3
71503,EL PUENTE(STC),estado nutricional en menores de 5 anos,clasificacion a y b,2002-02-01,32,24,32,24,56
60502,EL PUENTE(TJA),estado nutricional en menores de 5 anos,clasificacion a y b,2002-02-01,3,3,3,3,6
70105,EL TORNO,estado nutricional en menores de 5 anos,clasificacion a y b,2002-02-01,117,29,117,29,146
10405,EL VILLAR,estado nutricional en menores de 5 anos,clasificacion a y b,2002-02-01,14,3,14,3,17
60601,ENTRE RIOS,estado nutricional en menores de 5 anos,clasificacion a y b,2002-02-01,17,13,17,13,30
41101,EUCALIPTUS,estado nutricional en menores de 5 anos,clasificacion a y b,2002-02-01,1,9,1,9,10
90503,EUREKA (SANTOS MERCADO),estado nutricional en menores de 5 anos,clasificacion a y b,2002-02-01,0,2,0,2,2
80402,EXALTACION,estado nutricional en menores de 5 anos,clasificacion a y b,2002-02-01,0,41,0,41,41
90203,FILADELFIA,estado nutricional en menores de 5 anos,clasificacion a y b,2002-02-01,2,2,2,2,4
71002,GENERAL SAAVEDRA,estado nutricional en menores de 5 anos,clasificacion a y b,2002-02-01,29,61,29,61,90
21601,GRAL. J.J. PEREZ (CHARAZANI),estado nutricional en menores de 5 anos,clasificacion a y b,2002-02-01,2,0,2,0,2
20602,GUANAY,estado nutricional en menores de 5 anos,clasificacion a y b,2002-02-01,25,81,25,81,106
20802,GUAQUI,estado nutricional en menores de 5 anos,clasificacion a y b,2002-02-01,2,5,2,5,7
80202,GUAYARAMERIN,estado nutricional en menores de 5 anos,clasificacion a y b,2002-02-01,43,9,43,9,52
70705,GUTIERREZ,estado nutricional en menores de 5 anos,clasificacion a y b,2002-02-01,35,58,35,58,93
10502,HUACARETA,estado nutricional en menores de 5 anos,clasificacion a y b,2002-02-01,26,21,26,21,47
11002,HUACAYA (VILLA DE HUACAYA),estado nutricional en menores de 5 anos,clasificacion a y b,2002-02-01,7,5,7,5,12
40501,HUACHACALLA,estado nutricional en menores de 5 anos,clasificacion a y b,2002-02-01,1,6,1,6,7
80803,HUARACAJE,estado nutricional en menores de 5 anos,clasificacion a y b,2002-02-01,21,8,21,8,29
41601,HUAYLLAMARCA,estado nutricional en menores de 5 anos,clasificacion a y b,2002-02-01,1,2,1,2,3
21005,ICHOCA,estado nutricional en menores de 5 anos,clasificacion a y b,2002-02-01,3,0,3,0,3
10304,ICLA,estado nutricional en menores de 5 anos,clasificacion a y b,2002-02-01,9,6,9,6,15
10703,INCAHUASI,estado nutricional en menores de 5 anos,clasificacion a y b,2002-02-01,6,22,6,22,28
21001,INQUISIVI,estado nutricional en menores de 5 anos,clasificacion a y b,2002-02-01,4,3,4,3,7
21102,IRUPANA (VILLA DE LANZA),estado nutricional en menores de 5 anos,clasificacion a y b,2002-02-01,7,29,7,29,36
21501,IXIAMAS,estado nutricional en menores de 5 anos,clasificacion a y b,2002-02-01,50,21,50,21,71
21105,LA ASUNTA,estado nutricional en menores de 5 anos,clasificacion a y b,2002-02-01,15,24,15,24,39
70104,LA GUARDIA,estado nutricional en menores de 5 anos,clasificacion a y b,2002-02-01,158,26,158,26,184
20101,LA PAZ,estado nutricional en menores de 5 anos,clasificacion a y b,2002-02-01,420,276,420,276,696
70701,LAGUNILLAS,estado nutricional en menores de 5 anos,clasificacion a y b,2002-02-01,8,12,8,12,20
21202,LAJA,estado nutricional en menores de 5 anos,clasificacion a y b,2002-02-01,3,12,3,12,15
10903,LAS CARRERAS,estado nutricional en menores de 5 anos,clasificacion a y b,2002-02-01,0,7,0,7,7
51401,LLICA,estado nutricional en menores de 5 anos,clasificacion a y b,2002-02-01,0,2,0,2,2
80601,LORETO,estado nutricional en menores de 5 anos,clasificacion a y b,2002-02-01,0,1,0,1,1
20901,LURIBAY,estado nutricional en menores de 5 anos,clasificacion a y b,2002-02-01,1,9,1,9,10
40702,MACHACAMARCA,estado nutricional en menores de 5 anos,clasificacion a y b,2002-02-01,12,2,12,2,14
11003,MACHARETI,estado nutricional en menores de 5 anos,clasificacion a y b,2002-02-01,37,8,37,8,45
80801,MAGDALENA,estado nutricional en menores de 5 anos,clasificacion a y b,2002-02-01,2,2,2,2,4
70903,MAIRANA,estado nutricional en menores de 5 anos,clasificacion a y b,2002-02-01,42,8,42,8,50
20103,MECAPACA,estado nutricional en menores de 5 anos,clasificacion a y b,2002-02-01,7,5,7,5,12
71003,MINEROS,estado nutricional en menores de 5 anos,clasificacion a y b,2002-02-01,57,70,57,70,127
31301,MIZQUE,estado nutricional en menores de 5 anos,clasificacion a y b,2002-02-01,2,13,2,13,15
20402,MOCOMOCO,estado nutricional en menores de 5 anos,clasificacion a y b,2002-02-01,4,14,4,14,18
10303,MOJOCOYA,estado nutricional en menores de 5 anos,clasificacion a y b,2002-02-01,32,8,32,8,40
10501,MONTEAGUDO,estado nutricional en menores de 5 anos,clasificacion a y b,2002-02-01,101,26,101,26,127
71001,MONTERO,estado nutricional en menores de 5 anos,clasificacion a y b,2002-02-01,42,325,42,325,367
70803,MORO MORO,estado nutricional en menores de 5 anos,clasificacion a y b,2002-02-01,1,3,1,3,4
30302,MOROCHATA,estado nutricional en menores de 5 anos,clasificacion a y b,2002-02-01,10,3,10,3,13
90401,NACEBE (SANTA ROSA DEL ABUNA),estado nutricional en menores de 5 anos,clasificacion a y b,2002-02-01,1,0,1,0,1
50404,OCURI,estado nutricional en menores de 5 anos,clasificacion a y b,2002-02-01,6,5,6,5,11
70202,OKINAWA,estado nutricional en menores de 5 anos,clasificacion a y b,2002-02-01,12,0,12,0,12
30203,OMEREQUE,estado nutricional en menores de 5 anos,clasificacion a y b,2002-02-01,2,8,2,8,10
40101,ORURO,estado nutricional en menores de 5 anos,clasificacion a y b,2002-02-01,71,146,71,146,217
60201,PADCAYA,estado nutricional en menores de 5 anos,clasificacion a y b,2002-02-01,17,12,17,12,29
10401,PADILLA,estado nutricional en menores de 5 anos,clasificacion a y b,2002-02-01,42,10,42,10,52
70502,PAILON,estado nutricional en menores de 5 anos,clasificacion a y b,2002-02-01,15,53,15,53,68
20102,PALCA,estado nutricional en menores de 5 anos,clasificacion a y b,2002-02-01,15,2,15,2,17
21104,PALOS BLANCOS,estado nutricional en menores de 5 anos,clasificacion a y b,2002-02-01,36,8,36,8,44
40802,PAMPA AULLAGAS,estado nutricional en menores de 5 anos,clasificacion a y b,2002-02-01,7,1,7,1,8
70902,PAMPA GRANDE,estado nutricional en menores de 5 anos,clasificacion a y b,2002-02-01,21,8,21,8,29
21802,PAPEL PAMPA,estado nutricional en menores de 5 anos,clasificacion a y b,2002-02-01,1,4,1,4,5
30202,PASORAPA,estado nutricional en menores de 5 anos,clasificacion a y b,2002-02-01,12,1,12,1,13
21305,PATACAMAYA,estado nutricional en menores de 5 anos,clasificacion a y b,2002-02-01,27,0,27,0,27
40602,PAZÃ‘A,estado nutricional en menores de 5 anos,clasificacion a y b,2002-02-01,0,1,0,1,1
20702,PELECHUCO,estado nutricional en menores de 5 anos,clasificacion a y b,2002-02-01,1,2,1,2,3
50403,POCOATA,estado nutricional en menores de 5 anos,clasificacion a y b,2002-02-01,22,6,22,6,28
31203,POCONA,estado nutricional en menores de 5 anos,clasificacion a y b,2002-02-01,4,7,4,7,11
31202,POJO (CBBA),estado nutricional en menores de 5 anos,clasificacion a y b,2002-02-01,44,48,44,48,92
51203,PORCO,estado nutricional en menores de 5 anos,clasificacion a y b,2002-02-01,8,8,8,8,16
10103,POROMA,estado nutricional en menores de 5 anos,clasificacion a y b,2002-02-01,14,10,14,10,24
70103,PORONGO,estado nutricional en menores de 5 anos,clasificacion a y b,2002-02-01,22,6,22,6,28
70601,PORTACHUELO,estado nutricional en menores de 5 anos,clasificacion a y b,2002-02-01,44,13,44,13,57
90102,PORVENIR,estado nutricional en menores de 5 anos,clasificacion a y b,2002-02-01,0,1,0,1,1
50101,POTOSI,estado nutricional en menores de 5 anos,clasificacion a y b,2002-02-01,51,10,51,10,61
10302,PRESTO,estado nutricional en menores de 5 anos,clasificacion a y b,2002-02-01,28,2,28,2,30
21201,PUCARANI,estado nutricional en menores de 5 anos,clasificacion a y b,2002-02-01,5,20,5,20,25
20401,PUERTO ACOSTA,estado nutricional en menores de 5 anos,clasificacion a y b,2002-02-01,9,3,9,3,12
20403,PUERTO CARABUCO,estado nutricional en menores de 5 anos,clasificacion a y b,2002-02-01,21,6,21,6,27
21204,PUERTO PEREZ,estado nutricional en menores de 5 anos,clasificacion a y b,2002-02-01,1,3,1,3,4
71402,PUERTO QUIJARRO,estado nutricional en menores de 5 anos,clasificacion a y b,2002-02-01,31,1,31,1,32
90201,PUERTO RICO,estado nutricional en menores de 5 anos,clasificacion a y b,2002-02-01,1,3,1,3,4
71401,PUERTO SUAREZ,estado nutricional en menores de 5 anos,clasificacion a y b,2002-02-01,33,7,33,7,40
31205,PUERTO VILLARROEL,estado nutricional en menores de 5 anos,clasificacion a y b,2002-02-01,59,19,59,19,78
51101,PUNA,estado nutricional en menores de 5 anos,clasificacion a y b,2002-02-01,11,29,11,29,40
31401,PUNATA,estado nutricional en menores de 5 anos,clasificacion a y b,2002-02-01,0,3,0,3,3
20604,QUIABAYA,estado nutricional en menores de 5 anos,clasificacion a y b,2002-02-01,2,1,2,1,3
30901,QUILLACOLLO,estado nutricional en menores de 5 anos,clasificacion a y b,2002-02-01,2,0,2,0,2
21002,QUIME,estado nutricional en menores de 5 anos,clasificacion a y b,2002-02-01,8,15,8,15,23
50402,RAVELO,estado nutricional en menores de 5 anos,clasificacion a y b,2002-02-01,19,2,19,2,21
80301,REYES,estado nutricional en menores de 5 anos,clasificacion a y b,2002-02-01,10,2,10,2,12
80201,RIBERALTA,estado nutricional en menores de 5 anos,clasificacion a y b,2002-02-01,98,26,98,26,124
70503,ROBORE,estado nutricional en menores de 5 anos,clasificacion a y b,2002-02-01,11,17,11,17,28
80304,RURRENABAQUE,estado nutricional en menores de 5 anos,clasificacion a y b,2002-02-01,3,2,3,2,5
40901,SABAYA,estado nutricional en menores de 5 anos,clasificacion a y b,2002-02-01,1,3,1,3,4
31001,SACABA,estado nutricional en menores de 5 anos,clasificacion a y b,2002-02-01,86,23,86,23,109
30404,SACABAMBA,estado nutricional en menores de 5 anos,clasificacion a y b,2002-02-01,1,6,1,6,7
50701,SACACA,estado nutricional en menores de 5 anos,clasificacion a y b,2002-02-01,3,9,3,9,12
71302,SAIPINA,estado nutricional en menores de 5 anos,clasificacion a y b,2002-02-01,29,9,29,9,38
40801,SALINAS DE GARCI MENDOZA,estado nutricional en menores de 5 anos,clasificacion a y b,2002-02-01,1,0,1,0,1
70901,SAMAIPATA,estado nutricional en menores de 5 anos,clasificacion a y b,2002-02-01,17,1,17,1,18
51601,SAN AGUSTIN,estado nutricional en menores de 5 anos,clasificacion a y b,2002-02-01,1,5,1,5,6
51003,SAN ANTONIO DE ESMORUCO,estado nutricional en menores de 5 anos,clasificacion a y b,2002-02-01,1,0,1,0,1
71105,SAN ANTONIO DE LOMERIO,estado nutricional en menores de 5 anos,clasificacion a y b,2002-02-01,17,4,17,4,21
31403,SAN BENITO,estado nutricional en menores de 5 anos,clasificacion a y b,2002-02-01,0,6,0,6,6
80302,SAN BORJA,estado nutricional en menores de 5 anos,clasificacion a y b,2002-02-01,60,14,60,14,74
21502,SAN BUENA VENTURA,estado nutricional en menores de 5 anos,clasificacion a y b,2002-02-01,21,4,21,4,25
70402,SAN CARLOS,estado nutricional en menores de 5 anos,clasificacion a y b,2002-02-01,22,7,22,7,29
80501,SAN IGNACIO,estado nutricional en menores de 5 anos,clasificacion a y b,2002-02-01,12,28,12,28,40
70301,SAN IGNACIO DE VELASCO,estado nutricional en menores de 5 anos,clasificacion a y b,2002-02-01,144,36,144,36,180
80102,SAN JAVIER(BNI),estado nutricional en menores de 5 anos,clasificacion a y b,2002-02-01,3,9,3,9,12
71102,SAN JAVIER(STC),estado nutricional en menores de 5 anos,clasificacion a y b,2002-02-01,7,49,7,49,56
80701,SAN JOAQUIN,estado nutricional en menores de 5 anos,clasificacion a y b,2002-02-01,1,8,1,8,9
70501,SAN JOSE DE CHIQUITOS,estado nutricional en menores de 5 anos,clasificacion a y b,2002-02-01,16,10,16,10,26
71104,SAN JULIAN,estado nutricional en menores de 5 anos,clasificacion a y b,2002-02-01,118,58,118,58,176
60501,SAN LORENZO(TJA),estado nutricional en menores de 5 anos,clasificacion a y b,2002-02-01,5,1,5,1,6
10702,SAN LUCAS,estado nutricional en menores de 5 anos,clasificacion a y b,2002-02-01,5,26,5,26,31
71201,SAN MATIAS,estado nutricional en menores de 5 anos,clasificacion a y b,2002-02-01,27,34,27,34,61
70302,SAN MIGUEL DE VELASCO,estado nutricional en menores de 5 anos,clasificacion a y b,2002-02-01,25,6,25,6,31
51001,SAN PABLO DE LIPEZ,estado nutricional en menores de 5 anos,clasificacion a y b,2002-02-01,1,0,1,0,1
50501,SAN PEDRO DE BUENA VISTA,estado nutricional en menores de 5 anos,clasificacion a y b,2002-02-01,2,11,2,11,13
21801,SAN PEDRO DE CURAHUARA,estado nutricional en menores de 5 anos,clasificacion a y b,2002-02-01,2,5,2,5,7
50902,SAN PEDRO DE QUEMES,estado nutricional en menores de 5 anos,clasificacion a y b,2002-02-01,0,1,0,1,1
21702,SAN PEDRO DE TIQUINA,estado nutricional en menores de 5 anos,clasificacion a y b,2002-02-01,2,9,2,9,11
90202,SAN PEDRO(PND),estado nutricional en menores de 5 anos,clasificacion a y b,2002-02-01,1,0,1,0,1
70303,SAN RAFAEL,estado nutricional en menores de 5 anos,clasificacion a y b,2002-02-01,13,3,13,3,16
80702,SAN RAMON,estado nutricional en menores de 5 anos,clasificacion a y b,2002-02-01,4,14,4,14,18
80702,SAN RAMON,estado nutricional en menores de 5 anos,clasificacion a y b,2002-02-01,49,93,49,93,142
80401,SANTA ANA,estado nutricional en menores de 5 anos,clasificacion a y b,2002-02-01,31,29,31,29,60
70101,SANTA CRUZ DE LA SIERRA,estado nutricional en menores de 5 anos,clasificacion a y b,2002-02-01,827,559,827,559,1386
80303,SANTA ROSA,estado nutricional en menores de 5 anos,clasificacion a y b,2002-02-01,5,1,5,1,6
70602,SANTA ROSA DEL SARA,estado nutricional en menores de 5 anos,clasificacion a y b,2002-02-01,8,10,8,10,18
41401,SANTIAGO DE HUARI,estado nutricional en menores de 5 anos,clasificacion a y b,2002-02-01,12,1,12,1,13
21901,SANTIAGO DE MACHACA,estado nutricional en menores de 5 anos,clasificacion a y b,2002-02-01,2,0,2,0,2
30702,SANTIVAÃ‘ES,estado nutricional en menores de 5 anos,clasificacion a y b,2002-02-01,3,2,3,2,5
40202,SANTUARIO DE QUILLACAS,estado nutricional en menores de 5 anos,clasificacion a y b,2002-02-01,1,0,1,0,1
20902,SAPAHAQUI,estado nutricional en menores de 5 anos,clasificacion a y b,2002-02-01,0,2,0,2,2
21301,SICA SICA (VILLA AROMA),estado nutricional en menores de 5 anos,clasificacion a y b,2002-02-01,6,3,6,3,9
30703,SICAYA,estado nutricional en menores de 5 anos,clasificacion a y b,2002-02-01,2,3,2,3,5
30902,SIPE SIPE,estado nutricional en menores de 5 anos,clasificacion a y b,2002-02-01,40,27,40,27,67
10403,SOPACHUY,estado nutricional en menores de 5 anos,clasificacion a y b,2002-02-01,9,2,9,2,11
20601,SORATA,estado nutricional en menores de 5 anos,clasificacion a y b,2002-02-01,11,6,11,6,17
10101,SUCRE,estado nutricional en menores de 5 anos,clasificacion a y b,2002-02-01,64,262,64,262,326
31404,TACACHI,estado nutricional en menores de 5 anos,clasificacion a y b,2002-02-01,2,1,2,1,3
20603,TACACOMA,estado nutricional en menores de 5 anos,clasificacion a y b,2002-02-01,9,6,9,6,15
50303,TACOBAMBA,estado nutricional en menores de 5 anos,clasificacion a y b,2002-02-01,5,12,5,12,17
51402,TAHUA,estado nutricional en menores de 5 anos,clasificacion a y b,2002-02-01,1,2,1,2,3
31101,TAPACARI,estado nutricional en menores de 5 anos,clasificacion a y b,2002-02-01,5,15,5,15,20
10601,TARABUCO,estado nutricional en menores de 5 anos,clasificacion a y b,2002-02-01,30,47,30,47,77
30401,TARATA,estado nutricional en menores de 5 anos,clasificacion a y b,2002-02-01,1,3,1,3,4
60101,TARIJA,estado nutricional en menores de 5 anos,clasificacion a y b,2002-02-01,70,153,70,153,223
10202,TARVITA,estado nutricional en menores de 5 anos,clasificacion a y b,2002-02-01,20,2,20,2,22
20803,TIAWANACU,estado nutricional en menores de 5 anos,clasificacion a y b,2002-02-01,26,3,26,3,29
20606,TIPUANI,estado nutricional en menores de 5 anos,clasificacion a y b,2002-02-01,12,2,12,2,14
30903,TIQUIPAYA,estado nutricional en menores de 5 anos,clasificacion a y b,2002-02-01,3,10,3,10,13
31601,TIRAQUE (CBBA),estado nutricional en menores de 5 anos,clasificacion a y b,2002-02-01,56,31,56,31,87
30802,TOCO,estado nutricional en menores de 5 anos,clasificacion a y b,2002-02-01,1,2,1,2,3
41001,TOLEDO,estado nutricional en menores de 5 anos,clasificacion a y b,2002-02-01,7,1,7,1,8
51202,TOMAVE,estado nutricional en menores de 5 anos,clasificacion a y b,2002-02-01,6,20,6,20,26
10402,TOMINA,estado nutricional en menores de 5 anos,clasificacion a y b,2002-02-01,29,9,29,9,38
50502,TORO TORO,estado nutricional en menores de 5 anos,clasificacion a y b,2002-02-01,5,2,5,2,7
31201,TOTORA(CBBA),estado nutricional en menores de 5 anos,clasificacion a y b,2002-02-01,21,7,21,7,28
41301,TOTORA(ORR),estado nutricional en menores de 5 anos,clasificacion a y b,2002-02-01,2,4,2,4,6
70802,TRIGAL,estado nutricional en menores de 5 anos,clasificacion a y b,2002-02-01,3,0,3,0,3
50801,TUPIZA,estado nutricional en menores de 5 anos,clasificacion a y b,2002-02-01,14,48,14,48,62
40402,TURCO,estado nutricional en menores de 5 anos,clasificacion a y b,2002-02-01,10,1,10,1,11
21302,UMALA,estado nutricional en menores de 5 anos,clasificacion a y b,2002-02-01,1,0,1,0,1
60401,URIONDO (A. CONCEPCION),estado nutricional en menores de 5 anos,clasificacion a y b,2002-02-01,14,40,14,40,54
71502,URUBICHA,estado nutricional en menores de 5 anos,clasificacion a y b,2002-02-01,6,20,6,20,26
51201,UYUNI,estado nutricional en menores de 5 anos,clasificacion a y b,2002-02-01,4,6,4,6,10
30502,VACAS,estado nutricional en menores de 5 anos,clasificacion a y b,2002-02-01,1,1,1,1,2
70801,VALLEGRANDE,estado nutricional en menores de 5 anos,clasificacion a y b,2002-02-01,25,24,25,24,49
20801,VIACHA,estado nutricional en menores de 5 anos,clasificacion a y b,2002-02-01,11,20,11,20,31
31302,VILA VILA,estado nutricional en menores de 5 anos,clasificacion a y b,2002-02-01,1,4,1,4,5
60303,VILLA MONTES,estado nutricional en menores de 5 anos,clasificacion a y b,2002-02-01,19,13,19,13,32
90502,VILLA NUEVA (LOMA ALTA),estado nutricional en menores de 5 anos,clasificacion a y b,2002-02-01,2,0,2,0,2
31402,VILLA RIVERO,estado nutricional en menores de 5 anos,clasificacion a y b,2002-02-01,0,5,0,5,5
10801,VILLA SERRANO,estado nutricional en menores de 5 anos,clasificacion a y b,2002-02-01,12,4,12,4,16
31003,VILLA TUNARI,estado nutricional en menores de 5 anos,clasificacion a y b,2002-02-01,29,36,29,36,65
11001,VILLA VACA GUZMAN (MUYUPAMPA),estado nutricional en menores de 5 anos,clasificacion a y b,2002-02-01,41,21,41,21,62
51501,VILLAZON,estado nutricional en menores de 5 anos,clasificacion a y b,2002-02-01,13,55,13,55,68
30904,VINTO,estado nutricional en menores de 5 anos,clasificacion a y b,2002-02-01,30,34,30,34,64
50602,VITICHI,estado nutricional en menores de 5 anos,clasificacion a y b,2002-02-01,23,5,23,5,28
70201,WARNES,estado nutricional en menores de 5 anos,clasificacion a y b,2002-02-01,70,61,70,61,131
20903,YACO,estado nutricional en menores de 5 anos,clasificacion a y b,2002-02-01,3,6,3,6,9
60301,YACUIBA,estado nutricional en menores de 5 anos,clasificacion a y b,2002-02-01,30,4,30,4,34
10602,YAMPARAEZ,estado nutricional en menores de 5 anos,clasificacion a y b,2002-02-01,38,10,38,10,48
21103,YANACACHI,estado nutricional en menores de 5 anos,clasificacion a y b,2002-02-01,8,5,8,5,13
70403,YAPACANI,estado nutricional en menores de 5 anos,clasificacion a y b,2002-02-01,78,34,78,34,112
50103,YOCALLA,estado nutricional en menores de 5 anos,clasificacion a y b,2002-02-01,3,7,3,7,10
10102,YOTALA,estado nutricional en menores de 5 anos,clasificacion a y b,2002-02-01,41,6,41,6,47
60402,YUNCHARA,estado nutricional en menores de 5 anos,clasificacion a y b,2002-02-01,8,6,8,6,14
10301,ZUDAÃ‘EZ,estado nutricional en menores de 5 anos,clasificacion a y b,2002-02-01,26,7,26,7,33
51302,ACACIO,estado nutricional en menores de 5 anos,clasificacion a y b,2002-03-01,1,0,1,0,1
20201,ACHACACHI,estado nutricional en menores de 5 anos,clasificacion a y b,2002-03-01,49,85,49,85,134
20104,ACHOCALLA,estado nutricional en menores de 5 anos,clasificacion a y b,2002-03-01,12,1,12,1,13
30201,AIQUILE,estado nutricional en menores de 5 anos,clasificacion a y b,2002-03-01,3,0,3,0,3
31303,ALALAY,estado nutricional en menores de 5 anos,clasificacion a y b,2002-03-01,0,1,0,1,1
10404,ALCALA,estado nutricional en menores de 5 anos,clasificacion a y b,2002-03-01,18,6,18,6,24
20202,ANCORAIMES,estado nutricional en menores de 5 anos,clasificacion a y b,2002-03-01,18,5,18,5,23
41201,ANDAMARCA,estado nutricional en menores de 5 anos,clasificacion a y b,2002-03-01,1,0,1,0,1
30402,ANZALDO,estado nutricional en menores de 5 anos,clasificacion a y b,2002-03-01,0,7,0,7,7
20701,APOLO,estado nutricional en menores de 5 anos,clasificacion a y b,2002-03-01,20,3,20,3,23
51301,ARAMPAMPA,estado nutricional en menores de 5 anos,clasificacion a y b,2002-03-01,3,8,3,8,11
30501,ARANI,estado nutricional en menores de 5 anos,clasificacion a y b,2002-03-01,3,11,3,11,14
30403,ARBIETO,estado nutricional en menores de 5 anos,clasificacion a y b,2002-03-01,7,17,7,17,24
30601,ARQUE,estado nutricional en menores de 5 anos,clasificacion a y b,2002-03-01,9,3,9,3,12
71501,ASCENCION DE GUARAYOS,estado nutricional en menores de 5 anos,clasificacion a y b,2002-03-01,0,1,0,1,1
50802,ATOCHA,estado nutricional en menores de 5 anos,clasificacion a y b,2002-03-01,0,4,0,4,4
21303,AYO AYO,estado nutricional en menores de 5 anos,clasificacion a y b,2002-03-01,9,0,9,0,9
30301,AYOPAYA (V. DE INDEPENDENCIA),estado nutricional en menores de 5 anos,clasificacion a y b,2002-03-01,20,6,20,6,26
10201,AZURDUY,estado nutricional en menores de 5 anos,clasificacion a y b,2002-03-01,20,14,20,14,34
21203,BATALLAS,estado nutricional en menores de 5 anos,clasificacion a y b,2002-03-01,2,25,2,25,27
80802,BAURES,estado nutricional en menores de 5 anos,clasificacion a y b,2002-03-01,7,4,7,4,11
41202,BELEN DE ANDAMARCA,estado nutricional en menores de 5 anos,clasificacion a y b,2002-03-01,1,0,1,0,1
50104,BELEN DE URMIRI,estado nutricional en menores de 5 anos,clasificacion a y b,2002-03-01,0,5,0,5,5
90104,BELLA FLOR,estado nutricional en menores de 5 anos,clasificacion a y b,2002-03-01,2,4,2,4,6
60202,BERMEJO,estado nutricional en menores de 5 anos,clasificacion a y b,2002-03-01,2,34,2,34,36
50301,BETANZOS,estado nutricional en menores de 5 anos,clasificacion a y b,2002-03-01,46,35,46,35,81
31501,BOLIVAR,estado nutricional en menores de 5 anos,clasificacion a y b,2002-03-01,1,3,1,3,4
90103,BOLPEBRA,estado nutricional en menores de 5 anos,clasificacion a y b,2002-03-01,2,7,2,7,9
70707,BOYUIBE,estado nutricional en menores de 5 anos,clasificacion a y b,2002-03-01,6,18,6,18,24
70401,BUENA VISTA,estado nutricional en menores de 5 anos,clasificacion a y b,2002-03-01,79,19,79,19,98
70703,CABEZAS,estado nutricional en menores de 5 anos,clasificacion a y b,2002-03-01,7,50,7,50,57
20905,CAIROMA,estado nutricional en menores de 5 anos,clasificacion a y b,2002-03-01,3,10,3,10,13
51102,"CAIZA ""D""",estado nutricional en menores de 5 anos,clasificacion a y b,2002-03-01,20,7,20,7,27
21003,CAJUATA,estado nutricional en menores de 5 anos,clasificacion a y b,2002-03-01,14,0,14,0,14
21304,CALAMARCA,estado nutricional en menores de 5 anos,clasificacion a y b,2002-03-01,6,3,6,3,9
10701,CAMARGO,estado nutricional en menores de 5 anos,clasificacion a y b,2002-03-01,10,40,10,40,50
10901,CAMATAQUI (C. VILLA ABECIA),estado nutricional en menores de 5 anos,clasificacion a y b,2002-03-01,3,11,3,11,14
70706,CAMIRI,estado nutricional en menores de 5 anos,clasificacion a y b,2002-03-01,55,24,55,24,79
30701,CAPINOTA,estado nutricional en menores de 5 anos,clasificacion a y b,2002-03-01,1,1,1,1,2
20302,CAQUIAVIRI,estado nutricional en menores de 5 anos,clasificacion a y b,2002-03-01,20,5,20,5,25
40102,CARACOLLO,estado nutricional en menores de 5 anos,clasificacion a y b,2002-03-01,14,17,14,17,31
22001,CARANAVI,estado nutricional en menores de 5 anos,clasificacion a y b,2002-03-01,101,47,101,47,148
41503,CARANGAS,estado nutricional en menores de 5 anos,clasificacion a y b,2002-03-01,0,1,0,1,1
60302,CARAPARI,estado nutricional en menores de 5 anos,clasificacion a y b,2002-03-01,17,32,17,32,49
50702,CARIPUYO,estado nutricional en menores de 5 anos,clasificacion a y b,2002-03-01,3,4,3,4,7
21902,CATACORA,estado nutricional en menores de 5 anos,clasificacion a y b,2002-03-01,1,0,1,0,1
40201,CHALLAPATA,estado nutricional en menores de 5 anos,clasificacion a y b,2002-03-01,21,1,21,1,22
50302,CHAQUI,estado nutricional en menores de 5 anos,clasificacion a y b,2002-03-01,1,8,1,8,9
70702,CHARAGUA,estado nutricional en menores de 5 anos,clasificacion a y b,2002-03-01,22,63,22,63,85
20305,CHARAÃ‘A,estado nutricional en menores de 5 anos,clasificacion a y b,2002-03-01,0,1,0,1,1
31204,CHIMORE,estado nutricional en menores de 5 anos,clasificacion a y b,2002-03-01,16,5,16,5,21
40903,CHIPAYA,estado nutricional en menores de 5 anos,clasificacion a y b,2002-03-01,0,2,0,2,2
21101,CHULUMANI (V. DE LA LIBERTAD),estado nutricional en menores de 5 anos,clasificacion a y b,2002-03-01,6,9,6,9,15
20501,CHUMA,estado nutricional en menores de 5 anos,clasificacion a y b,2002-03-01,8,3,8,3,11
30801,CLIZA,estado nutricional en menores de 5 anos,clasificacion a y b,2002-03-01,10,14,10,14,24
90101,COBIJA,estado nutricional en menores de 5 anos,clasificacion a y b,2002-03-01,71,0,71,0,71
30101,COCHABAMBA,estado nutricional en menores de 5 anos,clasificacion a y b,2002-03-01,938,1398,938,1398,2336
30905,COLCAPIRHUA,estado nutricional en menores de 5 anos,clasificacion a y b,2002-03-01,53,11,53,11,64
50901,"COLCHA ""K""",estado nutricional en menores de 5 anos,clasificacion a y b,2002-03-01,3,18,3,18,21
21307,COLLANA,estado nutricional en menores de 5 anos,clasificacion a y b,2002-03-01,2,0,2,0,2
31002,COLOMI,estado nutricional en menores de 5 anos,clasificacion a y b,2002-03-01,20,4,20,4,24
50401,COLQUECHACA,estado nutricional en menores de 5 anos,clasificacion a y b,2002-03-01,6,1,6,1,7
21306,COLQUENCHA,estado nutricional en menores de 5 anos,clasificacion a y b,2002-03-01,10,0,10,0,10
21004,COLQUIRI,estado nutricional en menores de 5 anos,clasificacion a y b,2002-03-01,14,12,14,12,26
20304,COMANCHE,estado nutricional en menores de 5 anos,clasificacion a y b,2002-03-01,2,3,2,3,5
71301,COMARAPA,estado nutricional en menores de 5 anos,clasificacion a y b,2002-03-01,10,9,10,9,19
20605,COMBAYA,estado nutricional en menores de 5 anos,clasificacion a y b,2002-03-01,4,2,4,2,6
71101,CONCEPCION,estado nutricional en menores de 5 anos,clasificacion a y b,2002-03-01,4,27,4,27,31
21701,COPACABANA,estado nutricional en menores de 5 anos,clasificacion a y b,2002-03-01,1,13,1,13,14
21402,CORIPATA,estado nutricional en menores de 5 anos,clasificacion a y b,2002-03-01,18,31,18,31,49
20301,CORO CORO,estado nutricional en menores de 5 anos,clasificacion a y b,2002-03-01,6,3,6,3,9
21401,COROICO,estado nutricional en menores de 5 anos,clasificacion a y b,2002-03-01,11,3,11,3,14
40301,CORQUE,estado nutricional en menores de 5 anos,clasificacion a y b,2002-03-01,5,0,5,0,5
50601,COTAGAITA,estado nutricional en menores de 5 anos,clasificacion a y b,2002-03-01,15,25,15,25,40
70102,COTOCA,estado nutricional en menores de 5 anos,clasificacion a y b,2002-03-01,172,21,172,21,193
31405,CUCHUMUELA (V. G. VILLARROEL),estado nutricional en menores de 5 anos,clasificacion a y b,2002-03-01,1,8,1,8,9
70704,CUEVO,estado nutricional en menores de 5 anos,clasificacion a y b,2002-03-01,19,5,19,5,24
10902,CULPINA,estado nutricional en menores de 5 anos,clasificacion a y b,2002-03-01,26,37,26,37,63
40401,CURAHUARA DE CARANGAS,estado nutricional en menores de 5 anos,clasificacion a y b,2002-03-01,4,2,4,2,6
21602,CURVA,estado nutricional en menores de 5 anos,clasificacion a y b,2002-03-01,3,0,3,0,3
20804,DESAGUADERO,estado nutricional en menores de 5 anos,clasificacion a y b,2002-03-01,0,5,0,5,5
20105,EL ALTO,estado nutricional en menores de 5 anos,clasificacion a y b,2002-03-01,467,287,467,287,754
40103,EL CHORO,estado nutricional en menores de 5 anos,clasificacion a y b,2002-03-01,2,2,2,2,4
71503,EL PUENTE(STC),estado nutricional en menores de 5 anos,clasificacion a y b,2002-03-01,23,22,23,22,45
60502,EL PUENTE(TJA),estado nutricional en menores de 5 anos,clasificacion a y b,2002-03-01,2,4,2,4,6
70105,EL TORNO,estado nutricional en menores de 5 anos,clasificacion a y b,2002-03-01,123,40,123,40,163
10405,EL VILLAR,estado nutricional en menores de 5 anos,clasificacion a y b,2002-03-01,16,4,16,4,20
60601,ENTRE RIOS,estado nutricional en menores de 5 anos,clasificacion a y b,2002-03-01,25,17,25,17,42
41101,EUCALIPTUS,estado nutricional en menores de 5 anos,clasificacion a y b,2002-03-01,2,6,2,6,8
80402,EXALTACION,estado nutricional en menores de 5 anos,clasificacion a y b,2002-03-01,1,0,1,0,1
90203,FILADELFIA,estado nutricional en menores de 5 anos,clasificacion a y b,2002-03-01,3,5,3,5,8
71002,GENERAL SAAVEDRA,estado nutricional en menores de 5 anos,clasificacion a y b,2002-03-01,55,63,55,63,118
21601,GRAL. J.J. PEREZ (CHARAZANI),estado nutricional en menores de 5 anos,clasificacion a y b,2002-03-01,4,3,4,3,7
20602,GUANAY,estado nutricional en menores de 5 anos,clasificacion a y b,2002-03-01,21,94,21,94,115
20802,GUAQUI,estado nutricional en menores de 5 anos,clasificacion a y b,2002-03-01,0,5,0,5,5
80202,GUAYARAMERIN,estado nutricional en menores de 5 anos,clasificacion a y b,2002-03-01,47,17,47,17,64
70705,GUTIERREZ,estado nutricional en menores de 5 anos,clasificacion a y b,2002-03-01,16,48,16,48,64
10502,HUACARETA,estado nutricional en menores de 5 anos,clasificacion a y b,2002-03-01,59,15,59,15,74
11002,HUACAYA (VILLA DE HUACAYA),estado nutricional en menores de 5 anos,clasificacion a y b,2002-03-01,4,0,4,0,4
40501,HUACHACALLA,estado nutricional en menores de 5 anos,clasificacion a y b,2002-03-01,0,2,0,2,2
40701,HUANUNI,estado nutricional en menores de 5 anos,clasificacion a y b,2002-03-01,1,0,1,0,1
80803,HUARACAJE,estado nutricional en menores de 5 anos,clasificacion a y b,2002-03-01,9,8,9,8,17
41601,HUAYLLAMARCA,estado nutricional en menores de 5 anos,clasificacion a y b,2002-03-01,2,0,2,0,2
21005,ICHOCA,estado nutricional en menores de 5 anos,clasificacion a y b,2002-03-01,1,1,1,1,2
10304,ICLA,estado nutricional en menores de 5 anos,clasificacion a y b,2002-03-01,14,11,14,11,25
10703,INCAHUASI,estado nutricional en menores de 5 anos,clasificacion a y b,2002-03-01,11,50,11,50,61
21001,INQUISIVI,estado nutricional en menores de 5 anos,clasificacion a y b,2002-03-01,3,4,3,4,7
21102,IRUPANA (VILLA DE LANZA),estado nutricional en menores de 5 anos,clasificacion a y b,2002-03-01,16,14,16,14,30
21501,IXIAMAS,estado nutricional en menores de 5 anos,clasificacion a y b,2002-03-01,49,14,49,14,63
21105,LA ASUNTA,estado nutricional en menores de 5 anos,clasificacion a y b,2002-03-01,21,27,21,27,48
70104,LA GUARDIA,estado nutricional en menores de 5 anos,clasificacion a y b,2002-03-01,134,25,134,25,159
20101,LA PAZ,estado nutricional en menores de 5 anos,clasificacion a y b,2002-03-01,445,278,445,278,723
70701,LAGUNILLAS,estado nutricional en menores de 5 anos,clasificacion a y b,2002-03-01,14,23,14,23,37
21202,LAJA,estado nutricional en menores de 5 anos,clasificacion a y b,2002-03-01,5,15,5,15,20
10903,LAS CARRERAS,estado nutricional en menores de 5 anos,clasificacion a y b,2002-03-01,5,8,5,8,13
21006,LICOMA PAMPA,estado nutricional en menores de 5 anos,clasificacion a y b,2002-03-01,1,6,1,6,7
51401,LLICA,estado nutricional en menores de 5 anos,clasificacion a y b,2002-03-01,3,7,3,7,10
80601,LORETO,estado nutricional en menores de 5 anos,clasificacion a y b,2002-03-01,1,3,1,3,4
20901,LURIBAY,estado nutricional en menores de 5 anos,clasificacion a y b,2002-03-01,9,45,9,45,54
40702,MACHACAMARCA,estado nutricional en menores de 5 anos,clasificacion a y b,2002-03-01,5,4,5,4,9
11003,MACHARETI,estado nutricional en menores de 5 anos,clasificacion a y b,2002-03-01,25,15,25,15,40
80801,MAGDALENA,estado nutricional en menores de 5 anos,clasificacion a y b,2002-03-01,7,6,7,6,13
70903,MAIRANA,estado nutricional en menores de 5 anos,clasificacion a y b,2002-03-01,47,10,47,10,57
20103,MECAPACA,estado nutricional en menores de 5 anos,clasificacion a y b,2002-03-01,11,4,11,4,15
71003,MINEROS,estado nutricional en menores de 5 anos,clasificacion a y b,2002-03-01,76,54,76,54,130
31301,MIZQUE,estado nutricional en menores de 5 anos,clasificacion a y b,2002-03-01,4,14,4,14,18
20402,MOCOMOCO,estado nutricional en menores de 5 anos,clasificacion a y b,2002-03-01,14,2,14,2,16
10303,MOJOCOYA,estado nutricional en menores de 5 anos,clasificacion a y b,2002-03-01,47,13,47,13,60
10501,MONTEAGUDO,estado nutricional en menores de 5 anos,clasificacion a y b,2002-03-01,118,31,118,31,149
71001,MONTERO,estado nutricional en menores de 5 anos,clasificacion a y b,2002-03-01,48,358,48,358,406
70803,MORO MORO,estado nutricional en menores de 5 anos,clasificacion a y b,2002-03-01,12,5,12,5,17
30302,MOROCHATA,estado nutricional en menores de 5 anos,clasificacion a y b,2002-03-01,30,21,30,21,51
90401,NACEBE (SANTA ROSA DEL ABUNA),estado nutricional en menores de 5 anos,clasificacion a y b,2002-03-01,0,5,0,5,5
50404,OCURI,estado nutricional en menores de 5 anos,clasificacion a y b,2002-03-01,5,15,5,15,20
70202,OKINAWA,estado nutricional en menores de 5 anos,clasificacion a y b,2002-03-01,10,3,10,3,13
30203,OMEREQUE,estado nutricional en menores de 5 anos,clasificacion a y b,2002-03-01,2,4,2,4,6
40101,ORURO,estado nutricional en menores de 5 anos,clasificacion a y b,2002-03-01,230,112,230,112,342
60201,PADCAYA,estado nutricional en menores de 5 anos,clasificacion a y b,2002-03-01,29,26,29,26,55
10401,PADILLA,estado nutricional en menores de 5 anos,clasificacion a y b,2002-03-01,46,6,46,6,52
70502,PAILON,estado nutricional en menores de 5 anos,clasificacion a y b,2002-03-01,26,80,26,80,106
20102,PALCA,estado nutricional en menores de 5 anos,clasificacion a y b,2002-03-01,22,3,22,3,25
21104,PALOS BLANCOS,estado nutricional en menores de 5 anos,clasificacion a y b,2002-03-01,49,17,49,17,66
40802,PAMPA AULLAGAS,estado nutricional en menores de 5 anos,clasificacion a y b,2002-03-01,0,3,0,3,3
70902,PAMPA GRANDE,estado nutricional en menores de 5 anos,clasificacion a y b,2002-03-01,25,7,25,7,32
21802,PAPEL PAMPA,estado nutricional en menores de 5 anos,clasificacion a y b,2002-03-01,0,8,0,8,8
30202,PASORAPA,estado nutricional en menores de 5 anos,clasificacion a y b,2002-03-01,15,6,15,6,21
21305,PATACAMAYA,estado nutricional en menores de 5 anos,clasificacion a y b,2002-03-01,9,2,9,2,11
40602,PAZÃ‘A,estado nutricional en menores de 5 anos,clasificacion a y b,2002-03-01,3,4,3,4,7
50403,POCOATA,estado nutricional en menores de 5 anos,clasificacion a y b,2002-03-01,21,8,21,8,29
31203,POCONA,estado nutricional en menores de 5 anos,clasificacion a y b,2002-03-01,10,5,10,5,15
31202,POJO (CBBA),estado nutricional en menores de 5 anos,clasificacion a y b,2002-03-01,61,65,61,65,126
40601,POOPO,estado nutricional en menores de 5 anos,clasificacion a y b,2002-03-01,1,3,1,3,4
51203,PORCO,estado nutricional en menores de 5 anos,clasificacion a y b,2002-03-01,4,6,4,6,10
10103,POROMA,estado nutricional en menores de 5 anos,clasificacion a y b,2002-03-01,20,14,20,14,34
70103,PORONGO,estado nutricional en menores de 5 anos,clasificacion a y b,2002-03-01,22,5,22,5,27
70601,PORTACHUELO,estado nutricional en menores de 5 anos,clasificacion a y b,2002-03-01,74,22,74,22,96
90102,PORVENIR,estado nutricional en menores de 5 anos,clasificacion a y b,2002-03-01,0,1,0,1,1
70804,POSTRER VALLE,estado nutricional en menores de 5 anos,clasificacion a y b,2002-03-01,6,2,6,2,8
50101,POTOSI,estado nutricional en menores de 5 anos,clasificacion a y b,2002-03-01,65,25,65,25,90
10302,PRESTO,estado nutricional en menores de 5 anos,clasificacion a y b,2002-03-01,30,2,30,2,32
21201,PUCARANI,estado nutricional en menores de 5 anos,clasificacion a y b,2002-03-01,9,46,9,46,55
20401,PUERTO ACOSTA,estado nutricional en menores de 5 anos,clasificacion a y b,2002-03-01,5,5,5,5,10
20403,PUERTO CARABUCO,estado nutricional en menores de 5 anos,clasificacion a y b,2002-03-01,19,2,19,2,21
90301,PUERTO GONZALO MORENO,estado nutricional en menores de 5 anos,clasificacion a y b,2002-03-01,3,0,3,0,3
21204,PUERTO PEREZ,estado nutricional en menores de 5 anos,clasificacion a y b,2002-03-01,1,8,1,8,9
71402,PUERTO QUIJARRO,estado nutricional en menores de 5 anos,clasificacion a y b,2002-03-01,33,8,33,8,41
90201,PUERTO RICO,estado nutricional en menores de 5 anos,clasificacion a y b,2002-03-01,3,13,3,13,16
71401,PUERTO SUAREZ,estado nutricional en menores de 5 anos,clasificacion a y b,2002-03-01,33,15,33,15,48
31205,PUERTO VILLARROEL,estado nutricional en menores de 5 anos,clasificacion a y b,2002-03-01,64,26,64,26,90
51101,PUNA,estado nutricional en menores de 5 anos,clasificacion a y b,2002-03-01,30,47,30,47,77
31401,PUNATA,estado nutricional en menores de 5 anos,clasificacion a y b,2002-03-01,5,10,5,10,15
20604,QUIABAYA,estado nutricional en menores de 5 anos,clasificacion a y b,2002-03-01,2,6,2,6,8
30901,QUILLACOLLO,estado nutricional en menores de 5 anos,clasificacion a y b,2002-03-01,23,6,23,6,29
21002,QUIME,estado nutricional en menores de 5 anos,clasificacion a y b,2002-03-01,9,17,9,17,26
50402,RAVELO,estado nutricional en menores de 5 anos,clasificacion a y b,2002-03-01,11,6,11,6,17
80301,REYES,estado nutricional en menores de 5 anos,clasificacion a y b,2002-03-01,7,2,7,2,9
80201,RIBERALTA,estado nutricional en menores de 5 anos,clasificacion a y b,2002-03-01,177,40,177,40,217
70503,ROBORE,estado nutricional en menores de 5 anos,clasificacion a y b,2002-03-01,6,30,6,30,36
80304,RURRENABAQUE,estado nutricional en menores de 5 anos,clasificacion a y b,2002-03-01,37,33,37,33,70
40901,SABAYA,estado nutricional en menores de 5 anos,clasificacion a y b,2002-03-01,0,1,0,1,1
31001,SACABA,estado nutricional en menores de 5 anos,clasificacion a y b,2002-03-01,75,43,75,43,118
30404,SACABAMBA,estado nutricional en menores de 5 anos,clasificacion a y b,2002-03-01,2,2,2,2,4
50701,SACACA,estado nutricional en menores de 5 anos,clasificacion a y b,2002-03-01,8,2,8,2,10
71302,SAIPINA,estado nutricional en menores de 5 anos,clasificacion a y b,2002-03-01,40,17,40,17,57
40801,SALINAS DE GARCI MENDOZA,estado nutricional en menores de 5 anos,clasificacion a y b,2002-03-01,5,5,5,5,10
70901,SAMAIPATA,estado nutricional en menores de 5 anos,clasificacion a y b,2002-03-01,21,6,21,6,27
51601,SAN AGUSTIN,estado nutricional en menores de 5 anos,clasificacion a y b,2002-03-01,6,2,6,2,8
80602,SAN ANDRES,estado nutricional en menores de 5 anos,clasificacion a y b,2002-03-01,15,1,15,1,16
51003,SAN ANTONIO DE ESMORUCO,estado nutricional en menores de 5 anos,clasificacion a y b,2002-03-01,0,5,0,5,5
71105,SAN ANTONIO DE LOMERIO,estado nutricional en menores de 5 anos,clasificacion a y b,2002-03-01,17,5,17,5,22
31403,SAN BENITO,estado nutricional en menores de 5 anos,clasificacion a y b,2002-03-01,1,9,1,9,10
80302,SAN BORJA,estado nutricional en menores de 5 anos,clasificacion a y b,2002-03-01,85,16,85,16,101
21502,SAN BUENA VENTURA,estado nutricional en menores de 5 anos,clasificacion a y b,2002-03-01,24,6,24,6,30
70402,SAN CARLOS,estado nutricional en menores de 5 anos,clasificacion a y b,2002-03-01,18,13,18,13,31
80501,SAN IGNACIO,estado nutricional en menores de 5 anos,clasificacion a y b,2002-03-01,21,55,21,55,76
70301,SAN IGNACIO DE VELASCO,estado nutricional en menores de 5 anos,clasificacion a y b,2002-03-01,130,39,130,39,169
80102,SAN JAVIER(BNI),estado nutricional en menores de 5 anos,clasificacion a y b,2002-03-01,5,13,5,13,18
71102,SAN JAVIER(STC),estado nutricional en menores de 5 anos,clasificacion a y b,2002-03-01,12,27,12,27,39
80701,SAN JOAQUIN,estado nutricional en menores de 5 anos,clasificacion a y b,2002-03-01,2,21,2,21,23
70501,SAN JOSE DE CHIQUITOS,estado nutricional en menores de 5 anos,clasificacion a y b,2002-03-01,23,15,23,15,38
71104,SAN JULIAN,estado nutricional en menores de 5 anos,clasificacion a y b,2002-03-01,73,50,73,50,123
60501,SAN LORENZO(TJA),estado nutricional en menores de 5 anos,clasificacion a y b,2002-03-01,16,1,16,1,17
10702,SAN LUCAS,estado nutricional en menores de 5 anos,clasificacion a y b,2002-03-01,22,53,22,53,75
71201,SAN MATIAS,estado nutricional en menores de 5 anos,clasificacion a y b,2002-03-01,46,15,46,15,61
70302,SAN MIGUEL DE VELASCO,estado nutricional en menores de 5 anos,clasificacion a y b,2002-03-01,17,4,17,4,21
51001,SAN PABLO DE LIPEZ,estado nutricional en menores de 5 anos,clasificacion a y b,2002-03-01,1,5,1,5,6
50501,SAN PEDRO DE BUENA VISTA,estado nutricional en menores de 5 anos,clasificacion a y b,2002-03-01,0,12,0,12,12
21801,SAN PEDRO DE CURAHUARA,estado nutricional en menores de 5 anos,clasificacion a y b,2002-03-01,4,4,4,4,8
21702,SAN PEDRO DE TIQUINA,estado nutricional en menores de 5 anos,clasificacion a y b,2002-03-01,5,10,5,10,15
90202,SAN PEDRO(PND),estado nutricional en menores de 5 anos,clasificacion a y b,2002-03-01,1,0,1,0,1
70303,SAN RAFAEL,estado nutricional en menores de 5 anos,clasificacion a y b,2002-03-01,11,4,11,4,15
80702,SAN RAMON,estado nutricional en menores de 5 anos,clasificacion a y b,2002-03-01,22,10,22,10,32
80702,SAN RAMON,estado nutricional en menores de 5 anos,clasificacion a y b,2002-03-01,2,42,2,42,44
80401,SANTA ANA,estado nutricional en menores de 5 anos,clasificacion a y b,2002-03-01,22,24,22,24,46
70101,SANTA CRUZ DE LA SIERRA,estado nutricional en menores de 5 anos,clasificacion a y b,2002-03-01,688,487,688,487,1175
80303,SANTA ROSA,estado nutricional en menores de 5 anos,clasificacion a y b,2002-03-01,8,4,8,4,12
70602,SANTA ROSA DEL SARA,estado nutricional en menores de 5 anos,clasificacion a y b,2002-03-01,18,8,18,8,26
41401,SANTIAGO DE HUARI,estado nutricional en menores de 5 anos,clasificacion a y b,2002-03-01,5,0,5,0,5
21901,SANTIAGO DE MACHACA,estado nutricional en menores de 5 anos,clasificacion a y b,2002-03-01,7,0,7,0,7
30702,SANTIVAÃ‘ES,estado nutricional en menores de 5 anos,clasificacion a y b,2002-03-01,2,1,2,1,3
40202,SANTUARIO DE QUILLACAS,estado nutricional en menores de 5 anos,clasificacion a y b,2002-03-01,1,0,1,0,1
20902,SAPAHAQUI,estado nutricional en menores de 5 anos,clasificacion a y b,2002-03-01,0,6,0,6,6
21301,SICA SICA (VILLA AROMA),estado nutricional en menores de 5 anos,clasificacion a y b,2002-03-01,11,5,11,5,16
30902,SIPE SIPE,estado nutricional en menores de 5 anos,clasificacion a y b,2002-03-01,69,25,69,25,94
10403,SOPACHUY,estado nutricional en menores de 5 anos,clasificacion a y b,2002-03-01,8,1,8,1,9
20601,SORATA,estado nutricional en menores de 5 anos,clasificacion a y b,2002-03-01,2,19,2,19,21
10101,SUCRE,estado nutricional en menores de 5 anos,clasificacion a y b,2002-03-01,176,313,176,313,489
31404,TACACHI,estado nutricional en menores de 5 anos,clasificacion a y b,2002-03-01,0,1,0,1,1
20603,TACACOMA,estado nutricional en menores de 5 anos,clasificacion a y b,2002-03-01,13,1,13,1,14
50303,TACOBAMBA,estado nutricional en menores de 5 anos,clasificacion a y b,2002-03-01,9,3,9,3,12
30602,TACOPAYA,estado nutricional en menores de 5 anos,clasificacion a y b,2002-03-01,0,1,0,1,1
51402,TAHUA,estado nutricional en menores de 5 anos,clasificacion a y b,2002-03-01,0,3,0,3,3
31101,TAPACARI,estado nutricional en menores de 5 anos,clasificacion a y b,2002-03-01,4,8,4,8,12
10601,TARABUCO,estado nutricional en menores de 5 anos,clasificacion a y b,2002-03-01,18,54,18,54,72
30401,TARATA,estado nutricional en menores de 5 anos,clasificacion a y b,2002-03-01,2,11,2,11,13
60101,TARIJA,estado nutricional en menores de 5 anos,clasificacion a y b,2002-03-01,94,151,94,151,245
10202,TARVITA,estado nutricional en menores de 5 anos,clasificacion a y b,2002-03-01,21,0,21,0,21
20803,TIAWANACU,estado nutricional en menores de 5 anos,clasificacion a y b,2002-03-01,24,9,24,9,33
50102,TINGUIPAYA,estado nutricional en menores de 5 anos,clasificacion a y b,2002-03-01,6,1,6,1,7
20606,TIPUANI,estado nutricional en menores de 5 anos,clasificacion a y b,2002-03-01,20,2,20,2,22
30903,TIQUIPAYA,estado nutricional en menores de 5 anos,clasificacion a y b,2002-03-01,6,15,6,15,21
31601,TIRAQUE (CBBA),estado nutricional en menores de 5 anos,clasificacion a y b,2002-03-01,48,24,48,24,72
30802,TOCO,estado nutricional en menores de 5 anos,clasificacion a y b,2002-03-01,1,1,1,1,2
41001,TOLEDO,estado nutricional en menores de 5 anos,clasificacion a y b,2002-03-01,7,2,7,2,9
51202,TOMAVE,estado nutricional en menores de 5 anos,clasificacion a y b,2002-03-01,3,14,3,14,17
10402,TOMINA,estado nutricional en menores de 5 anos,clasificacion a y b,2002-03-01,36,16,36,16,52
50502,TORO TORO,estado nutricional en menores de 5 anos,clasificacion a y b,2002-03-01,6,0,6,0,6
31201,TOTORA(CBBA),estado nutricional en menores de 5 anos,clasificacion a y b,2002-03-01,29,10,29,10,39
41301,TOTORA(ORR),estado nutricional en menores de 5 anos,clasificacion a y b,2002-03-01,0,5,0,5,5
70802,TRIGAL,estado nutricional en menores de 5 anos,clasificacion a y b,2002-03-01,3,0,3,0,3
80101,TRINIDAD,estado nutricional en menores de 5 anos,clasificacion a y b,2002-03-01,96,96,96,96,192
50801,TUPIZA,estado nutricional en menores de 5 anos,clasificacion a y b,2002-03-01,16,63,16,63,79
40402,TURCO,estado nutricional en menores de 5 anos,clasificacion a y b,2002-03-01,9,1,9,1,10
21302,UMALA,estado nutricional en menores de 5 anos,clasificacion a y b,2002-03-01,2,3,2,3,5
60401,URIONDO (A. CONCEPCION),estado nutricional en menores de 5 anos,clasificacion a y b,2002-03-01,34,45,34,45,79
51201,UYUNI,estado nutricional en menores de 5 anos,clasificacion a y b,2002-03-01,11,17,11,17,28
30502,VACAS,estado nutricional en menores de 5 anos,clasificacion a y b,2002-03-01,3,1,3,1,4
70801,VALLEGRANDE,estado nutricional en menores de 5 anos,clasificacion a y b,2002-03-01,35,20,35,20,55
20801,VIACHA,estado nutricional en menores de 5 anos,clasificacion a y b,2002-03-01,17,51,17,51,68
31302,VILA VILA,estado nutricional en menores de 5 anos,clasificacion a y b,2002-03-01,2,8,2,8,10
60303,VILLA MONTES,estado nutricional en menores de 5 anos,clasificacion a y b,2002-03-01,25,28,25,28,53
90502,VILLA NUEVA (LOMA ALTA),estado nutricional en menores de 5 anos,clasificacion a y b,2002-03-01,1,0,1,0,1
31402,VILLA RIVERO,estado nutricional en menores de 5 anos,clasificacion a y b,2002-03-01,0,7,0,7,7
10801,VILLA SERRANO,estado nutricional en menores de 5 anos,clasificacion a y b,2002-03-01,21,5,21,5,26
31003,VILLA TUNARI,estado nutricional en menores de 5 anos,clasificacion a y b,2002-03-01,42,50,42,50,92
11001,VILLA VACA GUZMAN (MUYUPAMPA),estado nutricional en menores de 5 anos,clasificacion a y b,2002-03-01,69,18,69,18,87
51501,VILLAZON,estado nutricional en menores de 5 anos,clasificacion a y b,2002-03-01,17,71,17,71,88
30904,VINTO,estado nutricional en menores de 5 anos,clasificacion a y b,2002-03-01,45,5,45,5,50
50602,VITICHI,estado nutricional en menores de 5 anos,clasificacion a y b,2002-03-01,12,21,12,21,33
70201,WARNES,estado nutricional en menores de 5 anos,clasificacion a y b,2002-03-01,83,53,83,53,136
20903,YACO,estado nutricional en menores de 5 anos,clasificacion a y b,2002-03-01,3,5,3,5,8
60301,YACUIBA,estado nutricional en menores de 5 anos,clasificacion a y b,2002-03-01,120,47,120,47,167
10602,YAMPARAEZ,estado nutricional en menores de 5 anos,clasificacion a y b,2002-03-01,43,12,43,12,55
21103,YANACACHI,estado nutricional en menores de 5 anos,clasificacion a y b,2002-03-01,13,16,13,16,29
70403,YAPACANI,estado nutricional en menores de 5 anos,clasificacion a y b,2002-03-01,55,33,55,33,88
50103,YOCALLA,estado nutricional en menores de 5 anos,clasificacion a y b,2002-03-01,2,2,2,2,4
10102,YOTALA,estado nutricional en menores de 5 anos,clasificacion a y b,2002-03-01,42,4,42,4,46
60402,YUNCHARA,estado nutricional en menores de 5 anos,clasificacion a y b,2002-03-01,11,7,11,7,18
10301,ZUDAÃ‘EZ,estado nutricional en menores de 5 anos,clasificacion a y b,2002-03-01,19,8,19,8,27
51302,ACACIO,estado nutricional en menores de 5 anos,clasificacion a y b,2002-04-01,2,1,2,1,3
20201,ACHACACHI,estado nutricional en menores de 5 anos,clasificacion a y b,2002-04-01,73,46,73,46,119
20104,ACHOCALLA,estado nutricional en menores de 5 anos,clasificacion a y b,2002-04-01,21,2,21,2,23
30201,AIQUILE,estado nutricional en menores de 5 anos,clasificacion a y b,2002-04-01,0,4,0,4,4
31303,ALALAY,estado nutricional en menores de 5 anos,clasificacion a y b,2002-04-01,0,1,0,1,1
10404,ALCALA,estado nutricional en menores de 5 anos,clasificacion a y b,2002-04-01,15,2,15,2,17
20202,ANCORAIMES,estado nutricional en menores de 5 anos,clasificacion a y b,2002-04-01,13,4,13,4,17
40603,ANTEQUERA,estado nutricional en menores de 5 anos,clasificacion a y b,2002-04-01,0,13,0,13,13
30402,ANZALDO,estado nutricional en menores de 5 anos,clasificacion a y b,2002-04-01,4,9,4,9,13
20701,APOLO,estado nutricional en menores de 5 anos,clasificacion a y b,2002-04-01,19,1,19,1,20
51301,ARAMPAMPA,estado nutricional en menores de 5 anos,clasificacion a y b,2002-04-01,2,3,2,3,5
30501,ARANI,estado nutricional en menores de 5 anos,clasificacion a y b,2002-04-01,7,5,7,5,12
30403,ARBIETO,estado nutricional en menores de 5 anos,clasificacion a y b,2002-04-01,7,12,7,12,19
30601,ARQUE,estado nutricional en menores de 5 anos,clasificacion a y b,2002-04-01,3,0,3,0,3
71501,ASCENCION DE GUARAYOS,estado nutricional en menores de 5 anos,clasificacion a y b,2002-04-01,48,29,48,29,77
50802,ATOCHA,estado nutricional en menores de 5 anos,clasificacion a y b,2002-04-01,2,14,2,14,16
20503,AUCAPATA,estado nutricional en menores de 5 anos,clasificacion a y b,2002-04-01,7,0,7,0,7
20502,AYATA,estado nutricional en menores de 5 anos,clasificacion a y b,2002-04-01,0,1,0,1,1
21303,AYO AYO,estado nutricional en menores de 5 anos,clasificacion a y b,2002-04-01,18,8,18,8,26
30301,AYOPAYA (V. DE INDEPENDENCIA),estado nutricional en menores de 5 anos,clasificacion a y b,2002-04-01,19,8,19,8,27
10201,AZURDUY,estado nutricional en menores de 5 anos,clasificacion a y b,2002-04-01,36,9,36,9,45
21203,BATALLAS,estado nutricional en menores de 5 anos,clasificacion a y b,2002-04-01,4,17,4,17,21
80802,BAURES,estado nutricional en menores de 5 anos,clasificacion a y b,2002-04-01,10,9,10,9,19
41202,BELEN DE ANDAMARCA,estado nutricional en menores de 5 anos,clasificacion a y b,2002-04-01,1,0,1,0,1
50104,BELEN DE URMIRI,estado nutricional en menores de 5 anos,clasificacion a y b,2002-04-01,2,2,2,2,4
90104,BELLA FLOR,estado nutricional en menores de 5 anos,clasificacion a y b,2002-04-01,3,3,3,3,6
60202,BERMEJO,estado nutricional en menores de 5 anos,clasificacion a y b,2002-04-01,21,36,21,36,57
50301,BETANZOS,estado nutricional en menores de 5 anos,clasificacion a y b,2002-04-01,10,14,10,14,24
31501,BOLIVAR,estado nutricional en menores de 5 anos,clasificacion a y b,2002-04-01,5,4,5,4,9
70707,BOYUIBE,estado nutricional en menores de 5 anos,clasificacion a y b,2002-04-01,0,14,0,14,14
70401,BUENA VISTA,estado nutricional en menores de 5 anos,clasificacion a y b,2002-04-01,60,26,60,26,86
70703,CABEZAS,estado nutricional en menores de 5 anos,clasificacion a y b,2002-04-01,2,24,2,24,26
20905,CAIROMA,estado nutricional en menores de 5 anos,clasificacion a y b,2002-04-01,2,25,2,25,27
51102,"CAIZA ""D""",estado nutricional en menores de 5 anos,clasificacion a y b,2002-04-01,16,6,16,6,22
21003,CAJUATA,estado nutricional en menores de 5 anos,clasificacion a y b,2002-04-01,14,0,14,0,14
20303,CALACOTO,estado nutricional en menores de 5 anos,clasificacion a y b,2002-04-01,1,5,1,5,6
21304,CALAMARCA,estado nutricional en menores de 5 anos,clasificacion a y b,2002-04-01,7,8,7,8,15
10701,CAMARGO,estado nutricional en menores de 5 anos,clasificacion a y b,2002-04-01,4,17,4,17,21
10901,CAMATAQUI (C. VILLA ABECIA),estado nutricional en menores de 5 anos,clasificacion a y b,2002-04-01,1,3,1,3,4
70706,CAMIRI,estado nutricional en menores de 5 anos,clasificacion a y b,2002-04-01,56,42,56,42,98
30701,CAPINOTA,estado nutricional en menores de 5 anos,clasificacion a y b,2002-04-01,7,4,7,4,11
20302,CAQUIAVIRI,estado nutricional en menores de 5 anos,clasificacion a y b,2002-04-01,30,17,30,17,47
40102,CARACOLLO,estado nutricional en menores de 5 anos,clasificacion a y b,2002-04-01,23,21,23,21,44
22001,CARANAVI,estado nutricional en menores de 5 anos,clasificacion a y b,2002-04-01,94,60,94,60,154
60302,CARAPARI,estado nutricional en menores de 5 anos,clasificacion a y b,2002-04-01,23,26,23,26,49
50702,CARIPUYO,estado nutricional en menores de 5 anos,clasificacion a y b,2002-04-01,8,4,8,4,12
21902,CATACORA,estado nutricional en menores de 5 anos,clasificacion a y b,2002-04-01,2,0,2,0,2
40201,CHALLAPATA,estado nutricional en menores de 5 anos,clasificacion a y b,2002-04-01,8,6,8,6,14
50302,CHAQUI,estado nutricional en menores de 5 anos,clasificacion a y b,2002-04-01,0,7,0,7,7
70702,CHARAGUA,estado nutricional en menores de 5 anos,clasificacion a y b,2002-04-01,20,115,20,115,135
31204,CHIMORE,estado nutricional en menores de 5 anos,clasificacion a y b,2002-04-01,10,10,10,10,20
40302,CHOQUE COTA,estado nutricional en menores de 5 anos,clasificacion a y b,2002-04-01,3,3,3,3,6
21101,CHULUMANI (V. DE LA LIBERTAD),estado nutricional en menores de 5 anos,clasificacion a y b,2002-04-01,8,8,8,8,16
20501,CHUMA,estado nutricional en menores de 5 anos,clasificacion a y b,2002-04-01,6,8,6,8,14
30801,CLIZA,estado nutricional en menores de 5 anos,clasificacion a y b,2002-04-01,4,24,4,24,28
90101,COBIJA,estado nutricional en menores de 5 anos,clasificacion a y b,2002-04-01,99,14,99,14,113
30101,COCHABAMBA,estado nutricional en menores de 5 anos,clasificacion a y b,2002-04-01,1676,1148,1676,1148,2824
30905,COLCAPIRHUA,estado nutricional en menores de 5 anos,clasificacion a y b,2002-04-01,37,12,37,12,49
50901,"COLCHA ""K""",estado nutricional en menores de 5 anos,clasificacion a y b,2002-04-01,1,11,1,11,12
31002,COLOMI,estado nutricional en menores de 5 anos,clasificacion a y b,2002-04-01,19,17,19,17,36
50401,COLQUECHACA,estado nutricional en menores de 5 anos,clasificacion a y b,2002-04-01,3,3,3,3,6
21306,COLQUENCHA,estado nutricional en menores de 5 anos,clasificacion a y b,2002-04-01,5,0,5,0,5
21004,COLQUIRI,estado nutricional en menores de 5 anos,clasificacion a y b,2002-04-01,16,9,16,9,25
20304,COMANCHE,estado nutricional en menores de 5 anos,clasificacion a y b,2002-04-01,2,0,2,0,2
71301,COMARAPA,estado nutricional en menores de 5 anos,clasificacion a y b,2002-04-01,6,15,6,15,21
20605,COMBAYA,estado nutricional en menores de 5 anos,clasificacion a y b,2002-04-01,1,1,1,1,2
71101,CONCEPCION,estado nutricional en menores de 5 anos,clasificacion a y b,2002-04-01,6,35,6,35,41
21701,COPACABANA,estado nutricional en menores de 5 anos,clasificacion a y b,2002-04-01,4,7,4,7,11
21402,CORIPATA,estado nutricional en menores de 5 anos,clasificacion a y b,2002-04-01,13,19,13,19,32
20301,CORO CORO,estado nutricional en menores de 5 anos,clasificacion a y b,2002-04-01,9,6,9,6,15
21401,COROICO,estado nutricional en menores de 5 anos,clasificacion a y b,2002-04-01,3,5,3,5,8
40301,CORQUE,estado nutricional en menores de 5 anos,clasificacion a y b,2002-04-01,2,1,2,1,3
50601,COTAGAITA,estado nutricional en menores de 5 anos,clasificacion a y b,2002-04-01,9,16,9,16,25
70102,COTOCA,estado nutricional en menores de 5 anos,clasificacion a y b,2002-04-01,103,56,103,56,159
31405,CUCHUMUELA (V. G. VILLARROEL),estado nutricional en menores de 5 anos,clasificacion a y b,2002-04-01,0,6,0,6,6
70704,CUEVO,estado nutricional en menores de 5 anos,clasificacion a y b,2002-04-01,32,1,32,1,33
10902,CULPINA,estado nutricional en menores de 5 anos,clasificacion a y b,2002-04-01,26,4,26,4,30
40401,CURAHUARA DE CARANGAS,estado nutricional en menores de 5 anos,clasificacion a y b,2002-04-01,9,1,9,1,10
20804,DESAGUADERO,estado nutricional en menores de 5 anos,clasificacion a y b,2002-04-01,0,7,0,7,7
20105,EL ALTO,estado nutricional en menores de 5 anos,clasificacion a y b,2002-04-01,526,329,526,329,855
40103,EL CHORO,estado nutricional en menores de 5 anos,clasificacion a y b,2002-04-01,1,0,1,0,1
71503,EL PUENTE(STC),estado nutricional en menores de 5 anos,clasificacion a y b,2002-04-01,27,41,27,41,68
60502,EL PUENTE(TJA),estado nutricional en menores de 5 anos,clasificacion a y b,2002-04-01,4,5,4,5,9
70105,EL TORNO,estado nutricional en menores de 5 anos,clasificacion a y b,2002-04-01,122,14,122,14,136
10405,EL VILLAR,estado nutricional en menores de 5 anos,clasificacion a y b,2002-04-01,14,4,14,4,18
60601,ENTRE RIOS,estado nutricional en menores de 5 anos,clasificacion a y b,2002-04-01,36,19,36,19,55
41101,EUCALIPTUS,estado nutricional en menores de 5 anos,clasificacion a y b,2002-04-01,2,8,2,8,10
80402,EXALTACION,estado nutricional en menores de 5 anos,clasificacion a y b,2002-04-01,1,4,1,4,5
90203,FILADELFIA,estado nutricional en menores de 5 anos,clasificacion a y b,2002-04-01,2,5,2,5,7
21601,GRAL. J.J. PEREZ (CHARAZANI),estado nutricional en menores de 5 anos,clasificacion a y b,2002-04-01,4,0,4,0,4
20602,GUANAY,estado nutricional en menores de 5 anos,clasificacion a y b,2002-04-01,18,56,18,56,74
80202,GUAYARAMERIN,estado nutricional en menores de 5 anos,clasificacion a y b,2002-04-01,113,26,113,26,139
70705,GUTIERREZ,estado nutricional en menores de 5 anos,clasificacion a y b,2002-04-01,20,47,20,47,67
10502,HUACARETA,estado nutricional en menores de 5 anos,clasificacion a y b,2002-04-01,39,13,39,13,52
11002,HUACAYA (VILLA DE HUACAYA),estado nutricional en menores de 5 anos,clasificacion a y b,2002-04-01,11,4,11,4,15
40501,HUACHACALLA,estado nutricional en menores de 5 anos,clasificacion a y b,2002-04-01,0,2,0,2,2
40701,HUANUNI,estado nutricional en menores de 5 anos,clasificacion a y b,2002-04-01,2,1,2,1,3
80803,HUARACAJE,estado nutricional en menores de 5 anos,clasificacion a y b,2002-04-01,12,9,12,9,21
10304,ICLA,estado nutricional en menores de 5 anos,clasificacion a y b,2002-04-01,8,2,8,2,10
10703,INCAHUASI,estado nutricional en menores de 5 anos,clasificacion a y b,2002-04-01,18,42,18,42,60
21001,INQUISIVI,estado nutricional en menores de 5 anos,clasificacion a y b,2002-04-01,1,1,1,1,2
21102,IRUPANA (VILLA DE LANZA),estado nutricional en menores de 5 anos,clasificacion a y b,2002-04-01,14,13,14,13,27
21501,IXIAMAS,estado nutricional en menores de 5 anos,clasificacion a y b,2002-04-01,21,6,21,6,27
21105,LA ASUNTA,estado nutricional en menores de 5 anos,clasificacion a y b,2002-04-01,26,14,26,14,40
70104,LA GUARDIA,estado nutricional en menores de 5 anos,clasificacion a y b,2002-04-01,142,26,142,26,168
20101,LA PAZ,estado nutricional en menores de 5 anos,clasificacion a y b,2002-04-01,504,271,504,271,775
70701,LAGUNILLAS,estado nutricional en menores de 5 anos,clasificacion a y b,2002-04-01,10,28,10,28,38
21202,LAJA,estado nutricional en menores de 5 anos,clasificacion a y b,2002-04-01,2,10,2,10,12
10903,LAS CARRERAS,estado nutricional en menores de 5 anos,clasificacion a y b,2002-04-01,4,10,4,10,14
21006,LICOMA PAMPA,estado nutricional en menores de 5 anos,clasificacion a y b,2002-04-01,0,4,0,4,4
51401,LLICA,estado nutricional en menores de 5 anos,clasificacion a y b,2002-04-01,1,4,1,4,5
80601,LORETO,estado nutricional en menores de 5 anos,clasificacion a y b,2002-04-01,5,4,5,4,9
20901,LURIBAY,estado nutricional en menores de 5 anos,clasificacion a y b,2002-04-01,4,8,4,8,12
40702,MACHACAMARCA,estado nutricional en menores de 5 anos,clasificacion a y b,2002-04-01,4,3,4,3,7
11003,MACHARETI,estado nutricional en menores de 5 anos,clasificacion a y b,2002-04-01,23,20,23,20,43
80801,MAGDALENA,estado nutricional en menores de 5 anos,clasificacion a y b,2002-04-01,6,9,6,9,15
70903,MAIRANA,estado nutricional en menores de 5 anos,clasificacion a y b,2002-04-01,34,6,34,6,40
20904,MALLA,estado nutricional en menores de 5 anos,clasificacion a y b,2002-04-01,0,1,0,1,1
20103,MECAPACA,estado nutricional en menores de 5 anos,clasificacion a y b,2002-04-01,15,3,15,3,18
71003,MINEROS,estado nutricional en menores de 5 anos,clasificacion a y b,2002-04-01,26,7,26,7,33
31301,MIZQUE,estado nutricional en menores de 5 anos,clasificacion a y b,2002-04-01,14,6,14,6,20
20402,MOCOMOCO,estado nutricional en menores de 5 anos,clasificacion a y b,2002-04-01,23,6,23,6,29
10303,MOJOCOYA,estado nutricional en menores de 5 anos,clasificacion a y b,2002-04-01,27,14,27,14,41
10501,MONTEAGUDO,estado nutricional en menores de 5 anos,clasificacion a y b,2002-04-01,97,28,97,28,125
71001,MONTERO,estado nutricional en menores de 5 anos,clasificacion a y b,2002-04-01,0,17,0,17,17
70803,MORO MORO,estado nutricional en menores de 5 anos,clasificacion a y b,2002-04-01,5,2,5,2,7
30302,MOROCHATA,estado nutricional en menores de 5 anos,clasificacion a y b,2002-04-01,10,10,10,10,20
90401,NACEBE (SANTA ROSA DEL ABUNA),estado nutricional en menores de 5 anos,clasificacion a y b,2002-04-01,1,8,1,8,9
20307,NAZACARA DE PACAJES,estado nutricional en menores de 5 anos,clasificacion a y b,2002-04-01,0,2,0,2,2
90501,NUEVO MANOA (NUEVA ESPERANZA),estado nutricional en menores de 5 anos,clasificacion a y b,2002-04-01,5,3,5,3,8
50404,OCURI,estado nutricional en menores de 5 anos,clasificacion a y b,2002-04-01,6,3,6,3,9
70202,OKINAWA,estado nutricional en menores de 5 anos,clasificacion a y b,2002-04-01,15,7,15,7,22
30203,OMEREQUE,estado nutricional en menores de 5 anos,clasificacion a y b,2002-04-01,2,24,2,24,26
40101,ORURO,estado nutricional en menores de 5 anos,clasificacion a y b,2002-04-01,260,76,260,76,336
60201,PADCAYA,estado nutricional en menores de 5 anos,clasificacion a y b,2002-04-01,30,28,30,28,58
10401,PADILLA,estado nutricional en menores de 5 anos,clasificacion a y b,2002-04-01,49,7,49,7,56
70502,PAILON,estado nutricional en menores de 5 anos,clasificacion a y b,2002-04-01,14,53,14,53,67
20102,PALCA,estado nutricional en menores de 5 anos,clasificacion a y b,2002-04-01,10,0,10,0,10
21104,PALOS BLANCOS,estado nutricional en menores de 5 anos,clasificacion a y b,2002-04-01,31,29,31,29,60
40802,PAMPA AULLAGAS,estado nutricional en menores de 5 anos,clasificacion a y b,2002-04-01,1,5,1,5,6
70902,PAMPA GRANDE,estado nutricional en menores de 5 anos,clasificacion a y b,2002-04-01,33,9,33,9,42
21802,PAPEL PAMPA,estado nutricional en menores de 5 anos,clasificacion a y b,2002-04-01,1,3,1,3,4
30202,PASORAPA,estado nutricional en menores de 5 anos,clasificacion a y b,2002-04-01,10,5,10,5,15
21305,PATACAMAYA,estado nutricional en menores de 5 anos,clasificacion a y b,2002-04-01,24,2,24,2,26
40602,PAZÃ‘A,estado nutricional en menores de 5 anos,clasificacion a y b,2002-04-01,0,2,0,2,2
20702,PELECHUCO,estado nutricional en menores de 5 anos,clasificacion a y b,2002-04-01,2,0,2,0,2
50403,POCOATA,estado nutricional en menores de 5 anos,clasificacion a y b,2002-04-01,13,6,13,6,19
31203,POCONA,estado nutricional en menores de 5 anos,clasificacion a y b,2002-04-01,22,3,22,3,25
31202,POJO (CBBA),estado nutricional en menores de 5 anos,clasificacion a y b,2002-04-01,105,29,105,29,134
40601,POOPO,estado nutricional en menores de 5 anos,clasificacion a y b,2002-04-01,0,1,0,1,1
51203,PORCO,estado nutricional en menores de 5 anos,clasificacion a y b,2002-04-01,9,8,9,8,17
10103,POROMA,estado nutricional en menores de 5 anos,clasificacion a y b,2002-04-01,21,10,21,10,31
70103,PORONGO,estado nutricional en menores de 5 anos,clasificacion a y b,2002-04-01,21,11,21,11,32
70601,PORTACHUELO,estado nutricional en menores de 5 anos,clasificacion a y b,2002-04-01,83,28,83,28,111
90102,PORVENIR,estado nutricional en menores de 5 anos,clasificacion a y b,2002-04-01,1,2,1,2,3
50101,POTOSI,estado nutricional en menores de 5 anos,clasificacion a y b,2002-04-01,125,34,125,34,159
10302,PRESTO,estado nutricional en menores de 5 anos,clasificacion a y b,2002-04-01,13,3,13,3,16
21201,PUCARANI,estado nutricional en menores de 5 anos,clasificacion a y b,2002-04-01,2,18,2,18,20
20401,PUERTO ACOSTA,estado nutricional en menores de 5 anos,clasificacion a y b,2002-04-01,25,24,25,24,49
20403,PUERTO CARABUCO,estado nutricional en menores de 5 anos,clasificacion a y b,2002-04-01,23,5,23,5,28
90301,PUERTO GONZALO MORENO,estado nutricional en menores de 5 anos,clasificacion a y b,2002-04-01,0,1,0,1,1
21204,PUERTO PEREZ,estado nutricional en menores de 5 anos,clasificacion a y b,2002-04-01,2,7,2,7,9
71402,PUERTO QUIJARRO,estado nutricional en menores de 5 anos,clasificacion a y b,2002-04-01,54,16,54,16,70
80703,PUERTO SILES,estado nutricional en menores de 5 anos,clasificacion a y b,2002-04-01,0,1,0,1,1
71401,PUERTO SUAREZ,estado nutricional en menores de 5 anos,clasificacion a y b,2002-04-01,20,4,20,4,24
31205,PUERTO VILLARROEL,estado nutricional en menores de 5 anos,clasificacion a y b,2002-04-01,114,37,114,37,151
51101,PUNA,estado nutricional en menores de 5 anos,clasificacion a y b,2002-04-01,31,23,31,23,54
31401,PUNATA,estado nutricional en menores de 5 anos,clasificacion a y b,2002-04-01,4,29,4,29,33
20604,QUIABAYA,estado nutricional en menores de 5 anos,clasificacion a y b,2002-04-01,3,0,3,0,3
30901,QUILLACOLLO,estado nutricional en menores de 5 anos,clasificacion a y b,2002-04-01,22,40,22,40,62
21002,QUIME,estado nutricional en menores de 5 anos,clasificacion a y b,2002-04-01,5,15,5,15,20
50402,RAVELO,estado nutricional en menores de 5 anos,clasificacion a y b,2002-04-01,6,2,6,2,8
80301,REYES,estado nutricional en menores de 5 anos,clasificacion a y b,2002-04-01,38,5,38,5,43
80201,RIBERALTA,estado nutricional en menores de 5 anos,clasificacion a y b,2002-04-01,177,25,177,25,202
70503,ROBORE,estado nutricional en menores de 5 anos,clasificacion a y b,2002-04-01,23,26,23,26,49
80304,RURRENABAQUE,estado nutricional en menores de 5 anos,clasificacion a y b,2002-04-01,31,31,31,31,62
40901,SABAYA,estado nutricional en menores de 5 anos,clasificacion a y b,2002-04-01,0,2,0,2,2
31001,SACABA,estado nutricional en menores de 5 anos,clasificacion a y b,2002-04-01,37,2,37,2,39
30404,SACABAMBA,estado nutricional en menores de 5 anos,clasificacion a y b,2002-04-01,1,0,1,0,1
50701,SACACA,estado nutricional en menores de 5 anos,clasificacion a y b,2002-04-01,6,1,6,1,7
71302,SAIPINA,estado nutricional en menores de 5 anos,clasificacion a y b,2002-04-01,32,20,32,20,52
40801,SALINAS DE GARCI MENDOZA,estado nutricional en menores de 5 anos,clasificacion a y b,2002-04-01,9,2,9,2,11
70901,SAMAIPATA,estado nutricional en menores de 5 anos,clasificacion a y b,2002-04-01,6,4,6,4,10
51601,SAN AGUSTIN,estado nutricional en menores de 5 anos,clasificacion a y b,2002-04-01,2,1,2,1,3
80602,SAN ANDRES,estado nutricional en menores de 5 anos,clasificacion a y b,2002-04-01,12,7,12,7,19
51003,SAN ANTONIO DE ESMORUCO,estado nutricional en menores de 5 anos,clasificacion a y b,2002-04-01,0,2,0,2,2
71105,SAN ANTONIO DE LOMERIO,estado nutricional en menores de 5 anos,clasificacion a y b,2002-04-01,26,3,26,3,29
31403,SAN BENITO,estado nutricional en menores de 5 anos,clasificacion a y b,2002-04-01,1,13,1,13,14
80302,SAN BORJA,estado nutricional en menores de 5 anos,clasificacion a y b,2002-04-01,114,21,114,21,135
21502,SAN BUENA VENTURA,estado nutricional en menores de 5 anos,clasificacion a y b,2002-04-01,24,8,24,8,32
70402,SAN CARLOS,estado nutricional en menores de 5 anos,clasificacion a y b,2002-04-01,31,6,31,6,37
80501,SAN IGNACIO,estado nutricional en menores de 5 anos,clasificacion a y b,2002-04-01,26,45,26,45,71
70301,SAN IGNACIO DE VELASCO,estado nutricional en menores de 5 anos,clasificacion a y b,2002-04-01,154,21,154,21,175
80102,SAN JAVIER(BNI),estado nutricional en menores de 5 anos,clasificacion a y b,2002-04-01,3,6,3,6,9
71102,SAN JAVIER(STC),estado nutricional en menores de 5 anos,clasificacion a y b,2002-04-01,29,2,29,2,31
80701,SAN JOAQUIN,estado nutricional en menores de 5 anos,clasificacion a y b,2002-04-01,12,19,12,19,31
70501,SAN JOSE DE CHIQUITOS,estado nutricional en menores de 5 anos,clasificacion a y b,2002-04-01,9,5,9,5,14
71104,SAN JULIAN,estado nutricional en menores de 5 anos,clasificacion a y b,2002-04-01,80,148,80,148,228
60501,SAN LORENZO(TJA),estado nutricional en menores de 5 anos,clasificacion a y b,2002-04-01,4,2,4,2,6
10702,SAN LUCAS,estado nutricional en menores de 5 anos,clasificacion a y b,2002-04-01,30,33,30,33,63
71201,SAN MATIAS,estado nutricional en menores de 5 anos,clasificacion a y b,2002-04-01,26,12,26,12,38
70302,SAN MIGUEL DE VELASCO,estado nutricional en menores de 5 anos,clasificacion a y b,2002-04-01,24,10,24,10,34
51001,SAN PABLO DE LIPEZ,estado nutricional en menores de 5 anos,clasificacion a y b,2002-04-01,0,1,0,1,1
50501,SAN PEDRO DE BUENA VISTA,estado nutricional en menores de 5 anos,clasificacion a y b,2002-04-01,3,12,3,12,15
21801,SAN PEDRO DE CURAHUARA,estado nutricional en menores de 5 anos,clasificacion a y b,2002-04-01,0,3,0,3,3
50902,SAN PEDRO DE QUEMES,estado nutricional en menores de 5 anos,clasificacion a y b,2002-04-01,0,4,0,4,4
21702,SAN PEDRO DE TIQUINA,estado nutricional en menores de 5 anos,clasificacion a y b,2002-04-01,4,11,4,11,15
90202,SAN PEDRO(PND),estado nutricional en menores de 5 anos,clasificacion a y b,2002-04-01,1,0,1,0,1
70303,SAN RAFAEL,estado nutricional en menores de 5 anos,clasificacion a y b,2002-04-01,4,2,4,2,6
80702,SAN RAMON,estado nutricional en menores de 5 anos,clasificacion a y b,2002-04-01,28,4,28,4,32
80702,SAN RAMON,estado nutricional en menores de 5 anos,clasificacion a y b,2002-04-01,47,72,47,72,119
80401,SANTA ANA,estado nutricional en menores de 5 anos,clasificacion a y b,2002-04-01,15,9,15,9,24
70101,SANTA CRUZ DE LA SIERRA,estado nutricional en menores de 5 anos,clasificacion a y b,2002-04-01,659,550,659,550,1209
80303,SANTA ROSA,estado nutricional en menores de 5 anos,clasificacion a y b,2002-04-01,5,0,5,0,5
70602,SANTA ROSA DEL SARA,estado nutricional en menores de 5 anos,clasificacion a y b,2002-04-01,4,3,4,3,7
20308,SANTIAGO DE CALLAPA,estado nutricional en menores de 5 anos,clasificacion a y b,2002-04-01,4,3,4,3,7
41401,SANTIAGO DE HUARI,estado nutricional en menores de 5 anos,clasificacion a y b,2002-04-01,3,2,3,2,5
21901,SANTIAGO DE MACHACA,estado nutricional en menores de 5 anos,clasificacion a y b,2002-04-01,8,3,8,3,11
30702,SANTIVAÃ‘ES,estado nutricional en menores de 5 anos,clasificacion a y b,2002-04-01,3,0,3,0,3
20902,SAPAHAQUI,estado nutricional en menores de 5 anos,clasificacion a y b,2002-04-01,1,4,1,4,5
21301,SICA SICA (VILLA AROMA),estado nutricional en menores de 5 anos,clasificacion a y b,2002-04-01,27,1,27,1,28
30703,SICAYA,estado nutricional en menores de 5 anos,clasificacion a y b,2002-04-01,0,3,0,3,3
30902,SIPE SIPE,estado nutricional en menores de 5 anos,clasificacion a y b,2002-04-01,113,35,113,35,148
10403,SOPACHUY,estado nutricional en menores de 5 anos,clasificacion a y b,2002-04-01,22,1,22,1,23
20601,SORATA,estado nutricional en menores de 5 anos,clasificacion a y b,2002-04-01,9,9,9,9,18
10101,SUCRE,estado nutricional en menores de 5 anos,clasificacion a y b,2002-04-01,260,98,260,98,358
20603,TACACOMA,estado nutricional en menores de 5 anos,clasificacion a y b,2002-04-01,4,26,4,26,30
50303,TACOBAMBA,estado nutricional en menores de 5 anos,clasificacion a y b,2002-04-01,13,2,13,2,15
30602,TACOPAYA,estado nutricional en menores de 5 anos,clasificacion a y b,2002-04-01,2,2,2,2,4
31101,TAPACARI,estado nutricional en menores de 5 anos,clasificacion a y b,2002-04-01,4,18,4,18,22
10601,TARABUCO,estado nutricional en menores de 5 anos,clasificacion a y b,2002-04-01,32,43,32,43,75
30401,TARATA,estado nutricional en menores de 5 anos,clasificacion a y b,2002-04-01,7,12,7,12,19
60101,TARIJA,estado nutricional en menores de 5 anos,clasificacion a y b,2002-04-01,177,169,177,169,346
10202,TARVITA,estado nutricional en menores de 5 anos,clasificacion a y b,2002-04-01,13,4,13,4,17
20803,TIAWANACU,estado nutricional en menores de 5 anos,clasificacion a y b,2002-04-01,20,12,20,12,32
50102,TINGUIPAYA,estado nutricional en menores de 5 anos,clasificacion a y b,2002-04-01,5,0,5,0,5
20606,TIPUANI,estado nutricional en menores de 5 anos,clasificacion a y b,2002-04-01,14,2,14,2,16
30903,TIQUIPAYA,estado nutricional en menores de 5 anos,clasificacion a y b,2002-04-01,3,13,3,13,16
31601,TIRAQUE (CBBA),estado nutricional en menores de 5 anos,clasificacion a y b,2002-04-01,63,60,63,60,123
21703,TITO YUPANQUI (PARQUIPUJIO),estado nutricional en menores de 5 anos,clasificacion a y b,2002-04-01,1,0,1,0,1
30802,TOCO,estado nutricional en menores de 5 anos,clasificacion a y b,2002-04-01,5,1,5,1,6
41001,TOLEDO,estado nutricional en menores de 5 anos,clasificacion a y b,2002-04-01,6,0,6,0,6
51202,TOMAVE,estado nutricional en menores de 5 anos,clasificacion a y b,2002-04-01,4,11,4,11,15
10402,TOMINA,estado nutricional en menores de 5 anos,clasificacion a y b,2002-04-01,38,3,38,3,41
31201,TOTORA(CBBA),estado nutricional en menores de 5 anos,clasificacion a y b,2002-04-01,18,12,18,12,30
41301,TOTORA(ORR),estado nutricional en menores de 5 anos,clasificacion a y b,2002-04-01,1,5,1,5,6
70802,TRIGAL,estado nutricional en menores de 5 anos,clasificacion a y b,2002-04-01,1,1,1,1,2
80101,TRINIDAD,estado nutricional en menores de 5 anos,clasificacion a y b,2002-04-01,147,124,147,124,271
50801,TUPIZA,estado nutricional en menores de 5 anos,clasificacion a y b,2002-04-01,7,51,7,51,58
40402,TURCO,estado nutricional en menores de 5 anos,clasificacion a y b,2002-04-01,9,0,9,0,9
21302,UMALA,estado nutricional en menores de 5 anos,clasificacion a y b,2002-04-01,3,1,3,1,4
60401,URIONDO (A. CONCEPCION),estado nutricional en menores de 5 anos,clasificacion a y b,2002-04-01,18,53,18,53,71
71502,URUBICHA,estado nutricional en menores de 5 anos,clasificacion a y b,2002-04-01,4,5,4,5,9
51201,UYUNI,estado nutricional en menores de 5 anos,clasificacion a y b,2002-04-01,12,50,12,50,62
70801,VALLEGRANDE,estado nutricional en menores de 5 anos,clasificacion a y b,2002-04-01,41,16,41,16,57
20801,VIACHA,estado nutricional en menores de 5 anos,clasificacion a y b,2002-04-01,32,58,32,58,90
31302,VILA VILA,estado nutricional en menores de 5 anos,clasificacion a y b,2002-04-01,3,5,3,5,8
60303,VILLA MONTES,estado nutricional en menores de 5 anos,clasificacion a y b,2002-04-01,33,20,33,20,53
90502,VILLA NUEVA (LOMA ALTA),estado nutricional en menores de 5 anos,clasificacion a y b,2002-04-01,2,0,2,0,2
31402,VILLA RIVERO,estado nutricional en menores de 5 anos,clasificacion a y b,2002-04-01,7,15,7,15,22
10801,VILLA SERRANO,estado nutricional en menores de 5 anos,clasificacion a y b,2002-04-01,18,31,18,31,49
31003,VILLA TUNARI,estado nutricional en menores de 5 anos,clasificacion a y b,2002-04-01,88,33,88,33,121
11001,VILLA VACA GUZMAN (MUYUPAMPA),estado nutricional en menores de 5 anos,clasificacion a y b,2002-04-01,51,11,51,11,62
51501,VILLAZON,estado nutricional en menores de 5 anos,clasificacion a y b,2002-04-01,32,52,32,52,84
30904,VINTO,estado nutricional en menores de 5 anos,clasificacion a y b,2002-04-01,83,5,83,5,88
50602,VITICHI,estado nutricional en menores de 5 anos,clasificacion a y b,2002-04-01,24,11,24,11,35
70201,WARNES,estado nutricional en menores de 5 anos,clasificacion a y b,2002-04-01,57,46,57,46,103
20903,YACO,estado nutricional en menores de 5 anos,clasificacion a y b,2002-04-01,3,15,3,15,18
60301,YACUIBA,estado nutricional en menores de 5 anos,clasificacion a y b,2002-04-01,131,48,131,48,179
10602,YAMPARAEZ,estado nutricional en menores de 5 anos,clasificacion a y b,2002-04-01,27,7,27,7,34
21103,YANACACHI,estado nutricional en menores de 5 anos,clasificacion a y b,2002-04-01,9,8,9,8,17
70403,YAPACANI,estado nutricional en menores de 5 anos,clasificacion a y b,2002-04-01,57,43,57,43,100
50103,YOCALLA,estado nutricional en menores de 5 anos,clasificacion a y b,2002-04-01,2,7,2,7,9
10102,YOTALA,estado nutricional en menores de 5 anos,clasificacion a y b,2002-04-01,31,16,31,16,47
60402,YUNCHARA,estado nutricional en menores de 5 anos,clasificacion a y b,2002-04-01,8,10,8,10,18
10301,ZUDAÃ‘EZ,estado nutricional en menores de 5 anos,clasificacion a y b,2002-04-01,15,5,15,5,20
51302,ACACIO,estado nutricional en menores de 5 anos,clasificacion a y b,2002-05-01,4,2,4,2,6
20201,ACHACACHI,estado nutricional en menores de 5 anos,clasificacion a y b,2002-05-01,60,33,60,33,93
20104,ACHOCALLA,estado nutricional en menores de 5 anos,clasificacion a y b,2002-05-01,18,0,18,0,18
30201,AIQUILE,estado nutricional en menores de 5 anos,clasificacion a y b,2002-05-01,4,0,4,0,4
31303,ALALAY,estado nutricional en menores de 5 anos,clasificacion a y b,2002-05-01,0,1,0,1,1
10404,ALCALA,estado nutricional en menores de 5 anos,clasificacion a y b,2002-05-01,13,2,13,2,15
20202,ANCORAIMES,estado nutricional en menores de 5 anos,clasificacion a y b,2002-05-01,21,9,21,9,30
41201,ANDAMARCA,estado nutricional en menores de 5 anos,clasificacion a y b,2002-05-01,1,0,1,0,1
40603,ANTEQUERA,estado nutricional en menores de 5 anos,clasificacion a y b,2002-05-01,6,20,6,20,26
30402,ANZALDO,estado nutricional en menores de 5 anos,clasificacion a y b,2002-05-01,7,2,7,2,9
20701,APOLO,estado nutricional en menores de 5 anos,clasificacion a y b,2002-05-01,25,3,25,3,28
51301,ARAMPAMPA,estado nutricional en menores de 5 anos,clasificacion a y b,2002-05-01,1,1,1,1,2
30501,ARANI,estado nutricional en menores de 5 anos,clasificacion a y b,2002-05-01,2,10,2,10,12
30403,ARBIETO,estado nutricional en menores de 5 anos,clasificacion a y b,2002-05-01,3,5,3,5,8
30601,ARQUE,estado nutricional en menores de 5 anos,clasificacion a y b,2002-05-01,5,2,5,2,7
71501,ASCENCION DE GUARAYOS,estado nutricional en menores de 5 anos,clasificacion a y b,2002-05-01,1,0,1,0,1
50802,ATOCHA,estado nutricional en menores de 5 anos,clasificacion a y b,2002-05-01,4,12,4,12,16
21303,AYO AYO,estado nutricional en menores de 5 anos,clasificacion a y b,2002-05-01,19,2,19,2,21
30301,AYOPAYA (V. DE INDEPENDENCIA),estado nutricional en menores de 5 anos,clasificacion a y b,2002-05-01,19,7,19,7,26
10201,AZURDUY,estado nutricional en menores de 5 anos,clasificacion a y b,2002-05-01,28,2,28,2,30
21203,BATALLAS,estado nutricional en menores de 5 anos,clasificacion a y b,2002-05-01,10,36,10,36,46
80802,BAURES,estado nutricional en menores de 5 anos,clasificacion a y b,2002-05-01,4,2,4,2,6
50104,BELEN DE URMIRI,estado nutricional en menores de 5 anos,clasificacion a y b,2002-05-01,2,10,2,10,12
60202,BERMEJO,estado nutricional en menores de 5 anos,clasificacion a y b,2002-05-01,13,53,13,53,66
50301,BETANZOS,estado nutricional en menores de 5 anos,clasificacion a y b,2002-05-01,24,70,24,70,94
31501,BOLIVAR,estado nutricional en menores de 5 anos,clasificacion a y b,2002-05-01,0,2,0,2,2
70707,BOYUIBE,estado nutricional en menores de 5 anos,clasificacion a y b,2002-05-01,3,23,3,23,26
70401,BUENA VISTA,estado nutricional en menores de 5 anos,clasificacion a y b,2002-05-01,90,17,90,17,107
70703,CABEZAS,estado nutricional en menores de 5 anos,clasificacion a y b,2002-05-01,1,3,1,3,4
20905,CAIROMA,estado nutricional en menores de 5 anos,clasificacion a y b,2002-05-01,1,9,1,9,10
51102,"CAIZA ""D""",estado nutricional en menores de 5 anos,clasificacion a y b,2002-05-01,17,11,17,11,28
21003,CAJUATA,estado nutricional en menores de 5 anos,clasificacion a y b,2002-05-01,13,10,13,10,23
20303,CALACOTO,estado nutricional en menores de 5 anos,clasificacion a y b,2002-05-01,1,0,1,0,1
21304,CALAMARCA,estado nutricional en menores de 5 anos,clasificacion a y b,2002-05-01,18,2,18,2,20
10701,CAMARGO,estado nutricional en menores de 5 anos,clasificacion a y b,2002-05-01,27,14,27,14,41
10901,CAMATAQUI (C. VILLA ABECIA),estado nutricional en menores de 5 anos,clasificacion a y b,2002-05-01,11,1,11,1,12
70706,CAMIRI,estado nutricional en menores de 5 anos,clasificacion a y b,2002-05-01,49,24,49,24,73
30701,CAPINOTA,estado nutricional en menores de 5 anos,clasificacion a y b,2002-05-01,7,6,7,6,13
20302,CAQUIAVIRI,estado nutricional en menores de 5 anos,clasificacion a y b,2002-05-01,21,5,21,5,26
40102,CARACOLLO,estado nutricional en menores de 5 anos,clasificacion a y b,2002-05-01,25,48,25,48,73
22001,CARANAVI,estado nutricional en menores de 5 anos,clasificacion a y b,2002-05-01,43,55,43,55,98
60302,CARAPARI,estado nutricional en menores de 5 anos,clasificacion a y b,2002-05-01,16,35,16,35,51
50702,CARIPUYO,estado nutricional en menores de 5 anos,clasificacion a y b,2002-05-01,11,4,11,4,15
21803,CHACARILLA,estado nutricional en menores de 5 anos,clasificacion a y b,2002-05-01,1,0,1,0,1
40201,CHALLAPATA,estado nutricional en menores de 5 anos,clasificacion a y b,2002-05-01,10,12,10,12,22
50302,CHAQUI,estado nutricional en menores de 5 anos,clasificacion a y b,2002-05-01,8,1,8,1,9
70702,CHARAGUA,estado nutricional en menores de 5 anos,clasificacion a y b,2002-05-01,21,56,21,56,77
20305,CHARAÃ‘A,estado nutricional en menores de 5 anos,clasificacion a y b,2002-05-01,0,3,0,3,3
31204,CHIMORE,estado nutricional en menores de 5 anos,clasificacion a y b,2002-05-01,14,18,14,18,32
40302,CHOQUE COTA,estado nutricional en menores de 5 anos,clasificacion a y b,2002-05-01,0,2,0,2,2
21101,CHULUMANI (V. DE LA LIBERTAD),estado nutricional en menores de 5 anos,clasificacion a y b,2002-05-01,12,10,12,10,22
20501,CHUMA,estado nutricional en menores de 5 anos,clasificacion a y b,2002-05-01,3,1,3,1,4
30801,CLIZA,estado nutricional en menores de 5 anos,clasificacion a y b,2002-05-01,10,36,10,36,46
90101,COBIJA,estado nutricional en menores de 5 anos,clasificacion a y b,2002-05-01,80,17,80,17,97
30101,COCHABAMBA,estado nutricional en menores de 5 anos,clasificacion a y b,2002-05-01,1544,1237,1544,1237,2781
30905,COLCAPIRHUA,estado nutricional en menores de 5 anos,clasificacion a y b,2002-05-01,51,17,51,17,68
50901,"COLCHA ""K""",estado nutricional en menores de 5 anos,clasificacion a y b,2002-05-01,4,28,4,28,32
21307,COLLANA,estado nutricional en menores de 5 anos,clasificacion a y b,2002-05-01,2,0,2,0,2
31002,COLOMI,estado nutricional en menores de 5 anos,clasificacion a y b,2002-05-01,23,12,23,12,35
50401,COLQUECHACA,estado nutricional en menores de 5 anos,clasificacion a y b,2002-05-01,8,6,8,6,14
21306,COLQUENCHA,estado nutricional en menores de 5 anos,clasificacion a y b,2002-05-01,13,7,13,7,20
21004,COLQUIRI,estado nutricional en menores de 5 anos,clasificacion a y b,2002-05-01,7,10,7,10,17
20304,COMANCHE,estado nutricional en menores de 5 anos,clasificacion a y b,2002-05-01,1,0,1,0,1
71301,COMARAPA,estado nutricional en menores de 5 anos,clasificacion a y b,2002-05-01,23,68,23,68,91
20605,COMBAYA,estado nutricional en menores de 5 anos,clasificacion a y b,2002-05-01,3,0,3,0,3
71101,CONCEPCION,estado nutricional en menores de 5 anos,clasificacion a y b,2002-05-01,1,5,1,5,6
21701,COPACABANA,estado nutricional en menores de 5 anos,clasificacion a y b,2002-05-01,2,11,2,11,13
21402,CORIPATA,estado nutricional en menores de 5 anos,clasificacion a y b,2002-05-01,14,20,14,20,34
20301,CORO CORO,estado nutricional en menores de 5 anos,clasificacion a y b,2002-05-01,15,2,15,2,17
21401,COROICO,estado nutricional en menores de 5 anos,clasificacion a y b,2002-05-01,10,4,10,4,14
40301,CORQUE,estado nutricional en menores de 5 anos,clasificacion a y b,2002-05-01,3,0,3,0,3
50601,COTAGAITA,estado nutricional en menores de 5 anos,clasificacion a y b,2002-05-01,6,23,6,23,29
70102,COTOCA,estado nutricional en menores de 5 anos,clasificacion a y b,2002-05-01,106,27,106,27,133
70704,CUEVO,estado nutricional en menores de 5 anos,clasificacion a y b,2002-05-01,25,4,25,4,29
10902,CULPINA,estado nutricional en menores de 5 anos,clasificacion a y b,2002-05-01,28,12,28,12,40
40401,CURAHUARA DE CARANGAS,estado nutricional en menores de 5 anos,clasificacion a y b,2002-05-01,7,1,7,1,8
21602,CURVA,estado nutricional en menores de 5 anos,clasificacion a y b,2002-05-01,1,0,1,0,1
20804,DESAGUADERO,estado nutricional en menores de 5 anos,clasificacion a y b,2002-05-01,0,9,0,9,9
20105,EL ALTO,estado nutricional en menores de 5 anos,clasificacion a y b,2002-05-01,536,298,536,298,834
40103,EL CHORO,estado nutricional en menores de 5 anos,clasificacion a y b,2002-05-01,2,1,2,1,3
71503,EL PUENTE(STC),estado nutricional en menores de 5 anos,clasificacion a y b,2002-05-01,13,30,13,30,43
60502,EL PUENTE(TJA),estado nutricional en menores de 5 anos,clasificacion a y b,2002-05-01,9,5,9,5,14
70105,EL TORNO,estado nutricional en menores de 5 anos,clasificacion a y b,2002-05-01,158,80,158,80,238
10405,EL VILLAR,estado nutricional en menores de 5 anos,clasificacion a y b,2002-05-01,10,4,10,4,14
60601,ENTRE RIOS,estado nutricional en menores de 5 anos,clasificacion a y b,2002-05-01,28,26,28,26,54
41101,EUCALIPTUS,estado nutricional en menores de 5 anos,clasificacion a y b,2002-05-01,2,6,2,6,8
80402,EXALTACION,estado nutricional en menores de 5 anos,clasificacion a y b,2002-05-01,5,8,5,8,13
90203,FILADELFIA,estado nutricional en menores de 5 anos,clasificacion a y b,2002-05-01,1,10,1,10,11
71002,GENERAL SAAVEDRA,estado nutricional en menores de 5 anos,clasificacion a y b,2002-05-01,51,37,51,37,88
20602,GUANAY,estado nutricional en menores de 5 anos,clasificacion a y b,2002-05-01,41,69,41,69,110
20802,GUAQUI,estado nutricional en menores de 5 anos,clasificacion a y b,2002-05-01,7,5,7,5,12
80202,GUAYARAMERIN,estado nutricional en menores de 5 anos,clasificacion a y b,2002-05-01,79,32,79,32,111
70705,GUTIERREZ,estado nutricional en menores de 5 anos,clasificacion a y b,2002-05-01,18,43,18,43,61
10502,HUACARETA,estado nutricional en menores de 5 anos,clasificacion a y b,2002-05-01,28,11,28,11,39
11002,HUACAYA (VILLA DE HUACAYA),estado nutricional en menores de 5 anos,clasificacion a y b,2002-05-01,8,3,8,3,11
40501,HUACHACALLA,estado nutricional en menores de 5 anos,clasificacion a y b,2002-05-01,1,3,1,3,4
40701,HUANUNI,estado nutricional en menores de 5 anos,clasificacion a y b,2002-05-01,2,0,2,0,2
80803,HUARACAJE,estado nutricional en menores de 5 anos,clasificacion a y b,2002-05-01,11,7,11,7,18
41601,HUAYLLAMARCA,estado nutricional en menores de 5 anos,clasificacion a y b,2002-05-01,4,0,4,0,4
21005,ICHOCA,estado nutricional en menores de 5 anos,clasificacion a y b,2002-05-01,0,1,0,1,1
10304,ICLA,estado nutricional en menores de 5 anos,clasificacion a y b,2002-05-01,13,32,13,32,45
10703,INCAHUASI,estado nutricional en menores de 5 anos,clasificacion a y b,2002-05-01,47,26,47,26,73
90402,INGAVI (HUMAITA),estado nutricional en menores de 5 anos,clasificacion a y b,2002-05-01,0,3,0,3,3
21001,INQUISIVI,estado nutricional en menores de 5 anos,clasificacion a y b,2002-05-01,14,4,14,4,18
21102,IRUPANA (VILLA DE LANZA),estado nutricional en menores de 5 anos,clasificacion a y b,2002-05-01,9,15,9,15,24
21501,IXIAMAS,estado nutricional en menores de 5 anos,clasificacion a y b,2002-05-01,27,11,27,11,38
21105,LA ASUNTA,estado nutricional en menores de 5 anos,clasificacion a y b,2002-05-01,26,24,26,24,50
70104,LA GUARDIA,estado nutricional en menores de 5 anos,clasificacion a y b,2002-05-01,169,39,169,39,208
20101,LA PAZ,estado nutricional en menores de 5 anos,clasificacion a y b,2002-05-01,610,292,610,292,902
41501,LA RIVERA,estado nutricional en menores de 5 anos,clasificacion a y b,2002-05-01,1,1,1,1,2
70701,LAGUNILLAS,estado nutricional en menores de 5 anos,clasificacion a y b,2002-05-01,26,15,26,15,41
21202,LAJA,estado nutricional en menores de 5 anos,clasificacion a y b,2002-05-01,7,15,7,15,22
10903,LAS CARRERAS,estado nutricional en menores de 5 anos,clasificacion a y b,2002-05-01,6,3,6,3,9
51401,LLICA,estado nutricional en menores de 5 anos,clasificacion a y b,2002-05-01,6,5,6,5,11
80601,LORETO,estado nutricional en menores de 5 anos,clasificacion a y b,2002-05-01,6,6,6,6,12
20901,LURIBAY,estado nutricional en menores de 5 anos,clasificacion a y b,2002-05-01,7,3,7,3,10
40702,MACHACAMARCA,estado nutricional en menores de 5 anos,clasificacion a y b,2002-05-01,4,4,4,4,8
11003,MACHARETI,estado nutricional en menores de 5 anos,clasificacion a y b,2002-05-01,45,25,45,25,70
80801,MAGDALENA,estado nutricional en menores de 5 anos,clasificacion a y b,2002-05-01,15,15,15,15,30
70903,MAIRANA,estado nutricional en menores de 5 anos,clasificacion a y b,2002-05-01,45,8,45,8,53
20103,MECAPACA,estado nutricional en menores de 5 anos,clasificacion a y b,2002-05-01,28,7,28,7,35
71003,MINEROS,estado nutricional en menores de 5 anos,clasificacion a y b,2002-05-01,140,32,140,32,172
31301,MIZQUE,estado nutricional en menores de 5 anos,clasificacion a y b,2002-05-01,11,21,11,21,32
20402,MOCOMOCO,estado nutricional en menores de 5 anos,clasificacion a y b,2002-05-01,17,1,17,1,18
10303,MOJOCOYA,estado nutricional en menores de 5 anos,clasificacion a y b,2002-05-01,32,12,32,12,44
10501,MONTEAGUDO,estado nutricional en menores de 5 anos,clasificacion a y b,2002-05-01,124,33,124,33,157
71001,MONTERO,estado nutricional en menores de 5 anos,clasificacion a y b,2002-05-01,204,284,204,284,488
70803,MORO MORO,estado nutricional en menores de 5 anos,clasificacion a y b,2002-05-01,9,4,9,4,13
30302,MOROCHATA,estado nutricional en menores de 5 anos,clasificacion a y b,2002-05-01,8,8,8,8,16
90501,NUEVO MANOA (NUEVA ESPERANZA),estado nutricional en menores de 5 anos,clasificacion a y b,2002-05-01,1,0,1,0,1
50404,OCURI,estado nutricional en menores de 5 anos,clasificacion a y b,2002-05-01,15,6,15,6,21
70202,OKINAWA,estado nutricional en menores de 5 anos,clasificacion a y b,2002-05-01,3,1,3,1,4
30203,OMEREQUE,estado nutricional en menores de 5 anos,clasificacion a y b,2002-05-01,2,12,2,12,14
40101,ORURO,estado nutricional en menores de 5 anos,clasificacion a y b,2002-05-01,283,169,283,169,452
60201,PADCAYA,estado nutricional en menores de 5 anos,clasificacion a y b,2002-05-01,26,35,26,35,61
10401,PADILLA,estado nutricional en menores de 5 anos,clasificacion a y b,2002-05-01,38,9,38,9,47
70502,PAILON,estado nutricional en menores de 5 anos,clasificacion a y b,2002-05-01,7,19,7,19,26
20102,PALCA,estado nutricional en menores de 5 anos,clasificacion a y b,2002-05-01,16,3,16,3,19
21104,PALOS BLANCOS,estado nutricional en menores de 5 anos,clasificacion a y b,2002-05-01,50,15,50,15,65
40802,PAMPA AULLAGAS,estado nutricional en menores de 5 anos,clasificacion a y b,2002-05-01,2,0,2,0,2
70902,PAMPA GRANDE,estado nutricional en menores de 5 anos,clasificacion a y b,2002-05-01,20,3,20,3,23
21802,PAPEL PAMPA,estado nutricional en menores de 5 anos,clasificacion a y b,2002-05-01,4,1,4,1,5
30202,PASORAPA,estado nutricional en menores de 5 anos,clasificacion a y b,2002-05-01,22,6,22,6,28
21305,PATACAMAYA,estado nutricional en menores de 5 anos,clasificacion a y b,2002-05-01,45,5,45,5,50
40602,PAZÃ‘A,estado nutricional en menores de 5 anos,clasificacion a y b,2002-05-01,1,4,1,4,5
20702,PELECHUCO,estado nutricional en menores de 5 anos,clasificacion a y b,2002-05-01,2,2,2,2,4
50403,POCOATA,estado nutricional en menores de 5 anos,clasificacion a y b,2002-05-01,23,21,23,21,44
31203,POCONA,estado nutricional en menores de 5 anos,clasificacion a y b,2002-05-01,10,7,10,7,17
31202,POJO (CBBA),estado nutricional en menores de 5 anos,clasificacion a y b,2002-05-01,87,19,87,19,106
40601,POOPO,estado nutricional en menores de 5 anos,clasificacion a y b,2002-05-01,0,1,0,1,1
51203,PORCO,estado nutricional en menores de 5 anos,clasificacion a y b,2002-05-01,11,6,11,6,17
10103,POROMA,estado nutricional en menores de 5 anos,clasificacion a y b,2002-05-01,27,3,27,3,30
70103,PORONGO,estado nutricional en menores de 5 anos,clasificacion a y b,2002-05-01,24,2,24,2,26
70601,PORTACHUELO,estado nutricional en menores de 5 anos,clasificacion a y b,2002-05-01,72,25,72,25,97
50101,POTOSI,estado nutricional en menores de 5 anos,clasificacion a y b,2002-05-01,131,27,131,27,158
10302,PRESTO,estado nutricional en menores de 5 anos,clasificacion a y b,2002-05-01,16,2,16,2,18
70805,PUCARA,estado nutricional en menores de 5 anos,clasificacion a y b,2002-05-01,1,0,1,0,1
21201,PUCARANI,estado nutricional en menores de 5 anos,clasificacion a y b,2002-05-01,4,31,4,31,35
20401,PUERTO ACOSTA,estado nutricional en menores de 5 anos,clasificacion a y b,2002-05-01,23,20,23,20,43
20403,PUERTO CARABUCO,estado nutricional en menores de 5 anos,clasificacion a y b,2002-05-01,16,2,16,2,18
90301,PUERTO GONZALO MORENO,estado nutricional en menores de 5 anos,clasificacion a y b,2002-05-01,8,3,8,3,11
21204,PUERTO PEREZ,estado nutricional en menores de 5 anos,clasificacion a y b,2002-05-01,3,6,3,6,9
71402,PUERTO QUIJARRO,estado nutricional en menores de 5 anos,clasificacion a y b,2002-05-01,47,7,47,7,54
90201,PUERTO RICO,estado nutricional en menores de 5 anos,clasificacion a y b,2002-05-01,3,9,3,9,12
80703,PUERTO SILES,estado nutricional en menores de 5 anos,clasificacion a y b,2002-05-01,3,1,3,1,4
71401,PUERTO SUAREZ,estado nutricional en menores de 5 anos,clasificacion a y b,2002-05-01,54,9,54,9,63
31205,PUERTO VILLARROEL,estado nutricional en menores de 5 anos,clasificacion a y b,2002-05-01,148,59,148,59,207
51101,PUNA,estado nutricional en menores de 5 anos,clasificacion a y b,2002-05-01,46,35,46,35,81
31401,PUNATA,estado nutricional en menores de 5 anos,clasificacion a y b,2002-05-01,0,8,0,8,8
20604,QUIABAYA,estado nutricional en menores de 5 anos,clasificacion a y b,2002-05-01,7,1,7,1,8
30901,QUILLACOLLO,estado nutricional en menores de 5 anos,clasificacion a y b,2002-05-01,36,4,36,4,40
21002,QUIME,estado nutricional en menores de 5 anos,clasificacion a y b,2002-05-01,5,5,5,5,10
70904,QUIRUSILLAS,estado nutricional en menores de 5 anos,clasificacion a y b,2002-05-01,0,2,0,2,2
50402,RAVELO,estado nutricional en menores de 5 anos,clasificacion a y b,2002-05-01,10,5,10,5,15
80301,REYES,estado nutricional en menores de 5 anos,clasificacion a y b,2002-05-01,37,4,37,4,41
80201,RIBERALTA,estado nutricional en menores de 5 anos,clasificacion a y b,2002-05-01,213,68,213,68,281
70503,ROBORE,estado nutricional en menores de 5 anos,clasificacion a y b,2002-05-01,25,15,25,15,40
80304,RURRENABAQUE,estado nutricional en menores de 5 anos,clasificacion a y b,2002-05-01,25,16,25,16,41
40901,SABAYA,estado nutricional en menores de 5 anos,clasificacion a y b,2002-05-01,1,1,1,1,2
31001,SACABA,estado nutricional en menores de 5 anos,clasificacion a y b,2002-05-01,19,6,19,6,25
30404,SACABAMBA,estado nutricional en menores de 5 anos,clasificacion a y b,2002-05-01,1,7,1,7,8
50701,SACACA,estado nutricional en menores de 5 anos,clasificacion a y b,2002-05-01,15,4,15,4,19
71302,SAIPINA,estado nutricional en menores de 5 anos,clasificacion a y b,2002-05-01,36,16,36,16,52
40801,SALINAS DE GARCI MENDOZA,estado nutricional en menores de 5 anos,clasificacion a y b,2002-05-01,3,1,3,1,4
70901,SAMAIPATA,estado nutricional en menores de 5 anos,clasificacion a y b,2002-05-01,15,6,15,6,21
51601,SAN AGUSTIN,estado nutricional en menores de 5 anos,clasificacion a y b,2002-05-01,1,2,1,2,3
80602,SAN ANDRES,estado nutricional en menores de 5 anos,clasificacion a y b,2002-05-01,4,1,4,1,5
51003,SAN ANTONIO DE ESMORUCO,estado nutricional en menores de 5 anos,clasificacion a y b,2002-05-01,1,2,1,2,3
71105,SAN ANTONIO DE LOMERIO,estado nutricional en menores de 5 anos,clasificacion a y b,2002-05-01,27,6,27,6,33
31403,SAN BENITO,estado nutricional en menores de 5 anos,clasificacion a y b,2002-05-01,6,9,6,9,15
80302,SAN BORJA,estado nutricional en menores de 5 anos,clasificacion a y b,2002-05-01,93,20,93,20,113
21502,SAN BUENA VENTURA,estado nutricional en menores de 5 anos,clasificacion a y b,2002-05-01,5,4,5,4,9
70402,SAN CARLOS,estado nutricional en menores de 5 anos,clasificacion a y b,2002-05-01,8,6,8,6,14
80501,SAN IGNACIO,estado nutricional en menores de 5 anos,clasificacion a y b,2002-05-01,28,64,28,64,92
70301,SAN IGNACIO DE VELASCO,estado nutricional en menores de 5 anos,clasificacion a y b,2002-05-01,154,31,154,31,185
80102,SAN JAVIER(BNI),estado nutricional en menores de 5 anos,clasificacion a y b,2002-05-01,3,3,3,3,6
71102,SAN JAVIER(STC),estado nutricional en menores de 5 anos,clasificacion a y b,2002-05-01,25,6,25,6,31
80701,SAN JOAQUIN,estado nutricional en menores de 5 anos,clasificacion a y b,2002-05-01,5,17,5,17,22
70501,SAN JOSE DE CHIQUITOS,estado nutricional en menores de 5 anos,clasificacion a y b,2002-05-01,18,6,18,6,24
71104,SAN JULIAN,estado nutricional en menores de 5 anos,clasificacion a y b,2002-05-01,115,89,115,89,204
60501,SAN LORENZO(TJA),estado nutricional en menores de 5 anos,clasificacion a y b,2002-05-01,3,5,3,5,8
10702,SAN LUCAS,estado nutricional en menores de 5 anos,clasificacion a y b,2002-05-01,44,12,44,12,56
71201,SAN MATIAS,estado nutricional en menores de 5 anos,clasificacion a y b,2002-05-01,27,17,27,17,44
70302,SAN MIGUEL DE VELASCO,estado nutricional en menores de 5 anos,clasificacion a y b,2002-05-01,33,7,33,7,40
51001,SAN PABLO DE LIPEZ,estado nutricional en menores de 5 anos,clasificacion a y b,2002-05-01,2,10,2,10,12
50501,SAN PEDRO DE BUENA VISTA,estado nutricional en menores de 5 anos,clasificacion a y b,2002-05-01,0,21,0,21,21
21801,SAN PEDRO DE CURAHUARA,estado nutricional en menores de 5 anos,clasificacion a y b,2002-05-01,6,7,6,7,13
21702,SAN PEDRO DE TIQUINA,estado nutricional en menores de 5 anos,clasificacion a y b,2002-05-01,7,18,7,18,25
70303,SAN RAFAEL,estado nutricional en menores de 5 anos,clasificacion a y b,2002-05-01,8,0,8,0,8
80702,SAN RAMON,estado nutricional en menores de 5 anos,clasificacion a y b,2002-05-01,36,36,36,36,72
80401,SANTA ANA,estado nutricional en menores de 5 anos,clasificacion a y b,2002-05-01,43,10,43,10,53
70101,SANTA CRUZ DE LA SIERRA,estado nutricional en menores de 5 anos,clasificacion a y b,2002-05-01,1160,698,1160,698,1858
80303,SANTA ROSA,estado nutricional en menores de 5 anos,clasificacion a y b,2002-05-01,20,5,20,5,25
70602,SANTA ROSA DEL SARA,estado nutricional en menores de 5 anos,clasificacion a y b,2002-05-01,18,23,18,23,41
20308,SANTIAGO DE CALLAPA,estado nutricional en menores de 5 anos,clasificacion a y b,2002-05-01,0,2,0,2,2
41401,SANTIAGO DE HUARI,estado nutricional en menores de 5 anos,clasificacion a y b,2002-05-01,7,2,7,2,9
21901,SANTIAGO DE MACHACA,estado nutricional en menores de 5 anos,clasificacion a y b,2002-05-01,9,1,9,1,10
30702,SANTIVAÃ‘ES,estado nutricional en menores de 5 anos,clasificacion a y b,2002-05-01,3,0,3,0,3
40202,SANTUARIO DE QUILLACAS,estado nutricional en menores de 5 anos,clasificacion a y b,2002-05-01,3,1,3,1,4
20902,SAPAHAQUI,estado nutricional en menores de 5 anos,clasificacion a y b,2002-05-01,1,0,1,0,1
21301,SICA SICA (VILLA AROMA),estado nutricional en menores de 5 anos,clasificacion a y b,2002-05-01,16,9,16,9,25
30703,SICAYA,estado nutricional en menores de 5 anos,clasificacion a y b,2002-05-01,0,2,0,2,2
30902,SIPE SIPE,estado nutricional en menores de 5 anos,clasificacion a y b,2002-05-01,123,70,123,70,193
10403,SOPACHUY,estado nutricional en menores de 5 anos,clasificacion a y b,2002-05-01,17,1,17,1,18
20601,SORATA,estado nutricional en menores de 5 anos,clasificacion a y b,2002-05-01,16,9,16,9,25
10101,SUCRE,estado nutricional en menores de 5 anos,clasificacion a y b,2002-05-01,361,170,361,170,531
31404,TACACHI,estado nutricional en menores de 5 anos,clasificacion a y b,2002-05-01,0,1,0,1,1
20603,TACACOMA,estado nutricional en menores de 5 anos,clasificacion a y b,2002-05-01,4,22,4,22,26
50303,TACOBAMBA,estado nutricional en menores de 5 anos,clasificacion a y b,2002-05-01,17,0,17,0,17
30602,TACOPAYA,estado nutricional en menores de 5 anos,clasificacion a y b,2002-05-01,6,4,6,4,10
51402,TAHUA,estado nutricional en menores de 5 anos,clasificacion a y b,2002-05-01,0,2,0,2,2
31101,TAPACARI,estado nutricional en menores de 5 anos,clasificacion a y b,2002-05-01,13,33,13,33,46
10601,TARABUCO,estado nutricional en menores de 5 anos,clasificacion a y b,2002-05-01,30,52,30,52,82
30401,TARATA,estado nutricional en menores de 5 anos,clasificacion a y b,2002-05-01,16,10,16,10,26
60101,TARIJA,estado nutricional en menores de 5 anos,clasificacion a y b,2002-05-01,317,190,317,190,507
10202,TARVITA,estado nutricional en menores de 5 anos,clasificacion a y b,2002-05-01,15,0,15,0,15
20803,TIAWANACU,estado nutricional en menores de 5 anos,clasificacion a y b,2002-05-01,22,7,22,7,29
50102,TINGUIPAYA,estado nutricional en menores de 5 anos,clasificacion a y b,2002-05-01,10,2,10,2,12
20606,TIPUANI,estado nutricional en menores de 5 anos,clasificacion a y b,2002-05-01,13,9,13,9,22
30903,TIQUIPAYA,estado nutricional en menores de 5 anos,clasificacion a y b,2002-05-01,11,34,11,34,45
31601,TIRAQUE (CBBA),estado nutricional en menores de 5 anos,clasificacion a y b,2002-05-01,46,89,46,89,135
30802,TOCO,estado nutricional en menores de 5 anos,clasificacion a y b,2002-05-01,3,3,3,3,6
30803,TOLATA,estado nutricional en menores de 5 anos,clasificacion a y b,2002-05-01,1,5,1,5,6
41001,TOLEDO,estado nutricional en menores de 5 anos,clasificacion a y b,2002-05-01,3,2,3,2,5
51202,TOMAVE,estado nutricional en menores de 5 anos,clasificacion a y b,2002-05-01,2,17,2,17,19
10402,TOMINA,estado nutricional en menores de 5 anos,clasificacion a y b,2002-05-01,31,19,31,19,50
50502,TORO TORO,estado nutricional en menores de 5 anos,clasificacion a y b,2002-05-01,0,1,0,1,1
31201,TOTORA(CBBA),estado nutricional en menores de 5 anos,clasificacion a y b,2002-05-01,27,32,27,32,59
41301,TOTORA(ORR),estado nutricional en menores de 5 anos,clasificacion a y b,2002-05-01,0,1,0,1,1
70802,TRIGAL,estado nutricional en menores de 5 anos,clasificacion a y b,2002-05-01,4,0,4,0,4
80101,TRINIDAD,estado nutricional en menores de 5 anos,clasificacion a y b,2002-05-01,163,102,163,102,265
50801,TUPIZA,estado nutricional en menores de 5 anos,clasificacion a y b,2002-05-01,14,64,14,64,78
40402,TURCO,estado nutricional en menores de 5 anos,clasificacion a y b,2002-05-01,4,0,4,0,4
21302,UMALA,estado nutricional en menores de 5 anos,clasificacion a y b,2002-05-01,0,8,0,8,8
60401,URIONDO (A. CONCEPCION),estado nutricional en menores de 5 anos,clasificacion a y b,2002-05-01,15,38,15,38,53
51201,UYUNI,estado nutricional en menores de 5 anos,clasificacion a y b,2002-05-01,12,40,12,40,52
70801,VALLEGRANDE,estado nutricional en menores de 5 anos,clasificacion a y b,2002-05-01,59,29,59,29,88
20801,VIACHA,estado nutricional en menores de 5 anos,clasificacion a y b,2002-05-01,35,74,35,74,109
31302,VILA VILA,estado nutricional en menores de 5 anos,clasificacion a y b,2002-05-01,2,3,2,3,5
60303,VILLA MONTES,estado nutricional en menores de 5 anos,clasificacion a y b,2002-05-01,35,15,35,15,50
31402,VILLA RIVERO,estado nutricional en menores de 5 anos,clasificacion a y b,2002-05-01,0,5,0,5,5
10801,VILLA SERRANO,estado nutricional en menores de 5 anos,clasificacion a y b,2002-05-01,10,23,10,23,33
31003,VILLA TUNARI,estado nutricional en menores de 5 anos,clasificacion a y b,2002-05-01,119,17,119,17,136
11001,VILLA VACA GUZMAN (MUYUPAMPA),estado nutricional en menores de 5 anos,clasificacion a y b,2002-05-01,63,17,63,17,80
51501,VILLAZON,estado nutricional en menores de 5 anos,clasificacion a y b,2002-05-01,33,78,33,78,111
30904,VINTO,estado nutricional en menores de 5 anos,clasificacion a y b,2002-05-01,31,12,31,12,43
50602,VITICHI,estado nutricional en menores de 5 anos,clasificacion a y b,2002-05-01,4,9,4,9,13
20306,WALDO BALLIVIAN,estado nutricional en menores de 5 anos,clasificacion a y b,2002-05-01,0,1,0,1,1
70201,WARNES,estado nutricional en menores de 5 anos,clasificacion a y b,2002-05-01,76,33,76,33,109
20903,YACO,estado nutricional en menores de 5 anos,clasificacion a y b,2002-05-01,8,7,8,7,15
60301,YACUIBA,estado nutricional en menores de 5 anos,clasificacion a y b,2002-05-01,194,112,194,112,306
10602,YAMPARAEZ,estado nutricional en menores de 5 anos,clasificacion a y b,2002-05-01,34,4,34,4,38
21103,YANACACHI,estado nutricional en menores de 5 anos,clasificacion a y b,2002-05-01,4,6,4,6,10
70403,YAPACANI,estado nutricional en menores de 5 anos,clasificacion a y b,2002-05-01,34,23,34,23,57
50103,YOCALLA,estado nutricional en menores de 5 anos,clasificacion a y b,2002-05-01,1,6,1,6,7
10102,YOTALA,estado nutricional en menores de 5 anos,clasificacion a y b,2002-05-01,33,10,33,10,43
60402,YUNCHARA,estado nutricional en menores de 5 anos,clasificacion a y b,2002-05-01,9,8,9,8,17
10301,ZUDAÃ‘EZ,estado nutricional en menores de 5 anos,clasificacion a y b,2002-05-01,22,2,22,2,24
51302,ACACIO,estado nutricional en menores de 5 anos,clasificacion a y b,2002-06-01,1,1,1,1,2
20201,ACHACACHI,estado nutricional en menores de 5 anos,clasificacion a y b,2002-06-01,85,30,85,30,115
20104,ACHOCALLA,estado nutricional en menores de 5 anos,clasificacion a y b,2002-06-01,5,2,5,2,7
30201,AIQUILE,estado nutricional en menores de 5 anos,clasificacion a y b,2002-06-01,7,4,7,4,11
31303,ALALAY,estado nutricional en menores de 5 anos,clasificacion a y b,2002-06-01,0,3,0,3,3
10404,ALCALA,estado nutricional en menores de 5 anos,clasificacion a y b,2002-06-01,12,3,12,3,15
20202,ANCORAIMES,estado nutricional en menores de 5 anos,clasificacion a y b,2002-06-01,14,8,14,8,22
41201,ANDAMARCA,estado nutricional en menores de 5 anos,clasificacion a y b,2002-06-01,2,0,2,0,2
40603,ANTEQUERA,estado nutricional en menores de 5 anos,clasificacion a y b,2002-06-01,0,4,0,4,4
30402,ANZALDO,estado nutricional en menores de 5 anos,clasificacion a y b,2002-06-01,2,14,2,14,16
20701,APOLO,estado nutricional en menores de 5 anos,clasificacion a y b,2002-06-01,26,3,26,3,29
51301,ARAMPAMPA,estado nutricional en menores de 5 anos,clasificacion a y b,2002-06-01,5,1,5,1,6
30501,ARANI,estado nutricional en menores de 5 anos,clasificacion a y b,2002-06-01,3,6,3,6,9
30403,ARBIETO,estado nutricional en menores de 5 anos,clasificacion a y b,2002-06-01,4,11,4,11,15
30601,ARQUE,estado nutricional en menores de 5 anos,clasificacion a y b,2002-06-01,2,2,2,2,4
71501,ASCENCION DE GUARAYOS,estado nutricional en menores de 5 anos,clasificacion a y b,2002-06-01,109,34,109,34,143
50802,ATOCHA,estado nutricional en menores de 5 anos,clasificacion a y b,2002-06-01,1,11,1,11,12
20503,AUCAPATA,estado nutricional en menores de 5 anos,clasificacion a y b,2002-06-01,7,1,7,1,8
20502,AYATA,estado nutricional en menores de 5 anos,clasificacion a y b,2002-06-01,2,0,2,0,2
21303,AYO AYO,estado nutricional en menores de 5 anos,clasificacion a y b,2002-06-01,21,1,21,1,22
30301,AYOPAYA (V. DE INDEPENDENCIA),estado nutricional en menores de 5 anos,clasificacion a y b,2002-06-01,18,10,18,10,28
10201,AZURDUY,estado nutricional en menores de 5 anos,clasificacion a y b,2002-06-01,43,11,43,11,54
21203,BATALLAS,estado nutricional en menores de 5 anos,clasificacion a y b,2002-06-01,8,40,8,40,48
80802,BAURES,estado nutricional en menores de 5 anos,clasificacion a y b,2002-06-01,14,8,14,8,22
41202,BELEN DE ANDAMARCA,estado nutricional en menores de 5 anos,clasificacion a y b,2002-06-01,2,0,2,0,2
50104,BELEN DE URMIRI,estado nutricional en menores de 5 anos,clasificacion a y b,2002-06-01,8,2,8,2,10
60202,BERMEJO,estado nutricional en menores de 5 anos,clasificacion a y b,2002-06-01,20,36,20,36,56
50301,BETANZOS,estado nutricional en menores de 5 anos,clasificacion a y b,2002-06-01,10,11,10,11,21
31501,BOLIVAR,estado nutricional en menores de 5 anos,clasificacion a y b,2002-06-01,4,3,4,3,7
90103,BOLPEBRA,estado nutricional en menores de 5 anos,clasificacion a y b,2002-06-01,0,2,0,2,2
70707,BOYUIBE,estado nutricional en menores de 5 anos,clasificacion a y b,2002-06-01,1,2,1,2,3
70703,CABEZAS,estado nutricional en menores de 5 anos,clasificacion a y b,2002-06-01,7,68,7,68,75
20905,CAIROMA,estado nutricional en menores de 5 anos,clasificacion a y b,2002-06-01,21,10,21,10,31
51102,"CAIZA ""D""",estado nutricional en menores de 5 anos,clasificacion a y b,2002-06-01,9,6,9,6,15
21003,CAJUATA,estado nutricional en menores de 5 anos,clasificacion a y b,2002-06-01,24,2,24,2,26
20303,CALACOTO,estado nutricional en menores de 5 anos,clasificacion a y b,2002-06-01,3,0,3,0,3
21304,CALAMARCA,estado nutricional en menores de 5 anos,clasificacion a y b,2002-06-01,12,6,12,6,18
10701,CAMARGO,estado nutricional en menores de 5 anos,clasificacion a y b,2002-06-01,30,12,30,12,42
10901,CAMATAQUI (C. VILLA ABECIA),estado nutricional en menores de 5 anos,clasificacion a y b,2002-06-01,24,5,24,5,29
70706,CAMIRI,estado nutricional en menores de 5 anos,clasificacion a y b,2002-06-01,62,26,62,26,88
30701,CAPINOTA,estado nutricional en menores de 5 anos,clasificacion a y b,2002-06-01,9,2,9,2,11
20302,CAQUIAVIRI,estado nutricional en menores de 5 anos,clasificacion a y b,2002-06-01,19,10,19,10,29
40102,CARACOLLO,estado nutricional en menores de 5 anos,clasificacion a y b,2002-06-01,24,18,24,18,42
22001,CARANAVI,estado nutricional en menores de 5 anos,clasificacion a y b,2002-06-01,108,42,108,42,150
60302,CARAPARI,estado nutricional en menores de 5 anos,clasificacion a y b,2002-06-01,27,39,27,39,66
50702,CARIPUYO,estado nutricional en menores de 5 anos,clasificacion a y b,2002-06-01,2,3,2,3,5
21902,CATACORA,estado nutricional en menores de 5 anos,clasificacion a y b,2002-06-01,1,0,1,0,1
21803,CHACARILLA,estado nutricional en menores de 5 anos,clasificacion a y b,2002-06-01,1,1,1,1,2
40201,CHALLAPATA,estado nutricional en menores de 5 anos,clasificacion a y b,2002-06-01,9,7,9,7,16
50302,CHAQUI,estado nutricional en menores de 5 anos,clasificacion a y b,2002-06-01,16,3,16,3,19
70702,CHARAGUA,estado nutricional en menores de 5 anos,clasificacion a y b,2002-06-01,18,93,18,93,111
50202,CHAYANTA,estado nutricional en menores de 5 anos,clasificacion a y b,2002-06-01,2,7,2,7,9
31204,CHIMORE,estado nutricional en menores de 5 anos,clasificacion a y b,2002-06-01,7,2,7,2,9
40903,CHIPAYA,estado nutricional en menores de 5 anos,clasificacion a y b,2002-06-01,0,2,0,2,2
40302,CHOQUE COTA,estado nutricional en menores de 5 anos,clasificacion a y b,2002-06-01,0,2,0,2,2
21101,CHULUMANI (V. DE LA LIBERTAD),estado nutricional en menores de 5 anos,clasificacion a y b,2002-06-01,6,2,6,2,8
20501,CHUMA,estado nutricional en menores de 5 anos,clasificacion a y b,2002-06-01,8,4,8,4,12
30801,CLIZA,estado nutricional en menores de 5 anos,clasificacion a y b,2002-06-01,2,14,2,14,16
90101,COBIJA,estado nutricional en menores de 5 anos,clasificacion a y b,2002-06-01,43,14,43,14,57
30101,COCHABAMBA,estado nutricional en menores de 5 anos,clasificacion a y b,2002-06-01,330,298,330,298,628
40902,COIPASA,estado nutricional en menores de 5 anos,clasificacion a y b,2002-06-01,1,1,1,1,2
30905,COLCAPIRHUA,estado nutricional en menores de 5 anos,clasificacion a y b,2002-06-01,51,7,51,7,58
50901,"COLCHA ""K""",estado nutricional en menores de 5 anos,clasificacion a y b,2002-06-01,1,17,1,17,18
21307,COLLANA,estado nutricional en menores de 5 anos,clasificacion a y b,2002-06-01,3,0,3,0,3
31002,COLOMI,estado nutricional en menores de 5 anos,clasificacion a y b,2002-06-01,16,4,16,4,20
50401,COLQUECHACA,estado nutricional en menores de 5 anos,clasificacion a y b,2002-06-01,7,8,7,8,15
21306,COLQUENCHA,estado nutricional en menores de 5 anos,clasificacion a y b,2002-06-01,11,7,11,7,18
21004,COLQUIRI,estado nutricional en menores de 5 anos,clasificacion a y b,2002-06-01,22,5,22,5,27
20304,COMANCHE,estado nutricional en menores de 5 anos,clasificacion a y b,2002-06-01,2,0,2,0,2
71301,COMARAPA,estado nutricional en menores de 5 anos,clasificacion a y b,2002-06-01,50,28,50,28,78
20605,COMBAYA,estado nutricional en menores de 5 anos,clasificacion a y b,2002-06-01,3,0,3,0,3
71101,CONCEPCION,estado nutricional en menores de 5 anos,clasificacion a y b,2002-06-01,25,3,25,3,28
21701,COPACABANA,estado nutricional en menores de 5 anos,clasificacion a y b,2002-06-01,4,7,4,7,11
21402,CORIPATA,estado nutricional en menores de 5 anos,clasificacion a y b,2002-06-01,22,30,22,30,52
20301,CORO CORO,estado nutricional en menores de 5 anos,clasificacion a y b,2002-06-01,24,9,24,9,33
21401,COROICO,estado nutricional en menores de 5 anos,clasificacion a y b,2002-06-01,4,1,4,1,5
40301,CORQUE,estado nutricional en menores de 5 anos,clasificacion a y b,2002-06-01,7,1,7,1,8
50601,COTAGAITA,estado nutricional en menores de 5 anos,clasificacion a y b,2002-06-01,19,33,19,33,52
70102,COTOCA,estado nutricional en menores de 5 anos,clasificacion a y b,2002-06-01,135,17,135,17,152
31405,CUCHUMUELA (V. G. VILLARROEL),estado nutricional en menores de 5 anos,clasificacion a y b,2002-06-01,2,0,2,0,2
70704,CUEVO,estado nutricional en menores de 5 anos,clasificacion a y b,2002-06-01,17,0,17,0,17
10902,CULPINA,estado nutricional en menores de 5 anos,clasificacion a y b,2002-06-01,32,9,32,9,41
40401,CURAHUARA DE CARANGAS,estado nutricional en menores de 5 anos,clasificacion a y b,2002-06-01,6,0,6,0,6
21602,CURVA,estado nutricional en menores de 5 anos,clasificacion a y b,2002-06-01,3,0,3,0,3
20804,DESAGUADERO,estado nutricional en menores de 5 anos,clasificacion a y b,2002-06-01,1,9,1,9,10
20105,EL ALTO,estado nutricional en menores de 5 anos,clasificacion a y b,2002-06-01,570,203,570,203,773
40103,EL CHORO,estado nutricional en menores de 5 anos,clasificacion a y b,2002-06-01,2,2,2,2,4
71503,EL PUENTE(STC),estado nutricional en menores de 5 anos,clasificacion a y b,2002-06-01,15,26,15,26,41
60502,EL PUENTE(TJA),estado nutricional en menores de 5 anos,clasificacion a y b,2002-06-01,6,5,6,5,11
70105,EL TORNO,estado nutricional en menores de 5 anos,clasificacion a y b,2002-06-01,95,36,95,36,131
10405,EL VILLAR,estado nutricional en menores de 5 anos,clasificacion a y b,2002-06-01,13,6,13,6,19
60601,ENTRE RIOS,estado nutricional en menores de 5 anos,clasificacion a y b,2002-06-01,47,26,47,26,73
41101,EUCALIPTUS,estado nutricional en menores de 5 anos,clasificacion a y b,2002-06-01,0,8,0,8,8
90203,FILADELFIA,estado nutricional en menores de 5 anos,clasificacion a y b,2002-06-01,13,23,13,23,36
71002,GENERAL SAAVEDRA,estado nutricional en menores de 5 anos,clasificacion a y b,2002-06-01,43,19,43,19,62
20602,GUANAY,estado nutricional en menores de 5 anos,clasificacion a y b,2002-06-01,113,27,113,27,140
20802,GUAQUI,estado nutricional en menores de 5 anos,clasificacion a y b,2002-06-01,1,1,1,1,2
80202,GUAYARAMERIN,estado nutricional en menores de 5 anos,clasificacion a y b,2002-06-01,84,14,84,14,98
70705,GUTIERREZ,estado nutricional en menores de 5 anos,clasificacion a y b,2002-06-01,46,47,46,47,93
10502,HUACARETA,estado nutricional en menores de 5 anos,clasificacion a y b,2002-06-01,31,31,31,31,62
11002,HUACAYA (VILLA DE HUACAYA),estado nutricional en menores de 5 anos,clasificacion a y b,2002-06-01,7,2,7,2,9
40501,HUACHACALLA,estado nutricional en menores de 5 anos,clasificacion a y b,2002-06-01,2,4,2,4,6
40701,HUANUNI,estado nutricional en menores de 5 anos,clasificacion a y b,2002-06-01,3,0,3,0,3
80803,HUARACAJE,estado nutricional en menores de 5 anos,clasificacion a y b,2002-06-01,18,7,18,7,25
41601,HUAYLLAMARCA,estado nutricional en menores de 5 anos,clasificacion a y b,2002-06-01,4,0,4,0,4
10304,ICLA,estado nutricional en menores de 5 anos,clasificacion a y b,2002-06-01,14,8,14,8,22
10703,INCAHUASI,estado nutricional en menores de 5 anos,clasificacion a y b,2002-06-01,34,20,34,20,54
90402,INGAVI (HUMAITA),estado nutricional en menores de 5 anos,clasificacion a y b,2002-06-01,19,0,19,0,19
21001,INQUISIVI,estado nutricional en menores de 5 anos,clasificacion a y b,2002-06-01,41,7,41,7,48
21102,IRUPANA (VILLA DE LANZA),estado nutricional en menores de 5 anos,clasificacion a y b,2002-06-01,16,48,16,48,64
21501,IXIAMAS,estado nutricional en menores de 5 anos,clasificacion a y b,2002-06-01,29,13,29,13,42
21105,LA ASUNTA,estado nutricional en menores de 5 anos,clasificacion a y b,2002-06-01,18,4,18,4,22
70104,LA GUARDIA,estado nutricional en menores de 5 anos,clasificacion a y b,2002-06-01,156,36,156,36,192
20101,LA PAZ,estado nutricional en menores de 5 anos,clasificacion a y b,2002-06-01,561,211,561,211,772
41501,LA RIVERA,estado nutricional en menores de 5 anos,clasificacion a y b,2002-06-01,2,0,2,0,2
70701,LAGUNILLAS,estado nutricional en menores de 5 anos,clasificacion a y b,2002-06-01,37,17,37,17,54
21202,LAJA,estado nutricional en menores de 5 anos,clasificacion a y b,2002-06-01,8,8,8,8,16
10903,LAS CARRERAS,estado nutricional en menores de 5 anos,clasificacion a y b,2002-06-01,8,4,8,4,12
21006,LICOMA PAMPA,estado nutricional en menores de 5 anos,clasificacion a y b,2002-06-01,0,2,0,2,2
50203,LLALLAGUA,estado nutricional en menores de 5 anos,clasificacion a y b,2002-06-01,1,0,1,0,1
51401,LLICA,estado nutricional en menores de 5 anos,clasificacion a y b,2002-06-01,9,1,9,1,10
80601,LORETO,estado nutricional en menores de 5 anos,clasificacion a y b,2002-06-01,9,13,9,13,22
20901,LURIBAY,estado nutricional en menores de 5 anos,clasificacion a y b,2002-06-01,5,11,5,11,16
11003,MACHARETI,estado nutricional en menores de 5 anos,clasificacion a y b,2002-06-01,29,26,29,26,55
80801,MAGDALENA,estado nutricional en menores de 5 anos,clasificacion a y b,2002-06-01,18,3,18,3,21
70903,MAIRANA,estado nutricional en menores de 5 anos,clasificacion a y b,2002-06-01,46,9,46,9,55
20103,MECAPACA,estado nutricional en menores de 5 anos,clasificacion a y b,2002-06-01,16,1,16,1,17
71003,MINEROS,estado nutricional en menores de 5 anos,clasificacion a y b,2002-06-01,52,19,52,19,71
31301,MIZQUE,estado nutricional en menores de 5 anos,clasificacion a y b,2002-06-01,11,14,11,14,25
20402,MOCOMOCO,estado nutricional en menores de 5 anos,clasificacion a y b,2002-06-01,22,2,22,2,24
10303,MOJOCOYA,estado nutricional en menores de 5 anos,clasificacion a y b,2002-06-01,26,6,26,6,32
10501,MONTEAGUDO,estado nutricional en menores de 5 anos,clasificacion a y b,2002-06-01,111,26,111,26,137
71001,MONTERO,estado nutricional en menores de 5 anos,clasificacion a y b,2002-06-01,217,218,217,218,435
70803,MORO MORO,estado nutricional en menores de 5 anos,clasificacion a y b,2002-06-01,6,2,6,2,8
30302,MOROCHATA,estado nutricional en menores de 5 anos,clasificacion a y b,2002-06-01,11,14,11,14,25
90501,NUEVO MANOA (NUEVA ESPERANZA),estado nutricional en menores de 5 anos,clasificacion a y b,2002-06-01,1,1,1,1,2
50404,OCURI,estado nutricional en menores de 5 anos,clasificacion a y b,2002-06-01,17,19,17,19,36
70202,OKINAWA,estado nutricional en menores de 5 anos,clasificacion a y b,2002-06-01,0,4,0,4,4
40101,ORURO,estado nutricional en menores de 5 anos,clasificacion a y b,2002-06-01,279,80,279,80,359
60201,PADCAYA,estado nutricional en menores de 5 anos,clasificacion a y b,2002-06-01,32,44,32,44,76
10401,PADILLA,estado nutricional en menores de 5 anos,clasificacion a y b,2002-06-01,44,8,44,8,52
70502,PAILON,estado nutricional en menores de 5 anos,clasificacion a y b,2002-06-01,28,10,28,10,38
20102,PALCA,estado nutricional en menores de 5 anos,clasificacion a y b,2002-06-01,10,2,10,2,12
21104,PALOS BLANCOS,estado nutricional en menores de 5 anos,clasificacion a y b,2002-06-01,51,15,51,15,66
40802,PAMPA AULLAGAS,estado nutricional en menores de 5 anos,clasificacion a y b,2002-06-01,4,0,4,0,4
70902,PAMPA GRANDE,estado nutricional en menores de 5 anos,clasificacion a y b,2002-06-01,18,6,18,6,24
21802,PAPEL PAMPA,estado nutricional en menores de 5 anos,clasificacion a y b,2002-06-01,7,0,7,0,7
30202,PASORAPA,estado nutricional en menores de 5 anos,clasificacion a y b,2002-06-01,14,2,14,2,16
21305,PATACAMAYA,estado nutricional en menores de 5 anos,clasificacion a y b,2002-06-01,31,1,31,1,32
40602,PAZÃ‘A,estado nutricional en menores de 5 anos,clasificacion a y b,2002-06-01,2,1,2,1,3
20702,PELECHUCO,estado nutricional en menores de 5 anos,clasificacion a y b,2002-06-01,1,2,1,2,3
50403,POCOATA,estado nutricional en menores de 5 anos,clasificacion a y b,2002-06-01,16,20,16,20,36
31203,POCONA,estado nutricional en menores de 5 anos,clasificacion a y b,2002-06-01,10,6,10,6,16
31202,POJO (CBBA),estado nutricional en menores de 5 anos,clasificacion a y b,2002-06-01,54,22,54,22,76
40601,POOPO,estado nutricional en menores de 5 anos,clasificacion a y b,2002-06-01,1,0,1,0,1
51203,PORCO,estado nutricional en menores de 5 anos,clasificacion a y b,2002-06-01,11,10,11,10,21
10103,POROMA,estado nutricional en menores de 5 anos,clasificacion a y b,2002-06-01,40,13,40,13,53
70103,PORONGO,estado nutricional en menores de 5 anos,clasificacion a y b,2002-06-01,35,9,35,9,44
70601,PORTACHUELO,estado nutricional en menores de 5 anos,clasificacion a y b,2002-06-01,69,22,69,22,91
70804,POSTRER VALLE,estado nutricional en menores de 5 anos,clasificacion a y b,2002-06-01,7,8,7,8,15
50101,POTOSI,estado nutricional en menores de 5 anos,clasificacion a y b,2002-06-01,135,27,135,27,162
10302,PRESTO,estado nutricional en menores de 5 anos,clasificacion a y b,2002-06-01,10,5,10,5,15
21201,PUCARANI,estado nutricional en menores de 5 anos,clasificacion a y b,2002-06-01,3,17,3,17,20
20401,PUERTO ACOSTA,estado nutricional en menores de 5 anos,clasificacion a y b,2002-06-01,40,29,40,29,69
20403,PUERTO CARABUCO,estado nutricional en menores de 5 anos,clasificacion a y b,2002-06-01,17,7,17,7,24
90301,PUERTO GONZALO MORENO,estado nutricional en menores de 5 anos,clasificacion a y b,2002-06-01,1,0,1,0,1
21204,PUERTO PEREZ,estado nutricional en menores de 5 anos,clasificacion a y b,2002-06-01,3,6,3,6,9
71402,PUERTO QUIJARRO,estado nutricional en menores de 5 anos,clasificacion a y b,2002-06-01,59,6,59,6,65
90201,PUERTO RICO,estado nutricional en menores de 5 anos,clasificacion a y b,2002-06-01,8,7,8,7,15
71401,PUERTO SUAREZ,estado nutricional en menores de 5 anos,clasificacion a y b,2002-06-01,24,6,24,6,30
31205,PUERTO VILLARROEL,estado nutricional en menores de 5 anos,clasificacion a y b,2002-06-01,110,40,110,40,150
51101,PUNA,estado nutricional en menores de 5 anos,clasificacion a y b,2002-06-01,21,15,21,15,36
31401,PUNATA,estado nutricional en menores de 5 anos,clasificacion a y b,2002-06-01,16,6,16,6,22
20604,QUIABAYA,estado nutricional en menores de 5 anos,clasificacion a y b,2002-06-01,3,3,3,3,6
30901,QUILLACOLLO,estado nutricional en menores de 5 anos,clasificacion a y b,2002-06-01,25,11,25,11,36
21002,QUIME,estado nutricional en menores de 5 anos,clasificacion a y b,2002-06-01,10,36,10,36,46
70904,QUIRUSILLAS,estado nutricional en menores de 5 anos,clasificacion a y b,2002-06-01,1,1,1,1,2
50402,RAVELO,estado nutricional en menores de 5 anos,clasificacion a y b,2002-06-01,13,9,13,9,22
80301,REYES,estado nutricional en menores de 5 anos,clasificacion a y b,2002-06-01,32,5,32,5,37
80201,RIBERALTA,estado nutricional en menores de 5 anos,clasificacion a y b,2002-06-01,183,48,183,48,231
70503,ROBORE,estado nutricional en menores de 5 anos,clasificacion a y b,2002-06-01,64,18,64,18,82
80304,RURRENABAQUE,estado nutricional en menores de 5 anos,clasificacion a y b,2002-06-01,6,1,6,1,7
40901,SABAYA,estado nutricional en menores de 5 anos,clasificacion a y b,2002-06-01,1,1,1,1,2
31001,SACABA,estado nutricional en menores de 5 anos,clasificacion a y b,2002-06-01,49,4,49,4,53
30404,SACABAMBA,estado nutricional en menores de 5 anos,clasificacion a y b,2002-06-01,0,2,0,2,2
50701,SACACA,estado nutricional en menores de 5 anos,clasificacion a y b,2002-06-01,6,2,6,2,8
71302,SAIPINA,estado nutricional en menores de 5 anos,clasificacion a y b,2002-06-01,13,12,13,12,25
40801,SALINAS DE GARCI MENDOZA,estado nutricional en menores de 5 anos,clasificacion a y b,2002-06-01,4,2,4,2,6
70901,SAMAIPATA,estado nutricional en menores de 5 anos,clasificacion a y b,2002-06-01,11,4,11,4,15
51601,SAN AGUSTIN,estado nutricional en menores de 5 anos,clasificacion a y b,2002-06-01,4,0,4,0,4
80602,SAN ANDRES,estado nutricional en menores de 5 anos,clasificacion a y b,2002-06-01,21,10,21,10,31
51003,SAN ANTONIO DE ESMORUCO,estado nutricional en menores de 5 anos,clasificacion a y b,2002-06-01,1,0,1,0,1
71105,SAN ANTONIO DE LOMERIO,estado nutricional en menores de 5 anos,clasificacion a y b,2002-06-01,26,19,26,19,45
31403,SAN BENITO,estado nutricional en menores de 5 anos,clasificacion a y b,2002-06-01,1,5,1,5,6
80302,SAN BORJA,estado nutricional en menores de 5 anos,clasificacion a y b,2002-06-01,119,13,119,13,132
21502,SAN BUENA VENTURA,estado nutricional en menores de 5 anos,clasificacion a y b,2002-06-01,14,5,14,5,19
80501,SAN IGNACIO,estado nutricional en menores de 5 anos,clasificacion a y b,2002-06-01,27,48,27,48,75
70301,SAN IGNACIO DE VELASCO,estado nutricional en menores de 5 anos,clasificacion a y b,2002-06-01,200,16,200,16,216
80102,SAN JAVIER(BNI),estado nutricional en menores de 5 anos,clasificacion a y b,2002-06-01,14,14,14,14,28
71102,SAN JAVIER(STC),estado nutricional en menores de 5 anos,clasificacion a y b,2002-06-01,60,12,60,12,72
80701,SAN JOAQUIN,estado nutricional en menores de 5 anos,clasificacion a y b,2002-06-01,3,29,3,29,32
70501,SAN JOSE DE CHIQUITOS,estado nutricional en menores de 5 anos,clasificacion a y b,2002-06-01,14,4,14,4,18
71104,SAN JULIAN,estado nutricional en menores de 5 anos,clasificacion a y b,2002-06-01,93,78,93,78,171
90302,SAN LORENZO(PND),estado nutricional en menores de 5 anos,clasificacion a y b,2002-06-01,3,4,3,4,7
60501,SAN LORENZO(TJA),estado nutricional en menores de 5 anos,clasificacion a y b,2002-06-01,33,8,33,8,41
10702,SAN LUCAS,estado nutricional en menores de 5 anos,clasificacion a y b,2002-06-01,37,21,37,21,58
71201,SAN MATIAS,estado nutricional en menores de 5 anos,clasificacion a y b,2002-06-01,0,5,0,5,5
70302,SAN MIGUEL DE VELASCO,estado nutricional en menores de 5 anos,clasificacion a y b,2002-06-01,14,4,14,4,18
50501,SAN PEDRO DE BUENA VISTA,estado nutricional en menores de 5 anos,clasificacion a y b,2002-06-01,5,25,5,25,30
21801,SAN PEDRO DE CURAHUARA,estado nutricional en menores de 5 anos,clasificacion a y b,2002-06-01,2,7,2,7,9
50902,SAN PEDRO DE QUEMES,estado nutricional en menores de 5 anos,clasificacion a y b,2002-06-01,0,2,0,2,2
21702,SAN PEDRO DE TIQUINA,estado nutricional en menores de 5 anos,clasificacion a y b,2002-06-01,0,12,0,12,12
90202,SAN PEDRO(PND),estado nutricional en menores de 5 anos,clasificacion a y b,2002-06-01,0,2,0,2,2
70303,SAN RAFAEL,estado nutricional en menores de 5 anos,clasificacion a y b,2002-06-01,13,6,13,6,19
80702,SAN RAMON,estado nutricional en menores de 5 anos,clasificacion a y b,2002-06-01,50,82,50,82,132
80702,SAN RAMON,estado nutricional en menores de 5 anos,clasificacion a y b,2002-06-01,22,14,22,14,36
80401,SANTA ANA,estado nutricional en menores de 5 anos,clasificacion a y b,2002-06-01,13,8,13,8,21
70101,SANTA CRUZ DE LA SIERRA,estado nutricional en menores de 5 anos,clasificacion a y b,2002-06-01,1183,417,1183,417,1600
80303,SANTA ROSA,estado nutricional en menores de 5 anos,clasificacion a y b,2002-06-01,5,2,5,2,7
70602,SANTA ROSA DEL SARA,estado nutricional en menores de 5 anos,clasificacion a y b,2002-06-01,23,31,23,31,54
20308,SANTIAGO DE CALLAPA,estado nutricional en menores de 5 anos,clasificacion a y b,2002-06-01,2,0,2,0,2
41401,SANTIAGO DE HUARI,estado nutricional en menores de 5 anos,clasificacion a y b,2002-06-01,5,1,5,1,6
21901,SANTIAGO DE MACHACA,estado nutricional en menores de 5 anos,clasificacion a y b,2002-06-01,2,0,2,0,2
30702,SANTIVAÃ‘ES,estado nutricional en menores de 5 anos,clasificacion a y b,2002-06-01,1,0,1,0,1
40202,SANTUARIO DE QUILLACAS,estado nutricional en menores de 5 anos,clasificacion a y b,2002-06-01,2,1,2,1,3
20902,SAPAHAQUI,estado nutricional en menores de 5 anos,clasificacion a y b,2002-06-01,1,2,1,2,3
90303,SENA,estado nutricional en menores de 5 anos,clasificacion a y b,2002-06-01,16,6,16,6,22
21301,SICA SICA (VILLA AROMA),estado nutricional en menores de 5 anos,clasificacion a y b,2002-06-01,11,9,11,9,20
30703,SICAYA,estado nutricional en menores de 5 anos,clasificacion a y b,2002-06-01,0,3,0,3,3
30902,SIPE SIPE,estado nutricional en menores de 5 anos,clasificacion a y b,2002-06-01,143,33,143,33,176
10403,SOPACHUY,estado nutricional en menores de 5 anos,clasificacion a y b,2002-06-01,12,1,12,1,13
20601,SORATA,estado nutricional en menores de 5 anos,clasificacion a y b,2002-06-01,7,1,7,1,8
10101,SUCRE,estado nutricional en menores de 5 anos,clasificacion a y b,2002-06-01,304,88,304,88,392
31404,TACACHI,estado nutricional en menores de 5 anos,clasificacion a y b,2002-06-01,0,1,0,1,1
20603,TACACOMA,estado nutricional en menores de 5 anos,clasificacion a y b,2002-06-01,19,4,19,4,23
50303,TACOBAMBA,estado nutricional en menores de 5 anos,clasificacion a y b,2002-06-01,15,0,15,0,15
30602,TACOPAYA,estado nutricional en menores de 5 anos,clasificacion a y b,2002-06-01,9,8,9,8,17
51402,TAHUA,estado nutricional en menores de 5 anos,clasificacion a y b,2002-06-01,1,0,1,0,1
31101,TAPACARI,estado nutricional en menores de 5 anos,clasificacion a y b,2002-06-01,6,16,6,16,22
10601,TARABUCO,estado nutricional en menores de 5 anos,clasificacion a y b,2002-06-01,36,15,36,15,51
30401,TARATA,estado nutricional en menores de 5 anos,clasificacion a y b,2002-06-01,13,8,13,8,21
60101,TARIJA,estado nutricional en menores de 5 anos,clasificacion a y b,2002-06-01,376,132,376,132,508
10202,TARVITA,estado nutricional en menores de 5 anos,clasificacion a y b,2002-06-01,39,12,39,12,51
20803,TIAWANACU,estado nutricional en menores de 5 anos,clasificacion a y b,2002-06-01,24,12,24,12,36
50102,TINGUIPAYA,estado nutricional en menores de 5 anos,clasificacion a y b,2002-06-01,5,2,5,2,7
20606,TIPUANI,estado nutricional en menores de 5 anos,clasificacion a y b,2002-06-01,12,11,12,11,23
30903,TIQUIPAYA,estado nutricional en menores de 5 anos,clasificacion a y b,2002-06-01,20,22,20,22,42
31601,TIRAQUE (CBBA),estado nutricional en menores de 5 anos,clasificacion a y b,2002-06-01,58,34,58,34,92
21703,TITO YUPANQUI (PARQUIPUJIO),estado nutricional en menores de 5 anos,clasificacion a y b,2002-06-01,1,4,1,4,5
30802,TOCO,estado nutricional en menores de 5 anos,clasificacion a y b,2002-06-01,2,3,2,3,5
30803,TOLATA,estado nutricional en menores de 5 anos,clasificacion a y b,2002-06-01,3,0,3,0,3
41001,TOLEDO,estado nutricional en menores de 5 anos,clasificacion a y b,2002-06-01,3,2,3,2,5
51202,TOMAVE,estado nutricional en menores de 5 anos,clasificacion a y b,2002-06-01,3,15,3,15,18
10402,TOMINA,estado nutricional en menores de 5 anos,clasificacion a y b,2002-06-01,27,3,27,3,30
50502,TORO TORO,estado nutricional en menores de 5 anos,clasificacion a y b,2002-06-01,0,1,0,1,1
31201,TOTORA(CBBA),estado nutricional en menores de 5 anos,clasificacion a y b,2002-06-01,24,4,24,4,28
41301,TOTORA(ORR),estado nutricional en menores de 5 anos,clasificacion a y b,2002-06-01,5,2,5,2,7
70802,TRIGAL,estado nutricional en menores de 5 anos,clasificacion a y b,2002-06-01,1,1,1,1,2
80101,TRINIDAD,estado nutricional en menores de 5 anos,clasificacion a y b,2002-06-01,180,142,180,142,322
50801,TUPIZA,estado nutricional en menores de 5 anos,clasificacion a y b,2002-06-01,15,67,15,67,82
40402,TURCO,estado nutricional en menores de 5 anos,clasificacion a y b,2002-06-01,1,0,1,0,1
21302,UMALA,estado nutricional en menores de 5 anos,clasificacion a y b,2002-06-01,7,8,7,8,15
50201,UNCIA,estado nutricional en menores de 5 anos,clasificacion a y b,2002-06-01,21,22,21,22,43
60401,URIONDO (A. CONCEPCION),estado nutricional en menores de 5 anos,clasificacion a y b,2002-06-01,27,18,27,18,45
71502,URUBICHA,estado nutricional en menores de 5 anos,clasificacion a y b,2002-06-01,4,10,4,10,14
51201,UYUNI,estado nutricional en menores de 5 anos,clasificacion a y b,2002-06-01,30,38,30,38,68
70801,VALLEGRANDE,estado nutricional en menores de 5 anos,clasificacion a y b,2002-06-01,31,30,31,30,61
20801,VIACHA,estado nutricional en menores de 5 anos,clasificacion a y b,2002-06-01,22,44,22,44,66
31302,VILA VILA,estado nutricional en menores de 5 anos,clasificacion a y b,2002-06-01,5,0,5,0,5
60303,VILLA MONTES,estado nutricional en menores de 5 anos,clasificacion a y b,2002-06-01,34,15,34,15,49
90502,VILLA NUEVA (LOMA ALTA),estado nutricional en menores de 5 anos,clasificacion a y b,2002-06-01,1,0,1,0,1
31402,VILLA RIVERO,estado nutricional en menores de 5 anos,clasificacion a y b,2002-06-01,5,5,5,5,10
10801,VILLA SERRANO,estado nutricional en menores de 5 anos,clasificacion a y b,2002-06-01,16,27,16,27,43
31003,VILLA TUNARI,estado nutricional en menores de 5 anos,clasificacion a y b,2002-06-01,87,21,87,21,108
11001,VILLA VACA GUZMAN (MUYUPAMPA),estado nutricional en menores de 5 anos,clasificacion a y b,2002-06-01,52,29,52,29,81
51501,VILLAZON,estado nutricional en menores de 5 anos,clasificacion a y b,2002-06-01,26,76,26,76,102
30904,VINTO,estado nutricional en menores de 5 anos,clasificacion a y b,2002-06-01,65,4,65,4,69
50602,VITICHI,estado nutricional en menores de 5 anos,clasificacion a y b,2002-06-01,17,5,17,5,22
70201,WARNES,estado nutricional en menores de 5 anos,clasificacion a y b,2002-06-01,108,49,108,49,157
20903,YACO,estado nutricional en menores de 5 anos,clasificacion a y b,2002-06-01,6,12,6,12,18
60301,YACUIBA,estado nutricional en menores de 5 anos,clasificacion a y b,2002-06-01,174,37,174,37,211
10602,YAMPARAEZ,estado nutricional en menores de 5 anos,clasificacion a y b,2002-06-01,33,6,33,6,39
21103,YANACACHI,estado nutricional en menores de 5 anos,clasificacion a y b,2002-06-01,4,5,4,5,9
50103,YOCALLA,estado nutricional en menores de 5 anos,clasificacion a y b,2002-06-01,1,9,1,9,10
10102,YOTALA,estado nutricional en menores de 5 anos,clasificacion a y b,2002-06-01,34,12,34,12,46
60402,YUNCHARA,estado nutricional en menores de 5 anos,clasificacion a y b,2002-06-01,11,5,11,5,16
10301,ZUDAÃ‘EZ,estado nutricional en menores de 5 anos,clasificacion a y b,2002-06-01,16,1,16,1,17
51302,ACACIO,estado nutricional en menores de 5 anos,clasificacion a y b,2002-07-01,2,1,2,1,3
20201,ACHACACHI,estado nutricional en menores de 5 anos,clasificacion a y b,2002-07-01,83,41,83,41,124
20104,ACHOCALLA,estado nutricional en menores de 5 anos,clasificacion a y b,2002-07-01,14,2,14,2,16
30201,AIQUILE,estado nutricional en menores de 5 anos,clasificacion a y b,2002-07-01,10,6,10,6,16
10404,ALCALA,estado nutricional en menores de 5 anos,clasificacion a y b,2002-07-01,14,4,14,4,18
20202,ANCORAIMES,estado nutricional en menores de 5 anos,clasificacion a y b,2002-07-01,16,3,16,3,19
41201,ANDAMARCA,estado nutricional en menores de 5 anos,clasificacion a y b,2002-07-01,1,0,1,0,1
40603,ANTEQUERA,estado nutricional en menores de 5 anos,clasificacion a y b,2002-07-01,0,3,0,3,3
30402,ANZALDO,estado nutricional en menores de 5 anos,clasificacion a y b,2002-07-01,5,12,5,12,17
20701,APOLO,estado nutricional en menores de 5 anos,clasificacion a y b,2002-07-01,31,2,31,2,33
51301,ARAMPAMPA,estado nutricional en menores de 5 anos,clasificacion a y b,2002-07-01,4,6,4,6,10
30501,ARANI,estado nutricional en menores de 5 anos,clasificacion a y b,2002-07-01,2,6,2,6,8
30403,ARBIETO,estado nutricional en menores de 5 anos,clasificacion a y b,2002-07-01,8,4,8,4,12
30601,ARQUE,estado nutricional en menores de 5 anos,clasificacion a y b,2002-07-01,5,3,5,3,8
71501,ASCENCION DE GUARAYOS,estado nutricional en menores de 5 anos,clasificacion a y b,2002-07-01,2,0,2,0,2
50802,ATOCHA,estado nutricional en menores de 5 anos,clasificacion a y b,2002-07-01,3,21,3,21,24
20503,AUCAPATA,estado nutricional en menores de 5 anos,clasificacion a y b,2002-07-01,2,0,2,0,2
20502,AYATA,estado nutricional en menores de 5 anos,clasificacion a y b,2002-07-01,3,0,3,0,3
21303,AYO AYO,estado nutricional en menores de 5 anos,clasificacion a y b,2002-07-01,18,2,18,2,20
30301,AYOPAYA (V. DE INDEPENDENCIA),estado nutricional en menores de 5 anos,clasificacion a y b,2002-07-01,11,4,11,4,15
10201,AZURDUY,estado nutricional en menores de 5 anos,clasificacion a y b,2002-07-01,26,4,26,4,30
21203,BATALLAS,estado nutricional en menores de 5 anos,clasificacion a y b,2002-07-01,36,12,36,12,48
80802,BAURES,estado nutricional en menores de 5 anos,clasificacion a y b,2002-07-01,23,16,23,16,39
50104,BELEN DE URMIRI,estado nutricional en menores de 5 anos,clasificacion a y b,2002-07-01,5,4,5,4,9
90104,BELLA FLOR,estado nutricional en menores de 5 anos,clasificacion a y b,2002-07-01,4,1,4,1,5
60202,BERMEJO,estado nutricional en menores de 5 anos,clasificacion a y b,2002-07-01,19,51,19,51,70
50301,BETANZOS,estado nutricional en menores de 5 anos,clasificacion a y b,2002-07-01,67,25,67,25,92
31501,BOLIVAR,estado nutricional en menores de 5 anos,clasificacion a y b,2002-07-01,8,8,8,8,16
70707,BOYUIBE,estado nutricional en menores de 5 anos,clasificacion a y b,2002-07-01,5,30,5,30,35
70703,CABEZAS,estado nutricional en menores de 5 anos,clasificacion a y b,2002-07-01,54,42,54,42,96
20905,CAIROMA,estado nutricional en menores de 5 anos,clasificacion a y b,2002-07-01,4,8,4,8,12
51102,"CAIZA ""D""",estado nutricional en menores de 5 anos,clasificacion a y b,2002-07-01,22,3,22,3,25
21003,CAJUATA,estado nutricional en menores de 5 anos,clasificacion a y b,2002-07-01,17,4,17,4,21
20303,CALACOTO,estado nutricional en menores de 5 anos,clasificacion a y b,2002-07-01,2,0,2,0,2
21304,CALAMARCA,estado nutricional en menores de 5 anos,clasificacion a y b,2002-07-01,14,2,14,2,16
10701,CAMARGO,estado nutricional en menores de 5 anos,clasificacion a y b,2002-07-01,32,20,32,20,52
10901,CAMATAQUI (C. VILLA ABECIA),estado nutricional en menores de 5 anos,clasificacion a y b,2002-07-01,16,5,16,5,21
70706,CAMIRI,estado nutricional en menores de 5 anos,clasificacion a y b,2002-07-01,56,29,56,29,85
30701,CAPINOTA,estado nutricional en menores de 5 anos,clasificacion a y b,2002-07-01,6,1,6,1,7
20302,CAQUIAVIRI,estado nutricional en menores de 5 anos,clasificacion a y b,2002-07-01,13,7,13,7,20
40102,CARACOLLO,estado nutricional en menores de 5 anos,clasificacion a y b,2002-07-01,21,6,21,6,27
22001,CARANAVI,estado nutricional en menores de 5 anos,clasificacion a y b,2002-07-01,143,40,143,40,183
60302,CARAPARI,estado nutricional en menores de 5 anos,clasificacion a y b,2002-07-01,18,24,18,24,42
50702,CARIPUYO,estado nutricional en menores de 5 anos,clasificacion a y b,2002-07-01,7,1,7,1,8
21803,CHACARILLA,estado nutricional en menores de 5 anos,clasificacion a y b,2002-07-01,4,1,4,1,5
40201,CHALLAPATA,estado nutricional en menores de 5 anos,clasificacion a y b,2002-07-01,11,7,11,7,18
50302,CHAQUI,estado nutricional en menores de 5 anos,clasificacion a y b,2002-07-01,18,0,18,0,18
70702,CHARAGUA,estado nutricional en menores de 5 anos,clasificacion a y b,2002-07-01,42,98,42,98,140
20305,CHARAÃ‘A,estado nutricional en menores de 5 anos,clasificacion a y b,2002-07-01,1,1,1,1,2
50202,CHAYANTA,estado nutricional en menores de 5 anos,clasificacion a y b,2002-07-01,8,6,8,6,14
31204,CHIMORE,estado nutricional en menores de 5 anos,clasificacion a y b,2002-07-01,26,4,26,4,30
40903,CHIPAYA,estado nutricional en menores de 5 anos,clasificacion a y b,2002-07-01,1,1,1,1,2
21101,CHULUMANI (V. DE LA LIBERTAD),estado nutricional en menores de 5 anos,clasificacion a y b,2002-07-01,4,9,4,9,13
20501,CHUMA,estado nutricional en menores de 5 anos,clasificacion a y b,2002-07-01,9,8,9,8,17
30801,CLIZA,estado nutricional en menores de 5 anos,clasificacion a y b,2002-07-01,8,17,8,17,25
90101,COBIJA,estado nutricional en menores de 5 anos,clasificacion a y b,2002-07-01,116,20,116,20,136
30101,COCHABAMBA,estado nutricional en menores de 5 anos,clasificacion a y b,2002-07-01,1469,1135,1469,1135,2604
40902,COIPASA,estado nutricional en menores de 5 anos,clasificacion a y b,2002-07-01,1,0,1,0,1
30905,COLCAPIRHUA,estado nutricional en menores de 5 anos,clasificacion a y b,2002-07-01,29,36,29,36,65
50901,"COLCHA ""K""",estado nutricional en menores de 5 anos,clasificacion a y b,2002-07-01,18,4,18,4,22
21307,COLLANA,estado nutricional en menores de 5 anos,clasificacion a y b,2002-07-01,3,0,3,0,3
31002,COLOMI,estado nutricional en menores de 5 anos,clasificacion a y b,2002-07-01,23,25,23,25,48
50401,COLQUECHACA,estado nutricional en menores de 5 anos,clasificacion a y b,2002-07-01,13,1,13,1,14
21306,COLQUENCHA,estado nutricional en menores de 5 anos,clasificacion a y b,2002-07-01,13,6,13,6,19
21004,COLQUIRI,estado nutricional en menores de 5 anos,clasificacion a y b,2002-07-01,14,3,14,3,17
20304,COMANCHE,estado nutricional en menores de 5 anos,clasificacion a y b,2002-07-01,1,0,1,0,1
71301,COMARAPA,estado nutricional en menores de 5 anos,clasificacion a y b,2002-07-01,87,49,87,49,136
20605,COMBAYA,estado nutricional en menores de 5 anos,clasificacion a y b,2002-07-01,2,1,2,1,3
71101,CONCEPCION,estado nutricional en menores de 5 anos,clasificacion a y b,2002-07-01,21,4,21,4,25
21701,COPACABANA,estado nutricional en menores de 5 anos,clasificacion a y b,2002-07-01,17,5,17,5,22
21402,CORIPATA,estado nutricional en menores de 5 anos,clasificacion a y b,2002-07-01,13,31,13,31,44
20301,CORO CORO,estado nutricional en menores de 5 anos,clasificacion a y b,2002-07-01,16,4,16,4,20
21401,COROICO,estado nutricional en menores de 5 anos,clasificacion a y b,2002-07-01,50,6,50,6,56
40301,CORQUE,estado nutricional en menores de 5 anos,clasificacion a y b,2002-07-01,3,1,3,1,4
50601,COTAGAITA,estado nutricional en menores de 5 anos,clasificacion a y b,2002-07-01,27,17,27,17,44
70102,COTOCA,estado nutricional en menores de 5 anos,clasificacion a y b,2002-07-01,70,13,70,13,83
31405,CUCHUMUELA (V. G. VILLARROEL),estado nutricional en menores de 5 anos,clasificacion a y b,2002-07-01,1,0,1,0,1
70704,CUEVO,estado nutricional en menores de 5 anos,clasificacion a y b,2002-07-01,17,3,17,3,20
10902,CULPINA,estado nutricional en menores de 5 anos,clasificacion a y b,2002-07-01,35,9,35,9,44
40401,CURAHUARA DE CARANGAS,estado nutricional en menores de 5 anos,clasificacion a y b,2002-07-01,2,2,2,2,4
21602,CURVA,estado nutricional en menores de 5 anos,clasificacion a y b,2002-07-01,2,0,2,0,2
20804,DESAGUADERO,estado nutricional en menores de 5 anos,clasificacion a y b,2002-07-01,8,2,8,2,10
20105,EL ALTO,estado nutricional en menores de 5 anos,clasificacion a y b,2002-07-01,649,243,649,243,892
40103,EL CHORO,estado nutricional en menores de 5 anos,clasificacion a y b,2002-07-01,3,0,3,0,3
71503,EL PUENTE(STC),estado nutricional en menores de 5 anos,clasificacion a y b,2002-07-01,8,32,8,32,40
60502,EL PUENTE(TJA),estado nutricional en menores de 5 anos,clasificacion a y b,2002-07-01,4,6,4,6,10
70105,EL TORNO,estado nutricional en menores de 5 anos,clasificacion a y b,2002-07-01,175,68,175,68,243
10405,EL VILLAR,estado nutricional en menores de 5 anos,clasificacion a y b,2002-07-01,17,6,17,6,23
60601,ENTRE RIOS,estado nutricional en menores de 5 anos,clasificacion a y b,2002-07-01,34,13,34,13,47
41101,EUCALIPTUS,estado nutricional en menores de 5 anos,clasificacion a y b,2002-07-01,3,4,3,4,7
80402,EXALTACION,estado nutricional en menores de 5 anos,clasificacion a y b,2002-07-01,2,2,2,2,4
90203,FILADELFIA,estado nutricional en menores de 5 anos,clasificacion a y b,2002-07-01,0,5,0,5,5
71002,GENERAL SAAVEDRA,estado nutricional en menores de 5 anos,clasificacion a y b,2002-07-01,53,36,53,36,89
21601,GRAL. J.J. PEREZ (CHARAZANI),estado nutricional en menores de 5 anos,clasificacion a y b,2002-07-01,0,4,0,4,4
20602,GUANAY,estado nutricional en menores de 5 anos,clasificacion a y b,2002-07-01,150,44,150,44,194
20802,GUAQUI,estado nutricional en menores de 5 anos,clasificacion a y b,2002-07-01,16,3,16,3,19
80202,GUAYARAMERIN,estado nutricional en menores de 5 anos,clasificacion a y b,2002-07-01,75,17,75,17,92
70705,GUTIERREZ,estado nutricional en menores de 5 anos,clasificacion a y b,2002-07-01,47,23,47,23,70
10502,HUACARETA,estado nutricional en menores de 5 anos,clasificacion a y b,2002-07-01,24,27,24,27,51
11002,HUACAYA (VILLA DE HUACAYA),estado nutricional en menores de 5 anos,clasificacion a y b,2002-07-01,4,4,4,4,8
40501,HUACHACALLA,estado nutricional en menores de 5 anos,clasificacion a y b,2002-07-01,1,2,1,2,3
40701,HUANUNI,estado nutricional en menores de 5 anos,clasificacion a y b,2002-07-01,31,8,31,8,39
80803,HUARACAJE,estado nutricional en menores de 5 anos,clasificacion a y b,2002-07-01,21,10,21,10,31
41601,HUAYLLAMARCA,estado nutricional en menores de 5 anos,clasificacion a y b,2002-07-01,3,1,3,1,4
10304,ICLA,estado nutricional en menores de 5 anos,clasificacion a y b,2002-07-01,9,3,9,3,12
10703,INCAHUASI,estado nutricional en menores de 5 anos,clasificacion a y b,2002-07-01,30,5,30,5,35
90402,INGAVI (HUMAITA),estado nutricional en menores de 5 anos,clasificacion a y b,2002-07-01,0,13,0,13,13
21001,INQUISIVI,estado nutricional en menores de 5 anos,clasificacion a y b,2002-07-01,26,6,26,6,32
21102,IRUPANA (VILLA DE LANZA),estado nutricional en menores de 5 anos,clasificacion a y b,2002-07-01,25,47,25,47,72
21501,IXIAMAS,estado nutricional en menores de 5 anos,clasificacion a y b,2002-07-01,18,7,18,7,25
21105,LA ASUNTA,estado nutricional en menores de 5 anos,clasificacion a y b,2002-07-01,26,24,26,24,50
70104,LA GUARDIA,estado nutricional en menores de 5 anos,clasificacion a y b,2002-07-01,188,52,188,52,240
20101,LA PAZ,estado nutricional en menores de 5 anos,clasificacion a y b,2002-07-01,662,230,662,230,892
70701,LAGUNILLAS,estado nutricional en menores de 5 anos,clasificacion a y b,2002-07-01,32,18,32,18,50
21202,LAJA,estado nutricional en menores de 5 anos,clasificacion a y b,2002-07-01,21,7,21,7,28
10903,LAS CARRERAS,estado nutricional en menores de 5 anos,clasificacion a y b,2002-07-01,10,1,10,1,11
21006,LICOMA PAMPA,estado nutricional en menores de 5 anos,clasificacion a y b,2002-07-01,2,2,2,2,4
50203,LLALLAGUA,estado nutricional en menores de 5 anos,clasificacion a y b,2002-07-01,14,97,14,97,111
51401,LLICA,estado nutricional en menores de 5 anos,clasificacion a y b,2002-07-01,5,2,5,2,7
80601,LORETO,estado nutricional en menores de 5 anos,clasificacion a y b,2002-07-01,7,3,7,3,10
20901,LURIBAY,estado nutricional en menores de 5 anos,clasificacion a y b,2002-07-01,5,9,5,9,14
40702,MACHACAMARCA,estado nutricional en menores de 5 anos,clasificacion a y b,2002-07-01,6,2,6,2,8
11003,MACHARETI,estado nutricional en menores de 5 anos,clasificacion a y b,2002-07-01,49,40,49,40,89
80801,MAGDALENA,estado nutricional en menores de 5 anos,clasificacion a y b,2002-07-01,17,5,17,5,22
70903,MAIRANA,estado nutricional en menores de 5 anos,clasificacion a y b,2002-07-01,52,4,52,4,56
20103,MECAPACA,estado nutricional en menores de 5 anos,clasificacion a y b,2002-07-01,3,2,3,2,5
71003,MINEROS,estado nutricional en menores de 5 anos,clasificacion a y b,2002-07-01,123,64,123,64,187
31301,MIZQUE,estado nutricional en menores de 5 anos,clasificacion a y b,2002-07-01,18,7,18,7,25
20402,MOCOMOCO,estado nutricional en menores de 5 anos,clasificacion a y b,2002-07-01,26,6,26,6,32
10303,MOJOCOYA,estado nutricional en menores de 5 anos,clasificacion a y b,2002-07-01,37,6,37,6,43
10501,MONTEAGUDO,estado nutricional en menores de 5 anos,clasificacion a y b,2002-07-01,146,35,146,35,181
71001,MONTERO,estado nutricional en menores de 5 anos,clasificacion a y b,2002-07-01,258,160,258,160,418
70803,MORO MORO,estado nutricional en menores de 5 anos,clasificacion a y b,2002-07-01,2,2,2,2,4
30302,MOROCHATA,estado nutricional en menores de 5 anos,clasificacion a y b,2002-07-01,27,7,27,7,34
90501,NUEVO MANOA (NUEVA ESPERANZA),estado nutricional en menores de 5 anos,clasificacion a y b,2002-07-01,4,3,4,3,7
50404,OCURI,estado nutricional en menores de 5 anos,clasificacion a y b,2002-07-01,18,8,18,8,26
70202,OKINAWA,estado nutricional en menores de 5 anos,clasificacion a y b,2002-07-01,6,2,6,2,8
30203,OMEREQUE,estado nutricional en menores de 5 anos,clasificacion a y b,2002-07-01,0,7,0,7,7
40101,ORURO,estado nutricional en menores de 5 anos,clasificacion a y b,2002-07-01,263,71,263,71,334
60201,PADCAYA,estado nutricional en menores de 5 anos,clasificacion a y b,2002-07-01,36,29,36,29,65
10401,PADILLA,estado nutricional en menores de 5 anos,clasificacion a y b,2002-07-01,46,5,46,5,51
70502,PAILON,estado nutricional en menores de 5 anos,clasificacion a y b,2002-07-01,30,7,30,7,37
20102,PALCA,estado nutricional en menores de 5 anos,clasificacion a y b,2002-07-01,19,5,19,5,24
21104,PALOS BLANCOS,estado nutricional en menores de 5 anos,clasificacion a y b,2002-07-01,58,22,58,22,80
40802,PAMPA AULLAGAS,estado nutricional en menores de 5 anos,clasificacion a y b,2002-07-01,2,0,2,0,2
70902,PAMPA GRANDE,estado nutricional en menores de 5 anos,clasificacion a y b,2002-07-01,30,1,30,1,31
21802,PAPEL PAMPA,estado nutricional en menores de 5 anos,clasificacion a y b,2002-07-01,5,0,5,0,5
30202,PASORAPA,estado nutricional en menores de 5 anos,clasificacion a y b,2002-07-01,11,1,11,1,12
21305,PATACAMAYA,estado nutricional en menores de 5 anos,clasificacion a y b,2002-07-01,37,12,37,12,49
40602,PAZÃ‘A,estado nutricional en menores de 5 anos,clasificacion a y b,2002-07-01,5,2,5,2,7
20702,PELECHUCO,estado nutricional en menores de 5 anos,clasificacion a y b,2002-07-01,0,2,0,2,2
50403,POCOATA,estado nutricional en menores de 5 anos,clasificacion a y b,2002-07-01,22,10,22,10,32
31203,POCONA,estado nutricional en menores de 5 anos,clasificacion a y b,2002-07-01,9,2,9,2,11
31202,POJO (CBBA),estado nutricional en menores de 5 anos,clasificacion a y b,2002-07-01,119,16,119,16,135
40601,POOPO,estado nutricional en menores de 5 anos,clasificacion a y b,2002-07-01,0,2,0,2,2
51203,PORCO,estado nutricional en menores de 5 anos,clasificacion a y b,2002-07-01,19,1,19,1,20
10103,POROMA,estado nutricional en menores de 5 anos,clasificacion a y b,2002-07-01,46,4,46,4,50
70103,PORONGO,estado nutricional en menores de 5 anos,clasificacion a y b,2002-07-01,18,11,18,11,29
70601,PORTACHUELO,estado nutricional en menores de 5 anos,clasificacion a y b,2002-07-01,78,20,78,20,98
70804,POSTRER VALLE,estado nutricional en menores de 5 anos,clasificacion a y b,2002-07-01,7,1,7,1,8
50101,POTOSI,estado nutricional en menores de 5 anos,clasificacion a y b,2002-07-01,165,22,165,22,187
10302,PRESTO,estado nutricional en menores de 5 anos,clasificacion a y b,2002-07-01,19,6,19,6,25
21201,PUCARANI,estado nutricional en menores de 5 anos,clasificacion a y b,2002-07-01,12,7,12,7,19
20401,PUERTO ACOSTA,estado nutricional en menores de 5 anos,clasificacion a y b,2002-07-01,52,29,52,29,81
20403,PUERTO CARABUCO,estado nutricional en menores de 5 anos,clasificacion a y b,2002-07-01,13,5,13,5,18
90301,PUERTO GONZALO MORENO,estado nutricional en menores de 5 anos,clasificacion a y b,2002-07-01,4,1,4,1,5
21204,PUERTO PEREZ,estado nutricional en menores de 5 anos,clasificacion a y b,2002-07-01,6,1,6,1,7
71402,PUERTO QUIJARRO,estado nutricional en menores de 5 anos,clasificacion a y b,2002-07-01,58,9,58,9,67
90201,PUERTO RICO,estado nutricional en menores de 5 anos,clasificacion a y b,2002-07-01,8,5,8,5,13
80703,PUERTO SILES,estado nutricional en menores de 5 anos,clasificacion a y b,2002-07-01,2,7,2,7,9
71401,PUERTO SUAREZ,estado nutricional en menores de 5 anos,clasificacion a y b,2002-07-01,52,12,52,12,64
31205,PUERTO VILLARROEL,estado nutricional en menores de 5 anos,clasificacion a y b,2002-07-01,164,48,164,48,212
51101,PUNA,estado nutricional en menores de 5 anos,clasificacion a y b,2002-07-01,34,45,34,45,79
31401,PUNATA,estado nutricional en menores de 5 anos,clasificacion a y b,2002-07-01,10,5,10,5,15
20604,QUIABAYA,estado nutricional en menores de 5 anos,clasificacion a y b,2002-07-01,4,2,4,2,6
30901,QUILLACOLLO,estado nutricional en menores de 5 anos,clasificacion a y b,2002-07-01,51,18,51,18,69
21002,QUIME,estado nutricional en menores de 5 anos,clasificacion a y b,2002-07-01,14,9,14,9,23
70904,QUIRUSILLAS,estado nutricional en menores de 5 anos,clasificacion a y b,2002-07-01,4,5,4,5,9
50402,RAVELO,estado nutricional en menores de 5 anos,clasificacion a y b,2002-07-01,7,1,7,1,8
80201,RIBERALTA,estado nutricional en menores de 5 anos,clasificacion a y b,2002-07-01,190,35,190,35,225
70503,ROBORE,estado nutricional en menores de 5 anos,clasificacion a y b,2002-07-01,93,33,93,33,126
80304,RURRENABAQUE,estado nutricional en menores de 5 anos,clasificacion a y b,2002-07-01,1,4,1,4,5
40901,SABAYA,estado nutricional en menores de 5 anos,clasificacion a y b,2002-07-01,2,1,2,1,3
31001,SACABA,estado nutricional en menores de 5 anos,clasificacion a y b,2002-07-01,57,18,57,18,75
30404,SACABAMBA,estado nutricional en menores de 5 anos,clasificacion a y b,2002-07-01,2,4,2,4,6
50701,SACACA,estado nutricional en menores de 5 anos,clasificacion a y b,2002-07-01,7,1,7,1,8
71302,SAIPINA,estado nutricional en menores de 5 anos,clasificacion a y b,2002-07-01,19,8,19,8,27
40801,SALINAS DE GARCI MENDOZA,estado nutricional en menores de 5 anos,clasificacion a y b,2002-07-01,1,7,1,7,8
70901,SAMAIPATA,estado nutricional en menores de 5 anos,clasificacion a y b,2002-07-01,27,4,27,4,31
51601,SAN AGUSTIN,estado nutricional en menores de 5 anos,clasificacion a y b,2002-07-01,3,2,3,2,5
80602,SAN ANDRES,estado nutricional en menores de 5 anos,clasificacion a y b,2002-07-01,21,3,21,3,24
71105,SAN ANTONIO DE LOMERIO,estado nutricional en menores de 5 anos,clasificacion a y b,2002-07-01,25,9,25,9,34
31403,SAN BENITO,estado nutricional en menores de 5 anos,clasificacion a y b,2002-07-01,9,2,9,2,11
80302,SAN BORJA,estado nutricional en menores de 5 anos,clasificacion a y b,2002-07-01,87,18,87,18,105
21502,SAN BUENA VENTURA,estado nutricional en menores de 5 anos,clasificacion a y b,2002-07-01,17,4,17,4,21
80501,SAN IGNACIO,estado nutricional en menores de 5 anos,clasificacion a y b,2002-07-01,20,40,20,40,60
70301,SAN IGNACIO DE VELASCO,estado nutricional en menores de 5 anos,clasificacion a y b,2002-07-01,205,14,205,14,219
80102,SAN JAVIER(BNI),estado nutricional en menores de 5 anos,clasificacion a y b,2002-07-01,22,6,22,6,28
71102,SAN JAVIER(STC),estado nutricional en menores de 5 anos,clasificacion a y b,2002-07-01,73,4,73,4,77
80701,SAN JOAQUIN,estado nutricional en menores de 5 anos,clasificacion a y b,2002-07-01,13,17,13,17,30
70501,SAN JOSE DE CHIQUITOS,estado nutricional en menores de 5 anos,clasificacion a y b,2002-07-01,28,2,28,2,30
71104,SAN JULIAN,estado nutricional en menores de 5 anos,clasificacion a y b,2002-07-01,112,61,112,61,173
90302,SAN LORENZO(PND),estado nutricional en menores de 5 anos,clasificacion a y b,2002-07-01,6,7,6,7,13
60501,SAN LORENZO(TJA),estado nutricional en menores de 5 anos,clasificacion a y b,2002-07-01,38,19,38,19,57
10702,SAN LUCAS,estado nutricional en menores de 5 anos,clasificacion a y b,2002-07-01,57,24,57,24,81
71201,SAN MATIAS,estado nutricional en menores de 5 anos,clasificacion a y b,2002-07-01,1,8,1,8,9
70302,SAN MIGUEL DE VELASCO,estado nutricional en menores de 5 anos,clasificacion a y b,2002-07-01,22,17,22,17,39
51001,SAN PABLO DE LIPEZ,estado nutricional en menores de 5 anos,clasificacion a y b,2002-07-01,0,3,0,3,3
50501,SAN PEDRO DE BUENA VISTA,estado nutricional en menores de 5 anos,clasificacion a y b,2002-07-01,1,19,1,19,20
21801,SAN PEDRO DE CURAHUARA,estado nutricional en menores de 5 anos,clasificacion a y b,2002-07-01,3,2,3,2,5
50902,SAN PEDRO DE QUEMES,estado nutricional en menores de 5 anos,clasificacion a y b,2002-07-01,1,0,1,0,1
21702,SAN PEDRO DE TIQUINA,estado nutricional en menores de 5 anos,clasificacion a y b,2002-07-01,4,12,4,12,16
70303,SAN RAFAEL,estado nutricional en menores de 5 anos,clasificacion a y b,2002-07-01,15,7,15,7,22
80702,SAN RAMON,estado nutricional en menores de 5 anos,clasificacion a y b,2002-07-01,26,8,26,8,34
80401,SANTA ANA,estado nutricional en menores de 5 anos,clasificacion a y b,2002-07-01,43,41,43,41,84
70101,SANTA CRUZ DE LA SIERRA,estado nutricional en menores de 5 anos,clasificacion a y b,2002-07-01,1494,601,1494,601,2095
80303,SANTA ROSA,estado nutricional en menores de 5 anos,clasificacion a y b,2002-07-01,6,3,6,3,9
70602,SANTA ROSA DEL SARA,estado nutricional en menores de 5 anos,clasificacion a y b,2002-07-01,16,23,16,23,39
41401,SANTIAGO DE HUARI,estado nutricional en menores de 5 anos,clasificacion a y b,2002-07-01,1,4,1,4,5
21901,SANTIAGO DE MACHACA,estado nutricional en menores de 5 anos,clasificacion a y b,2002-07-01,6,1,6,1,7
30702,SANTIVAÃ‘ES,estado nutricional en menores de 5 anos,clasificacion a y b,2002-07-01,4,0,4,0,4
40202,SANTUARIO DE QUILLACAS,estado nutricional en menores de 5 anos,clasificacion a y b,2002-07-01,1,2,1,2,3
20902,SAPAHAQUI,estado nutricional en menores de 5 anos,clasificacion a y b,2002-07-01,1,3,1,3,4
21301,SICA SICA (VILLA AROMA),estado nutricional en menores de 5 anos,clasificacion a y b,2002-07-01,25,1,25,1,26
30703,SICAYA,estado nutricional en menores de 5 anos,clasificacion a y b,2002-07-01,6,0,6,0,6
30902,SIPE SIPE,estado nutricional en menores de 5 anos,clasificacion a y b,2002-07-01,137,32,137,32,169
10403,SOPACHUY,estado nutricional en menores de 5 anos,clasificacion a y b,2002-07-01,17,1,17,1,18
20601,SORATA,estado nutricional en menores de 5 anos,clasificacion a y b,2002-07-01,20,11,20,11,31
10101,SUCRE,estado nutricional en menores de 5 anos,clasificacion a y b,2002-07-01,394,77,394,77,471
20603,TACACOMA,estado nutricional en menores de 5 anos,clasificacion a y b,2002-07-01,3,12,3,12,15
50303,TACOBAMBA,estado nutricional en menores de 5 anos,clasificacion a y b,2002-07-01,13,0,13,0,13
30602,TACOPAYA,estado nutricional en menores de 5 anos,clasificacion a y b,2002-07-01,7,0,7,0,7
31101,TAPACARI,estado nutricional en menores de 5 anos,clasificacion a y b,2002-07-01,2,13,2,13,15
10601,TARABUCO,estado nutricional en menores de 5 anos,clasificacion a y b,2002-07-01,32,11,32,11,43
30401,TARATA,estado nutricional en menores de 5 anos,clasificacion a y b,2002-07-01,18,7,18,7,25
60101,TARIJA,estado nutricional en menores de 5 anos,clasificacion a y b,2002-07-01,337,202,337,202,539
10202,TARVITA,estado nutricional en menores de 5 anos,clasificacion a y b,2002-07-01,26,7,26,7,33
20803,TIAWANACU,estado nutricional en menores de 5 anos,clasificacion a y b,2002-07-01,18,9,18,9,27
50102,TINGUIPAYA,estado nutricional en menores de 5 anos,clasificacion a y b,2002-07-01,1,2,1,2,3
20606,TIPUANI,estado nutricional en menores de 5 anos,clasificacion a y b,2002-07-01,35,9,35,9,44
30903,TIQUIPAYA,estado nutricional en menores de 5 anos,clasificacion a y b,2002-07-01,3,15,3,15,18
31601,TIRAQUE (CBBA),estado nutricional en menores de 5 anos,clasificacion a y b,2002-07-01,62,35,62,35,97
30802,TOCO,estado nutricional en menores de 5 anos,clasificacion a y b,2002-07-01,0,4,0,4,4
30803,TOLATA,estado nutricional en menores de 5 anos,clasificacion a y b,2002-07-01,0,1,0,1,1
41001,TOLEDO,estado nutricional en menores de 5 anos,clasificacion a y b,2002-07-01,8,2,8,2,10
51202,TOMAVE,estado nutricional en menores de 5 anos,clasificacion a y b,2002-07-01,13,9,13,9,22
10402,TOMINA,estado nutricional en menores de 5 anos,clasificacion a y b,2002-07-01,29,7,29,7,36
50502,TORO TORO,estado nutricional en menores de 5 anos,clasificacion a y b,2002-07-01,4,1,4,1,5
31201,TOTORA(CBBA),estado nutricional en menores de 5 anos,clasificacion a y b,2002-07-01,14,7,14,7,21
41301,TOTORA(ORR),estado nutricional en menores de 5 anos,clasificacion a y b,2002-07-01,2,0,2,0,2
70802,TRIGAL,estado nutricional en menores de 5 anos,clasificacion a y b,2002-07-01,3,4,3,4,7
80101,TRINIDAD,estado nutricional en menores de 5 anos,clasificacion a y b,2002-07-01,291,187,291,187,478
50801,TUPIZA,estado nutricional en menores de 5 anos,clasificacion a y b,2002-07-01,22,73,22,73,95
40402,TURCO,estado nutricional en menores de 5 anos,clasificacion a y b,2002-07-01,1,3,1,3,4
21302,UMALA,estado nutricional en menores de 5 anos,clasificacion a y b,2002-07-01,2,14,2,14,16
50201,UNCIA,estado nutricional en menores de 5 anos,clasificacion a y b,2002-07-01,2,5,2,5,7
60401,URIONDO (A. CONCEPCION),estado nutricional en menores de 5 anos,clasificacion a y b,2002-07-01,42,36,42,36,78
51201,UYUNI,estado nutricional en menores de 5 anos,clasificacion a y b,2002-07-01,45,29,45,29,74
70801,VALLEGRANDE,estado nutricional en menores de 5 anos,clasificacion a y b,2002-07-01,39,47,39,47,86
20801,VIACHA,estado nutricional en menores de 5 anos,clasificacion a y b,2002-07-01,59,36,59,36,95
31302,VILA VILA,estado nutricional en menores de 5 anos,clasificacion a y b,2002-07-01,5,1,5,1,6
60303,VILLA MONTES,estado nutricional en menores de 5 anos,clasificacion a y b,2002-07-01,41,20,41,20,61
90502,VILLA NUEVA (LOMA ALTA),estado nutricional en menores de 5 anos,clasificacion a y b,2002-07-01,1,0,1,0,1
31402,VILLA RIVERO,estado nutricional en menores de 5 anos,clasificacion a y b,2002-07-01,9,1,9,1,10
10801,VILLA SERRANO,estado nutricional en menores de 5 anos,clasificacion a y b,2002-07-01,16,22,16,22,38
31003,VILLA TUNARI,estado nutricional en menores de 5 anos,clasificacion a y b,2002-07-01,73,36,73,36,109
11001,VILLA VACA GUZMAN (MUYUPAMPA),estado nutricional en menores de 5 anos,clasificacion a y b,2002-07-01,35,15,35,15,50
51501,VILLAZON,estado nutricional en menores de 5 anos,clasificacion a y b,2002-07-01,40,96,40,96,136
30904,VINTO,estado nutricional en menores de 5 anos,clasificacion a y b,2002-07-01,41,7,41,7,48
50602,VITICHI,estado nutricional en menores de 5 anos,clasificacion a y b,2002-07-01,4,2,4,2,6
20306,WALDO BALLIVIAN,estado nutricional en menores de 5 anos,clasificacion a y b,2002-07-01,1,0,1,0,1
70201,WARNES,estado nutricional en menores de 5 anos,clasificacion a y b,2002-07-01,101,60,101,60,161
20903,YACO,estado nutricional en menores de 5 anos,clasificacion a y b,2002-07-01,0,4,0,4,4
60301,YACUIBA,estado nutricional en menores de 5 anos,clasificacion a y b,2002-07-01,205,32,205,32,237
10602,YAMPARAEZ,estado nutricional en menores de 5 anos,clasificacion a y b,2002-07-01,25,5,25,5,30
21103,YANACACHI,estado nutricional en menores de 5 anos,clasificacion a y b,2002-07-01,12,4,12,4,16
50103,YOCALLA,estado nutricional en menores de 5 anos,clasificacion a y b,2002-07-01,1,8,1,8,9
10102,YOTALA,estado nutricional en menores de 5 anos,clasificacion a y b,2002-07-01,32,11,32,11,43
60402,YUNCHARA,estado nutricional en menores de 5 anos,clasificacion a y b,2002-07-01,12,7,12,7,19
10301,ZUDAÃ‘EZ,estado nutricional en menores de 5 anos,clasificacion a y b,2002-07-01,20,2,20,2,22
51302,ACACIO,estado nutricional en menores de 5 anos,clasificacion a y b,2002-08-01,2,2,2,2,4
20201,ACHACACHI,estado nutricional en menores de 5 anos,clasificacion a y b,2002-08-01,93,38,93,38,131
20104,ACHOCALLA,estado nutricional en menores de 5 anos,clasificacion a y b,2002-08-01,20,3,20,3,23
30201,AIQUILE,estado nutricional en menores de 5 anos,clasificacion a y b,2002-08-01,8,2,8,2,10
10404,ALCALA,estado nutricional en menores de 5 anos,clasificacion a y b,2002-08-01,13,3,13,3,16
20202,ANCORAIMES,estado nutricional en menores de 5 anos,clasificacion a y b,2002-08-01,26,8,26,8,34
30402,ANZALDO,estado nutricional en menores de 5 anos,clasificacion a y b,2002-08-01,1,8,1,8,9
20701,APOLO,estado nutricional en menores de 5 anos,clasificacion a y b,2002-08-01,6,11,6,11,17
51301,ARAMPAMPA,estado nutricional en menores de 5 anos,clasificacion a y b,2002-08-01,1,0,1,0,1
30403,ARBIETO,estado nutricional en menores de 5 anos,clasificacion a y b,2002-08-01,5,9,5,9,14
30601,ARQUE,estado nutricional en menores de 5 anos,clasificacion a y b,2002-08-01,1,4,1,4,5
71501,ASCENCION DE GUARAYOS,estado nutricional en menores de 5 anos,clasificacion a y b,2002-08-01,77,24,77,24,101
50802,ATOCHA,estado nutricional en menores de 5 anos,clasificacion a y b,2002-08-01,1,4,1,4,5
20503,AUCAPATA,estado nutricional en menores de 5 anos,clasificacion a y b,2002-08-01,35,2,35,2,37
20502,AYATA,estado nutricional en menores de 5 anos,clasificacion a y b,2002-08-01,3,0,3,0,3
21303,AYO AYO,estado nutricional en menores de 5 anos,clasificacion a y b,2002-08-01,16,4,16,4,20
30301,AYOPAYA (V. DE INDEPENDENCIA),estado nutricional en menores de 5 anos,clasificacion a y b,2002-08-01,24,2,24,2,26
10201,AZURDUY,estado nutricional en menores de 5 anos,clasificacion a y b,2002-08-01,29,4,29,4,33
21203,BATALLAS,estado nutricional en menores de 5 anos,clasificacion a y b,2002-08-01,20,6,20,6,26
80802,BAURES,estado nutricional en menores de 5 anos,clasificacion a y b,2002-08-01,12,1,12,1,13
50104,BELEN DE URMIRI,estado nutricional en menores de 5 anos,clasificacion a y b,2002-08-01,5,0,5,0,5
60202,BERMEJO,estado nutricional en menores de 5 anos,clasificacion a y b,2002-08-01,14,49,14,49,63
50301,BETANZOS,estado nutricional en menores de 5 anos,clasificacion a y b,2002-08-01,30,8,30,8,38
31501,BOLIVAR,estado nutricional en menores de 5 anos,clasificacion a y b,2002-08-01,1,1,1,1,2
70707,BOYUIBE,estado nutricional en menores de 5 anos,clasificacion a y b,2002-08-01,7,8,7,8,15
70703,CABEZAS,estado nutricional en menores de 5 anos,clasificacion a y b,2002-08-01,51,31,51,31,82
20905,CAIROMA,estado nutricional en menores de 5 anos,clasificacion a y b,2002-08-01,16,5,16,5,21
51102,"CAIZA ""D""",estado nutricional en menores de 5 anos,clasificacion a y b,2002-08-01,19,0,19,0,19
21003,CAJUATA,estado nutricional en menores de 5 anos,clasificacion a y b,2002-08-01,12,4,12,4,16
20303,CALACOTO,estado nutricional en menores de 5 anos,clasificacion a y b,2002-08-01,6,0,6,0,6
21304,CALAMARCA,estado nutricional en menores de 5 anos,clasificacion a y b,2002-08-01,21,4,21,4,25
10701,CAMARGO,estado nutricional en menores de 5 anos,clasificacion a y b,2002-08-01,11,3,11,3,14
10901,CAMATAQUI (C. VILLA ABECIA),estado nutricional en menores de 5 anos,clasificacion a y b,2002-08-01,17,8,17,8,25
70706,CAMIRI,estado nutricional en menores de 5 anos,clasificacion a y b,2002-08-01,52,49,52,49,101
30701,CAPINOTA,estado nutricional en menores de 5 anos,clasificacion a y b,2002-08-01,8,5,8,5,13
20302,CAQUIAVIRI,estado nutricional en menores de 5 anos,clasificacion a y b,2002-08-01,7,5,7,5,12
40102,CARACOLLO,estado nutricional en menores de 5 anos,clasificacion a y b,2002-08-01,10,2,10,2,12
22001,CARANAVI,estado nutricional en menores de 5 anos,clasificacion a y b,2002-08-01,137,52,137,52,189
60302,CARAPARI,estado nutricional en menores de 5 anos,clasificacion a y b,2002-08-01,24,44,24,44,68
50702,CARIPUYO,estado nutricional en menores de 5 anos,clasificacion a y b,2002-08-01,5,2,5,2,7
40201,CHALLAPATA,estado nutricional en menores de 5 anos,clasificacion a y b,2002-08-01,16,12,16,12,28
50302,CHAQUI,estado nutricional en menores de 5 anos,clasificacion a y b,2002-08-01,9,2,9,2,11
70702,CHARAGUA,estado nutricional en menores de 5 anos,clasificacion a y b,2002-08-01,41,66,41,66,107
20305,CHARAÃ‘A,estado nutricional en menores de 5 anos,clasificacion a y b,2002-08-01,3,0,3,0,3
31204,CHIMORE,estado nutricional en menores de 5 anos,clasificacion a y b,2002-08-01,34,19,34,19,53
21101,CHULUMANI (V. DE LA LIBERTAD),estado nutricional en menores de 5 anos,clasificacion a y b,2002-08-01,15,1,15,1,16
20501,CHUMA,estado nutricional en menores de 5 anos,clasificacion a y b,2002-08-01,13,1,13,1,14
30801,CLIZA,estado nutricional en menores de 5 anos,clasificacion a y b,2002-08-01,7,10,7,10,17
90101,COBIJA,estado nutricional en menores de 5 anos,clasificacion a y b,2002-08-01,149,22,149,22,171
30101,COCHABAMBA,estado nutricional en menores de 5 anos,clasificacion a y b,2002-08-01,1046,1205,1046,1205,2251
40902,COIPASA,estado nutricional en menores de 5 anos,clasificacion a y b,2002-08-01,2,0,2,0,2
30905,COLCAPIRHUA,estado nutricional en menores de 5 anos,clasificacion a y b,2002-08-01,54,5,54,5,59
50901,"COLCHA ""K""",estado nutricional en menores de 5 anos,clasificacion a y b,2002-08-01,18,8,18,8,26
31002,COLOMI,estado nutricional en menores de 5 anos,clasificacion a y b,2002-08-01,12,4,12,4,16
50401,COLQUECHACA,estado nutricional en menores de 5 anos,clasificacion a y b,2002-08-01,21,9,21,9,30
21306,COLQUENCHA,estado nutricional en menores de 5 anos,clasificacion a y b,2002-08-01,21,10,21,10,31
21004,COLQUIRI,estado nutricional en menores de 5 anos,clasificacion a y b,2002-08-01,11,6,11,6,17
20304,COMANCHE,estado nutricional en menores de 5 anos,clasificacion a y b,2002-08-01,3,0,3,0,3
71301,COMARAPA,estado nutricional en menores de 5 anos,clasificacion a y b,2002-08-01,73,16,73,16,89
20605,COMBAYA,estado nutricional en menores de 5 anos,clasificacion a y b,2002-08-01,4,0,4,0,4
71101,CONCEPCION,estado nutricional en menores de 5 anos,clasificacion a y b,2002-08-01,13,1,13,1,14
21701,COPACABANA,estado nutricional en menores de 5 anos,clasificacion a y b,2002-08-01,12,1,12,1,13
21402,CORIPATA,estado nutricional en menores de 5 anos,clasificacion a y b,2002-08-01,43,11,43,11,54
20301,CORO CORO,estado nutricional en menores de 5 anos,clasificacion a y b,2002-08-01,15,6,15,6,21
21401,COROICO,estado nutricional en menores de 5 anos,clasificacion a y b,2002-08-01,3,7,3,7,10
40301,CORQUE,estado nutricional en menores de 5 anos,clasificacion a y b,2002-08-01,5,0,5,0,5
50601,COTAGAITA,estado nutricional en menores de 5 anos,clasificacion a y b,2002-08-01,25,24,25,24,49
70102,COTOCA,estado nutricional en menores de 5 anos,clasificacion a y b,2002-08-01,91,18,91,18,109
70704,CUEVO,estado nutricional en menores de 5 anos,clasificacion a y b,2002-08-01,11,3,11,3,14
10902,CULPINA,estado nutricional en menores de 5 anos,clasificacion a y b,2002-08-01,41,12,41,12,53
40401,CURAHUARA DE CARANGAS,estado nutricional en menores de 5 anos,clasificacion a y b,2002-08-01,0,2,0,2,2
20804,DESAGUADERO,estado nutricional en menores de 5 anos,clasificacion a y b,2002-08-01,4,9,4,9,13
20105,EL ALTO,estado nutricional en menores de 5 anos,clasificacion a y b,2002-08-01,543,219,543,219,762
40103,EL CHORO,estado nutricional en menores de 5 anos,clasificacion a y b,2002-08-01,3,2,3,2,5
71503,EL PUENTE(STC),estado nutricional en menores de 5 anos,clasificacion a y b,2002-08-01,9,39,9,39,48
60502,EL PUENTE(TJA),estado nutricional en menores de 5 anos,clasificacion a y b,2002-08-01,7,2,7,2,9
70105,EL TORNO,estado nutricional en menores de 5 anos,clasificacion a y b,2002-08-01,113,27,113,27,140
10405,EL VILLAR,estado nutricional en menores de 5 anos,clasificacion a y b,2002-08-01,13,4,13,4,17
60601,ENTRE RIOS,estado nutricional en menores de 5 anos,clasificacion a y b,2002-08-01,38,20,38,20,58
41101,EUCALIPTUS,estado nutricional en menores de 5 anos,clasificacion a y b,2002-08-01,19,1,19,1,20
90503,EUREKA (SANTOS MERCADO),estado nutricional en menores de 5 anos,clasificacion a y b,2002-08-01,0,7,0,7,7
80402,EXALTACION,estado nutricional en menores de 5 anos,clasificacion a y b,2002-08-01,6,11,6,11,17
90203,FILADELFIA,estado nutricional en menores de 5 anos,clasificacion a y b,2002-08-01,2,8,2,8,10
71002,GENERAL SAAVEDRA,estado nutricional en menores de 5 anos,clasificacion a y b,2002-08-01,55,28,55,28,83
21601,GRAL. J.J. PEREZ (CHARAZANI),estado nutricional en menores de 5 anos,clasificacion a y b,2002-08-01,0,3,0,3,3
20602,GUANAY,estado nutricional en menores de 5 anos,clasificacion a y b,2002-08-01,119,44,119,44,163
20802,GUAQUI,estado nutricional en menores de 5 anos,clasificacion a y b,2002-08-01,4,4,4,4,8
80202,GUAYARAMERIN,estado nutricional en menores de 5 anos,clasificacion a y b,2002-08-01,99,30,99,30,129
70705,GUTIERREZ,estado nutricional en menores de 5 anos,clasificacion a y b,2002-08-01,69,22,69,22,91
10502,HUACARETA,estado nutricional en menores de 5 anos,clasificacion a y b,2002-08-01,37,9,37,9,46
11002,HUACAYA (VILLA DE HUACAYA),estado nutricional en menores de 5 anos,clasificacion a y b,2002-08-01,5,2,5,2,7
40501,HUACHACALLA,estado nutricional en menores de 5 anos,clasificacion a y b,2002-08-01,3,2,3,2,5
40701,HUANUNI,estado nutricional en menores de 5 anos,clasificacion a y b,2002-08-01,16,7,16,7,23
41601,HUAYLLAMARCA,estado nutricional en menores de 5 anos,clasificacion a y b,2002-08-01,5,2,5,2,7
21005,ICHOCA,estado nutricional en menores de 5 anos,clasificacion a y b,2002-08-01,4,1,4,1,5
10304,ICLA,estado nutricional en menores de 5 anos,clasificacion a y b,2002-08-01,10,5,10,5,15
10703,INCAHUASI,estado nutricional en menores de 5 anos,clasificacion a y b,2002-08-01,47,19,47,19,66
21001,INQUISIVI,estado nutricional en menores de 5 anos,clasificacion a y b,2002-08-01,19,4,19,4,23
21102,IRUPANA (VILLA DE LANZA),estado nutricional en menores de 5 anos,clasificacion a y b,2002-08-01,21,27,21,27,48
21501,IXIAMAS,estado nutricional en menores de 5 anos,clasificacion a y b,2002-08-01,19,14,19,14,33
21105,LA ASUNTA,estado nutricional en menores de 5 anos,clasificacion a y b,2002-08-01,44,21,44,21,65
70104,LA GUARDIA,estado nutricional en menores de 5 anos,clasificacion a y b,2002-08-01,163,34,163,34,197
20101,LA PAZ,estado nutricional en menores de 5 anos,clasificacion a y b,2002-08-01,580,411,580,411,991
70701,LAGUNILLAS,estado nutricional en menores de 5 anos,clasificacion a y b,2002-08-01,24,3,24,3,27
21202,LAJA,estado nutricional en menores de 5 anos,clasificacion a y b,2002-08-01,21,3,21,3,24
10903,LAS CARRERAS,estado nutricional en menores de 5 anos,clasificacion a y b,2002-08-01,12,6,12,6,18
21006,LICOMA PAMPA,estado nutricional en menores de 5 anos,clasificacion a y b,2002-08-01,1,0,1,0,1
51401,LLICA,estado nutricional en menores de 5 anos,clasificacion a y b,2002-08-01,6,3,6,3,9
80601,LORETO,estado nutricional en menores de 5 anos,clasificacion a y b,2002-08-01,4,7,4,7,11
20901,LURIBAY,estado nutricional en menores de 5 anos,clasificacion a y b,2002-08-01,5,0,5,0,5
40702,MACHACAMARCA,estado nutricional en menores de 5 anos,clasificacion a y b,2002-08-01,4,4,4,4,8
11003,MACHARETI,estado nutricional en menores de 5 anos,clasificacion a y b,2002-08-01,49,26,49,26,75
80801,MAGDALENA,estado nutricional en menores de 5 anos,clasificacion a y b,2002-08-01,19,8,19,8,27
70903,MAIRANA,estado nutricional en menores de 5 anos,clasificacion a y b,2002-08-01,56,3,56,3,59
20103,MECAPACA,estado nutricional en menores de 5 anos,clasificacion a y b,2002-08-01,3,2,3,2,5
71003,MINEROS,estado nutricional en menores de 5 anos,clasificacion a y b,2002-08-01,84,50,84,50,134
31301,MIZQUE,estado nutricional en menores de 5 anos,clasificacion a y b,2002-08-01,10,2,10,2,12
20402,MOCOMOCO,estado nutricional en menores de 5 anos,clasificacion a y b,2002-08-01,27,4,27,4,31
10303,MOJOCOYA,estado nutricional en menores de 5 anos,clasificacion a y b,2002-08-01,31,10,31,10,41
10501,MONTEAGUDO,estado nutricional en menores de 5 anos,clasificacion a y b,2002-08-01,123,29,123,29,152
71001,MONTERO,estado nutricional en menores de 5 anos,clasificacion a y b,2002-08-01,514,63,514,63,577
70803,MORO MORO,estado nutricional en menores de 5 anos,clasificacion a y b,2002-08-01,4,2,4,2,6
30302,MOROCHATA,estado nutricional en menores de 5 anos,clasificacion a y b,2002-08-01,34,37,34,37,71
90401,NACEBE (SANTA ROSA DEL ABUNA),estado nutricional en menores de 5 anos,clasificacion a y b,2002-08-01,1,0,1,0,1
20307,NAZACARA DE PACAJES,estado nutricional en menores de 5 anos,clasificacion a y b,2002-08-01,2,0,2,0,2
90501,NUEVO MANOA (NUEVA ESPERANZA),estado nutricional en menores de 5 anos,clasificacion a y b,2002-08-01,2,1,2,1,3
50404,OCURI,estado nutricional en menores de 5 anos,clasificacion a y b,2002-08-01,13,6,13,6,19
70202,OKINAWA,estado nutricional en menores de 5 anos,clasificacion a y b,2002-08-01,23,3,23,3,26
30203,OMEREQUE,estado nutricional en menores de 5 anos,clasificacion a y b,2002-08-01,8,24,8,24,32
40101,ORURO,estado nutricional en menores de 5 anos,clasificacion a y b,2002-08-01,246,39,246,39,285
60201,PADCAYA,estado nutricional en menores de 5 anos,clasificacion a y b,2002-08-01,23,30,23,30,53
10401,PADILLA,estado nutricional en menores de 5 anos,clasificacion a y b,2002-08-01,49,7,49,7,56
70502,PAILON,estado nutricional en menores de 5 anos,clasificacion a y b,2002-08-01,24,36,24,36,60
20102,PALCA,estado nutricional en menores de 5 anos,clasificacion a y b,2002-08-01,34,6,34,6,40
21104,PALOS BLANCOS,estado nutricional en menores de 5 anos,clasificacion a y b,2002-08-01,56,43,56,43,99
40802,PAMPA AULLAGAS,estado nutricional en menores de 5 anos,clasificacion a y b,2002-08-01,5,0,5,0,5
70902,PAMPA GRANDE,estado nutricional en menores de 5 anos,clasificacion a y b,2002-08-01,21,4,21,4,25
21802,PAPEL PAMPA,estado nutricional en menores de 5 anos,clasificacion a y b,2002-08-01,3,0,3,0,3
30202,PASORAPA,estado nutricional en menores de 5 anos,clasificacion a y b,2002-08-01,14,0,14,0,14
21305,PATACAMAYA,estado nutricional en menores de 5 anos,clasificacion a y b,2002-08-01,28,5,28,5,33
40602,PAZÃ‘A,estado nutricional en menores de 5 anos,clasificacion a y b,2002-08-01,4,1,4,1,5
20702,PELECHUCO,estado nutricional en menores de 5 anos,clasificacion a y b,2002-08-01,1,0,1,0,1
50403,POCOATA,estado nutricional en menores de 5 anos,clasificacion a y b,2002-08-01,34,12,34,12,46
31203,POCONA,estado nutricional en menores de 5 anos,clasificacion a y b,2002-08-01,13,4,13,4,17
31202,POJO (CBBA),estado nutricional en menores de 5 anos,clasificacion a y b,2002-08-01,119,24,119,24,143
51203,PORCO,estado nutricional en menores de 5 anos,clasificacion a y b,2002-08-01,9,1,9,1,10
10103,POROMA,estado nutricional en menores de 5 anos,clasificacion a y b,2002-08-01,43,55,43,55,98
70103,PORONGO,estado nutricional en menores de 5 anos,clasificacion a y b,2002-08-01,23,14,23,14,37
70601,PORTACHUELO,estado nutricional en menores de 5 anos,clasificacion a y b,2002-08-01,37,16,37,16,53
70804,POSTRER VALLE,estado nutricional en menores de 5 anos,clasificacion a y b,2002-08-01,12,1,12,1,13
50101,POTOSI,estado nutricional en menores de 5 anos,clasificacion a y b,2002-08-01,150,20,150,20,170
10302,PRESTO,estado nutricional en menores de 5 anos,clasificacion a y b,2002-08-01,10,7,10,7,17
70805,PUCARA,estado nutricional en menores de 5 anos,clasificacion a y b,2002-08-01,2,0,2,0,2
21201,PUCARANI,estado nutricional en menores de 5 anos,clasificacion a y b,2002-08-01,27,7,27,7,34
20401,PUERTO ACOSTA,estado nutricional en menores de 5 anos,clasificacion a y b,2002-08-01,44,27,44,27,71
20403,PUERTO CARABUCO,estado nutricional en menores de 5 anos,clasificacion a y b,2002-08-01,26,3,26,3,29
21204,PUERTO PEREZ,estado nutricional en menores de 5 anos,clasificacion a y b,2002-08-01,9,2,9,2,11
71402,PUERTO QUIJARRO,estado nutricional en menores de 5 anos,clasificacion a y b,2002-08-01,55,10,55,10,65
90201,PUERTO RICO,estado nutricional en menores de 5 anos,clasificacion a y b,2002-08-01,5,0,5,0,5
80703,PUERTO SILES,estado nutricional en menores de 5 anos,clasificacion a y b,2002-08-01,3,4,3,4,7
71401,PUERTO SUAREZ,estado nutricional en menores de 5 anos,clasificacion a y b,2002-08-01,34,14,34,14,48
31205,PUERTO VILLARROEL,estado nutricional en menores de 5 anos,clasificacion a y b,2002-08-01,158,52,158,52,210
51101,PUNA,estado nutricional en menores de 5 anos,clasificacion a y b,2002-08-01,25,13,25,13,38
20604,QUIABAYA,estado nutricional en menores de 5 anos,clasificacion a y b,2002-08-01,6,1,6,1,7
30901,QUILLACOLLO,estado nutricional en menores de 5 anos,clasificacion a y b,2002-08-01,39,8,39,8,47
21002,QUIME,estado nutricional en menores de 5 anos,clasificacion a y b,2002-08-01,11,1,11,1,12
70904,QUIRUSILLAS,estado nutricional en menores de 5 anos,clasificacion a y b,2002-08-01,4,11,4,11,15
50402,RAVELO,estado nutricional en menores de 5 anos,clasificacion a y b,2002-08-01,13,2,13,2,15
80301,REYES,estado nutricional en menores de 5 anos,clasificacion a y b,2002-08-01,10,1,10,1,11
80201,RIBERALTA,estado nutricional en menores de 5 anos,clasificacion a y b,2002-08-01,218,31,218,31,249
70503,ROBORE,estado nutricional en menores de 5 anos,clasificacion a y b,2002-08-01,43,9,43,9,52
80304,RURRENABAQUE,estado nutricional en menores de 5 anos,clasificacion a y b,2002-08-01,3,10,3,10,13
31001,SACABA,estado nutricional en menores de 5 anos,clasificacion a y b,2002-08-01,34,8,34,8,42
30404,SACABAMBA,estado nutricional en menores de 5 anos,clasificacion a y b,2002-08-01,0,2,0,2,2
50701,SACACA,estado nutricional en menores de 5 anos,clasificacion a y b,2002-08-01,3,0,3,0,3
71302,SAIPINA,estado nutricional en menores de 5 anos,clasificacion a y b,2002-08-01,26,16,26,16,42
40801,SALINAS DE GARCI MENDOZA,estado nutricional en menores de 5 anos,clasificacion a y b,2002-08-01,6,0,6,0,6
70901,SAMAIPATA,estado nutricional en menores de 5 anos,clasificacion a y b,2002-08-01,29,4,29,4,33
51601,SAN AGUSTIN,estado nutricional en menores de 5 anos,clasificacion a y b,2002-08-01,4,0,4,0,4
80602,SAN ANDRES,estado nutricional en menores de 5 anos,clasificacion a y b,2002-08-01,21,9,21,9,30
71105,SAN ANTONIO DE LOMERIO,estado nutricional en menores de 5 anos,clasificacion a y b,2002-08-01,23,11,23,11,34
80302,SAN BORJA,estado nutricional en menores de 5 anos,clasificacion a y b,2002-08-01,91,39,91,39,130
21502,SAN BUENA VENTURA,estado nutricional en menores de 5 anos,clasificacion a y b,2002-08-01,10,2,10,2,12
80501,SAN IGNACIO,estado nutricional en menores de 5 anos,clasificacion a y b,2002-08-01,59,38,59,38,97
70301,SAN IGNACIO DE VELASCO,estado nutricional en menores de 5 anos,clasificacion a y b,2002-08-01,176,11,176,11,187
80102,SAN JAVIER(BNI),estado nutricional en menores de 5 anos,clasificacion a y b,2002-08-01,6,6,6,6,12
71102,SAN JAVIER(STC),estado nutricional en menores de 5 anos,clasificacion a y b,2002-08-01,50,1,50,1,51
80701,SAN JOAQUIN,estado nutricional en menores de 5 anos,clasificacion a y b,2002-08-01,11,12,11,12,23
70501,SAN JOSE DE CHIQUITOS,estado nutricional en menores de 5 anos,clasificacion a y b,2002-08-01,25,7,25,7,32
71104,SAN JULIAN,estado nutricional en menores de 5 anos,clasificacion a y b,2002-08-01,138,65,138,65,203
90302,SAN LORENZO(PND),estado nutricional en menores de 5 anos,clasificacion a y b,2002-08-01,1,0,1,0,1
60501,SAN LORENZO(TJA),estado nutricional en menores de 5 anos,clasificacion a y b,2002-08-01,5,0,5,0,5
10702,SAN LUCAS,estado nutricional en menores de 5 anos,clasificacion a y b,2002-08-01,62,27,62,27,89
71201,SAN MATIAS,estado nutricional en menores de 5 anos,clasificacion a y b,2002-08-01,39,8,39,8,47
70302,SAN MIGUEL DE VELASCO,estado nutricional en menores de 5 anos,clasificacion a y b,2002-08-01,19,2,19,2,21
50501,SAN PEDRO DE BUENA VISTA,estado nutricional en menores de 5 anos,clasificacion a y b,2002-08-01,9,13,9,13,22
21801,SAN PEDRO DE CURAHUARA,estado nutricional en menores de 5 anos,clasificacion a y b,2002-08-01,3,0,3,0,3
21702,SAN PEDRO DE TIQUINA,estado nutricional en menores de 5 anos,clasificacion a y b,2002-08-01,0,9,0,9,9
90202,SAN PEDRO(PND),estado nutricional en menores de 5 anos,clasificacion a y b,2002-08-01,1,0,1,0,1
70303,SAN RAFAEL,estado nutricional en menores de 5 anos,clasificacion a y b,2002-08-01,22,4,22,4,26
80702,SAN RAMON,estado nutricional en menores de 5 anos,clasificacion a y b,2002-08-01,38,26,38,26,64
80401,SANTA ANA,estado nutricional en menores de 5 anos,clasificacion a y b,2002-08-01,16,0,16,0,16
70101,SANTA CRUZ DE LA SIERRA,estado nutricional en menores de 5 anos,clasificacion a y b,2002-08-01,1315,766,1315,766,2081
80303,SANTA ROSA,estado nutricional en menores de 5 anos,clasificacion a y b,2002-08-01,7,8,7,8,15
70602,SANTA ROSA DEL SARA,estado nutricional en menores de 5 anos,clasificacion a y b,2002-08-01,26,16,26,16,42
20308,SANTIAGO DE CALLAPA,estado nutricional en menores de 5 anos,clasificacion a y b,2002-08-01,2,1,2,1,3
41401,SANTIAGO DE HUARI,estado nutricional en menores de 5 anos,clasificacion a y b,2002-08-01,3,5,3,5,8
21901,SANTIAGO DE MACHACA,estado nutricional en menores de 5 anos,clasificacion a y b,2002-08-01,1,2,1,2,3
30702,SANTIVAÃ‘ES,estado nutricional en menores de 5 anos,clasificacion a y b,2002-08-01,5,0,5,0,5
40202,SANTUARIO DE QUILLACAS,estado nutricional en menores de 5 anos,clasificacion a y b,2002-08-01,3,0,3,0,3
20902,SAPAHAQUI,estado nutricional en menores de 5 anos,clasificacion a y b,2002-08-01,3,0,3,0,3
21301,SICA SICA (VILLA AROMA),estado nutricional en menores de 5 anos,clasificacion a y b,2002-08-01,17,3,17,3,20
30703,SICAYA,estado nutricional en menores de 5 anos,clasificacion a y b,2002-08-01,3,0,3,0,3
30902,SIPE SIPE,estado nutricional en menores de 5 anos,clasificacion a y b,2002-08-01,86,34,86,34,120
10403,SOPACHUY,estado nutricional en menores de 5 anos,clasificacion a y b,2002-08-01,21,2,21,2,23
20601,SORATA,estado nutricional en menores de 5 anos,clasificacion a y b,2002-08-01,21,3,21,3,24
10101,SUCRE,estado nutricional en menores de 5 anos,clasificacion a y b,2002-08-01,353,124,353,124,477
20603,TACACOMA,estado nutricional en menores de 5 anos,clasificacion a y b,2002-08-01,19,7,19,7,26
50303,TACOBAMBA,estado nutricional en menores de 5 anos,clasificacion a y b,2002-08-01,14,0,14,0,14
30602,TACOPAYA,estado nutricional en menores de 5 anos,clasificacion a y b,2002-08-01,1,0,1,0,1
51402,TAHUA,estado nutricional en menores de 5 anos,clasificacion a y b,2002-08-01,0,1,0,1,1
31101,TAPACARI,estado nutricional en menores de 5 anos,clasificacion a y b,2002-08-01,18,14,18,14,32
10601,TARABUCO,estado nutricional en menores de 5 anos,clasificacion a y b,2002-08-01,49,13,49,13,62
30401,TARATA,estado nutricional en menores de 5 anos,clasificacion a y b,2002-08-01,19,4,19,4,23
60101,TARIJA,estado nutricional en menores de 5 anos,clasificacion a y b,2002-08-01,307,142,307,142,449
10202,TARVITA,estado nutricional en menores de 5 anos,clasificacion a y b,2002-08-01,19,4,19,4,23
20803,TIAWANACU,estado nutricional en menores de 5 anos,clasificacion a y b,2002-08-01,36,5,36,5,41
50102,TINGUIPAYA,estado nutricional en menores de 5 anos,clasificacion a y b,2002-08-01,9,0,9,0,9
20606,TIPUANI,estado nutricional en menores de 5 anos,clasificacion a y b,2002-08-01,40,7,40,7,47
30903,TIQUIPAYA,estado nutricional en menores de 5 anos,clasificacion a y b,2002-08-01,13,9,13,9,22
31601,TIRAQUE (CBBA),estado nutricional en menores de 5 anos,clasificacion a y b,2002-08-01,103,17,103,17,120
30802,TOCO,estado nutricional en menores de 5 anos,clasificacion a y b,2002-08-01,0,1,0,1,1
41001,TOLEDO,estado nutricional en menores de 5 anos,clasificacion a y b,2002-08-01,3,2,3,2,5
51202,TOMAVE,estado nutricional en menores de 5 anos,clasificacion a y b,2002-08-01,1,1,1,1,2
10402,TOMINA,estado nutricional en menores de 5 anos,clasificacion a y b,2002-08-01,22,3,22,3,25
50502,TORO TORO,estado nutricional en menores de 5 anos,clasificacion a y b,2002-08-01,8,4,8,4,12
31201,TOTORA(CBBA),estado nutricional en menores de 5 anos,clasificacion a y b,2002-08-01,14,5,14,5,19
41301,TOTORA(ORR),estado nutricional en menores de 5 anos,clasificacion a y b,2002-08-01,3,2,3,2,5
70802,TRIGAL,estado nutricional en menores de 5 anos,clasificacion a y b,2002-08-01,1,2,1,2,3
80101,TRINIDAD,estado nutricional en menores de 5 anos,clasificacion a y b,2002-08-01,253,220,253,220,473
40402,TURCO,estado nutricional en menores de 5 anos,clasificacion a y b,2002-08-01,3,0,3,0,3
21302,UMALA,estado nutricional en menores de 5 anos,clasificacion a y b,2002-08-01,9,2,9,2,11
60401,URIONDO (A. CONCEPCION),estado nutricional en menores de 5 anos,clasificacion a y b,2002-08-01,31,26,31,26,57
71502,URUBICHA,estado nutricional en menores de 5 anos,clasificacion a y b,2002-08-01,6,22,6,22,28
51201,UYUNI,estado nutricional en menores de 5 anos,clasificacion a y b,2002-08-01,50,22,50,22,72
70801,VALLEGRANDE,estado nutricional en menores de 5 anos,clasificacion a y b,2002-08-01,39,21,39,21,60
20801,VIACHA,estado nutricional en menores de 5 anos,clasificacion a y b,2002-08-01,36,49,36,49,85
31302,VILA VILA,estado nutricional en menores de 5 anos,clasificacion a y b,2002-08-01,3,5,3,5,8
60303,VILLA MONTES,estado nutricional en menores de 5 anos,clasificacion a y b,2002-08-01,35,21,35,21,56
31402,VILLA RIVERO,estado nutricional en menores de 5 anos,clasificacion a y b,2002-08-01,2,0,2,0,2
10801,VILLA SERRANO,estado nutricional en menores de 5 anos,clasificacion a y b,2002-08-01,22,16,22,16,38
31003,VILLA TUNARI,estado nutricional en menores de 5 anos,clasificacion a y b,2002-08-01,83,25,83,25,108
11001,VILLA VACA GUZMAN (MUYUPAMPA),estado nutricional en menores de 5 anos,clasificacion a y b,2002-08-01,38,12,38,12,50
51501,VILLAZON,estado nutricional en menores de 5 anos,clasificacion a y b,2002-08-01,88,27,88,27,115
50602,VITICHI,estado nutricional en menores de 5 anos,clasificacion a y b,2002-08-01,8,4,8,4,12
70201,WARNES,estado nutricional en menores de 5 anos,clasificacion a y b,2002-08-01,123,68,123,68,191
20903,YACO,estado nutricional en menores de 5 anos,clasificacion a y b,2002-08-01,2,6,2,6,8
60301,YACUIBA,estado nutricional en menores de 5 anos,clasificacion a y b,2002-08-01,144,35,144,35,179
10602,YAMPARAEZ,estado nutricional en menores de 5 anos,clasificacion a y b,2002-08-01,24,6,24,6,30
21103,YANACACHI,estado nutricional en menores de 5 anos,clasificacion a y b,2002-08-01,9,2,9,2,11
70403,YAPACANI,estado nutricional en menores de 5 anos,clasificacion a y b,2002-08-01,7,2,7,2,9
50103,YOCALLA,estado nutricional en menores de 5 anos,clasificacion a y b,2002-08-01,5,7,5,7,12
10102,YOTALA,estado nutricional en menores de 5 anos,clasificacion a y b,2002-08-01,40,22,40,22,62
60402,YUNCHARA,estado nutricional en menores de 5 anos,clasificacion a y b,2002-08-01,15,2,15,2,17
10301,ZUDAÃ‘EZ,estado nutricional en menores de 5 anos,clasificacion a y b,2002-08-01,30,0,30,0,30
51302,ACACIO,estado nutricional en menores de 5 anos,clasificacion a y b,2002-09-01,0,2,0,2,2
20201,ACHACACHI,estado nutricional en menores de 5 anos,clasificacion a y b,2002-09-01,104,78,104,78,182
20104,ACHOCALLA,estado nutricional en menores de 5 anos,clasificacion a y b,2002-09-01,24,0,24,0,24
30201,AIQUILE,estado nutricional en menores de 5 anos,clasificacion a y b,2002-09-01,5,0,5,0,5
10404,ALCALA,estado nutricional en menores de 5 anos,clasificacion a y b,2002-09-01,11,2,11,2,13
20202,ANCORAIMES,estado nutricional en menores de 5 anos,clasificacion a y b,2002-09-01,17,7,17,7,24
40603,ANTEQUERA,estado nutricional en menores de 5 anos,clasificacion a y b,2002-09-01,13,0,13,0,13
30402,ANZALDO,estado nutricional en menores de 5 anos,clasificacion a y b,2002-09-01,3,17,3,17,20
20701,APOLO,estado nutricional en menores de 5 anos,clasificacion a y b,2002-09-01,32,4,32,4,36
51301,ARAMPAMPA,estado nutricional en menores de 5 anos,clasificacion a y b,2002-09-01,8,1,8,1,9
30501,ARANI,estado nutricional en menores de 5 anos,clasificacion a y b,2002-09-01,1,4,1,4,5
30403,ARBIETO,estado nutricional en menores de 5 anos,clasificacion a y b,2002-09-01,5,11,5,11,16
30601,ARQUE,estado nutricional en menores de 5 anos,clasificacion a y b,2002-09-01,1,1,1,1,2
50802,ATOCHA,estado nutricional en menores de 5 anos,clasificacion a y b,2002-09-01,6,15,6,15,21
20503,AUCAPATA,estado nutricional en menores de 5 anos,clasificacion a y b,2002-09-01,11,0,11,0,11
20502,AYATA,estado nutricional en menores de 5 anos,clasificacion a y b,2002-09-01,26,6,26,6,32
21303,AYO AYO,estado nutricional en menores de 5 anos,clasificacion a y b,2002-09-01,19,3,19,3,22
30301,AYOPAYA (V. DE INDEPENDENCIA),estado nutricional en menores de 5 anos,clasificacion a y b,2002-09-01,22,8,22,8,30
10201,AZURDUY,estado nutricional en menores de 5 anos,clasificacion a y b,2002-09-01,44,9,44,9,53
21203,BATALLAS,estado nutricional en menores de 5 anos,clasificacion a y b,2002-09-01,23,14,23,14,37
80802,BAURES,estado nutricional en menores de 5 anos,clasificacion a y b,2002-09-01,8,2,8,2,10
50104,BELEN DE URMIRI,estado nutricional en menores de 5 anos,clasificacion a y b,2002-09-01,7,3,7,3,10
60202,BERMEJO,estado nutricional en menores de 5 anos,clasificacion a y b,2002-09-01,19,53,19,53,72
50301,BETANZOS,estado nutricional en menores de 5 anos,clasificacion a y b,2002-09-01,39,8,39,8,47
31501,BOLIVAR,estado nutricional en menores de 5 anos,clasificacion a y b,2002-09-01,10,4,10,4,14
70707,BOYUIBE,estado nutricional en menores de 5 anos,clasificacion a y b,2002-09-01,6,9,6,9,15
70401,BUENA VISTA,estado nutricional en menores de 5 anos,clasificacion a y b,2002-09-01,67,17,67,17,84
70703,CABEZAS,estado nutricional en menores de 5 anos,clasificacion a y b,2002-09-01,47,28,47,28,75
20905,CAIROMA,estado nutricional en menores de 5 anos,clasificacion a y b,2002-09-01,12,1,12,1,13
51102,"CAIZA ""D""",estado nutricional en menores de 5 anos,clasificacion a y b,2002-09-01,28,2,28,2,30
21003,CAJUATA,estado nutricional en menores de 5 anos,clasificacion a y b,2002-09-01,8,1,8,1,9
20303,CALACOTO,estado nutricional en menores de 5 anos,clasificacion a y b,2002-09-01,3,1,3,1,4
21304,CALAMARCA,estado nutricional en menores de 5 anos,clasificacion a y b,2002-09-01,14,4,14,4,18
10701,CAMARGO,estado nutricional en menores de 5 anos,clasificacion a y b,2002-09-01,15,13,15,13,28
10901,CAMATAQUI (C. VILLA ABECIA),estado nutricional en menores de 5 anos,clasificacion a y b,2002-09-01,10,5,10,5,15
70706,CAMIRI,estado nutricional en menores de 5 anos,clasificacion a y b,2002-09-01,68,24,68,24,92
30701,CAPINOTA,estado nutricional en menores de 5 anos,clasificacion a y b,2002-09-01,13,10,13,10,23
20302,CAQUIAVIRI,estado nutricional en menores de 5 anos,clasificacion a y b,2002-09-01,13,1,13,1,14
40102,CARACOLLO,estado nutricional en menores de 5 anos,clasificacion a y b,2002-09-01,24,6,24,6,30
22001,CARANAVI,estado nutricional en menores de 5 anos,clasificacion a y b,2002-09-01,128,45,128,45,173
60302,CARAPARI,estado nutricional en menores de 5 anos,clasificacion a y b,2002-09-01,39,7,39,7,46
50702,CARIPUYO,estado nutricional en menores de 5 anos,clasificacion a y b,2002-09-01,2,0,2,0,2
21902,CATACORA,estado nutricional en menores de 5 anos,clasificacion a y b,2002-09-01,0,1,0,1,1
21803,CHACARILLA,estado nutricional en menores de 5 anos,clasificacion a y b,2002-09-01,2,2,2,2,4
40201,CHALLAPATA,estado nutricional en menores de 5 anos,clasificacion a y b,2002-09-01,12,10,12,10,22
50302,CHAQUI,estado nutricional en menores de 5 anos,clasificacion a y b,2002-09-01,18,0,18,0,18
70702,CHARAGUA,estado nutricional en menores de 5 anos,clasificacion a y b,2002-09-01,37,75,37,75,112
20305,CHARAÃ‘A,estado nutricional en menores de 5 anos,clasificacion a y b,2002-09-01,3,2,3,2,5
50202,CHAYANTA,estado nutricional en menores de 5 anos,clasificacion a y b,2002-09-01,9,4,9,4,13
31204,CHIMORE,estado nutricional en menores de 5 anos,clasificacion a y b,2002-09-01,22,10,22,10,32
40903,CHIPAYA,estado nutricional en menores de 5 anos,clasificacion a y b,2002-09-01,0,2,0,2,2
40302,CHOQUE COTA,estado nutricional en menores de 5 anos,clasificacion a y b,2002-09-01,3,0,3,0,3
21101,CHULUMANI (V. DE LA LIBERTAD),estado nutricional en menores de 5 anos,clasificacion a y b,2002-09-01,23,6,23,6,29
20501,CHUMA,estado nutricional en menores de 5 anos,clasificacion a y b,2002-09-01,18,6,18,6,24
30801,CLIZA,estado nutricional en menores de 5 anos,clasificacion a y b,2002-09-01,7,15,7,15,22
90101,COBIJA,estado nutricional en menores de 5 anos,clasificacion a y b,2002-09-01,91,20,91,20,111
30101,COCHABAMBA,estado nutricional en menores de 5 anos,clasificacion a y b,2002-09-01,1409,1265,1409,1265,2674
40902,COIPASA,estado nutricional en menores de 5 anos,clasificacion a y b,2002-09-01,1,0,1,0,1
30905,COLCAPIRHUA,estado nutricional en menores de 5 anos,clasificacion a y b,2002-09-01,37,6,37,6,43
50901,"COLCHA ""K""",estado nutricional en menores de 5 anos,clasificacion a y b,2002-09-01,11,5,11,5,16
21307,COLLANA,estado nutricional en menores de 5 anos,clasificacion a y b,2002-09-01,3,0,3,0,3
31002,COLOMI,estado nutricional en menores de 5 anos,clasificacion a y b,2002-09-01,18,6,18,6,24
50401,COLQUECHACA,estado nutricional en menores de 5 anos,clasificacion a y b,2002-09-01,41,2,41,2,43
21306,COLQUENCHA,estado nutricional en menores de 5 anos,clasificacion a y b,2002-09-01,23,13,23,13,36
21004,COLQUIRI,estado nutricional en menores de 5 anos,clasificacion a y b,2002-09-01,8,9,8,9,17
20304,COMANCHE,estado nutricional en menores de 5 anos,clasificacion a y b,2002-09-01,3,0,3,0,3
71301,COMARAPA,estado nutricional en menores de 5 anos,clasificacion a y b,2002-09-01,78,22,78,22,100
20605,COMBAYA,estado nutricional en menores de 5 anos,clasificacion a y b,2002-09-01,4,0,4,0,4
71101,CONCEPCION,estado nutricional en menores de 5 anos,clasificacion a y b,2002-09-01,5,0,5,0,5
21402,CORIPATA,estado nutricional en menores de 5 anos,clasificacion a y b,2002-09-01,29,21,29,21,50
20301,CORO CORO,estado nutricional en menores de 5 anos,clasificacion a y b,2002-09-01,21,1,21,1,22
21401,COROICO,estado nutricional en menores de 5 anos,clasificacion a y b,2002-09-01,5,5,5,5,10
40301,CORQUE,estado nutricional en menores de 5 anos,clasificacion a y b,2002-09-01,3,1,3,1,4
50601,COTAGAITA,estado nutricional en menores de 5 anos,clasificacion a y b,2002-09-01,32,6,32,6,38
70102,COTOCA,estado nutricional en menores de 5 anos,clasificacion a y b,2002-09-01,49,5,49,5,54
70704,CUEVO,estado nutricional en menores de 5 anos,clasificacion a y b,2002-09-01,12,9,12,9,21
10902,CULPINA,estado nutricional en menores de 5 anos,clasificacion a y b,2002-09-01,57,23,57,23,80
40401,CURAHUARA DE CARANGAS,estado nutricional en menores de 5 anos,clasificacion a y b,2002-09-01,2,0,2,0,2
21602,CURVA,estado nutricional en menores de 5 anos,clasificacion a y b,2002-09-01,1,0,1,0,1
20804,DESAGUADERO,estado nutricional en menores de 5 anos,clasificacion a y b,2002-09-01,6,1,6,1,7
20105,EL ALTO,estado nutricional en menores de 5 anos,clasificacion a y b,2002-09-01,605,209,605,209,814
40103,EL CHORO,estado nutricional en menores de 5 anos,clasificacion a y b,2002-09-01,0,1,0,1,1
71503,EL PUENTE(STC),estado nutricional en menores de 5 anos,clasificacion a y b,2002-09-01,6,22,6,22,28
60502,EL PUENTE(TJA),estado nutricional en menores de 5 anos,clasificacion a y b,2002-09-01,5,4,5,4,9
70105,EL TORNO,estado nutricional en menores de 5 anos,clasificacion a y b,2002-09-01,125,47,125,47,172
10405,EL VILLAR,estado nutricional en menores de 5 anos,clasificacion a y b,2002-09-01,15,3,15,3,18
60601,ENTRE RIOS,estado nutricional en menores de 5 anos,clasificacion a y b,2002-09-01,38,19,38,19,57
41101,EUCALIPTUS,estado nutricional en menores de 5 anos,clasificacion a y b,2002-09-01,51,3,51,3,54
90503,EUREKA (SANTOS MERCADO),estado nutricional en menores de 5 anos,clasificacion a y b,2002-09-01,5,3,5,3,8
80402,EXALTACION,estado nutricional en menores de 5 anos,clasificacion a y b,2002-09-01,0,2,0,2,2
71002,GENERAL SAAVEDRA,estado nutricional en menores de 5 anos,clasificacion a y b,2002-09-01,15,2,15,2,17
21601,GRAL. J.J. PEREZ (CHARAZANI),estado nutricional en menores de 5 anos,clasificacion a y b,2002-09-01,13,22,13,22,35
20602,GUANAY,estado nutricional en menores de 5 anos,clasificacion a y b,2002-09-01,84,40,84,40,124
20802,GUAQUI,estado nutricional en menores de 5 anos,clasificacion a y b,2002-09-01,4,0,4,0,4
80202,GUAYARAMERIN,estado nutricional en menores de 5 anos,clasificacion a y b,2002-09-01,89,28,89,28,117
70705,GUTIERREZ,estado nutricional en menores de 5 anos,clasificacion a y b,2002-09-01,50,17,50,17,67
10502,HUACARETA,estado nutricional en menores de 5 anos,clasificacion a y b,2002-09-01,28,14,28,14,42
11002,HUACAYA (VILLA DE HUACAYA),estado nutricional en menores de 5 anos,clasificacion a y b,2002-09-01,8,5,8,5,13
40501,HUACHACALLA,estado nutricional en menores de 5 anos,clasificacion a y b,2002-09-01,1,2,1,2,3
40701,HUANUNI,estado nutricional en menores de 5 anos,clasificacion a y b,2002-09-01,4,3,4,3,7
80803,HUARACAJE,estado nutricional en menores de 5 anos,clasificacion a y b,2002-09-01,4,1,4,1,5
41601,HUAYLLAMARCA,estado nutricional en menores de 5 anos,clasificacion a y b,2002-09-01,3,1,3,1,4
10304,ICLA,estado nutricional en menores de 5 anos,clasificacion a y b,2002-09-01,14,6,14,6,20
10703,INCAHUASI,estado nutricional en menores de 5 anos,clasificacion a y b,2002-09-01,29,13,29,13,42
21001,INQUISIVI,estado nutricional en menores de 5 anos,clasificacion a y b,2002-09-01,28,7,28,7,35
21102,IRUPANA (VILLA DE LANZA),estado nutricional en menores de 5 anos,clasificacion a y b,2002-09-01,19,12,19,12,31
21501,IXIAMAS,estado nutricional en menores de 5 anos,clasificacion a y b,2002-09-01,22,14,22,14,36
21105,LA ASUNTA,estado nutricional en menores de 5 anos,clasificacion a y b,2002-09-01,37,11,37,11,48
70104,LA GUARDIA,estado nutricional en menores de 5 anos,clasificacion a y b,2002-09-01,130,32,130,32,162
20101,LA PAZ,estado nutricional en menores de 5 anos,clasificacion a y b,2002-09-01,485,240,485,240,725
41501,LA RIVERA,estado nutricional en menores de 5 anos,clasificacion a y b,2002-09-01,1,0,1,0,1
70701,LAGUNILLAS,estado nutricional en menores de 5 anos,clasificacion a y b,2002-09-01,23,8,23,8,31
21202,LAJA,estado nutricional en menores de 5 anos,clasificacion a y b,2002-09-01,24,0,24,0,24
10903,LAS CARRERAS,estado nutricional en menores de 5 anos,clasificacion a y b,2002-09-01,6,4,6,4,10
21006,LICOMA PAMPA,estado nutricional en menores de 5 anos,clasificacion a y b,2002-09-01,1,0,1,0,1
50203,LLALLAGUA,estado nutricional en menores de 5 anos,clasificacion a y b,2002-09-01,16,63,16,63,79
51401,LLICA,estado nutricional en menores de 5 anos,clasificacion a y b,2002-09-01,3,1,3,1,4
80601,LORETO,estado nutricional en menores de 5 anos,clasificacion a y b,2002-09-01,0,16,0,16,16
20901,LURIBAY,estado nutricional en menores de 5 anos,clasificacion a y b,2002-09-01,21,2,21,2,23
40702,MACHACAMARCA,estado nutricional en menores de 5 anos,clasificacion a y b,2002-09-01,6,0,6,0,6
11003,MACHARETI,estado nutricional en menores de 5 anos,clasificacion a y b,2002-09-01,55,31,55,31,86
80801,MAGDALENA,estado nutricional en menores de 5 anos,clasificacion a y b,2002-09-01,21,5,21,5,26
70903,MAIRANA,estado nutricional en menores de 5 anos,clasificacion a y b,2002-09-01,44,4,44,4,48
20904,MALLA,estado nutricional en menores de 5 anos,clasificacion a y b,2002-09-01,3,0,3,0,3
20103,MECAPACA,estado nutricional en menores de 5 anos,clasificacion a y b,2002-09-01,4,1,4,1,5
71003,MINEROS,estado nutricional en menores de 5 anos,clasificacion a y b,2002-09-01,8,0,8,0,8
31301,MIZQUE,estado nutricional en menores de 5 anos,clasificacion a y b,2002-09-01,20,9,20,9,29
20402,MOCOMOCO,estado nutricional en menores de 5 anos,clasificacion a y b,2002-09-01,23,2,23,2,25
51002,MOJINETE,estado nutricional en menores de 5 anos,clasificacion a y b,2002-09-01,2,0,2,0,2
10303,MOJOCOYA,estado nutricional en menores de 5 anos,clasificacion a y b,2002-09-01,33,20,33,20,53
10501,MONTEAGUDO,estado nutricional en menores de 5 anos,clasificacion a y b,2002-09-01,148,22,148,22,170
71001,MONTERO,estado nutricional en menores de 5 anos,clasificacion a y b,2002-09-01,311,102,311,102,413
70803,MORO MORO,estado nutricional en menores de 5 anos,clasificacion a y b,2002-09-01,10,3,10,3,13
30302,MOROCHATA,estado nutricional en menores de 5 anos,clasificacion a y b,2002-09-01,28,10,28,10,38
20307,NAZACARA DE PACAJES,estado nutricional en menores de 5 anos,clasificacion a y b,2002-09-01,2,0,2,0,2
90501,NUEVO MANOA (NUEVA ESPERANZA),estado nutricional en menores de 5 anos,clasificacion a y b,2002-09-01,1,0,1,0,1
50404,OCURI,estado nutricional en menores de 5 anos,clasificacion a y b,2002-09-01,11,14,11,14,25
70202,OKINAWA,estado nutricional en menores de 5 anos,clasificacion a y b,2002-09-01,9,3,9,3,12
30203,OMEREQUE,estado nutricional en menores de 5 anos,clasificacion a y b,2002-09-01,0,12,0,12,12
40101,ORURO,estado nutricional en menores de 5 anos,clasificacion a y b,2002-09-01,237,41,237,41,278
60201,PADCAYA,estado nutricional en menores de 5 anos,clasificacion a y b,2002-09-01,37,40,37,40,77
10401,PADILLA,estado nutricional en menores de 5 anos,clasificacion a y b,2002-09-01,45,4,45,4,49
70502,PAILON,estado nutricional en menores de 5 anos,clasificacion a y b,2002-09-01,55,32,55,32,87
20102,PALCA,estado nutricional en menores de 5 anos,clasificacion a y b,2002-09-01,22,4,22,4,26
21104,PALOS BLANCOS,estado nutricional en menores de 5 anos,clasificacion a y b,2002-09-01,40,12,40,12,52
40802,PAMPA AULLAGAS,estado nutricional en menores de 5 anos,clasificacion a y b,2002-09-01,2,0,2,0,2
70902,PAMPA GRANDE,estado nutricional en menores de 5 anos,clasificacion a y b,2002-09-01,34,6,34,6,40
21802,PAPEL PAMPA,estado nutricional en menores de 5 anos,clasificacion a y b,2002-09-01,8,0,8,0,8
30202,PASORAPA,estado nutricional en menores de 5 anos,clasificacion a y b,2002-09-01,3,0,3,0,3
21305,PATACAMAYA,estado nutricional en menores de 5 anos,clasificacion a y b,2002-09-01,28,1,28,1,29
40602,PAZÃ‘A,estado nutricional en menores de 5 anos,clasificacion a y b,2002-09-01,1,0,1,0,1
20702,PELECHUCO,estado nutricional en menores de 5 anos,clasificacion a y b,2002-09-01,2,0,2,0,2
50403,POCOATA,estado nutricional en menores de 5 anos,clasificacion a y b,2002-09-01,34,9,34,9,43
31203,POCONA,estado nutricional en menores de 5 anos,clasificacion a y b,2002-09-01,15,1,15,1,16
31202,POJO (CBBA),estado nutricional en menores de 5 anos,clasificacion a y b,2002-09-01,118,20,118,20,138
51203,PORCO,estado nutricional en menores de 5 anos,clasificacion a y b,2002-09-01,13,1,13,1,14
10103,POROMA,estado nutricional en menores de 5 anos,clasificacion a y b,2002-09-01,48,6,48,6,54
70103,PORONGO,estado nutricional en menores de 5 anos,clasificacion a y b,2002-09-01,8,3,8,3,11
70601,PORTACHUELO,estado nutricional en menores de 5 anos,clasificacion a y b,2002-09-01,62,18,62,18,80
90102,PORVENIR,estado nutricional en menores de 5 anos,clasificacion a y b,2002-09-01,11,2,11,2,13
70804,POSTRER VALLE,estado nutricional en menores de 5 anos,clasificacion a y b,2002-09-01,1,4,1,4,5
50101,POTOSI,estado nutricional en menores de 5 anos,clasificacion a y b,2002-09-01,167,22,167,22,189
10302,PRESTO,estado nutricional en menores de 5 anos,clasificacion a y b,2002-09-01,21,5,21,5,26
70805,PUCARA,estado nutricional en menores de 5 anos,clasificacion a y b,2002-09-01,1,0,1,0,1
21201,PUCARANI,estado nutricional en menores de 5 anos,clasificacion a y b,2002-09-01,21,6,21,6,27
20401,PUERTO ACOSTA,estado nutricional en menores de 5 anos,clasificacion a y b,2002-09-01,64,61,64,61,125
20403,PUERTO CARABUCO,estado nutricional en menores de 5 anos,clasificacion a y b,2002-09-01,17,4,17,4,21
21204,PUERTO PEREZ,estado nutricional en menores de 5 anos,clasificacion a y b,2002-09-01,7,0,7,0,7
71402,PUERTO QUIJARRO,estado nutricional en menores de 5 anos,clasificacion a y b,2002-09-01,50,8,50,8,58
90201,PUERTO RICO,estado nutricional en menores de 5 anos,clasificacion a y b,2002-09-01,6,6,6,6,12
80703,PUERTO SILES,estado nutricional en menores de 5 anos,clasificacion a y b,2002-09-01,1,0,1,0,1
71401,PUERTO SUAREZ,estado nutricional en menores de 5 anos,clasificacion a y b,2002-09-01,31,5,31,5,36
31205,PUERTO VILLARROEL,estado nutricional en menores de 5 anos,clasificacion a y b,2002-09-01,148,38,148,38,186
51101,PUNA,estado nutricional en menores de 5 anos,clasificacion a y b,2002-09-01,46,39,46,39,85
31401,PUNATA,estado nutricional en menores de 5 anos,clasificacion a y b,2002-09-01,16,2,16,2,18
20604,QUIABAYA,estado nutricional en menores de 5 anos,clasificacion a y b,2002-09-01,12,0,12,0,12
30901,QUILLACOLLO,estado nutricional en menores de 5 anos,clasificacion a y b,2002-09-01,42,24,42,24,66
21002,QUIME,estado nutricional en menores de 5 anos,clasificacion a y b,2002-09-01,15,2,15,2,17
70904,QUIRUSILLAS,estado nutricional en menores de 5 anos,clasificacion a y b,2002-09-01,3,4,3,4,7
50402,RAVELO,estado nutricional en menores de 5 anos,clasificacion a y b,2002-09-01,23,8,23,8,31
80301,REYES,estado nutricional en menores de 5 anos,clasificacion a y b,2002-09-01,25,7,25,7,32
80201,RIBERALTA,estado nutricional en menores de 5 anos,clasificacion a y b,2002-09-01,227,44,227,44,271
70503,ROBORE,estado nutricional en menores de 5 anos,clasificacion a y b,2002-09-01,39,7,39,7,46
80304,RURRENABAQUE,estado nutricional en menores de 5 anos,clasificacion a y b,2002-09-01,4,5,4,5,9
31001,SACABA,estado nutricional en menores de 5 anos,clasificacion a y b,2002-09-01,126,7,126,7,133
30404,SACABAMBA,estado nutricional en menores de 5 anos,clasificacion a y b,2002-09-01,0,5,0,5,5
50701,SACACA,estado nutricional en menores de 5 anos,clasificacion a y b,2002-09-01,26,17,26,17,43
71302,SAIPINA,estado nutricional en menores de 5 anos,clasificacion a y b,2002-09-01,22,25,22,25,47
40801,SALINAS DE GARCI MENDOZA,estado nutricional en menores de 5 anos,clasificacion a y b,2002-09-01,2,3,2,3,5
70901,SAMAIPATA,estado nutricional en menores de 5 anos,clasificacion a y b,2002-09-01,23,9,23,9,32
51601,SAN AGUSTIN,estado nutricional en menores de 5 anos,clasificacion a y b,2002-09-01,6,0,6,0,6
80602,SAN ANDRES,estado nutricional en menores de 5 anos,clasificacion a y b,2002-09-01,3,8,3,8,11
51003,SAN ANTONIO DE ESMORUCO,estado nutricional en menores de 5 anos,clasificacion a y b,2002-09-01,1,0,1,0,1
71105,SAN ANTONIO DE LOMERIO,estado nutricional en menores de 5 anos,clasificacion a y b,2002-09-01,16,7,16,7,23
31403,SAN BENITO,estado nutricional en menores de 5 anos,clasificacion a y b,2002-09-01,8,1,8,1,9
80302,SAN BORJA,estado nutricional en menores de 5 anos,clasificacion a y b,2002-09-01,72,22,72,22,94
21502,SAN BUENA VENTURA,estado nutricional en menores de 5 anos,clasificacion a y b,2002-09-01,21,5,21,5,26
70402,SAN CARLOS,estado nutricional en menores de 5 anos,clasificacion a y b,2002-09-01,75,19,75,19,94
80501,SAN IGNACIO,estado nutricional en menores de 5 anos,clasificacion a y b,2002-09-01,65,42,65,42,107
70301,SAN IGNACIO DE VELASCO,estado nutricional en menores de 5 anos,clasificacion a y b,2002-09-01,175,17,175,17,192
80102,SAN JAVIER(BNI),estado nutricional en menores de 5 anos,clasificacion a y b,2002-09-01,0,10,0,10,10
71102,SAN JAVIER(STC),estado nutricional en menores de 5 anos,clasificacion a y b,2002-09-01,21,1,21,1,22
80701,SAN JOAQUIN,estado nutricional en menores de 5 anos,clasificacion a y b,2002-09-01,4,32,4,32,36
70501,SAN JOSE DE CHIQUITOS,estado nutricional en menores de 5 anos,clasificacion a y b,2002-09-01,20,5,20,5,25
71104,SAN JULIAN,estado nutricional en menores de 5 anos,clasificacion a y b,2002-09-01,124,37,124,37,161
90302,SAN LORENZO(PND),estado nutricional en menores de 5 anos,clasificacion a y b,2002-09-01,3,2,3,2,5
60501,SAN LORENZO(TJA),estado nutricional en menores de 5 anos,clasificacion a y b,2002-09-01,8,1,8,1,9
10702,SAN LUCAS,estado nutricional en menores de 5 anos,clasificacion a y b,2002-09-01,50,21,50,21,71
71201,SAN MATIAS,estado nutricional en menores de 5 anos,clasificacion a y b,2002-09-01,48,6,48,6,54
70302,SAN MIGUEL DE VELASCO,estado nutricional en menores de 5 anos,clasificacion a y b,2002-09-01,27,3,27,3,30
51001,SAN PABLO DE LIPEZ,estado nutricional en menores de 5 anos,clasificacion a y b,2002-09-01,2,3,2,3,5
50501,SAN PEDRO DE BUENA VISTA,estado nutricional en menores de 5 anos,clasificacion a y b,2002-09-01,12,11,12,11,23
21801,SAN PEDRO DE CURAHUARA,estado nutricional en menores de 5 anos,clasificacion a y b,2002-09-01,2,0,2,0,2
50902,SAN PEDRO DE QUEMES,estado nutricional en menores de 5 anos,clasificacion a y b,2002-09-01,1,0,1,0,1
21702,SAN PEDRO DE TIQUINA,estado nutricional en menores de 5 anos,clasificacion a y b,2002-09-01,7,7,7,7,14
70303,SAN RAFAEL,estado nutricional en menores de 5 anos,clasificacion a y b,2002-09-01,12,1,12,1,13
80702,SAN RAMON,estado nutricional en menores de 5 anos,clasificacion a y b,2002-09-01,24,6,24,6,30
80401,SANTA ANA,estado nutricional en menores de 5 anos,clasificacion a y b,2002-09-01,10,6,10,6,16
70101,SANTA CRUZ DE LA SIERRA,estado nutricional en menores de 5 anos,clasificacion a y b,2002-09-01,1376,555,1376,555,1931
80303,SANTA ROSA,estado nutricional en menores de 5 anos,clasificacion a y b,2002-09-01,13,0,13,0,13
70602,SANTA ROSA DEL SARA,estado nutricional en menores de 5 anos,clasificacion a y b,2002-09-01,14,13,14,13,27
20308,SANTIAGO DE CALLAPA,estado nutricional en menores de 5 anos,clasificacion a y b,2002-09-01,5,2,5,2,7
41401,SANTIAGO DE HUARI,estado nutricional en menores de 5 anos,clasificacion a y b,2002-09-01,13,2,13,2,15
21901,SANTIAGO DE MACHACA,estado nutricional en menores de 5 anos,clasificacion a y b,2002-09-01,5,2,5,2,7
30702,SANTIVAÃ‘ES,estado nutricional en menores de 5 anos,clasificacion a y b,2002-09-01,9,1,9,1,10
40202,SANTUARIO DE QUILLACAS,estado nutricional en menores de 5 anos,clasificacion a y b,2002-09-01,1,0,1,0,1
20902,SAPAHAQUI,estado nutricional en menores de 5 anos,clasificacion a y b,2002-09-01,2,0,2,0,2
90303,SENA,estado nutricional en menores de 5 anos,clasificacion a y b,2002-09-01,3,4,3,4,7
21301,SICA SICA (VILLA AROMA),estado nutricional en menores de 5 anos,clasificacion a y b,2002-09-01,18,5,18,5,23
30703,SICAYA,estado nutricional en menores de 5 anos,clasificacion a y b,2002-09-01,3,0,3,0,3
30902,SIPE SIPE,estado nutricional en menores de 5 anos,clasificacion a y b,2002-09-01,159,78,159,78,237
10403,SOPACHUY,estado nutricional en menores de 5 anos,clasificacion a y b,2002-09-01,15,1,15,1,16
20601,SORATA,estado nutricional en menores de 5 anos,clasificacion a y b,2002-09-01,16,27,16,27,43
10101,SUCRE,estado nutricional en menores de 5 anos,clasificacion a y b,2002-09-01,303,97,303,97,400
31404,TACACHI,estado nutricional en menores de 5 anos,clasificacion a y b,2002-09-01,1,0,1,0,1
20603,TACACOMA,estado nutricional en menores de 5 anos,clasificacion a y b,2002-09-01,9,5,9,5,14
50303,TACOBAMBA,estado nutricional en menores de 5 anos,clasificacion a y b,2002-09-01,19,3,19,3,22
30602,TACOPAYA,estado nutricional en menores de 5 anos,clasificacion a y b,2002-09-01,14,21,14,21,35
31101,TAPACARI,estado nutricional en menores de 5 anos,clasificacion a y b,2002-09-01,15,7,15,7,22
10601,TARABUCO,estado nutricional en menores de 5 anos,clasificacion a y b,2002-09-01,44,10,44,10,54
30401,TARATA,estado nutricional en menores de 5 anos,clasificacion a y b,2002-09-01,16,8,16,8,24
60101,TARIJA,estado nutricional en menores de 5 anos,clasificacion a y b,2002-09-01,307,152,307,152,459
10202,TARVITA,estado nutricional en menores de 5 anos,clasificacion a y b,2002-09-01,23,10,23,10,33
20803,TIAWANACU,estado nutricional en menores de 5 anos,clasificacion a y b,2002-09-01,9,4,9,4,13
50102,TINGUIPAYA,estado nutricional en menores de 5 anos,clasificacion a y b,2002-09-01,13,8,13,8,21
20606,TIPUANI,estado nutricional en menores de 5 anos,clasificacion a y b,2002-09-01,39,8,39,8,47
30903,TIQUIPAYA,estado nutricional en menores de 5 anos,clasificacion a y b,2002-09-01,10,4,10,4,14
31601,TIRAQUE (CBBA),estado nutricional en menores de 5 anos,clasificacion a y b,2002-09-01,98,59,98,59,157
30802,TOCO,estado nutricional en menores de 5 anos,clasificacion a y b,2002-09-01,0,1,0,1,1
30803,TOLATA,estado nutricional en menores de 5 anos,clasificacion a y b,2002-09-01,1,0,1,0,1
41001,TOLEDO,estado nutricional en menores de 5 anos,clasificacion a y b,2002-09-01,2,6,2,6,8
51202,TOMAVE,estado nutricional en menores de 5 anos,clasificacion a y b,2002-09-01,12,11,12,11,23
10402,TOMINA,estado nutricional en menores de 5 anos,clasificacion a y b,2002-09-01,31,7,31,7,38
50502,TORO TORO,estado nutricional en menores de 5 anos,clasificacion a y b,2002-09-01,19,2,19,2,21
31201,TOTORA(CBBA),estado nutricional en menores de 5 anos,clasificacion a y b,2002-09-01,25,6,25,6,31
41301,TOTORA(ORR),estado nutricional en menores de 5 anos,clasificacion a y b,2002-09-01,1,4,1,4,5
70802,TRIGAL,estado nutricional en menores de 5 anos,clasificacion a y b,2002-09-01,5,0,5,0,5
80101,TRINIDAD,estado nutricional en menores de 5 anos,clasificacion a y b,2002-09-01,26,430,26,430,456
50801,TUPIZA,estado nutricional en menores de 5 anos,clasificacion a y b,2002-09-01,104,65,104,65,169
40402,TURCO,estado nutricional en menores de 5 anos,clasificacion a y b,2002-09-01,1,4,1,4,5
21302,UMALA,estado nutricional en menores de 5 anos,clasificacion a y b,2002-09-01,7,1,7,1,8
60401,URIONDO (A. CONCEPCION),estado nutricional en menores de 5 anos,clasificacion a y b,2002-09-01,14,3,14,3,17
71502,URUBICHA,estado nutricional en menores de 5 anos,clasificacion a y b,2002-09-01,1,0,1,0,1
51201,UYUNI,estado nutricional en menores de 5 anos,clasificacion a y b,2002-09-01,54,12,54,12,66
30502,VACAS,estado nutricional en menores de 5 anos,clasificacion a y b,2002-09-01,1,1,1,1,2
70801,VALLEGRANDE,estado nutricional en menores de 5 anos,clasificacion a y b,2002-09-01,47,19,47,19,66
20801,VIACHA,estado nutricional en menores de 5 anos,clasificacion a y b,2002-09-01,46,28,46,28,74
60303,VILLA MONTES,estado nutricional en menores de 5 anos,clasificacion a y b,2002-09-01,32,18,32,18,50
31402,VILLA RIVERO,estado nutricional en menores de 5 anos,clasificacion a y b,2002-09-01,3,2,3,2,5
10801,VILLA SERRANO,estado nutricional en menores de 5 anos,clasificacion a y b,2002-09-01,31,9,31,9,40
31003,VILLA TUNARI,estado nutricional en menores de 5 anos,clasificacion a y b,2002-09-01,94,24,94,24,118
11001,VILLA VACA GUZMAN (MUYUPAMPA),estado nutricional en menores de 5 anos,clasificacion a y b,2002-09-01,51,24,51,24,75
51501,VILLAZON,estado nutricional en menores de 5 anos,clasificacion a y b,2002-09-01,66,30,66,30,96
30904,VINTO,estado nutricional en menores de 5 anos,clasificacion a y b,2002-09-01,36,13,36,13,49
50602,VITICHI,estado nutricional en menores de 5 anos,clasificacion a y b,2002-09-01,5,6,5,6,11
20306,WALDO BALLIVIAN,estado nutricional en menores de 5 anos,clasificacion a y b,2002-09-01,0,1,0,1,1
70201,WARNES,estado nutricional en menores de 5 anos,clasificacion a y b,2002-09-01,112,26,112,26,138
20903,YACO,estado nutricional en menores de 5 anos,clasificacion a y b,2002-09-01,3,3,3,3,6
60301,YACUIBA,estado nutricional en menores de 5 anos,clasificacion a y b,2002-09-01,156,53,156,53,209
10602,YAMPARAEZ,estado nutricional en menores de 5 anos,clasificacion a y b,2002-09-01,31,7,31,7,38
21103,YANACACHI,estado nutricional en menores de 5 anos,clasificacion a y b,2002-09-01,13,1,13,1,14
70403,YAPACANI,estado nutricional en menores de 5 anos,clasificacion a y b,2002-09-01,123,21,123,21,144
50103,YOCALLA,estado nutricional en menores de 5 anos,clasificacion a y b,2002-09-01,6,1,6,1,7
10102,YOTALA,estado nutricional en menores de 5 anos,clasificacion a y b,2002-09-01,34,9,34,9,43
60402,YUNCHARA,estado nutricional en menores de 5 anos,clasificacion a y b,2002-09-01,10,9,10,9,19
10301,ZUDAÃ‘EZ,estado nutricional en menores de 5 anos,clasificacion a y b,2002-09-01,20,1,20,1,21
51302,ACACIO,estado nutricional en menores de 5 anos,clasificacion a y b,2002-10-01,0,1,0,1,1
20201,ACHACACHI,estado nutricional en menores de 5 anos,clasificacion a y b,2002-10-01,142,179,142,179,321
20104,ACHOCALLA,estado nutricional en menores de 5 anos,clasificacion a y b,2002-10-01,22,5,22,5,27
30201,AIQUILE,estado nutricional en menores de 5 anos,clasificacion a y b,2002-10-01,18,5,18,5,23
10404,ALCALA,estado nutricional en menores de 5 anos,clasificacion a y b,2002-10-01,8,5,8,5,13
20202,ANCORAIMES,estado nutricional en menores de 5 anos,clasificacion a y b,2002-10-01,23,6,23,6,29
30402,ANZALDO,estado nutricional en menores de 5 anos,clasificacion a y b,2002-10-01,5,5,5,5,10
20701,APOLO,estado nutricional en menores de 5 anos,clasificacion a y b,2002-10-01,31,9,31,9,40
51301,ARAMPAMPA,estado nutricional en menores de 5 anos,clasificacion a y b,2002-10-01,8,2,8,2,10
30501,ARANI,estado nutricional en menores de 5 anos,clasificacion a y b,2002-10-01,1,7,1,7,8
30403,ARBIETO,estado nutricional en menores de 5 anos,clasificacion a y b,2002-10-01,1,11,1,11,12
30601,ARQUE,estado nutricional en menores de 5 anos,clasificacion a y b,2002-10-01,2,0,2,0,2
71501,ASCENCION DE GUARAYOS,estado nutricional en menores de 5 anos,clasificacion a y b,2002-10-01,74,23,74,23,97
50802,ATOCHA,estado nutricional en menores de 5 anos,clasificacion a y b,2002-10-01,6,15,6,15,21
20503,AUCAPATA,estado nutricional en menores de 5 anos,clasificacion a y b,2002-10-01,2,2,2,2,4
20502,AYATA,estado nutricional en menores de 5 anos,clasificacion a y b,2002-10-01,5,1,5,1,6
21303,AYO AYO,estado nutricional en menores de 5 anos,clasificacion a y b,2002-10-01,27,6,27,6,33
30301,AYOPAYA (V. DE INDEPENDENCIA),estado nutricional en menores de 5 anos,clasificacion a y b,2002-10-01,16,5,16,5,21
10201,AZURDUY,estado nutricional en menores de 5 anos,clasificacion a y b,2002-10-01,35,14,35,14,49
21203,BATALLAS,estado nutricional en menores de 5 anos,clasificacion a y b,2002-10-01,29,15,29,15,44
80802,BAURES,estado nutricional en menores de 5 anos,clasificacion a y b,2002-10-01,5,3,5,3,8
50104,BELEN DE URMIRI,estado nutricional en menores de 5 anos,clasificacion a y b,2002-10-01,6,4,6,4,10
60202,BERMEJO,estado nutricional en menores de 5 anos,clasificacion a y b,2002-10-01,23,14,23,14,37
50301,BETANZOS,estado nutricional en menores de 5 anos,clasificacion a y b,2002-10-01,12,6,12,6,18
31501,BOLIVAR,estado nutricional en menores de 5 anos,clasificacion a y b,2002-10-01,8,4,8,4,12
70707,BOYUIBE,estado nutricional en menores de 5 anos,clasificacion a y b,2002-10-01,4,4,4,4,8
70703,CABEZAS,estado nutricional en menores de 5 anos,clasificacion a y b,2002-10-01,26,20,26,20,46
20905,CAIROMA,estado nutricional en menores de 5 anos,clasificacion a y b,2002-10-01,8,0,8,0,8
51102,"CAIZA ""D""",estado nutricional en menores de 5 anos,clasificacion a y b,2002-10-01,11,3,11,3,14
21003,CAJUATA,estado nutricional en menores de 5 anos,clasificacion a y b,2002-10-01,12,3,12,3,15
20303,CALACOTO,estado nutricional en menores de 5 anos,clasificacion a y b,2002-10-01,2,0,2,0,2
21304,CALAMARCA,estado nutricional en menores de 5 anos,clasificacion a y b,2002-10-01,25,4,25,4,29
10701,CAMARGO,estado nutricional en menores de 5 anos,clasificacion a y b,2002-10-01,18,12,18,12,30
10901,CAMATAQUI (C. VILLA ABECIA),estado nutricional en menores de 5 anos,clasificacion a y b,2002-10-01,11,12,11,12,23
70706,CAMIRI,estado nutricional en menores de 5 anos,clasificacion a y b,2002-10-01,147,38,147,38,185
30701,CAPINOTA,estado nutricional en menores de 5 anos,clasificacion a y b,2002-10-01,1,6,1,6,7
20302,CAQUIAVIRI,estado nutricional en menores de 5 anos,clasificacion a y b,2002-10-01,12,4,12,4,16
40102,CARACOLLO,estado nutricional en menores de 5 anos,clasificacion a y b,2002-10-01,21,25,21,25,46
22001,CARANAVI,estado nutricional en menores de 5 anos,clasificacion a y b,2002-10-01,122,35,122,35,157
60302,CARAPARI,estado nutricional en menores de 5 anos,clasificacion a y b,2002-10-01,40,13,40,13,53
50702,CARIPUYO,estado nutricional en menores de 5 anos,clasificacion a y b,2002-10-01,4,1,4,1,5
21803,CHACARILLA,estado nutricional en menores de 5 anos,clasificacion a y b,2002-10-01,4,6,4,6,10
40201,CHALLAPATA,estado nutricional en menores de 5 anos,clasificacion a y b,2002-10-01,21,9,21,9,30
50302,CHAQUI,estado nutricional en menores de 5 anos,clasificacion a y b,2002-10-01,12,1,12,1,13
70702,CHARAGUA,estado nutricional en menores de 5 anos,clasificacion a y b,2002-10-01,28,61,28,61,89
20305,CHARAÃ‘A,estado nutricional en menores de 5 anos,clasificacion a y b,2002-10-01,7,1,7,1,8
50202,CHAYANTA,estado nutricional en menores de 5 anos,clasificacion a y b,2002-10-01,6,6,6,6,12
31204,CHIMORE,estado nutricional en menores de 5 anos,clasificacion a y b,2002-10-01,18,10,18,10,28
40302,CHOQUE COTA,estado nutricional en menores de 5 anos,clasificacion a y b,2002-10-01,1,0,1,0,1
21101,CHULUMANI (V. DE LA LIBERTAD),estado nutricional en menores de 5 anos,clasificacion a y b,2002-10-01,5,7,5,7,12
20501,CHUMA,estado nutricional en menores de 5 anos,clasificacion a y b,2002-10-01,15,2,15,2,17
30801,CLIZA,estado nutricional en menores de 5 anos,clasificacion a y b,2002-10-01,10,15,10,15,25
90101,COBIJA,estado nutricional en menores de 5 anos,clasificacion a y b,2002-10-01,101,13,101,13,114
30101,COCHABAMBA,estado nutricional en menores de 5 anos,clasificacion a y b,2002-10-01,1665,1258,1665,1258,2923
30905,COLCAPIRHUA,estado nutricional en menores de 5 anos,clasificacion a y b,2002-10-01,36,9,36,9,45
50901,"COLCHA ""K""",estado nutricional en menores de 5 anos,clasificacion a y b,2002-10-01,25,10,25,10,35
21307,COLLANA,estado nutricional en menores de 5 anos,clasificacion a y b,2002-10-01,3,0,3,0,3
31002,COLOMI,estado nutricional en menores de 5 anos,clasificacion a y b,2002-10-01,18,12,18,12,30
50401,COLQUECHACA,estado nutricional en menores de 5 anos,clasificacion a y b,2002-10-01,15,8,15,8,23
21306,COLQUENCHA,estado nutricional en menores de 5 anos,clasificacion a y b,2002-10-01,20,12,20,12,32
21004,COLQUIRI,estado nutricional en menores de 5 anos,clasificacion a y b,2002-10-01,31,7,31,7,38
20304,COMANCHE,estado nutricional en menores de 5 anos,clasificacion a y b,2002-10-01,5,0,5,0,5
71301,COMARAPA,estado nutricional en menores de 5 anos,clasificacion a y b,2002-10-01,91,21,91,21,112
20605,COMBAYA,estado nutricional en menores de 5 anos,clasificacion a y b,2002-10-01,3,0,3,0,3
71101,CONCEPCION,estado nutricional en menores de 5 anos,clasificacion a y b,2002-10-01,6,1,6,1,7
21701,COPACABANA,estado nutricional en menores de 5 anos,clasificacion a y b,2002-10-01,21,2,21,2,23
21402,CORIPATA,estado nutricional en menores de 5 anos,clasificacion a y b,2002-10-01,44,9,44,9,53
20301,CORO CORO,estado nutricional en menores de 5 anos,clasificacion a y b,2002-10-01,12,2,12,2,14
21401,COROICO,estado nutricional en menores de 5 anos,clasificacion a y b,2002-10-01,9,3,9,3,12
40301,CORQUE,estado nutricional en menores de 5 anos,clasificacion a y b,2002-10-01,4,1,4,1,5
50601,COTAGAITA,estado nutricional en menores de 5 anos,clasificacion a y b,2002-10-01,38,28,38,28,66
70102,COTOCA,estado nutricional en menores de 5 anos,clasificacion a y b,2002-10-01,121,16,121,16,137
70704,CUEVO,estado nutricional en menores de 5 anos,clasificacion a y b,2002-10-01,18,4,18,4,22
10902,CULPINA,estado nutricional en menores de 5 anos,clasificacion a y b,2002-10-01,38,6,38,6,44
40401,CURAHUARA DE CARANGAS,estado nutricional en menores de 5 anos,clasificacion a y b,2002-10-01,3,5,3,5,8
21602,CURVA,estado nutricional en menores de 5 anos,clasificacion a y b,2002-10-01,1,0,1,0,1
20804,DESAGUADERO,estado nutricional en menores de 5 anos,clasificacion a y b,2002-10-01,8,2,8,2,10
20105,EL ALTO,estado nutricional en menores de 5 anos,clasificacion a y b,2002-10-01,753,225,753,225,978
40103,EL CHORO,estado nutricional en menores de 5 anos,clasificacion a y b,2002-10-01,10,4,10,4,14
71503,EL PUENTE(STC),estado nutricional en menores de 5 anos,clasificacion a y b,2002-10-01,19,17,19,17,36
60502,EL PUENTE(TJA),estado nutricional en menores de 5 anos,clasificacion a y b,2002-10-01,9,8,9,8,17
70105,EL TORNO,estado nutricional en menores de 5 anos,clasificacion a y b,2002-10-01,93,26,93,26,119
10405,EL VILLAR,estado nutricional en menores de 5 anos,clasificacion a y b,2002-10-01,11,4,11,4,15
60601,ENTRE RIOS,estado nutricional en menores de 5 anos,clasificacion a y b,2002-10-01,35,24,35,24,59
41101,EUCALIPTUS,estado nutricional en menores de 5 anos,clasificacion a y b,2002-10-01,5,1,5,1,6
90203,FILADELFIA,estado nutricional en menores de 5 anos,clasificacion a y b,2002-10-01,2,5,2,5,7
71002,GENERAL SAAVEDRA,estado nutricional en menores de 5 anos,clasificacion a y b,2002-10-01,60,77,60,77,137
21601,GRAL. J.J. PEREZ (CHARAZANI),estado nutricional en menores de 5 anos,clasificacion a y b,2002-10-01,12,5,12,5,17
20602,GUANAY,estado nutricional en menores de 5 anos,clasificacion a y b,2002-10-01,99,18,99,18,117
20802,GUAQUI,estado nutricional en menores de 5 anos,clasificacion a y b,2002-10-01,3,0,3,0,3
80202,GUAYARAMERIN,estado nutricional en menores de 5 anos,clasificacion a y b,2002-10-01,96,47,96,47,143
70705,GUTIERREZ,estado nutricional en menores de 5 anos,clasificacion a y b,2002-10-01,36,22,36,22,58
10502,HUACARETA,estado nutricional en menores de 5 anos,clasificacion a y b,2002-10-01,43,61,43,61,104
11002,HUACAYA (VILLA DE HUACAYA),estado nutricional en menores de 5 anos,clasificacion a y b,2002-10-01,5,6,5,6,11
40501,HUACHACALLA,estado nutricional en menores de 5 anos,clasificacion a y b,2002-10-01,2,2,2,2,4
40701,HUANUNI,estado nutricional en menores de 5 anos,clasificacion a y b,2002-10-01,33,9,33,9,42
80803,HUARACAJE,estado nutricional en menores de 5 anos,clasificacion a y b,2002-10-01,22,5,22,5,27
41601,HUAYLLAMARCA,estado nutricional en menores de 5 anos,clasificacion a y b,2002-10-01,1,0,1,0,1
21005,ICHOCA,estado nutricional en menores de 5 anos,clasificacion a y b,2002-10-01,10,9,10,9,19
10304,ICLA,estado nutricional en menores de 5 anos,clasificacion a y b,2002-10-01,8,8,8,8,16
10703,INCAHUASI,estado nutricional en menores de 5 anos,clasificacion a y b,2002-10-01,33,9,33,9,42
21001,INQUISIVI,estado nutricional en menores de 5 anos,clasificacion a y b,2002-10-01,15,3,15,3,18
21102,IRUPANA (VILLA DE LANZA),estado nutricional en menores de 5 anos,clasificacion a y b,2002-10-01,20,5,20,5,25
21501,IXIAMAS,estado nutricional en menores de 5 anos,clasificacion a y b,2002-10-01,19,11,19,11,30
21105,LA ASUNTA,estado nutricional en menores de 5 anos,clasificacion a y b,2002-10-01,66,7,66,7,73
70104,LA GUARDIA,estado nutricional en menores de 5 anos,clasificacion a y b,2002-10-01,98,37,98,37,135
20101,LA PAZ,estado nutricional en menores de 5 anos,clasificacion a y b,2002-10-01,681,321,681,321,1002
70701,LAGUNILLAS,estado nutricional en menores de 5 anos,clasificacion a y b,2002-10-01,26,6,26,6,32
21202,LAJA,estado nutricional en menores de 5 anos,clasificacion a y b,2002-10-01,46,7,46,7,53
10903,LAS CARRERAS,estado nutricional en menores de 5 anos,clasificacion a y b,2002-10-01,9,9,9,9,18
21006,LICOMA PAMPA,estado nutricional en menores de 5 anos,clasificacion a y b,2002-10-01,1,0,1,0,1
50203,LLALLAGUA,estado nutricional en menores de 5 anos,clasificacion a y b,2002-10-01,27,137,27,137,164
51401,LLICA,estado nutricional en menores de 5 anos,clasificacion a y b,2002-10-01,6,3,6,3,9
80601,LORETO,estado nutricional en menores de 5 anos,clasificacion a y b,2002-10-01,25,5,25,5,30
20901,LURIBAY,estado nutricional en menores de 5 anos,clasificacion a y b,2002-10-01,16,0,16,0,16
40702,MACHACAMARCA,estado nutricional en menores de 5 anos,clasificacion a y b,2002-10-01,6,3,6,3,9
11003,MACHARETI,estado nutricional en menores de 5 anos,clasificacion a y b,2002-10-01,41,25,41,25,66
80801,MAGDALENA,estado nutricional en menores de 5 anos,clasificacion a y b,2002-10-01,34,7,34,7,41
70903,MAIRANA,estado nutricional en menores de 5 anos,clasificacion a y b,2002-10-01,53,16,53,16,69
20103,MECAPACA,estado nutricional en menores de 5 anos,clasificacion a y b,2002-10-01,25,5,25,5,30
71003,MINEROS,estado nutricional en menores de 5 anos,clasificacion a y b,2002-10-01,163,49,163,49,212
31301,MIZQUE,estado nutricional en menores de 5 anos,clasificacion a y b,2002-10-01,10,14,10,14,24
20402,MOCOMOCO,estado nutricional en menores de 5 anos,clasificacion a y b,2002-10-01,24,3,24,3,27
51002,MOJINETE,estado nutricional en menores de 5 anos,clasificacion a y b,2002-10-01,1,0,1,0,1
10303,MOJOCOYA,estado nutricional en menores de 5 anos,clasificacion a y b,2002-10-01,28,22,28,22,50
10501,MONTEAGUDO,estado nutricional en menores de 5 anos,clasificacion a y b,2002-10-01,89,43,89,43,132
71001,MONTERO,estado nutricional en menores de 5 anos,clasificacion a y b,2002-10-01,413,121,413,121,534
70803,MORO MORO,estado nutricional en menores de 5 anos,clasificacion a y b,2002-10-01,4,5,4,5,9
30302,MOROCHATA,estado nutricional en menores de 5 anos,clasificacion a y b,2002-10-01,15,10,15,10,25
90401,NACEBE (SANTA ROSA DEL ABUNA),estado nutricional en menores de 5 anos,clasificacion a y b,2002-10-01,1,2,1,2,3
20307,NAZACARA DE PACAJES,estado nutricional en menores de 5 anos,clasificacion a y b,2002-10-01,2,0,2,0,2
90501,NUEVO MANOA (NUEVA ESPERANZA),estado nutricional en menores de 5 anos,clasificacion a y b,2002-10-01,1,2,1,2,3
50404,OCURI,estado nutricional en menores de 5 anos,clasificacion a y b,2002-10-01,12,10,12,10,22
70202,OKINAWA,estado nutricional en menores de 5 anos,clasificacion a y b,2002-10-01,4,7,4,7,11
30203,OMEREQUE,estado nutricional en menores de 5 anos,clasificacion a y b,2002-10-01,5,15,5,15,20
40101,ORURO,estado nutricional en menores de 5 anos,clasificacion a y b,2002-10-01,354,82,354,82,436
60201,PADCAYA,estado nutricional en menores de 5 anos,clasificacion a y b,2002-10-01,28,55,28,55,83
10401,PADILLA,estado nutricional en menores de 5 anos,clasificacion a y b,2002-10-01,43,3,43,3,46
70502,PAILON,estado nutricional en menores de 5 anos,clasificacion a y b,2002-10-01,23,17,23,17,40
20102,PALCA,estado nutricional en menores de 5 anos,clasificacion a y b,2002-10-01,9,2,9,2,11
21104,PALOS BLANCOS,estado nutricional en menores de 5 anos,clasificacion a y b,2002-10-01,45,8,45,8,53
40802,PAMPA AULLAGAS,estado nutricional en menores de 5 anos,clasificacion a y b,2002-10-01,2,0,2,0,2
70902,PAMPA GRANDE,estado nutricional en menores de 5 anos,clasificacion a y b,2002-10-01,34,5,34,5,39
21802,PAPEL PAMPA,estado nutricional en menores de 5 anos,clasificacion a y b,2002-10-01,5,1,5,1,6
30202,PASORAPA,estado nutricional en menores de 5 anos,clasificacion a y b,2002-10-01,11,2,11,2,13
21305,PATACAMAYA,estado nutricional en menores de 5 anos,clasificacion a y b,2002-10-01,26,3,26,3,29
40602,PAZÃ‘A,estado nutricional en menores de 5 anos,clasificacion a y b,2002-10-01,1,0,1,0,1
20702,PELECHUCO,estado nutricional en menores de 5 anos,clasificacion a y b,2002-10-01,3,1,3,1,4
50403,POCOATA,estado nutricional en menores de 5 anos,clasificacion a y b,2002-10-01,51,10,51,10,61
31203,POCONA,estado nutricional en menores de 5 anos,clasificacion a y b,2002-10-01,16,8,16,8,24
31202,POJO (CBBA),estado nutricional en menores de 5 anos,clasificacion a y b,2002-10-01,132,60,132,60,192
40601,POOPO,estado nutricional en menores de 5 anos,clasificacion a y b,2002-10-01,2,0,2,0,2
51203,PORCO,estado nutricional en menores de 5 anos,clasificacion a y b,2002-10-01,15,5,15,5,20
10103,POROMA,estado nutricional en menores de 5 anos,clasificacion a y b,2002-10-01,46,8,46,8,54
70103,PORONGO,estado nutricional en menores de 5 anos,clasificacion a y b,2002-10-01,3,3,3,3,6
70601,PORTACHUELO,estado nutricional en menores de 5 anos,clasificacion a y b,2002-10-01,56,17,56,17,73
70804,POSTRER VALLE,estado nutricional en menores de 5 anos,clasificacion a y b,2002-10-01,4,3,4,3,7
50101,POTOSI,estado nutricional en menores de 5 anos,clasificacion a y b,2002-10-01,203,18,203,18,221
10302,PRESTO,estado nutricional en menores de 5 anos,clasificacion a y b,2002-10-01,30,6,30,6,36
70805,PUCARA,estado nutricional en menores de 5 anos,clasificacion a y b,2002-10-01,0,1,0,1,1
21201,PUCARANI,estado nutricional en menores de 5 anos,clasificacion a y b,2002-10-01,23,8,23,8,31
20401,PUERTO ACOSTA,estado nutricional en menores de 5 anos,clasificacion a y b,2002-10-01,58,65,58,65,123
20403,PUERTO CARABUCO,estado nutricional en menores de 5 anos,clasificacion a y b,2002-10-01,23,15,23,15,38
90301,PUERTO GONZALO MORENO,estado nutricional en menores de 5 anos,clasificacion a y b,2002-10-01,1,0,1,0,1
21204,PUERTO PEREZ,estado nutricional en menores de 5 anos,clasificacion a y b,2002-10-01,7,0,7,0,7
71402,PUERTO QUIJARRO,estado nutricional en menores de 5 anos,clasificacion a y b,2002-10-01,59,12,59,12,71
90201,PUERTO RICO,estado nutricional en menores de 5 anos,clasificacion a y b,2002-10-01,8,9,8,9,17
71401,PUERTO SUAREZ,estado nutricional en menores de 5 anos,clasificacion a y b,2002-10-01,34,5,34,5,39
31205,PUERTO VILLARROEL,estado nutricional en menores de 5 anos,clasificacion a y b,2002-10-01,167,50,167,50,217
51101,PUNA,estado nutricional en menores de 5 anos,clasificacion a y b,2002-10-01,16,5,16,5,21
31401,PUNATA,estado nutricional en menores de 5 anos,clasificacion a y b,2002-10-01,23,10,23,10,33
20604,QUIABAYA,estado nutricional en menores de 5 anos,clasificacion a y b,2002-10-01,10,0,10,0,10
30901,QUILLACOLLO,estado nutricional en menores de 5 anos,clasificacion a y b,2002-10-01,139,124,139,124,263
21002,QUIME,estado nutricional en menores de 5 anos,clasificacion a y b,2002-10-01,22,12,22,12,34
70904,QUIRUSILLAS,estado nutricional en menores de 5 anos,clasificacion a y b,2002-10-01,1,2,1,2,3
50402,RAVELO,estado nutricional en menores de 5 anos,clasificacion a y b,2002-10-01,27,6,27,6,33
80301,REYES,estado nutricional en menores de 5 anos,clasificacion a y b,2002-10-01,26,5,26,5,31
80201,RIBERALTA,estado nutricional en menores de 5 anos,clasificacion a y b,2002-10-01,203,35,203,35,238
70503,ROBORE,estado nutricional en menores de 5 anos,clasificacion a y b,2002-10-01,45,9,45,9,54
80304,RURRENABAQUE,estado nutricional en menores de 5 anos,clasificacion a y b,2002-10-01,9,4,9,4,13
31001,SACABA,estado nutricional en menores de 5 anos,clasificacion a y b,2002-10-01,138,10,138,10,148
30404,SACABAMBA,estado nutricional en menores de 5 anos,clasificacion a y b,2002-10-01,5,1,5,1,6
50701,SACACA,estado nutricional en menores de 5 anos,clasificacion a y b,2002-10-01,5,1,5,1,6
71302,SAIPINA,estado nutricional en menores de 5 anos,clasificacion a y b,2002-10-01,27,26,27,26,53
40801,SALINAS DE GARCI MENDOZA,estado nutricional en menores de 5 anos,clasificacion a y b,2002-10-01,4,3,4,3,7
70901,SAMAIPATA,estado nutricional en menores de 5 anos,clasificacion a y b,2002-10-01,33,3,33,3,36
51601,SAN AGUSTIN,estado nutricional en menores de 5 anos,clasificacion a y b,2002-10-01,1,0,1,0,1
80602,SAN ANDRES,estado nutricional en menores de 5 anos,clasificacion a y b,2002-10-01,6,3,6,3,9
71105,SAN ANTONIO DE LOMERIO,estado nutricional en menores de 5 anos,clasificacion a y b,2002-10-01,17,9,17,9,26
31403,SAN BENITO,estado nutricional en menores de 5 anos,clasificacion a y b,2002-10-01,4,17,4,17,21
80302,SAN BORJA,estado nutricional en menores de 5 anos,clasificacion a y b,2002-10-01,80,32,80,32,112
21502,SAN BUENA VENTURA,estado nutricional en menores de 5 anos,clasificacion a y b,2002-10-01,16,2,16,2,18
80501,SAN IGNACIO,estado nutricional en menores de 5 anos,clasificacion a y b,2002-10-01,61,25,61,25,86
70301,SAN IGNACIO DE VELASCO,estado nutricional en menores de 5 anos,clasificacion a y b,2002-10-01,136,14,136,14,150
80102,SAN JAVIER(BNI),estado nutricional en menores de 5 anos,clasificacion a y b,2002-10-01,1,2,1,2,3
71102,SAN JAVIER(STC),estado nutricional en menores de 5 anos,clasificacion a y b,2002-10-01,53,3,53,3,56
80701,SAN JOAQUIN,estado nutricional en menores de 5 anos,clasificacion a y b,2002-10-01,4,9,4,9,13
70501,SAN JOSE DE CHIQUITOS,estado nutricional en menores de 5 anos,clasificacion a y b,2002-10-01,23,2,23,2,25
71104,SAN JULIAN,estado nutricional en menores de 5 anos,clasificacion a y b,2002-10-01,117,25,117,25,142
90302,SAN LORENZO(PND),estado nutricional en menores de 5 anos,clasificacion a y b,2002-10-01,7,4,7,4,11
60501,SAN LORENZO(TJA),estado nutricional en menores de 5 anos,clasificacion a y b,2002-10-01,11,3,11,3,14
10702,SAN LUCAS,estado nutricional en menores de 5 anos,clasificacion a y b,2002-10-01,63,13,63,13,76
71201,SAN MATIAS,estado nutricional en menores de 5 anos,clasificacion a y b,2002-10-01,34,15,34,15,49
70302,SAN MIGUEL DE VELASCO,estado nutricional en menores de 5 anos,clasificacion a y b,2002-10-01,24,5,24,5,29
51001,SAN PABLO DE LIPEZ,estado nutricional en menores de 5 anos,clasificacion a y b,2002-10-01,0,1,0,1,1
50501,SAN PEDRO DE BUENA VISTA,estado nutricional en menores de 5 anos,clasificacion a y b,2002-10-01,8,11,8,11,19
21801,SAN PEDRO DE CURAHUARA,estado nutricional en menores de 5 anos,clasificacion a y b,2002-10-01,12,0,12,0,12
21702,SAN PEDRO DE TIQUINA,estado nutricional en menores de 5 anos,clasificacion a y b,2002-10-01,6,6,6,6,12
90202,SAN PEDRO(PND),estado nutricional en menores de 5 anos,clasificacion a y b,2002-10-01,2,0,2,0,2
70303,SAN RAFAEL,estado nutricional en menores de 5 anos,clasificacion a y b,2002-10-01,12,6,12,6,18
80702,SAN RAMON,estado nutricional en menores de 5 anos,clasificacion a y b,2002-10-01,18,6,18,6,24
80702,SAN RAMON,estado nutricional en menores de 5 anos,clasificacion a y b,2002-10-01,14,3,14,3,17
80401,SANTA ANA,estado nutricional en menores de 5 anos,clasificacion a y b,2002-10-01,22,14,22,14,36
70101,SANTA CRUZ DE LA SIERRA,estado nutricional en menores de 5 anos,clasificacion a y b,2002-10-01,1811,752,1811,752,2563
80303,SANTA ROSA,estado nutricional en menores de 5 anos,clasificacion a y b,2002-10-01,8,11,8,11,19
70602,SANTA ROSA DEL SARA,estado nutricional en menores de 5 anos,clasificacion a y b,2002-10-01,19,15,19,15,34
20308,SANTIAGO DE CALLAPA,estado nutricional en menores de 5 anos,clasificacion a y b,2002-10-01,9,6,9,6,15
41401,SANTIAGO DE HUARI,estado nutricional en menores de 5 anos,clasificacion a y b,2002-10-01,8,2,8,2,10
21901,SANTIAGO DE MACHACA,estado nutricional en menores de 5 anos,clasificacion a y b,2002-10-01,5,0,5,0,5
30702,SANTIVAÃ‘ES,estado nutricional en menores de 5 anos,clasificacion a y b,2002-10-01,4,0,4,0,4
40202,SANTUARIO DE QUILLACAS,estado nutricional en menores de 5 anos,clasificacion a y b,2002-10-01,0,3,0,3,3
20902,SAPAHAQUI,estado nutricional en menores de 5 anos,clasificacion a y b,2002-10-01,8,1,8,1,9
90303,SENA,estado nutricional en menores de 5 anos,clasificacion a y b,2002-10-01,1,10,1,10,11
21301,SICA SICA (VILLA AROMA),estado nutricional en menores de 5 anos,clasificacion a y b,2002-10-01,36,9,36,9,45
30703,SICAYA,estado nutricional en menores de 5 anos,clasificacion a y b,2002-10-01,1,0,1,0,1
30902,SIPE SIPE,estado nutricional en menores de 5 anos,clasificacion a y b,2002-10-01,131,35,131,35,166
10403,SOPACHUY,estado nutricional en menores de 5 anos,clasificacion a y b,2002-10-01,12,2,12,2,14
20601,SORATA,estado nutricional en menores de 5 anos,clasificacion a y b,2002-10-01,23,3,23,3,26
10101,SUCRE,estado nutricional en menores de 5 anos,clasificacion a y b,2002-10-01,405,153,405,153,558
20603,TACACOMA,estado nutricional en menores de 5 anos,clasificacion a y b,2002-10-01,9,16,9,16,25
50303,TACOBAMBA,estado nutricional en menores de 5 anos,clasificacion a y b,2002-10-01,35,3,35,3,38
30602,TACOPAYA,estado nutricional en menores de 5 anos,clasificacion a y b,2002-10-01,12,6,12,6,18
31101,TAPACARI,estado nutricional en menores de 5 anos,clasificacion a y b,2002-10-01,24,4,24,4,28
10601,TARABUCO,estado nutricional en menores de 5 anos,clasificacion a y b,2002-10-01,34,9,34,9,43
30401,TARATA,estado nutricional en menores de 5 anos,clasificacion a y b,2002-10-01,15,4,15,4,19
60101,TARIJA,estado nutricional en menores de 5 anos,clasificacion a y b,2002-10-01,557,210,557,210,767
10202,TARVITA,estado nutricional en menores de 5 anos,clasificacion a y b,2002-10-01,27,8,27,8,35
20803,TIAWANACU,estado nutricional en menores de 5 anos,clasificacion a y b,2002-10-01,19,5,19,5,24
50102,TINGUIPAYA,estado nutricional en menores de 5 anos,clasificacion a y b,2002-10-01,26,8,26,8,34
20606,TIPUANI,estado nutricional en menores de 5 anos,clasificacion a y b,2002-10-01,32,1,32,1,33
30903,TIQUIPAYA,estado nutricional en menores de 5 anos,clasificacion a y b,2002-10-01,69,18,69,18,87
31601,TIRAQUE (CBBA),estado nutricional en menores de 5 anos,clasificacion a y b,2002-10-01,75,40,75,40,115
30802,TOCO,estado nutricional en menores de 5 anos,clasificacion a y b,2002-10-01,2,3,2,3,5
41001,TOLEDO,estado nutricional en menores de 5 anos,clasificacion a y b,2002-10-01,6,2,6,2,8
51202,TOMAVE,estado nutricional en menores de 5 anos,clasificacion a y b,2002-10-01,8,3,8,3,11
10402,TOMINA,estado nutricional en menores de 5 anos,clasificacion a y b,2002-10-01,44,5,44,5,49
50502,TORO TORO,estado nutricional en menores de 5 anos,clasificacion a y b,2002-10-01,14,4,14,4,18
31201,TOTORA(CBBA),estado nutricional en menores de 5 anos,clasificacion a y b,2002-10-01,30,5,30,5,35
41301,TOTORA(ORR),estado nutricional en menores de 5 anos,clasificacion a y b,2002-10-01,2,0,2,0,2
70802,TRIGAL,estado nutricional en menores de 5 anos,clasificacion a y b,2002-10-01,3,2,3,2,5
80101,TRINIDAD,estado nutricional en menores de 5 anos,clasificacion a y b,2002-10-01,179,149,179,149,328
50801,TUPIZA,estado nutricional en menores de 5 anos,clasificacion a y b,2002-10-01,41,66,41,66,107
40402,TURCO,estado nutricional en menores de 5 anos,clasificacion a y b,2002-10-01,5,2,5,2,7
21302,UMALA,estado nutricional en menores de 5 anos,clasificacion a y b,2002-10-01,9,1,9,1,10
60401,URIONDO (A. CONCEPCION),estado nutricional en menores de 5 anos,clasificacion a y b,2002-10-01,22,23,22,23,45
71502,URUBICHA,estado nutricional en menores de 5 anos,clasificacion a y b,2002-10-01,16,11,16,11,27
51201,UYUNI,estado nutricional en menores de 5 anos,clasificacion a y b,2002-10-01,74,11,74,11,85
30502,VACAS,estado nutricional en menores de 5 anos,clasificacion a y b,2002-10-01,3,2,3,2,5
70801,VALLEGRANDE,estado nutricional en menores de 5 anos,clasificacion a y b,2002-10-01,55,35,55,35,90
20801,VIACHA,estado nutricional en menores de 5 anos,clasificacion a y b,2002-10-01,63,30,63,30,93
31302,VILA VILA,estado nutricional en menores de 5 anos,clasificacion a y b,2002-10-01,1,6,1,6,7
60303,VILLA MONTES,estado nutricional en menores de 5 anos,clasificacion a y b,2002-10-01,61,18,61,18,79
90502,VILLA NUEVA (LOMA ALTA),estado nutricional en menores de 5 anos,clasificacion a y b,2002-10-01,1,0,1,0,1
31402,VILLA RIVERO,estado nutricional en menores de 5 anos,clasificacion a y b,2002-10-01,10,4,10,4,14
10801,VILLA SERRANO,estado nutricional en menores de 5 anos,clasificacion a y b,2002-10-01,25,3,25,3,28
31003,VILLA TUNARI,estado nutricional en menores de 5 anos,clasificacion a y b,2002-10-01,102,27,102,27,129
11001,VILLA VACA GUZMAN (MUYUPAMPA),estado nutricional en menores de 5 anos,clasificacion a y b,2002-10-01,58,6,58,6,64
51501,VILLAZON,estado nutricional en menores de 5 anos,clasificacion a y b,2002-10-01,85,28,85,28,113
30904,VINTO,estado nutricional en menores de 5 anos,clasificacion a y b,2002-10-01,102,13,102,13,115
50602,VITICHI,estado nutricional en menores de 5 anos,clasificacion a y b,2002-10-01,18,11,18,11,29
70201,WARNES,estado nutricional en menores de 5 anos,clasificacion a y b,2002-10-01,152,33,152,33,185
20903,YACO,estado nutricional en menores de 5 anos,clasificacion a y b,2002-10-01,7,5,7,5,12
60301,YACUIBA,estado nutricional en menores de 5 anos,clasificacion a y b,2002-10-01,130,46,130,46,176
10602,YAMPARAEZ,estado nutricional en menores de 5 anos,clasificacion a y b,2002-10-01,25,3,25,3,28
21103,YANACACHI,estado nutricional en menores de 5 anos,clasificacion a y b,2002-10-01,5,3,5,3,8
50103,YOCALLA,estado nutricional en menores de 5 anos,clasificacion a y b,2002-10-01,2,0,2,0,2
10102,YOTALA,estado nutricional en menores de 5 anos,clasificacion a y b,2002-10-01,38,9,38,9,47
60402,YUNCHARA,estado nutricional en menores de 5 anos,clasificacion a y b,2002-10-01,16,15,16,15,31
10301,ZUDAÃ‘EZ,estado nutricional en menores de 5 anos,clasificacion a y b,2002-10-01,25,5,25,5,30
51302,ACACIO,estado nutricional en menores de 5 anos,clasificacion a y b,2002-11-01,2,0,2,0,2
20201,ACHACACHI,estado nutricional en menores de 5 anos,clasificacion a y b,2002-11-01,132,114,132,114,246
20104,ACHOCALLA,estado nutricional en menores de 5 anos,clasificacion a y b,2002-11-01,24,1,24,1,25
30201,AIQUILE,estado nutricional en menores de 5 anos,clasificacion a y b,2002-11-01,24,13,24,13,37
31303,ALALAY,estado nutricional en menores de 5 anos,clasificacion a y b,2002-11-01,0,3,0,3,3
10404,ALCALA,estado nutricional en menores de 5 anos,clasificacion a y b,2002-11-01,12,4,12,4,16
20202,ANCORAIMES,estado nutricional en menores de 5 anos,clasificacion a y b,2002-11-01,16,7,16,7,23
30402,ANZALDO,estado nutricional en menores de 5 anos,clasificacion a y b,2002-11-01,8,12,8,12,20
20701,APOLO,estado nutricional en menores de 5 anos,clasificacion a y b,2002-11-01,50,2,50,2,52
51301,ARAMPAMPA,estado nutricional en menores de 5 anos,clasificacion a y b,2002-11-01,21,5,21,5,26
30501,ARANI,estado nutricional en menores de 5 anos,clasificacion a y b,2002-11-01,10,1,10,1,11
30403,ARBIETO,estado nutricional en menores de 5 anos,clasificacion a y b,2002-11-01,5,1,5,1,6
30601,ARQUE,estado nutricional en menores de 5 anos,clasificacion a y b,2002-11-01,0,2,0,2,2
50802,ATOCHA,estado nutricional en menores de 5 anos,clasificacion a y b,2002-11-01,5,9,5,9,14
20503,AUCAPATA,estado nutricional en menores de 5 anos,clasificacion a y b,2002-11-01,11,3,11,3,14
20502,AYATA,estado nutricional en menores de 5 anos,clasificacion a y b,2002-11-01,13,0,13,0,13
21303,AYO AYO,estado nutricional en menores de 5 anos,clasificacion a y b,2002-11-01,19,6,19,6,25
30301,AYOPAYA (V. DE INDEPENDENCIA),estado nutricional en menores de 5 anos,clasificacion a y b,2002-11-01,16,14,16,14,30
10201,AZURDUY,estado nutricional en menores de 5 anos,clasificacion a y b,2002-11-01,46,28,46,28,74
21203,BATALLAS,estado nutricional en menores de 5 anos,clasificacion a y b,2002-11-01,39,17,39,17,56
80802,BAURES,estado nutricional en menores de 5 anos,clasificacion a y b,2002-11-01,8,3,8,3,11
41202,BELEN DE ANDAMARCA,estado nutricional en menores de 5 anos,clasificacion a y b,2002-11-01,0,1,0,1,1
50104,BELEN DE URMIRI,estado nutricional en menores de 5 anos,clasificacion a y b,2002-11-01,4,1,4,1,5
60202,BERMEJO,estado nutricional en menores de 5 anos,clasificacion a y b,2002-11-01,27,20,27,20,47
50301,BETANZOS,estado nutricional en menores de 5 anos,clasificacion a y b,2002-11-01,66,11,66,11,77
31501,BOLIVAR,estado nutricional en menores de 5 anos,clasificacion a y b,2002-11-01,9,4,9,4,13
90103,BOLPEBRA,estado nutricional en menores de 5 anos,clasificacion a y b,2002-11-01,2,1,2,1,3
70707,BOYUIBE,estado nutricional en menores de 5 anos,clasificacion a y b,2002-11-01,6,3,6,3,9
70401,BUENA VISTA,estado nutricional en menores de 5 anos,clasificacion a y b,2002-11-01,50,20,50,20,70
70703,CABEZAS,estado nutricional en menores de 5 anos,clasificacion a y b,2002-11-01,26,20,26,20,46
20905,CAIROMA,estado nutricional en menores de 5 anos,clasificacion a y b,2002-11-01,6,0,6,0,6
51102,"CAIZA ""D""",estado nutricional en menores de 5 anos,clasificacion a y b,2002-11-01,29,6,29,6,35
21003,CAJUATA,estado nutricional en menores de 5 anos,clasificacion a y b,2002-11-01,19,12,19,12,31
20303,CALACOTO,estado nutricional en menores de 5 anos,clasificacion a y b,2002-11-01,4,0,4,0,4
21304,CALAMARCA,estado nutricional en menores de 5 anos,clasificacion a y b,2002-11-01,18,0,18,0,18
10701,CAMARGO,estado nutricional en menores de 5 anos,clasificacion a y b,2002-11-01,18,8,18,8,26
10901,CAMATAQUI (C. VILLA ABECIA),estado nutricional en menores de 5 anos,clasificacion a y b,2002-11-01,9,1,9,1,10
70706,CAMIRI,estado nutricional en menores de 5 anos,clasificacion a y b,2002-11-01,76,24,76,24,100
30701,CAPINOTA,estado nutricional en menores de 5 anos,clasificacion a y b,2002-11-01,9,0,9,0,9
20302,CAQUIAVIRI,estado nutricional en menores de 5 anos,clasificacion a y b,2002-11-01,18,0,18,0,18
40102,CARACOLLO,estado nutricional en menores de 5 anos,clasificacion a y b,2002-11-01,20,18,20,18,38
22001,CARANAVI,estado nutricional en menores de 5 anos,clasificacion a y b,2002-11-01,128,41,128,41,169
60302,CARAPARI,estado nutricional en menores de 5 anos,clasificacion a y b,2002-11-01,23,7,23,7,30
50702,CARIPUYO,estado nutricional en menores de 5 anos,clasificacion a y b,2002-11-01,3,1,3,1,4
21902,CATACORA,estado nutricional en menores de 5 anos,clasificacion a y b,2002-11-01,1,1,1,1,2
21803,CHACARILLA,estado nutricional en menores de 5 anos,clasificacion a y b,2002-11-01,2,0,2,0,2
40201,CHALLAPATA,estado nutricional en menores de 5 anos,clasificacion a y b,2002-11-01,7,5,7,5,12
50302,CHAQUI,estado nutricional en menores de 5 anos,clasificacion a y b,2002-11-01,8,1,8,1,9
70702,CHARAGUA,estado nutricional en menores de 5 anos,clasificacion a y b,2002-11-01,30,46,30,46,76
50202,CHAYANTA,estado nutricional en menores de 5 anos,clasificacion a y b,2002-11-01,6,5,6,5,11
31204,CHIMORE,estado nutricional en menores de 5 anos,clasificacion a y b,2002-11-01,16,9,16,9,25
40903,CHIPAYA,estado nutricional en menores de 5 anos,clasificacion a y b,2002-11-01,1,0,1,0,1
21101,CHULUMANI (V. DE LA LIBERTAD),estado nutricional en menores de 5 anos,clasificacion a y b,2002-11-01,19,10,19,10,29
20501,CHUMA,estado nutricional en menores de 5 anos,clasificacion a y b,2002-11-01,14,4,14,4,18
30801,CLIZA,estado nutricional en menores de 5 anos,clasificacion a y b,2002-11-01,12,4,12,4,16
90101,COBIJA,estado nutricional en menores de 5 anos,clasificacion a y b,2002-11-01,50,2,50,2,52
30101,COCHABAMBA,estado nutricional en menores de 5 anos,clasificacion a y b,2002-11-01,1404,1105,1404,1105,2509
40902,COIPASA,estado nutricional en menores de 5 anos,clasificacion a y b,2002-11-01,1,0,1,0,1
30905,COLCAPIRHUA,estado nutricional en menores de 5 anos,clasificacion a y b,2002-11-01,18,6,18,6,24
50901,"COLCHA ""K""",estado nutricional en menores de 5 anos,clasificacion a y b,2002-11-01,14,4,14,4,18
21307,COLLANA,estado nutricional en menores de 5 anos,clasificacion a y b,2002-11-01,1,0,1,0,1
31002,COLOMI,estado nutricional en menores de 5 anos,clasificacion a y b,2002-11-01,24,3,24,3,27
50401,COLQUECHACA,estado nutricional en menores de 5 anos,clasificacion a y b,2002-11-01,12,6,12,6,18
21306,COLQUENCHA,estado nutricional en menores de 5 anos,clasificacion a y b,2002-11-01,29,2,29,2,31
21004,COLQUIRI,estado nutricional en menores de 5 anos,clasificacion a y b,2002-11-01,19,2,19,2,21
20304,COMANCHE,estado nutricional en menores de 5 anos,clasificacion a y b,2002-11-01,3,1,3,1,4
71301,COMARAPA,estado nutricional en menores de 5 anos,clasificacion a y b,2002-11-01,78,12,78,12,90
20605,COMBAYA,estado nutricional en menores de 5 anos,clasificacion a y b,2002-11-01,5,0,5,0,5
71101,CONCEPCION,estado nutricional en menores de 5 anos,clasificacion a y b,2002-11-01,65,80,65,80,145
21701,COPACABANA,estado nutricional en menores de 5 anos,clasificacion a y b,2002-11-01,20,1,20,1,21
21402,CORIPATA,estado nutricional en menores de 5 anos,clasificacion a y b,2002-11-01,40,10,40,10,50
20301,CORO CORO,estado nutricional en menores de 5 anos,clasificacion a y b,2002-11-01,11,6,11,6,17
21401,COROICO,estado nutricional en menores de 5 anos,clasificacion a y b,2002-11-01,5,6,5,6,11
40301,CORQUE,estado nutricional en menores de 5 anos,clasificacion a y b,2002-11-01,2,0,2,0,2
50601,COTAGAITA,estado nutricional en menores de 5 anos,clasificacion a y b,2002-11-01,28,10,28,10,38
70102,COTOCA,estado nutricional en menores de 5 anos,clasificacion a y b,2002-11-01,92,27,92,27,119
31405,CUCHUMUELA (V. G. VILLARROEL),estado nutricional en menores de 5 anos,clasificacion a y b,2002-11-01,1,0,1,0,1
70704,CUEVO,estado nutricional en menores de 5 anos,clasificacion a y b,2002-11-01,19,9,19,9,28
10902,CULPINA,estado nutricional en menores de 5 anos,clasificacion a y b,2002-11-01,40,21,40,21,61
40401,CURAHUARA DE CARANGAS,estado nutricional en menores de 5 anos,clasificacion a y b,2002-11-01,2,1,2,1,3
21602,CURVA,estado nutricional en menores de 5 anos,clasificacion a y b,2002-11-01,1,0,1,0,1
20804,DESAGUADERO,estado nutricional en menores de 5 anos,clasificacion a y b,2002-11-01,4,3,4,3,7
20105,EL ALTO,estado nutricional en menores de 5 anos,clasificacion a y b,2002-11-01,733,171,733,171,904
40103,EL CHORO,estado nutricional en menores de 5 anos,clasificacion a y b,2002-11-01,3,2,3,2,5
71503,EL PUENTE(STC),estado nutricional en menores de 5 anos,clasificacion a y b,2002-11-01,19,10,19,10,29
60502,EL PUENTE(TJA),estado nutricional en menores de 5 anos,clasificacion a y b,2002-11-01,5,11,5,11,16
70105,EL TORNO,estado nutricional en menores de 5 anos,clasificacion a y b,2002-11-01,156,26,156,26,182
10405,EL VILLAR,estado nutricional en menores de 5 anos,clasificacion a y b,2002-11-01,7,3,7,3,10
60601,ENTRE RIOS,estado nutricional en menores de 5 anos,clasificacion a y b,2002-11-01,22,22,22,22,44
41101,EUCALIPTUS,estado nutricional en menores de 5 anos,clasificacion a y b,2002-11-01,10,2,10,2,12
90503,EUREKA (SANTOS MERCADO),estado nutricional en menores de 5 anos,clasificacion a y b,2002-11-01,2,1,2,1,3
80402,EXALTACION,estado nutricional en menores de 5 anos,clasificacion a y b,2002-11-01,6,10,6,10,16
71002,GENERAL SAAVEDRA,estado nutricional en menores de 5 anos,clasificacion a y b,2002-11-01,72,33,72,33,105
21601,GRAL. J.J. PEREZ (CHARAZANI),estado nutricional en menores de 5 anos,clasificacion a y b,2002-11-01,6,26,6,26,32
20602,GUANAY,estado nutricional en menores de 5 anos,clasificacion a y b,2002-11-01,99,21,99,21,120
20802,GUAQUI,estado nutricional en menores de 5 anos,clasificacion a y b,2002-11-01,8,0,8,0,8
80202,GUAYARAMERIN,estado nutricional en menores de 5 anos,clasificacion a y b,2002-11-01,92,23,92,23,115
70705,GUTIERREZ,estado nutricional en menores de 5 anos,clasificacion a y b,2002-11-01,79,8,79,8,87
10502,HUACARETA,estado nutricional en menores de 5 anos,clasificacion a y b,2002-11-01,29,15,29,15,44
11002,HUACAYA (VILLA DE HUACAYA),estado nutricional en menores de 5 anos,clasificacion a y b,2002-11-01,4,2,4,2,6
40501,HUACHACALLA,estado nutricional en menores de 5 anos,clasificacion a y b,2002-11-01,1,7,1,7,8
40701,HUANUNI,estado nutricional en menores de 5 anos,clasificacion a y b,2002-11-01,26,3,26,3,29
80803,HUARACAJE,estado nutricional en menores de 5 anos,clasificacion a y b,2002-11-01,9,6,9,6,15
41601,HUAYLLAMARCA,estado nutricional en menores de 5 anos,clasificacion a y b,2002-11-01,2,0,2,0,2
21005,ICHOCA,estado nutricional en menores de 5 anos,clasificacion a y b,2002-11-01,10,15,10,15,25
10304,ICLA,estado nutricional en menores de 5 anos,clasificacion a y b,2002-11-01,9,5,9,5,14
10703,INCAHUASI,estado nutricional en menores de 5 anos,clasificacion a y b,2002-11-01,40,14,40,14,54
90402,INGAVI (HUMAITA),estado nutricional en menores de 5 anos,clasificacion a y b,2002-11-01,1,0,1,0,1
21001,INQUISIVI,estado nutricional en menores de 5 anos,clasificacion a y b,2002-11-01,32,6,32,6,38
21102,IRUPANA (VILLA DE LANZA),estado nutricional en menores de 5 anos,clasificacion a y b,2002-11-01,9,13,9,13,22
21501,IXIAMAS,estado nutricional en menores de 5 anos,clasificacion a y b,2002-11-01,36,8,36,8,44
21105,LA ASUNTA,estado nutricional en menores de 5 anos,clasificacion a y b,2002-11-01,34,9,34,9,43
70104,LA GUARDIA,estado nutricional en menores de 5 anos,clasificacion a y b,2002-11-01,90,36,90,36,126
20101,LA PAZ,estado nutricional en menores de 5 anos,clasificacion a y b,2002-11-01,605,250,605,250,855
70701,LAGUNILLAS,estado nutricional en menores de 5 anos,clasificacion a y b,2002-11-01,43,16,43,16,59
21202,LAJA,estado nutricional en menores de 5 anos,clasificacion a y b,2002-11-01,19,5,19,5,24
10903,LAS CARRERAS,estado nutricional en menores de 5 anos,clasificacion a y b,2002-11-01,10,3,10,3,13
50203,LLALLAGUA,estado nutricional en menores de 5 anos,clasificacion a y b,2002-11-01,12,64,12,64,76
51401,LLICA,estado nutricional en menores de 5 anos,clasificacion a y b,2002-11-01,7,3,7,3,10
80601,LORETO,estado nutricional en menores de 5 anos,clasificacion a y b,2002-11-01,15,12,15,12,27
20901,LURIBAY,estado nutricional en menores de 5 anos,clasificacion a y b,2002-11-01,19,2,19,2,21
40702,MACHACAMARCA,estado nutricional en menores de 5 anos,clasificacion a y b,2002-11-01,3,10,3,10,13
11003,MACHARETI,estado nutricional en menores de 5 anos,clasificacion a y b,2002-11-01,39,11,39,11,50
80801,MAGDALENA,estado nutricional en menores de 5 anos,clasificacion a y b,2002-11-01,15,3,15,3,18
70903,MAIRANA,estado nutricional en menores de 5 anos,clasificacion a y b,2002-11-01,55,7,55,7,62
20904,MALLA,estado nutricional en menores de 5 anos,clasificacion a y b,2002-11-01,2,1,2,1,3
20103,MECAPACA,estado nutricional en menores de 5 anos,clasificacion a y b,2002-11-01,7,3,7,3,10
71003,MINEROS,estado nutricional en menores de 5 anos,clasificacion a y b,2002-11-01,179,46,179,46,225
31301,MIZQUE,estado nutricional en menores de 5 anos,clasificacion a y b,2002-11-01,16,7,16,7,23
20402,MOCOMOCO,estado nutricional en menores de 5 anos,clasificacion a y b,2002-11-01,18,2,18,2,20
51002,MOJINETE,estado nutricional en menores de 5 anos,clasificacion a y b,2002-11-01,2,1,2,1,3
10303,MOJOCOYA,estado nutricional en menores de 5 anos,clasificacion a y b,2002-11-01,32,10,32,10,42
10501,MONTEAGUDO,estado nutricional en menores de 5 anos,clasificacion a y b,2002-11-01,94,17,94,17,111
71001,MONTERO,estado nutricional en menores de 5 anos,clasificacion a y b,2002-11-01,349,115,349,115,464
70803,MORO MORO,estado nutricional en menores de 5 anos,clasificacion a y b,2002-11-01,6,1,6,1,7
30302,MOROCHATA,estado nutricional en menores de 5 anos,clasificacion a y b,2002-11-01,29,16,29,16,45
90501,NUEVO MANOA (NUEVA ESPERANZA),estado nutricional en menores de 5 anos,clasificacion a y b,2002-11-01,3,0,3,0,3
50404,OCURI,estado nutricional en menores de 5 anos,clasificacion a y b,2002-11-01,8,13,8,13,21
70202,OKINAWA,estado nutricional en menores de 5 anos,clasificacion a y b,2002-11-01,17,0,17,0,17
30203,OMEREQUE,estado nutricional en menores de 5 anos,clasificacion a y b,2002-11-01,5,1,5,1,6
40101,ORURO,estado nutricional en menores de 5 anos,clasificacion a y b,2002-11-01,282,112,282,112,394
60201,PADCAYA,estado nutricional en menores de 5 anos,clasificacion a y b,2002-11-01,41,24,41,24,65
10401,PADILLA,estado nutricional en menores de 5 anos,clasificacion a y b,2002-11-01,59,7,59,7,66
70502,PAILON,estado nutricional en menores de 5 anos,clasificacion a y b,2002-11-01,25,3,25,3,28
20102,PALCA,estado nutricional en menores de 5 anos,clasificacion a y b,2002-11-01,9,1,9,1,10
21104,PALOS BLANCOS,estado nutricional en menores de 5 anos,clasificacion a y b,2002-11-01,47,9,47,9,56
40802,PAMPA AULLAGAS,estado nutricional en menores de 5 anos,clasificacion a y b,2002-11-01,1,0,1,0,1
70902,PAMPA GRANDE,estado nutricional en menores de 5 anos,clasificacion a y b,2002-11-01,19,3,19,3,22
21802,PAPEL PAMPA,estado nutricional en menores de 5 anos,clasificacion a y b,2002-11-01,1,0,1,0,1
30202,PASORAPA,estado nutricional en menores de 5 anos,clasificacion a y b,2002-11-01,9,1,9,1,10
21305,PATACAMAYA,estado nutricional en menores de 5 anos,clasificacion a y b,2002-11-01,30,1,30,1,31
40602,PAZÃ‘A,estado nutricional en menores de 5 anos,clasificacion a y b,2002-11-01,2,1,2,1,3
20702,PELECHUCO,estado nutricional en menores de 5 anos,clasificacion a y b,2002-11-01,1,0,1,0,1
50403,POCOATA,estado nutricional en menores de 5 anos,clasificacion a y b,2002-11-01,22,8,22,8,30
31203,POCONA,estado nutricional en menores de 5 anos,clasificacion a y b,2002-11-01,7,4,7,4,11
31202,POJO (CBBA),estado nutricional en menores de 5 anos,clasificacion a y b,2002-11-01,111,38,111,38,149
40601,POOPO,estado nutricional en menores de 5 anos,clasificacion a y b,2002-11-01,0,2,0,2,2
10103,POROMA,estado nutricional en menores de 5 anos,clasificacion a y b,2002-11-01,47,12,47,12,59
70103,PORONGO,estado nutricional en menores de 5 anos,clasificacion a y b,2002-11-01,1,1,1,1,2
70601,PORTACHUELO,estado nutricional en menores de 5 anos,clasificacion a y b,2002-11-01,84,27,84,27,111
90102,PORVENIR,estado nutricional en menores de 5 anos,clasificacion a y b,2002-11-01,6,1,6,1,7
70804,POSTRER VALLE,estado nutricional en menores de 5 anos,clasificacion a y b,2002-11-01,2,0,2,0,2
50101,POTOSI,estado nutricional en menores de 5 anos,clasificacion a y b,2002-11-01,181,19,181,19,200
10302,PRESTO,estado nutricional en menores de 5 anos,clasificacion a y b,2002-11-01,26,5,26,5,31
70805,PUCARA,estado nutricional en menores de 5 anos,clasificacion a y b,2002-11-01,2,0,2,0,2
21201,PUCARANI,estado nutricional en menores de 5 anos,clasificacion a y b,2002-11-01,16,11,16,11,27
20401,PUERTO ACOSTA,estado nutricional en menores de 5 anos,clasificacion a y b,2002-11-01,58,65,58,65,123
20403,PUERTO CARABUCO,estado nutricional en menores de 5 anos,clasificacion a y b,2002-11-01,10,4,10,4,14
90301,PUERTO GONZALO MORENO,estado nutricional en menores de 5 anos,clasificacion a y b,2002-11-01,2,0,2,0,2
21204,PUERTO PEREZ,estado nutricional en menores de 5 anos,clasificacion a y b,2002-11-01,11,0,11,0,11
71402,PUERTO QUIJARRO,estado nutricional en menores de 5 anos,clasificacion a y b,2002-11-01,52,8,52,8,60
90201,PUERTO RICO,estado nutricional en menores de 5 anos,clasificacion a y b,2002-11-01,9,8,9,8,17
80703,PUERTO SILES,estado nutricional en menores de 5 anos,clasificacion a y b,2002-11-01,1,1,1,1,2
71401,PUERTO SUAREZ,estado nutricional en menores de 5 anos,clasificacion a y b,2002-11-01,37,4,37,4,41
31205,PUERTO VILLARROEL,estado nutricional en menores de 5 anos,clasificacion a y b,2002-11-01,112,42,112,42,154
51101,PUNA,estado nutricional en menores de 5 anos,clasificacion a y b,2002-11-01,39,13,39,13,52
31401,PUNATA,estado nutricional en menores de 5 anos,clasificacion a y b,2002-11-01,9,1,9,1,10
20604,QUIABAYA,estado nutricional en menores de 5 anos,clasificacion a y b,2002-11-01,7,1,7,1,8
30901,QUILLACOLLO,estado nutricional en menores de 5 anos,clasificacion a y b,2002-11-01,72,41,72,41,113
21002,QUIME,estado nutricional en menores de 5 anos,clasificacion a y b,2002-11-01,16,6,16,6,22
70904,QUIRUSILLAS,estado nutricional en menores de 5 anos,clasificacion a y b,2002-11-01,4,1,4,1,5
50402,RAVELO,estado nutricional en menores de 5 anos,clasificacion a y b,2002-11-01,12,1,12,1,13
80301,REYES,estado nutricional en menores de 5 anos,clasificacion a y b,2002-11-01,39,4,39,4,43
80201,RIBERALTA,estado nutricional en menores de 5 anos,clasificacion a y b,2002-11-01,144,43,144,43,187
70503,ROBORE,estado nutricional en menores de 5 anos,clasificacion a y b,2002-11-01,29,12,29,12,41
80304,RURRENABAQUE,estado nutricional en menores de 5 anos,clasificacion a y b,2002-11-01,0,1,0,1,1
40901,SABAYA,estado nutricional en menores de 5 anos,clasificacion a y b,2002-11-01,3,0,3,0,3
31001,SACABA,estado nutricional en menores de 5 anos,clasificacion a y b,2002-11-01,115,9,115,9,124
30404,SACABAMBA,estado nutricional en menores de 5 anos,clasificacion a y b,2002-11-01,0,2,0,2,2
50701,SACACA,estado nutricional en menores de 5 anos,clasificacion a y b,2002-11-01,5,5,5,5,10
71302,SAIPINA,estado nutricional en menores de 5 anos,clasificacion a y b,2002-11-01,54,34,54,34,88
70901,SAMAIPATA,estado nutricional en menores de 5 anos,clasificacion a y b,2002-11-01,34,5,34,5,39
51601,SAN AGUSTIN,estado nutricional en menores de 5 anos,clasificacion a y b,2002-11-01,2,0,2,0,2
80602,SAN ANDRES,estado nutricional en menores de 5 anos,clasificacion a y b,2002-11-01,8,4,8,4,12
51003,SAN ANTONIO DE ESMORUCO,estado nutricional en menores de 5 anos,clasificacion a y b,2002-11-01,1,0,1,0,1
71105,SAN ANTONIO DE LOMERIO,estado nutricional en menores de 5 anos,clasificacion a y b,2002-11-01,12,3,12,3,15
31403,SAN BENITO,estado nutricional en menores de 5 anos,clasificacion a y b,2002-11-01,5,37,5,37,42
80302,SAN BORJA,estado nutricional en menores de 5 anos,clasificacion a y b,2002-11-01,60,47,60,47,107
21502,SAN BUENA VENTURA,estado nutricional en menores de 5 anos,clasificacion a y b,2002-11-01,25,15,25,15,40
70402,SAN CARLOS,estado nutricional en menores de 5 anos,clasificacion a y b,2002-11-01,92,22,92,22,114
80501,SAN IGNACIO,estado nutricional en menores de 5 anos,clasificacion a y b,2002-11-01,62,29,62,29,91
70301,SAN IGNACIO DE VELASCO,estado nutricional en menores de 5 anos,clasificacion a y b,2002-11-01,165,30,165,30,195
80102,SAN JAVIER(BNI),estado nutricional en menores de 5 anos,clasificacion a y b,2002-11-01,6,3,6,3,9
71102,SAN JAVIER(STC),estado nutricional en menores de 5 anos,clasificacion a y b,2002-11-01,36,4,36,4,40
70501,SAN JOSE DE CHIQUITOS,estado nutricional en menores de 5 anos,clasificacion a y b,2002-11-01,32,15,32,15,47
71104,SAN JULIAN,estado nutricional en menores de 5 anos,clasificacion a y b,2002-11-01,118,42,118,42,160
90302,SAN LORENZO(PND),estado nutricional en menores de 5 anos,clasificacion a y b,2002-11-01,4,5,4,5,9
60501,SAN LORENZO(TJA),estado nutricional en menores de 5 anos,clasificacion a y b,2002-11-01,17,4,17,4,21
10702,SAN LUCAS,estado nutricional en menores de 5 anos,clasificacion a y b,2002-11-01,51,12,51,12,63
70302,SAN MIGUEL DE VELASCO,estado nutricional en menores de 5 anos,clasificacion a y b,2002-11-01,23,4,23,4,27
51001,SAN PABLO DE LIPEZ,estado nutricional en menores de 5 anos,clasificacion a y b,2002-11-01,7,0,7,0,7
50501,SAN PEDRO DE BUENA VISTA,estado nutricional en menores de 5 anos,clasificacion a y b,2002-11-01,6,9,6,9,15
21801,SAN PEDRO DE CURAHUARA,estado nutricional en menores de 5 anos,clasificacion a y b,2002-11-01,5,0,5,0,5
21702,SAN PEDRO DE TIQUINA,estado nutricional en menores de 5 anos,clasificacion a y b,2002-11-01,8,1,8,1,9
90202,SAN PEDRO(PND),estado nutricional en menores de 5 anos,clasificacion a y b,2002-11-01,4,1,4,1,5
70303,SAN RAFAEL,estado nutricional en menores de 5 anos,clasificacion a y b,2002-11-01,19,1,19,1,20
80702,SAN RAMON,estado nutricional en menores de 5 anos,clasificacion a y b,2002-11-01,10,4,10,4,14
80702,SAN RAMON,estado nutricional en menores de 5 anos,clasificacion a y b,2002-11-01,6,2,6,2,8
80401,SANTA ANA,estado nutricional en menores de 5 anos,clasificacion a y b,2002-11-01,6,20,6,20,26
70101,SANTA CRUZ DE LA SIERRA,estado nutricional en menores de 5 anos,clasificacion a y b,2002-11-01,1607,643,1607,643,2250
80303,SANTA ROSA,estado nutricional en menores de 5 anos,clasificacion a y b,2002-11-01,34,10,34,10,44
70602,SANTA ROSA DEL SARA,estado nutricional en menores de 5 anos,clasificacion a y b,2002-11-01,7,2,7,2,9
20308,SANTIAGO DE CALLAPA,estado nutricional en menores de 5 anos,clasificacion a y b,2002-11-01,3,0,3,0,3
41401,SANTIAGO DE HUARI,estado nutricional en menores de 5 anos,clasificacion a y b,2002-11-01,11,12,11,12,23
21901,SANTIAGO DE MACHACA,estado nutricional en menores de 5 anos,clasificacion a y b,2002-11-01,10,0,10,0,10
30702,SANTIVAÃ‘ES,estado nutricional en menores de 5 anos,clasificacion a y b,2002-11-01,7,1,7,1,8
40202,SANTUARIO DE QUILLACAS,estado nutricional en menores de 5 anos,clasificacion a y b,2002-11-01,0,2,0,2,2
20902,SAPAHAQUI,estado nutricional en menores de 5 anos,clasificacion a y b,2002-11-01,10,2,10,2,12
90303,SENA,estado nutricional en menores de 5 anos,clasificacion a y b,2002-11-01,2,0,2,0,2
21301,SICA SICA (VILLA AROMA),estado nutricional en menores de 5 anos,clasificacion a y b,2002-11-01,19,7,19,7,26
30703,SICAYA,estado nutricional en menores de 5 anos,clasificacion a y b,2002-11-01,1,0,1,0,1
30902,SIPE SIPE,estado nutricional en menores de 5 anos,clasificacion a y b,2002-11-01,144,41,144,41,185
10403,SOPACHUY,estado nutricional en menores de 5 anos,clasificacion a y b,2002-11-01,17,2,17,2,19
20601,SORATA,estado nutricional en menores de 5 anos,clasificacion a y b,2002-11-01,32,13,32,13,45
10101,SUCRE,estado nutricional en menores de 5 anos,clasificacion a y b,2002-11-01,346,87,346,87,433
20603,TACACOMA,estado nutricional en menores de 5 anos,clasificacion a y b,2002-11-01,22,2,22,2,24
50303,TACOBAMBA,estado nutricional en menores de 5 anos,clasificacion a y b,2002-11-01,28,3,28,3,31
30602,TACOPAYA,estado nutricional en menores de 5 anos,clasificacion a y b,2002-11-01,9,4,9,4,13
51402,TAHUA,estado nutricional en menores de 5 anos,clasificacion a y b,2002-11-01,0,1,0,1,1
31101,TAPACARI,estado nutricional en menores de 5 anos,clasificacion a y b,2002-11-01,16,3,16,3,19
10601,TARABUCO,estado nutricional en menores de 5 anos,clasificacion a y b,2002-11-01,49,3,49,3,52
30401,TARATA,estado nutricional en menores de 5 anos,clasificacion a y b,2002-11-01,8,3,8,3,11
60101,TARIJA,estado nutricional en menores de 5 anos,clasificacion a y b,2002-11-01,269,135,269,135,404
10202,TARVITA,estado nutricional en menores de 5 anos,clasificacion a y b,2002-11-01,20,5,20,5,25
20803,TIAWANACU,estado nutricional en menores de 5 anos,clasificacion a y b,2002-11-01,25,7,25,7,32
50102,TINGUIPAYA,estado nutricional en menores de 5 anos,clasificacion a y b,2002-11-01,4,4,4,4,8
20606,TIPUANI,estado nutricional en menores de 5 anos,clasificacion a y b,2002-11-01,41,4,41,4,45
30903,TIQUIPAYA,estado nutricional en menores de 5 anos,clasificacion a y b,2002-11-01,62,11,62,11,73
31601,TIRAQUE (CBBA),estado nutricional en menores de 5 anos,clasificacion a y b,2002-11-01,76,34,76,34,110
30802,TOCO,estado nutricional en menores de 5 anos,clasificacion a y b,2002-11-01,2,1,2,1,3
30803,TOLATA,estado nutricional en menores de 5 anos,clasificacion a y b,2002-11-01,4,1,4,1,5
41001,TOLEDO,estado nutricional en menores de 5 anos,clasificacion a y b,2002-11-01,7,1,7,1,8
51202,TOMAVE,estado nutricional en menores de 5 anos,clasificacion a y b,2002-11-01,14,1,14,1,15
10402,TOMINA,estado nutricional en menores de 5 anos,clasificacion a y b,2002-11-01,35,7,35,7,42
50502,TORO TORO,estado nutricional en menores de 5 anos,clasificacion a y b,2002-11-01,6,1,6,1,7
31201,TOTORA(CBBA),estado nutricional en menores de 5 anos,clasificacion a y b,2002-11-01,15,5,15,5,20
41301,TOTORA(ORR),estado nutricional en menores de 5 anos,clasificacion a y b,2002-11-01,1,0,1,0,1
70802,TRIGAL,estado nutricional en menores de 5 anos,clasificacion a y b,2002-11-01,3,2,3,2,5
80101,TRINIDAD,estado nutricional en menores de 5 anos,clasificacion a y b,2002-11-01,126,71,126,71,197
50801,TUPIZA,estado nutricional en menores de 5 anos,clasificacion a y b,2002-11-01,34,40,34,40,74
40402,TURCO,estado nutricional en menores de 5 anos,clasificacion a y b,2002-11-01,1,0,1,0,1
21302,UMALA,estado nutricional en menores de 5 anos,clasificacion a y b,2002-11-01,4,8,4,8,12
50201,UNCIA,estado nutricional en menores de 5 anos,clasificacion a y b,2002-11-01,3,1,3,1,4
60401,URIONDO (A. CONCEPCION),estado nutricional en menores de 5 anos,clasificacion a y b,2002-11-01,25,11,25,11,36
71502,URUBICHA,estado nutricional en menores de 5 anos,clasificacion a y b,2002-11-01,2,2,2,2,4
51201,UYUNI,estado nutricional en menores de 5 anos,clasificacion a y b,2002-11-01,39,28,39,28,67
30502,VACAS,estado nutricional en menores de 5 anos,clasificacion a y b,2002-11-01,1,3,1,3,4
70801,VALLEGRANDE,estado nutricional en menores de 5 anos,clasificacion a y b,2002-11-01,49,22,49,22,71
20801,VIACHA,estado nutricional en menores de 5 anos,clasificacion a y b,2002-11-01,68,24,68,24,92
60303,VILLA MONTES,estado nutricional en menores de 5 anos,clasificacion a y b,2002-11-01,49,16,49,16,65
90502,VILLA NUEVA (LOMA ALTA),estado nutricional en menores de 5 anos,clasificacion a y b,2002-11-01,2,1,2,1,3
31402,VILLA RIVERO,estado nutricional en menores de 5 anos,clasificacion a y b,2002-11-01,14,1,14,1,15
10801,VILLA SERRANO,estado nutricional en menores de 5 anos,clasificacion a y b,2002-11-01,45,9,45,9,54
31003,VILLA TUNARI,estado nutricional en menores de 5 anos,clasificacion a y b,2002-11-01,71,20,71,20,91
11001,VILLA VACA GUZMAN (MUYUPAMPA),estado nutricional en menores de 5 anos,clasificacion a y b,2002-11-01,37,7,37,7,44
51501,VILLAZON,estado nutricional en menores de 5 anos,clasificacion a y b,2002-11-01,90,16,90,16,106
30904,VINTO,estado nutricional en menores de 5 anos,clasificacion a y b,2002-11-01,29,4,29,4,33
50602,VITICHI,estado nutricional en menores de 5 anos,clasificacion a y b,2002-11-01,17,2,17,2,19
20306,WALDO BALLIVIAN,estado nutricional en menores de 5 anos,clasificacion a y b,2002-11-01,0,1,0,1,1
70201,WARNES,estado nutricional en menores de 5 anos,clasificacion a y b,2002-11-01,138,35,138,35,173
20903,YACO,estado nutricional en menores de 5 anos,clasificacion a y b,2002-11-01,7,5,7,5,12
60301,YACUIBA,estado nutricional en menores de 5 anos,clasificacion a y b,2002-11-01,160,35,160,35,195
10602,YAMPARAEZ,estado nutricional en menores de 5 anos,clasificacion a y b,2002-11-01,33,4,33,4,37
21103,YANACACHI,estado nutricional en menores de 5 anos,clasificacion a y b,2002-11-01,10,2,10,2,12
70403,YAPACANI,estado nutricional en menores de 5 anos,clasificacion a y b,2002-11-01,53,15,53,15,68
50103,YOCALLA,estado nutricional en menores de 5 anos,clasificacion a y b,2002-11-01,13,1,13,1,14
10102,YOTALA,estado nutricional en menores de 5 anos,clasificacion a y b,2002-11-01,40,8,40,8,48
60402,YUNCHARA,estado nutricional en menores de 5 anos,clasificacion a y b,2002-11-01,21,4,21,4,25
10301,ZUDAÃ‘EZ,estado nutricional en menores de 5 anos,clasificacion a y b,2002-11-01,17,2,17,2,19
51302,ACACIO,estado nutricional en menores de 5 anos,clasificacion a y b,2002-12-01,4,4,4,4,8
20201,ACHACACHI,estado nutricional en menores de 5 anos,clasificacion a y b,2002-12-01,78,44,78,44,122
20104,ACHOCALLA,estado nutricional en menores de 5 anos,clasificacion a y b,2002-12-01,27,1,27,1,28
30201,AIQUILE,estado nutricional en menores de 5 anos,clasificacion a y b,2002-12-01,38,12,38,12,50
31303,ALALAY,estado nutricional en menores de 5 anos,clasificacion a y b,2002-12-01,1,0,1,0,1
10404,ALCALA,estado nutricional en menores de 5 anos,clasificacion a y b,2002-12-01,14,1,14,1,15
20202,ANCORAIMES,estado nutricional en menores de 5 anos,clasificacion a y b,2002-12-01,8,4,8,4,12
30402,ANZALDO,estado nutricional en menores de 5 anos,clasificacion a y b,2002-12-01,1,3,1,3,4
20701,APOLO,estado nutricional en menores de 5 anos,clasificacion a y b,2002-12-01,27,3,27,3,30
51301,ARAMPAMPA,estado nutricional en menores de 5 anos,clasificacion a y b,2002-12-01,9,0,9,0,9
30501,ARANI,estado nutricional en menores de 5 anos,clasificacion a y b,2002-12-01,3,7,3,7,10
30403,ARBIETO,estado nutricional en menores de 5 anos,clasificacion a y b,2002-12-01,4,1,4,1,5
30601,ARQUE,estado nutricional en menores de 5 anos,clasificacion a y b,2002-12-01,0,1,0,1,1
71501,ASCENCION DE GUARAYOS,estado nutricional en menores de 5 anos,clasificacion a y b,2002-12-01,2,1,2,1,3
50802,ATOCHA,estado nutricional en menores de 5 anos,clasificacion a y b,2002-12-01,1,19,1,19,20
20503,AUCAPATA,estado nutricional en menores de 5 anos,clasificacion a y b,2002-12-01,10,15,10,15,25
21303,AYO AYO,estado nutricional en menores de 5 anos,clasificacion a y b,2002-12-01,13,4,13,4,17
30301,AYOPAYA (V. DE INDEPENDENCIA),estado nutricional en menores de 5 anos,clasificacion a y b,2002-12-01,13,3,13,3,16
10201,AZURDUY,estado nutricional en menores de 5 anos,clasificacion a y b,2002-12-01,24,14,24,14,38
21203,BATALLAS,estado nutricional en menores de 5 anos,clasificacion a y b,2002-12-01,19,5,19,5,24
80802,BAURES,estado nutricional en menores de 5 anos,clasificacion a y b,2002-12-01,11,3,11,3,14
41202,BELEN DE ANDAMARCA,estado nutricional en menores de 5 anos,clasificacion a y b,2002-12-01,0,1,0,1,1
50104,BELEN DE URMIRI,estado nutricional en menores de 5 anos,clasificacion a y b,2002-12-01,1,0,1,0,1
60202,BERMEJO,estado nutricional en menores de 5 anos,clasificacion a y b,2002-12-01,28,27,28,27,55
50301,BETANZOS,estado nutricional en menores de 5 anos,clasificacion a y b,2002-12-01,32,5,32,5,37
31501,BOLIVAR,estado nutricional en menores de 5 anos,clasificacion a y b,2002-12-01,1,4,1,4,5
70707,BOYUIBE,estado nutricional en menores de 5 anos,clasificacion a y b,2002-12-01,6,8,6,8,14
70703,CABEZAS,estado nutricional en menores de 5 anos,clasificacion a y b,2002-12-01,25,10,25,10,35
20905,CAIROMA,estado nutricional en menores de 5 anos,clasificacion a y b,2002-12-01,5,4,5,4,9
51102,"CAIZA ""D""",estado nutricional en menores de 5 anos,clasificacion a y b,2002-12-01,12,5,12,5,17
21003,CAJUATA,estado nutricional en menores de 5 anos,clasificacion a y b,2002-12-01,4,2,4,2,6
20303,CALACOTO,estado nutricional en menores de 5 anos,clasificacion a y b,2002-12-01,2,0,2,0,2
21304,CALAMARCA,estado nutricional en menores de 5 anos,clasificacion a y b,2002-12-01,25,2,25,2,27
10701,CAMARGO,estado nutricional en menores de 5 anos,clasificacion a y b,2002-12-01,13,2,13,2,15
10901,CAMATAQUI (C. VILLA ABECIA),estado nutricional en menores de 5 anos,clasificacion a y b,2002-12-01,3,2,3,2,5
70706,CAMIRI,estado nutricional en menores de 5 anos,clasificacion a y b,2002-12-01,115,17,115,17,132
30701,CAPINOTA,estado nutricional en menores de 5 anos,clasificacion a y b,2002-12-01,5,1,5,1,6
20302,CAQUIAVIRI,estado nutricional en menores de 5 anos,clasificacion a y b,2002-12-01,6,3,6,3,9
40102,CARACOLLO,estado nutricional en menores de 5 anos,clasificacion a y b,2002-12-01,7,5,7,5,12
22001,CARANAVI,estado nutricional en menores de 5 anos,clasificacion a y b,2002-12-01,131,37,131,37,168
60302,CARAPARI,estado nutricional en menores de 5 anos,clasificacion a y b,2002-12-01,27,6,27,6,33
50702,CARIPUYO,estado nutricional en menores de 5 anos,clasificacion a y b,2002-12-01,3,1,3,1,4
40201,CHALLAPATA,estado nutricional en menores de 5 anos,clasificacion a y b,2002-12-01,16,4,16,4,20
50302,CHAQUI,estado nutricional en menores de 5 anos,clasificacion a y b,2002-12-01,9,0,9,0,9
70702,CHARAGUA,estado nutricional en menores de 5 anos,clasificacion a y b,2002-12-01,52,44,52,44,96
20305,CHARAÃ‘A,estado nutricional en menores de 5 anos,clasificacion a y b,2002-12-01,3,1,3,1,4
50202,CHAYANTA,estado nutricional en menores de 5 anos,clasificacion a y b,2002-12-01,8,2,8,2,10
31204,CHIMORE,estado nutricional en menores de 5 anos,clasificacion a y b,2002-12-01,9,9,9,9,18
21101,CHULUMANI (V. DE LA LIBERTAD),estado nutricional en menores de 5 anos,clasificacion a y b,2002-12-01,5,1,5,1,6
20501,CHUMA,estado nutricional en menores de 5 anos,clasificacion a y b,2002-12-01,7,1,7,1,8
30801,CLIZA,estado nutricional en menores de 5 anos,clasificacion a y b,2002-12-01,9,6,9,6,15
90101,COBIJA,estado nutricional en menores de 5 anos,clasificacion a y b,2002-12-01,131,19,131,19,150
30101,COCHABAMBA,estado nutricional en menores de 5 anos,clasificacion a y b,2002-12-01,1285,745,1285,745,2030
30905,COLCAPIRHUA,estado nutricional en menores de 5 anos,clasificacion a y b,2002-12-01,34,15,34,15,49
50901,"COLCHA ""K""",estado nutricional en menores de 5 anos,clasificacion a y b,2002-12-01,9,4,9,4,13
21307,COLLANA,estado nutricional en menores de 5 anos,clasificacion a y b,2002-12-01,2,0,2,0,2
31002,COLOMI,estado nutricional en menores de 5 anos,clasificacion a y b,2002-12-01,33,2,33,2,35
50401,COLQUECHACA,estado nutricional en menores de 5 anos,clasificacion a y b,2002-12-01,9,0,9,0,9
21306,COLQUENCHA,estado nutricional en menores de 5 anos,clasificacion a y b,2002-12-01,12,1,12,1,13
21004,COLQUIRI,estado nutricional en menores de 5 anos,clasificacion a y b,2002-12-01,20,12,20,12,32
20304,COMANCHE,estado nutricional en menores de 5 anos,clasificacion a y b,2002-12-01,1,0,1,0,1
71301,COMARAPA,estado nutricional en menores de 5 anos,clasificacion a y b,2002-12-01,73,14,73,14,87
20605,COMBAYA,estado nutricional en menores de 5 anos,clasificacion a y b,2002-12-01,5,0,5,0,5
71101,CONCEPCION,estado nutricional en menores de 5 anos,clasificacion a y b,2002-12-01,15,13,15,13,28
21701,COPACABANA,estado nutricional en menores de 5 anos,clasificacion a y b,2002-12-01,8,0,8,0,8
21402,CORIPATA,estado nutricional en menores de 5 anos,clasificacion a y b,2002-12-01,28,3,28,3,31
20301,CORO CORO,estado nutricional en menores de 5 anos,clasificacion a y b,2002-12-01,9,5,9,5,14
21401,COROICO,estado nutricional en menores de 5 anos,clasificacion a y b,2002-12-01,8,4,8,4,12
40301,CORQUE,estado nutricional en menores de 5 anos,clasificacion a y b,2002-12-01,3,1,3,1,4
50601,COTAGAITA,estado nutricional en menores de 5 anos,clasificacion a y b,2002-12-01,28,8,28,8,36
70102,COTOCA,estado nutricional en menores de 5 anos,clasificacion a y b,2002-12-01,117,29,117,29,146
70704,CUEVO,estado nutricional en menores de 5 anos,clasificacion a y b,2002-12-01,9,4,9,4,13
10902,CULPINA,estado nutricional en menores de 5 anos,clasificacion a y b,2002-12-01,37,12,37,12,49
20804,DESAGUADERO,estado nutricional en menores de 5 anos,clasificacion a y b,2002-12-01,3,0,3,0,3
20105,EL ALTO,estado nutricional en menores de 5 anos,clasificacion a y b,2002-12-01,603,145,603,145,748
40103,EL CHORO,estado nutricional en menores de 5 anos,clasificacion a y b,2002-12-01,7,3,7,3,10
71503,EL PUENTE(STC),estado nutricional en menores de 5 anos,clasificacion a y b,2002-12-01,15,21,15,21,36
60502,EL PUENTE(TJA),estado nutricional en menores de 5 anos,clasificacion a y b,2002-12-01,4,0,4,0,4
70105,EL TORNO,estado nutricional en menores de 5 anos,clasificacion a y b,2002-12-01,99,10,99,10,109
10405,EL VILLAR,estado nutricional en menores de 5 anos,clasificacion a y b,2002-12-01,13,1,13,1,14
60601,ENTRE RIOS,estado nutricional en menores de 5 anos,clasificacion a y b,2002-12-01,22,12,22,12,34
41101,EUCALIPTUS,estado nutricional en menores de 5 anos,clasificacion a y b,2002-12-01,1,0,1,0,1
80402,EXALTACION,estado nutricional en menores de 5 anos,clasificacion a y b,2002-12-01,2,2,2,2,4
71002,GENERAL SAAVEDRA,estado nutricional en menores de 5 anos,clasificacion a y b,2002-12-01,69,39,69,39,108
20602,GUANAY,estado nutricional en menores de 5 anos,clasificacion a y b,2002-12-01,45,18,45,18,63
20802,GUAQUI,estado nutricional en menores de 5 anos,clasificacion a y b,2002-12-01,1,0,1,0,1
80202,GUAYARAMERIN,estado nutricional en menores de 5 anos,clasificacion a y b,2002-12-01,140,22,140,22,162
70705,GUTIERREZ,estado nutricional en menores de 5 anos,clasificacion a y b,2002-12-01,61,7,61,7,68
10502,HUACARETA,estado nutricional en menores de 5 anos,clasificacion a y b,2002-12-01,19,7,19,7,26
11002,HUACAYA (VILLA DE HUACAYA),estado nutricional en menores de 5 anos,clasificacion a y b,2002-12-01,5,3,5,3,8
40501,HUACHACALLA,estado nutricional en menores de 5 anos,clasificacion a y b,2002-12-01,0,4,0,4,4
40701,HUANUNI,estado nutricional en menores de 5 anos,clasificacion a y b,2002-12-01,35,7,35,7,42
80803,HUARACAJE,estado nutricional en menores de 5 anos,clasificacion a y b,2002-12-01,6,1,6,1,7
21005,ICHOCA,estado nutricional en menores de 5 anos,clasificacion a y b,2002-12-01,3,2,3,2,5
10304,ICLA,estado nutricional en menores de 5 anos,clasificacion a y b,2002-12-01,12,4,12,4,16
10703,INCAHUASI,estado nutricional en menores de 5 anos,clasificacion a y b,2002-12-01,30,1,30,1,31
21001,INQUISIVI,estado nutricional en menores de 5 anos,clasificacion a y b,2002-12-01,12,4,12,4,16
21102,IRUPANA (VILLA DE LANZA),estado nutricional en menores de 5 anos,clasificacion a y b,2002-12-01,14,9,14,9,23
21501,IXIAMAS,estado nutricional en menores de 5 anos,clasificacion a y b,2002-12-01,34,14,34,14,48
21105,LA ASUNTA,estado nutricional en menores de 5 anos,clasificacion a y b,2002-12-01,19,0,19,0,19
70104,LA GUARDIA,estado nutricional en menores de 5 anos,clasificacion a y b,2002-12-01,80,27,80,27,107
20101,LA PAZ,estado nutricional en menores de 5 anos,clasificacion a y b,2002-12-01,478,124,478,124,602
70701,LAGUNILLAS,estado nutricional en menores de 5 anos,clasificacion a y b,2002-12-01,27,9,27,9,36
21202,LAJA,estado nutricional en menores de 5 anos,clasificacion a y b,2002-12-01,21,3,21,3,24
10903,LAS CARRERAS,estado nutricional en menores de 5 anos,clasificacion a y b,2002-12-01,6,4,6,4,10
50203,LLALLAGUA,estado nutricional en menores de 5 anos,clasificacion a y b,2002-12-01,14,73,14,73,87
51401,LLICA,estado nutricional en menores de 5 anos,clasificacion a y b,2002-12-01,1,0,1,0,1
80601,LORETO,estado nutricional en menores de 5 anos,clasificacion a y b,2002-12-01,9,10,9,10,19
20901,LURIBAY,estado nutricional en menores de 5 anos,clasificacion a y b,2002-12-01,10,4,10,4,14
40702,MACHACAMARCA,estado nutricional en menores de 5 anos,clasificacion a y b,2002-12-01,0,4,0,4,4
11003,MACHARETI,estado nutricional en menores de 5 anos,clasificacion a y b,2002-12-01,31,16,31,16,47
80801,MAGDALENA,estado nutricional en menores de 5 anos,clasificacion a y b,2002-12-01,9,6,9,6,15
70903,MAIRANA,estado nutricional en menores de 5 anos,clasificacion a y b,2002-12-01,25,1,25,1,26
20103,MECAPACA,estado nutricional en menores de 5 anos,clasificacion a y b,2002-12-01,7,5,7,5,12
71003,MINEROS,estado nutricional en menores de 5 anos,clasificacion a y b,2002-12-01,120,51,120,51,171
31301,MIZQUE,estado nutricional en menores de 5 anos,clasificacion a y b,2002-12-01,5,7,5,7,12
20402,MOCOMOCO,estado nutricional en menores de 5 anos,clasificacion a y b,2002-12-01,6,8,6,8,14
10303,MOJOCOYA,estado nutricional en menores de 5 anos,clasificacion a y b,2002-12-01,30,6,30,6,36
10501,MONTEAGUDO,estado nutricional en menores de 5 anos,clasificacion a y b,2002-12-01,91,40,91,40,131
71001,MONTERO,estado nutricional en menores de 5 anos,clasificacion a y b,2002-12-01,248,76,248,76,324
70803,MORO MORO,estado nutricional en menores de 5 anos,clasificacion a y b,2002-12-01,6,0,6,0,6
30302,MOROCHATA,estado nutricional en menores de 5 anos,clasificacion a y b,2002-12-01,20,434,20,434,454
90401,NACEBE (SANTA ROSA DEL ABUNA),estado nutricional en menores de 5 anos,clasificacion a y b,2002-12-01,0,1,0,1,1
90501,NUEVO MANOA (NUEVA ESPERANZA),estado nutricional en menores de 5 anos,clasificacion a y b,2002-12-01,2,0,2,0,2
50404,OCURI,estado nutricional en menores de 5 anos,clasificacion a y b,2002-12-01,9,22,9,22,31
70202,OKINAWA,estado nutricional en menores de 5 anos,clasificacion a y b,2002-12-01,22,5,22,5,27
30203,OMEREQUE,estado nutricional en menores de 5 anos,clasificacion a y b,2002-12-01,3,6,3,6,9
40101,ORURO,estado nutricional en menores de 5 anos,clasificacion a y b,2002-12-01,239,57,239,57,296
60201,PADCAYA,estado nutricional en menores de 5 anos,clasificacion a y b,2002-12-01,25,26,25,26,51
10401,PADILLA,estado nutricional en menores de 5 anos,clasificacion a y b,2002-12-01,43,5,43,5,48
70502,PAILON,estado nutricional en menores de 5 anos,clasificacion a y b,2002-12-01,6,1,6,1,7
20102,PALCA,estado nutricional en menores de 5 anos,clasificacion a y b,2002-12-01,4,2,4,2,6
21104,PALOS BLANCOS,estado nutricional en menores de 5 anos,clasificacion a y b,2002-12-01,25,5,25,5,30
40802,PAMPA AULLAGAS,estado nutricional en menores de 5 anos,clasificacion a y b,2002-12-01,2,0,2,0,2
70902,PAMPA GRANDE,estado nutricional en menores de 5 anos,clasificacion a y b,2002-12-01,23,0,23,0,23
21802,PAPEL PAMPA,estado nutricional en menores de 5 anos,clasificacion a y b,2002-12-01,3,3,3,3,6
30202,PASORAPA,estado nutricional en menores de 5 anos,clasificacion a y b,2002-12-01,7,1,7,1,8
21305,PATACAMAYA,estado nutricional en menores de 5 anos,clasificacion a y b,2002-12-01,20,7,20,7,27
40602,PAZÃ‘A,estado nutricional en menores de 5 anos,clasificacion a y b,2002-12-01,3,0,3,0,3
20702,PELECHUCO,estado nutricional en menores de 5 anos,clasificacion a y b,2002-12-01,2,1,2,1,3
50403,POCOATA,estado nutricional en menores de 5 anos,clasificacion a y b,2002-12-01,12,11,12,11,23
31203,POCONA,estado nutricional en menores de 5 anos,clasificacion a y b,2002-12-01,14,0,14,0,14
31202,POJO (CBBA),estado nutricional en menores de 5 anos,clasificacion a y b,2002-12-01,70,4,70,4,74
40601,POOPO,estado nutricional en menores de 5 anos,clasificacion a y b,2002-12-01,1,0,1,0,1
51203,PORCO,estado nutricional en menores de 5 anos,clasificacion a y b,2002-12-01,6,3,6,3,9
10103,POROMA,estado nutricional en menores de 5 anos,clasificacion a y b,2002-12-01,23,7,23,7,30
70601,PORTACHUELO,estado nutricional en menores de 5 anos,clasificacion a y b,2002-12-01,75,26,75,26,101
90102,PORVENIR,estado nutricional en menores de 5 anos,clasificacion a y b,2002-12-01,6,0,6,0,6
70804,POSTRER VALLE,estado nutricional en menores de 5 anos,clasificacion a y b,2002-12-01,2,3,2,3,5
50101,POTOSI,estado nutricional en menores de 5 anos,clasificacion a y b,2002-12-01,95,8,95,8,103
10302,PRESTO,estado nutricional en menores de 5 anos,clasificacion a y b,2002-12-01,20,2,20,2,22
21201,PUCARANI,estado nutricional en menores de 5 anos,clasificacion a y b,2002-12-01,5,7,5,7,12
20401,PUERTO ACOSTA,estado nutricional en menores de 5 anos,clasificacion a y b,2002-12-01,43,52,43,52,95
20403,PUERTO CARABUCO,estado nutricional en menores de 5 anos,clasificacion a y b,2002-12-01,20,3,20,3,23
90301,PUERTO GONZALO MORENO,estado nutricional en menores de 5 anos,clasificacion a y b,2002-12-01,1,0,1,0,1
21204,PUERTO PEREZ,estado nutricional en menores de 5 anos,clasificacion a y b,2002-12-01,1,3,1,3,4
71402,PUERTO QUIJARRO,estado nutricional en menores de 5 anos,clasificacion a y b,2002-12-01,48,1,48,1,49
90201,PUERTO RICO,estado nutricional en menores de 5 anos,clasificacion a y b,2002-12-01,12,7,12,7,19
71401,PUERTO SUAREZ,estado nutricional en menores de 5 anos,clasificacion a y b,2002-12-01,35,5,35,5,40
31205,PUERTO VILLARROEL,estado nutricional en menores de 5 anos,clasificacion a y b,2002-12-01,121,21,121,21,142
51101,PUNA,estado nutricional en menores de 5 anos,clasificacion a y b,2002-12-01,21,3,21,3,24
31401,PUNATA,estado nutricional en menores de 5 anos,clasificacion a y b,2002-12-01,46,7,46,7,53
30901,QUILLACOLLO,estado nutricional en menores de 5 anos,clasificacion a y b,2002-12-01,58,32,58,32,90
21002,QUIME,estado nutricional en menores de 5 anos,clasificacion a y b,2002-12-01,12,0,12,0,12
70904,QUIRUSILLAS,estado nutricional en menores de 5 anos,clasificacion a y b,2002-12-01,8,4,8,4,12
50402,RAVELO,estado nutricional en menores de 5 anos,clasificacion a y b,2002-12-01,17,12,17,12,29
80301,REYES,estado nutricional en menores de 5 anos,clasificacion a y b,2002-12-01,25,5,25,5,30
80201,RIBERALTA,estado nutricional en menores de 5 anos,clasificacion a y b,2002-12-01,148,14,148,14,162
70503,ROBORE,estado nutricional en menores de 5 anos,clasificacion a y b,2002-12-01,36,5,36,5,41
80304,RURRENABAQUE,estado nutricional en menores de 5 anos,clasificacion a y b,2002-12-01,12,16,12,16,28
40901,SABAYA,estado nutricional en menores de 5 anos,clasificacion a y b,2002-12-01,3,1,3,1,4
31001,SACABA,estado nutricional en menores de 5 anos,clasificacion a y b,2002-12-01,56,26,56,26,82
50701,SACACA,estado nutricional en menores de 5 anos,clasificacion a y b,2002-12-01,14,4,14,4,18
71302,SAIPINA,estado nutricional en menores de 5 anos,clasificacion a y b,2002-12-01,39,8,39,8,47
40801,SALINAS DE GARCI MENDOZA,estado nutricional en menores de 5 anos,clasificacion a y b,2002-12-01,0,3,0,3,3
70901,SAMAIPATA,estado nutricional en menores de 5 anos,clasificacion a y b,2002-12-01,31,10,31,10,41
51601,SAN AGUSTIN,estado nutricional en menores de 5 anos,clasificacion a y b,2002-12-01,1,3,1,3,4
80602,SAN ANDRES,estado nutricional en menores de 5 anos,clasificacion a y b,2002-12-01,3,0,3,0,3
71105,SAN ANTONIO DE LOMERIO,estado nutricional en menores de 5 anos,clasificacion a y b,2002-12-01,14,9,14,9,23
31403,SAN BENITO,estado nutricional en menores de 5 anos,clasificacion a y b,2002-12-01,2,5,2,5,7
80302,SAN BORJA,estado nutricional en menores de 5 anos,clasificacion a y b,2002-12-01,66,25,66,25,91
21502,SAN BUENA VENTURA,estado nutricional en menores de 5 anos,clasificacion a y b,2002-12-01,21,4,21,4,25
70402,SAN CARLOS,estado nutricional en menores de 5 anos,clasificacion a y b,2002-12-01,27,3,27,3,30
80501,SAN IGNACIO,estado nutricional en menores de 5 anos,clasificacion a y b,2002-12-01,48,6,48,6,54
70301,SAN IGNACIO DE VELASCO,estado nutricional en menores de 5 anos,clasificacion a y b,2002-12-01,159,14,159,14,173
71102,SAN JAVIER(STC),estado nutricional en menores de 5 anos,clasificacion a y b,2002-12-01,59,2,59,2,61
80701,SAN JOAQUIN,estado nutricional en menores de 5 anos,clasificacion a y b,2002-12-01,4,1,4,1,5
70501,SAN JOSE DE CHIQUITOS,estado nutricional en menores de 5 anos,clasificacion a y b,2002-12-01,13,0,13,0,13
71104,SAN JULIAN,estado nutricional en menores de 5 anos,clasificacion a y b,2002-12-01,109,45,109,45,154
60501,SAN LORENZO(TJA),estado nutricional en menores de 5 anos,clasificacion a y b,2002-12-01,39,14,39,14,53
10702,SAN LUCAS,estado nutricional en menores de 5 anos,clasificacion a y b,2002-12-01,24,5,24,5,29
70302,SAN MIGUEL DE VELASCO,estado nutricional en menores de 5 anos,clasificacion a y b,2002-12-01,21,2,21,2,23
51001,SAN PABLO DE LIPEZ,estado nutricional en menores de 5 anos,clasificacion a y b,2002-12-01,3,1,3,1,4
50501,SAN PEDRO DE BUENA VISTA,estado nutricional en menores de 5 anos,clasificacion a y b,2002-12-01,5,6,5,6,11
21801,SAN PEDRO DE CURAHUARA,estado nutricional en menores de 5 anos,clasificacion a y b,2002-12-01,6,0,6,0,6
21702,SAN PEDRO DE TIQUINA,estado nutricional en menores de 5 anos,clasificacion a y b,2002-12-01,8,0,8,0,8
70303,SAN RAFAEL,estado nutricional en menores de 5 anos,clasificacion a y b,2002-12-01,10,1,10,1,11
80702,SAN RAMON,estado nutricional en menores de 5 anos,clasificacion a y b,2002-12-01,3,0,3,0,3
80702,SAN RAMON,estado nutricional en menores de 5 anos,clasificacion a y b,2002-12-01,14,10,14,10,24
80401,SANTA ANA,estado nutricional en menores de 5 anos,clasificacion a y b,2002-12-01,11,11,11,11,22
70101,SANTA CRUZ DE LA SIERRA,estado nutricional en menores de 5 anos,clasificacion a y b,2002-12-01,1342,587,1342,587,1929
80303,SANTA ROSA,estado nutricional en menores de 5 anos,clasificacion a y b,2002-12-01,10,8,10,8,18
70602,SANTA ROSA DEL SARA,estado nutricional en menores de 5 anos,clasificacion a y b,2002-12-01,10,20,10,20,30
20308,SANTIAGO DE CALLAPA,estado nutricional en menores de 5 anos,clasificacion a y b,2002-12-01,3,0,3,0,3
41401,SANTIAGO DE HUARI,estado nutricional en menores de 5 anos,clasificacion a y b,2002-12-01,6,1,6,1,7
21901,SANTIAGO DE MACHACA,estado nutricional en menores de 5 anos,clasificacion a y b,2002-12-01,2,0,2,0,2
30702,SANTIVAÃ‘ES,estado nutricional en menores de 5 anos,clasificacion a y b,2002-12-01,1,0,1,0,1
40202,SANTUARIO DE QUILLACAS,estado nutricional en menores de 5 anos,clasificacion a y b,2002-12-01,2,0,2,0,2
20902,SAPAHAQUI,estado nutricional en menores de 5 anos,clasificacion a y b,2002-12-01,7,0,7,0,7
90303,SENA,estado nutricional en menores de 5 anos,clasificacion a y b,2002-12-01,1,0,1,0,1
21301,SICA SICA (VILLA AROMA),estado nutricional en menores de 5 anos,clasificacion a y b,2002-12-01,13,5,13,5,18
30703,SICAYA,estado nutricional en menores de 5 anos,clasificacion a y b,2002-12-01,0,1,0,1,1
30902,SIPE SIPE,estado nutricional en menores de 5 anos,clasificacion a y b,2002-12-01,113,16,113,16,129
10403,SOPACHUY,estado nutricional en menores de 5 anos,clasificacion a y b,2002-12-01,17,5,17,5,22
20601,SORATA,estado nutricional en menores de 5 anos,clasificacion a y b,2002-12-01,19,3,19,3,22
10101,SUCRE,estado nutricional en menores de 5 anos,clasificacion a y b,2002-12-01,270,49,270,49,319
31404,TACACHI,estado nutricional en menores de 5 anos,clasificacion a y b,2002-12-01,1,0,1,0,1
20603,TACACOMA,estado nutricional en menores de 5 anos,clasificacion a y b,2002-12-01,14,9,14,9,23
50303,TACOBAMBA,estado nutricional en menores de 5 anos,clasificacion a y b,2002-12-01,22,9,22,9,31
30602,TACOPAYA,estado nutricional en menores de 5 anos,clasificacion a y b,2002-12-01,2,0,2,0,2
51402,TAHUA,estado nutricional en menores de 5 anos,clasificacion a y b,2002-12-01,2,0,2,0,2
31101,TAPACARI,estado nutricional en menores de 5 anos,clasificacion a y b,2002-12-01,5,14,5,14,19
10601,TARABUCO,estado nutricional en menores de 5 anos,clasificacion a y b,2002-12-01,45,6,45,6,51
30401,TARATA,estado nutricional en menores de 5 anos,clasificacion a y b,2002-12-01,9,14,9,14,23
60101,TARIJA,estado nutricional en menores de 5 anos,clasificacion a y b,2002-12-01,287,236,287,236,523
10202,TARVITA,estado nutricional en menores de 5 anos,clasificacion a y b,2002-12-01,20,13,20,13,33
20803,TIAWANACU,estado nutricional en menores de 5 anos,clasificacion a y b,2002-12-01,18,7,18,7,25
50102,TINGUIPAYA,estado nutricional en menores de 5 anos,clasificacion a y b,2002-12-01,3,5,3,5,8
20606,TIPUANI,estado nutricional en menores de 5 anos,clasificacion a y b,2002-12-01,24,4,24,4,28
30903,TIQUIPAYA,estado nutricional en menores de 5 anos,clasificacion a y b,2002-12-01,14,18,14,18,32
31601,TIRAQUE (CBBA),estado nutricional en menores de 5 anos,clasificacion a y b,2002-12-01,94,40,94,40,134
30802,TOCO,estado nutricional en menores de 5 anos,clasificacion a y b,2002-12-01,2,4,2,4,6
41001,TOLEDO,estado nutricional en menores de 5 anos,clasificacion a y b,2002-12-01,7,0,7,0,7
51202,TOMAVE,estado nutricional en menores de 5 anos,clasificacion a y b,2002-12-01,11,1,11,1,12
10402,TOMINA,estado nutricional en menores de 5 anos,clasificacion a y b,2002-12-01,36,7,36,7,43
50502,TORO TORO,estado nutricional en menores de 5 anos,clasificacion a y b,2002-12-01,7,3,7,3,10
31201,TOTORA(CBBA),estado nutricional en menores de 5 anos,clasificacion a y b,2002-12-01,10,1,10,1,11
41301,TOTORA(ORR),estado nutricional en menores de 5 anos,clasificacion a y b,2002-12-01,3,2,3,2,5
70802,TRIGAL,estado nutricional en menores de 5 anos,clasificacion a y b,2002-12-01,6,1,6,1,7
80101,TRINIDAD,estado nutricional en menores de 5 anos,clasificacion a y b,2002-12-01,152,144,152,144,296
50801,TUPIZA,estado nutricional en menores de 5 anos,clasificacion a y b,2002-12-01,47,45,47,45,92
40402,TURCO,estado nutricional en menores de 5 anos,clasificacion a y b,2002-12-01,2,0,2,0,2
21302,UMALA,estado nutricional en menores de 5 anos,clasificacion a y b,2002-12-01,3,1,3,1,4
50201,UNCIA,estado nutricional en menores de 5 anos,clasificacion a y b,2002-12-01,3,0,3,0,3
60401,URIONDO (A. CONCEPCION),estado nutricional en menores de 5 anos,clasificacion a y b,2002-12-01,53,20,53,20,73
71502,URUBICHA,estado nutricional en menores de 5 anos,clasificacion a y b,2002-12-01,25,6,25,6,31
51201,UYUNI,estado nutricional en menores de 5 anos,clasificacion a y b,2002-12-01,46,11,46,11,57
30502,VACAS,estado nutricional en menores de 5 anos,clasificacion a y b,2002-12-01,1,7,1,7,8
70801,VALLEGRANDE,estado nutricional en menores de 5 anos,clasificacion a y b,2002-12-01,50,21,50,21,71
20801,VIACHA,estado nutricional en menores de 5 anos,clasificacion a y b,2002-12-01,60,33,60,33,93
31302,VILA VILA,estado nutricional en menores de 5 anos,clasificacion a y b,2002-12-01,0,1,0,1,1
60303,VILLA MONTES,estado nutricional en menores de 5 anos,clasificacion a y b,2002-12-01,34,17,34,17,51
31402,VILLA RIVERO,estado nutricional en menores de 5 anos,clasificacion a y b,2002-12-01,0,6,0,6,6
10801,VILLA SERRANO,estado nutricional en menores de 5 anos,clasificacion a y b,2002-12-01,28,3,28,3,31
31003,VILLA TUNARI,estado nutricional en menores de 5 anos,clasificacion a y b,2002-12-01,34,20,34,20,54
11001,VILLA VACA GUZMAN (MUYUPAMPA),estado nutricional en menores de 5 anos,clasificacion a y b,2002-12-01,61,11,61,11,72
51501,VILLAZON,estado nutricional en menores de 5 anos,clasificacion a y b,2002-12-01,71,11,71,11,82
30904,VINTO,estado nutricional en menores de 5 anos,clasificacion a y b,2002-12-01,47,10,47,10,57
50602,VITICHI,estado nutricional en menores de 5 anos,clasificacion a y b,2002-12-01,14,2,14,2,16
70201,WARNES,estado nutricional en menores de 5 anos,clasificacion a y b,2002-12-01,116,24,116,24,140
20903,YACO,estado nutricional en menores de 5 anos,clasificacion a y b,2002-12-01,3,2,3,2,5
60301,YACUIBA,estado nutricional en menores de 5 anos,clasificacion a y b,2002-12-01,169,44,169,44,213
10602,YAMPARAEZ,estado nutricional en menores de 5 anos,clasificacion a y b,2002-12-01,28,3,28,3,31
21103,YANACACHI,estado nutricional en menores de 5 anos,clasificacion a y b,2002-12-01,8,0,8,0,8
50103,YOCALLA,estado nutricional en menores de 5 anos,clasificacion a y b,2002-12-01,3,0,3,0,3
10102,YOTALA,estado nutricional en menores de 5 anos,clasificacion a y b,2002-12-01,36,12,36,12,48
60402,YUNCHARA,estado nutricional en menores de 5 anos,clasificacion a y b,2002-12-01,3,2,3,2,5
10301,ZUDAÃ‘EZ,estado nutricional en menores de 5 anos,clasificacion a y b,2002-12-01,18,3,18,3,21
51302,ACACIO,estado nutricional en menores de 5 anos,clasificacion a y b,2003-01-01,8,2,8,2,10
20201,ACHACACHI,estado nutricional en menores de 5 anos,clasificacion a y b,2003-01-01,79,63,79,63,142
20104,ACHOCALLA,estado nutricional en menores de 5 anos,clasificacion a y b,2003-01-01,9,2,9,2,11
30201,AIQUILE,estado nutricional en menores de 5 anos,clasificacion a y b,2003-01-01,31,10,31,10,41
10404,ALCALA,estado nutricional en menores de 5 anos,clasificacion a y b,2003-01-01,15,2,15,2,17
20202,ANCORAIMES,estado nutricional en menores de 5 anos,clasificacion a y b,2003-01-01,17,8,17,8,25
30402,ANZALDO,estado nutricional en menores de 5 anos,clasificacion a y b,2003-01-01,3,0,3,0,3
20701,APOLO,estado nutricional en menores de 5 anos,clasificacion a y b,2003-01-01,34,6,34,6,40
51301,ARAMPAMPA,estado nutricional en menores de 5 anos,clasificacion a y b,2003-01-01,11,2,11,2,13
30501,ARANI,estado nutricional en menores de 5 anos,clasificacion a y b,2003-01-01,2,12,2,12,14
30403,ARBIETO,estado nutricional en menores de 5 anos,clasificacion a y b,2003-01-01,5,1,5,1,6
30601,ARQUE,estado nutricional en menores de 5 anos,clasificacion a y b,2003-01-01,3,2,3,2,5
50802,ATOCHA,estado nutricional en menores de 5 anos,clasificacion a y b,2003-01-01,2,26,2,26,28
20503,AUCAPATA,estado nutricional en menores de 5 anos,clasificacion a y b,2003-01-01,0,1,0,1,1
20502,AYATA,estado nutricional en menores de 5 anos,clasificacion a y b,2003-01-01,2,0,2,0,2
21303,AYO AYO,estado nutricional en menores de 5 anos,clasificacion a y b,2003-01-01,28,3,28,3,31
30301,AYOPAYA (V. DE INDEPENDENCIA),estado nutricional en menores de 5 anos,clasificacion a y b,2003-01-01,12,0,12,0,12
10201,AZURDUY,estado nutricional en menores de 5 anos,clasificacion a y b,2003-01-01,30,2,30,2,32
21203,BATALLAS,estado nutricional en menores de 5 anos,clasificacion a y b,2003-01-01,22,2,22,2,24
80802,BAURES,estado nutricional en menores de 5 anos,clasificacion a y b,2003-01-01,11,3,11,3,14
41202,BELEN DE ANDAMARCA,estado nutricional en menores de 5 anos,clasificacion a y b,2003-01-01,1,0,1,0,1
90104,BELLA FLOR,estado nutricional en menores de 5 anos,clasificacion a y b,2003-01-01,3,1,3,1,4
60202,BERMEJO,estado nutricional en menores de 5 anos,clasificacion a y b,2003-01-01,17,16,17,16,33
50301,BETANZOS,estado nutricional en menores de 5 anos,clasificacion a y b,2003-01-01,52,13,52,13,65
31501,BOLIVAR,estado nutricional en menores de 5 anos,clasificacion a y b,2003-01-01,2,1,2,1,3
90103,BOLPEBRA,estado nutricional en menores de 5 anos,clasificacion a y b,2003-01-01,1,1,1,1,2
70707,BOYUIBE,estado nutricional en menores de 5 anos,clasificacion a y b,2003-01-01,14,32,14,32,46
70401,BUENA VISTA,estado nutricional en menores de 5 anos,clasificacion a y b,2003-01-01,48,18,48,18,66
70703,CABEZAS,estado nutricional en menores de 5 anos,clasificacion a y b,2003-01-01,46,26,46,26,72
20905,CAIROMA,estado nutricional en menores de 5 anos,clasificacion a y b,2003-01-01,5,0,5,0,5
51102,"CAIZA ""D""",estado nutricional en menores de 5 anos,clasificacion a y b,2003-01-01,22,5,22,5,27
21003,CAJUATA,estado nutricional en menores de 5 anos,clasificacion a y b,2003-01-01,35,3,35,3,38
20303,CALACOTO,estado nutricional en menores de 5 anos,clasificacion a y b,2003-01-01,2,0,2,0,2
21304,CALAMARCA,estado nutricional en menores de 5 anos,clasificacion a y b,2003-01-01,18,1,18,1,19
10701,CAMARGO,estado nutricional en menores de 5 anos,clasificacion a y b,2003-01-01,29,6,29,6,35
10901,CAMATAQUI (C. VILLA ABECIA),estado nutricional en menores de 5 anos,clasificacion a y b,2003-01-01,5,0,5,0,5
70706,CAMIRI,estado nutricional en menores de 5 anos,clasificacion a y b,2003-01-01,190,26,190,26,216
30701,CAPINOTA,estado nutricional en menores de 5 anos,clasificacion a y b,2003-01-01,6,1,6,1,7
20302,CAQUIAVIRI,estado nutricional en menores de 5 anos,clasificacion a y b,2003-01-01,7,3,7,3,10
40102,CARACOLLO,estado nutricional en menores de 5 anos,clasificacion a y b,2003-01-01,16,9,16,9,25
22001,CARANAVI,estado nutricional en menores de 5 anos,clasificacion a y b,2003-01-01,65,13,65,13,78
60302,CARAPARI,estado nutricional en menores de 5 anos,clasificacion a y b,2003-01-01,43,5,43,5,48
50702,CARIPUYO,estado nutricional en menores de 5 anos,clasificacion a y b,2003-01-01,7,3,7,3,10
21902,CATACORA,estado nutricional en menores de 5 anos,clasificacion a y b,2003-01-01,2,0,2,0,2
40201,CHALLAPATA,estado nutricional en menores de 5 anos,clasificacion a y b,2003-01-01,14,10,14,10,24
50302,CHAQUI,estado nutricional en menores de 5 anos,clasificacion a y b,2003-01-01,24,3,24,3,27
70702,CHARAGUA,estado nutricional en menores de 5 anos,clasificacion a y b,2003-01-01,69,53,69,53,122
20305,CHARAÃ‘A,estado nutricional en menores de 5 anos,clasificacion a y b,2003-01-01,1,1,1,1,2
50202,CHAYANTA,estado nutricional en menores de 5 anos,clasificacion a y b,2003-01-01,19,4,19,4,23
31204,CHIMORE,estado nutricional en menores de 5 anos,clasificacion a y b,2003-01-01,55,19,55,19,74
40302,CHOQUE COTA,estado nutricional en menores de 5 anos,clasificacion a y b,2003-01-01,3,0,3,0,3
21101,CHULUMANI (V. DE LA LIBERTAD),estado nutricional en menores de 5 anos,clasificacion a y b,2003-01-01,4,2,4,2,6
20501,CHUMA,estado nutricional en menores de 5 anos,clasificacion a y b,2003-01-01,5,0,5,0,5
30801,CLIZA,estado nutricional en menores de 5 anos,clasificacion a y b,2003-01-01,11,2,11,2,13
90101,COBIJA,estado nutricional en menores de 5 anos,clasificacion a y b,2003-01-01,116,18,116,18,134
30101,COCHABAMBA,estado nutricional en menores de 5 anos,clasificacion a y b,2003-01-01,2283,343,2283,343,2626
30905,COLCAPIRHUA,estado nutricional en menores de 5 anos,clasificacion a y b,2003-01-01,36,13,36,13,49
50901,"COLCHA ""K""",estado nutricional en menores de 5 anos,clasificacion a y b,2003-01-01,7,4,7,4,11
21307,COLLANA,estado nutricional en menores de 5 anos,clasificacion a y b,2003-01-01,2,2,2,2,4
31002,COLOMI,estado nutricional en menores de 5 anos,clasificacion a y b,2003-01-01,33,5,33,5,38
50401,COLQUECHACA,estado nutricional en menores de 5 anos,clasificacion a y b,2003-01-01,6,2,6,2,8
21306,COLQUENCHA,estado nutricional en menores de 5 anos,clasificacion a y b,2003-01-01,8,3,8,3,11
21004,COLQUIRI,estado nutricional en menores de 5 anos,clasificacion a y b,2003-01-01,25,6,25,6,31
20304,COMANCHE,estado nutricional en menores de 5 anos,clasificacion a y b,2003-01-01,1,1,1,1,2
71301,COMARAPA,estado nutricional en menores de 5 anos,clasificacion a y b,2003-01-01,76,9,76,9,85
20605,COMBAYA,estado nutricional en menores de 5 anos,clasificacion a y b,2003-01-01,2,0,2,0,2
71101,CONCEPCION,estado nutricional en menores de 5 anos,clasificacion a y b,2003-01-01,6,16,6,16,22
21701,COPACABANA,estado nutricional en menores de 5 anos,clasificacion a y b,2003-01-01,18,1,18,1,19
21402,CORIPATA,estado nutricional en menores de 5 anos,clasificacion a y b,2003-01-01,19,13,19,13,32
20301,CORO CORO,estado nutricional en menores de 5 anos,clasificacion a y b,2003-01-01,13,5,13,5,18
21401,COROICO,estado nutricional en menores de 5 anos,clasificacion a y b,2003-01-01,7,9,7,9,16
40301,CORQUE,estado nutricional en menores de 5 anos,clasificacion a y b,2003-01-01,2,1,2,1,3
50601,COTAGAITA,estado nutricional en menores de 5 anos,clasificacion a y b,2003-01-01,45,8,45,8,53
70102,COTOCA,estado nutricional en menores de 5 anos,clasificacion a y b,2003-01-01,78,6,78,6,84
31405,CUCHUMUELA (V. G. VILLARROEL),estado nutricional en menores de 5 anos,clasificacion a y b,2003-01-01,2,0,2,0,2
70704,CUEVO,estado nutricional en menores de 5 anos,clasificacion a y b,2003-01-01,18,1,18,1,19
10902,CULPINA,estado nutricional en menores de 5 anos,clasificacion a y b,2003-01-01,58,11,58,11,69
40401,CURAHUARA DE CARANGAS,estado nutricional en menores de 5 anos,clasificacion a y b,2003-01-01,1,0,1,0,1
21602,CURVA,estado nutricional en menores de 5 anos,clasificacion a y b,2003-01-01,1,0,1,0,1
20804,DESAGUADERO,estado nutricional en menores de 5 anos,clasificacion a y b,2003-01-01,7,4,7,4,11
20105,EL ALTO,estado nutricional en menores de 5 anos,clasificacion a y b,2003-01-01,821,164,821,164,985
40103,EL CHORO,estado nutricional en menores de 5 anos,clasificacion a y b,2003-01-01,9,1,9,1,10
71503,EL PUENTE(STC),estado nutricional en menores de 5 anos,clasificacion a y b,2003-01-01,13,18,13,18,31
60502,EL PUENTE(TJA),estado nutricional en menores de 5 anos,clasificacion a y b,2003-01-01,10,3,10,3,13
70105,EL TORNO,estado nutricional en menores de 5 anos,clasificacion a y b,2003-01-01,175,33,175,33,208
10405,EL VILLAR,estado nutricional en menores de 5 anos,clasificacion a y b,2003-01-01,14,1,14,1,15
60601,ENTRE RIOS,estado nutricional en menores de 5 anos,clasificacion a y b,2003-01-01,43,14,43,14,57
40502,ESCARA,estado nutricional en menores de 5 anos,clasificacion a y b,2003-01-01,1,0,1,0,1
41101,EUCALIPTUS,estado nutricional en menores de 5 anos,clasificacion a y b,2003-01-01,9,1,9,1,10
80402,EXALTACION,estado nutricional en menores de 5 anos,clasificacion a y b,2003-01-01,6,6,6,6,12
90203,FILADELFIA,estado nutricional en menores de 5 anos,clasificacion a y b,2003-01-01,0,1,0,1,1
71002,GENERAL SAAVEDRA,estado nutricional en menores de 5 anos,clasificacion a y b,2003-01-01,71,28,71,28,99
21601,GRAL. J.J. PEREZ (CHARAZANI),estado nutricional en menores de 5 anos,clasificacion a y b,2003-01-01,1,0,1,0,1
20602,GUANAY,estado nutricional en menores de 5 anos,clasificacion a y b,2003-01-01,73,13,73,13,86
20802,GUAQUI,estado nutricional en menores de 5 anos,clasificacion a y b,2003-01-01,4,1,4,1,5
80202,GUAYARAMERIN,estado nutricional en menores de 5 anos,clasificacion a y b,2003-01-01,184,26,184,26,210
70705,GUTIERREZ,estado nutricional en menores de 5 anos,clasificacion a y b,2003-01-01,71,16,71,16,87
10502,HUACARETA,estado nutricional en menores de 5 anos,clasificacion a y b,2003-01-01,21,9,21,9,30
11002,HUACAYA (VILLA DE HUACAYA),estado nutricional en menores de 5 anos,clasificacion a y b,2003-01-01,9,2,9,2,11
40501,HUACHACALLA,estado nutricional en menores de 5 anos,clasificacion a y b,2003-01-01,1,0,1,0,1
40701,HUANUNI,estado nutricional en menores de 5 anos,clasificacion a y b,2003-01-01,41,3,41,3,44
80803,HUARACAJE,estado nutricional en menores de 5 anos,clasificacion a y b,2003-01-01,7,9,7,9,16
41601,HUAYLLAMARCA,estado nutricional en menores de 5 anos,clasificacion a y b,2003-01-01,1,1,1,1,2
21005,ICHOCA,estado nutricional en menores de 5 anos,clasificacion a y b,2003-01-01,17,8,17,8,25
10304,ICLA,estado nutricional en menores de 5 anos,clasificacion a y b,2003-01-01,11,2,11,2,13
10703,INCAHUASI,estado nutricional en menores de 5 anos,clasificacion a y b,2003-01-01,44,8,44,8,52
21001,INQUISIVI,estado nutricional en menores de 5 anos,clasificacion a y b,2003-01-01,29,15,29,15,44
21102,IRUPANA (VILLA DE LANZA),estado nutricional en menores de 5 anos,clasificacion a y b,2003-01-01,26,20,26,20,46
21501,IXIAMAS,estado nutricional en menores de 5 anos,clasificacion a y b,2003-01-01,32,6,32,6,38
21105,LA ASUNTA,estado nutricional en menores de 5 anos,clasificacion a y b,2003-01-01,64,6,64,6,70
70104,LA GUARDIA,estado nutricional en menores de 5 anos,clasificacion a y b,2003-01-01,103,43,103,43,146
20101,LA PAZ,estado nutricional en menores de 5 anos,clasificacion a y b,2003-01-01,781,203,781,203,984
70701,LAGUNILLAS,estado nutricional en menores de 5 anos,clasificacion a y b,2003-01-01,27,11,27,11,38
21202,LAJA,estado nutricional en menores de 5 anos,clasificacion a y b,2003-01-01,19,1,19,1,20
10903,LAS CARRERAS,estado nutricional en menores de 5 anos,clasificacion a y b,2003-01-01,9,9,9,9,18
21006,LICOMA PAMPA,estado nutricional en menores de 5 anos,clasificacion a y b,2003-01-01,3,1,3,1,4
50203,LLALLAGUA,estado nutricional en menores de 5 anos,clasificacion a y b,2003-01-01,29,131,29,131,160
51401,LLICA,estado nutricional en menores de 5 anos,clasificacion a y b,2003-01-01,4,1,4,1,5
80601,LORETO,estado nutricional en menores de 5 anos,clasificacion a y b,2003-01-01,7,9,7,9,16
20901,LURIBAY,estado nutricional en menores de 5 anos,clasificacion a y b,2003-01-01,5,3,5,3,8
40702,MACHACAMARCA,estado nutricional en menores de 5 anos,clasificacion a y b,2003-01-01,2,0,2,0,2
11003,MACHARETI,estado nutricional en menores de 5 anos,clasificacion a y b,2003-01-01,41,16,41,16,57
80801,MAGDALENA,estado nutricional en menores de 5 anos,clasificacion a y b,2003-01-01,37,6,37,6,43
70903,MAIRANA,estado nutricional en menores de 5 anos,clasificacion a y b,2003-01-01,43,6,43,6,49
20904,MALLA,estado nutricional en menores de 5 anos,clasificacion a y b,2003-01-01,1,0,1,0,1
20103,MECAPACA,estado nutricional en menores de 5 anos,clasificacion a y b,2003-01-01,0,1,0,1,1
71003,MINEROS,estado nutricional en menores de 5 anos,clasificacion a y b,2003-01-01,183,85,183,85,268
31301,MIZQUE,estado nutricional en menores de 5 anos,clasificacion a y b,2003-01-01,13,0,13,0,13
20402,MOCOMOCO,estado nutricional en menores de 5 anos,clasificacion a y b,2003-01-01,14,0,14,0,14
51002,MOJINETE,estado nutricional en menores de 5 anos,clasificacion a y b,2003-01-01,1,1,1,1,2
10303,MOJOCOYA,estado nutricional en menores de 5 anos,clasificacion a y b,2003-01-01,31,5,31,5,36
10501,MONTEAGUDO,estado nutricional en menores de 5 anos,clasificacion a y b,2003-01-01,78,20,78,20,98
71001,MONTERO,estado nutricional en menores de 5 anos,clasificacion a y b,2003-01-01,435,114,435,114,549
70803,MORO MORO,estado nutricional en menores de 5 anos,clasificacion a y b,2003-01-01,4,4,4,4,8
30302,MOROCHATA,estado nutricional en menores de 5 anos,clasificacion a y b,2003-01-01,42,7,42,7,49
90401,NACEBE (SANTA ROSA DEL ABUNA),estado nutricional en menores de 5 anos,clasificacion a y b,2003-01-01,0,2,0,2,2
20307,NAZACARA DE PACAJES,estado nutricional en menores de 5 anos,clasificacion a y b,2003-01-01,1,0,1,0,1
90501,NUEVO MANOA (NUEVA ESPERANZA),estado nutricional en menores de 5 anos,clasificacion a y b,2003-01-01,2,1,2,1,3
50404,OCURI,estado nutricional en menores de 5 anos,clasificacion a y b,2003-01-01,12,11,12,11,23
70202,OKINAWA,estado nutricional en menores de 5 anos,clasificacion a y b,2003-01-01,13,6,13,6,19
30203,OMEREQUE,estado nutricional en menores de 5 anos,clasificacion a y b,2003-01-01,1,9,1,9,10
40101,ORURO,estado nutricional en menores de 5 anos,clasificacion a y b,2003-01-01,424,126,424,126,550
60201,PADCAYA,estado nutricional en menores de 5 anos,clasificacion a y b,2003-01-01,32,25,32,25,57
10401,PADILLA,estado nutricional en menores de 5 anos,clasificacion a y b,2003-01-01,56,4,56,4,60
70502,PAILON,estado nutricional en menores de 5 anos,clasificacion a y b,2003-01-01,22,11,22,11,33
20102,PALCA,estado nutricional en menores de 5 anos,clasificacion a y b,2003-01-01,6,1,6,1,7
21104,PALOS BLANCOS,estado nutricional en menores de 5 anos,clasificacion a y b,2003-01-01,31,10,31,10,41
40802,PAMPA AULLAGAS,estado nutricional en menores de 5 anos,clasificacion a y b,2003-01-01,6,0,6,0,6
70902,PAMPA GRANDE,estado nutricional en menores de 5 anos,clasificacion a y b,2003-01-01,35,2,35,2,37
21802,PAPEL PAMPA,estado nutricional en menores de 5 anos,clasificacion a y b,2003-01-01,1,1,1,1,2
30202,PASORAPA,estado nutricional en menores de 5 anos,clasificacion a y b,2003-01-01,15,1,15,1,16
21305,PATACAMAYA,estado nutricional en menores de 5 anos,clasificacion a y b,2003-01-01,40,10,40,10,50
40602,PAZÃ‘A,estado nutricional en menores de 5 anos,clasificacion a y b,2003-01-01,0,1,0,1,1
20702,PELECHUCO,estado nutricional en menores de 5 anos,clasificacion a y b,2003-01-01,3,0,3,0,3
50403,POCOATA,estado nutricional en menores de 5 anos,clasificacion a y b,2003-01-01,21,7,21,7,28
31203,POCONA,estado nutricional en menores de 5 anos,clasificacion a y b,2003-01-01,9,0,9,0,9
31202,POJO (CBBA),estado nutricional en menores de 5 anos,clasificacion a y b,2003-01-01,85,17,85,17,102
40601,POOPO,estado nutricional en menores de 5 anos,clasificacion a y b,2003-01-01,2,2,2,2,4
51203,PORCO,estado nutricional en menores de 5 anos,clasificacion a y b,2003-01-01,14,0,14,0,14
10103,POROMA,estado nutricional en menores de 5 anos,clasificacion a y b,2003-01-01,51,36,51,36,87
70103,PORONGO,estado nutricional en menores de 5 anos,clasificacion a y b,2003-01-01,2,7,2,7,9
70601,PORTACHUELO,estado nutricional en menores de 5 anos,clasificacion a y b,2003-01-01,140,45,140,45,185
90102,PORVENIR,estado nutricional en menores de 5 anos,clasificacion a y b,2003-01-01,4,3,4,3,7
70804,POSTRER VALLE,estado nutricional en menores de 5 anos,clasificacion a y b,2003-01-01,6,2,6,2,8
50101,POTOSI,estado nutricional en menores de 5 anos,clasificacion a y b,2003-01-01,168,8,168,8,176
10302,PRESTO,estado nutricional en menores de 5 anos,clasificacion a y b,2003-01-01,19,4,19,4,23
21201,PUCARANI,estado nutricional en menores de 5 anos,clasificacion a y b,2003-01-01,8,4,8,4,12
20401,PUERTO ACOSTA,estado nutricional en menores de 5 anos,clasificacion a y b,2003-01-01,46,41,46,41,87
20403,PUERTO CARABUCO,estado nutricional en menores de 5 anos,clasificacion a y b,2003-01-01,20,12,20,12,32
21204,PUERTO PEREZ,estado nutricional en menores de 5 anos,clasificacion a y b,2003-01-01,14,3,14,3,17
71402,PUERTO QUIJARRO,estado nutricional en menores de 5 anos,clasificacion a y b,2003-01-01,45,5,45,5,50
90201,PUERTO RICO,estado nutricional en menores de 5 anos,clasificacion a y b,2003-01-01,1,6,1,6,7
80703,PUERTO SILES,estado nutricional en menores de 5 anos,clasificacion a y b,2003-01-01,1,0,1,0,1
71401,PUERTO SUAREZ,estado nutricional en menores de 5 anos,clasificacion a y b,2003-01-01,44,14,44,14,58
31205,PUERTO VILLARROEL,estado nutricional en menores de 5 anos,clasificacion a y b,2003-01-01,161,34,161,34,195
51101,PUNA,estado nutricional en menores de 5 anos,clasificacion a y b,2003-01-01,56,10,56,10,66
31401,PUNATA,estado nutricional en menores de 5 anos,clasificacion a y b,2003-01-01,49,4,49,4,53
20604,QUIABAYA,estado nutricional en menores de 5 anos,clasificacion a y b,2003-01-01,4,1,4,1,5
30901,QUILLACOLLO,estado nutricional en menores de 5 anos,clasificacion a y b,2003-01-01,66,32,66,32,98
21002,QUIME,estado nutricional en menores de 5 anos,clasificacion a y b,2003-01-01,13,2,13,2,15
70904,QUIRUSILLAS,estado nutricional en menores de 5 anos,clasificacion a y b,2003-01-01,2,1,2,1,3
50402,RAVELO,estado nutricional en menores de 5 anos,clasificacion a y b,2003-01-01,5,1,5,1,6
80301,REYES,estado nutricional en menores de 5 anos,clasificacion a y b,2003-01-01,38,6,38,6,44
80201,RIBERALTA,estado nutricional en menores de 5 anos,clasificacion a y b,2003-01-01,209,25,209,25,234
70503,ROBORE,estado nutricional en menores de 5 anos,clasificacion a y b,2003-01-01,36,25,36,25,61
40901,SABAYA,estado nutricional en menores de 5 anos,clasificacion a y b,2003-01-01,4,2,4,2,6
31001,SACABA,estado nutricional en menores de 5 anos,clasificacion a y b,2003-01-01,44,6,44,6,50
50701,SACACA,estado nutricional en menores de 5 anos,clasificacion a y b,2003-01-01,6,2,6,2,8
71302,SAIPINA,estado nutricional en menores de 5 anos,clasificacion a y b,2003-01-01,56,22,56,22,78
40801,SALINAS DE GARCI MENDOZA,estado nutricional en menores de 5 anos,clasificacion a y b,2003-01-01,9,3,9,3,12
70901,SAMAIPATA,estado nutricional en menores de 5 anos,clasificacion a y b,2003-01-01,30,12,30,12,42
51601,SAN AGUSTIN,estado nutricional en menores de 5 anos,clasificacion a y b,2003-01-01,0,2,0,2,2
80602,SAN ANDRES,estado nutricional en menores de 5 anos,clasificacion a y b,2003-01-01,5,0,5,0,5
51003,SAN ANTONIO DE ESMORUCO,estado nutricional en menores de 5 anos,clasificacion a y b,2003-01-01,1,0,1,0,1
71105,SAN ANTONIO DE LOMERIO,estado nutricional en menores de 5 anos,clasificacion a y b,2003-01-01,9,7,9,7,16
31403,SAN BENITO,estado nutricional en menores de 5 anos,clasificacion a y b,2003-01-01,5,8,5,8,13
80302,SAN BORJA,estado nutricional en menores de 5 anos,clasificacion a y b,2003-01-01,99,14,99,14,113
21502,SAN BUENA VENTURA,estado nutricional en menores de 5 anos,clasificacion a y b,2003-01-01,33,7,33,7,40
70402,SAN CARLOS,estado nutricional en menores de 5 anos,clasificacion a y b,2003-01-01,72,18,72,18,90
80501,SAN IGNACIO,estado nutricional en menores de 5 anos,clasificacion a y b,2003-01-01,85,15,85,15,100
70301,SAN IGNACIO DE VELASCO,estado nutricional en menores de 5 anos,clasificacion a y b,2003-01-01,167,9,167,9,176
80102,SAN JAVIER(BNI),estado nutricional en menores de 5 anos,clasificacion a y b,2003-01-01,3,0,3,0,3
71102,SAN JAVIER(STC),estado nutricional en menores de 5 anos,clasificacion a y b,2003-01-01,65,5,65,5,70
80701,SAN JOAQUIN,estado nutricional en menores de 5 anos,clasificacion a y b,2003-01-01,2,17,2,17,19
70501,SAN JOSE DE CHIQUITOS,estado nutricional en menores de 5 anos,clasificacion a y b,2003-01-01,39,5,39,5,44
71104,SAN JULIAN,estado nutricional en menores de 5 anos,clasificacion a y b,2003-01-01,95,32,95,32,127
90302,SAN LORENZO(PND),estado nutricional en menores de 5 anos,clasificacion a y b,2003-01-01,0,7,0,7,7
60501,SAN LORENZO(TJA),estado nutricional en menores de 5 anos,clasificacion a y b,2003-01-01,15,4,15,4,19
10702,SAN LUCAS,estado nutricional en menores de 5 anos,clasificacion a y b,2003-01-01,63,11,63,11,74
71201,SAN MATIAS,estado nutricional en menores de 5 anos,clasificacion a y b,2003-01-01,36,4,36,4,40
70302,SAN MIGUEL DE VELASCO,estado nutricional en menores de 5 anos,clasificacion a y b,2003-01-01,39,4,39,4,43
51001,SAN PABLO DE LIPEZ,estado nutricional en menores de 5 anos,clasificacion a y b,2003-01-01,4,3,4,3,7
50501,SAN PEDRO DE BUENA VISTA,estado nutricional en menores de 5 anos,clasificacion a y b,2003-01-01,4,6,4,6,10
21801,SAN PEDRO DE CURAHUARA,estado nutricional en menores de 5 anos,clasificacion a y b,2003-01-01,5,2,5,2,7
21702,SAN PEDRO DE TIQUINA,estado nutricional en menores de 5 anos,clasificacion a y b,2003-01-01,7,0,7,0,7
90202,SAN PEDRO(PND),estado nutricional en menores de 5 anos,clasificacion a y b,2003-01-01,6,1,6,1,7
70303,SAN RAFAEL,estado nutricional en menores de 5 anos,clasificacion a y b,2003-01-01,6,5,6,5,11
80702,SAN RAMON,estado nutricional en menores de 5 anos,clasificacion a y b,2003-01-01,11,1,11,1,12
80702,SAN RAMON,estado nutricional en menores de 5 anos,clasificacion a y b,2003-01-01,10,3,10,3,13
70101,SANTA CRUZ DE LA SIERRA,estado nutricional en menores de 5 anos,clasificacion a y b,2003-01-01,1973,1028,1973,1028,3001
80303,SANTA ROSA,estado nutricional en menores de 5 anos,clasificacion a y b,2003-01-01,19,4,19,4,23
70602,SANTA ROSA DEL SARA,estado nutricional en menores de 5 anos,clasificacion a y b,2003-01-01,15,24,15,24,39
20308,SANTIAGO DE CALLAPA,estado nutricional en menores de 5 anos,clasificacion a y b,2003-01-01,5,0,5,0,5
41401,SANTIAGO DE HUARI,estado nutricional en menores de 5 anos,clasificacion a y b,2003-01-01,8,7,8,7,15
21901,SANTIAGO DE MACHACA,estado nutricional en menores de 5 anos,clasificacion a y b,2003-01-01,4,0,4,0,4
30702,SANTIVAÃ‘ES,estado nutricional en menores de 5 anos,clasificacion a y b,2003-01-01,4,0,4,0,4
40202,SANTUARIO DE QUILLACAS,estado nutricional en menores de 5 anos,clasificacion a y b,2003-01-01,3,0,3,0,3
20902,SAPAHAQUI,estado nutricional en menores de 5 anos,clasificacion a y b,2003-01-01,5,0,5,0,5
90303,SENA,estado nutricional en menores de 5 anos,clasificacion a y b,2003-01-01,1,7,1,7,8
21301,SICA SICA (VILLA AROMA),estado nutricional en menores de 5 anos,clasificacion a y b,2003-01-01,14,9,14,9,23
30902,SIPE SIPE,estado nutricional en menores de 5 anos,clasificacion a y b,2003-01-01,100,16,100,16,116
10403,SOPACHUY,estado nutricional en menores de 5 anos,clasificacion a y b,2003-01-01,13,1,13,1,14
20601,SORATA,estado nutricional en menores de 5 anos,clasificacion a y b,2003-01-01,21,2,21,2,23
10101,SUCRE,estado nutricional en menores de 5 anos,clasificacion a y b,2003-01-01,407,89,407,89,496
20603,TACACOMA,estado nutricional en menores de 5 anos,clasificacion a y b,2003-01-01,19,16,19,16,35
50303,TACOBAMBA,estado nutricional en menores de 5 anos,clasificacion a y b,2003-01-01,13,3,13,3,16
30602,TACOPAYA,estado nutricional en menores de 5 anos,clasificacion a y b,2003-01-01,4,2,4,2,6
51402,TAHUA,estado nutricional en menores de 5 anos,clasificacion a y b,2003-01-01,1,0,1,0,1
31101,TAPACARI,estado nutricional en menores de 5 anos,clasificacion a y b,2003-01-01,12,6,12,6,18
10601,TARABUCO,estado nutricional en menores de 5 anos,clasificacion a y b,2003-01-01,43,3,43,3,46
30401,TARATA,estado nutricional en menores de 5 anos,clasificacion a y b,2003-01-01,11,0,11,0,11
60101,TARIJA,estado nutricional en menores de 5 anos,clasificacion a y b,2003-01-01,853,167,853,167,1020
10202,TARVITA,estado nutricional en menores de 5 anos,clasificacion a y b,2003-01-01,7,6,7,6,13
20803,TIAWANACU,estado nutricional en menores de 5 anos,clasificacion a y b,2003-01-01,19,8,19,8,27
50102,TINGUIPAYA,estado nutricional en menores de 5 anos,clasificacion a y b,2003-01-01,2,1,2,1,3
20606,TIPUANI,estado nutricional en menores de 5 anos,clasificacion a y b,2003-01-01,31,2,31,2,33
30903,TIQUIPAYA,estado nutricional en menores de 5 anos,clasificacion a y b,2003-01-01,25,1,25,1,26
31601,TIRAQUE (CBBA),estado nutricional en menores de 5 anos,clasificacion a y b,2003-01-01,81,26,81,26,107
30802,TOCO,estado nutricional en menores de 5 anos,clasificacion a y b,2003-01-01,1,0,1,0,1
30803,TOLATA,estado nutricional en menores de 5 anos,clasificacion a y b,2003-01-01,8,0,8,0,8
41001,TOLEDO,estado nutricional en menores de 5 anos,clasificacion a y b,2003-01-01,5,0,5,0,5
51202,TOMAVE,estado nutricional en menores de 5 anos,clasificacion a y b,2003-01-01,20,5,20,5,25
10402,TOMINA,estado nutricional en menores de 5 anos,clasificacion a y b,2003-01-01,33,5,33,5,38
50502,TORO TORO,estado nutricional en menores de 5 anos,clasificacion a y b,2003-01-01,11,2,11,2,13
31201,TOTORA(CBBA),estado nutricional en menores de 5 anos,clasificacion a y b,2003-01-01,15,2,15,2,17
41301,TOTORA(ORR),estado nutricional en menores de 5 anos,clasificacion a y b,2003-01-01,3,0,3,0,3
70802,TRIGAL,estado nutricional en menores de 5 anos,clasificacion a y b,2003-01-01,5,2,5,2,7
80101,TRINIDAD,estado nutricional en menores de 5 anos,clasificacion a y b,2003-01-01,220,106,220,106,326
50801,TUPIZA,estado nutricional en menores de 5 anos,clasificacion a y b,2003-01-01,50,47,50,47,97
40402,TURCO,estado nutricional en menores de 5 anos,clasificacion a y b,2003-01-01,8,0,8,0,8
21302,UMALA,estado nutricional en menores de 5 anos,clasificacion a y b,2003-01-01,5,0,5,0,5
50201,UNCIA,estado nutricional en menores de 5 anos,clasificacion a y b,2003-01-01,1,2,1,2,3
60401,URIONDO (A. CONCEPCION),estado nutricional en menores de 5 anos,clasificacion a y b,2003-01-01,72,13,72,13,85
51201,UYUNI,estado nutricional en menores de 5 anos,clasificacion a y b,2003-01-01,11,0,11,0,11
30502,VACAS,estado nutricional en menores de 5 anos,clasificacion a y b,2003-01-01,0,1,0,1,1
70801,VALLEGRANDE,estado nutricional en menores de 5 anos,clasificacion a y b,2003-01-01,57,19,57,19,76
20801,VIACHA,estado nutricional en menores de 5 anos,clasificacion a y b,2003-01-01,38,64,38,64,102
31302,VILA VILA,estado nutricional en menores de 5 anos,clasificacion a y b,2003-01-01,5,1,5,1,6
60303,VILLA MONTES,estado nutricional en menores de 5 anos,clasificacion a y b,2003-01-01,36,10,36,10,46
90502,VILLA NUEVA (LOMA ALTA),estado nutricional en menores de 5 anos,clasificacion a y b,2003-01-01,1,1,1,1,2
31402,VILLA RIVERO,estado nutricional en menores de 5 anos,clasificacion a y b,2003-01-01,16,3,16,3,19
10801,VILLA SERRANO,estado nutricional en menores de 5 anos,clasificacion a y b,2003-01-01,24,3,24,3,27
31003,VILLA TUNARI,estado nutricional en menores de 5 anos,clasificacion a y b,2003-01-01,89,29,89,29,118
11001,VILLA VACA GUZMAN (MUYUPAMPA),estado nutricional en menores de 5 anos,clasificacion a y b,2003-01-01,36,9,36,9,45
51501,VILLAZON,estado nutricional en menores de 5 anos,clasificacion a y b,2003-01-01,92,9,92,9,101
50602,VITICHI,estado nutricional en menores de 5 anos,clasificacion a y b,2003-01-01,32,6,32,6,38
20306,WALDO BALLIVIAN,estado nutricional en menores de 5 anos,clasificacion a y b,2003-01-01,2,0,2,0,2
70201,WARNES,estado nutricional en menores de 5 anos,clasificacion a y b,2003-01-01,115,30,115,30,145
20903,YACO,estado nutricional en menores de 5 anos,clasificacion a y b,2003-01-01,4,4,4,4,8
60301,YACUIBA,estado nutricional en menores de 5 anos,clasificacion a y b,2003-01-01,185,40,185,40,225
10602,YAMPARAEZ,estado nutricional en menores de 5 anos,clasificacion a y b,2003-01-01,31,0,31,0,31
21103,YANACACHI,estado nutricional en menores de 5 anos,clasificacion a y b,2003-01-01,12,1,12,1,13
70403,YAPACANI,estado nutricional en menores de 5 anos,clasificacion a y b,2003-01-01,163,37,163,37,200
50103,YOCALLA,estado nutricional en menores de 5 anos,clasificacion a y b,2003-01-01,9,2,9,2,11
10102,YOTALA,estado nutricional en menores de 5 anos,clasificacion a y b,2003-01-01,36,7,36,7,43
60402,YUNCHARA,estado nutricional en menores de 5 anos,clasificacion a y b,2003-01-01,2,1,2,1,3
10301,ZUDAÃ‘EZ,estado nutricional en menores de 5 anos,clasificacion a y b,2003-01-01,19,3,19,3,22
51302,ACACIO,estado nutricional en menores de 5 anos,clasificacion a y b,2003-02-01,13,3,13,3,16
20201,ACHACACHI,estado nutricional en menores de 5 anos,clasificacion a y b,2003-02-01,100,36,100,36,136
20104,ACHOCALLA,estado nutricional en menores de 5 anos,clasificacion a y b,2003-02-01,3,0,3,0,3
30201,AIQUILE,estado nutricional en menores de 5 anos,clasificacion a y b,2003-02-01,25,9,25,9,34
31303,ALALAY,estado nutricional en menores de 5 anos,clasificacion a y b,2003-02-01,1,0,1,0,1
10404,ALCALA,estado nutricional en menores de 5 anos,clasificacion a y b,2003-02-01,13,5,13,5,18
20202,ANCORAIMES,estado nutricional en menores de 5 anos,clasificacion a y b,2003-02-01,13,6,13,6,19
41201,ANDAMARCA,estado nutricional en menores de 5 anos,clasificacion a y b,2003-02-01,1,0,1,0,1
40603,ANTEQUERA,estado nutricional en menores de 5 anos,clasificacion a y b,2003-02-01,3,0,3,0,3
30402,ANZALDO,estado nutricional en menores de 5 anos,clasificacion a y b,2003-02-01,7,7,7,7,14
20701,APOLO,estado nutricional en menores de 5 anos,clasificacion a y b,2003-02-01,51,13,51,13,64
51301,ARAMPAMPA,estado nutricional en menores de 5 anos,clasificacion a y b,2003-02-01,10,3,10,3,13
30501,ARANI,estado nutricional en menores de 5 anos,clasificacion a y b,2003-02-01,3,3,3,3,6
30403,ARBIETO,estado nutricional en menores de 5 anos,clasificacion a y b,2003-02-01,8,1,8,1,9
30601,ARQUE,estado nutricional en menores de 5 anos,clasificacion a y b,2003-02-01,6,5,6,5,11
71501,ASCENCION DE GUARAYOS,estado nutricional en menores de 5 anos,clasificacion a y b,2003-02-01,74,17,74,17,91
50802,ATOCHA,estado nutricional en menores de 5 anos,clasificacion a y b,2003-02-01,4,14,4,14,18
20503,AUCAPATA,estado nutricional en menores de 5 anos,clasificacion a y b,2003-02-01,1,0,1,0,1
20502,AYATA,estado nutricional en menores de 5 anos,clasificacion a y b,2003-02-01,2,0,2,0,2
21303,AYO AYO,estado nutricional en menores de 5 anos,clasificacion a y b,2003-02-01,11,1,11,1,12
30301,AYOPAYA (V. DE INDEPENDENCIA),estado nutricional en menores de 5 anos,clasificacion a y b,2003-02-01,19,3,19,3,22
10201,AZURDUY,estado nutricional en menores de 5 anos,clasificacion a y b,2003-02-01,42,3,42,3,45
21203,BATALLAS,estado nutricional en menores de 5 anos,clasificacion a y b,2003-02-01,32,6,32,6,38
80802,BAURES,estado nutricional en menores de 5 anos,clasificacion a y b,2003-02-01,7,3,7,3,10
50104,BELEN DE URMIRI,estado nutricional en menores de 5 anos,clasificacion a y b,2003-02-01,0,1,0,1,1
60202,BERMEJO,estado nutricional en menores de 5 anos,clasificacion a y b,2003-02-01,26,22,26,22,48
50301,BETANZOS,estado nutricional en menores de 5 anos,clasificacion a y b,2003-02-01,19,2,19,2,21
31501,BOLIVAR,estado nutricional en menores de 5 anos,clasificacion a y b,2003-02-01,1,1,1,1,2
90103,BOLPEBRA,estado nutricional en menores de 5 anos,clasificacion a y b,2003-02-01,1,0,1,0,1
70707,BOYUIBE,estado nutricional en menores de 5 anos,clasificacion a y b,2003-02-01,26,5,26,5,31
70401,BUENA VISTA,estado nutricional en menores de 5 anos,clasificacion a y b,2003-02-01,66,19,66,19,85
70703,CABEZAS,estado nutricional en menores de 5 anos,clasificacion a y b,2003-02-01,19,15,19,15,34
20905,CAIROMA,estado nutricional en menores de 5 anos,clasificacion a y b,2003-02-01,12,2,12,2,14
51102,"CAIZA ""D""",estado nutricional en menores de 5 anos,clasificacion a y b,2003-02-01,14,2,14,2,16
21003,CAJUATA,estado nutricional en menores de 5 anos,clasificacion a y b,2003-02-01,13,2,13,2,15
20303,CALACOTO,estado nutricional en menores de 5 anos,clasificacion a y b,2003-02-01,8,0,8,0,8
21304,CALAMARCA,estado nutricional en menores de 5 anos,clasificacion a y b,2003-02-01,16,1,16,1,17
10701,CAMARGO,estado nutricional en menores de 5 anos,clasificacion a y b,2003-02-01,23,1,23,1,24
10901,CAMATAQUI (C. VILLA ABECIA),estado nutricional en menores de 5 anos,clasificacion a y b,2003-02-01,1,0,1,0,1
70706,CAMIRI,estado nutricional en menores de 5 anos,clasificacion a y b,2003-02-01,108,19,108,19,127
30701,CAPINOTA,estado nutricional en menores de 5 anos,clasificacion a y b,2003-02-01,4,0,4,0,4
20302,CAQUIAVIRI,estado nutricional en menores de 5 anos,clasificacion a y b,2003-02-01,9,3,9,3,12
40102,CARACOLLO,estado nutricional en menores de 5 anos,clasificacion a y b,2003-02-01,28,8,28,8,36
22001,CARANAVI,estado nutricional en menores de 5 anos,clasificacion a y b,2003-02-01,88,35,88,35,123
60302,CARAPARI,estado nutricional en menores de 5 anos,clasificacion a y b,2003-02-01,25,9,25,9,34
50702,CARIPUYO,estado nutricional en menores de 5 anos,clasificacion a y b,2003-02-01,7,1,7,1,8
40201,CHALLAPATA,estado nutricional en menores de 5 anos,clasificacion a y b,2003-02-01,12,12,12,12,24
50302,CHAQUI,estado nutricional en menores de 5 anos,clasificacion a y b,2003-02-01,18,2,18,2,20
70702,CHARAGUA,estado nutricional en menores de 5 anos,clasificacion a y b,2003-02-01,48,17,48,17,65
20305,CHARAÃ‘A,estado nutricional en menores de 5 anos,clasificacion a y b,2003-02-01,2,0,2,0,2
50202,CHAYANTA,estado nutricional en menores de 5 anos,clasificacion a y b,2003-02-01,13,2,13,2,15
31204,CHIMORE,estado nutricional en menores de 5 anos,clasificacion a y b,2003-02-01,27,17,27,17,44
21101,CHULUMANI (V. DE LA LIBERTAD),estado nutricional en menores de 5 anos,clasificacion a y b,2003-02-01,5,3,5,3,8
20501,CHUMA,estado nutricional en menores de 5 anos,clasificacion a y b,2003-02-01,25,0,25,0,25
30801,CLIZA,estado nutricional en menores de 5 anos,clasificacion a y b,2003-02-01,5,1,5,1,6
90101,COBIJA,estado nutricional en menores de 5 anos,clasificacion a y b,2003-02-01,114,23,114,23,137
30101,COCHABAMBA,estado nutricional en menores de 5 anos,clasificacion a y b,2003-02-01,1696,653,1696,653,2349
40902,COIPASA,estado nutricional en menores de 5 anos,clasificacion a y b,2003-02-01,1,0,1,0,1
30905,COLCAPIRHUA,estado nutricional en menores de 5 anos,clasificacion a y b,2003-02-01,13,1,13,1,14
50901,"COLCHA ""K""",estado nutricional en menores de 5 anos,clasificacion a y b,2003-02-01,7,6,7,6,13
31002,COLOMI,estado nutricional en menores de 5 anos,clasificacion a y b,2003-02-01,38,14,38,14,52
50401,COLQUECHACA,estado nutricional en menores de 5 anos,clasificacion a y b,2003-02-01,17,1,17,1,18
21306,COLQUENCHA,estado nutricional en menores de 5 anos,clasificacion a y b,2003-02-01,12,1,12,1,13
21004,COLQUIRI,estado nutricional en menores de 5 anos,clasificacion a y b,2003-02-01,24,4,24,4,28
71301,COMARAPA,estado nutricional en menores de 5 anos,clasificacion a y b,2003-02-01,90,11,90,11,101
71101,CONCEPCION,estado nutricional en menores de 5 anos,clasificacion a y b,2003-02-01,3,9,3,9,12
21701,COPACABANA,estado nutricional en menores de 5 anos,clasificacion a y b,2003-02-01,14,2,14,2,16
21402,CORIPATA,estado nutricional en menores de 5 anos,clasificacion a y b,2003-02-01,44,3,44,3,47
20301,CORO CORO,estado nutricional en menores de 5 anos,clasificacion a y b,2003-02-01,2,1,2,1,3
21401,COROICO,estado nutricional en menores de 5 anos,clasificacion a y b,2003-02-01,10,5,10,5,15
40301,CORQUE,estado nutricional en menores de 5 anos,clasificacion a y b,2003-02-01,3,1,3,1,4
50601,COTAGAITA,estado nutricional en menores de 5 anos,clasificacion a y b,2003-02-01,37,9,37,9,46
70102,COTOCA,estado nutricional en menores de 5 anos,clasificacion a y b,2003-02-01,47,3,47,3,50
70704,CUEVO,estado nutricional en menores de 5 anos,clasificacion a y b,2003-02-01,8,1,8,1,9
10902,CULPINA,estado nutricional en menores de 5 anos,clasificacion a y b,2003-02-01,56,16,56,16,72
40401,CURAHUARA DE CARANGAS,estado nutricional en menores de 5 anos,clasificacion a y b,2003-02-01,1,0,1,0,1
21602,CURVA,estado nutricional en menores de 5 anos,clasificacion a y b,2003-02-01,5,0,5,0,5
20804,DESAGUADERO,estado nutricional en menores de 5 anos,clasificacion a y b,2003-02-01,6,3,6,3,9
20105,EL ALTO,estado nutricional en menores de 5 anos,clasificacion a y b,2003-02-01,601,110,601,110,711
40103,EL CHORO,estado nutricional en menores de 5 anos,clasificacion a y b,2003-02-01,7,3,7,3,10
71503,EL PUENTE(STC),estado nutricional en menores de 5 anos,clasificacion a y b,2003-02-01,20,12,20,12,32
60502,EL PUENTE(TJA),estado nutricional en menores de 5 anos,clasificacion a y b,2003-02-01,7,3,7,3,10
70105,EL TORNO,estado nutricional en menores de 5 anos,clasificacion a y b,2003-02-01,148,15,148,15,163
10405,EL VILLAR,estado nutricional en menores de 5 anos,clasificacion a y b,2003-02-01,9,2,9,2,11
60601,ENTRE RIOS,estado nutricional en menores de 5 anos,clasificacion a y b,2003-02-01,38,11,38,11,49
41101,EUCALIPTUS,estado nutricional en menores de 5 anos,clasificacion a y b,2003-02-01,8,2,8,2,10
90503,EUREKA (SANTOS MERCADO),estado nutricional en menores de 5 anos,clasificacion a y b,2003-02-01,2,4,2,4,6
90203,FILADELFIA,estado nutricional en menores de 5 anos,clasificacion a y b,2003-02-01,0,4,0,4,4
71002,GENERAL SAAVEDRA,estado nutricional en menores de 5 anos,clasificacion a y b,2003-02-01,59,44,59,44,103
21601,GRAL. J.J. PEREZ (CHARAZANI),estado nutricional en menores de 5 anos,clasificacion a y b,2003-02-01,8,1,8,1,9
20602,GUANAY,estado nutricional en menores de 5 anos,clasificacion a y b,2003-02-01,81,18,81,18,99
20802,GUAQUI,estado nutricional en menores de 5 anos,clasificacion a y b,2003-02-01,5,4,5,4,9
80202,GUAYARAMERIN,estado nutricional en menores de 5 anos,clasificacion a y b,2003-02-01,136,20,136,20,156
70705,GUTIERREZ,estado nutricional en menores de 5 anos,clasificacion a y b,2003-02-01,94,12,94,12,106
10502,HUACARETA,estado nutricional en menores de 5 anos,clasificacion a y b,2003-02-01,27,9,27,9,36
11002,HUACAYA (VILLA DE HUACAYA),estado nutricional en menores de 5 anos,clasificacion a y b,2003-02-01,7,7,7,7,14
40701,HUANUNI,estado nutricional en menores de 5 anos,clasificacion a y b,2003-02-01,20,3,20,3,23
80803,HUARACAJE,estado nutricional en menores de 5 anos,clasificacion a y b,2003-02-01,11,2,11,2,13
21005,ICHOCA,estado nutricional en menores de 5 anos,clasificacion a y b,2003-02-01,5,11,5,11,16
10304,ICLA,estado nutricional en menores de 5 anos,clasificacion a y b,2003-02-01,4,4,4,4,8
10703,INCAHUASI,estado nutricional en menores de 5 anos,clasificacion a y b,2003-02-01,34,5,34,5,39
21001,INQUISIVI,estado nutricional en menores de 5 anos,clasificacion a y b,2003-02-01,25,4,25,4,29
21102,IRUPANA (VILLA DE LANZA),estado nutricional en menores de 5 anos,clasificacion a y b,2003-02-01,19,11,19,11,30
21501,IXIAMAS,estado nutricional en menores de 5 anos,clasificacion a y b,2003-02-01,23,10,23,10,33
21105,LA ASUNTA,estado nutricional en menores de 5 anos,clasificacion a y b,2003-02-01,59,1,59,1,60
70104,LA GUARDIA,estado nutricional en menores de 5 anos,clasificacion a y b,2003-02-01,104,28,104,28,132
20101,LA PAZ,estado nutricional en menores de 5 anos,clasificacion a y b,2003-02-01,568,142,568,142,710
70701,LAGUNILLAS,estado nutricional en menores de 5 anos,clasificacion a y b,2003-02-01,36,4,36,4,40
21202,LAJA,estado nutricional en menores de 5 anos,clasificacion a y b,2003-02-01,15,5,15,5,20
10903,LAS CARRERAS,estado nutricional en menores de 5 anos,clasificacion a y b,2003-02-01,11,7,11,7,18
21006,LICOMA PAMPA,estado nutricional en menores de 5 anos,clasificacion a y b,2003-02-01,5,0,5,0,5
50203,LLALLAGUA,estado nutricional en menores de 5 anos,clasificacion a y b,2003-02-01,0,82,0,82,82
51401,LLICA,estado nutricional en menores de 5 anos,clasificacion a y b,2003-02-01,7,2,7,2,9
80601,LORETO,estado nutricional en menores de 5 anos,clasificacion a y b,2003-02-01,3,3,3,3,6
20901,LURIBAY,estado nutricional en menores de 5 anos,clasificacion a y b,2003-02-01,3,1,3,1,4
40702,MACHACAMARCA,estado nutricional en menores de 5 anos,clasificacion a y b,2003-02-01,5,0,5,0,5
11003,MACHARETI,estado nutricional en menores de 5 anos,clasificacion a y b,2003-02-01,30,17,30,17,47
80801,MAGDALENA,estado nutricional en menores de 5 anos,clasificacion a y b,2003-02-01,26,10,26,10,36
70903,MAIRANA,estado nutricional en menores de 5 anos,clasificacion a y b,2003-02-01,38,4,38,4,42
20103,MECAPACA,estado nutricional en menores de 5 anos,clasificacion a y b,2003-02-01,1,0,1,0,1
71003,MINEROS,estado nutricional en menores de 5 anos,clasificacion a y b,2003-02-01,170,48,170,48,218
31301,MIZQUE,estado nutricional en menores de 5 anos,clasificacion a y b,2003-02-01,34,4,34,4,38
20402,MOCOMOCO,estado nutricional en menores de 5 anos,clasificacion a y b,2003-02-01,10,1,10,1,11
10303,MOJOCOYA,estado nutricional en menores de 5 anos,clasificacion a y b,2003-02-01,34,6,34,6,40
10501,MONTEAGUDO,estado nutricional en menores de 5 anos,clasificacion a y b,2003-02-01,82,20,82,20,102
71001,MONTERO,estado nutricional en menores de 5 anos,clasificacion a y b,2003-02-01,370,55,370,55,425
70803,MORO MORO,estado nutricional en menores de 5 anos,clasificacion a y b,2003-02-01,5,2,5,2,7
30302,MOROCHATA,estado nutricional en menores de 5 anos,clasificacion a y b,2003-02-01,25,5,25,5,30
90401,NACEBE (SANTA ROSA DEL ABUNA),estado nutricional en menores de 5 anos,clasificacion a y b,2003-02-01,1,0,1,0,1
20307,NAZACARA DE PACAJES,estado nutricional en menores de 5 anos,clasificacion a y b,2003-02-01,1,0,1,0,1
90501,NUEVO MANOA (NUEVA ESPERANZA),estado nutricional en menores de 5 anos,clasificacion a y b,2003-02-01,0,1,0,1,1
50404,OCURI,estado nutricional en menores de 5 anos,clasificacion a y b,2003-02-01,2,3,2,3,5
70202,OKINAWA,estado nutricional en menores de 5 anos,clasificacion a y b,2003-02-01,5,0,5,0,5
30203,OMEREQUE,estado nutricional en menores de 5 anos,clasificacion a y b,2003-02-01,0,2,0,2,2
40101,ORURO,estado nutricional en menores de 5 anos,clasificacion a y b,2003-02-01,242,70,242,70,312
60201,PADCAYA,estado nutricional en menores de 5 anos,clasificacion a y b,2003-02-01,41,22,41,22,63
10401,PADILLA,estado nutricional en menores de 5 anos,clasificacion a y b,2003-02-01,60,5,60,5,65
70502,PAILON,estado nutricional en menores de 5 anos,clasificacion a y b,2003-02-01,19,5,19,5,24
20102,PALCA,estado nutricional en menores de 5 anos,clasificacion a y b,2003-02-01,4,2,4,2,6
21104,PALOS BLANCOS,estado nutricional en menores de 5 anos,clasificacion a y b,2003-02-01,46,9,46,9,55
40802,PAMPA AULLAGAS,estado nutricional en menores de 5 anos,clasificacion a y b,2003-02-01,7,1,7,1,8
70902,PAMPA GRANDE,estado nutricional en menores de 5 anos,clasificacion a y b,2003-02-01,25,6,25,6,31
21802,PAPEL PAMPA,estado nutricional en menores de 5 anos,clasificacion a y b,2003-02-01,2,3,2,3,5
30202,PASORAPA,estado nutricional en menores de 5 anos,clasificacion a y b,2003-02-01,3,1,3,1,4
21305,PATACAMAYA,estado nutricional en menores de 5 anos,clasificacion a y b,2003-02-01,41,8,41,8,49
40602,PAZÃ‘A,estado nutricional en menores de 5 anos,clasificacion a y b,2003-02-01,1,1,1,1,2
20702,PELECHUCO,estado nutricional en menores de 5 anos,clasificacion a y b,2003-02-01,3,0,3,0,3
50403,POCOATA,estado nutricional en menores de 5 anos,clasificacion a y b,2003-02-01,14,8,14,8,22
31203,POCONA,estado nutricional en menores de 5 anos,clasificacion a y b,2003-02-01,15,2,15,2,17
31202,POJO (CBBA),estado nutricional en menores de 5 anos,clasificacion a y b,2003-02-01,85,13,85,13,98
40601,POOPO,estado nutricional en menores de 5 anos,clasificacion a y b,2003-02-01,3,2,3,2,5
51203,PORCO,estado nutricional en menores de 5 anos,clasificacion a y b,2003-02-01,16,2,16,2,18
10103,POROMA,estado nutricional en menores de 5 anos,clasificacion a y b,2003-02-01,44,9,44,9,53
70103,PORONGO,estado nutricional en menores de 5 anos,clasificacion a y b,2003-02-01,7,10,7,10,17
70601,PORTACHUELO,estado nutricional en menores de 5 anos,clasificacion a y b,2003-02-01,98,24,98,24,122
90102,PORVENIR,estado nutricional en menores de 5 anos,clasificacion a y b,2003-02-01,8,5,8,5,13
70804,POSTRER VALLE,estado nutricional en menores de 5 anos,clasificacion a y b,2003-02-01,8,13,8,13,21
50101,POTOSI,estado nutricional en menores de 5 anos,clasificacion a y b,2003-02-01,134,6,134,6,140
10302,PRESTO,estado nutricional en menores de 5 anos,clasificacion a y b,2003-02-01,26,13,26,13,39
21201,PUCARANI,estado nutricional en menores de 5 anos,clasificacion a y b,2003-02-01,24,6,24,6,30
20401,PUERTO ACOSTA,estado nutricional en menores de 5 anos,clasificacion a y b,2003-02-01,41,43,41,43,84
20403,PUERTO CARABUCO,estado nutricional en menores de 5 anos,clasificacion a y b,2003-02-01,21,1,21,1,22
90301,PUERTO GONZALO MORENO,estado nutricional en menores de 5 anos,clasificacion a y b,2003-02-01,6,6,6,6,12
21204,PUERTO PEREZ,estado nutricional en menores de 5 anos,clasificacion a y b,2003-02-01,12,1,12,1,13
71402,PUERTO QUIJARRO,estado nutricional en menores de 5 anos,clasificacion a y b,2003-02-01,41,3,41,3,44
90201,PUERTO RICO,estado nutricional en menores de 5 anos,clasificacion a y b,2003-02-01,5,1,5,1,6
80703,PUERTO SILES,estado nutricional en menores de 5 anos,clasificacion a y b,2003-02-01,0,1,0,1,1
71401,PUERTO SUAREZ,estado nutricional en menores de 5 anos,clasificacion a y b,2003-02-01,48,7,48,7,55
31205,PUERTO VILLARROEL,estado nutricional en menores de 5 anos,clasificacion a y b,2003-02-01,169,53,169,53,222
51101,PUNA,estado nutricional en menores de 5 anos,clasificacion a y b,2003-02-01,26,1,26,1,27
31401,PUNATA,estado nutricional en menores de 5 anos,clasificacion a y b,2003-02-01,37,6,37,6,43
30901,QUILLACOLLO,estado nutricional en menores de 5 anos,clasificacion a y b,2003-02-01,87,54,87,54,141
21002,QUIME,estado nutricional en menores de 5 anos,clasificacion a y b,2003-02-01,12,2,12,2,14
70904,QUIRUSILLAS,estado nutricional en menores de 5 anos,clasificacion a y b,2003-02-01,1,0,1,0,1
50402,RAVELO,estado nutricional en menores de 5 anos,clasificacion a y b,2003-02-01,15,1,15,1,16
80301,REYES,estado nutricional en menores de 5 anos,clasificacion a y b,2003-02-01,36,7,36,7,43
80201,RIBERALTA,estado nutricional en menores de 5 anos,clasificacion a y b,2003-02-01,169,20,169,20,189
70503,ROBORE,estado nutricional en menores de 5 anos,clasificacion a y b,2003-02-01,22,19,22,19,41
80304,RURRENABAQUE,estado nutricional en menores de 5 anos,clasificacion a y b,2003-02-01,2,1,2,1,3
40901,SABAYA,estado nutricional en menores de 5 anos,clasificacion a y b,2003-02-01,3,3,3,3,6
31001,SACABA,estado nutricional en menores de 5 anos,clasificacion a y b,2003-02-01,53,52,53,52,105
30404,SACABAMBA,estado nutricional en menores de 5 anos,clasificacion a y b,2003-02-01,3,0,3,0,3
50701,SACACA,estado nutricional en menores de 5 anos,clasificacion a y b,2003-02-01,7,2,7,2,9
71302,SAIPINA,estado nutricional en menores de 5 anos,clasificacion a y b,2003-02-01,50,34,50,34,84
40801,SALINAS DE GARCI MENDOZA,estado nutricional en menores de 5 anos,clasificacion a y b,2003-02-01,4,2,4,2,6
70901,SAMAIPATA,estado nutricional en menores de 5 anos,clasificacion a y b,2003-02-01,23,2,23,2,25
51601,SAN AGUSTIN,estado nutricional en menores de 5 anos,clasificacion a y b,2003-02-01,5,0,5,0,5
80602,SAN ANDRES,estado nutricional en menores de 5 anos,clasificacion a y b,2003-02-01,12,0,12,0,12
51003,SAN ANTONIO DE ESMORUCO,estado nutricional en menores de 5 anos,clasificacion a y b,2003-02-01,0,1,0,1,1
71105,SAN ANTONIO DE LOMERIO,estado nutricional en menores de 5 anos,clasificacion a y b,2003-02-01,16,7,16,7,23
31403,SAN BENITO,estado nutricional en menores de 5 anos,clasificacion a y b,2003-02-01,13,3,13,3,16
80302,SAN BORJA,estado nutricional en menores de 5 anos,clasificacion a y b,2003-02-01,85,10,85,10,95
21502,SAN BUENA VENTURA,estado nutricional en menores de 5 anos,clasificacion a y b,2003-02-01,31,9,31,9,40
70402,SAN CARLOS,estado nutricional en menores de 5 anos,clasificacion a y b,2003-02-01,42,11,42,11,53
80501,SAN IGNACIO,estado nutricional en menores de 5 anos,clasificacion a y b,2003-02-01,47,19,47,19,66
70301,SAN IGNACIO DE VELASCO,estado nutricional en menores de 5 anos,clasificacion a y b,2003-02-01,148,17,148,17,165
80102,SAN JAVIER(BNI),estado nutricional en menores de 5 anos,clasificacion a y b,2003-02-01,4,1,4,1,5
71102,SAN JAVIER(STC),estado nutricional en menores de 5 anos,clasificacion a y b,2003-02-01,29,1,29,1,30
80701,SAN JOAQUIN,estado nutricional en menores de 5 anos,clasificacion a y b,2003-02-01,8,3,8,3,11
70501,SAN JOSE DE CHIQUITOS,estado nutricional en menores de 5 anos,clasificacion a y b,2003-02-01,16,3,16,3,19
71104,SAN JULIAN,estado nutricional en menores de 5 anos,clasificacion a y b,2003-02-01,164,52,164,52,216
90302,SAN LORENZO(PND),estado nutricional en menores de 5 anos,clasificacion a y b,2003-02-01,10,1,10,1,11
60501,SAN LORENZO(TJA),estado nutricional en menores de 5 anos,clasificacion a y b,2003-02-01,13,4,13,4,17
10702,SAN LUCAS,estado nutricional en menores de 5 anos,clasificacion a y b,2003-02-01,50,1,50,1,51
71201,SAN MATIAS,estado nutricional en menores de 5 anos,clasificacion a y b,2003-02-01,4,0,4,0,4
70302,SAN MIGUEL DE VELASCO,estado nutricional en menores de 5 anos,clasificacion a y b,2003-02-01,7,6,7,6,13
50501,SAN PEDRO DE BUENA VISTA,estado nutricional en menores de 5 anos,clasificacion a y b,2003-02-01,14,9,14,9,23
21801,SAN PEDRO DE CURAHUARA,estado nutricional en menores de 5 anos,clasificacion a y b,2003-02-01,5,0,5,0,5
21702,SAN PEDRO DE TIQUINA,estado nutricional en menores de 5 anos,clasificacion a y b,2003-02-01,5,1,5,1,6
70303,SAN RAFAEL,estado nutricional en menores de 5 anos,clasificacion a y b,2003-02-01,13,1,13,1,14
80702,SAN RAMON,estado nutricional en menores de 5 anos,clasificacion a y b,2003-02-01,18,14,18,14,32
80702,SAN RAMON,estado nutricional en menores de 5 anos,clasificacion a y b,2003-02-01,7,3,7,3,10
80401,SANTA ANA,estado nutricional en menores de 5 anos,clasificacion a y b,2003-02-01,5,0,5,0,5
70101,SANTA CRUZ DE LA SIERRA,estado nutricional en menores de 5 anos,clasificacion a y b,2003-02-01,1573,657,1573,657,2230
80303,SANTA ROSA,estado nutricional en menores de 5 anos,clasificacion a y b,2003-02-01,8,7,8,7,15
70602,SANTA ROSA DEL SARA,estado nutricional en menores de 5 anos,clasificacion a y b,2003-02-01,12,21,12,21,33
20308,SANTIAGO DE CALLAPA,estado nutricional en menores de 5 anos,clasificacion a y b,2003-02-01,1,2,1,2,3
41401,SANTIAGO DE HUARI,estado nutricional en menores de 5 anos,clasificacion a y b,2003-02-01,2,2,2,2,4
21901,SANTIAGO DE MACHACA,estado nutricional en menores de 5 anos,clasificacion a y b,2003-02-01,2,0,2,0,2
30702,SANTIVAÃ‘ES,estado nutricional en menores de 5 anos,clasificacion a y b,2003-02-01,5,1,5,1,6
40202,SANTUARIO DE QUILLACAS,estado nutricional en menores de 5 anos,clasificacion a y b,2003-02-01,4,2,4,2,6
20902,SAPAHAQUI,estado nutricional en menores de 5 anos,clasificacion a y b,2003-02-01,10,1,10,1,11
90303,SENA,estado nutricional en menores de 5 anos,clasificacion a y b,2003-02-01,4,1,4,1,5
21301,SICA SICA (VILLA AROMA),estado nutricional en menores de 5 anos,clasificacion a y b,2003-02-01,11,3,11,3,14
30902,SIPE SIPE,estado nutricional en menores de 5 anos,clasificacion a y b,2003-02-01,73,8,73,8,81
10403,SOPACHUY,estado nutricional en menores de 5 anos,clasificacion a y b,2003-02-01,18,1,18,1,19
20601,SORATA,estado nutricional en menores de 5 anos,clasificacion a y b,2003-02-01,30,5,30,5,35
10101,SUCRE,estado nutricional en menores de 5 anos,clasificacion a y b,2003-02-01,404,145,404,145,549
50303,TACOBAMBA,estado nutricional en menores de 5 anos,clasificacion a y b,2003-02-01,11,2,11,2,13
30602,TACOPAYA,estado nutricional en menores de 5 anos,clasificacion a y b,2003-02-01,2,1,2,1,3
51402,TAHUA,estado nutricional en menores de 5 anos,clasificacion a y b,2003-02-01,3,0,3,0,3
31101,TAPACARI,estado nutricional en menores de 5 anos,clasificacion a y b,2003-02-01,15,6,15,6,21
10601,TARABUCO,estado nutricional en menores de 5 anos,clasificacion a y b,2003-02-01,42,2,42,2,44
30401,TARATA,estado nutricional en menores de 5 anos,clasificacion a y b,2003-02-01,7,1,7,1,8
60101,TARIJA,estado nutricional en menores de 5 anos,clasificacion a y b,2003-02-01,370,153,370,153,523
10202,TARVITA,estado nutricional en menores de 5 anos,clasificacion a y b,2003-02-01,27,9,27,9,36
20803,TIAWANACU,estado nutricional en menores de 5 anos,clasificacion a y b,2003-02-01,14,5,14,5,19
50102,TINGUIPAYA,estado nutricional en menores de 5 anos,clasificacion a y b,2003-02-01,11,0,11,0,11
20606,TIPUANI,estado nutricional en menores de 5 anos,clasificacion a y b,2003-02-01,9,0,9,0,9
30903,TIQUIPAYA,estado nutricional en menores de 5 anos,clasificacion a y b,2003-02-01,10,1,10,1,11
31601,TIRAQUE (CBBA),estado nutricional en menores de 5 anos,clasificacion a y b,2003-02-01,95,42,95,42,137
30802,TOCO,estado nutricional en menores de 5 anos,clasificacion a y b,2003-02-01,1,0,1,0,1
30803,TOLATA,estado nutricional en menores de 5 anos,clasificacion a y b,2003-02-01,8,4,8,4,12
41001,TOLEDO,estado nutricional en menores de 5 anos,clasificacion a y b,2003-02-01,0,1,0,1,1
51202,TOMAVE,estado nutricional en menores de 5 anos,clasificacion a y b,2003-02-01,23,12,23,12,35
10402,TOMINA,estado nutricional en menores de 5 anos,clasificacion a y b,2003-02-01,32,5,32,5,37
50502,TORO TORO,estado nutricional en menores de 5 anos,clasificacion a y b,2003-02-01,12,2,12,2,14
31201,TOTORA(CBBA),estado nutricional en menores de 5 anos,clasificacion a y b,2003-02-01,11,3,11,3,14
41301,TOTORA(ORR),estado nutricional en menores de 5 anos,clasificacion a y b,2003-02-01,4,5,4,5,9
70802,TRIGAL,estado nutricional en menores de 5 anos,clasificacion a y b,2003-02-01,3,1,3,1,4
80101,TRINIDAD,estado nutricional en menores de 5 anos,clasificacion a y b,2003-02-01,129,87,129,87,216
50801,TUPIZA,estado nutricional en menores de 5 anos,clasificacion a y b,2003-02-01,41,57,41,57,98
40402,TURCO,estado nutricional en menores de 5 anos,clasificacion a y b,2003-02-01,3,0,3,0,3
21302,UMALA,estado nutricional en menores de 5 anos,clasificacion a y b,2003-02-01,5,0,5,0,5
50201,UNCIA,estado nutricional en menores de 5 anos,clasificacion a y b,2003-02-01,0,2,0,2,2
60401,URIONDO (A. CONCEPCION),estado nutricional en menores de 5 anos,clasificacion a y b,2003-02-01,76,12,76,12,88
71502,URUBICHA,estado nutricional en menores de 5 anos,clasificacion a y b,2003-02-01,19,9,19,9,28
51201,UYUNI,estado nutricional en menores de 5 anos,clasificacion a y b,2003-02-01,29,2,29,2,31
30502,VACAS,estado nutricional en menores de 5 anos,clasificacion a y b,2003-02-01,3,0,3,0,3
70801,VALLEGRANDE,estado nutricional en menores de 5 anos,clasificacion a y b,2003-02-01,38,17,38,17,55
20801,VIACHA,estado nutricional en menores de 5 anos,clasificacion a y b,2003-02-01,46,37,46,37,83
31302,VILA VILA,estado nutricional en menores de 5 anos,clasificacion a y b,2003-02-01,2,0,2,0,2
60303,VILLA MONTES,estado nutricional en menores de 5 anos,clasificacion a y b,2003-02-01,68,23,68,23,91
31402,VILLA RIVERO,estado nutricional en menores de 5 anos,clasificacion a y b,2003-02-01,14,0,14,0,14
10801,VILLA SERRANO,estado nutricional en menores de 5 anos,clasificacion a y b,2003-02-01,24,2,24,2,26
31003,VILLA TUNARI,estado nutricional en menores de 5 anos,clasificacion a y b,2003-02-01,130,62,130,62,192
11001,VILLA VACA GUZMAN (MUYUPAMPA),estado nutricional en menores de 5 anos,clasificacion a y b,2003-02-01,41,11,41,11,52
51501,VILLAZON,estado nutricional en menores de 5 anos,clasificacion a y b,2003-02-01,67,8,67,8,75
50602,VITICHI,estado nutricional en menores de 5 anos,clasificacion a y b,2003-02-01,21,13,21,13,34
20306,WALDO BALLIVIAN,estado nutricional en menores de 5 anos,clasificacion a y b,2003-02-01,1,0,1,0,1
70201,WARNES,estado nutricional en menores de 5 anos,clasificacion a y b,2003-02-01,89,29,89,29,118
20903,YACO,estado nutricional en menores de 5 anos,clasificacion a y b,2003-02-01,3,2,3,2,5
60301,YACUIBA,estado nutricional en menores de 5 anos,clasificacion a y b,2003-02-01,121,24,121,24,145
10602,YAMPARAEZ,estado nutricional en menores de 5 anos,clasificacion a y b,2003-02-01,26,1,26,1,27
21103,YANACACHI,estado nutricional en menores de 5 anos,clasificacion a y b,2003-02-01,5,1,5,1,6
70403,YAPACANI,estado nutricional en menores de 5 anos,clasificacion a y b,2003-02-01,148,18,148,18,166
50103,YOCALLA,estado nutricional en menores de 5 anos,clasificacion a y b,2003-02-01,6,0,6,0,6
10102,YOTALA,estado nutricional en menores de 5 anos,clasificacion a y b,2003-02-01,43,9,43,9,52
60402,YUNCHARA,estado nutricional en menores de 5 anos,clasificacion a y b,2003-02-01,5,7,5,7,12
10301,ZUDAÃ‘EZ,estado nutricional en menores de 5 anos,clasificacion a y b,2003-02-01,11,8,11,8,19
51302,ACACIO,estado nutricional en menores de 5 anos,clasificacion a y b,2003-03-01,6,0,6,0,6
20201,ACHACACHI,estado nutricional en menores de 5 anos,clasificacion a y b,2003-03-01,56,15,56,15,71
20104,ACHOCALLA,estado nutricional en menores de 5 anos,clasificacion a y b,2003-03-01,5,2,5,2,7
30201,AIQUILE,estado nutricional en menores de 5 anos,clasificacion a y b,2003-03-01,15,3,15,3,18
31303,ALALAY,estado nutricional en menores de 5 anos,clasificacion a y b,2003-03-01,5,1,5,1,6
10404,ALCALA,estado nutricional en menores de 5 anos,clasificacion a y b,2003-03-01,7,6,7,6,13
20202,ANCORAIMES,estado nutricional en menores de 5 anos,clasificacion a y b,2003-03-01,14,3,14,3,17
41201,ANDAMARCA,estado nutricional en menores de 5 anos,clasificacion a y b,2003-03-01,2,1,2,1,3
40603,ANTEQUERA,estado nutricional en menores de 5 anos,clasificacion a y b,2003-03-01,1,0,1,0,1
30402,ANZALDO,estado nutricional en menores de 5 anos,clasificacion a y b,2003-03-01,1,4,1,4,5
20701,APOLO,estado nutricional en menores de 5 anos,clasificacion a y b,2003-03-01,22,11,22,11,33
51301,ARAMPAMPA,estado nutricional en menores de 5 anos,clasificacion a y b,2003-03-01,18,4,18,4,22
30501,ARANI,estado nutricional en menores de 5 anos,clasificacion a y b,2003-03-01,3,9,3,9,12
30403,ARBIETO,estado nutricional en menores de 5 anos,clasificacion a y b,2003-03-01,2,2,2,2,4
30601,ARQUE,estado nutricional en menores de 5 anos,clasificacion a y b,2003-03-01,7,2,7,2,9
71501,ASCENCION DE GUARAYOS,estado nutricional en menores de 5 anos,clasificacion a y b,2003-03-01,1,1,1,1,2
50802,ATOCHA,estado nutricional en menores de 5 anos,clasificacion a y b,2003-03-01,5,26,5,26,31
20503,AUCAPATA,estado nutricional en menores de 5 anos,clasificacion a y b,2003-03-01,8,0,8,0,8
20502,AYATA,estado nutricional en menores de 5 anos,clasificacion a y b,2003-03-01,1,0,1,0,1
21303,AYO AYO,estado nutricional en menores de 5 anos,clasificacion a y b,2003-03-01,12,1,12,1,13
30301,AYOPAYA (V. DE INDEPENDENCIA),estado nutricional en menores de 5 anos,clasificacion a y b,2003-03-01,35,29,35,29,64
10201,AZURDUY,estado nutricional en menores de 5 anos,clasificacion a y b,2003-03-01,29,8,29,8,37
21203,BATALLAS,estado nutricional en menores de 5 anos,clasificacion a y b,2003-03-01,24,14,24,14,38
80802,BAURES,estado nutricional en menores de 5 anos,clasificacion a y b,2003-03-01,12,2,12,2,14
50104,BELEN DE URMIRI,estado nutricional en menores de 5 anos,clasificacion a y b,2003-03-01,1,1,1,1,2
90104,BELLA FLOR,estado nutricional en menores de 5 anos,clasificacion a y b,2003-03-01,5,1,5,1,6
60202,BERMEJO,estado nutricional en menores de 5 anos,clasificacion a y b,2003-03-01,23,34,23,34,57
50301,BETANZOS,estado nutricional en menores de 5 anos,clasificacion a y b,2003-03-01,48,8,48,8,56
31501,BOLIVAR,estado nutricional en menores de 5 anos,clasificacion a y b,2003-03-01,9,3,9,3,12
70707,BOYUIBE,estado nutricional en menores de 5 anos,clasificacion a y b,2003-03-01,21,6,21,6,27
70401,BUENA VISTA,estado nutricional en menores de 5 anos,clasificacion a y b,2003-03-01,64,16,64,16,80
70703,CABEZAS,estado nutricional en menores de 5 anos,clasificacion a y b,2003-03-01,16,3,16,3,19
20905,CAIROMA,estado nutricional en menores de 5 anos,clasificacion a y b,2003-03-01,1,3,1,3,4
51102,"CAIZA ""D""",estado nutricional en menores de 5 anos,clasificacion a y b,2003-03-01,22,3,22,3,25
21003,CAJUATA,estado nutricional en menores de 5 anos,clasificacion a y b,2003-03-01,16,1,16,1,17
20303,CALACOTO,estado nutricional en menores de 5 anos,clasificacion a y b,2003-03-01,3,2,3,2,5
21304,CALAMARCA,estado nutricional en menores de 5 anos,clasificacion a y b,2003-03-01,13,3,13,3,16
10701,CAMARGO,estado nutricional en menores de 5 anos,clasificacion a y b,2003-03-01,18,5,18,5,23
10901,CAMATAQUI (C. VILLA ABECIA),estado nutricional en menores de 5 anos,clasificacion a y b,2003-03-01,5,3,5,3,8
70706,CAMIRI,estado nutricional en menores de 5 anos,clasificacion a y b,2003-03-01,108,19,108,19,127
30701,CAPINOTA,estado nutricional en menores de 5 anos,clasificacion a y b,2003-03-01,1,8,1,8,9
20302,CAQUIAVIRI,estado nutricional en menores de 5 anos,clasificacion a y b,2003-03-01,5,3,5,3,8
40102,CARACOLLO,estado nutricional en menores de 5 anos,clasificacion a y b,2003-03-01,22,8,22,8,30
22001,CARANAVI,estado nutricional en menores de 5 anos,clasificacion a y b,2003-03-01,121,29,121,29,150
41503,CARANGAS,estado nutricional en menores de 5 anos,clasificacion a y b,2003-03-01,1,0,1,0,1
60302,CARAPARI,estado nutricional en menores de 5 anos,clasificacion a y b,2003-03-01,36,4,36,4,40
50702,CARIPUYO,estado nutricional en menores de 5 anos,clasificacion a y b,2003-03-01,7,0,7,0,7
40201,CHALLAPATA,estado nutricional en menores de 5 anos,clasificacion a y b,2003-03-01,11,9,11,9,20
50302,CHAQUI,estado nutricional en menores de 5 anos,clasificacion a y b,2003-03-01,28,6,28,6,34
70702,CHARAGUA,estado nutricional en menores de 5 anos,clasificacion a y b,2003-03-01,66,18,66,18,84
20305,CHARAÃ‘A,estado nutricional en menores de 5 anos,clasificacion a y b,2003-03-01,1,0,1,0,1
50202,CHAYANTA,estado nutricional en menores de 5 anos,clasificacion a y b,2003-03-01,22,2,22,2,24
31204,CHIMORE,estado nutricional en menores de 5 anos,clasificacion a y b,2003-03-01,25,13,25,13,38
40302,CHOQUE COTA,estado nutricional en menores de 5 anos,clasificacion a y b,2003-03-01,3,0,3,0,3
21101,CHULUMANI (V. DE LA LIBERTAD),estado nutricional en menores de 5 anos,clasificacion a y b,2003-03-01,14,4,14,4,18
20501,CHUMA,estado nutricional en menores de 5 anos,clasificacion a y b,2003-03-01,11,2,11,2,13
30801,CLIZA,estado nutricional en menores de 5 anos,clasificacion a y b,2003-03-01,6,2,6,2,8
90101,COBIJA,estado nutricional en menores de 5 anos,clasificacion a y b,2003-03-01,84,8,84,8,92
30101,COCHABAMBA,estado nutricional en menores de 5 anos,clasificacion a y b,2003-03-01,2256,359,2256,359,2615
40902,COIPASA,estado nutricional en menores de 5 anos,clasificacion a y b,2003-03-01,1,1,1,1,2
30905,COLCAPIRHUA,estado nutricional en menores de 5 anos,clasificacion a y b,2003-03-01,4,0,4,0,4
50901,"COLCHA ""K""",estado nutricional en menores de 5 anos,clasificacion a y b,2003-03-01,13,10,13,10,23
31002,COLOMI,estado nutricional en menores de 5 anos,clasificacion a y b,2003-03-01,46,12,46,12,58
50401,COLQUECHACA,estado nutricional en menores de 5 anos,clasificacion a y b,2003-03-01,43,9,43,9,52
21306,COLQUENCHA,estado nutricional en menores de 5 anos,clasificacion a y b,2003-03-01,14,5,14,5,19
21004,COLQUIRI,estado nutricional en menores de 5 anos,clasificacion a y b,2003-03-01,16,3,16,3,19
71301,COMARAPA,estado nutricional en menores de 5 anos,clasificacion a y b,2003-03-01,79,7,79,7,86
71101,CONCEPCION,estado nutricional en menores de 5 anos,clasificacion a y b,2003-03-01,6,7,6,7,13
21701,COPACABANA,estado nutricional en menores de 5 anos,clasificacion a y b,2003-03-01,13,1,13,1,14
21402,CORIPATA,estado nutricional en menores de 5 anos,clasificacion a y b,2003-03-01,52,13,52,13,65
20301,CORO CORO,estado nutricional en menores de 5 anos,clasificacion a y b,2003-03-01,6,3,6,3,9
21401,COROICO,estado nutricional en menores de 5 anos,clasificacion a y b,2003-03-01,5,1,5,1,6
40301,CORQUE,estado nutricional en menores de 5 anos,clasificacion a y b,2003-03-01,6,0,6,0,6
50601,COTAGAITA,estado nutricional en menores de 5 anos,clasificacion a y b,2003-03-01,23,3,23,3,26
70102,COTOCA,estado nutricional en menores de 5 anos,clasificacion a y b,2003-03-01,30,1,30,1,31
70704,CUEVO,estado nutricional en menores de 5 anos,clasificacion a y b,2003-03-01,13,1,13,1,14
10902,CULPINA,estado nutricional en menores de 5 anos,clasificacion a y b,2003-03-01,42,24,42,24,66
40401,CURAHUARA DE CARANGAS,estado nutricional en menores de 5 anos,clasificacion a y b,2003-03-01,2,0,2,0,2
21602,CURVA,estado nutricional en menores de 5 anos,clasificacion a y b,2003-03-01,5,0,5,0,5
20804,DESAGUADERO,estado nutricional en menores de 5 anos,clasificacion a y b,2003-03-01,4,8,4,8,12
20105,EL ALTO,estado nutricional en menores de 5 anos,clasificacion a y b,2003-03-01,539,99,539,99,638
40103,EL CHORO,estado nutricional en menores de 5 anos,clasificacion a y b,2003-03-01,8,0,8,0,8
71503,EL PUENTE(STC),estado nutricional en menores de 5 anos,clasificacion a y b,2003-03-01,9,16,9,16,25
60502,EL PUENTE(TJA),estado nutricional en menores de 5 anos,clasificacion a y b,2003-03-01,6,1,6,1,7
70105,EL TORNO,estado nutricional en menores de 5 anos,clasificacion a y b,2003-03-01,119,30,119,30,149
10405,EL VILLAR,estado nutricional en menores de 5 anos,clasificacion a y b,2003-03-01,9,1,9,1,10
60601,ENTRE RIOS,estado nutricional en menores de 5 anos,clasificacion a y b,2003-03-01,49,16,49,16,65
41101,EUCALIPTUS,estado nutricional en menores de 5 anos,clasificacion a y b,2003-03-01,10,5,10,5,15
90503,EUREKA (SANTOS MERCADO),estado nutricional en menores de 5 anos,clasificacion a y b,2003-03-01,1,3,1,3,4
80402,EXALTACION,estado nutricional en menores de 5 anos,clasificacion a y b,2003-03-01,0,21,0,21,21
90203,FILADELFIA,estado nutricional en menores de 5 anos,clasificacion a y b,2003-03-01,0,1,0,1,1
71002,GENERAL SAAVEDRA,estado nutricional en menores de 5 anos,clasificacion a y b,2003-03-01,73,24,73,24,97
21601,GRAL. J.J. PEREZ (CHARAZANI),estado nutricional en menores de 5 anos,clasificacion a y b,2003-03-01,12,7,12,7,19
20602,GUANAY,estado nutricional en menores de 5 anos,clasificacion a y b,2003-03-01,67,10,67,10,77
20802,GUAQUI,estado nutricional en menores de 5 anos,clasificacion a y b,2003-03-01,7,0,7,0,7
80202,GUAYARAMERIN,estado nutricional en menores de 5 anos,clasificacion a y b,2003-03-01,160,12,160,12,172
70705,GUTIERREZ,estado nutricional en menores de 5 anos,clasificacion a y b,2003-03-01,72,21,72,21,93
10502,HUACARETA,estado nutricional en menores de 5 anos,clasificacion a y b,2003-03-01,29,11,29,11,40
11002,HUACAYA (VILLA DE HUACAYA),estado nutricional en menores de 5 anos,clasificacion a y b,2003-03-01,4,0,4,0,4
40701,HUANUNI,estado nutricional en menores de 5 anos,clasificacion a y b,2003-03-01,44,12,44,12,56
80803,HUARACAJE,estado nutricional en menores de 5 anos,clasificacion a y b,2003-03-01,7,4,7,4,11
21005,ICHOCA,estado nutricional en menores de 5 anos,clasificacion a y b,2003-03-01,8,7,8,7,15
10304,ICLA,estado nutricional en menores de 5 anos,clasificacion a y b,2003-03-01,19,1,19,1,20
10703,INCAHUASI,estado nutricional en menores de 5 anos,clasificacion a y b,2003-03-01,35,2,35,2,37
90402,INGAVI (HUMAITA),estado nutricional en menores de 5 anos,clasificacion a y b,2003-03-01,4,0,4,0,4
21001,INQUISIVI,estado nutricional en menores de 5 anos,clasificacion a y b,2003-03-01,38,7,38,7,45
21102,IRUPANA (VILLA DE LANZA),estado nutricional en menores de 5 anos,clasificacion a y b,2003-03-01,14,12,14,12,26
21501,IXIAMAS,estado nutricional en menores de 5 anos,clasificacion a y b,2003-03-01,23,4,23,4,27
21105,LA ASUNTA,estado nutricional en menores de 5 anos,clasificacion a y b,2003-03-01,62,6,62,6,68
70104,LA GUARDIA,estado nutricional en menores de 5 anos,clasificacion a y b,2003-03-01,112,40,112,40,152
20101,LA PAZ,estado nutricional en menores de 5 anos,clasificacion a y b,2003-03-01,594,192,594,192,786
41501,LA RIVERA,estado nutricional en menores de 5 anos,clasificacion a y b,2003-03-01,1,0,1,0,1
70701,LAGUNILLAS,estado nutricional en menores de 5 anos,clasificacion a y b,2003-03-01,36,20,36,20,56
21202,LAJA,estado nutricional en menores de 5 anos,clasificacion a y b,2003-03-01,12,0,12,0,12
10903,LAS CARRERAS,estado nutricional en menores de 5 anos,clasificacion a y b,2003-03-01,9,2,9,2,11
21006,LICOMA PAMPA,estado nutricional en menores de 5 anos,clasificacion a y b,2003-03-01,4,0,4,0,4
50203,LLALLAGUA,estado nutricional en menores de 5 anos,clasificacion a y b,2003-03-01,21,68,21,68,89
51401,LLICA,estado nutricional en menores de 5 anos,clasificacion a y b,2003-03-01,11,1,11,1,12
80601,LORETO,estado nutricional en menores de 5 anos,clasificacion a y b,2003-03-01,9,2,9,2,11
20901,LURIBAY,estado nutricional en menores de 5 anos,clasificacion a y b,2003-03-01,5,5,5,5,10
40702,MACHACAMARCA,estado nutricional en menores de 5 anos,clasificacion a y b,2003-03-01,1,1,1,1,2
11003,MACHARETI,estado nutricional en menores de 5 anos,clasificacion a y b,2003-03-01,32,12,32,12,44
80801,MAGDALENA,estado nutricional en menores de 5 anos,clasificacion a y b,2003-03-01,15,4,15,4,19
70903,MAIRANA,estado nutricional en menores de 5 anos,clasificacion a y b,2003-03-01,51,4,51,4,55
20103,MECAPACA,estado nutricional en menores de 5 anos,clasificacion a y b,2003-03-01,6,1,6,1,7
71003,MINEROS,estado nutricional en menores de 5 anos,clasificacion a y b,2003-03-01,212,37,212,37,249
31301,MIZQUE,estado nutricional en menores de 5 anos,clasificacion a y b,2003-03-01,13,2,13,2,15
20402,MOCOMOCO,estado nutricional en menores de 5 anos,clasificacion a y b,2003-03-01,14,2,14,2,16
10303,MOJOCOYA,estado nutricional en menores de 5 anos,clasificacion a y b,2003-03-01,25,4,25,4,29
10501,MONTEAGUDO,estado nutricional en menores de 5 anos,clasificacion a y b,2003-03-01,87,22,87,22,109
71001,MONTERO,estado nutricional en menores de 5 anos,clasificacion a y b,2003-03-01,311,80,311,80,391
70803,MORO MORO,estado nutricional en menores de 5 anos,clasificacion a y b,2003-03-01,6,0,6,0,6
30302,MOROCHATA,estado nutricional en menores de 5 anos,clasificacion a y b,2003-03-01,54,5,54,5,59
90401,NACEBE (SANTA ROSA DEL ABUNA),estado nutricional en menores de 5 anos,clasificacion a y b,2003-03-01,1,1,1,1,2
20307,NAZACARA DE PACAJES,estado nutricional en menores de 5 anos,clasificacion a y b,2003-03-01,2,0,2,0,2
90501,NUEVO MANOA (NUEVA ESPERANZA),estado nutricional en menores de 5 anos,clasificacion a y b,2003-03-01,1,0,1,0,1
50404,OCURI,estado nutricional en menores de 5 anos,clasificacion a y b,2003-03-01,10,7,10,7,17
70202,OKINAWA,estado nutricional en menores de 5 anos,clasificacion a y b,2003-03-01,12,3,12,3,15
30203,OMEREQUE,estado nutricional en menores de 5 anos,clasificacion a y b,2003-03-01,1,4,1,4,5
40101,ORURO,estado nutricional en menores de 5 anos,clasificacion a y b,2003-03-01,257,80,257,80,337
60201,PADCAYA,estado nutricional en menores de 5 anos,clasificacion a y b,2003-03-01,50,51,50,51,101
10401,PADILLA,estado nutricional en menores de 5 anos,clasificacion a y b,2003-03-01,65,6,65,6,71
70502,PAILON,estado nutricional en menores de 5 anos,clasificacion a y b,2003-03-01,19,4,19,4,23
20102,PALCA,estado nutricional en menores de 5 anos,clasificacion a y b,2003-03-01,9,2,9,2,11
21104,PALOS BLANCOS,estado nutricional en menores de 5 anos,clasificacion a y b,2003-03-01,38,11,38,11,49
40802,PAMPA AULLAGAS,estado nutricional en menores de 5 anos,clasificacion a y b,2003-03-01,5,0,5,0,5
70902,PAMPA GRANDE,estado nutricional en menores de 5 anos,clasificacion a y b,2003-03-01,23,1,23,1,24
21802,PAPEL PAMPA,estado nutricional en menores de 5 anos,clasificacion a y b,2003-03-01,5,1,5,1,6
30202,PASORAPA,estado nutricional en menores de 5 anos,clasificacion a y b,2003-03-01,9,1,9,1,10
21305,PATACAMAYA,estado nutricional en menores de 5 anos,clasificacion a y b,2003-03-01,28,8,28,8,36
40602,PAZÃ‘A,estado nutricional en menores de 5 anos,clasificacion a y b,2003-03-01,4,0,4,0,4
20702,PELECHUCO,estado nutricional en menores de 5 anos,clasificacion a y b,2003-03-01,4,0,4,0,4
50403,POCOATA,estado nutricional en menores de 5 anos,clasificacion a y b,2003-03-01,29,9,29,9,38
31203,POCONA,estado nutricional en menores de 5 anos,clasificacion a y b,2003-03-01,8,6,8,6,14
31202,POJO (CBBA),estado nutricional en menores de 5 anos,clasificacion a y b,2003-03-01,70,27,70,27,97
40601,POOPO,estado nutricional en menores de 5 anos,clasificacion a y b,2003-03-01,1,4,1,4,5
51203,PORCO,estado nutricional en menores de 5 anos,clasificacion a y b,2003-03-01,26,5,26,5,31
10103,POROMA,estado nutricional en menores de 5 anos,clasificacion a y b,2003-03-01,52,7,52,7,59
70103,PORONGO,estado nutricional en menores de 5 anos,clasificacion a y b,2003-03-01,5,3,5,3,8
70601,PORTACHUELO,estado nutricional en menores de 5 anos,clasificacion a y b,2003-03-01,106,30,106,30,136
70804,POSTRER VALLE,estado nutricional en menores de 5 anos,clasificacion a y b,2003-03-01,7,6,7,6,13
50101,POTOSI,estado nutricional en menores de 5 anos,clasificacion a y b,2003-03-01,142,12,142,12,154
10302,PRESTO,estado nutricional en menores de 5 anos,clasificacion a y b,2003-03-01,17,1,17,1,18
70805,PUCARA,estado nutricional en menores de 5 anos,clasificacion a y b,2003-03-01,3,0,3,0,3
21201,PUCARANI,estado nutricional en menores de 5 anos,clasificacion a y b,2003-03-01,14,8,14,8,22
20401,PUERTO ACOSTA,estado nutricional en menores de 5 anos,clasificacion a y b,2003-03-01,43,37,43,37,80
20403,PUERTO CARABUCO,estado nutricional en menores de 5 anos,clasificacion a y b,2003-03-01,11,1,11,1,12
90301,PUERTO GONZALO MORENO,estado nutricional en menores de 5 anos,clasificacion a y b,2003-03-01,1,0,1,0,1
21204,PUERTO PEREZ,estado nutricional en menores de 5 anos,clasificacion a y b,2003-03-01,15,0,15,0,15
71402,PUERTO QUIJARRO,estado nutricional en menores de 5 anos,clasificacion a y b,2003-03-01,56,3,56,3,59
90201,PUERTO RICO,estado nutricional en menores de 5 anos,clasificacion a y b,2003-03-01,3,8,3,8,11
71401,PUERTO SUAREZ,estado nutricional en menores de 5 anos,clasificacion a y b,2003-03-01,43,9,43,9,52
31205,PUERTO VILLARROEL,estado nutricional en menores de 5 anos,clasificacion a y b,2003-03-01,117,29,117,29,146
51101,PUNA,estado nutricional en menores de 5 anos,clasificacion a y b,2003-03-01,53,20,53,20,73
31401,PUNATA,estado nutricional en menores de 5 anos,clasificacion a y b,2003-03-01,38,8,38,8,46
30901,QUILLACOLLO,estado nutricional en menores de 5 anos,clasificacion a y b,2003-03-01,91,54,91,54,145
21002,QUIME,estado nutricional en menores de 5 anos,clasificacion a y b,2003-03-01,21,5,21,5,26
70904,QUIRUSILLAS,estado nutricional en menores de 5 anos,clasificacion a y b,2003-03-01,1,0,1,0,1
50402,RAVELO,estado nutricional en menores de 5 anos,clasificacion a y b,2003-03-01,13,7,13,7,20
80301,REYES,estado nutricional en menores de 5 anos,clasificacion a y b,2003-03-01,24,6,24,6,30
80201,RIBERALTA,estado nutricional en menores de 5 anos,clasificacion a y b,2003-03-01,218,24,218,24,242
70503,ROBORE,estado nutricional en menores de 5 anos,clasificacion a y b,2003-03-01,44,19,44,19,63
80304,RURRENABAQUE,estado nutricional en menores de 5 anos,clasificacion a y b,2003-03-01,3,0,3,0,3
40901,SABAYA,estado nutricional en menores de 5 anos,clasificacion a y b,2003-03-01,1,1,1,1,2
31001,SACABA,estado nutricional en menores de 5 anos,clasificacion a y b,2003-03-01,74,36,74,36,110
30404,SACABAMBA,estado nutricional en menores de 5 anos,clasificacion a y b,2003-03-01,1,0,1,0,1
50701,SACACA,estado nutricional en menores de 5 anos,clasificacion a y b,2003-03-01,4,3,4,3,7
71302,SAIPINA,estado nutricional en menores de 5 anos,clasificacion a y b,2003-03-01,44,8,44,8,52
40801,SALINAS DE GARCI MENDOZA,estado nutricional en menores de 5 anos,clasificacion a y b,2003-03-01,1,7,1,7,8
70901,SAMAIPATA,estado nutricional en menores de 5 anos,clasificacion a y b,2003-03-01,27,6,27,6,33
51601,SAN AGUSTIN,estado nutricional en menores de 5 anos,clasificacion a y b,2003-03-01,2,1,2,1,3
80602,SAN ANDRES,estado nutricional en menores de 5 anos,clasificacion a y b,2003-03-01,2,1,2,1,3
71105,SAN ANTONIO DE LOMERIO,estado nutricional en menores de 5 anos,clasificacion a y b,2003-03-01,13,8,13,8,21
31403,SAN BENITO,estado nutricional en menores de 5 anos,clasificacion a y b,2003-03-01,6,2,6,2,8
80302,SAN BORJA,estado nutricional en menores de 5 anos,clasificacion a y b,2003-03-01,107,15,107,15,122
21502,SAN BUENA VENTURA,estado nutricional en menores de 5 anos,clasificacion a y b,2003-03-01,28,6,28,6,34
70402,SAN CARLOS,estado nutricional en menores de 5 anos,clasificacion a y b,2003-03-01,66,12,66,12,78
80501,SAN IGNACIO,estado nutricional en menores de 5 anos,clasificacion a y b,2003-03-01,41,26,41,26,67
70301,SAN IGNACIO DE VELASCO,estado nutricional en menores de 5 anos,clasificacion a y b,2003-03-01,159,14,159,14,173
80102,SAN JAVIER(BNI),estado nutricional en menores de 5 anos,clasificacion a y b,2003-03-01,6,0,6,0,6
71102,SAN JAVIER(STC),estado nutricional en menores de 5 anos,clasificacion a y b,2003-03-01,66,4,66,4,70
80701,SAN JOAQUIN,estado nutricional en menores de 5 anos,clasificacion a y b,2003-03-01,14,1,14,1,15
70501,SAN JOSE DE CHIQUITOS,estado nutricional en menores de 5 anos,clasificacion a y b,2003-03-01,20,1,20,1,21
71104,SAN JULIAN,estado nutricional en menores de 5 anos,clasificacion a y b,2003-03-01,157,67,157,67,224
90302,SAN LORENZO(PND),estado nutricional en menores de 5 anos,clasificacion a y b,2003-03-01,15,12,15,12,27
60501,SAN LORENZO(TJA),estado nutricional en menores de 5 anos,clasificacion a y b,2003-03-01,23,20,23,20,43
10702,SAN LUCAS,estado nutricional en menores de 5 anos,clasificacion a y b,2003-03-01,44,5,44,5,49
70302,SAN MIGUEL DE VELASCO,estado nutricional en menores de 5 anos,clasificacion a y b,2003-03-01,10,2,10,2,12
51001,SAN PABLO DE LIPEZ,estado nutricional en menores de 5 anos,clasificacion a y b,2003-03-01,3,0,3,0,3
50501,SAN PEDRO DE BUENA VISTA,estado nutricional en menores de 5 anos,clasificacion a y b,2003-03-01,16,10,16,10,26
21801,SAN PEDRO DE CURAHUARA,estado nutricional en menores de 5 anos,clasificacion a y b,2003-03-01,5,1,5,1,6
21702,SAN PEDRO DE TIQUINA,estado nutricional en menores de 5 anos,clasificacion a y b,2003-03-01,7,1,7,1,8
70303,SAN RAFAEL,estado nutricional en menores de 5 anos,clasificacion a y b,2003-03-01,19,1,19,1,20
80702,SAN RAMON,estado nutricional en menores de 5 anos,clasificacion a y b,2003-03-01,4,3,4,3,7
80702,SAN RAMON,estado nutricional en menores de 5 anos,clasificacion a y b,2003-03-01,22,3,22,3,25
80401,SANTA ANA,estado nutricional en menores de 5 anos,clasificacion a y b,2003-03-01,0,2,0,2,2
70101,SANTA CRUZ DE LA SIERRA,estado nutricional en menores de 5 anos,clasificacion a y b,2003-03-01,1785,633,1785,633,2418
80303,SANTA ROSA,estado nutricional en menores de 5 anos,clasificacion a y b,2003-03-01,23,5,23,5,28
70602,SANTA ROSA DEL SARA,estado nutricional en menores de 5 anos,clasificacion a y b,2003-03-01,21,20,21,20,41
20308,SANTIAGO DE CALLAPA,estado nutricional en menores de 5 anos,clasificacion a y b,2003-03-01,9,6,9,6,15
21901,SANTIAGO DE MACHACA,estado nutricional en menores de 5 anos,clasificacion a y b,2003-03-01,3,0,3,0,3
30702,SANTIVAÃ‘ES,estado nutricional en menores de 5 anos,clasificacion a y b,2003-03-01,4,0,4,0,4
40202,SANTUARIO DE QUILLACAS,estado nutricional en menores de 5 anos,clasificacion a y b,2003-03-01,1,0,1,0,1
20902,SAPAHAQUI,estado nutricional en menores de 5 anos,clasificacion a y b,2003-03-01,15,3,15,3,18
90303,SENA,estado nutricional en menores de 5 anos,clasificacion a y b,2003-03-01,3,5,3,5,8
21301,SICA SICA (VILLA AROMA),estado nutricional en menores de 5 anos,clasificacion a y b,2003-03-01,6,1,6,1,7
30703,SICAYA,estado nutricional en menores de 5 anos,clasificacion a y b,2003-03-01,1,0,1,0,1
30902,SIPE SIPE,estado nutricional en menores de 5 anos,clasificacion a y b,2003-03-01,98,23,98,23,121
10403,SOPACHUY,estado nutricional en menores de 5 anos,clasificacion a y b,2003-03-01,9,3,9,3,12
20601,SORATA,estado nutricional en menores de 5 anos,clasificacion a y b,2003-03-01,23,7,23,7,30
10101,SUCRE,estado nutricional en menores de 5 anos,clasificacion a y b,2003-03-01,331,77,331,77,408
50303,TACOBAMBA,estado nutricional en menores de 5 anos,clasificacion a y b,2003-03-01,16,1,16,1,17
30602,TACOPAYA,estado nutricional en menores de 5 anos,clasificacion a y b,2003-03-01,5,0,5,0,5
51402,TAHUA,estado nutricional en menores de 5 anos,clasificacion a y b,2003-03-01,3,1,3,1,4
31101,TAPACARI,estado nutricional en menores de 5 anos,clasificacion a y b,2003-03-01,15,9,15,9,24
10601,TARABUCO,estado nutricional en menores de 5 anos,clasificacion a y b,2003-03-01,38,2,38,2,40
30401,TARATA,estado nutricional en menores de 5 anos,clasificacion a y b,2003-03-01,12,3,12,3,15
60101,TARIJA,estado nutricional en menores de 5 anos,clasificacion a y b,2003-03-01,209,147,209,147,356
10202,TARVITA,estado nutricional en menores de 5 anos,clasificacion a y b,2003-03-01,30,6,30,6,36
20803,TIAWANACU,estado nutricional en menores de 5 anos,clasificacion a y b,2003-03-01,18,3,18,3,21
50102,TINGUIPAYA,estado nutricional en menores de 5 anos,clasificacion a y b,2003-03-01,14,1,14,1,15
20606,TIPUANI,estado nutricional en menores de 5 anos,clasificacion a y b,2003-03-01,19,1,19,1,20
30903,TIQUIPAYA,estado nutricional en menores de 5 anos,clasificacion a y b,2003-03-01,9,10,9,10,19
31601,TIRAQUE (CBBA),estado nutricional en menores de 5 anos,clasificacion a y b,2003-03-01,84,46,84,46,130
30802,TOCO,estado nutricional en menores de 5 anos,clasificacion a y b,2003-03-01,1,3,1,3,4
41502,TODOS SANTOS,estado nutricional en menores de 5 anos,clasificacion a y b,2003-03-01,1,0,1,0,1
30803,TOLATA,estado nutricional en menores de 5 anos,clasificacion a y b,2003-03-01,6,2,6,2,8
41001,TOLEDO,estado nutricional en menores de 5 anos,clasificacion a y b,2003-03-01,3,2,3,2,5
51202,TOMAVE,estado nutricional en menores de 5 anos,clasificacion a y b,2003-03-01,11,0,11,0,11
10402,TOMINA,estado nutricional en menores de 5 anos,clasificacion a y b,2003-03-01,18,5,18,5,23
50502,TORO TORO,estado nutricional en menores de 5 anos,clasificacion a y b,2003-03-01,7,3,7,3,10
31201,TOTORA(CBBA),estado nutricional en menores de 5 anos,clasificacion a y b,2003-03-01,17,3,17,3,20
41301,TOTORA(ORR),estado nutricional en menores de 5 anos,clasificacion a y b,2003-03-01,3,1,3,1,4
70802,TRIGAL,estado nutricional en menores de 5 anos,clasificacion a y b,2003-03-01,3,1,3,1,4
80101,TRINIDAD,estado nutricional en menores de 5 anos,clasificacion a y b,2003-03-01,130,104,130,104,234
50801,TUPIZA,estado nutricional en menores de 5 anos,clasificacion a y b,2003-03-01,53,57,53,57,110
40402,TURCO,estado nutricional en menores de 5 anos,clasificacion a y b,2003-03-01,5,0,5,0,5
21302,UMALA,estado nutricional en menores de 5 anos,clasificacion a y b,2003-03-01,10,2,10,2,12
50201,UNCIA,estado nutricional en menores de 5 anos,clasificacion a y b,2003-03-01,3,3,3,3,6
60401,URIONDO (A. CONCEPCION),estado nutricional en menores de 5 anos,clasificacion a y b,2003-03-01,69,13,69,13,82
71502,URUBICHA,estado nutricional en menores de 5 anos,clasificacion a y b,2003-03-01,9,3,9,3,12
51201,UYUNI,estado nutricional en menores de 5 anos,clasificacion a y b,2003-03-01,42,18,42,18,60
30502,VACAS,estado nutricional en menores de 5 anos,clasificacion a y b,2003-03-01,1,0,1,0,1
70801,VALLEGRANDE,estado nutricional en menores de 5 anos,clasificacion a y b,2003-03-01,40,26,40,26,66
20801,VIACHA,estado nutricional en menores de 5 anos,clasificacion a y b,2003-03-01,86,24,86,24,110
31302,VILA VILA,estado nutricional en menores de 5 anos,clasificacion a y b,2003-03-01,4,0,4,0,4
60303,VILLA MONTES,estado nutricional en menores de 5 anos,clasificacion a y b,2003-03-01,42,25,42,25,67
31402,VILLA RIVERO,estado nutricional en menores de 5 anos,clasificacion a y b,2003-03-01,17,1,17,1,18
10801,VILLA SERRANO,estado nutricional en menores de 5 anos,clasificacion a y b,2003-03-01,19,1,19,1,20
31003,VILLA TUNARI,estado nutricional en menores de 5 anos,clasificacion a y b,2003-03-01,83,70,83,70,153
11001,VILLA VACA GUZMAN (MUYUPAMPA),estado nutricional en menores de 5 anos,clasificacion a y b,2003-03-01,54,9,54,9,63
51501,VILLAZON,estado nutricional en menores de 5 anos,clasificacion a y b,2003-03-01,66,11,66,11,77
50602,VITICHI,estado nutricional en menores de 5 anos,clasificacion a y b,2003-03-01,15,11,15,11,26
20306,WALDO BALLIVIAN,estado nutricional en menores de 5 anos,clasificacion a y b,2003-03-01,1,0,1,0,1
70201,WARNES,estado nutricional en menores de 5 anos,clasificacion a y b,2003-03-01,129,30,129,30,159
20903,YACO,estado nutricional en menores de 5 anos,clasificacion a y b,2003-03-01,11,2,11,2,13
60301,YACUIBA,estado nutricional en menores de 5 anos,clasificacion a y b,2003-03-01,204,21,204,21,225
10602,YAMPARAEZ,estado nutricional en menores de 5 anos,clasificacion a y b,2003-03-01,21,4,21,4,25
21103,YANACACHI,estado nutricional en menores de 5 anos,clasificacion a y b,2003-03-01,9,0,9,0,9
70403,YAPACANI,estado nutricional en menores de 5 anos,clasificacion a y b,2003-03-01,131,11,131,11,142
50103,YOCALLA,estado nutricional en menores de 5 anos,clasificacion a y b,2003-03-01,7,3,7,3,10
10102,YOTALA,estado nutricional en menores de 5 anos,clasificacion a y b,2003-03-01,40,7,40,7,47
60402,YUNCHARA,estado nutricional en menores de 5 anos,clasificacion a y b,2003-03-01,8,3,8,3,11
10301,ZUDAÃ‘EZ,estado nutricional en menores de 5 anos,clasificacion a y b,2003-03-01,15,1,15,1,16
51302,ACACIO,estado nutricional en menores de 5 anos,clasificacion a y b,2003-04-01,3,1,3,1,4
20201,ACHACACHI,estado nutricional en menores de 5 anos,clasificacion a y b,2003-04-01,53,35,53,35,88
20104,ACHOCALLA,estado nutricional en menores de 5 anos,clasificacion a y b,2003-04-01,7,4,7,4,11
30201,AIQUILE,estado nutricional en menores de 5 anos,clasificacion a y b,2003-04-01,27,6,27,6,33
31303,ALALAY,estado nutricional en menores de 5 anos,clasificacion a y b,2003-04-01,3,4,3,4,7
10404,ALCALA,estado nutricional en menores de 5 anos,clasificacion a y b,2003-04-01,10,3,10,3,13
20202,ANCORAIMES,estado nutricional en menores de 5 anos,clasificacion a y b,2003-04-01,7,0,7,0,7
41201,ANDAMARCA,estado nutricional en menores de 5 anos,clasificacion a y b,2003-04-01,4,0,4,0,4
30402,ANZALDO,estado nutricional en menores de 5 anos,clasificacion a y b,2003-04-01,12,4,12,4,16
20701,APOLO,estado nutricional en menores de 5 anos,clasificacion a y b,2003-04-01,15,9,15,9,24
51301,ARAMPAMPA,estado nutricional en menores de 5 anos,clasificacion a y b,2003-04-01,11,24,11,24,35
30501,ARANI,estado nutricional en menores de 5 anos,clasificacion a y b,2003-04-01,2,13,2,13,15
30403,ARBIETO,estado nutricional en menores de 5 anos,clasificacion a y b,2003-04-01,9,1,9,1,10
30601,ARQUE,estado nutricional en menores de 5 anos,clasificacion a y b,2003-04-01,1,1,1,1,2
71501,ASCENCION DE GUARAYOS,estado nutricional en menores de 5 anos,clasificacion a y b,2003-04-01,72,22,72,22,94
50802,ATOCHA,estado nutricional en menores de 5 anos,clasificacion a y b,2003-04-01,9,28,9,28,37
20503,AUCAPATA,estado nutricional en menores de 5 anos,clasificacion a y b,2003-04-01,6,0,6,0,6
20502,AYATA,estado nutricional en menores de 5 anos,clasificacion a y b,2003-04-01,3,0,3,0,3
21303,AYO AYO,estado nutricional en menores de 5 anos,clasificacion a y b,2003-04-01,25,5,25,5,30
30301,AYOPAYA (V. DE INDEPENDENCIA),estado nutricional en menores de 5 anos,clasificacion a y b,2003-04-01,10,5,10,5,15
10201,AZURDUY,estado nutricional en menores de 5 anos,clasificacion a y b,2003-04-01,23,11,23,11,34
21203,BATALLAS,estado nutricional en menores de 5 anos,clasificacion a y b,2003-04-01,22,8,22,8,30
80802,BAURES,estado nutricional en menores de 5 anos,clasificacion a y b,2003-04-01,13,10,13,10,23
90104,BELLA FLOR,estado nutricional en menores de 5 anos,clasificacion a y b,2003-04-01,11,5,11,5,16
60202,BERMEJO,estado nutricional en menores de 5 anos,clasificacion a y b,2003-04-01,18,10,18,10,28
50301,BETANZOS,estado nutricional en menores de 5 anos,clasificacion a y b,2003-04-01,34,5,34,5,39
31501,BOLIVAR,estado nutricional en menores de 5 anos,clasificacion a y b,2003-04-01,8,5,8,5,13
90103,BOLPEBRA,estado nutricional en menores de 5 anos,clasificacion a y b,2003-04-01,2,1,2,1,3
70707,BOYUIBE,estado nutricional en menores de 5 anos,clasificacion a y b,2003-04-01,19,10,19,10,29
70401,BUENA VISTA,estado nutricional en menores de 5 anos,clasificacion a y b,2003-04-01,91,40,91,40,131
70703,CABEZAS,estado nutricional en menores de 5 anos,clasificacion a y b,2003-04-01,47,21,47,21,68
20905,CAIROMA,estado nutricional en menores de 5 anos,clasificacion a y b,2003-04-01,21,19,21,19,40
51102,"CAIZA ""D""",estado nutricional en menores de 5 anos,clasificacion a y b,2003-04-01,13,0,13,0,13
21003,CAJUATA,estado nutricional en menores de 5 anos,clasificacion a y b,2003-04-01,18,2,18,2,20
20303,CALACOTO,estado nutricional en menores de 5 anos,clasificacion a y b,2003-04-01,6,3,6,3,9
21304,CALAMARCA,estado nutricional en menores de 5 anos,clasificacion a y b,2003-04-01,14,1,14,1,15
10701,CAMARGO,estado nutricional en menores de 5 anos,clasificacion a y b,2003-04-01,24,12,24,12,36
10901,CAMATAQUI (C. VILLA ABECIA),estado nutricional en menores de 5 anos,clasificacion a y b,2003-04-01,6,2,6,2,8
70706,CAMIRI,estado nutricional en menores de 5 anos,clasificacion a y b,2003-04-01,183,46,183,46,229
30701,CAPINOTA,estado nutricional en menores de 5 anos,clasificacion a y b,2003-04-01,3,1,3,1,4
20302,CAQUIAVIRI,estado nutricional en menores de 5 anos,clasificacion a y b,2003-04-01,6,2,6,2,8
40102,CARACOLLO,estado nutricional en menores de 5 anos,clasificacion a y b,2003-04-01,19,13,19,13,32
22001,CARANAVI,estado nutricional en menores de 5 anos,clasificacion a y b,2003-04-01,119,31,119,31,150
60302,CARAPARI,estado nutricional en menores de 5 anos,clasificacion a y b,2003-04-01,26,12,26,12,38
50702,CARIPUYO,estado nutricional en menores de 5 anos,clasificacion a y b,2003-04-01,9,1,9,1,10
40201,CHALLAPATA,estado nutricional en menores de 5 anos,clasificacion a y b,2003-04-01,10,9,10,9,19
50302,CHAQUI,estado nutricional en menores de 5 anos,clasificacion a y b,2003-04-01,29,1,29,1,30
70702,CHARAGUA,estado nutricional en menores de 5 anos,clasificacion a y b,2003-04-01,82,41,82,41,123
20305,CHARAÃ‘A,estado nutricional en menores de 5 anos,clasificacion a y b,2003-04-01,3,0,3,0,3
50202,CHAYANTA,estado nutricional en menores de 5 anos,clasificacion a y b,2003-04-01,13,16,13,16,29
31204,CHIMORE,estado nutricional en menores de 5 anos,clasificacion a y b,2003-04-01,42,12,42,12,54
40903,CHIPAYA,estado nutricional en menores de 5 anos,clasificacion a y b,2003-04-01,2,8,2,8,10
40302,CHOQUE COTA,estado nutricional en menores de 5 anos,clasificacion a y b,2003-04-01,2,0,2,0,2
21101,CHULUMANI (V. DE LA LIBERTAD),estado nutricional en menores de 5 anos,clasificacion a y b,2003-04-01,6,2,6,2,8
20501,CHUMA,estado nutricional en menores de 5 anos,clasificacion a y b,2003-04-01,30,31,30,31,61
30801,CLIZA,estado nutricional en menores de 5 anos,clasificacion a y b,2003-04-01,12,12,12,12,24
90101,COBIJA,estado nutricional en menores de 5 anos,clasificacion a y b,2003-04-01,99,70,99,70,169
30101,COCHABAMBA,estado nutricional en menores de 5 anos,clasificacion a y b,2003-04-01,1575,1159,1575,1159,2734
40902,COIPASA,estado nutricional en menores de 5 anos,clasificacion a y b,2003-04-01,2,0,2,0,2
30905,COLCAPIRHUA,estado nutricional en menores de 5 anos,clasificacion a y b,2003-04-01,10,3,10,3,13
50901,"COLCHA ""K""",estado nutricional en menores de 5 anos,clasificacion a y b,2003-04-01,15,3,15,3,18
31002,COLOMI,estado nutricional en menores de 5 anos,clasificacion a y b,2003-04-01,25,17,25,17,42
50401,COLQUECHACA,estado nutricional en menores de 5 anos,clasificacion a y b,2003-04-01,12,19,12,19,31
21306,COLQUENCHA,estado nutricional en menores de 5 anos,clasificacion a y b,2003-04-01,22,7,22,7,29
21004,COLQUIRI,estado nutricional en menores de 5 anos,clasificacion a y b,2003-04-01,25,1,25,1,26
20304,COMANCHE,estado nutricional en menores de 5 anos,clasificacion a y b,2003-04-01,0,1,0,1,1
71301,COMARAPA,estado nutricional en menores de 5 anos,clasificacion a y b,2003-04-01,92,6,92,6,98
20605,COMBAYA,estado nutricional en menores de 5 anos,clasificacion a y b,2003-04-01,6,8,6,8,14
71101,CONCEPCION,estado nutricional en menores de 5 anos,clasificacion a y b,2003-04-01,14,25,14,25,39
21701,COPACABANA,estado nutricional en menores de 5 anos,clasificacion a y b,2003-04-01,17,3,17,3,20
21402,CORIPATA,estado nutricional en menores de 5 anos,clasificacion a y b,2003-04-01,56,5,56,5,61
20301,CORO CORO,estado nutricional en menores de 5 anos,clasificacion a y b,2003-04-01,5,2,5,2,7
21401,COROICO,estado nutricional en menores de 5 anos,clasificacion a y b,2003-04-01,5,4,5,4,9
40301,CORQUE,estado nutricional en menores de 5 anos,clasificacion a y b,2003-04-01,6,0,6,0,6
50601,COTAGAITA,estado nutricional en menores de 5 anos,clasificacion a y b,2003-04-01,38,7,38,7,45
70102,COTOCA,estado nutricional en menores de 5 anos,clasificacion a y b,2003-04-01,62,3,62,3,65
70704,CUEVO,estado nutricional en menores de 5 anos,clasificacion a y b,2003-04-01,7,1,7,1,8
10902,CULPINA,estado nutricional en menores de 5 anos,clasificacion a y b,2003-04-01,46,23,46,23,69
40401,CURAHUARA DE CARANGAS,estado nutricional en menores de 5 anos,clasificacion a y b,2003-04-01,2,1,2,1,3
21602,CURVA,estado nutricional en menores de 5 anos,clasificacion a y b,2003-04-01,4,0,4,0,4
20804,DESAGUADERO,estado nutricional en menores de 5 anos,clasificacion a y b,2003-04-01,5,1,5,1,6
20105,EL ALTO,estado nutricional en menores de 5 anos,clasificacion a y b,2003-04-01,748,210,748,210,958
40103,EL CHORO,estado nutricional en menores de 5 anos,clasificacion a y b,2003-04-01,6,1,6,1,7
71503,EL PUENTE(STC),estado nutricional en menores de 5 anos,clasificacion a y b,2003-04-01,7,13,7,13,20
60502,EL PUENTE(TJA),estado nutricional en menores de 5 anos,clasificacion a y b,2003-04-01,6,2,6,2,8
70105,EL TORNO,estado nutricional en menores de 5 anos,clasificacion a y b,2003-04-01,137,12,137,12,149
10405,EL VILLAR,estado nutricional en menores de 5 anos,clasificacion a y b,2003-04-01,8,4,8,4,12
60601,ENTRE RIOS,estado nutricional en menores de 5 anos,clasificacion a y b,2003-04-01,39,24,39,24,63
41101,EUCALIPTUS,estado nutricional en menores de 5 anos,clasificacion a y b,2003-04-01,9,0,9,0,9
90503,EUREKA (SANTOS MERCADO),estado nutricional en menores de 5 anos,clasificacion a y b,2003-04-01,4,1,4,1,5
80402,EXALTACION,estado nutricional en menores de 5 anos,clasificacion a y b,2003-04-01,5,6,5,6,11
90203,FILADELFIA,estado nutricional en menores de 5 anos,clasificacion a y b,2003-04-01,5,3,5,3,8
71002,GENERAL SAAVEDRA,estado nutricional en menores de 5 anos,clasificacion a y b,2003-04-01,56,28,56,28,84
21601,GRAL. J.J. PEREZ (CHARAZANI),estado nutricional en menores de 5 anos,clasificacion a y b,2003-04-01,16,8,16,8,24
20602,GUANAY,estado nutricional en menores de 5 anos,clasificacion a y b,2003-04-01,71,24,71,24,95
20802,GUAQUI,estado nutricional en menores de 5 anos,clasificacion a y b,2003-04-01,8,0,8,0,8
80202,GUAYARAMERIN,estado nutricional en menores de 5 anos,clasificacion a y b,2003-04-01,123,14,123,14,137
70705,GUTIERREZ,estado nutricional en menores de 5 anos,clasificacion a y b,2003-04-01,63,12,63,12,75
10502,HUACARETA,estado nutricional en menores de 5 anos,clasificacion a y b,2003-04-01,20,14,20,14,34
11002,HUACAYA (VILLA DE HUACAYA),estado nutricional en menores de 5 anos,clasificacion a y b,2003-04-01,12,0,12,0,12
40501,HUACHACALLA,estado nutricional en menores de 5 anos,clasificacion a y b,2003-04-01,0,1,0,1,1
40701,HUANUNI,estado nutricional en menores de 5 anos,clasificacion a y b,2003-04-01,37,3,37,3,40
80803,HUARACAJE,estado nutricional en menores de 5 anos,clasificacion a y b,2003-04-01,11,1,11,1,12
41601,HUAYLLAMARCA,estado nutricional en menores de 5 anos,clasificacion a y b,2003-04-01,4,3,4,3,7
21005,ICHOCA,estado nutricional en menores de 5 anos,clasificacion a y b,2003-04-01,10,4,10,4,14
10304,ICLA,estado nutricional en menores de 5 anos,clasificacion a y b,2003-04-01,18,6,18,6,24
10703,INCAHUASI,estado nutricional en menores de 5 anos,clasificacion a y b,2003-04-01,44,2,44,2,46
90402,INGAVI (HUMAITA),estado nutricional en menores de 5 anos,clasificacion a y b,2003-04-01,5,9,5,9,14
21001,INQUISIVI,estado nutricional en menores de 5 anos,clasificacion a y b,2003-04-01,49,8,49,8,57
21102,IRUPANA (VILLA DE LANZA),estado nutricional en menores de 5 anos,clasificacion a y b,2003-04-01,19,12,19,12,31
21501,IXIAMAS,estado nutricional en menores de 5 anos,clasificacion a y b,2003-04-01,30,6,30,6,36
21105,LA ASUNTA,estado nutricional en menores de 5 anos,clasificacion a y b,2003-04-01,76,7,76,7,83
70104,LA GUARDIA,estado nutricional en menores de 5 anos,clasificacion a y b,2003-04-01,120,33,120,33,153
20101,LA PAZ,estado nutricional en menores de 5 anos,clasificacion a y b,2003-04-01,927,312,927,312,1239
70701,LAGUNILLAS,estado nutricional en menores de 5 anos,clasificacion a y b,2003-04-01,35,12,35,12,47
21202,LAJA,estado nutricional en menores de 5 anos,clasificacion a y b,2003-04-01,16,1,16,1,17
10903,LAS CARRERAS,estado nutricional en menores de 5 anos,clasificacion a y b,2003-04-01,10,3,10,3,13
50203,LLALLAGUA,estado nutricional en menores de 5 anos,clasificacion a y b,2003-04-01,10,82,10,82,92
51401,LLICA,estado nutricional en menores de 5 anos,clasificacion a y b,2003-04-01,4,3,4,3,7
80601,LORETO,estado nutricional en menores de 5 anos,clasificacion a y b,2003-04-01,12,3,12,3,15
20901,LURIBAY,estado nutricional en menores de 5 anos,clasificacion a y b,2003-04-01,10,4,10,4,14
40702,MACHACAMARCA,estado nutricional en menores de 5 anos,clasificacion a y b,2003-04-01,6,2,6,2,8
11003,MACHARETI,estado nutricional en menores de 5 anos,clasificacion a y b,2003-04-01,48,22,48,22,70
80801,MAGDALENA,estado nutricional en menores de 5 anos,clasificacion a y b,2003-04-01,30,9,30,9,39
70903,MAIRANA,estado nutricional en menores de 5 anos,clasificacion a y b,2003-04-01,52,6,52,6,58
20904,MALLA,estado nutricional en menores de 5 anos,clasificacion a y b,2003-04-01,2,0,2,0,2
20103,MECAPACA,estado nutricional en menores de 5 anos,clasificacion a y b,2003-04-01,5,0,5,0,5
71003,MINEROS,estado nutricional en menores de 5 anos,clasificacion a y b,2003-04-01,236,30,236,30,266
31301,MIZQUE,estado nutricional en menores de 5 anos,clasificacion a y b,2003-04-01,24,1,24,1,25
20402,MOCOMOCO,estado nutricional en menores de 5 anos,clasificacion a y b,2003-04-01,18,0,18,0,18
51002,MOJINETE,estado nutricional en menores de 5 anos,clasificacion a y b,2003-04-01,1,1,1,1,2
10303,MOJOCOYA,estado nutricional en menores de 5 anos,clasificacion a y b,2003-04-01,33,7,33,7,40
10501,MONTEAGUDO,estado nutricional en menores de 5 anos,clasificacion a y b,2003-04-01,125,44,125,44,169
71001,MONTERO,estado nutricional en menores de 5 anos,clasificacion a y b,2003-04-01,488,111,488,111,599
70803,MORO MORO,estado nutricional en menores de 5 anos,clasificacion a y b,2003-04-01,10,1,10,1,11
30302,MOROCHATA,estado nutricional en menores de 5 anos,clasificacion a y b,2003-04-01,54,5,54,5,59
90401,NACEBE (SANTA ROSA DEL ABUNA),estado nutricional en menores de 5 anos,clasificacion a y b,2003-04-01,0,1,0,1,1
50404,OCURI,estado nutricional en menores de 5 anos,clasificacion a y b,2003-04-01,11,4,11,4,15
70202,OKINAWA,estado nutricional en menores de 5 anos,clasificacion a y b,2003-04-01,17,1,17,1,18
30203,OMEREQUE,estado nutricional en menores de 5 anos,clasificacion a y b,2003-04-01,8,2,8,2,10
40101,ORURO,estado nutricional en menores de 5 anos,clasificacion a y b,2003-04-01,296,149,296,149,445
60201,PADCAYA,estado nutricional en menores de 5 anos,clasificacion a y b,2003-04-01,53,39,53,39,92
10401,PADILLA,estado nutricional en menores de 5 anos,clasificacion a y b,2003-04-01,47,6,47,6,53
70502,PAILON,estado nutricional en menores de 5 anos,clasificacion a y b,2003-04-01,16,7,16,7,23
20102,PALCA,estado nutricional en menores de 5 anos,clasificacion a y b,2003-04-01,14,6,14,6,20
21104,PALOS BLANCOS,estado nutricional en menores de 5 anos,clasificacion a y b,2003-04-01,39,13,39,13,52
40802,PAMPA AULLAGAS,estado nutricional en menores de 5 anos,clasificacion a y b,2003-04-01,2,0,2,0,2
70902,PAMPA GRANDE,estado nutricional en menores de 5 anos,clasificacion a y b,2003-04-01,33,1,33,1,34
21802,PAPEL PAMPA,estado nutricional en menores de 5 anos,clasificacion a y b,2003-04-01,13,2,13,2,15
30202,PASORAPA,estado nutricional en menores de 5 anos,clasificacion a y b,2003-04-01,7,0,7,0,7
21305,PATACAMAYA,estado nutricional en menores de 5 anos,clasificacion a y b,2003-04-01,34,2,34,2,36
40602,PAZÃ‘A,estado nutricional en menores de 5 anos,clasificacion a y b,2003-04-01,6,0,6,0,6
20702,PELECHUCO,estado nutricional en menores de 5 anos,clasificacion a y b,2003-04-01,3,2,3,2,5
50403,POCOATA,estado nutricional en menores de 5 anos,clasificacion a y b,2003-04-01,24,11,24,11,35
31203,POCONA,estado nutricional en menores de 5 anos,clasificacion a y b,2003-04-01,12,1,12,1,13
31202,POJO (CBBA),estado nutricional en menores de 5 anos,clasificacion a y b,2003-04-01,113,33,113,33,146
40601,POOPO,estado nutricional en menores de 5 anos,clasificacion a y b,2003-04-01,7,2,7,2,9
51203,PORCO,estado nutricional en menores de 5 anos,clasificacion a y b,2003-04-01,25,2,25,2,27
10103,POROMA,estado nutricional en menores de 5 anos,clasificacion a y b,2003-04-01,54,8,54,8,62
70103,PORONGO,estado nutricional en menores de 5 anos,clasificacion a y b,2003-04-01,9,1,9,1,10
70601,PORTACHUELO,estado nutricional en menores de 5 anos,clasificacion a y b,2003-04-01,126,43,126,43,169
90102,PORVENIR,estado nutricional en menores de 5 anos,clasificacion a y b,2003-04-01,4,3,4,3,7
70804,POSTRER VALLE,estado nutricional en menores de 5 anos,clasificacion a y b,2003-04-01,4,1,4,1,5
50101,POTOSI,estado nutricional en menores de 5 anos,clasificacion a y b,2003-04-01,165,7,165,7,172
10302,PRESTO,estado nutricional en menores de 5 anos,clasificacion a y b,2003-04-01,15,0,15,0,15
21201,PUCARANI,estado nutricional en menores de 5 anos,clasificacion a y b,2003-04-01,41,2,41,2,43
20401,PUERTO ACOSTA,estado nutricional en menores de 5 anos,clasificacion a y b,2003-04-01,35,21,35,21,56
20403,PUERTO CARABUCO,estado nutricional en menores de 5 anos,clasificacion a y b,2003-04-01,14,1,14,1,15
90301,PUERTO GONZALO MORENO,estado nutricional en menores de 5 anos,clasificacion a y b,2003-04-01,13,2,13,2,15
21204,PUERTO PEREZ,estado nutricional en menores de 5 anos,clasificacion a y b,2003-04-01,11,3,11,3,14
71402,PUERTO QUIJARRO,estado nutricional en menores de 5 anos,clasificacion a y b,2003-04-01,55,19,55,19,74
90201,PUERTO RICO,estado nutricional en menores de 5 anos,clasificacion a y b,2003-04-01,1,9,1,9,10
80703,PUERTO SILES,estado nutricional en menores de 5 anos,clasificacion a y b,2003-04-01,1,0,1,0,1
71401,PUERTO SUAREZ,estado nutricional en menores de 5 anos,clasificacion a y b,2003-04-01,61,9,61,9,70
31205,PUERTO VILLARROEL,estado nutricional en menores de 5 anos,clasificacion a y b,2003-04-01,201,47,201,47,248
51101,PUNA,estado nutricional en menores de 5 anos,clasificacion a y b,2003-04-01,24,0,24,0,24
31401,PUNATA,estado nutricional en menores de 5 anos,clasificacion a y b,2003-04-01,32,21,32,21,53
20604,QUIABAYA,estado nutricional en menores de 5 anos,clasificacion a y b,2003-04-01,7,0,7,0,7
30901,QUILLACOLLO,estado nutricional en menores de 5 anos,clasificacion a y b,2003-04-01,90,29,90,29,119
21002,QUIME,estado nutricional en menores de 5 anos,clasificacion a y b,2003-04-01,20,3,20,3,23
70904,QUIRUSILLAS,estado nutricional en menores de 5 anos,clasificacion a y b,2003-04-01,14,8,14,8,22
50402,RAVELO,estado nutricional en menores de 5 anos,clasificacion a y b,2003-04-01,6,4,6,4,10
80301,REYES,estado nutricional en menores de 5 anos,clasificacion a y b,2003-04-01,32,5,32,5,37
80201,RIBERALTA,estado nutricional en menores de 5 anos,clasificacion a y b,2003-04-01,221,24,221,24,245
70503,ROBORE,estado nutricional en menores de 5 anos,clasificacion a y b,2003-04-01,45,9,45,9,54
80304,RURRENABAQUE,estado nutricional en menores de 5 anos,clasificacion a y b,2003-04-01,2,3,2,3,5
40901,SABAYA,estado nutricional en menores de 5 anos,clasificacion a y b,2003-04-01,2,0,2,0,2
31001,SACABA,estado nutricional en menores de 5 anos,clasificacion a y b,2003-04-01,90,27,90,27,117
30404,SACABAMBA,estado nutricional en menores de 5 anos,clasificacion a y b,2003-04-01,0,1,0,1,1
50701,SACACA,estado nutricional en menores de 5 anos,clasificacion a y b,2003-04-01,11,4,11,4,15
71302,SAIPINA,estado nutricional en menores de 5 anos,clasificacion a y b,2003-04-01,49,20,49,20,69
70901,SAMAIPATA,estado nutricional en menores de 5 anos,clasificacion a y b,2003-04-01,40,5,40,5,45
51601,SAN AGUSTIN,estado nutricional en menores de 5 anos,clasificacion a y b,2003-04-01,3,0,3,0,3
80602,SAN ANDRES,estado nutricional en menores de 5 anos,clasificacion a y b,2003-04-01,10,1,10,1,11
71105,SAN ANTONIO DE LOMERIO,estado nutricional en menores de 5 anos,clasificacion a y b,2003-04-01,9,5,9,5,14
31403,SAN BENITO,estado nutricional en menores de 5 anos,clasificacion a y b,2003-04-01,4,11,4,11,15
80302,SAN BORJA,estado nutricional en menores de 5 anos,clasificacion a y b,2003-04-01,169,17,169,17,186
21502,SAN BUENA VENTURA,estado nutricional en menores de 5 anos,clasificacion a y b,2003-04-01,27,2,27,2,29
70402,SAN CARLOS,estado nutricional en menores de 5 anos,clasificacion a y b,2003-04-01,77,12,77,12,89
80501,SAN IGNACIO,estado nutricional en menores de 5 anos,clasificacion a y b,2003-04-01,48,38,48,38,86
70301,SAN IGNACIO DE VELASCO,estado nutricional en menores de 5 anos,clasificacion a y b,2003-04-01,195,21,195,21,216
80102,SAN JAVIER(BNI),estado nutricional en menores de 5 anos,clasificacion a y b,2003-04-01,3,1,3,1,4
71102,SAN JAVIER(STC),estado nutricional en menores de 5 anos,clasificacion a y b,2003-04-01,45,10,45,10,55
80701,SAN JOAQUIN,estado nutricional en menores de 5 anos,clasificacion a y b,2003-04-01,1,8,1,8,9
70501,SAN JOSE DE CHIQUITOS,estado nutricional en menores de 5 anos,clasificacion a y b,2003-04-01,29,3,29,3,32
71104,SAN JULIAN,estado nutricional en menores de 5 anos,clasificacion a y b,2003-04-01,97,42,97,42,139
90302,SAN LORENZO(PND),estado nutricional en menores de 5 anos,clasificacion a y b,2003-04-01,0,1,0,1,1
60501,SAN LORENZO(TJA),estado nutricional en menores de 5 anos,clasificacion a y b,2003-04-01,39,21,39,21,60
10702,SAN LUCAS,estado nutricional en menores de 5 anos,clasificacion a y b,2003-04-01,93,6,93,6,99
70302,SAN MIGUEL DE VELASCO,estado nutricional en menores de 5 anos,clasificacion a y b,2003-04-01,22,1,22,1,23
51001,SAN PABLO DE LIPEZ,estado nutricional en menores de 5 anos,clasificacion a y b,2003-04-01,2,0,2,0,2
50501,SAN PEDRO DE BUENA VISTA,estado nutricional en menores de 5 anos,clasificacion a y b,2003-04-01,24,6,24,6,30
21801,SAN PEDRO DE CURAHUARA,estado nutricional en menores de 5 anos,clasificacion a y b,2003-04-01,4,3,4,3,7
21702,SAN PEDRO DE TIQUINA,estado nutricional en menores de 5 anos,clasificacion a y b,2003-04-01,6,1,6,1,7
70303,SAN RAFAEL,estado nutricional en menores de 5 anos,clasificacion a y b,2003-04-01,16,2,16,2,18
80702,SAN RAMON,estado nutricional en menores de 5 anos,clasificacion a y b,2003-04-01,7,2,7,2,9
80401,SANTA ANA,estado nutricional en menores de 5 anos,clasificacion a y b,2003-04-01,3,0,3,0,3
70101,SANTA CRUZ DE LA SIERRA,estado nutricional en menores de 5 anos,clasificacion a y b,2003-04-01,2932,817,2932,817,3749
80303,SANTA ROSA,estado nutricional en menores de 5 anos,clasificacion a y b,2003-04-01,18,11,18,11,29
70602,SANTA ROSA DEL SARA,estado nutricional en menores de 5 anos,clasificacion a y b,2003-04-01,11,23,11,23,34
20308,SANTIAGO DE CALLAPA,estado nutricional en menores de 5 anos,clasificacion a y b,2003-04-01,5,3,5,3,8
41401,SANTIAGO DE HUARI,estado nutricional en menores de 5 anos,clasificacion a y b,2003-04-01,8,1,8,1,9
21901,SANTIAGO DE MACHACA,estado nutricional en menores de 5 anos,clasificacion a y b,2003-04-01,1,0,1,0,1
30702,SANTIVAÃ‘ES,estado nutricional en menores de 5 anos,clasificacion a y b,2003-04-01,5,0,5,0,5
40202,SANTUARIO DE QUILLACAS,estado nutricional en menores de 5 anos,clasificacion a y b,2003-04-01,1,0,1,0,1
20902,SAPAHAQUI,estado nutricional en menores de 5 anos,clasificacion a y b,2003-04-01,19,4,19,4,23
90303,SENA,estado nutricional en menores de 5 anos,clasificacion a y b,2003-04-01,7,0,7,0,7
21301,SICA SICA (VILLA AROMA),estado nutricional en menores de 5 anos,clasificacion a y b,2003-04-01,19,5,19,5,24
30902,SIPE SIPE,estado nutricional en menores de 5 anos,clasificacion a y b,2003-04-01,101,14,101,14,115
10403,SOPACHUY,estado nutricional en menores de 5 anos,clasificacion a y b,2003-04-01,18,2,18,2,20
20601,SORATA,estado nutricional en menores de 5 anos,clasificacion a y b,2003-04-01,22,6,22,6,28
10101,SUCRE,estado nutricional en menores de 5 anos,clasificacion a y b,2003-04-01,418,114,418,114,532
20603,TACACOMA,estado nutricional en menores de 5 anos,clasificacion a y b,2003-04-01,20,5,20,5,25
50303,TACOBAMBA,estado nutricional en menores de 5 anos,clasificacion a y b,2003-04-01,19,1,19,1,20
30602,TACOPAYA,estado nutricional en menores de 5 anos,clasificacion a y b,2003-04-01,19,2,19,2,21
51402,TAHUA,estado nutricional en menores de 5 anos,clasificacion a y b,2003-04-01,2,1,2,1,3
31101,TAPACARI,estado nutricional en menores de 5 anos,clasificacion a y b,2003-04-01,16,3,16,3,19
10601,TARABUCO,estado nutricional en menores de 5 anos,clasificacion a y b,2003-04-01,38,4,38,4,42
30401,TARATA,estado nutricional en menores de 5 anos,clasificacion a y b,2003-04-01,13,52,13,52,65
60101,TARIJA,estado nutricional en menores de 5 anos,clasificacion a y b,2003-04-01,351,155,351,155,506
10202,TARVITA,estado nutricional en menores de 5 anos,clasificacion a y b,2003-04-01,13,9,13,9,22
20803,TIAWANACU,estado nutricional en menores de 5 anos,clasificacion a y b,2003-04-01,28,7,28,7,35
50102,TINGUIPAYA,estado nutricional en menores de 5 anos,clasificacion a y b,2003-04-01,8,0,8,0,8
20606,TIPUANI,estado nutricional en menores de 5 anos,clasificacion a y b,2003-04-01,29,1,29,1,30
30903,TIQUIPAYA,estado nutricional en menores de 5 anos,clasificacion a y b,2003-04-01,26,11,26,11,37
31601,TIRAQUE (CBBA),estado nutricional en menores de 5 anos,clasificacion a y b,2003-04-01,108,28,108,28,136
30802,TOCO,estado nutricional en menores de 5 anos,clasificacion a y b,2003-04-01,0,1,0,1,1
30803,TOLATA,estado nutricional en menores de 5 anos,clasificacion a y b,2003-04-01,3,3,3,3,6
41001,TOLEDO,estado nutricional en menores de 5 anos,clasificacion a y b,2003-04-01,4,2,4,2,6
51202,TOMAVE,estado nutricional en menores de 5 anos,clasificacion a y b,2003-04-01,29,4,29,4,33
10402,TOMINA,estado nutricional en menores de 5 anos,clasificacion a y b,2003-04-01,22,6,22,6,28
50502,TORO TORO,estado nutricional en menores de 5 anos,clasificacion a y b,2003-04-01,18,3,18,3,21
31201,TOTORA(CBBA),estado nutricional en menores de 5 anos,clasificacion a y b,2003-04-01,25,1,25,1,26
41301,TOTORA(ORR),estado nutricional en menores de 5 anos,clasificacion a y b,2003-04-01,4,6,4,6,10
70802,TRIGAL,estado nutricional en menores de 5 anos,clasificacion a y b,2003-04-01,2,0,2,0,2
80101,TRINIDAD,estado nutricional en menores de 5 anos,clasificacion a y b,2003-04-01,158,128,158,128,286
50801,TUPIZA,estado nutricional en menores de 5 anos,clasificacion a y b,2003-04-01,66,74,66,74,140
40402,TURCO,estado nutricional en menores de 5 anos,clasificacion a y b,2003-04-01,1,1,1,1,2
21302,UMALA,estado nutricional en menores de 5 anos,clasificacion a y b,2003-04-01,15,24,15,24,39
50201,UNCIA,estado nutricional en menores de 5 anos,clasificacion a y b,2003-04-01,2,3,2,3,5
60401,URIONDO (A. CONCEPCION),estado nutricional en menores de 5 anos,clasificacion a y b,2003-04-01,80,23,80,23,103
71502,URUBICHA,estado nutricional en menores de 5 anos,clasificacion a y b,2003-04-01,11,3,11,3,14
51201,UYUNI,estado nutricional en menores de 5 anos,clasificacion a y b,2003-04-01,88,14,88,14,102
70801,VALLEGRANDE,estado nutricional en menores de 5 anos,clasificacion a y b,2003-04-01,60,15,60,15,75
20801,VIACHA,estado nutricional en menores de 5 anos,clasificacion a y b,2003-04-01,98,29,98,29,127
31302,VILA VILA,estado nutricional en menores de 5 anos,clasificacion a y b,2003-04-01,2,0,2,0,2
60303,VILLA MONTES,estado nutricional en menores de 5 anos,clasificacion a y b,2003-04-01,71,17,71,17,88
90502,VILLA NUEVA (LOMA ALTA),estado nutricional en menores de 5 anos,clasificacion a y b,2003-04-01,0,2,0,2,2
31402,VILLA RIVERO,estado nutricional en menores de 5 anos,clasificacion a y b,2003-04-01,11,1,11,1,12
10801,VILLA SERRANO,estado nutricional en menores de 5 anos,clasificacion a y b,2003-04-01,20,4,20,4,24
31003,VILLA TUNARI,estado nutricional en menores de 5 anos,clasificacion a y b,2003-04-01,86,17,86,17,103
11001,VILLA VACA GUZMAN (MUYUPAMPA),estado nutricional en menores de 5 anos,clasificacion a y b,2003-04-01,69,27,69,27,96
51501,VILLAZON,estado nutricional en menores de 5 anos,clasificacion a y b,2003-04-01,69,17,69,17,86
30904,VINTO,estado nutricional en menores de 5 anos,clasificacion a y b,2003-04-01,71,5,71,5,76
50602,VITICHI,estado nutricional en menores de 5 anos,clasificacion a y b,2003-04-01,26,7,26,7,33
70201,WARNES,estado nutricional en menores de 5 anos,clasificacion a y b,2003-04-01,151,36,151,36,187
20903,YACO,estado nutricional en menores de 5 anos,clasificacion a y b,2003-04-01,7,8,7,8,15
60301,YACUIBA,estado nutricional en menores de 5 anos,clasificacion a y b,2003-04-01,245,29,245,29,274
10602,YAMPARAEZ,estado nutricional en menores de 5 anos,clasificacion a y b,2003-04-01,32,8,32,8,40
21103,YANACACHI,estado nutricional en menores de 5 anos,clasificacion a y b,2003-04-01,10,1,10,1,11
70403,YAPACANI,estado nutricional en menores de 5 anos,clasificacion a y b,2003-04-01,189,27,189,27,216
50103,YOCALLA,estado nutricional en menores de 5 anos,clasificacion a y b,2003-04-01,2,1,2,1,3
10102,YOTALA,estado nutricional en menores de 5 anos,clasificacion a y b,2003-04-01,23,58,23,58,81
60402,YUNCHARA,estado nutricional en menores de 5 anos,clasificacion a y b,2003-04-01,18,6,18,6,24
10301,ZUDAÃ‘EZ,estado nutricional en menores de 5 anos,clasificacion a y b,2003-04-01,14,1,14,1,15
51302,ACACIO,estado nutricional en menores de 5 anos,clasificacion a y b,2003-05-01,1,1,1,1,2
20201,ACHACACHI,estado nutricional en menores de 5 anos,clasificacion a y b,2003-05-01,92,81,92,81,173
20104,ACHOCALLA,estado nutricional en menores de 5 anos,clasificacion a y b,2003-05-01,9,2,9,2,11
30201,AIQUILE,estado nutricional en menores de 5 anos,clasificacion a y b,2003-05-01,37,8,37,8,45
31303,ALALAY,estado nutricional en menores de 5 anos,clasificacion a y b,2003-05-01,5,0,5,0,5
10404,ALCALA,estado nutricional en menores de 5 anos,clasificacion a y b,2003-05-01,13,3,13,3,16
20202,ANCORAIMES,estado nutricional en menores de 5 anos,clasificacion a y b,2003-05-01,14,3,14,3,17
30402,ANZALDO,estado nutricional en menores de 5 anos,clasificacion a y b,2003-05-01,5,4,5,4,9
20701,APOLO,estado nutricional en menores de 5 anos,clasificacion a y b,2003-05-01,11,7,11,7,18
51301,ARAMPAMPA,estado nutricional en menores de 5 anos,clasificacion a y b,2003-05-01,5,6,5,6,11
30403,ARBIETO,estado nutricional en menores de 5 anos,clasificacion a y b,2003-05-01,6,0,6,0,6
30601,ARQUE,estado nutricional en menores de 5 anos,clasificacion a y b,2003-05-01,4,2,4,2,6
50802,ATOCHA,estado nutricional en menores de 5 anos,clasificacion a y b,2003-05-01,11,20,11,20,31
20503,AUCAPATA,estado nutricional en menores de 5 anos,clasificacion a y b,2003-05-01,10,2,10,2,12
20502,AYATA,estado nutricional en menores de 5 anos,clasificacion a y b,2003-05-01,3,0,3,0,3
21303,AYO AYO,estado nutricional en menores de 5 anos,clasificacion a y b,2003-05-01,41,6,41,6,47
30301,AYOPAYA (V. DE INDEPENDENCIA),estado nutricional en menores de 5 anos,clasificacion a y b,2003-05-01,15,14,15,14,29
10201,AZURDUY,estado nutricional en menores de 5 anos,clasificacion a y b,2003-05-01,17,7,17,7,24
21203,BATALLAS,estado nutricional en menores de 5 anos,clasificacion a y b,2003-05-01,34,12,34,12,46
80802,BAURES,estado nutricional en menores de 5 anos,clasificacion a y b,2003-05-01,13,4,13,4,17
41202,BELEN DE ANDAMARCA,estado nutricional en menores de 5 anos,clasificacion a y b,2003-05-01,0,1,0,1,1
50104,BELEN DE URMIRI,estado nutricional en menores de 5 anos,clasificacion a y b,2003-05-01,5,0,5,0,5
90104,BELLA FLOR,estado nutricional en menores de 5 anos,clasificacion a y b,2003-05-01,5,6,5,6,11
60202,BERMEJO,estado nutricional en menores de 5 anos,clasificacion a y b,2003-05-01,14,24,14,24,38
50301,BETANZOS,estado nutricional en menores de 5 anos,clasificacion a y b,2003-05-01,45,13,45,13,58
31501,BOLIVAR,estado nutricional en menores de 5 anos,clasificacion a y b,2003-05-01,4,0,4,0,4
90103,BOLPEBRA,estado nutricional en menores de 5 anos,clasificacion a y b,2003-05-01,2,5,2,5,7
70707,BOYUIBE,estado nutricional en menores de 5 anos,clasificacion a y b,2003-05-01,24,12,24,12,36
70401,BUENA VISTA,estado nutricional en menores de 5 anos,clasificacion a y b,2003-05-01,111,48,111,48,159
70703,CABEZAS,estado nutricional en menores de 5 anos,clasificacion a y b,2003-05-01,37,26,37,26,63
20905,CAIROMA,estado nutricional en menores de 5 anos,clasificacion a y b,2003-05-01,3,4,3,4,7
51102,"CAIZA ""D""",estado nutricional en menores de 5 anos,clasificacion a y b,2003-05-01,27,4,27,4,31
21003,CAJUATA,estado nutricional en menores de 5 anos,clasificacion a y b,2003-05-01,24,6,24,6,30
20303,CALACOTO,estado nutricional en menores de 5 anos,clasificacion a y b,2003-05-01,3,0,3,0,3
21304,CALAMARCA,estado nutricional en menores de 5 anos,clasificacion a y b,2003-05-01,5,2,5,2,7
10701,CAMARGO,estado nutricional en menores de 5 anos,clasificacion a y b,2003-05-01,21,4,21,4,25
10901,CAMATAQUI (C. VILLA ABECIA),estado nutricional en menores de 5 anos,clasificacion a y b,2003-05-01,3,2,3,2,5
70706,CAMIRI,estado nutricional en menores de 5 anos,clasificacion a y b,2003-05-01,137,26,137,26,163
30701,CAPINOTA,estado nutricional en menores de 5 anos,clasificacion a y b,2003-05-01,5,0,5,0,5
20302,CAQUIAVIRI,estado nutricional en menores de 5 anos,clasificacion a y b,2003-05-01,12,10,12,10,22
40102,CARACOLLO,estado nutricional en menores de 5 anos,clasificacion a y b,2003-05-01,23,5,23,5,28
22001,CARANAVI,estado nutricional en menores de 5 anos,clasificacion a y b,2003-05-01,136,69,136,69,205
60302,CARAPARI,estado nutricional en menores de 5 anos,clasificacion a y b,2003-05-01,39,7,39,7,46
50702,CARIPUYO,estado nutricional en menores de 5 anos,clasificacion a y b,2003-05-01,1,1,1,1,2
21902,CATACORA,estado nutricional en menores de 5 anos,clasificacion a y b,2003-05-01,2,1,2,1,3
40201,CHALLAPATA,estado nutricional en menores de 5 anos,clasificacion a y b,2003-05-01,18,6,18,6,24
50302,CHAQUI,estado nutricional en menores de 5 anos,clasificacion a y b,2003-05-01,18,1,18,1,19
70702,CHARAGUA,estado nutricional en menores de 5 anos,clasificacion a y b,2003-05-01,105,40,105,40,145
20305,CHARAÃ‘A,estado nutricional en menores de 5 anos,clasificacion a y b,2003-05-01,1,1,1,1,2
50202,CHAYANTA,estado nutricional en menores de 5 anos,clasificacion a y b,2003-05-01,6,3,6,3,9
31204,CHIMORE,estado nutricional en menores de 5 anos,clasificacion a y b,2003-05-01,23,4,23,4,27
40302,CHOQUE COTA,estado nutricional en menores de 5 anos,clasificacion a y b,2003-05-01,3,0,3,0,3
21101,CHULUMANI (V. DE LA LIBERTAD),estado nutricional en menores de 5 anos,clasificacion a y b,2003-05-01,11,0,11,0,11
20501,CHUMA,estado nutricional en menores de 5 anos,clasificacion a y b,2003-05-01,13,3,13,3,16
30801,CLIZA,estado nutricional en menores de 5 anos,clasificacion a y b,2003-05-01,31,6,31,6,37
90101,COBIJA,estado nutricional en menores de 5 anos,clasificacion a y b,2003-05-01,149,29,149,29,178
30101,COCHABAMBA,estado nutricional en menores de 5 anos,clasificacion a y b,2003-05-01,2437,379,2437,379,2816
40902,COIPASA,estado nutricional en menores de 5 anos,clasificacion a y b,2003-05-01,4,0,4,0,4
30905,COLCAPIRHUA,estado nutricional en menores de 5 anos,clasificacion a y b,2003-05-01,10,3,10,3,13
50901,"COLCHA ""K""",estado nutricional en menores de 5 anos,clasificacion a y b,2003-05-01,20,10,20,10,30
31002,COLOMI,estado nutricional en menores de 5 anos,clasificacion a y b,2003-05-01,33,5,33,5,38
50401,COLQUECHACA,estado nutricional en menores de 5 anos,clasificacion a y b,2003-05-01,33,17,33,17,50
21306,COLQUENCHA,estado nutricional en menores de 5 anos,clasificacion a y b,2003-05-01,10,2,10,2,12
21004,COLQUIRI,estado nutricional en menores de 5 anos,clasificacion a y b,2003-05-01,41,16,41,16,57
20304,COMANCHE,estado nutricional en menores de 5 anos,clasificacion a y b,2003-05-01,1,0,1,0,1
71301,COMARAPA,estado nutricional en menores de 5 anos,clasificacion a y b,2003-05-01,66,28,66,28,94
20605,COMBAYA,estado nutricional en menores de 5 anos,clasificacion a y b,2003-05-01,2,1,2,1,3
71101,CONCEPCION,estado nutricional en menores de 5 anos,clasificacion a y b,2003-05-01,24,6,24,6,30
21701,COPACABANA,estado nutricional en menores de 5 anos,clasificacion a y b,2003-05-01,19,9,19,9,28
21402,CORIPATA,estado nutricional en menores de 5 anos,clasificacion a y b,2003-05-01,50,0,50,0,50
20301,CORO CORO,estado nutricional en menores de 5 anos,clasificacion a y b,2003-05-01,6,0,6,0,6
21401,COROICO,estado nutricional en menores de 5 anos,clasificacion a y b,2003-05-01,7,9,7,9,16
40301,CORQUE,estado nutricional en menores de 5 anos,clasificacion a y b,2003-05-01,5,1,5,1,6
50601,COTAGAITA,estado nutricional en menores de 5 anos,clasificacion a y b,2003-05-01,42,24,42,24,66
70102,COTOCA,estado nutricional en menores de 5 anos,clasificacion a y b,2003-05-01,48,5,48,5,53
70704,CUEVO,estado nutricional en menores de 5 anos,clasificacion a y b,2003-05-01,11,3,11,3,14
10902,CULPINA,estado nutricional en menores de 5 anos,clasificacion a y b,2003-05-01,46,13,46,13,59
40401,CURAHUARA DE CARANGAS,estado nutricional en menores de 5 anos,clasificacion a y b,2003-05-01,3,4,3,4,7
21602,CURVA,estado nutricional en menores de 5 anos,clasificacion a y b,2003-05-01,4,1,4,1,5
20804,DESAGUADERO,estado nutricional en menores de 5 anos,clasificacion a y b,2003-05-01,1,4,1,4,5
20105,EL ALTO,estado nutricional en menores de 5 anos,clasificacion a y b,2003-05-01,682,216,682,216,898
40103,EL CHORO,estado nutricional en menores de 5 anos,clasificacion a y b,2003-05-01,7,1,7,1,8
71503,EL PUENTE(STC),estado nutricional en menores de 5 anos,clasificacion a y b,2003-05-01,9,23,9,23,32
60502,EL PUENTE(TJA),estado nutricional en menores de 5 anos,clasificacion a y b,2003-05-01,10,3,10,3,13
70105,EL TORNO,estado nutricional en menores de 5 anos,clasificacion a y b,2003-05-01,108,33,108,33,141
10405,EL VILLAR,estado nutricional en menores de 5 anos,clasificacion a y b,2003-05-01,7,8,7,8,15
60601,ENTRE RIOS,estado nutricional en menores de 5 anos,clasificacion a y b,2003-05-01,28,8,28,8,36
41101,EUCALIPTUS,estado nutricional en menores de 5 anos,clasificacion a y b,2003-05-01,3,8,3,8,11
80402,EXALTACION,estado nutricional en menores de 5 anos,clasificacion a y b,2003-05-01,0,23,0,23,23
90203,FILADELFIA,estado nutricional en menores de 5 anos,clasificacion a y b,2003-05-01,6,4,6,4,10
71002,GENERAL SAAVEDRA,estado nutricional en menores de 5 anos,clasificacion a y b,2003-05-01,51,23,51,23,74
21601,GRAL. J.J. PEREZ (CHARAZANI),estado nutricional en menores de 5 anos,clasificacion a y b,2003-05-01,15,7,15,7,22
20602,GUANAY,estado nutricional en menores de 5 anos,clasificacion a y b,2003-05-01,70,34,70,34,104
20802,GUAQUI,estado nutricional en menores de 5 anos,clasificacion a y b,2003-05-01,5,1,5,1,6
80202,GUAYARAMERIN,estado nutricional en menores de 5 anos,clasificacion a y b,2003-05-01,102,9,102,9,111
70705,GUTIERREZ,estado nutricional en menores de 5 anos,clasificacion a y b,2003-05-01,75,15,75,15,90
10502,HUACARETA,estado nutricional en menores de 5 anos,clasificacion a y b,2003-05-01,23,32,23,32,55
11002,HUACAYA (VILLA DE HUACAYA),estado nutricional en menores de 5 anos,clasificacion a y b,2003-05-01,16,1,16,1,17
40501,HUACHACALLA,estado nutricional en menores de 5 anos,clasificacion a y b,2003-05-01,1,1,1,1,2
40701,HUANUNI,estado nutricional en menores de 5 anos,clasificacion a y b,2003-05-01,50,13,50,13,63
80803,HUARACAJE,estado nutricional en menores de 5 anos,clasificacion a y b,2003-05-01,9,12,9,12,21
41601,HUAYLLAMARCA,estado nutricional en menores de 5 anos,clasificacion a y b,2003-05-01,3,0,3,0,3
21005,ICHOCA,estado nutricional en menores de 5 anos,clasificacion a y b,2003-05-01,19,36,19,36,55
10304,ICLA,estado nutricional en menores de 5 anos,clasificacion a y b,2003-05-01,30,1,30,1,31
10703,INCAHUASI,estado nutricional en menores de 5 anos,clasificacion a y b,2003-05-01,38,5,38,5,43
21001,INQUISIVI,estado nutricional en menores de 5 anos,clasificacion a y b,2003-05-01,70,55,70,55,125
21102,IRUPANA (VILLA DE LANZA),estado nutricional en menores de 5 anos,clasificacion a y b,2003-05-01,22,23,22,23,45
21501,IXIAMAS,estado nutricional en menores de 5 anos,clasificacion a y b,2003-05-01,16,14,16,14,30
21105,LA ASUNTA,estado nutricional en menores de 5 anos,clasificacion a y b,2003-05-01,69,4,69,4,73
70104,LA GUARDIA,estado nutricional en menores de 5 anos,clasificacion a y b,2003-05-01,100,52,100,52,152
20101,LA PAZ,estado nutricional en menores de 5 anos,clasificacion a y b,2003-05-01,645,219,645,219,864
70701,LAGUNILLAS,estado nutricional en menores de 5 anos,clasificacion a y b,2003-05-01,35,13,35,13,48
21202,LAJA,estado nutricional en menores de 5 anos,clasificacion a y b,2003-05-01,28,10,28,10,38
10903,LAS CARRERAS,estado nutricional en menores de 5 anos,clasificacion a y b,2003-05-01,16,9,16,9,25
21006,LICOMA PAMPA,estado nutricional en menores de 5 anos,clasificacion a y b,2003-05-01,2,1,2,1,3
50203,LLALLAGUA,estado nutricional en menores de 5 anos,clasificacion a y b,2003-05-01,41,37,41,37,78
51401,LLICA,estado nutricional en menores de 5 anos,clasificacion a y b,2003-05-01,6,2,6,2,8
80601,LORETO,estado nutricional en menores de 5 anos,clasificacion a y b,2003-05-01,4,9,4,9,13
20901,LURIBAY,estado nutricional en menores de 5 anos,clasificacion a y b,2003-05-01,8,4,8,4,12
40702,MACHACAMARCA,estado nutricional en menores de 5 anos,clasificacion a y b,2003-05-01,7,0,7,0,7
11003,MACHARETI,estado nutricional en menores de 5 anos,clasificacion a y b,2003-05-01,44,28,44,28,72
80801,MAGDALENA,estado nutricional en menores de 5 anos,clasificacion a y b,2003-05-01,29,14,29,14,43
70903,MAIRANA,estado nutricional en menores de 5 anos,clasificacion a y b,2003-05-01,41,7,41,7,48
20103,MECAPACA,estado nutricional en menores de 5 anos,clasificacion a y b,2003-05-01,4,5,4,5,9
71003,MINEROS,estado nutricional en menores de 5 anos,clasificacion a y b,2003-05-01,253,66,253,66,319
31301,MIZQUE,estado nutricional en menores de 5 anos,clasificacion a y b,2003-05-01,25,11,25,11,36
20402,MOCOMOCO,estado nutricional en menores de 5 anos,clasificacion a y b,2003-05-01,21,1,21,1,22
51002,MOJINETE,estado nutricional en menores de 5 anos,clasificacion a y b,2003-05-01,3,1,3,1,4
10303,MOJOCOYA,estado nutricional en menores de 5 anos,clasificacion a y b,2003-05-01,35,14,35,14,49
10501,MONTEAGUDO,estado nutricional en menores de 5 anos,clasificacion a y b,2003-05-01,114,31,114,31,145
71001,MONTERO,estado nutricional en menores de 5 anos,clasificacion a y b,2003-05-01,424,105,424,105,529
70803,MORO MORO,estado nutricional en menores de 5 anos,clasificacion a y b,2003-05-01,11,2,11,2,13
30302,MOROCHATA,estado nutricional en menores de 5 anos,clasificacion a y b,2003-05-01,45,8,45,8,53
90401,NACEBE (SANTA ROSA DEL ABUNA),estado nutricional en menores de 5 anos,clasificacion a y b,2003-05-01,1,0,1,0,1
90501,NUEVO MANOA (NUEVA ESPERANZA),estado nutricional en menores de 5 anos,clasificacion a y b,2003-05-01,1,6,1,6,7
50404,OCURI,estado nutricional en menores de 5 anos,clasificacion a y b,2003-05-01,11,10,11,10,21
30203,OMEREQUE,estado nutricional en menores de 5 anos,clasificacion a y b,2003-05-01,17,1,17,1,18
40101,ORURO,estado nutricional en menores de 5 anos,clasificacion a y b,2003-05-01,293,73,293,73,366
60201,PADCAYA,estado nutricional en menores de 5 anos,clasificacion a y b,2003-05-01,53,50,53,50,103
10401,PADILLA,estado nutricional en menores de 5 anos,clasificacion a y b,2003-05-01,60,8,60,8,68
70502,PAILON,estado nutricional en menores de 5 anos,clasificacion a y b,2003-05-01,16,9,16,9,25
20102,PALCA,estado nutricional en menores de 5 anos,clasificacion a y b,2003-05-01,19,28,19,28,47
21104,PALOS BLANCOS,estado nutricional en menores de 5 anos,clasificacion a y b,2003-05-01,53,19,53,19,72
40802,PAMPA AULLAGAS,estado nutricional en menores de 5 anos,clasificacion a y b,2003-05-01,1,0,1,0,1
70902,PAMPA GRANDE,estado nutricional en menores de 5 anos,clasificacion a y b,2003-05-01,23,10,23,10,33
21802,PAPEL PAMPA,estado nutricional en menores de 5 anos,clasificacion a y b,2003-05-01,3,3,3,3,6
30202,PASORAPA,estado nutricional en menores de 5 anos,clasificacion a y b,2003-05-01,17,0,17,0,17
21305,PATACAMAYA,estado nutricional en menores de 5 anos,clasificacion a y b,2003-05-01,35,6,35,6,41
40602,PAZÃ‘A,estado nutricional en menores de 5 anos,clasificacion a y b,2003-05-01,3,1,3,1,4
20702,PELECHUCO,estado nutricional en menores de 5 anos,clasificacion a y b,2003-05-01,9,2,9,2,11
50403,POCOATA,estado nutricional en menores de 5 anos,clasificacion a y b,2003-05-01,24,14,24,14,38
31203,POCONA,estado nutricional en menores de 5 anos,clasificacion a y b,2003-05-01,6,2,6,2,8
31202,POJO (CBBA),estado nutricional en menores de 5 anos,clasificacion a y b,2003-05-01,111,46,111,46,157
40601,POOPO,estado nutricional en menores de 5 anos,clasificacion a y b,2003-05-01,5,2,5,2,7
51203,PORCO,estado nutricional en menores de 5 anos,clasificacion a y b,2003-05-01,8,8,8,8,16
10103,POROMA,estado nutricional en menores de 5 anos,clasificacion a y b,2003-05-01,67,23,67,23,90
70103,PORONGO,estado nutricional en menores de 5 anos,clasificacion a y b,2003-05-01,9,3,9,3,12
70601,PORTACHUELO,estado nutricional en menores de 5 anos,clasificacion a y b,2003-05-01,123,37,123,37,160
90102,PORVENIR,estado nutricional en menores de 5 anos,clasificacion a y b,2003-05-01,10,1,10,1,11
70804,POSTRER VALLE,estado nutricional en menores de 5 anos,clasificacion a y b,2003-05-01,8,4,8,4,12
50101,POTOSI,estado nutricional en menores de 5 anos,clasificacion a y b,2003-05-01,117,17,117,17,134
10302,PRESTO,estado nutricional en menores de 5 anos,clasificacion a y b,2003-05-01,15,3,15,3,18
70805,PUCARA,estado nutricional en menores de 5 anos,clasificacion a y b,2003-05-01,3,3,3,3,6
21201,PUCARANI,estado nutricional en menores de 5 anos,clasificacion a y b,2003-05-01,44,5,44,5,49
20401,PUERTO ACOSTA,estado nutricional en menores de 5 anos,clasificacion a y b,2003-05-01,49,60,49,60,109
20403,PUERTO CARABUCO,estado nutricional en menores de 5 anos,clasificacion a y b,2003-05-01,25,3,25,3,28
90301,PUERTO GONZALO MORENO,estado nutricional en menores de 5 anos,clasificacion a y b,2003-05-01,1,1,1,1,2
21204,PUERTO PEREZ,estado nutricional en menores de 5 anos,clasificacion a y b,2003-05-01,10,0,10,0,10
71402,PUERTO QUIJARRO,estado nutricional en menores de 5 anos,clasificacion a y b,2003-05-01,46,7,46,7,53
90201,PUERTO RICO,estado nutricional en menores de 5 anos,clasificacion a y b,2003-05-01,6,6,6,6,12
80703,PUERTO SILES,estado nutricional en menores de 5 anos,clasificacion a y b,2003-05-01,3,1,3,1,4
71401,PUERTO SUAREZ,estado nutricional en menores de 5 anos,clasificacion a y b,2003-05-01,41,4,41,4,45
31205,PUERTO VILLARROEL,estado nutricional en menores de 5 anos,clasificacion a y b,2003-05-01,191,80,191,80,271
51101,PUNA,estado nutricional en menores de 5 anos,clasificacion a y b,2003-05-01,37,20,37,20,57
20604,QUIABAYA,estado nutricional en menores de 5 anos,clasificacion a y b,2003-05-01,6,1,6,1,7
30901,QUILLACOLLO,estado nutricional en menores de 5 anos,clasificacion a y b,2003-05-01,65,47,65,47,112
21002,QUIME,estado nutricional en menores de 5 anos,clasificacion a y b,2003-05-01,24,11,24,11,35
70904,QUIRUSILLAS,estado nutricional en menores de 5 anos,clasificacion a y b,2003-05-01,4,1,4,1,5
50402,RAVELO,estado nutricional en menores de 5 anos,clasificacion a y b,2003-05-01,6,3,6,3,9
80301,REYES,estado nutricional en menores de 5 anos,clasificacion a y b,2003-05-01,71,17,71,17,88
80201,RIBERALTA,estado nutricional en menores de 5 anos,clasificacion a y b,2003-05-01,182,41,182,41,223
70503,ROBORE,estado nutricional en menores de 5 anos,clasificacion a y b,2003-05-01,40,11,40,11,51
80304,RURRENABAQUE,estado nutricional en menores de 5 anos,clasificacion a y b,2003-05-01,26,6,26,6,32
40901,SABAYA,estado nutricional en menores de 5 anos,clasificacion a y b,2003-05-01,3,11,3,11,14
31001,SACABA,estado nutricional en menores de 5 anos,clasificacion a y b,2003-05-01,94,22,94,22,116
50701,SACACA,estado nutricional en menores de 5 anos,clasificacion a y b,2003-05-01,20,4,20,4,24
71302,SAIPINA,estado nutricional en menores de 5 anos,clasificacion a y b,2003-05-01,54,15,54,15,69
40801,SALINAS DE GARCI MENDOZA,estado nutricional en menores de 5 anos,clasificacion a y b,2003-05-01,0,2,0,2,2
70901,SAMAIPATA,estado nutricional en menores de 5 anos,clasificacion a y b,2003-05-01,33,10,33,10,43
51601,SAN AGUSTIN,estado nutricional en menores de 5 anos,clasificacion a y b,2003-05-01,5,0,5,0,5
80602,SAN ANDRES,estado nutricional en menores de 5 anos,clasificacion a y b,2003-05-01,1,0,1,0,1
51003,SAN ANTONIO DE ESMORUCO,estado nutricional en menores de 5 anos,clasificacion a y b,2003-05-01,1,0,1,0,1
71105,SAN ANTONIO DE LOMERIO,estado nutricional en menores de 5 anos,clasificacion a y b,2003-05-01,5,6,5,6,11
80302,SAN BORJA,estado nutricional en menores de 5 anos,clasificacion a y b,2003-05-01,142,26,142,26,168
21502,SAN BUENA VENTURA,estado nutricional en menores de 5 anos,clasificacion a y b,2003-05-01,24,11,24,11,35
70402,SAN CARLOS,estado nutricional en menores de 5 anos,clasificacion a y b,2003-05-01,90,44,90,44,134
80501,SAN IGNACIO,estado nutricional en menores de 5 anos,clasificacion a y b,2003-05-01,47,28,47,28,75
70301,SAN IGNACIO DE VELASCO,estado nutricional en menores de 5 anos,clasificacion a y b,2003-05-01,190,18,190,18,208
80102,SAN JAVIER(BNI),estado nutricional en menores de 5 anos,clasificacion a y b,2003-05-01,4,0,4,0,4
71102,SAN JAVIER(STC),estado nutricional en menores de 5 anos,clasificacion a y b,2003-05-01,41,8,41,8,49
80701,SAN JOAQUIN,estado nutricional en menores de 5 anos,clasificacion a y b,2003-05-01,14,5,14,5,19
70501,SAN JOSE DE CHIQUITOS,estado nutricional en menores de 5 anos,clasificacion a y b,2003-05-01,19,13,19,13,32
71104,SAN JULIAN,estado nutricional en menores de 5 anos,clasificacion a y b,2003-05-01,141,66,141,66,207
90302,SAN LORENZO(PND),estado nutricional en menores de 5 anos,clasificacion a y b,2003-05-01,4,3,4,3,7
60501,SAN LORENZO(TJA),estado nutricional en menores de 5 anos,clasificacion a y b,2003-05-01,24,12,24,12,36
10702,SAN LUCAS,estado nutricional en menores de 5 anos,clasificacion a y b,2003-05-01,38,26,38,26,64
70302,SAN MIGUEL DE VELASCO,estado nutricional en menores de 5 anos,clasificacion a y b,2003-05-01,12,2,12,2,14
51001,SAN PABLO DE LIPEZ,estado nutricional en menores de 5 anos,clasificacion a y b,2003-05-01,2,0,2,0,2
50501,SAN PEDRO DE BUENA VISTA,estado nutricional en menores de 5 anos,clasificacion a y b,2003-05-01,16,39,16,39,55
50902,SAN PEDRO DE QUEMES,estado nutricional en menores de 5 anos,clasificacion a y b,2003-05-01,1,2,1,2,3
21702,SAN PEDRO DE TIQUINA,estado nutricional en menores de 5 anos,clasificacion a y b,2003-05-01,3,2,3,2,5
70303,SAN RAFAEL,estado nutricional en menores de 5 anos,clasificacion a y b,2003-05-01,13,6,13,6,19
80702,SAN RAMON,estado nutricional en menores de 5 anos,clasificacion a y b,2003-05-01,5,5,5,5,10
80702,SAN RAMON,estado nutricional en menores de 5 anos,clasificacion a y b,2003-05-01,98,32,98,32,130
80401,SANTA ANA,estado nutricional en menores de 5 anos,clasificacion a y b,2003-05-01,0,10,0,10,10
70101,SANTA CRUZ DE LA SIERRA,estado nutricional en menores de 5 anos,clasificacion a y b,2003-05-01,844,283,844,283,1127
80303,SANTA ROSA,estado nutricional en menores de 5 anos,clasificacion a y b,2003-05-01,13,9,13,9,22
70602,SANTA ROSA DEL SARA,estado nutricional en menores de 5 anos,clasificacion a y b,2003-05-01,12,14,12,14,26
20308,SANTIAGO DE CALLAPA,estado nutricional en menores de 5 anos,clasificacion a y b,2003-05-01,10,2,10,2,12
41401,SANTIAGO DE HUARI,estado nutricional en menores de 5 anos,clasificacion a y b,2003-05-01,5,0,5,0,5
21901,SANTIAGO DE MACHACA,estado nutricional en menores de 5 anos,clasificacion a y b,2003-05-01,2,2,2,2,4
30702,SANTIVAÃ‘ES,estado nutricional en menores de 5 anos,clasificacion a y b,2003-05-01,5,0,5,0,5
40202,SANTUARIO DE QUILLACAS,estado nutricional en menores de 5 anos,clasificacion a y b,2003-05-01,1,0,1,0,1
20902,SAPAHAQUI,estado nutricional en menores de 5 anos,clasificacion a y b,2003-05-01,8,11,8,11,19
90303,SENA,estado nutricional en menores de 5 anos,clasificacion a y b,2003-05-01,14,0,14,0,14
21301,SICA SICA (VILLA AROMA),estado nutricional en menores de 5 anos,clasificacion a y b,2003-05-01,12,8,12,8,20
30902,SIPE SIPE,estado nutricional en menores de 5 anos,clasificacion a y b,2003-05-01,85,24,85,24,109
10403,SOPACHUY,estado nutricional en menores de 5 anos,clasificacion a y b,2003-05-01,6,5,6,5,11
20601,SORATA,estado nutricional en menores de 5 anos,clasificacion a y b,2003-05-01,37,7,37,7,44
10101,SUCRE,estado nutricional en menores de 5 anos,clasificacion a y b,2003-05-01,357,103,357,103,460
20603,TACACOMA,estado nutricional en menores de 5 anos,clasificacion a y b,2003-05-01,26,14,26,14,40
50303,TACOBAMBA,estado nutricional en menores de 5 anos,clasificacion a y b,2003-05-01,22,10,22,10,32
30602,TACOPAYA,estado nutricional en menores de 5 anos,clasificacion a y b,2003-05-01,7,0,7,0,7
51402,TAHUA,estado nutricional en menores de 5 anos,clasificacion a y b,2003-05-01,3,2,3,2,5
31101,TAPACARI,estado nutricional en menores de 5 anos,clasificacion a y b,2003-05-01,18,6,18,6,24
10601,TARABUCO,estado nutricional en menores de 5 anos,clasificacion a y b,2003-05-01,40,7,40,7,47
30401,TARATA,estado nutricional en menores de 5 anos,clasificacion a y b,2003-05-01,4,15,4,15,19
60101,TARIJA,estado nutricional en menores de 5 anos,clasificacion a y b,2003-05-01,429,154,429,154,583
10202,TARVITA,estado nutricional en menores de 5 anos,clasificacion a y b,2003-05-01,20,29,20,29,49
20803,TIAWANACU,estado nutricional en menores de 5 anos,clasificacion a y b,2003-05-01,25,10,25,10,35
50102,TINGUIPAYA,estado nutricional en menores de 5 anos,clasificacion a y b,2003-05-01,7,0,7,0,7
20606,TIPUANI,estado nutricional en menores de 5 anos,clasificacion a y b,2003-05-01,23,0,23,0,23
30903,TIQUIPAYA,estado nutricional en menores de 5 anos,clasificacion a y b,2003-05-01,38,7,38,7,45
31601,TIRAQUE (CBBA),estado nutricional en menores de 5 anos,clasificacion a y b,2003-05-01,79,14,79,14,93
30802,TOCO,estado nutricional en menores de 5 anos,clasificacion a y b,2003-05-01,0,3,0,3,3
30803,TOLATA,estado nutricional en menores de 5 anos,clasificacion a y b,2003-05-01,4,6,4,6,10
41001,TOLEDO,estado nutricional en menores de 5 anos,clasificacion a y b,2003-05-01,1,0,1,0,1
51202,TOMAVE,estado nutricional en menores de 5 anos,clasificacion a y b,2003-05-01,9,2,9,2,11
10402,TOMINA,estado nutricional en menores de 5 anos,clasificacion a y b,2003-05-01,24,7,24,7,31
50502,TORO TORO,estado nutricional en menores de 5 anos,clasificacion a y b,2003-05-01,8,3,8,3,11
31201,TOTORA(CBBA),estado nutricional en menores de 5 anos,clasificacion a y b,2003-05-01,19,2,19,2,21
41301,TOTORA(ORR),estado nutricional en menores de 5 anos,clasificacion a y b,2003-05-01,3,2,3,2,5
70802,TRIGAL,estado nutricional en menores de 5 anos,clasificacion a y b,2003-05-01,3,0,3,0,3
80101,TRINIDAD,estado nutricional en menores de 5 anos,clasificacion a y b,2003-05-01,135,44,135,44,179
50801,TUPIZA,estado nutricional en menores de 5 anos,clasificacion a y b,2003-05-01,58,64,58,64,122
21302,UMALA,estado nutricional en menores de 5 anos,clasificacion a y b,2003-05-01,5,8,5,8,13
50201,UNCIA,estado nutricional en menores de 5 anos,clasificacion a y b,2003-05-01,2,0,2,0,2
60401,URIONDO (A. CONCEPCION),estado nutricional en menores de 5 anos,clasificacion a y b,2003-05-01,67,6,67,6,73
51201,UYUNI,estado nutricional en menores de 5 anos,clasificacion a y b,2003-05-01,65,6,65,6,71
70801,VALLEGRANDE,estado nutricional en menores de 5 anos,clasificacion a y b,2003-05-01,63,28,63,28,91
20801,VIACHA,estado nutricional en menores de 5 anos,clasificacion a y b,2003-05-01,67,36,67,36,103
31302,VILA VILA,estado nutricional en menores de 5 anos,clasificacion a y b,2003-05-01,3,2,3,2,5
60303,VILLA MONTES,estado nutricional en menores de 5 anos,clasificacion a y b,2003-05-01,76,15,76,15,91
10801,VILLA SERRANO,estado nutricional en menores de 5 anos,clasificacion a y b,2003-05-01,26,5,26,5,31
31003,VILLA TUNARI,estado nutricional en menores de 5 anos,clasificacion a y b,2003-05-01,65,28,65,28,93
11001,VILLA VACA GUZMAN (MUYUPAMPA),estado nutricional en menores de 5 anos,clasificacion a y b,2003-05-01,74,19,74,19,93
51501,VILLAZON,estado nutricional en menores de 5 anos,clasificacion a y b,2003-05-01,52,7,52,7,59
50602,VITICHI,estado nutricional en menores de 5 anos,clasificacion a y b,2003-05-01,28,11,28,11,39
70201,WARNES,estado nutricional en menores de 5 anos,clasificacion a y b,2003-05-01,16,4,16,4,20
20903,YACO,estado nutricional en menores de 5 anos,clasificacion a y b,2003-05-01,7,14,7,14,21
60301,YACUIBA,estado nutricional en menores de 5 anos,clasificacion a y b,2003-05-01,361,78,361,78,439
10602,YAMPARAEZ,estado nutricional en menores de 5 anos,clasificacion a y b,2003-05-01,31,7,31,7,38
21103,YANACACHI,estado nutricional en menores de 5 anos,clasificacion a y b,2003-05-01,11,14,11,14,25
70403,YAPACANI,estado nutricional en menores de 5 anos,clasificacion a y b,2003-05-01,111,66,111,66,177
50103,YOCALLA,estado nutricional en menores de 5 anos,clasificacion a y b,2003-05-01,4,1,4,1,5
10102,YOTALA,estado nutricional en menores de 5 anos,clasificacion a y b,2003-05-01,25,13,25,13,38
60402,YUNCHARA,estado nutricional en menores de 5 anos,clasificacion a y b,2003-05-01,7,1,7,1,8
10301,ZUDAÃ‘EZ,estado nutricional en menores de 5 anos,clasificacion a y b,2003-05-01,13,1,13,1,14
51302,ACACIO,estado nutricional en menores de 5 anos,clasificacion a y b,2003-06-01,3,0,3,0,3
20201,ACHACACHI,estado nutricional en menores de 5 anos,clasificacion a y b,2003-06-01,75,62,75,62,137
20104,ACHOCALLA,estado nutricional en menores de 5 anos,clasificacion a y b,2003-06-01,4,2,4,2,6
30201,AIQUILE,estado nutricional en menores de 5 anos,clasificacion a y b,2003-06-01,18,4,18,4,22
10404,ALCALA,estado nutricional en menores de 5 anos,clasificacion a y b,2003-06-01,14,4,14,4,18
20202,ANCORAIMES,estado nutricional en menores de 5 anos,clasificacion a y b,2003-06-01,8,0,8,0,8
30402,ANZALDO,estado nutricional en menores de 5 anos,clasificacion a y b,2003-06-01,5,8,5,8,13
20701,APOLO,estado nutricional en menores de 5 anos,clasificacion a y b,2003-06-01,10,4,10,4,14
51301,ARAMPAMPA,estado nutricional en menores de 5 anos,clasificacion a y b,2003-06-01,7,5,7,5,12
30501,ARANI,estado nutricional en menores de 5 anos,clasificacion a y b,2003-06-01,5,3,5,3,8
30403,ARBIETO,estado nutricional en menores de 5 anos,clasificacion a y b,2003-06-01,1,0,1,0,1
30601,ARQUE,estado nutricional en menores de 5 anos,clasificacion a y b,2003-06-01,17,5,17,5,22
71501,ASCENCION DE GUARAYOS,estado nutricional en menores de 5 anos,clasificacion a y b,2003-06-01,68,21,68,21,89
50802,ATOCHA,estado nutricional en menores de 5 anos,clasificacion a y b,2003-06-01,12,10,12,10,22
20503,AUCAPATA,estado nutricional en menores de 5 anos,clasificacion a y b,2003-06-01,3,0,3,0,3
20502,AYATA,estado nutricional en menores de 5 anos,clasificacion a y b,2003-06-01,18,1,18,1,19
21303,AYO AYO,estado nutricional en menores de 5 anos,clasificacion a y b,2003-06-01,39,13,39,13,52
30301,AYOPAYA (V. DE INDEPENDENCIA),estado nutricional en menores de 5 anos,clasificacion a y b,2003-06-01,23,7,23,7,30
10201,AZURDUY,estado nutricional en menores de 5 anos,clasificacion a y b,2003-06-01,14,3,14,3,17
21203,BATALLAS,estado nutricional en menores de 5 anos,clasificacion a y b,2003-06-01,12,8,12,8,20
80802,BAURES,estado nutricional en menores de 5 anos,clasificacion a y b,2003-06-01,10,2,10,2,12
90104,BELLA FLOR,estado nutricional en menores de 5 anos,clasificacion a y b,2003-06-01,18,6,18,6,24
60202,BERMEJO,estado nutricional en menores de 5 anos,clasificacion a y b,2003-06-01,34,28,34,28,62
50301,BETANZOS,estado nutricional en menores de 5 anos,clasificacion a y b,2003-06-01,28,2,28,2,30
31501,BOLIVAR,estado nutricional en menores de 5 anos,clasificacion a y b,2003-06-01,2,0,2,0,2
90103,BOLPEBRA,estado nutricional en menores de 5 anos,clasificacion a y b,2003-06-01,2,1,2,1,3
70707,BOYUIBE,estado nutricional en menores de 5 anos,clasificacion a y b,2003-06-01,14,6,14,6,20
70401,BUENA VISTA,estado nutricional en menores de 5 anos,clasificacion a y b,2003-06-01,76,25,76,25,101
70703,CABEZAS,estado nutricional en menores de 5 anos,clasificacion a y b,2003-06-01,40,17,40,17,57
20905,CAIROMA,estado nutricional en menores de 5 anos,clasificacion a y b,2003-06-01,15,3,15,3,18
51102,"CAIZA ""D""",estado nutricional en menores de 5 anos,clasificacion a y b,2003-06-01,16,1,16,1,17
21003,CAJUATA,estado nutricional en menores de 5 anos,clasificacion a y b,2003-06-01,28,1,28,1,29
20303,CALACOTO,estado nutricional en menores de 5 anos,clasificacion a y b,2003-06-01,5,0,5,0,5
21304,CALAMARCA,estado nutricional en menores de 5 anos,clasificacion a y b,2003-06-01,13,1,13,1,14
10701,CAMARGO,estado nutricional en menores de 5 anos,clasificacion a y b,2003-06-01,18,0,18,0,18
10901,CAMATAQUI (C. VILLA ABECIA),estado nutricional en menores de 5 anos,clasificacion a y b,2003-06-01,5,0,5,0,5
70706,CAMIRI,estado nutricional en menores de 5 anos,clasificacion a y b,2003-06-01,91,23,91,23,114
30701,CAPINOTA,estado nutricional en menores de 5 anos,clasificacion a y b,2003-06-01,3,1,3,1,4
20302,CAQUIAVIRI,estado nutricional en menores de 5 anos,clasificacion a y b,2003-06-01,12,4,12,4,16
40102,CARACOLLO,estado nutricional en menores de 5 anos,clasificacion a y b,2003-06-01,20,2,20,2,22
22001,CARANAVI,estado nutricional en menores de 5 anos,clasificacion a y b,2003-06-01,81,22,81,22,103
60302,CARAPARI,estado nutricional en menores de 5 anos,clasificacion a y b,2003-06-01,44,11,44,11,55
50702,CARIPUYO,estado nutricional en menores de 5 anos,clasificacion a y b,2003-06-01,14,0,14,0,14
40201,CHALLAPATA,estado nutricional en menores de 5 anos,clasificacion a y b,2003-06-01,22,5,22,5,27
50302,CHAQUI,estado nutricional en menores de 5 anos,clasificacion a y b,2003-06-01,15,0,15,0,15
70702,CHARAGUA,estado nutricional en menores de 5 anos,clasificacion a y b,2003-06-01,90,29,90,29,119
50202,CHAYANTA,estado nutricional en menores de 5 anos,clasificacion a y b,2003-06-01,9,3,9,3,12
31204,CHIMORE,estado nutricional en menores de 5 anos,clasificacion a y b,2003-06-01,21,10,21,10,31
40903,CHIPAYA,estado nutricional en menores de 5 anos,clasificacion a y b,2003-06-01,1,0,1,0,1
40302,CHOQUE COTA,estado nutricional en menores de 5 anos,clasificacion a y b,2003-06-01,3,0,3,0,3
21101,CHULUMANI (V. DE LA LIBERTAD),estado nutricional en menores de 5 anos,clasificacion a y b,2003-06-01,10,1,10,1,11
20501,CHUMA,estado nutricional en menores de 5 anos,clasificacion a y b,2003-06-01,17,0,17,0,17
30801,CLIZA,estado nutricional en menores de 5 anos,clasificacion a y b,2003-06-01,14,8,14,8,22
90101,COBIJA,estado nutricional en menores de 5 anos,clasificacion a y b,2003-06-01,65,9,65,9,74
30101,COCHABAMBA,estado nutricional en menores de 5 anos,clasificacion a y b,2003-06-01,2478,478,2478,478,2956
40902,COIPASA,estado nutricional en menores de 5 anos,clasificacion a y b,2003-06-01,3,1,3,1,4
30905,COLCAPIRHUA,estado nutricional en menores de 5 anos,clasificacion a y b,2003-06-01,20,0,20,0,20
50901,"COLCHA ""K""",estado nutricional en menores de 5 anos,clasificacion a y b,2003-06-01,18,2,18,2,20
31002,COLOMI,estado nutricional en menores de 5 anos,clasificacion a y b,2003-06-01,26,9,26,9,35
50401,COLQUECHACA,estado nutricional en menores de 5 anos,clasificacion a y b,2003-06-01,24,12,24,12,36
21306,COLQUENCHA,estado nutricional en menores de 5 anos,clasificacion a y b,2003-06-01,12,0,12,0,12
21004,COLQUIRI,estado nutricional en menores de 5 anos,clasificacion a y b,2003-06-01,18,9,18,9,27
71301,COMARAPA,estado nutricional en menores de 5 anos,clasificacion a y b,2003-06-01,64,4,64,4,68
20605,COMBAYA,estado nutricional en menores de 5 anos,clasificacion a y b,2003-06-01,3,0,3,0,3
71101,CONCEPCION,estado nutricional en menores de 5 anos,clasificacion a y b,2003-06-01,3,6,3,6,9
21701,COPACABANA,estado nutricional en menores de 5 anos,clasificacion a y b,2003-06-01,15,4,15,4,19
21402,CORIPATA,estado nutricional en menores de 5 anos,clasificacion a y b,2003-06-01,17,2,17,2,19
20301,CORO CORO,estado nutricional en menores de 5 anos,clasificacion a y b,2003-06-01,3,0,3,0,3
21401,COROICO,estado nutricional en menores de 5 anos,clasificacion a y b,2003-06-01,16,7,16,7,23
40301,CORQUE,estado nutricional en menores de 5 anos,clasificacion a y b,2003-06-01,2,1,2,1,3
50601,COTAGAITA,estado nutricional en menores de 5 anos,clasificacion a y b,2003-06-01,51,16,51,16,67
70102,COTOCA,estado nutricional en menores de 5 anos,clasificacion a y b,2003-06-01,35,0,35,0,35
31405,CUCHUMUELA (V. G. VILLARROEL),estado nutricional en menores de 5 anos,clasificacion a y b,2003-06-01,4,3,4,3,7
70704,CUEVO,estado nutricional en menores de 5 anos,clasificacion a y b,2003-06-01,11,1,11,1,12
10902,CULPINA,estado nutricional en menores de 5 anos,clasificacion a y b,2003-06-01,39,16,39,16,55
40401,CURAHUARA DE CARANGAS,estado nutricional en menores de 5 anos,clasificacion a y b,2003-06-01,2,1,2,1,3
21602,CURVA,estado nutricional en menores de 5 anos,clasificacion a y b,2003-06-01,4,0,4,0,4
20804,DESAGUADERO,estado nutricional en menores de 5 anos,clasificacion a y b,2003-06-01,4,11,4,11,15
20105,EL ALTO,estado nutricional en menores de 5 anos,clasificacion a y b,2003-06-01,713,178,713,178,891
40103,EL CHORO,estado nutricional en menores de 5 anos,clasificacion a y b,2003-06-01,6,3,6,3,9
71503,EL PUENTE(STC),estado nutricional en menores de 5 anos,clasificacion a y b,2003-06-01,13,13,13,13,26
60502,EL PUENTE(TJA),estado nutricional en menores de 5 anos,clasificacion a y b,2003-06-01,9,2,9,2,11
70105,EL TORNO,estado nutricional en menores de 5 anos,clasificacion a y b,2003-06-01,142,23,142,23,165
10405,EL VILLAR,estado nutricional en menores de 5 anos,clasificacion a y b,2003-06-01,15,3,15,3,18
60601,ENTRE RIOS,estado nutricional en menores de 5 anos,clasificacion a y b,2003-06-01,25,14,25,14,39
41101,EUCALIPTUS,estado nutricional en menores de 5 anos,clasificacion a y b,2003-06-01,10,3,10,3,13
90503,EUREKA (SANTOS MERCADO),estado nutricional en menores de 5 anos,clasificacion a y b,2003-06-01,3,3,3,3,6
80402,EXALTACION,estado nutricional en menores de 5 anos,clasificacion a y b,2003-06-01,0,12,0,12,12
90203,FILADELFIA,estado nutricional en menores de 5 anos,clasificacion a y b,2003-06-01,2,1,2,1,3
71002,GENERAL SAAVEDRA,estado nutricional en menores de 5 anos,clasificacion a y b,2003-06-01,83,61,83,61,144
21601,GRAL. J.J. PEREZ (CHARAZANI),estado nutricional en menores de 5 anos,clasificacion a y b,2003-06-01,17,10,17,10,27
20602,GUANAY,estado nutricional en menores de 5 anos,clasificacion a y b,2003-06-01,91,20,91,20,111
20802,GUAQUI,estado nutricional en menores de 5 anos,clasificacion a y b,2003-06-01,4,0,4,0,4
80202,GUAYARAMERIN,estado nutricional en menores de 5 anos,clasificacion a y b,2003-06-01,138,26,138,26,164
70705,GUTIERREZ,estado nutricional en menores de 5 anos,clasificacion a y b,2003-06-01,84,14,84,14,98
10502,HUACARETA,estado nutricional en menores de 5 anos,clasificacion a y b,2003-06-01,30,14,30,14,44
11002,HUACAYA (VILLA DE HUACAYA),estado nutricional en menores de 5 anos,clasificacion a y b,2003-06-01,7,5,7,5,12
40501,HUACHACALLA,estado nutricional en menores de 5 anos,clasificacion a y b,2003-06-01,2,2,2,2,4
40701,HUANUNI,estado nutricional en menores de 5 anos,clasificacion a y b,2003-06-01,42,6,42,6,48
80803,HUARACAJE,estado nutricional en menores de 5 anos,clasificacion a y b,2003-06-01,13,9,13,9,22
41601,HUAYLLAMARCA,estado nutricional en menores de 5 anos,clasificacion a y b,2003-06-01,2,0,2,0,2
21005,ICHOCA,estado nutricional en menores de 5 anos,clasificacion a y b,2003-06-01,2,25,2,25,27
10304,ICLA,estado nutricional en menores de 5 anos,clasificacion a y b,2003-06-01,19,3,19,3,22
10703,INCAHUASI,estado nutricional en menores de 5 anos,clasificacion a y b,2003-06-01,25,6,25,6,31
21001,INQUISIVI,estado nutricional en menores de 5 anos,clasificacion a y b,2003-06-01,43,20,43,20,63
21102,IRUPANA (VILLA DE LANZA),estado nutricional en menores de 5 anos,clasificacion a y b,2003-06-01,15,4,15,4,19
21501,IXIAMAS,estado nutricional en menores de 5 anos,clasificacion a y b,2003-06-01,25,10,25,10,35
21105,LA ASUNTA,estado nutricional en menores de 5 anos,clasificacion a y b,2003-06-01,44,4,44,4,48
70104,LA GUARDIA,estado nutricional en menores de 5 anos,clasificacion a y b,2003-06-01,81,34,81,34,115
20101,LA PAZ,estado nutricional en menores de 5 anos,clasificacion a y b,2003-06-01,613,218,613,218,831
41501,LA RIVERA,estado nutricional en menores de 5 anos,clasificacion a y b,2003-06-01,1,0,1,0,1
70701,LAGUNILLAS,estado nutricional en menores de 5 anos,clasificacion a y b,2003-06-01,44,6,44,6,50
21202,LAJA,estado nutricional en menores de 5 anos,clasificacion a y b,2003-06-01,28,6,28,6,34
10903,LAS CARRERAS,estado nutricional en menores de 5 anos,clasificacion a y b,2003-06-01,16,2,16,2,18
21006,LICOMA PAMPA,estado nutricional en menores de 5 anos,clasificacion a y b,2003-06-01,2,3,2,3,5
50203,LLALLAGUA,estado nutricional en menores de 5 anos,clasificacion a y b,2003-06-01,18,77,18,77,95
51401,LLICA,estado nutricional en menores de 5 anos,clasificacion a y b,2003-06-01,4,1,4,1,5
80601,LORETO,estado nutricional en menores de 5 anos,clasificacion a y b,2003-06-01,9,8,9,8,17
20901,LURIBAY,estado nutricional en menores de 5 anos,clasificacion a y b,2003-06-01,10,2,10,2,12
40702,MACHACAMARCA,estado nutricional en menores de 5 anos,clasificacion a y b,2003-06-01,5,3,5,3,8
11003,MACHARETI,estado nutricional en menores de 5 anos,clasificacion a y b,2003-06-01,36,9,36,9,45
80801,MAGDALENA,estado nutricional en menores de 5 anos,clasificacion a y b,2003-06-01,12,3,12,3,15
70903,MAIRANA,estado nutricional en menores de 5 anos,clasificacion a y b,2003-06-01,29,3,29,3,32
20103,MECAPACA,estado nutricional en menores de 5 anos,clasificacion a y b,2003-06-01,7,9,7,9,16
71003,MINEROS,estado nutricional en menores de 5 anos,clasificacion a y b,2003-06-01,286,62,286,62,348
31301,MIZQUE,estado nutricional en menores de 5 anos,clasificacion a y b,2003-06-01,6,0,6,0,6
20402,MOCOMOCO,estado nutricional en menores de 5 anos,clasificacion a y b,2003-06-01,19,3,19,3,22
51002,MOJINETE,estado nutricional en menores de 5 anos,clasificacion a y b,2003-06-01,1,0,1,0,1
10303,MOJOCOYA,estado nutricional en menores de 5 anos,clasificacion a y b,2003-06-01,21,9,21,9,30
10501,MONTEAGUDO,estado nutricional en menores de 5 anos,clasificacion a y b,2003-06-01,82,23,82,23,105
71001,MONTERO,estado nutricional en menores de 5 anos,clasificacion a y b,2003-06-01,428,91,428,91,519
70803,MORO MORO,estado nutricional en menores de 5 anos,clasificacion a y b,2003-06-01,9,4,9,4,13
30302,MOROCHATA,estado nutricional en menores de 5 anos,clasificacion a y b,2003-06-01,12,63,12,63,75
90401,NACEBE (SANTA ROSA DEL ABUNA),estado nutricional en menores de 5 anos,clasificacion a y b,2003-06-01,2,2,2,2,4
50404,OCURI,estado nutricional en menores de 5 anos,clasificacion a y b,2003-06-01,9,4,9,4,13
30203,OMEREQUE,estado nutricional en menores de 5 anos,clasificacion a y b,2003-06-01,9,1,9,1,10
40101,ORURO,estado nutricional en menores de 5 anos,clasificacion a y b,2003-06-01,310,91,310,91,401
60201,PADCAYA,estado nutricional en menores de 5 anos,clasificacion a y b,2003-06-01,46,48,46,48,94
10401,PADILLA,estado nutricional en menores de 5 anos,clasificacion a y b,2003-06-01,47,7,47,7,54
70502,PAILON,estado nutricional en menores de 5 anos,clasificacion a y b,2003-06-01,15,10,15,10,25
20102,PALCA,estado nutricional en menores de 5 anos,clasificacion a y b,2003-06-01,6,2,6,2,8
21104,PALOS BLANCOS,estado nutricional en menores de 5 anos,clasificacion a y b,2003-06-01,32,5,32,5,37
40802,PAMPA AULLAGAS,estado nutricional en menores de 5 anos,clasificacion a y b,2003-06-01,8,1,8,1,9
70902,PAMPA GRANDE,estado nutricional en menores de 5 anos,clasificacion a y b,2003-06-01,29,0,29,0,29
21802,PAPEL PAMPA,estado nutricional en menores de 5 anos,clasificacion a y b,2003-06-01,1,1,1,1,2
30202,PASORAPA,estado nutricional en menores de 5 anos,clasificacion a y b,2003-06-01,6,1,6,1,7
21305,PATACAMAYA,estado nutricional en menores de 5 anos,clasificacion a y b,2003-06-01,98,10,98,10,108
40602,PAZÃ‘A,estado nutricional en menores de 5 anos,clasificacion a y b,2003-06-01,4,3,4,3,7
20702,PELECHUCO,estado nutricional en menores de 5 anos,clasificacion a y b,2003-06-01,4,0,4,0,4
50403,POCOATA,estado nutricional en menores de 5 anos,clasificacion a y b,2003-06-01,23,14,23,14,37
31203,POCONA,estado nutricional en menores de 5 anos,clasificacion a y b,2003-06-01,7,2,7,2,9
31202,POJO (CBBA),estado nutricional en menores de 5 anos,clasificacion a y b,2003-06-01,54,27,54,27,81
40601,POOPO,estado nutricional en menores de 5 anos,clasificacion a y b,2003-06-01,8,3,8,3,11
51203,PORCO,estado nutricional en menores de 5 anos,clasificacion a y b,2003-06-01,22,8,22,8,30
10103,POROMA,estado nutricional en menores de 5 anos,clasificacion a y b,2003-06-01,50,13,50,13,63
70103,PORONGO,estado nutricional en menores de 5 anos,clasificacion a y b,2003-06-01,4,2,4,2,6
70601,PORTACHUELO,estado nutricional en menores de 5 anos,clasificacion a y b,2003-06-01,131,48,131,48,179
90102,PORVENIR,estado nutricional en menores de 5 anos,clasificacion a y b,2003-06-01,7,3,7,3,10
70804,POSTRER VALLE,estado nutricional en menores de 5 anos,clasificacion a y b,2003-06-01,3,5,3,5,8
50101,POTOSI,estado nutricional en menores de 5 anos,clasificacion a y b,2003-06-01,160,13,160,13,173
10302,PRESTO,estado nutricional en menores de 5 anos,clasificacion a y b,2003-06-01,5,1,5,1,6
21201,PUCARANI,estado nutricional en menores de 5 anos,clasificacion a y b,2003-06-01,27,3,27,3,30
20401,PUERTO ACOSTA,estado nutricional en menores de 5 anos,clasificacion a y b,2003-06-01,38,32,38,32,70
20403,PUERTO CARABUCO,estado nutricional en menores de 5 anos,clasificacion a y b,2003-06-01,7,2,7,2,9
90301,PUERTO GONZALO MORENO,estado nutricional en menores de 5 anos,clasificacion a y b,2003-06-01,1,1,1,1,2
21204,PUERTO PEREZ,estado nutricional en menores de 5 anos,clasificacion a y b,2003-06-01,14,2,14,2,16
71402,PUERTO QUIJARRO,estado nutricional en menores de 5 anos,clasificacion a y b,2003-06-01,45,4,45,4,49
90201,PUERTO RICO,estado nutricional en menores de 5 anos,clasificacion a y b,2003-06-01,3,1,3,1,4
80703,PUERTO SILES,estado nutricional en menores de 5 anos,clasificacion a y b,2003-06-01,4,4,4,4,8
71401,PUERTO SUAREZ,estado nutricional en menores de 5 anos,clasificacion a y b,2003-06-01,64,3,64,3,67
31205,PUERTO VILLARROEL,estado nutricional en menores de 5 anos,clasificacion a y b,2003-06-01,138,31,138,31,169
51101,PUNA,estado nutricional en menores de 5 anos,clasificacion a y b,2003-06-01,28,2,28,2,30
31401,PUNATA,estado nutricional en menores de 5 anos,clasificacion a y b,2003-06-01,12,5,12,5,17
20604,QUIABAYA,estado nutricional en menores de 5 anos,clasificacion a y b,2003-06-01,4,0,4,0,4
30901,QUILLACOLLO,estado nutricional en menores de 5 anos,clasificacion a y b,2003-06-01,70,11,70,11,81
21002,QUIME,estado nutricional en menores de 5 anos,clasificacion a y b,2003-06-01,13,2,13,2,15
70904,QUIRUSILLAS,estado nutricional en menores de 5 anos,clasificacion a y b,2003-06-01,4,1,4,1,5
50402,RAVELO,estado nutricional en menores de 5 anos,clasificacion a y b,2003-06-01,23,9,23,9,32
80301,REYES,estado nutricional en menores de 5 anos,clasificacion a y b,2003-06-01,2,2,2,2,4
80201,RIBERALTA,estado nutricional en menores de 5 anos,clasificacion a y b,2003-06-01,174,43,174,43,217
70503,ROBORE,estado nutricional en menores de 5 anos,clasificacion a y b,2003-06-01,35,11,35,11,46
80304,RURRENABAQUE,estado nutricional en menores de 5 anos,clasificacion a y b,2003-06-01,41,9,41,9,50
40901,SABAYA,estado nutricional en menores de 5 anos,clasificacion a y b,2003-06-01,1,0,1,0,1
31001,SACABA,estado nutricional en menores de 5 anos,clasificacion a y b,2003-06-01,56,6,56,6,62
50701,SACACA,estado nutricional en menores de 5 anos,clasificacion a y b,2003-06-01,5,1,5,1,6
71302,SAIPINA,estado nutricional en menores de 5 anos,clasificacion a y b,2003-06-01,66,29,66,29,95
40801,SALINAS DE GARCI MENDOZA,estado nutricional en menores de 5 anos,clasificacion a y b,2003-06-01,2,1,2,1,3
70901,SAMAIPATA,estado nutricional en menores de 5 anos,clasificacion a y b,2003-06-01,57,9,57,9,66
51601,SAN AGUSTIN,estado nutricional en menores de 5 anos,clasificacion a y b,2003-06-01,2,1,2,1,3
80602,SAN ANDRES,estado nutricional en menores de 5 anos,clasificacion a y b,2003-06-01,4,0,4,0,4
71105,SAN ANTONIO DE LOMERIO,estado nutricional en menores de 5 anos,clasificacion a y b,2003-06-01,9,17,9,17,26
31403,SAN BENITO,estado nutricional en menores de 5 anos,clasificacion a y b,2003-06-01,13,0,13,0,13
80302,SAN BORJA,estado nutricional en menores de 5 anos,clasificacion a y b,2003-06-01,103,21,103,21,124
21502,SAN BUENA VENTURA,estado nutricional en menores de 5 anos,clasificacion a y b,2003-06-01,17,3,17,3,20
70402,SAN CARLOS,estado nutricional en menores de 5 anos,clasificacion a y b,2003-06-01,100,56,100,56,156
80501,SAN IGNACIO,estado nutricional en menores de 5 anos,clasificacion a y b,2003-06-01,71,16,71,16,87
70301,SAN IGNACIO DE VELASCO,estado nutricional en menores de 5 anos,clasificacion a y b,2003-06-01,170,32,170,32,202
80102,SAN JAVIER(BNI),estado nutricional en menores de 5 anos,clasificacion a y b,2003-06-01,6,0,6,0,6
71102,SAN JAVIER(STC),estado nutricional en menores de 5 anos,clasificacion a y b,2003-06-01,36,9,36,9,45
80701,SAN JOAQUIN,estado nutricional en menores de 5 anos,clasificacion a y b,2003-06-01,13,4,13,4,17
70501,SAN JOSE DE CHIQUITOS,estado nutricional en menores de 5 anos,clasificacion a y b,2003-06-01,27,8,27,8,35
71104,SAN JULIAN,estado nutricional en menores de 5 anos,clasificacion a y b,2003-06-01,141,39,141,39,180
90302,SAN LORENZO(PND),estado nutricional en menores de 5 anos,clasificacion a y b,2003-06-01,0,1,0,1,1
60501,SAN LORENZO(TJA),estado nutricional en menores de 5 anos,clasificacion a y b,2003-06-01,19,9,19,9,28
10702,SAN LUCAS,estado nutricional en menores de 5 anos,clasificacion a y b,2003-06-01,35,4,35,4,39
71201,SAN MATIAS,estado nutricional en menores de 5 anos,clasificacion a y b,2003-06-01,36,28,36,28,64
70302,SAN MIGUEL DE VELASCO,estado nutricional en menores de 5 anos,clasificacion a y b,2003-06-01,21,3,21,3,24
50501,SAN PEDRO DE BUENA VISTA,estado nutricional en menores de 5 anos,clasificacion a y b,2003-06-01,27,9,27,9,36
21801,SAN PEDRO DE CURAHUARA,estado nutricional en menores de 5 anos,clasificacion a y b,2003-06-01,13,5,13,5,18
21702,SAN PEDRO DE TIQUINA,estado nutricional en menores de 5 anos,clasificacion a y b,2003-06-01,4,2,4,2,6
70303,SAN RAFAEL,estado nutricional en menores de 5 anos,clasificacion a y b,2003-06-01,20,3,20,3,23
80702,SAN RAMON,estado nutricional en menores de 5 anos,clasificacion a y b,2003-06-01,5,5,5,5,10
70101,SANTA CRUZ DE LA SIERRA,estado nutricional en menores de 5 anos,clasificacion a y b,2003-06-01,2151,760,2151,760,2911
80303,SANTA ROSA,estado nutricional en menores de 5 anos,clasificacion a y b,2003-06-01,16,5,16,5,21
70602,SANTA ROSA DEL SARA,estado nutricional en menores de 5 anos,clasificacion a y b,2003-06-01,17,20,17,20,37
20308,SANTIAGO DE CALLAPA,estado nutricional en menores de 5 anos,clasificacion a y b,2003-06-01,5,1,5,1,6
41401,SANTIAGO DE HUARI,estado nutricional en menores de 5 anos,clasificacion a y b,2003-06-01,6,3,6,3,9
21901,SANTIAGO DE MACHACA,estado nutricional en menores de 5 anos,clasificacion a y b,2003-06-01,2,0,2,0,2
30702,SANTIVAÃ‘ES,estado nutricional en menores de 5 anos,clasificacion a y b,2003-06-01,3,0,3,0,3
20902,SAPAHAQUI,estado nutricional en menores de 5 anos,clasificacion a y b,2003-06-01,7,0,7,0,7
90303,SENA,estado nutricional en menores de 5 anos,clasificacion a y b,2003-06-01,28,4,28,4,32
21301,SICA SICA (VILLA AROMA),estado nutricional en menores de 5 anos,clasificacion a y b,2003-06-01,13,4,13,4,17
30703,SICAYA,estado nutricional en menores de 5 anos,clasificacion a y b,2003-06-01,3,3,3,3,6
30902,SIPE SIPE,estado nutricional en menores de 5 anos,clasificacion a y b,2003-06-01,76,22,76,22,98
10403,SOPACHUY,estado nutricional en menores de 5 anos,clasificacion a y b,2003-06-01,10,2,10,2,12
20601,SORATA,estado nutricional en menores de 5 anos,clasificacion a y b,2003-06-01,25,10,25,10,35
10101,SUCRE,estado nutricional en menores de 5 anos,clasificacion a y b,2003-06-01,357,123,357,123,480
20603,TACACOMA,estado nutricional en menores de 5 anos,clasificacion a y b,2003-06-01,22,10,22,10,32
50303,TACOBAMBA,estado nutricional en menores de 5 anos,clasificacion a y b,2003-06-01,22,5,22,5,27
30602,TACOPAYA,estado nutricional en menores de 5 anos,clasificacion a y b,2003-06-01,6,1,6,1,7
51402,TAHUA,estado nutricional en menores de 5 anos,clasificacion a y b,2003-06-01,3,1,3,1,4
31101,TAPACARI,estado nutricional en menores de 5 anos,clasificacion a y b,2003-06-01,15,7,15,7,22
10601,TARABUCO,estado nutricional en menores de 5 anos,clasificacion a y b,2003-06-01,31,5,31,5,36
30401,TARATA,estado nutricional en menores de 5 anos,clasificacion a y b,2003-06-01,6,2,6,2,8
60101,TARIJA,estado nutricional en menores de 5 anos,clasificacion a y b,2003-06-01,340,138,340,138,478
10202,TARVITA,estado nutricional en menores de 5 anos,clasificacion a y b,2003-06-01,21,0,21,0,21
20803,TIAWANACU,estado nutricional en menores de 5 anos,clasificacion a y b,2003-06-01,34,11,34,11,45
50102,TINGUIPAYA,estado nutricional en menores de 5 anos,clasificacion a y b,2003-06-01,44,5,44,5,49
20606,TIPUANI,estado nutricional en menores de 5 anos,clasificacion a y b,2003-06-01,38,5,38,5,43
30903,TIQUIPAYA,estado nutricional en menores de 5 anos,clasificacion a y b,2003-06-01,16,1,16,1,17
31601,TIRAQUE (CBBA),estado nutricional en menores de 5 anos,clasificacion a y b,2003-06-01,95,31,95,31,126
21703,TITO YUPANQUI (PARQUIPUJIO),estado nutricional en menores de 5 anos,clasificacion a y b,2003-06-01,1,1,1,1,2
30802,TOCO,estado nutricional en menores de 5 anos,clasificacion a y b,2003-06-01,1,1,1,1,2
30803,TOLATA,estado nutricional en menores de 5 anos,clasificacion a y b,2003-06-01,3,2,3,2,5
41001,TOLEDO,estado nutricional en menores de 5 anos,clasificacion a y b,2003-06-01,2,1,2,1,3
51202,TOMAVE,estado nutricional en menores de 5 anos,clasificacion a y b,2003-06-01,9,8,9,8,17
10402,TOMINA,estado nutricional en menores de 5 anos,clasificacion a y b,2003-06-01,25,4,25,4,29
50502,TORO TORO,estado nutricional en menores de 5 anos,clasificacion a y b,2003-06-01,11,2,11,2,13
31201,TOTORA(CBBA),estado nutricional en menores de 5 anos,clasificacion a y b,2003-06-01,19,0,19,0,19
41301,TOTORA(ORR),estado nutricional en menores de 5 anos,clasificacion a y b,2003-06-01,1,1,1,1,2
70802,TRIGAL,estado nutricional en menores de 5 anos,clasificacion a y b,2003-06-01,9,2,9,2,11
80101,TRINIDAD,estado nutricional en menores de 5 anos,clasificacion a y b,2003-06-01,190,97,190,97,287
50801,TUPIZA,estado nutricional en menores de 5 anos,clasificacion a y b,2003-06-01,59,58,59,58,117
40402,TURCO,estado nutricional en menores de 5 anos,clasificacion a y b,2003-06-01,7,0,7,0,7
21302,UMALA,estado nutricional en menores de 5 anos,clasificacion a y b,2003-06-01,8,10,8,10,18
50201,UNCIA,estado nutricional en menores de 5 anos,clasificacion a y b,2003-06-01,1,2,1,2,3
60401,URIONDO (A. CONCEPCION),estado nutricional en menores de 5 anos,clasificacion a y b,2003-06-01,86,33,86,33,119
71502,URUBICHA,estado nutricional en menores de 5 anos,clasificacion a y b,2003-06-01,10,8,10,8,18
51201,UYUNI,estado nutricional en menores de 5 anos,clasificacion a y b,2003-06-01,56,19,56,19,75
30502,VACAS,estado nutricional en menores de 5 anos,clasificacion a y b,2003-06-01,7,2,7,2,9
70801,VALLEGRANDE,estado nutricional en menores de 5 anos,clasificacion a y b,2003-06-01,61,33,61,33,94
20801,VIACHA,estado nutricional en menores de 5 anos,clasificacion a y b,2003-06-01,67,20,67,20,87
31302,VILA VILA,estado nutricional en menores de 5 anos,clasificacion a y b,2003-06-01,1,1,1,1,2
60303,VILLA MONTES,estado nutricional en menores de 5 anos,clasificacion a y b,2003-06-01,26,10,26,10,36
31402,VILLA RIVERO,estado nutricional en menores de 5 anos,clasificacion a y b,2003-06-01,6,2,6,2,8
10801,VILLA SERRANO,estado nutricional en menores de 5 anos,clasificacion a y b,2003-06-01,27,1,27,1,28
31003,VILLA TUNARI,estado nutricional en menores de 5 anos,clasificacion a y b,2003-06-01,67,32,67,32,99
11001,VILLA VACA GUZMAN (MUYUPAMPA),estado nutricional en menores de 5 anos,clasificacion a y b,2003-06-01,48,7,48,7,55
51501,VILLAZON,estado nutricional en menores de 5 anos,clasificacion a y b,2003-06-01,59,12,59,12,71
30904,VINTO,estado nutricional en menores de 5 anos,clasificacion a y b,2003-06-01,22,6,22,6,28
50602,VITICHI,estado nutricional en menores de 5 anos,clasificacion a y b,2003-06-01,22,6,22,6,28
20903,YACO,estado nutricional en menores de 5 anos,clasificacion a y b,2003-06-01,8,6,8,6,14
60301,YACUIBA,estado nutricional en menores de 5 anos,clasificacion a y b,2003-06-01,147,23,147,23,170
10602,YAMPARAEZ,estado nutricional en menores de 5 anos,clasificacion a y b,2003-06-01,34,5,34,5,39
21103,YANACACHI,estado nutricional en menores de 5 anos,clasificacion a y b,2003-06-01,13,0,13,0,13
70403,YAPACANI,estado nutricional en menores de 5 anos,clasificacion a y b,2003-06-01,100,24,100,24,124
50103,YOCALLA,estado nutricional en menores de 5 anos,clasificacion a y b,2003-06-01,3,1,3,1,4
10102,YOTALA,estado nutricional en menores de 5 anos,clasificacion a y b,2003-06-01,21,17,21,17,38
60402,YUNCHARA,estado nutricional en menores de 5 anos,clasificacion a y b,2003-06-01,6,9,6,9,15
10301,ZUDAÃ‘EZ,estado nutricional en menores de 5 anos,clasificacion a y b,2003-06-01,9,3,9,3,12
51302,ACACIO,estado nutricional en menores de 5 anos,clasificacion a y b,2003-07-01,7,2,7,2,9
20201,ACHACACHI,estado nutricional en menores de 5 anos,clasificacion a y b,2003-07-01,61,42,61,42,103
20104,ACHOCALLA,estado nutricional en menores de 5 anos,clasificacion a y b,2003-07-01,12,2,12,2,14
30201,AIQUILE,estado nutricional en menores de 5 anos,clasificacion a y b,2003-07-01,41,4,41,4,45
10404,ALCALA,estado nutricional en menores de 5 anos,clasificacion a y b,2003-07-01,9,3,9,3,12
20202,ANCORAIMES,estado nutricional en menores de 5 anos,clasificacion a y b,2003-07-01,17,3,17,3,20
30402,ANZALDO,estado nutricional en menores de 5 anos,clasificacion a y b,2003-07-01,6,1,6,1,7
20701,APOLO,estado nutricional en menores de 5 anos,clasificacion a y b,2003-07-01,21,2,21,2,23
51301,ARAMPAMPA,estado nutricional en menores de 5 anos,clasificacion a y b,2003-07-01,5,4,5,4,9
30501,ARANI,estado nutricional en menores de 5 anos,clasificacion a y b,2003-07-01,3,5,3,5,8
30403,ARBIETO,estado nutricional en menores de 5 anos,clasificacion a y b,2003-07-01,2,0,2,0,2
30601,ARQUE,estado nutricional en menores de 5 anos,clasificacion a y b,2003-07-01,8,1,8,1,9
50802,ATOCHA,estado nutricional en menores de 5 anos,clasificacion a y b,2003-07-01,12,34,12,34,46
20503,AUCAPATA,estado nutricional en menores de 5 anos,clasificacion a y b,2003-07-01,4,0,4,0,4
20502,AYATA,estado nutricional en menores de 5 anos,clasificacion a y b,2003-07-01,19,7,19,7,26
21303,AYO AYO,estado nutricional en menores de 5 anos,clasificacion a y b,2003-07-01,17,0,17,0,17
30301,AYOPAYA (V. DE INDEPENDENCIA),estado nutricional en menores de 5 anos,clasificacion a y b,2003-07-01,25,11,25,11,36
10201,AZURDUY,estado nutricional en menores de 5 anos,clasificacion a y b,2003-07-01,29,10,29,10,39
21203,BATALLAS,estado nutricional en menores de 5 anos,clasificacion a y b,2003-07-01,23,2,23,2,25
80802,BAURES,estado nutricional en menores de 5 anos,clasificacion a y b,2003-07-01,19,2,19,2,21
50104,BELEN DE URMIRI,estado nutricional en menores de 5 anos,clasificacion a y b,2003-07-01,1,0,1,0,1
90104,BELLA FLOR,estado nutricional en menores de 5 anos,clasificacion a y b,2003-07-01,9,10,9,10,19
60202,BERMEJO,estado nutricional en menores de 5 anos,clasificacion a y b,2003-07-01,19,11,19,11,30
50301,BETANZOS,estado nutricional en menores de 5 anos,clasificacion a y b,2003-07-01,32,2,32,2,34
31501,BOLIVAR,estado nutricional en menores de 5 anos,clasificacion a y b,2003-07-01,3,0,3,0,3
90103,BOLPEBRA,estado nutricional en menores de 5 anos,clasificacion a y b,2003-07-01,6,1,6,1,7
70707,BOYUIBE,estado nutricional en menores de 5 anos,clasificacion a y b,2003-07-01,11,5,11,5,16
70401,BUENA VISTA,estado nutricional en menores de 5 anos,clasificacion a y b,2003-07-01,84,22,84,22,106
70703,CABEZAS,estado nutricional en menores de 5 anos,clasificacion a y b,2003-07-01,14,12,14,12,26
20905,CAIROMA,estado nutricional en menores de 5 anos,clasificacion a y b,2003-07-01,5,0,5,0,5
51102,"CAIZA ""D""",estado nutricional en menores de 5 anos,clasificacion a y b,2003-07-01,19,4,19,4,23
21003,CAJUATA,estado nutricional en menores de 5 anos,clasificacion a y b,2003-07-01,12,0,12,0,12
20303,CALACOTO,estado nutricional en menores de 5 anos,clasificacion a y b,2003-07-01,2,0,2,0,2
21304,CALAMARCA,estado nutricional en menores de 5 anos,clasificacion a y b,2003-07-01,3,0,3,0,3
10701,CAMARGO,estado nutricional en menores de 5 anos,clasificacion a y b,2003-07-01,15,0,15,0,15
10901,CAMATAQUI (C. VILLA ABECIA),estado nutricional en menores de 5 anos,clasificacion a y b,2003-07-01,8,3,8,3,11
70706,CAMIRI,estado nutricional en menores de 5 anos,clasificacion a y b,2003-07-01,170,27,170,27,197
30701,CAPINOTA,estado nutricional en menores de 5 anos,clasificacion a y b,2003-07-01,4,3,4,3,7
20302,CAQUIAVIRI,estado nutricional en menores de 5 anos,clasificacion a y b,2003-07-01,9,8,9,8,17
40102,CARACOLLO,estado nutricional en menores de 5 anos,clasificacion a y b,2003-07-01,27,8,27,8,35
22001,CARANAVI,estado nutricional en menores de 5 anos,clasificacion a y b,2003-07-01,122,30,122,30,152
60302,CARAPARI,estado nutricional en menores de 5 anos,clasificacion a y b,2003-07-01,50,11,50,11,61
50702,CARIPUYO,estado nutricional en menores de 5 anos,clasificacion a y b,2003-07-01,9,5,9,5,14
40201,CHALLAPATA,estado nutricional en menores de 5 anos,clasificacion a y b,2003-07-01,23,0,23,0,23
50302,CHAQUI,estado nutricional en menores de 5 anos,clasificacion a y b,2003-07-01,15,0,15,0,15
70702,CHARAGUA,estado nutricional en menores de 5 anos,clasificacion a y b,2003-07-01,129,39,129,39,168
20305,CHARAÃ‘A,estado nutricional en menores de 5 anos,clasificacion a y b,2003-07-01,2,0,2,0,2
50202,CHAYANTA,estado nutricional en menores de 5 anos,clasificacion a y b,2003-07-01,12,0,12,0,12
31204,CHIMORE,estado nutricional en menores de 5 anos,clasificacion a y b,2003-07-01,29,8,29,8,37
21101,CHULUMANI (V. DE LA LIBERTAD),estado nutricional en menores de 5 anos,clasificacion a y b,2003-07-01,19,10,19,10,29
20501,CHUMA,estado nutricional en menores de 5 anos,clasificacion a y b,2003-07-01,13,6,13,6,19
30801,CLIZA,estado nutricional en menores de 5 anos,clasificacion a y b,2003-07-01,5,23,5,23,28
90101,COBIJA,estado nutricional en menores de 5 anos,clasificacion a y b,2003-07-01,140,28,140,28,168
30101,COCHABAMBA,estado nutricional en menores de 5 anos,clasificacion a y b,2003-07-01,1872,1176,1872,1176,3048
40902,COIPASA,estado nutricional en menores de 5 anos,clasificacion a y b,2003-07-01,2,1,2,1,3
30905,COLCAPIRHUA,estado nutricional en menores de 5 anos,clasificacion a y b,2003-07-01,42,10,42,10,52
50901,"COLCHA ""K""",estado nutricional en menores de 5 anos,clasificacion a y b,2003-07-01,18,2,18,2,20
31002,COLOMI,estado nutricional en menores de 5 anos,clasificacion a y b,2003-07-01,27,2,27,2,29
50401,COLQUECHACA,estado nutricional en menores de 5 anos,clasificacion a y b,2003-07-01,34,9,34,9,43
21306,COLQUENCHA,estado nutricional en menores de 5 anos,clasificacion a y b,2003-07-01,10,0,10,0,10
21004,COLQUIRI,estado nutricional en menores de 5 anos,clasificacion a y b,2003-07-01,14,4,14,4,18
20304,COMANCHE,estado nutricional en menores de 5 anos,clasificacion a y b,2003-07-01,2,0,2,0,2
71301,COMARAPA,estado nutricional en menores de 5 anos,clasificacion a y b,2003-07-01,87,12,87,12,99
20605,COMBAYA,estado nutricional en menores de 5 anos,clasificacion a y b,2003-07-01,5,0,5,0,5
71101,CONCEPCION,estado nutricional en menores de 5 anos,clasificacion a y b,2003-07-01,5,5,5,5,10
21701,COPACABANA,estado nutricional en menores de 5 anos,clasificacion a y b,2003-07-01,4,3,4,3,7
21402,CORIPATA,estado nutricional en menores de 5 anos,clasificacion a y b,2003-07-01,20,0,20,0,20
20301,CORO CORO,estado nutricional en menores de 5 anos,clasificacion a y b,2003-07-01,2,1,2,1,3
21401,COROICO,estado nutricional en menores de 5 anos,clasificacion a y b,2003-07-01,7,2,7,2,9
40301,CORQUE,estado nutricional en menores de 5 anos,clasificacion a y b,2003-07-01,2,7,2,7,9
50601,COTAGAITA,estado nutricional en menores de 5 anos,clasificacion a y b,2003-07-01,25,18,25,18,43
70102,COTOCA,estado nutricional en menores de 5 anos,clasificacion a y b,2003-07-01,40,4,40,4,44
31405,CUCHUMUELA (V. G. VILLARROEL),estado nutricional en menores de 5 anos,clasificacion a y b,2003-07-01,1,0,1,0,1
70704,CUEVO,estado nutricional en menores de 5 anos,clasificacion a y b,2003-07-01,5,0,5,0,5
10902,CULPINA,estado nutricional en menores de 5 anos,clasificacion a y b,2003-07-01,40,13,40,13,53
40401,CURAHUARA DE CARANGAS,estado nutricional en menores de 5 anos,clasificacion a y b,2003-07-01,5,1,5,1,6
21602,CURVA,estado nutricional en menores de 5 anos,clasificacion a y b,2003-07-01,3,1,3,1,4
20804,DESAGUADERO,estado nutricional en menores de 5 anos,clasificacion a y b,2003-07-01,6,3,6,3,9
20105,EL ALTO,estado nutricional en menores de 5 anos,clasificacion a y b,2003-07-01,811,295,811,295,1106
40103,EL CHORO,estado nutricional en menores de 5 anos,clasificacion a y b,2003-07-01,3,1,3,1,4
71503,EL PUENTE(STC),estado nutricional en menores de 5 anos,clasificacion a y b,2003-07-01,3,37,3,37,40
60502,EL PUENTE(TJA),estado nutricional en menores de 5 anos,clasificacion a y b,2003-07-01,19,1,19,1,20
70105,EL TORNO,estado nutricional en menores de 5 anos,clasificacion a y b,2003-07-01,152,22,152,22,174
10405,EL VILLAR,estado nutricional en menores de 5 anos,clasificacion a y b,2003-07-01,5,5,5,5,10
60601,ENTRE RIOS,estado nutricional en menores de 5 anos,clasificacion a y b,2003-07-01,46,19,46,19,65
41101,EUCALIPTUS,estado nutricional en menores de 5 anos,clasificacion a y b,2003-07-01,8,0,8,0,8
90503,EUREKA (SANTOS MERCADO),estado nutricional en menores de 5 anos,clasificacion a y b,2003-07-01,2,2,2,2,4
80402,EXALTACION,estado nutricional en menores de 5 anos,clasificacion a y b,2003-07-01,4,8,4,8,12
90203,FILADELFIA,estado nutricional en menores de 5 anos,clasificacion a y b,2003-07-01,1,0,1,0,1
71002,GENERAL SAAVEDRA,estado nutricional en menores de 5 anos,clasificacion a y b,2003-07-01,58,27,58,27,85
21601,GRAL. J.J. PEREZ (CHARAZANI),estado nutricional en menores de 5 anos,clasificacion a y b,2003-07-01,31,9,31,9,40
20602,GUANAY,estado nutricional en menores de 5 anos,clasificacion a y b,2003-07-01,63,18,63,18,81
20802,GUAQUI,estado nutricional en menores de 5 anos,clasificacion a y b,2003-07-01,1,0,1,0,1
80202,GUAYARAMERIN,estado nutricional en menores de 5 anos,clasificacion a y b,2003-07-01,156,23,156,23,179
70705,GUTIERREZ,estado nutricional en menores de 5 anos,clasificacion a y b,2003-07-01,83,19,83,19,102
10502,HUACARETA,estado nutricional en menores de 5 anos,clasificacion a y b,2003-07-01,29,11,29,11,40
11002,HUACAYA (VILLA DE HUACAYA),estado nutricional en menores de 5 anos,clasificacion a y b,2003-07-01,7,2,7,2,9
40501,HUACHACALLA,estado nutricional en menores de 5 anos,clasificacion a y b,2003-07-01,0,1,0,1,1
40701,HUANUNI,estado nutricional en menores de 5 anos,clasificacion a y b,2003-07-01,22,2,22,2,24
80803,HUARACAJE,estado nutricional en menores de 5 anos,clasificacion a y b,2003-07-01,11,13,11,13,24
41601,HUAYLLAMARCA,estado nutricional en menores de 5 anos,clasificacion a y b,2003-07-01,3,0,3,0,3
21005,ICHOCA,estado nutricional en menores de 5 anos,clasificacion a y b,2003-07-01,11,1,11,1,12
10304,ICLA,estado nutricional en menores de 5 anos,clasificacion a y b,2003-07-01,11,4,11,4,15
10703,INCAHUASI,estado nutricional en menores de 5 anos,clasificacion a y b,2003-07-01,28,3,28,3,31
21001,INQUISIVI,estado nutricional en menores de 5 anos,clasificacion a y b,2003-07-01,30,13,30,13,43
21102,IRUPANA (VILLA DE LANZA),estado nutricional en menores de 5 anos,clasificacion a y b,2003-07-01,22,32,22,32,54
21501,IXIAMAS,estado nutricional en menores de 5 anos,clasificacion a y b,2003-07-01,22,8,22,8,30
21105,LA ASUNTA,estado nutricional en menores de 5 anos,clasificacion a y b,2003-07-01,54,7,54,7,61
70104,LA GUARDIA,estado nutricional en menores de 5 anos,clasificacion a y b,2003-07-01,113,36,113,36,149
20101,LA PAZ,estado nutricional en menores de 5 anos,clasificacion a y b,2003-07-01,694,237,694,237,931
41501,LA RIVERA,estado nutricional en menores de 5 anos,clasificacion a y b,2003-07-01,1,0,1,0,1
70701,LAGUNILLAS,estado nutricional en menores de 5 anos,clasificacion a y b,2003-07-01,49,6,49,6,55
21202,LAJA,estado nutricional en menores de 5 anos,clasificacion a y b,2003-07-01,28,47,28,47,75
10903,LAS CARRERAS,estado nutricional en menores de 5 anos,clasificacion a y b,2003-07-01,18,7,18,7,25
50203,LLALLAGUA,estado nutricional en menores de 5 anos,clasificacion a y b,2003-07-01,38,123,38,123,161
51401,LLICA,estado nutricional en menores de 5 anos,clasificacion a y b,2003-07-01,3,1,3,1,4
80601,LORETO,estado nutricional en menores de 5 anos,clasificacion a y b,2003-07-01,7,12,7,12,19
20901,LURIBAY,estado nutricional en menores de 5 anos,clasificacion a y b,2003-07-01,8,0,8,0,8
40702,MACHACAMARCA,estado nutricional en menores de 5 anos,clasificacion a y b,2003-07-01,7,4,7,4,11
11003,MACHARETI,estado nutricional en menores de 5 anos,clasificacion a y b,2003-07-01,75,30,75,30,105
80801,MAGDALENA,estado nutricional en menores de 5 anos,clasificacion a y b,2003-07-01,10,7,10,7,17
70903,MAIRANA,estado nutricional en menores de 5 anos,clasificacion a y b,2003-07-01,70,5,70,5,75
20904,MALLA,estado nutricional en menores de 5 anos,clasificacion a y b,2003-07-01,1,0,1,0,1
20103,MECAPACA,estado nutricional en menores de 5 anos,clasificacion a y b,2003-07-01,5,5,5,5,10
71003,MINEROS,estado nutricional en menores de 5 anos,clasificacion a y b,2003-07-01,257,56,257,56,313
31301,MIZQUE,estado nutricional en menores de 5 anos,clasificacion a y b,2003-07-01,16,1,16,1,17
20402,MOCOMOCO,estado nutricional en menores de 5 anos,clasificacion a y b,2003-07-01,16,10,16,10,26
51002,MOJINETE,estado nutricional en menores de 5 anos,clasificacion a y b,2003-07-01,4,1,4,1,5
10303,MOJOCOYA,estado nutricional en menores de 5 anos,clasificacion a y b,2003-07-01,20,13,20,13,33
10501,MONTEAGUDO,estado nutricional en menores de 5 anos,clasificacion a y b,2003-07-01,80,20,80,20,100
71001,MONTERO,estado nutricional en menores de 5 anos,clasificacion a y b,2003-07-01,532,110,532,110,642
70803,MORO MORO,estado nutricional en menores de 5 anos,clasificacion a y b,2003-07-01,11,1,11,1,12
30302,MOROCHATA,estado nutricional en menores de 5 anos,clasificacion a y b,2003-07-01,24,3,24,3,27
90501,NUEVO MANOA (NUEVA ESPERANZA),estado nutricional en menores de 5 anos,clasificacion a y b,2003-07-01,1,0,1,0,1
50404,OCURI,estado nutricional en menores de 5 anos,clasificacion a y b,2003-07-01,3,1,3,1,4
70202,OKINAWA,estado nutricional en menores de 5 anos,clasificacion a y b,2003-07-01,8,1,8,1,9
30203,OMEREQUE,estado nutricional en menores de 5 anos,clasificacion a y b,2003-07-01,10,2,10,2,12
40101,ORURO,estado nutricional en menores de 5 anos,clasificacion a y b,2003-07-01,355,103,355,103,458
60201,PADCAYA,estado nutricional en menores de 5 anos,clasificacion a y b,2003-07-01,42,33,42,33,75
10401,PADILLA,estado nutricional en menores de 5 anos,clasificacion a y b,2003-07-01,48,7,48,7,55
70502,PAILON,estado nutricional en menores de 5 anos,clasificacion a y b,2003-07-01,33,31,33,31,64
20102,PALCA,estado nutricional en menores de 5 anos,clasificacion a y b,2003-07-01,7,1,7,1,8
21104,PALOS BLANCOS,estado nutricional en menores de 5 anos,clasificacion a y b,2003-07-01,33,9,33,9,42
40802,PAMPA AULLAGAS,estado nutricional en menores de 5 anos,clasificacion a y b,2003-07-01,8,0,8,0,8
70902,PAMPA GRANDE,estado nutricional en menores de 5 anos,clasificacion a y b,2003-07-01,26,4,26,4,30
21802,PAPEL PAMPA,estado nutricional en menores de 5 anos,clasificacion a y b,2003-07-01,4,0,4,0,4
30202,PASORAPA,estado nutricional en menores de 5 anos,clasificacion a y b,2003-07-01,14,11,14,11,25
21305,PATACAMAYA,estado nutricional en menores de 5 anos,clasificacion a y b,2003-07-01,30,5,30,5,35
40602,PAZÃ‘A,estado nutricional en menores de 5 anos,clasificacion a y b,2003-07-01,7,9,7,9,16
20702,PELECHUCO,estado nutricional en menores de 5 anos,clasificacion a y b,2003-07-01,2,1,2,1,3
50403,POCOATA,estado nutricional en menores de 5 anos,clasificacion a y b,2003-07-01,18,5,18,5,23
31203,POCONA,estado nutricional en menores de 5 anos,clasificacion a y b,2003-07-01,6,0,6,0,6
31202,POJO (CBBA),estado nutricional en menores de 5 anos,clasificacion a y b,2003-07-01,115,56,115,56,171
40601,POOPO,estado nutricional en menores de 5 anos,clasificacion a y b,2003-07-01,6,5,6,5,11
51203,PORCO,estado nutricional en menores de 5 anos,clasificacion a y b,2003-07-01,17,2,17,2,19
10103,POROMA,estado nutricional en menores de 5 anos,clasificacion a y b,2003-07-01,34,5,34,5,39
70103,PORONGO,estado nutricional en menores de 5 anos,clasificacion a y b,2003-07-01,5,1,5,1,6
70601,PORTACHUELO,estado nutricional en menores de 5 anos,clasificacion a y b,2003-07-01,149,59,149,59,208
90102,PORVENIR,estado nutricional en menores de 5 anos,clasificacion a y b,2003-07-01,10,5,10,5,15
70804,POSTRER VALLE,estado nutricional en menores de 5 anos,clasificacion a y b,2003-07-01,3,7,3,7,10
50101,POTOSI,estado nutricional en menores de 5 anos,clasificacion a y b,2003-07-01,163,14,163,14,177
10302,PRESTO,estado nutricional en menores de 5 anos,clasificacion a y b,2003-07-01,13,6,13,6,19
70805,PUCARA,estado nutricional en menores de 5 anos,clasificacion a y b,2003-07-01,5,0,5,0,5
21201,PUCARANI,estado nutricional en menores de 5 anos,clasificacion a y b,2003-07-01,22,0,22,0,22
20401,PUERTO ACOSTA,estado nutricional en menores de 5 anos,clasificacion a y b,2003-07-01,28,17,28,17,45
20403,PUERTO CARABUCO,estado nutricional en menores de 5 anos,clasificacion a y b,2003-07-01,22,1,22,1,23
90301,PUERTO GONZALO MORENO,estado nutricional en menores de 5 anos,clasificacion a y b,2003-07-01,4,0,4,0,4
21204,PUERTO PEREZ,estado nutricional en menores de 5 anos,clasificacion a y b,2003-07-01,9,0,9,0,9
71402,PUERTO QUIJARRO,estado nutricional en menores de 5 anos,clasificacion a y b,2003-07-01,98,15,98,15,113
90201,PUERTO RICO,estado nutricional en menores de 5 anos,clasificacion a y b,2003-07-01,4,0,4,0,4
80703,PUERTO SILES,estado nutricional en menores de 5 anos,clasificacion a y b,2003-07-01,3,3,3,3,6
71401,PUERTO SUAREZ,estado nutricional en menores de 5 anos,clasificacion a y b,2003-07-01,77,4,77,4,81
31205,PUERTO VILLARROEL,estado nutricional en menores de 5 anos,clasificacion a y b,2003-07-01,216,52,216,52,268
51101,PUNA,estado nutricional en menores de 5 anos,clasificacion a y b,2003-07-01,37,22,37,22,59
31401,PUNATA,estado nutricional en menores de 5 anos,clasificacion a y b,2003-07-01,27,3,27,3,30
20604,QUIABAYA,estado nutricional en menores de 5 anos,clasificacion a y b,2003-07-01,10,0,10,0,10
30901,QUILLACOLLO,estado nutricional en menores de 5 anos,clasificacion a y b,2003-07-01,89,43,89,43,132
21002,QUIME,estado nutricional en menores de 5 anos,clasificacion a y b,2003-07-01,25,2,25,2,27
70904,QUIRUSILLAS,estado nutricional en menores de 5 anos,clasificacion a y b,2003-07-01,7,0,7,0,7
50402,RAVELO,estado nutricional en menores de 5 anos,clasificacion a y b,2003-07-01,5,1,5,1,6
80301,REYES,estado nutricional en menores de 5 anos,clasificacion a y b,2003-07-01,43,3,43,3,46
80201,RIBERALTA,estado nutricional en menores de 5 anos,clasificacion a y b,2003-07-01,218,45,218,45,263
70503,ROBORE,estado nutricional en menores de 5 anos,clasificacion a y b,2003-07-01,37,12,37,12,49
80304,RURRENABAQUE,estado nutricional en menores de 5 anos,clasificacion a y b,2003-07-01,32,7,32,7,39
40901,SABAYA,estado nutricional en menores de 5 anos,clasificacion a y b,2003-07-01,5,0,5,0,5
31001,SACABA,estado nutricional en menores de 5 anos,clasificacion a y b,2003-07-01,92,8,92,8,100
30404,SACABAMBA,estado nutricional en menores de 5 anos,clasificacion a y b,2003-07-01,1,0,1,0,1
50701,SACACA,estado nutricional en menores de 5 anos,clasificacion a y b,2003-07-01,4,4,4,4,8
71302,SAIPINA,estado nutricional en menores de 5 anos,clasificacion a y b,2003-07-01,78,36,78,36,114
40801,SALINAS DE GARCI MENDOZA,estado nutricional en menores de 5 anos,clasificacion a y b,2003-07-01,1,1,1,1,2
70901,SAMAIPATA,estado nutricional en menores de 5 anos,clasificacion a y b,2003-07-01,38,14,38,14,52
51601,SAN AGUSTIN,estado nutricional en menores de 5 anos,clasificacion a y b,2003-07-01,6,0,6,0,6
80602,SAN ANDRES,estado nutricional en menores de 5 anos,clasificacion a y b,2003-07-01,11,4,11,4,15
71105,SAN ANTONIO DE LOMERIO,estado nutricional en menores de 5 anos,clasificacion a y b,2003-07-01,6,7,6,7,13
31403,SAN BENITO,estado nutricional en menores de 5 anos,clasificacion a y b,2003-07-01,12,8,12,8,20
80302,SAN BORJA,estado nutricional en menores de 5 anos,clasificacion a y b,2003-07-01,75,8,75,8,83
21502,SAN BUENA VENTURA,estado nutricional en menores de 5 anos,clasificacion a y b,2003-07-01,21,13,21,13,34
70402,SAN CARLOS,estado nutricional en menores de 5 anos,clasificacion a y b,2003-07-01,107,73,107,73,180
80501,SAN IGNACIO,estado nutricional en menores de 5 anos,clasificacion a y b,2003-07-01,51,12,51,12,63
70301,SAN IGNACIO DE VELASCO,estado nutricional en menores de 5 anos,clasificacion a y b,2003-07-01,184,21,184,21,205
80102,SAN JAVIER(BNI),estado nutricional en menores de 5 anos,clasificacion a y b,2003-07-01,9,3,9,3,12
71102,SAN JAVIER(STC),estado nutricional en menores de 5 anos,clasificacion a y b,2003-07-01,62,4,62,4,66
80701,SAN JOAQUIN,estado nutricional en menores de 5 anos,clasificacion a y b,2003-07-01,24,6,24,6,30
70501,SAN JOSE DE CHIQUITOS,estado nutricional en menores de 5 anos,clasificacion a y b,2003-07-01,27,12,27,12,39
71104,SAN JULIAN,estado nutricional en menores de 5 anos,clasificacion a y b,2003-07-01,146,82,146,82,228
90302,SAN LORENZO(PND),estado nutricional en menores de 5 anos,clasificacion a y b,2003-07-01,5,0,5,0,5
60501,SAN LORENZO(TJA),estado nutricional en menores de 5 anos,clasificacion a y b,2003-07-01,34,23,34,23,57
10702,SAN LUCAS,estado nutricional en menores de 5 anos,clasificacion a y b,2003-07-01,26,6,26,6,32
70302,SAN MIGUEL DE VELASCO,estado nutricional en menores de 5 anos,clasificacion a y b,2003-07-01,19,4,19,4,23
51001,SAN PABLO DE LIPEZ,estado nutricional en menores de 5 anos,clasificacion a y b,2003-07-01,2,0,2,0,2
50501,SAN PEDRO DE BUENA VISTA,estado nutricional en menores de 5 anos,clasificacion a y b,2003-07-01,10,4,10,4,14
21801,SAN PEDRO DE CURAHUARA,estado nutricional en menores de 5 anos,clasificacion a y b,2003-07-01,5,0,5,0,5
50902,SAN PEDRO DE QUEMES,estado nutricional en menores de 5 anos,clasificacion a y b,2003-07-01,1,0,1,0,1
21702,SAN PEDRO DE TIQUINA,estado nutricional en menores de 5 anos,clasificacion a y b,2003-07-01,10,6,10,6,16
70303,SAN RAFAEL,estado nutricional en menores de 5 anos,clasificacion a y b,2003-07-01,18,1,18,1,19
80702,SAN RAMON,estado nutricional en menores de 5 anos,clasificacion a y b,2003-07-01,12,0,12,0,12
80702,SAN RAMON,estado nutricional en menores de 5 anos,clasificacion a y b,2003-07-01,10,8,10,8,18
80401,SANTA ANA,estado nutricional en menores de 5 anos,clasificacion a y b,2003-07-01,67,25,67,25,92
70101,SANTA CRUZ DE LA SIERRA,estado nutricional en menores de 5 anos,clasificacion a y b,2003-07-01,2795,1032,2795,1032,3827
80303,SANTA ROSA,estado nutricional en menores de 5 anos,clasificacion a y b,2003-07-01,24,6,24,6,30
70602,SANTA ROSA DEL SARA,estado nutricional en menores de 5 anos,clasificacion a y b,2003-07-01,28,30,28,30,58
20308,SANTIAGO DE CALLAPA,estado nutricional en menores de 5 anos,clasificacion a y b,2003-07-01,5,1,5,1,6
41401,SANTIAGO DE HUARI,estado nutricional en menores de 5 anos,clasificacion a y b,2003-07-01,7,3,7,3,10
21901,SANTIAGO DE MACHACA,estado nutricional en menores de 5 anos,clasificacion a y b,2003-07-01,9,2,9,2,11
30702,SANTIVAÃ‘ES,estado nutricional en menores de 5 anos,clasificacion a y b,2003-07-01,5,2,5,2,7
40202,SANTUARIO DE QUILLACAS,estado nutricional en menores de 5 anos,clasificacion a y b,2003-07-01,1,0,1,0,1
20902,SAPAHAQUI,estado nutricional en menores de 5 anos,clasificacion a y b,2003-07-01,4,1,4,1,5
90303,SENA,estado nutricional en menores de 5 anos,clasificacion a y b,2003-07-01,60,53,60,53,113
21301,SICA SICA (VILLA AROMA),estado nutricional en menores de 5 anos,clasificacion a y b,2003-07-01,11,0,11,0,11
30703,SICAYA,estado nutricional en menores de 5 anos,clasificacion a y b,2003-07-01,2,1,2,1,3
30902,SIPE SIPE,estado nutricional en menores de 5 anos,clasificacion a y b,2003-07-01,121,24,121,24,145
10403,SOPACHUY,estado nutricional en menores de 5 anos,clasificacion a y b,2003-07-01,12,2,12,2,14
20601,SORATA,estado nutricional en menores de 5 anos,clasificacion a y b,2003-07-01,48,6,48,6,54
10101,SUCRE,estado nutricional en menores de 5 anos,clasificacion a y b,2003-07-01,319,98,319,98,417
31404,TACACHI,estado nutricional en menores de 5 anos,clasificacion a y b,2003-07-01,1,0,1,0,1
20603,TACACOMA,estado nutricional en menores de 5 anos,clasificacion a y b,2003-07-01,24,5,24,5,29
50303,TACOBAMBA,estado nutricional en menores de 5 anos,clasificacion a y b,2003-07-01,29,1,29,1,30
30602,TACOPAYA,estado nutricional en menores de 5 anos,clasificacion a y b,2003-07-01,5,2,5,2,7
51402,TAHUA,estado nutricional en menores de 5 anos,clasificacion a y b,2003-07-01,4,0,4,0,4
31101,TAPACARI,estado nutricional en menores de 5 anos,clasificacion a y b,2003-07-01,14,1,14,1,15
10601,TARABUCO,estado nutricional en menores de 5 anos,clasificacion a y b,2003-07-01,34,9,34,9,43
30401,TARATA,estado nutricional en menores de 5 anos,clasificacion a y b,2003-07-01,18,5,18,5,23
60101,TARIJA,estado nutricional en menores de 5 anos,clasificacion a y b,2003-07-01,603,192,603,192,795
10202,TARVITA,estado nutricional en menores de 5 anos,clasificacion a y b,2003-07-01,29,24,29,24,53
20803,TIAWANACU,estado nutricional en menores de 5 anos,clasificacion a y b,2003-07-01,31,4,31,4,35
50102,TINGUIPAYA,estado nutricional en menores de 5 anos,clasificacion a y b,2003-07-01,5,1,5,1,6
20606,TIPUANI,estado nutricional en menores de 5 anos,clasificacion a y b,2003-07-01,40,0,40,0,40
30903,TIQUIPAYA,estado nutricional en menores de 5 anos,clasificacion a y b,2003-07-01,4,1,4,1,5
31601,TIRAQUE (CBBA),estado nutricional en menores de 5 anos,clasificacion a y b,2003-07-01,120,59,120,59,179
21703,TITO YUPANQUI (PARQUIPUJIO),estado nutricional en menores de 5 anos,clasificacion a y b,2003-07-01,1,0,1,0,1
30803,TOLATA,estado nutricional en menores de 5 anos,clasificacion a y b,2003-07-01,6,7,6,7,13
41001,TOLEDO,estado nutricional en menores de 5 anos,clasificacion a y b,2003-07-01,6,3,6,3,9
51202,TOMAVE,estado nutricional en menores de 5 anos,clasificacion a y b,2003-07-01,4,2,4,2,6
10402,TOMINA,estado nutricional en menores de 5 anos,clasificacion a y b,2003-07-01,22,0,22,0,22
50502,TORO TORO,estado nutricional en menores de 5 anos,clasificacion a y b,2003-07-01,15,4,15,4,19
31201,TOTORA(CBBA),estado nutricional en menores de 5 anos,clasificacion a y b,2003-07-01,24,4,24,4,28
41301,TOTORA(ORR),estado nutricional en menores de 5 anos,clasificacion a y b,2003-07-01,7,2,7,2,9
70802,TRIGAL,estado nutricional en menores de 5 anos,clasificacion a y b,2003-07-01,6,1,6,1,7
80101,TRINIDAD,estado nutricional en menores de 5 anos,clasificacion a y b,2003-07-01,235,108,235,108,343
50801,TUPIZA,estado nutricional en menores de 5 anos,clasificacion a y b,2003-07-01,63,51,63,51,114
40402,TURCO,estado nutricional en menores de 5 anos,clasificacion a y b,2003-07-01,5,0,5,0,5
21302,UMALA,estado nutricional en menores de 5 anos,clasificacion a y b,2003-07-01,13,16,13,16,29
50201,UNCIA,estado nutricional en menores de 5 anos,clasificacion a y b,2003-07-01,2,3,2,3,5
60401,URIONDO (A. CONCEPCION),estado nutricional en menores de 5 anos,clasificacion a y b,2003-07-01,74,35,74,35,109
51201,UYUNI,estado nutricional en menores de 5 anos,clasificacion a y b,2003-07-01,68,19,68,19,87
30502,VACAS,estado nutricional en menores de 5 anos,clasificacion a y b,2003-07-01,2,0,2,0,2
70801,VALLEGRANDE,estado nutricional en menores de 5 anos,clasificacion a y b,2003-07-01,61,21,61,21,82
20801,VIACHA,estado nutricional en menores de 5 anos,clasificacion a y b,2003-07-01,100,21,100,21,121
60303,VILLA MONTES,estado nutricional en menores de 5 anos,clasificacion a y b,2003-07-01,103,14,103,14,117
90502,VILLA NUEVA (LOMA ALTA),estado nutricional en menores de 5 anos,clasificacion a y b,2003-07-01,1,0,1,0,1
31402,VILLA RIVERO,estado nutricional en menores de 5 anos,clasificacion a y b,2003-07-01,10,0,10,0,10
10801,VILLA SERRANO,estado nutricional en menores de 5 anos,clasificacion a y b,2003-07-01,26,7,26,7,33
31003,VILLA TUNARI,estado nutricional en menores de 5 anos,clasificacion a y b,2003-07-01,84,21,84,21,105
11001,VILLA VACA GUZMAN (MUYUPAMPA),estado nutricional en menores de 5 anos,clasificacion a y b,2003-07-01,61,9,61,9,70
51501,VILLAZON,estado nutricional en menores de 5 anos,clasificacion a y b,2003-07-01,99,15,99,15,114
30904,VINTO,estado nutricional en menores de 5 anos,clasificacion a y b,2003-07-01,60,12,60,12,72
50602,VITICHI,estado nutricional en menores de 5 anos,clasificacion a y b,2003-07-01,16,1,16,1,17
20306,WALDO BALLIVIAN,estado nutricional en menores de 5 anos,clasificacion a y b,2003-07-01,1,0,1,0,1
20903,YACO,estado nutricional en menores de 5 anos,clasificacion a y b,2003-07-01,10,5,10,5,15
60301,YACUIBA,estado nutricional en menores de 5 anos,clasificacion a y b,2003-07-01,130,22,130,22,152
10602,YAMPARAEZ,estado nutricional en menores de 5 anos,clasificacion a y b,2003-07-01,26,6,26,6,32
21103,YANACACHI,estado nutricional en menores de 5 anos,clasificacion a y b,2003-07-01,8,2,8,2,10
70403,YAPACANI,estado nutricional en menores de 5 anos,clasificacion a y b,2003-07-01,133,37,133,37,170
50103,YOCALLA,estado nutricional en menores de 5 anos,clasificacion a y b,2003-07-01,11,6,11,6,17
10102,YOTALA,estado nutricional en menores de 5 anos,clasificacion a y b,2003-07-01,28,25,28,25,53
60402,YUNCHARA,estado nutricional en menores de 5 anos,clasificacion a y b,2003-07-01,7,3,7,3,10
10301,ZUDAÃ‘EZ,estado nutricional en menores de 5 anos,clasificacion a y b,2003-07-01,16,1,16,1,17
51302,ACACIO,estado nutricional en menores de 5 anos,clasificacion a y b,2003-08-01,2,7,2,7,9
20201,ACHACACHI,estado nutricional en menores de 5 anos,clasificacion a y b,2003-08-01,70,35,70,35,105
20104,ACHOCALLA,estado nutricional en menores de 5 anos,clasificacion a y b,2003-08-01,4,2,4,2,6
30201,AIQUILE,estado nutricional en menores de 5 anos,clasificacion a y b,2003-08-01,30,4,30,4,34
31303,ALALAY,estado nutricional en menores de 5 anos,clasificacion a y b,2003-08-01,1,1,1,1,2
10404,ALCALA,estado nutricional en menores de 5 anos,clasificacion a y b,2003-08-01,9,1,9,1,10
20202,ANCORAIMES,estado nutricional en menores de 5 anos,clasificacion a y b,2003-08-01,11,0,11,0,11
41201,ANDAMARCA,estado nutricional en menores de 5 anos,clasificacion a y b,2003-08-01,1,0,1,0,1
30402,ANZALDO,estado nutricional en menores de 5 anos,clasificacion a y b,2003-08-01,8,7,8,7,15
20701,APOLO,estado nutricional en menores de 5 anos,clasificacion a y b,2003-08-01,29,5,29,5,34
51301,ARAMPAMPA,estado nutricional en menores de 5 anos,clasificacion a y b,2003-08-01,10,2,10,2,12
30501,ARANI,estado nutricional en menores de 5 anos,clasificacion a y b,2003-08-01,6,3,6,3,9
30403,ARBIETO,estado nutricional en menores de 5 anos,clasificacion a y b,2003-08-01,4,0,4,0,4
30601,ARQUE,estado nutricional en menores de 5 anos,clasificacion a y b,2003-08-01,2,0,2,0,2
71501,ASCENCION DE GUARAYOS,estado nutricional en menores de 5 anos,clasificacion a y b,2003-08-01,90,30,90,30,120
50802,ATOCHA,estado nutricional en menores de 5 anos,clasificacion a y b,2003-08-01,30,18,30,18,48
20503,AUCAPATA,estado nutricional en menores de 5 anos,clasificacion a y b,2003-08-01,7,1,7,1,8
20502,AYATA,estado nutricional en menores de 5 anos,clasificacion a y b,2003-08-01,11,1,11,1,12
21303,AYO AYO,estado nutricional en menores de 5 anos,clasificacion a y b,2003-08-01,17,0,17,0,17
30301,AYOPAYA (V. DE INDEPENDENCIA),estado nutricional en menores de 5 anos,clasificacion a y b,2003-08-01,25,3,25,3,28
10201,AZURDUY,estado nutricional en menores de 5 anos,clasificacion a y b,2003-08-01,30,10,30,10,40
21203,BATALLAS,estado nutricional en menores de 5 anos,clasificacion a y b,2003-08-01,20,5,20,5,25
80802,BAURES,estado nutricional en menores de 5 anos,clasificacion a y b,2003-08-01,11,2,11,2,13
41202,BELEN DE ANDAMARCA,estado nutricional en menores de 5 anos,clasificacion a y b,2003-08-01,0,2,0,2,2
50104,BELEN DE URMIRI,estado nutricional en menores de 5 anos,clasificacion a y b,2003-08-01,5,0,5,0,5
90104,BELLA FLOR,estado nutricional en menores de 5 anos,clasificacion a y b,2003-08-01,11,2,11,2,13
60202,BERMEJO,estado nutricional en menores de 5 anos,clasificacion a y b,2003-08-01,9,3,9,3,12
50301,BETANZOS,estado nutricional en menores de 5 anos,clasificacion a y b,2003-08-01,39,6,39,6,45
31501,BOLIVAR,estado nutricional en menores de 5 anos,clasificacion a y b,2003-08-01,4,0,4,0,4
90103,BOLPEBRA,estado nutricional en menores de 5 anos,clasificacion a y b,2003-08-01,2,0,2,0,2
70707,BOYUIBE,estado nutricional en menores de 5 anos,clasificacion a y b,2003-08-01,11,10,11,10,21
70401,BUENA VISTA,estado nutricional en menores de 5 anos,clasificacion a y b,2003-08-01,67,21,67,21,88
70703,CABEZAS,estado nutricional en menores de 5 anos,clasificacion a y b,2003-08-01,18,3,18,3,21
20905,CAIROMA,estado nutricional en menores de 5 anos,clasificacion a y b,2003-08-01,9,0,9,0,9
51102,"CAIZA ""D""",estado nutricional en menores de 5 anos,clasificacion a y b,2003-08-01,17,8,17,8,25
21003,CAJUATA,estado nutricional en menores de 5 anos,clasificacion a y b,2003-08-01,35,0,35,0,35
20303,CALACOTO,estado nutricional en menores de 5 anos,clasificacion a y b,2003-08-01,3,1,3,1,4
21304,CALAMARCA,estado nutricional en menores de 5 anos,clasificacion a y b,2003-08-01,9,0,9,0,9
10701,CAMARGO,estado nutricional en menores de 5 anos,clasificacion a y b,2003-08-01,20,1,20,1,21
10901,CAMATAQUI (C. VILLA ABECIA),estado nutricional en menores de 5 anos,clasificacion a y b,2003-08-01,7,2,7,2,9
70706,CAMIRI,estado nutricional en menores de 5 anos,clasificacion a y b,2003-08-01,152,51,152,51,203
30701,CAPINOTA,estado nutricional en menores de 5 anos,clasificacion a y b,2003-08-01,5,7,5,7,12
20302,CAQUIAVIRI,estado nutricional en menores de 5 anos,clasificacion a y b,2003-08-01,13,4,13,4,17
40102,CARACOLLO,estado nutricional en menores de 5 anos,clasificacion a y b,2003-08-01,13,7,13,7,20
22001,CARANAVI,estado nutricional en menores de 5 anos,clasificacion a y b,2003-08-01,94,13,94,13,107
60302,CARAPARI,estado nutricional en menores de 5 anos,clasificacion a y b,2003-08-01,31,1,31,1,32
50702,CARIPUYO,estado nutricional en menores de 5 anos,clasificacion a y b,2003-08-01,5,2,5,2,7
40201,CHALLAPATA,estado nutricional en menores de 5 anos,clasificacion a y b,2003-08-01,7,2,7,2,9
50302,CHAQUI,estado nutricional en menores de 5 anos,clasificacion a y b,2003-08-01,8,1,8,1,9
70702,CHARAGUA,estado nutricional en menores de 5 anos,clasificacion a y b,2003-08-01,132,50,132,50,182
20305,CHARAÃ‘A,estado nutricional en menores de 5 anos,clasificacion a y b,2003-08-01,1,0,1,0,1
50202,CHAYANTA,estado nutricional en menores de 5 anos,clasificacion a y b,2003-08-01,21,4,21,4,25
31204,CHIMORE,estado nutricional en menores de 5 anos,clasificacion a y b,2003-08-01,19,7,19,7,26
40302,CHOQUE COTA,estado nutricional en menores de 5 anos,clasificacion a y b,2003-08-01,2,0,2,0,2
21101,CHULUMANI (V. DE LA LIBERTAD),estado nutricional en menores de 5 anos,clasificacion a y b,2003-08-01,9,1,9,1,10
20501,CHUMA,estado nutricional en menores de 5 anos,clasificacion a y b,2003-08-01,13,3,13,3,16
30801,CLIZA,estado nutricional en menores de 5 anos,clasificacion a y b,2003-08-01,5,1,5,1,6
90101,COBIJA,estado nutricional en menores de 5 anos,clasificacion a y b,2003-08-01,90,12,90,12,102
30101,COCHABAMBA,estado nutricional en menores de 5 anos,clasificacion a y b,2003-08-01,1455,852,1455,852,2307
40902,COIPASA,estado nutricional en menores de 5 anos,clasificacion a y b,2003-08-01,2,0,2,0,2
30905,COLCAPIRHUA,estado nutricional en menores de 5 anos,clasificacion a y b,2003-08-01,45,10,45,10,55
50901,"COLCHA ""K""",estado nutricional en menores de 5 anos,clasificacion a y b,2003-08-01,22,3,22,3,25
21307,COLLANA,estado nutricional en menores de 5 anos,clasificacion a y b,2003-08-01,1,0,1,0,1
31002,COLOMI,estado nutricional en menores de 5 anos,clasificacion a y b,2003-08-01,31,10,31,10,41
50401,COLQUECHACA,estado nutricional en menores de 5 anos,clasificacion a y b,2003-08-01,23,7,23,7,30
21306,COLQUENCHA,estado nutricional en menores de 5 anos,clasificacion a y b,2003-08-01,12,1,12,1,13
21004,COLQUIRI,estado nutricional en menores de 5 anos,clasificacion a y b,2003-08-01,17,5,17,5,22
71301,COMARAPA,estado nutricional en menores de 5 anos,clasificacion a y b,2003-08-01,85,14,85,14,99
20605,COMBAYA,estado nutricional en menores de 5 anos,clasificacion a y b,2003-08-01,3,0,3,0,3
71101,CONCEPCION,estado nutricional en menores de 5 anos,clasificacion a y b,2003-08-01,18,50,18,50,68
21701,COPACABANA,estado nutricional en menores de 5 anos,clasificacion a y b,2003-08-01,18,4,18,4,22
21402,CORIPATA,estado nutricional en menores de 5 anos,clasificacion a y b,2003-08-01,25,2,25,2,27
20301,CORO CORO,estado nutricional en menores de 5 anos,clasificacion a y b,2003-08-01,4,1,4,1,5
21401,COROICO,estado nutricional en menores de 5 anos,clasificacion a y b,2003-08-01,15,9,15,9,24
40301,CORQUE,estado nutricional en menores de 5 anos,clasificacion a y b,2003-08-01,2,2,2,2,4
50601,COTAGAITA,estado nutricional en menores de 5 anos,clasificacion a y b,2003-08-01,55,5,55,5,60
31405,CUCHUMUELA (V. G. VILLARROEL),estado nutricional en menores de 5 anos,clasificacion a y b,2003-08-01,3,0,3,0,3
70704,CUEVO,estado nutricional en menores de 5 anos,clasificacion a y b,2003-08-01,3,0,3,0,3
10902,CULPINA,estado nutricional en menores de 5 anos,clasificacion a y b,2003-08-01,46,11,46,11,57
40401,CURAHUARA DE CARANGAS,estado nutricional en menores de 5 anos,clasificacion a y b,2003-08-01,3,0,3,0,3
21602,CURVA,estado nutricional en menores de 5 anos,clasificacion a y b,2003-08-01,2,0,2,0,2
20804,DESAGUADERO,estado nutricional en menores de 5 anos,clasificacion a y b,2003-08-01,6,2,6,2,8
20105,EL ALTO,estado nutricional en menores de 5 anos,clasificacion a y b,2003-08-01,780,280,780,280,1060
40103,EL CHORO,estado nutricional en menores de 5 anos,clasificacion a y b,2003-08-01,8,2,8,2,10
71503,EL PUENTE(STC),estado nutricional en menores de 5 anos,clasificacion a y b,2003-08-01,6,10,6,10,16
60502,EL PUENTE(TJA),estado nutricional en menores de 5 anos,clasificacion a y b,2003-08-01,13,3,13,3,16
70105,EL TORNO,estado nutricional en menores de 5 anos,clasificacion a y b,2003-08-01,160,13,160,13,173
10405,EL VILLAR,estado nutricional en menores de 5 anos,clasificacion a y b,2003-08-01,11,3,11,3,14
60601,ENTRE RIOS,estado nutricional en menores de 5 anos,clasificacion a y b,2003-08-01,51,19,51,19,70
41101,EUCALIPTUS,estado nutricional en menores de 5 anos,clasificacion a y b,2003-08-01,5,4,5,4,9
90503,EUREKA (SANTOS MERCADO),estado nutricional en menores de 5 anos,clasificacion a y b,2003-08-01,2,2,2,2,4
80402,EXALTACION,estado nutricional en menores de 5 anos,clasificacion a y b,2003-08-01,10,11,10,11,21
90203,FILADELFIA,estado nutricional en menores de 5 anos,clasificacion a y b,2003-08-01,3,3,3,3,6
71002,GENERAL SAAVEDRA,estado nutricional en menores de 5 anos,clasificacion a y b,2003-08-01,63,54,63,54,117
21601,GRAL. J.J. PEREZ (CHARAZANI),estado nutricional en menores de 5 anos,clasificacion a y b,2003-08-01,27,1,27,1,28
20602,GUANAY,estado nutricional en menores de 5 anos,clasificacion a y b,2003-08-01,118,22,118,22,140
20802,GUAQUI,estado nutricional en menores de 5 anos,clasificacion a y b,2003-08-01,4,0,4,0,4
80202,GUAYARAMERIN,estado nutricional en menores de 5 anos,clasificacion a y b,2003-08-01,124,17,124,17,141
70705,GUTIERREZ,estado nutricional en menores de 5 anos,clasificacion a y b,2003-08-01,88,32,88,32,120
10502,HUACARETA,estado nutricional en menores de 5 anos,clasificacion a y b,2003-08-01,36,33,36,33,69
11002,HUACAYA (VILLA DE HUACAYA),estado nutricional en menores de 5 anos,clasificacion a y b,2003-08-01,8,2,8,2,10
40501,HUACHACALLA,estado nutricional en menores de 5 anos,clasificacion a y b,2003-08-01,1,1,1,1,2
40701,HUANUNI,estado nutricional en menores de 5 anos,clasificacion a y b,2003-08-01,27,6,27,6,33
80803,HUARACAJE,estado nutricional en menores de 5 anos,clasificacion a y b,2003-08-01,16,13,16,13,29
41601,HUAYLLAMARCA,estado nutricional en menores de 5 anos,clasificacion a y b,2003-08-01,3,0,3,0,3
21005,ICHOCA,estado nutricional en menores de 5 anos,clasificacion a y b,2003-08-01,18,8,18,8,26
10304,ICLA,estado nutricional en menores de 5 anos,clasificacion a y b,2003-08-01,18,2,18,2,20
10703,INCAHUASI,estado nutricional en menores de 5 anos,clasificacion a y b,2003-08-01,19,4,19,4,23
21001,INQUISIVI,estado nutricional en menores de 5 anos,clasificacion a y b,2003-08-01,37,13,37,13,50
21102,IRUPANA (VILLA DE LANZA),estado nutricional en menores de 5 anos,clasificacion a y b,2003-08-01,29,38,29,38,67
21501,IXIAMAS,estado nutricional en menores de 5 anos,clasificacion a y b,2003-08-01,30,4,30,4,34
21105,LA ASUNTA,estado nutricional en menores de 5 anos,clasificacion a y b,2003-08-01,51,5,51,5,56
70104,LA GUARDIA,estado nutricional en menores de 5 anos,clasificacion a y b,2003-08-01,94,34,94,34,128
20101,LA PAZ,estado nutricional en menores de 5 anos,clasificacion a y b,2003-08-01,642,200,642,200,842
41501,LA RIVERA,estado nutricional en menores de 5 anos,clasificacion a y b,2003-08-01,0,1,0,1,1
70701,LAGUNILLAS,estado nutricional en menores de 5 anos,clasificacion a y b,2003-08-01,53,21,53,21,74
21202,LAJA,estado nutricional en menores de 5 anos,clasificacion a y b,2003-08-01,13,0,13,0,13
10903,LAS CARRERAS,estado nutricional en menores de 5 anos,clasificacion a y b,2003-08-01,14,12,14,12,26
21006,LICOMA PAMPA,estado nutricional en menores de 5 anos,clasificacion a y b,2003-08-01,13,8,13,8,21
50203,LLALLAGUA,estado nutricional en menores de 5 anos,clasificacion a y b,2003-08-01,15,115,15,115,130
51401,LLICA,estado nutricional en menores de 5 anos,clasificacion a y b,2003-08-01,5,1,5,1,6
80601,LORETO,estado nutricional en menores de 5 anos,clasificacion a y b,2003-08-01,11,6,11,6,17
20901,LURIBAY,estado nutricional en menores de 5 anos,clasificacion a y b,2003-08-01,8,1,8,1,9
40702,MACHACAMARCA,estado nutricional en menores de 5 anos,clasificacion a y b,2003-08-01,6,1,6,1,7
11003,MACHARETI,estado nutricional en menores de 5 anos,clasificacion a y b,2003-08-01,49,24,49,24,73
80801,MAGDALENA,estado nutricional en menores de 5 anos,clasificacion a y b,2003-08-01,17,1,17,1,18
70903,MAIRANA,estado nutricional en menores de 5 anos,clasificacion a y b,2003-08-01,44,5,44,5,49
20904,MALLA,estado nutricional en menores de 5 anos,clasificacion a y b,2003-08-01,0,2,0,2,2
20103,MECAPACA,estado nutricional en menores de 5 anos,clasificacion a y b,2003-08-01,2,0,2,0,2
71003,MINEROS,estado nutricional en menores de 5 anos,clasificacion a y b,2003-08-01,244,34,244,34,278
31301,MIZQUE,estado nutricional en menores de 5 anos,clasificacion a y b,2003-08-01,13,3,13,3,16
20402,MOCOMOCO,estado nutricional en menores de 5 anos,clasificacion a y b,2003-08-01,9,2,9,2,11
51002,MOJINETE,estado nutricional en menores de 5 anos,clasificacion a y b,2003-08-01,0,1,0,1,1
10303,MOJOCOYA,estado nutricional en menores de 5 anos,clasificacion a y b,2003-08-01,28,9,28,9,37
10501,MONTEAGUDO,estado nutricional en menores de 5 anos,clasificacion a y b,2003-08-01,107,35,107,35,142
71001,MONTERO,estado nutricional en menores de 5 anos,clasificacion a y b,2003-08-01,420,92,420,92,512
70803,MORO MORO,estado nutricional en menores de 5 anos,clasificacion a y b,2003-08-01,10,2,10,2,12
30302,MOROCHATA,estado nutricional en menores de 5 anos,clasificacion a y b,2003-08-01,30,3,30,3,33
50404,OCURI,estado nutricional en menores de 5 anos,clasificacion a y b,2003-08-01,6,3,6,3,9
30203,OMEREQUE,estado nutricional en menores de 5 anos,clasificacion a y b,2003-08-01,4,0,4,0,4
40101,ORURO,estado nutricional en menores de 5 anos,clasificacion a y b,2003-08-01,286,50,286,50,336
60201,PADCAYA,estado nutricional en menores de 5 anos,clasificacion a y b,2003-08-01,33,33,33,33,66
10401,PADILLA,estado nutricional en menores de 5 anos,clasificacion a y b,2003-08-01,52,12,52,12,64
70502,PAILON,estado nutricional en menores de 5 anos,clasificacion a y b,2003-08-01,16,4,16,4,20
20102,PALCA,estado nutricional en menores de 5 anos,clasificacion a y b,2003-08-01,10,6,10,6,16
21104,PALOS BLANCOS,estado nutricional en menores de 5 anos,clasificacion a y b,2003-08-01,51,8,51,8,59
40802,PAMPA AULLAGAS,estado nutricional en menores de 5 anos,clasificacion a y b,2003-08-01,3,1,3,1,4
70902,PAMPA GRANDE,estado nutricional en menores de 5 anos,clasificacion a y b,2003-08-01,8,0,8,0,8
21802,PAPEL PAMPA,estado nutricional en menores de 5 anos,clasificacion a y b,2003-08-01,3,1,3,1,4
30202,PASORAPA,estado nutricional en menores de 5 anos,clasificacion a y b,2003-08-01,7,3,7,3,10
21305,PATACAMAYA,estado nutricional en menores de 5 anos,clasificacion a y b,2003-08-01,56,4,56,4,60
40602,PAZÃ‘A,estado nutricional en menores de 5 anos,clasificacion a y b,2003-08-01,7,3,7,3,10
20702,PELECHUCO,estado nutricional en menores de 5 anos,clasificacion a y b,2003-08-01,3,0,3,0,3
50403,POCOATA,estado nutricional en menores de 5 anos,clasificacion a y b,2003-08-01,26,9,26,9,35
31203,POCONA,estado nutricional en menores de 5 anos,clasificacion a y b,2003-08-01,11,0,11,0,11
31202,POJO (CBBA),estado nutricional en menores de 5 anos,clasificacion a y b,2003-08-01,129,30,129,30,159
40601,POOPO,estado nutricional en menores de 5 anos,clasificacion a y b,2003-08-01,2,5,2,5,7
51203,PORCO,estado nutricional en menores de 5 anos,clasificacion a y b,2003-08-01,14,0,14,0,14
10103,POROMA,estado nutricional en menores de 5 anos,clasificacion a y b,2003-08-01,31,5,31,5,36
70103,PORONGO,estado nutricional en menores de 5 anos,clasificacion a y b,2003-08-01,11,2,11,2,13
70601,PORTACHUELO,estado nutricional en menores de 5 anos,clasificacion a y b,2003-08-01,156,35,156,35,191
90102,PORVENIR,estado nutricional en menores de 5 anos,clasificacion a y b,2003-08-01,7,1,7,1,8
70804,POSTRER VALLE,estado nutricional en menores de 5 anos,clasificacion a y b,2003-08-01,1,2,1,2,3
50101,POTOSI,estado nutricional en menores de 5 anos,clasificacion a y b,2003-08-01,136,15,136,15,151
10302,PRESTO,estado nutricional en menores de 5 anos,clasificacion a y b,2003-08-01,15,4,15,4,19
21201,PUCARANI,estado nutricional en menores de 5 anos,clasificacion a y b,2003-08-01,37,2,37,2,39
20401,PUERTO ACOSTA,estado nutricional en menores de 5 anos,clasificacion a y b,2003-08-01,32,18,32,18,50
20403,PUERTO CARABUCO,estado nutricional en menores de 5 anos,clasificacion a y b,2003-08-01,23,2,23,2,25
90301,PUERTO GONZALO MORENO,estado nutricional en menores de 5 anos,clasificacion a y b,2003-08-01,3,1,3,1,4
21204,PUERTO PEREZ,estado nutricional en menores de 5 anos,clasificacion a y b,2003-08-01,4,0,4,0,4
71402,PUERTO QUIJARRO,estado nutricional en menores de 5 anos,clasificacion a y b,2003-08-01,68,14,68,14,82
90201,PUERTO RICO,estado nutricional en menores de 5 anos,clasificacion a y b,2003-08-01,6,16,6,16,22
80703,PUERTO SILES,estado nutricional en menores de 5 anos,clasificacion a y b,2003-08-01,2,1,2,1,3
71401,PUERTO SUAREZ,estado nutricional en menores de 5 anos,clasificacion a y b,2003-08-01,66,14,66,14,80
31205,PUERTO VILLARROEL,estado nutricional en menores de 5 anos,clasificacion a y b,2003-08-01,131,33,131,33,164
51101,PUNA,estado nutricional en menores de 5 anos,clasificacion a y b,2003-08-01,2,0,2,0,2
31401,PUNATA,estado nutricional en menores de 5 anos,clasificacion a y b,2003-08-01,8,3,8,3,11
20604,QUIABAYA,estado nutricional en menores de 5 anos,clasificacion a y b,2003-08-01,6,0,6,0,6
30901,QUILLACOLLO,estado nutricional en menores de 5 anos,clasificacion a y b,2003-08-01,59,27,59,27,86
21002,QUIME,estado nutricional en menores de 5 anos,clasificacion a y b,2003-08-01,18,1,18,1,19
70904,QUIRUSILLAS,estado nutricional en menores de 5 anos,clasificacion a y b,2003-08-01,8,1,8,1,9
50402,RAVELO,estado nutricional en menores de 5 anos,clasificacion a y b,2003-08-01,8,2,8,2,10
80301,REYES,estado nutricional en menores de 5 anos,clasificacion a y b,2003-08-01,30,1,30,1,31
80201,RIBERALTA,estado nutricional en menores de 5 anos,clasificacion a y b,2003-08-01,133,20,133,20,153
70503,ROBORE,estado nutricional en menores de 5 anos,clasificacion a y b,2003-08-01,48,24,48,24,72
80304,RURRENABAQUE,estado nutricional en menores de 5 anos,clasificacion a y b,2003-08-01,19,2,19,2,21
40901,SABAYA,estado nutricional en menores de 5 anos,clasificacion a y b,2003-08-01,3,0,3,0,3
31001,SACABA,estado nutricional en menores de 5 anos,clasificacion a y b,2003-08-01,57,40,57,40,97
30404,SACABAMBA,estado nutricional en menores de 5 anos,clasificacion a y b,2003-08-01,1,1,1,1,2
50701,SACACA,estado nutricional en menores de 5 anos,clasificacion a y b,2003-08-01,4,2,4,2,6
71302,SAIPINA,estado nutricional en menores de 5 anos,clasificacion a y b,2003-08-01,71,36,71,36,107
40801,SALINAS DE GARCI MENDOZA,estado nutricional en menores de 5 anos,clasificacion a y b,2003-08-01,5,0,5,0,5
70901,SAMAIPATA,estado nutricional en menores de 5 anos,clasificacion a y b,2003-08-01,41,6,41,6,47
51601,SAN AGUSTIN,estado nutricional en menores de 5 anos,clasificacion a y b,2003-08-01,2,2,2,2,4
80602,SAN ANDRES,estado nutricional en menores de 5 anos,clasificacion a y b,2003-08-01,3,0,3,0,3
51003,SAN ANTONIO DE ESMORUCO,estado nutricional en menores de 5 anos,clasificacion a y b,2003-08-01,2,0,2,0,2
71105,SAN ANTONIO DE LOMERIO,estado nutricional en menores de 5 anos,clasificacion a y b,2003-08-01,20,9,20,9,29
31403,SAN BENITO,estado nutricional en menores de 5 anos,clasificacion a y b,2003-08-01,13,1,13,1,14
80302,SAN BORJA,estado nutricional en menores de 5 anos,clasificacion a y b,2003-08-01,68,15,68,15,83
21502,SAN BUENA VENTURA,estado nutricional en menores de 5 anos,clasificacion a y b,2003-08-01,20,4,20,4,24
70402,SAN CARLOS,estado nutricional en menores de 5 anos,clasificacion a y b,2003-08-01,141,8,141,8,149
80501,SAN IGNACIO,estado nutricional en menores de 5 anos,clasificacion a y b,2003-08-01,74,24,74,24,98
70301,SAN IGNACIO DE VELASCO,estado nutricional en menores de 5 anos,clasificacion a y b,2003-08-01,199,13,199,13,212
80102,SAN JAVIER(BNI),estado nutricional en menores de 5 anos,clasificacion a y b,2003-08-01,4,1,4,1,5
71102,SAN JAVIER(STC),estado nutricional en menores de 5 anos,clasificacion a y b,2003-08-01,33,11,33,11,44
80701,SAN JOAQUIN,estado nutricional en menores de 5 anos,clasificacion a y b,2003-08-01,12,9,12,9,21
70501,SAN JOSE DE CHIQUITOS,estado nutricional en menores de 5 anos,clasificacion a y b,2003-08-01,24,0,24,0,24
71104,SAN JULIAN,estado nutricional en menores de 5 anos,clasificacion a y b,2003-08-01,179,50,179,50,229
90302,SAN LORENZO(PND),estado nutricional en menores de 5 anos,clasificacion a y b,2003-08-01,2,2,2,2,4
60501,SAN LORENZO(TJA),estado nutricional en menores de 5 anos,clasificacion a y b,2003-08-01,60,41,60,41,101
10702,SAN LUCAS,estado nutricional en menores de 5 anos,clasificacion a y b,2003-08-01,35,3,35,3,38
71201,SAN MATIAS,estado nutricional en menores de 5 anos,clasificacion a y b,2003-08-01,27,16,27,16,43
70302,SAN MIGUEL DE VELASCO,estado nutricional en menores de 5 anos,clasificacion a y b,2003-08-01,38,7,38,7,45
51001,SAN PABLO DE LIPEZ,estado nutricional en menores de 5 anos,clasificacion a y b,2003-08-01,4,0,4,0,4
50501,SAN PEDRO DE BUENA VISTA,estado nutricional en menores de 5 anos,clasificacion a y b,2003-08-01,13,10,13,10,23
21801,SAN PEDRO DE CURAHUARA,estado nutricional en menores de 5 anos,clasificacion a y b,2003-08-01,3,1,3,1,4
50902,SAN PEDRO DE QUEMES,estado nutricional en menores de 5 anos,clasificacion a y b,2003-08-01,3,2,3,2,5
21702,SAN PEDRO DE TIQUINA,estado nutricional en menores de 5 anos,clasificacion a y b,2003-08-01,7,0,7,0,7
70303,SAN RAFAEL,estado nutricional en menores de 5 anos,clasificacion a y b,2003-08-01,14,2,14,2,16
80702,SAN RAMON,estado nutricional en menores de 5 anos,clasificacion a y b,2003-08-01,8,4,8,4,12
80401,SANTA ANA,estado nutricional en menores de 5 anos,clasificacion a y b,2003-08-01,85,30,85,30,115
70101,SANTA CRUZ DE LA SIERRA,estado nutricional en menores de 5 anos,clasificacion a y b,2003-08-01,1727,697,1727,697,2424
80303,SANTA ROSA,estado nutricional en menores de 5 anos,clasificacion a y b,2003-08-01,23,14,23,14,37
70602,SANTA ROSA DEL SARA,estado nutricional en menores de 5 anos,clasificacion a y b,2003-08-01,29,19,29,19,48
20308,SANTIAGO DE CALLAPA,estado nutricional en menores de 5 anos,clasificacion a y b,2003-08-01,8,2,8,2,10
41401,SANTIAGO DE HUARI,estado nutricional en menores de 5 anos,clasificacion a y b,2003-08-01,7,1,7,1,8
21901,SANTIAGO DE MACHACA,estado nutricional en menores de 5 anos,clasificacion a y b,2003-08-01,5,1,5,1,6
30702,SANTIVAÃ‘ES,estado nutricional en menores de 5 anos,clasificacion a y b,2003-08-01,6,0,6,0,6
40202,SANTUARIO DE QUILLACAS,estado nutricional en menores de 5 anos,clasificacion a y b,2003-08-01,1,0,1,0,1
20902,SAPAHAQUI,estado nutricional en menores de 5 anos,clasificacion a y b,2003-08-01,13,1,13,1,14
90303,SENA,estado nutricional en menores de 5 anos,clasificacion a y b,2003-08-01,16,23,16,23,39
21301,SICA SICA (VILLA AROMA),estado nutricional en menores de 5 anos,clasificacion a y b,2003-08-01,13,15,13,15,28
30703,SICAYA,estado nutricional en menores de 5 anos,clasificacion a y b,2003-08-01,3,1,3,1,4
30902,SIPE SIPE,estado nutricional en menores de 5 anos,clasificacion a y b,2003-08-01,108,16,108,16,124
10403,SOPACHUY,estado nutricional en menores de 5 anos,clasificacion a y b,2003-08-01,10,3,10,3,13
20601,SORATA,estado nutricional en menores de 5 anos,clasificacion a y b,2003-08-01,21,6,21,6,27
10101,SUCRE,estado nutricional en menores de 5 anos,clasificacion a y b,2003-08-01,329,65,329,65,394
31404,TACACHI,estado nutricional en menores de 5 anos,clasificacion a y b,2003-08-01,1,0,1,0,1
20603,TACACOMA,estado nutricional en menores de 5 anos,clasificacion a y b,2003-08-01,12,7,12,7,19
50303,TACOBAMBA,estado nutricional en menores de 5 anos,clasificacion a y b,2003-08-01,23,6,23,6,29
30602,TACOPAYA,estado nutricional en menores de 5 anos,clasificacion a y b,2003-08-01,13,3,13,3,16
51402,TAHUA,estado nutricional en menores de 5 anos,clasificacion a y b,2003-08-01,1,0,1,0,1
31101,TAPACARI,estado nutricional en menores de 5 anos,clasificacion a y b,2003-08-01,23,0,23,0,23
10601,TARABUCO,estado nutricional en menores de 5 anos,clasificacion a y b,2003-08-01,26,10,26,10,36
30401,TARATA,estado nutricional en menores de 5 anos,clasificacion a y b,2003-08-01,8,6,8,6,14
60101,TARIJA,estado nutricional en menores de 5 anos,clasificacion a y b,2003-08-01,588,202,588,202,790
10202,TARVITA,estado nutricional en menores de 5 anos,clasificacion a y b,2003-08-01,23,7,23,7,30
20803,TIAWANACU,estado nutricional en menores de 5 anos,clasificacion a y b,2003-08-01,11,3,11,3,14
50102,TINGUIPAYA,estado nutricional en menores de 5 anos,clasificacion a y b,2003-08-01,25,3,25,3,28
20606,TIPUANI,estado nutricional en menores de 5 anos,clasificacion a y b,2003-08-01,29,10,29,10,39
30903,TIQUIPAYA,estado nutricional en menores de 5 anos,clasificacion a y b,2003-08-01,18,8,18,8,26
31601,TIRAQUE (CBBA),estado nutricional en menores de 5 anos,clasificacion a y b,2003-08-01,108,20,108,20,128
21703,TITO YUPANQUI (PARQUIPUJIO),estado nutricional en menores de 5 anos,clasificacion a y b,2003-08-01,1,1,1,1,2
30802,TOCO,estado nutricional en menores de 5 anos,clasificacion a y b,2003-08-01,0,3,0,3,3
30803,TOLATA,estado nutricional en menores de 5 anos,clasificacion a y b,2003-08-01,12,5,12,5,17
41001,TOLEDO,estado nutricional en menores de 5 anos,clasificacion a y b,2003-08-01,4,1,4,1,5
51202,TOMAVE,estado nutricional en menores de 5 anos,clasificacion a y b,2003-08-01,9,12,9,12,21
10402,TOMINA,estado nutricional en menores de 5 anos,clasificacion a y b,2003-08-01,21,4,21,4,25
50502,TORO TORO,estado nutricional en menores de 5 anos,clasificacion a y b,2003-08-01,28,6,28,6,34
31201,TOTORA(CBBA),estado nutricional en menores de 5 anos,clasificacion a y b,2003-08-01,28,5,28,5,33
41301,TOTORA(ORR),estado nutricional en menores de 5 anos,clasificacion a y b,2003-08-01,1,1,1,1,2
70802,TRIGAL,estado nutricional en menores de 5 anos,clasificacion a y b,2003-08-01,3,0,3,0,3
80101,TRINIDAD,estado nutricional en menores de 5 anos,clasificacion a y b,2003-08-01,199,63,199,63,262
50801,TUPIZA,estado nutricional en menores de 5 anos,clasificacion a y b,2003-08-01,54,57,54,57,111
40402,TURCO,estado nutricional en menores de 5 anos,clasificacion a y b,2003-08-01,1,1,1,1,2
21302,UMALA,estado nutricional en menores de 5 anos,clasificacion a y b,2003-08-01,13,34,13,34,47
50201,UNCIA,estado nutricional en menores de 5 anos,clasificacion a y b,2003-08-01,3,0,3,0,3
60401,URIONDO (A. CONCEPCION),estado nutricional en menores de 5 anos,clasificacion a y b,2003-08-01,63,20,63,20,83
71502,URUBICHA,estado nutricional en menores de 5 anos,clasificacion a y b,2003-08-01,10,12,10,12,22
51201,UYUNI,estado nutricional en menores de 5 anos,clasificacion a y b,2003-08-01,53,6,53,6,59
30502,VACAS,estado nutricional en menores de 5 anos,clasificacion a y b,2003-08-01,1,0,1,0,1
70801,VALLEGRANDE,estado nutricional en menores de 5 anos,clasificacion a y b,2003-08-01,2,1,2,1,3
20801,VIACHA,estado nutricional en menores de 5 anos,clasificacion a y b,2003-08-01,72,11,72,11,83
31302,VILA VILA,estado nutricional en menores de 5 anos,clasificacion a y b,2003-08-01,4,0,4,0,4
60303,VILLA MONTES,estado nutricional en menores de 5 anos,clasificacion a y b,2003-08-01,61,11,61,11,72
31402,VILLA RIVERO,estado nutricional en menores de 5 anos,clasificacion a y b,2003-08-01,15,2,15,2,17
10801,VILLA SERRANO,estado nutricional en menores de 5 anos,clasificacion a y b,2003-08-01,20,6,20,6,26
31003,VILLA TUNARI,estado nutricional en menores de 5 anos,clasificacion a y b,2003-08-01,64,22,64,22,86
11001,VILLA VACA GUZMAN (MUYUPAMPA),estado nutricional en menores de 5 anos,clasificacion a y b,2003-08-01,46,8,46,8,54
51501,VILLAZON,estado nutricional en menores de 5 anos,clasificacion a y b,2003-08-01,95,12,95,12,107
30904,VINTO,estado nutricional en menores de 5 anos,clasificacion a y b,2003-08-01,51,4,51,4,55
50602,VITICHI,estado nutricional en menores de 5 anos,clasificacion a y b,2003-08-01,17,15,17,15,32
20903,YACO,estado nutricional en menores de 5 anos,clasificacion a y b,2003-08-01,8,2,8,2,10
60301,YACUIBA,estado nutricional en menores de 5 anos,clasificacion a y b,2003-08-01,187,29,187,29,216
10602,YAMPARAEZ,estado nutricional en menores de 5 anos,clasificacion a y b,2003-08-01,31,4,31,4,35
21103,YANACACHI,estado nutricional en menores de 5 anos,clasificacion a y b,2003-08-01,9,0,9,0,9
70403,YAPACANI,estado nutricional en menores de 5 anos,clasificacion a y b,2003-08-01,138,26,138,26,164
50103,YOCALLA,estado nutricional en menores de 5 anos,clasificacion a y b,2003-08-01,3,1,3,1,4
10102,YOTALA,estado nutricional en menores de 5 anos,clasificacion a y b,2003-08-01,28,14,28,14,42
60402,YUNCHARA,estado nutricional en menores de 5 anos,clasificacion a y b,2003-08-01,17,22,17,22,39
10301,ZUDAÃ‘EZ,estado nutricional en menores de 5 anos,clasificacion a y b,2003-08-01,19,9,19,9,28
51302,ACACIO,estado nutricional en menores de 5 anos,clasificacion a y b,2003-09-01,3,0,3,0,3
20201,ACHACACHI,estado nutricional en menores de 5 anos,clasificacion a y b,2003-09-01,81,46,81,46,127
20104,ACHOCALLA,estado nutricional en menores de 5 anos,clasificacion a y b,2003-09-01,8,0,8,0,8
30201,AIQUILE,estado nutricional en menores de 5 anos,clasificacion a y b,2003-09-01,29,5,29,5,34
10404,ALCALA,estado nutricional en menores de 5 anos,clasificacion a y b,2003-09-01,7,4,7,4,11
20202,ANCORAIMES,estado nutricional en menores de 5 anos,clasificacion a y b,2003-09-01,13,2,13,2,15
41201,ANDAMARCA,estado nutricional en menores de 5 anos,clasificacion a y b,2003-09-01,3,2,3,2,5
30402,ANZALDO,estado nutricional en menores de 5 anos,clasificacion a y b,2003-09-01,8,8,8,8,16
20701,APOLO,estado nutricional en menores de 5 anos,clasificacion a y b,2003-09-01,25,1,25,1,26
51301,ARAMPAMPA,estado nutricional en menores de 5 anos,clasificacion a y b,2003-09-01,7,4,7,4,11
30501,ARANI,estado nutricional en menores de 5 anos,clasificacion a y b,2003-09-01,2,5,2,5,7
30403,ARBIETO,estado nutricional en menores de 5 anos,clasificacion a y b,2003-09-01,4,0,4,0,4
30601,ARQUE,estado nutricional en menores de 5 anos,clasificacion a y b,2003-09-01,4,0,4,0,4
71501,ASCENCION DE GUARAYOS,estado nutricional en menores de 5 anos,clasificacion a y b,2003-09-01,2,0,2,0,2
50802,ATOCHA,estado nutricional en menores de 5 anos,clasificacion a y b,2003-09-01,11,23,11,23,34
20503,AUCAPATA,estado nutricional en menores de 5 anos,clasificacion a y b,2003-09-01,8,3,8,3,11
21303,AYO AYO,estado nutricional en menores de 5 anos,clasificacion a y b,2003-09-01,14,0,14,0,14
30301,AYOPAYA (V. DE INDEPENDENCIA),estado nutricional en menores de 5 anos,clasificacion a y b,2003-09-01,19,5,19,5,24
10201,AZURDUY,estado nutricional en menores de 5 anos,clasificacion a y b,2003-09-01,29,7,29,7,36
21203,BATALLAS,estado nutricional en menores de 5 anos,clasificacion a y b,2003-09-01,22,2,22,2,24
80802,BAURES,estado nutricional en menores de 5 anos,clasificacion a y b,2003-09-01,23,8,23,8,31
41202,BELEN DE ANDAMARCA,estado nutricional en menores de 5 anos,clasificacion a y b,2003-09-01,1,0,1,0,1
50104,BELEN DE URMIRI,estado nutricional en menores de 5 anos,clasificacion a y b,2003-09-01,3,2,3,2,5
90104,BELLA FLOR,estado nutricional en menores de 5 anos,clasificacion a y b,2003-09-01,10,6,10,6,16
60202,BERMEJO,estado nutricional en menores de 5 anos,clasificacion a y b,2003-09-01,17,17,17,17,34
50301,BETANZOS,estado nutricional en menores de 5 anos,clasificacion a y b,2003-09-01,47,2,47,2,49
31501,BOLIVAR,estado nutricional en menores de 5 anos,clasificacion a y b,2003-09-01,7,1,7,1,8
90103,BOLPEBRA,estado nutricional en menores de 5 anos,clasificacion a y b,2003-09-01,2,1,2,1,3
70707,BOYUIBE,estado nutricional en menores de 5 anos,clasificacion a y b,2003-09-01,12,6,12,6,18
70401,BUENA VISTA,estado nutricional en menores de 5 anos,clasificacion a y b,2003-09-01,83,46,83,46,129
70703,CABEZAS,estado nutricional en menores de 5 anos,clasificacion a y b,2003-09-01,4,0,4,0,4
20905,CAIROMA,estado nutricional en menores de 5 anos,clasificacion a y b,2003-09-01,5,0,5,0,5
51102,"CAIZA ""D""",estado nutricional en menores de 5 anos,clasificacion a y b,2003-09-01,14,4,14,4,18
21003,CAJUATA,estado nutricional en menores de 5 anos,clasificacion a y b,2003-09-01,34,1,34,1,35
20303,CALACOTO,estado nutricional en menores de 5 anos,clasificacion a y b,2003-09-01,2,1,2,1,3
21304,CALAMARCA,estado nutricional en menores de 5 anos,clasificacion a y b,2003-09-01,5,4,5,4,9
10701,CAMARGO,estado nutricional en menores de 5 anos,clasificacion a y b,2003-09-01,26,5,26,5,31
10901,CAMATAQUI (C. VILLA ABECIA),estado nutricional en menores de 5 anos,clasificacion a y b,2003-09-01,4,1,4,1,5
70706,CAMIRI,estado nutricional en menores de 5 anos,clasificacion a y b,2003-09-01,177,45,177,45,222
30701,CAPINOTA,estado nutricional en menores de 5 anos,clasificacion a y b,2003-09-01,12,1,12,1,13
20302,CAQUIAVIRI,estado nutricional en menores de 5 anos,clasificacion a y b,2003-09-01,9,4,9,4,13
40102,CARACOLLO,estado nutricional en menores de 5 anos,clasificacion a y b,2003-09-01,13,5,13,5,18
22001,CARANAVI,estado nutricional en menores de 5 anos,clasificacion a y b,2003-09-01,107,15,107,15,122
60302,CARAPARI,estado nutricional en menores de 5 anos,clasificacion a y b,2003-09-01,24,14,24,14,38
50702,CARIPUYO,estado nutricional en menores de 5 anos,clasificacion a y b,2003-09-01,4,3,4,3,7
40201,CHALLAPATA,estado nutricional en menores de 5 anos,clasificacion a y b,2003-09-01,17,5,17,5,22
50302,CHAQUI,estado nutricional en menores de 5 anos,clasificacion a y b,2003-09-01,13,1,13,1,14
70702,CHARAGUA,estado nutricional en menores de 5 anos,clasificacion a y b,2003-09-01,83,35,83,35,118
50202,CHAYANTA,estado nutricional en menores de 5 anos,clasificacion a y b,2003-09-01,28,11,28,11,39
31204,CHIMORE,estado nutricional en menores de 5 anos,clasificacion a y b,2003-09-01,26,8,26,8,34
40903,CHIPAYA,estado nutricional en menores de 5 anos,clasificacion a y b,2003-09-01,1,1,1,1,2
21101,CHULUMANI (V. DE LA LIBERTAD),estado nutricional en menores de 5 anos,clasificacion a y b,2003-09-01,5,0,5,0,5
20501,CHUMA,estado nutricional en menores de 5 anos,clasificacion a y b,2003-09-01,7,4,7,4,11
30801,CLIZA,estado nutricional en menores de 5 anos,clasificacion a y b,2003-09-01,4,1,4,1,5
90101,COBIJA,estado nutricional en menores de 5 anos,clasificacion a y b,2003-09-01,160,39,160,39,199
30101,COCHABAMBA,estado nutricional en menores de 5 anos,clasificacion a y b,2003-09-01,497,96,497,96,593
40902,COIPASA,estado nutricional en menores de 5 anos,clasificacion a y b,2003-09-01,1,0,1,0,1
30905,COLCAPIRHUA,estado nutricional en menores de 5 anos,clasificacion a y b,2003-09-01,44,7,44,7,51
50901,"COLCHA ""K""",estado nutricional en menores de 5 anos,clasificacion a y b,2003-09-01,12,2,12,2,14
21307,COLLANA,estado nutricional en menores de 5 anos,clasificacion a y b,2003-09-01,3,0,3,0,3
31002,COLOMI,estado nutricional en menores de 5 anos,clasificacion a y b,2003-09-01,26,9,26,9,35
50401,COLQUECHACA,estado nutricional en menores de 5 anos,clasificacion a y b,2003-09-01,42,12,42,12,54
21306,COLQUENCHA,estado nutricional en menores de 5 anos,clasificacion a y b,2003-09-01,21,4,21,4,25
21004,COLQUIRI,estado nutricional en menores de 5 anos,clasificacion a y b,2003-09-01,7,0,7,0,7
71301,COMARAPA,estado nutricional en menores de 5 anos,clasificacion a y b,2003-09-01,75,22,75,22,97
20605,COMBAYA,estado nutricional en menores de 5 anos,clasificacion a y b,2003-09-01,4,0,4,0,4
71101,CONCEPCION,estado nutricional en menores de 5 anos,clasificacion a y b,2003-09-01,10,11,10,11,21
21701,COPACABANA,estado nutricional en menores de 5 anos,clasificacion a y b,2003-09-01,12,14,12,14,26
21402,CORIPATA,estado nutricional en menores de 5 anos,clasificacion a y b,2003-09-01,29,1,29,1,30
20301,CORO CORO,estado nutricional en menores de 5 anos,clasificacion a y b,2003-09-01,11,15,11,15,26
21401,COROICO,estado nutricional en menores de 5 anos,clasificacion a y b,2003-09-01,18,5,18,5,23
40301,CORQUE,estado nutricional en menores de 5 anos,clasificacion a y b,2003-09-01,8,5,8,5,13
50601,COTAGAITA,estado nutricional en menores de 5 anos,clasificacion a y b,2003-09-01,32,16,32,16,48
70704,CUEVO,estado nutricional en menores de 5 anos,clasificacion a y b,2003-09-01,3,2,3,2,5
10902,CULPINA,estado nutricional en menores de 5 anos,clasificacion a y b,2003-09-01,45,4,45,4,49
40401,CURAHUARA DE CARANGAS,estado nutricional en menores de 5 anos,clasificacion a y b,2003-09-01,3,2,3,2,5
21602,CURVA,estado nutricional en menores de 5 anos,clasificacion a y b,2003-09-01,1,0,1,0,1
20804,DESAGUADERO,estado nutricional en menores de 5 anos,clasificacion a y b,2003-09-01,6,0,6,0,6
20105,EL ALTO,estado nutricional en menores de 5 anos,clasificacion a y b,2003-09-01,652,191,652,191,843
40103,EL CHORO,estado nutricional en menores de 5 anos,clasificacion a y b,2003-09-01,7,0,7,0,7
71503,EL PUENTE(STC),estado nutricional en menores de 5 anos,clasificacion a y b,2003-09-01,26,18,26,18,44
60502,EL PUENTE(TJA),estado nutricional en menores de 5 anos,clasificacion a y b,2003-09-01,15,5,15,5,20
70105,EL TORNO,estado nutricional en menores de 5 anos,clasificacion a y b,2003-09-01,134,21,134,21,155
10405,EL VILLAR,estado nutricional en menores de 5 anos,clasificacion a y b,2003-09-01,12,3,12,3,15
60601,ENTRE RIOS,estado nutricional en menores de 5 anos,clasificacion a y b,2003-09-01,67,20,67,20,87
41101,EUCALIPTUS,estado nutricional en menores de 5 anos,clasificacion a y b,2003-09-01,4,0,4,0,4
90503,EUREKA (SANTOS MERCADO),estado nutricional en menores de 5 anos,clasificacion a y b,2003-09-01,2,0,2,0,2
80402,EXALTACION,estado nutricional en menores de 5 anos,clasificacion a y b,2003-09-01,3,0,3,0,3
90203,FILADELFIA,estado nutricional en menores de 5 anos,clasificacion a y b,2003-09-01,2,2,2,2,4
71002,GENERAL SAAVEDRA,estado nutricional en menores de 5 anos,clasificacion a y b,2003-09-01,81,51,81,51,132
21601,GRAL. J.J. PEREZ (CHARAZANI),estado nutricional en menores de 5 anos,clasificacion a y b,2003-09-01,18,2,18,2,20
20602,GUANAY,estado nutricional en menores de 5 anos,clasificacion a y b,2003-09-01,82,25,82,25,107
20802,GUAQUI,estado nutricional en menores de 5 anos,clasificacion a y b,2003-09-01,5,0,5,0,5
80202,GUAYARAMERIN,estado nutricional en menores de 5 anos,clasificacion a y b,2003-09-01,142,31,142,31,173
70705,GUTIERREZ,estado nutricional en menores de 5 anos,clasificacion a y b,2003-09-01,62,8,62,8,70
10502,HUACARETA,estado nutricional en menores de 5 anos,clasificacion a y b,2003-09-01,31,28,31,28,59
11002,HUACAYA (VILLA DE HUACAYA),estado nutricional en menores de 5 anos,clasificacion a y b,2003-09-01,5,3,5,3,8
40501,HUACHACALLA,estado nutricional en menores de 5 anos,clasificacion a y b,2003-09-01,2,4,2,4,6
40701,HUANUNI,estado nutricional en menores de 5 anos,clasificacion a y b,2003-09-01,24,2,24,2,26
80803,HUARACAJE,estado nutricional en menores de 5 anos,clasificacion a y b,2003-09-01,5,4,5,4,9
41601,HUAYLLAMARCA,estado nutricional en menores de 5 anos,clasificacion a y b,2003-09-01,1,0,1,0,1
21005,ICHOCA,estado nutricional en menores de 5 anos,clasificacion a y b,2003-09-01,11,7,11,7,18
10304,ICLA,estado nutricional en menores de 5 anos,clasificacion a y b,2003-09-01,19,3,19,3,22
10703,INCAHUASI,estado nutricional en menores de 5 anos,clasificacion a y b,2003-09-01,34,9,34,9,43
90402,INGAVI (HUMAITA),estado nutricional en menores de 5 anos,clasificacion a y b,2003-09-01,5,5,5,5,10
21001,INQUISIVI,estado nutricional en menores de 5 anos,clasificacion a y b,2003-09-01,38,12,38,12,50
21102,IRUPANA (VILLA DE LANZA),estado nutricional en menores de 5 anos,clasificacion a y b,2003-09-01,18,22,18,22,40
21501,IXIAMAS,estado nutricional en menores de 5 anos,clasificacion a y b,2003-09-01,18,1,18,1,19
21105,LA ASUNTA,estado nutricional en menores de 5 anos,clasificacion a y b,2003-09-01,83,4,83,4,87
70104,LA GUARDIA,estado nutricional en menores de 5 anos,clasificacion a y b,2003-09-01,81,27,81,27,108
20101,LA PAZ,estado nutricional en menores de 5 anos,clasificacion a y b,2003-09-01,624,177,624,177,801
41501,LA RIVERA,estado nutricional en menores de 5 anos,clasificacion a y b,2003-09-01,1,0,1,0,1
70701,LAGUNILLAS,estado nutricional en menores de 5 anos,clasificacion a y b,2003-09-01,30,9,30,9,39
21202,LAJA,estado nutricional en menores de 5 anos,clasificacion a y b,2003-09-01,18,2,18,2,20
10903,LAS CARRERAS,estado nutricional en menores de 5 anos,clasificacion a y b,2003-09-01,12,6,12,6,18
21006,LICOMA PAMPA,estado nutricional en menores de 5 anos,clasificacion a y b,2003-09-01,1,1,1,1,2
50203,LLALLAGUA,estado nutricional en menores de 5 anos,clasificacion a y b,2003-09-01,38,45,38,45,83
51401,LLICA,estado nutricional en menores de 5 anos,clasificacion a y b,2003-09-01,2,1,2,1,3
80601,LORETO,estado nutricional en menores de 5 anos,clasificacion a y b,2003-09-01,8,7,8,7,15
20901,LURIBAY,estado nutricional en menores de 5 anos,clasificacion a y b,2003-09-01,13,1,13,1,14
40702,MACHACAMARCA,estado nutricional en menores de 5 anos,clasificacion a y b,2003-09-01,12,4,12,4,16
11003,MACHARETI,estado nutricional en menores de 5 anos,clasificacion a y b,2003-09-01,43,31,43,31,74
80801,MAGDALENA,estado nutricional en menores de 5 anos,clasificacion a y b,2003-09-01,16,7,16,7,23
70903,MAIRANA,estado nutricional en menores de 5 anos,clasificacion a y b,2003-09-01,43,10,43,10,53
20103,MECAPACA,estado nutricional en menores de 5 anos,clasificacion a y b,2003-09-01,15,11,15,11,26
71003,MINEROS,estado nutricional en menores de 5 anos,clasificacion a y b,2003-09-01,238,54,238,54,292
31301,MIZQUE,estado nutricional en menores de 5 anos,clasificacion a y b,2003-09-01,15,1,15,1,16
20402,MOCOMOCO,estado nutricional en menores de 5 anos,clasificacion a y b,2003-09-01,7,2,7,2,9
10303,MOJOCOYA,estado nutricional en menores de 5 anos,clasificacion a y b,2003-09-01,24,9,24,9,33
10501,MONTEAGUDO,estado nutricional en menores de 5 anos,clasificacion a y b,2003-09-01,86,26,86,26,112
71001,MONTERO,estado nutricional en menores de 5 anos,clasificacion a y b,2003-09-01,414,92,414,92,506
70803,MORO MORO,estado nutricional en menores de 5 anos,clasificacion a y b,2003-09-01,6,0,6,0,6
30302,MOROCHATA,estado nutricional en menores de 5 anos,clasificacion a y b,2003-09-01,23,19,23,19,42
20307,NAZACARA DE PACAJES,estado nutricional en menores de 5 anos,clasificacion a y b,2003-09-01,1,0,1,0,1
90501,NUEVO MANOA (NUEVA ESPERANZA),estado nutricional en menores de 5 anos,clasificacion a y b,2003-09-01,2,0,2,0,2
50404,OCURI,estado nutricional en menores de 5 anos,clasificacion a y b,2003-09-01,11,4,11,4,15
30203,OMEREQUE,estado nutricional en menores de 5 anos,clasificacion a y b,2003-09-01,9,3,9,3,12
40101,ORURO,estado nutricional en menores de 5 anos,clasificacion a y b,2003-09-01,308,65,308,65,373
60201,PADCAYA,estado nutricional en menores de 5 anos,clasificacion a y b,2003-09-01,31,24,31,24,55
10401,PADILLA,estado nutricional en menores de 5 anos,clasificacion a y b,2003-09-01,46,6,46,6,52
70502,PAILON,estado nutricional en menores de 5 anos,clasificacion a y b,2003-09-01,22,5,22,5,27
20102,PALCA,estado nutricional en menores de 5 anos,clasificacion a y b,2003-09-01,4,13,4,13,17
21104,PALOS BLANCOS,estado nutricional en menores de 5 anos,clasificacion a y b,2003-09-01,49,8,49,8,57
40802,PAMPA AULLAGAS,estado nutricional en menores de 5 anos,clasificacion a y b,2003-09-01,4,1,4,1,5
70902,PAMPA GRANDE,estado nutricional en menores de 5 anos,clasificacion a y b,2003-09-01,8,2,8,2,10
21802,PAPEL PAMPA,estado nutricional en menores de 5 anos,clasificacion a y b,2003-09-01,2,0,2,0,2
30202,PASORAPA,estado nutricional en menores de 5 anos,clasificacion a y b,2003-09-01,2,0,2,0,2
21305,PATACAMAYA,estado nutricional en menores de 5 anos,clasificacion a y b,2003-09-01,30,2,30,2,32
40602,PAZÃ‘A,estado nutricional en menores de 5 anos,clasificacion a y b,2003-09-01,4,3,4,3,7
20702,PELECHUCO,estado nutricional en menores de 5 anos,clasificacion a y b,2003-09-01,3,1,3,1,4
50403,POCOATA,estado nutricional en menores de 5 anos,clasificacion a y b,2003-09-01,29,5,29,5,34
31203,POCONA,estado nutricional en menores de 5 anos,clasificacion a y b,2003-09-01,8,3,8,3,11
31202,POJO (CBBA),estado nutricional en menores de 5 anos,clasificacion a y b,2003-09-01,104,22,104,22,126
40601,POOPO,estado nutricional en menores de 5 anos,clasificacion a y b,2003-09-01,2,3,2,3,5
51203,PORCO,estado nutricional en menores de 5 anos,clasificacion a y b,2003-09-01,7,2,7,2,9
10103,POROMA,estado nutricional en menores de 5 anos,clasificacion a y b,2003-09-01,35,6,35,6,41
70103,PORONGO,estado nutricional en menores de 5 anos,clasificacion a y b,2003-09-01,17,3,17,3,20
70601,PORTACHUELO,estado nutricional en menores de 5 anos,clasificacion a y b,2003-09-01,139,66,139,66,205
90102,PORVENIR,estado nutricional en menores de 5 anos,clasificacion a y b,2003-09-01,3,4,3,4,7
70804,POSTRER VALLE,estado nutricional en menores de 5 anos,clasificacion a y b,2003-09-01,8,10,8,10,18
50101,POTOSI,estado nutricional en menores de 5 anos,clasificacion a y b,2003-09-01,128,11,128,11,139
10302,PRESTO,estado nutricional en menores de 5 anos,clasificacion a y b,2003-09-01,6,0,6,0,6
70805,PUCARA,estado nutricional en menores de 5 anos,clasificacion a y b,2003-09-01,1,0,1,0,1
21201,PUCARANI,estado nutricional en menores de 5 anos,clasificacion a y b,2003-09-01,16,3,16,3,19
20401,PUERTO ACOSTA,estado nutricional en menores de 5 anos,clasificacion a y b,2003-09-01,25,12,25,12,37
20403,PUERTO CARABUCO,estado nutricional en menores de 5 anos,clasificacion a y b,2003-09-01,17,2,17,2,19
90301,PUERTO GONZALO MORENO,estado nutricional en menores de 5 anos,clasificacion a y b,2003-09-01,54,45,54,45,99
21204,PUERTO PEREZ,estado nutricional en menores de 5 anos,clasificacion a y b,2003-09-01,9,3,9,3,12
71402,PUERTO QUIJARRO,estado nutricional en menores de 5 anos,clasificacion a y b,2003-09-01,26,4,26,4,30
90201,PUERTO RICO,estado nutricional en menores de 5 anos,clasificacion a y b,2003-09-01,3,1,3,1,4
80703,PUERTO SILES,estado nutricional en menores de 5 anos,clasificacion a y b,2003-09-01,4,1,4,1,5
71401,PUERTO SUAREZ,estado nutricional en menores de 5 anos,clasificacion a y b,2003-09-01,110,12,110,12,122
31205,PUERTO VILLARROEL,estado nutricional en menores de 5 anos,clasificacion a y b,2003-09-01,255,66,255,66,321
51101,PUNA,estado nutricional en menores de 5 anos,clasificacion a y b,2003-09-01,64,16,64,16,80
31401,PUNATA,estado nutricional en menores de 5 anos,clasificacion a y b,2003-09-01,2,2,2,2,4
20604,QUIABAYA,estado nutricional en menores de 5 anos,clasificacion a y b,2003-09-01,4,3,4,3,7
30901,QUILLACOLLO,estado nutricional en menores de 5 anos,clasificacion a y b,2003-09-01,62,11,62,11,73
21002,QUIME,estado nutricional en menores de 5 anos,clasificacion a y b,2003-09-01,36,5,36,5,41
70904,QUIRUSILLAS,estado nutricional en menores de 5 anos,clasificacion a y b,2003-09-01,7,0,7,0,7
50402,RAVELO,estado nutricional en menores de 5 anos,clasificacion a y b,2003-09-01,14,9,14,9,23
80301,REYES,estado nutricional en menores de 5 anos,clasificacion a y b,2003-09-01,29,5,29,5,34
80201,RIBERALTA,estado nutricional en menores de 5 anos,clasificacion a y b,2003-09-01,183,43,183,43,226
70503,ROBORE,estado nutricional en menores de 5 anos,clasificacion a y b,2003-09-01,54,13,54,13,67
80304,RURRENABAQUE,estado nutricional en menores de 5 anos,clasificacion a y b,2003-09-01,27,2,27,2,29
40901,SABAYA,estado nutricional en menores de 5 anos,clasificacion a y b,2003-09-01,3,3,3,3,6
31001,SACABA,estado nutricional en menores de 5 anos,clasificacion a y b,2003-09-01,63,14,63,14,77
50701,SACACA,estado nutricional en menores de 5 anos,clasificacion a y b,2003-09-01,15,16,15,16,31
71302,SAIPINA,estado nutricional en menores de 5 anos,clasificacion a y b,2003-09-01,50,21,50,21,71
40801,SALINAS DE GARCI MENDOZA,estado nutricional en menores de 5 anos,clasificacion a y b,2003-09-01,7,0,7,0,7
70901,SAMAIPATA,estado nutricional en menores de 5 anos,clasificacion a y b,2003-09-01,33,8,33,8,41
51601,SAN AGUSTIN,estado nutricional en menores de 5 anos,clasificacion a y b,2003-09-01,2,0,2,0,2
80602,SAN ANDRES,estado nutricional en menores de 5 anos,clasificacion a y b,2003-09-01,0,1,0,1,1
71105,SAN ANTONIO DE LOMERIO,estado nutricional en menores de 5 anos,clasificacion a y b,2003-09-01,22,8,22,8,30
31403,SAN BENITO,estado nutricional en menores de 5 anos,clasificacion a y b,2003-09-01,6,2,6,2,8
80302,SAN BORJA,estado nutricional en menores de 5 anos,clasificacion a y b,2003-09-01,125,27,125,27,152
21502,SAN BUENA VENTURA,estado nutricional en menores de 5 anos,clasificacion a y b,2003-09-01,27,7,27,7,34
70402,SAN CARLOS,estado nutricional en menores de 5 anos,clasificacion a y b,2003-09-01,82,45,82,45,127
80501,SAN IGNACIO,estado nutricional en menores de 5 anos,clasificacion a y b,2003-09-01,71,18,71,18,89
70301,SAN IGNACIO DE VELASCO,estado nutricional en menores de 5 anos,clasificacion a y b,2003-09-01,166,13,166,13,179
80102,SAN JAVIER(BNI),estado nutricional en menores de 5 anos,clasificacion a y b,2003-09-01,11,3,11,3,14
71102,SAN JAVIER(STC),estado nutricional en menores de 5 anos,clasificacion a y b,2003-09-01,45,7,45,7,52
80701,SAN JOAQUIN,estado nutricional en menores de 5 anos,clasificacion a y b,2003-09-01,7,6,7,6,13
70501,SAN JOSE DE CHIQUITOS,estado nutricional en menores de 5 anos,clasificacion a y b,2003-09-01,27,0,27,0,27
71104,SAN JULIAN,estado nutricional en menores de 5 anos,clasificacion a y b,2003-09-01,192,114,192,114,306
90302,SAN LORENZO(PND),estado nutricional en menores de 5 anos,clasificacion a y b,2003-09-01,1,8,1,8,9
60501,SAN LORENZO(TJA),estado nutricional en menores de 5 anos,clasificacion a y b,2003-09-01,32,4,32,4,36
10702,SAN LUCAS,estado nutricional en menores de 5 anos,clasificacion a y b,2003-09-01,43,5,43,5,48
70302,SAN MIGUEL DE VELASCO,estado nutricional en menores de 5 anos,clasificacion a y b,2003-09-01,22,3,22,3,25
51001,SAN PABLO DE LIPEZ,estado nutricional en menores de 5 anos,clasificacion a y b,2003-09-01,0,1,0,1,1
50501,SAN PEDRO DE BUENA VISTA,estado nutricional en menores de 5 anos,clasificacion a y b,2003-09-01,19,6,19,6,25
21801,SAN PEDRO DE CURAHUARA,estado nutricional en menores de 5 anos,clasificacion a y b,2003-09-01,12,0,12,0,12
50902,SAN PEDRO DE QUEMES,estado nutricional en menores de 5 anos,clasificacion a y b,2003-09-01,2,0,2,0,2
21702,SAN PEDRO DE TIQUINA,estado nutricional en menores de 5 anos,clasificacion a y b,2003-09-01,8,3,8,3,11
70303,SAN RAFAEL,estado nutricional en menores de 5 anos,clasificacion a y b,2003-09-01,14,3,14,3,17
80702,SAN RAMON,estado nutricional en menores de 5 anos,clasificacion a y b,2003-09-01,8,7,8,7,15
80401,SANTA ANA,estado nutricional en menores de 5 anos,clasificacion a y b,2003-09-01,22,38,22,38,60
70101,SANTA CRUZ DE LA SIERRA,estado nutricional en menores de 5 anos,clasificacion a y b,2003-09-01,2441,763,2441,763,3204
80303,SANTA ROSA,estado nutricional en menores de 5 anos,clasificacion a y b,2003-09-01,22,23,22,23,45
70602,SANTA ROSA DEL SARA,estado nutricional en menores de 5 anos,clasificacion a y b,2003-09-01,26,23,26,23,49
20308,SANTIAGO DE CALLAPA,estado nutricional en menores de 5 anos,clasificacion a y b,2003-09-01,6,1,6,1,7
41401,SANTIAGO DE HUARI,estado nutricional en menores de 5 anos,clasificacion a y b,2003-09-01,7,6,7,6,13
21901,SANTIAGO DE MACHACA,estado nutricional en menores de 5 anos,clasificacion a y b,2003-09-01,2,0,2,0,2
30702,SANTIVAÃ‘ES,estado nutricional en menores de 5 anos,clasificacion a y b,2003-09-01,4,0,4,0,4
40202,SANTUARIO DE QUILLACAS,estado nutricional en menores de 5 anos,clasificacion a y b,2003-09-01,2,0,2,0,2
20902,SAPAHAQUI,estado nutricional en menores de 5 anos,clasificacion a y b,2003-09-01,4,1,4,1,5
90303,SENA,estado nutricional en menores de 5 anos,clasificacion a y b,2003-09-01,4,1,4,1,5
21301,SICA SICA (VILLA AROMA),estado nutricional en menores de 5 anos,clasificacion a y b,2003-09-01,10,1,10,1,11
30703,SICAYA,estado nutricional en menores de 5 anos,clasificacion a y b,2003-09-01,4,0,4,0,4
30902,SIPE SIPE,estado nutricional en menores de 5 anos,clasificacion a y b,2003-09-01,109,57,109,57,166
10403,SOPACHUY,estado nutricional en menores de 5 anos,clasificacion a y b,2003-09-01,15,2,15,2,17
20601,SORATA,estado nutricional en menores de 5 anos,clasificacion a y b,2003-09-01,26,17,26,17,43
10101,SUCRE,estado nutricional en menores de 5 anos,clasificacion a y b,2003-09-01,312,62,312,62,374
31404,TACACHI,estado nutricional en menores de 5 anos,clasificacion a y b,2003-09-01,1,0,1,0,1
20603,TACACOMA,estado nutricional en menores de 5 anos,clasificacion a y b,2003-09-01,14,3,14,3,17
50303,TACOBAMBA,estado nutricional en menores de 5 anos,clasificacion a y b,2003-09-01,21,8,21,8,29
30602,TACOPAYA,estado nutricional en menores de 5 anos,clasificacion a y b,2003-09-01,6,2,6,2,8
51402,TAHUA,estado nutricional en menores de 5 anos,clasificacion a y b,2003-09-01,3,0,3,0,3
31101,TAPACARI,estado nutricional en menores de 5 anos,clasificacion a y b,2003-09-01,21,2,21,2,23
10601,TARABUCO,estado nutricional en menores de 5 anos,clasificacion a y b,2003-09-01,33,6,33,6,39
30401,TARATA,estado nutricional en menores de 5 anos,clasificacion a y b,2003-09-01,17,22,17,22,39
60101,TARIJA,estado nutricional en menores de 5 anos,clasificacion a y b,2003-09-01,316,75,316,75,391
10202,TARVITA,estado nutricional en menores de 5 anos,clasificacion a y b,2003-09-01,14,2,14,2,16
20803,TIAWANACU,estado nutricional en menores de 5 anos,clasificacion a y b,2003-09-01,16,1,16,1,17
50102,TINGUIPAYA,estado nutricional en menores de 5 anos,clasificacion a y b,2003-09-01,13,5,13,5,18
20606,TIPUANI,estado nutricional en menores de 5 anos,clasificacion a y b,2003-09-01,52,3,52,3,55
30903,TIQUIPAYA,estado nutricional en menores de 5 anos,clasificacion a y b,2003-09-01,50,16,50,16,66
31601,TIRAQUE (CBBA),estado nutricional en menores de 5 anos,clasificacion a y b,2003-09-01,95,17,95,17,112
30802,TOCO,estado nutricional en menores de 5 anos,clasificacion a y b,2003-09-01,0,3,0,3,3
41502,TODOS SANTOS,estado nutricional en menores de 5 anos,clasificacion a y b,2003-09-01,2,3,2,3,5
30803,TOLATA,estado nutricional en menores de 5 anos,clasificacion a y b,2003-09-01,12,1,12,1,13
41001,TOLEDO,estado nutricional en menores de 5 anos,clasificacion a y b,2003-09-01,4,0,4,0,4
51202,TOMAVE,estado nutricional en menores de 5 anos,clasificacion a y b,2003-09-01,12,5,12,5,17
10402,TOMINA,estado nutricional en menores de 5 anos,clasificacion a y b,2003-09-01,15,4,15,4,19
50502,TORO TORO,estado nutricional en menores de 5 anos,clasificacion a y b,2003-09-01,28,5,28,5,33
31201,TOTORA(CBBA),estado nutricional en menores de 5 anos,clasificacion a y b,2003-09-01,33,3,33,3,36
41301,TOTORA(ORR),estado nutricional en menores de 5 anos,clasificacion a y b,2003-09-01,5,0,5,0,5
70802,TRIGAL,estado nutricional en menores de 5 anos,clasificacion a y b,2003-09-01,2,0,2,0,2
80101,TRINIDAD,estado nutricional en menores de 5 anos,clasificacion a y b,2003-09-01,173,52,173,52,225
50801,TUPIZA,estado nutricional en menores de 5 anos,clasificacion a y b,2003-09-01,79,44,79,44,123
40402,TURCO,estado nutricional en menores de 5 anos,clasificacion a y b,2003-09-01,24,1,24,1,25
21302,UMALA,estado nutricional en menores de 5 anos,clasificacion a y b,2003-09-01,26,33,26,33,59
50201,UNCIA,estado nutricional en menores de 5 anos,clasificacion a y b,2003-09-01,4,1,4,1,5
60401,URIONDO (A. CONCEPCION),estado nutricional en menores de 5 anos,clasificacion a y b,2003-09-01,67,14,67,14,81
51201,UYUNI,estado nutricional en menores de 5 anos,clasificacion a y b,2003-09-01,46,3,46,3,49
30502,VACAS,estado nutricional en menores de 5 anos,clasificacion a y b,2003-09-01,4,1,4,1,5
70801,VALLEGRANDE,estado nutricional en menores de 5 anos,clasificacion a y b,2003-09-01,10,13,10,13,23
20801,VIACHA,estado nutricional en menores de 5 anos,clasificacion a y b,2003-09-01,100,26,100,26,126
31302,VILA VILA,estado nutricional en menores de 5 anos,clasificacion a y b,2003-09-01,2,0,2,0,2
60303,VILLA MONTES,estado nutricional en menores de 5 anos,clasificacion a y b,2003-09-01,102,16,102,16,118
31402,VILLA RIVERO,estado nutricional en menores de 5 anos,clasificacion a y b,2003-09-01,12,1,12,1,13
10801,VILLA SERRANO,estado nutricional en menores de 5 anos,clasificacion a y b,2003-09-01,35,8,35,8,43
31003,VILLA TUNARI,estado nutricional en menores de 5 anos,clasificacion a y b,2003-09-01,86,39,86,39,125
11001,VILLA VACA GUZMAN (MUYUPAMPA),estado nutricional en menores de 5 anos,clasificacion a y b,2003-09-01,23,5,23,5,28
51501,VILLAZON,estado nutricional en menores de 5 anos,clasificacion a y b,2003-09-01,68,14,68,14,82
30904,VINTO,estado nutricional en menores de 5 anos,clasificacion a y b,2003-09-01,69,4,69,4,73
50602,VITICHI,estado nutricional en menores de 5 anos,clasificacion a y b,2003-09-01,6,1,6,1,7
20306,WALDO BALLIVIAN,estado nutricional en menores de 5 anos,clasificacion a y b,2003-09-01,1,1,1,1,2
20903,YACO,estado nutricional en menores de 5 anos,clasificacion a y b,2003-09-01,8,6,8,6,14
60301,YACUIBA,estado nutricional en menores de 5 anos,clasificacion a y b,2003-09-01,0,207,0,207,207
10602,YAMPARAEZ,estado nutricional en menores de 5 anos,clasificacion a y b,2003-09-01,30,7,30,7,37
21103,YANACACHI,estado nutricional en menores de 5 anos,clasificacion a y b,2003-09-01,7,1,7,1,8
70403,YAPACANI,estado nutricional en menores de 5 anos,clasificacion a y b,2003-09-01,139,31,139,31,170
50103,YOCALLA,estado nutricional en menores de 5 anos,clasificacion a y b,2003-09-01,10,5,10,5,15
10102,YOTALA,estado nutricional en menores de 5 anos,clasificacion a y b,2003-09-01,21,12,21,12,33
60402,YUNCHARA,estado nutricional en menores de 5 anos,clasificacion a y b,2003-09-01,4,0,4,0,4
10301,ZUDAÃ‘EZ,estado nutricional en menores de 5 anos,clasificacion a y b,2003-09-01,15,7,15,7,22
51302,ACACIO,estado nutricional en menores de 5 anos,clasificacion a y b,2003-10-01,4,5,4,5,9
20201,ACHACACHI,estado nutricional en menores de 5 anos,clasificacion a y b,2003-10-01,72,18,72,18,90
20104,ACHOCALLA,estado nutricional en menores de 5 anos,clasificacion a y b,2003-10-01,7,0,7,0,7
30201,AIQUILE,estado nutricional en menores de 5 anos,clasificacion a y b,2003-10-01,20,5,20,5,25
31303,ALALAY,estado nutricional en menores de 5 anos,clasificacion a y b,2003-10-01,0,1,0,1,1
10404,ALCALA,estado nutricional en menores de 5 anos,clasificacion a y b,2003-10-01,12,3,12,3,15
20202,ANCORAIMES,estado nutricional en menores de 5 anos,clasificacion a y b,2003-10-01,10,1,10,1,11
41201,ANDAMARCA,estado nutricional en menores de 5 anos,clasificacion a y b,2003-10-01,6,0,6,0,6
30402,ANZALDO,estado nutricional en menores de 5 anos,clasificacion a y b,2003-10-01,7,8,7,8,15
20701,APOLO,estado nutricional en menores de 5 anos,clasificacion a y b,2003-10-01,15,1,15,1,16
51301,ARAMPAMPA,estado nutricional en menores de 5 anos,clasificacion a y b,2003-10-01,11,4,11,4,15
30501,ARANI,estado nutricional en menores de 5 anos,clasificacion a y b,2003-10-01,12,1,12,1,13
30403,ARBIETO,estado nutricional en menores de 5 anos,clasificacion a y b,2003-10-01,1,1,1,1,2
30601,ARQUE,estado nutricional en menores de 5 anos,clasificacion a y b,2003-10-01,10,3,10,3,13
71501,ASCENCION DE GUARAYOS,estado nutricional en menores de 5 anos,clasificacion a y b,2003-10-01,18,2,18,2,20
50802,ATOCHA,estado nutricional en menores de 5 anos,clasificacion a y b,2003-10-01,20,25,20,25,45
20503,AUCAPATA,estado nutricional en menores de 5 anos,clasificacion a y b,2003-10-01,6,1,6,1,7
21303,AYO AYO,estado nutricional en menores de 5 anos,clasificacion a y b,2003-10-01,9,2,9,2,11
30301,AYOPAYA (V. DE INDEPENDENCIA),estado nutricional en menores de 5 anos,clasificacion a y b,2003-10-01,26,9,26,9,35
10201,AZURDUY,estado nutricional en menores de 5 anos,clasificacion a y b,2003-10-01,27,10,27,10,37
21203,BATALLAS,estado nutricional en menores de 5 anos,clasificacion a y b,2003-10-01,21,3,21,3,24
80802,BAURES,estado nutricional en menores de 5 anos,clasificacion a y b,2003-10-01,15,6,15,6,21
41202,BELEN DE ANDAMARCA,estado nutricional en menores de 5 anos,clasificacion a y b,2003-10-01,1,0,1,0,1
50104,BELEN DE URMIRI,estado nutricional en menores de 5 anos,clasificacion a y b,2003-10-01,5,1,5,1,6
90104,BELLA FLOR,estado nutricional en menores de 5 anos,clasificacion a y b,2003-10-01,1,3,1,3,4
60202,BERMEJO,estado nutricional en menores de 5 anos,clasificacion a y b,2003-10-01,33,14,33,14,47
50301,BETANZOS,estado nutricional en menores de 5 anos,clasificacion a y b,2003-10-01,35,2,35,2,37
31501,BOLIVAR,estado nutricional en menores de 5 anos,clasificacion a y b,2003-10-01,8,1,8,1,9
90103,BOLPEBRA,estado nutricional en menores de 5 anos,clasificacion a y b,2003-10-01,4,1,4,1,5
70707,BOYUIBE,estado nutricional en menores de 5 anos,clasificacion a y b,2003-10-01,14,8,14,8,22
70401,BUENA VISTA,estado nutricional en menores de 5 anos,clasificacion a y b,2003-10-01,82,62,82,62,144
70703,CABEZAS,estado nutricional en menores de 5 anos,clasificacion a y b,2003-10-01,55,19,55,19,74
20905,CAIROMA,estado nutricional en menores de 5 anos,clasificacion a y b,2003-10-01,18,4,18,4,22
51102,"CAIZA ""D""",estado nutricional en menores de 5 anos,clasificacion a y b,2003-10-01,23,4,23,4,27
21003,CAJUATA,estado nutricional en menores de 5 anos,clasificacion a y b,2003-10-01,39,2,39,2,41
20303,CALACOTO,estado nutricional en menores de 5 anos,clasificacion a y b,2003-10-01,2,0,2,0,2
21304,CALAMARCA,estado nutricional en menores de 5 anos,clasificacion a y b,2003-10-01,16,0,16,0,16
10701,CAMARGO,estado nutricional en menores de 5 anos,clasificacion a y b,2003-10-01,14,0,14,0,14
10901,CAMATAQUI (C. VILLA ABECIA),estado nutricional en menores de 5 anos,clasificacion a y b,2003-10-01,9,4,9,4,13
70706,CAMIRI,estado nutricional en menores de 5 anos,clasificacion a y b,2003-10-01,110,20,110,20,130
30701,CAPINOTA,estado nutricional en menores de 5 anos,clasificacion a y b,2003-10-01,8,16,8,16,24
20302,CAQUIAVIRI,estado nutricional en menores de 5 anos,clasificacion a y b,2003-10-01,7,4,7,4,11
40102,CARACOLLO,estado nutricional en menores de 5 anos,clasificacion a y b,2003-10-01,28,9,28,9,37
22001,CARANAVI,estado nutricional en menores de 5 anos,clasificacion a y b,2003-10-01,103,20,103,20,123
60302,CARAPARI,estado nutricional en menores de 5 anos,clasificacion a y b,2003-10-01,27,7,27,7,34
50702,CARIPUYO,estado nutricional en menores de 5 anos,clasificacion a y b,2003-10-01,15,0,15,0,15
40201,CHALLAPATA,estado nutricional en menores de 5 anos,clasificacion a y b,2003-10-01,29,3,29,3,32
50302,CHAQUI,estado nutricional en menores de 5 anos,clasificacion a y b,2003-10-01,14,0,14,0,14
70702,CHARAGUA,estado nutricional en menores de 5 anos,clasificacion a y b,2003-10-01,90,27,90,27,117
50202,CHAYANTA,estado nutricional en menores de 5 anos,clasificacion a y b,2003-10-01,31,12,31,12,43
31204,CHIMORE,estado nutricional en menores de 5 anos,clasificacion a y b,2003-10-01,19,11,19,11,30
40903,CHIPAYA,estado nutricional en menores de 5 anos,clasificacion a y b,2003-10-01,1,0,1,0,1
21101,CHULUMANI (V. DE LA LIBERTAD),estado nutricional en menores de 5 anos,clasificacion a y b,2003-10-01,11,2,11,2,13
20501,CHUMA,estado nutricional en menores de 5 anos,clasificacion a y b,2003-10-01,7,1,7,1,8
30801,CLIZA,estado nutricional en menores de 5 anos,clasificacion a y b,2003-10-01,6,5,6,5,11
90101,COBIJA,estado nutricional en menores de 5 anos,clasificacion a y b,2003-10-01,53,20,53,20,73
30101,COCHABAMBA,estado nutricional en menores de 5 anos,clasificacion a y b,2003-10-01,556,156,556,156,712
30905,COLCAPIRHUA,estado nutricional en menores de 5 anos,clasificacion a y b,2003-10-01,36,3,36,3,39
50901,"COLCHA ""K""",estado nutricional en menores de 5 anos,clasificacion a y b,2003-10-01,10,1,10,1,11
31002,COLOMI,estado nutricional en menores de 5 anos,clasificacion a y b,2003-10-01,27,9,27,9,36
50401,COLQUECHACA,estado nutricional en menores de 5 anos,clasificacion a y b,2003-10-01,71,19,71,19,90
21306,COLQUENCHA,estado nutricional en menores de 5 anos,clasificacion a y b,2003-10-01,17,10,17,10,27
21004,COLQUIRI,estado nutricional en menores de 5 anos,clasificacion a y b,2003-10-01,24,3,24,3,27
20304,COMANCHE,estado nutricional en menores de 5 anos,clasificacion a y b,2003-10-01,2,0,2,0,2
71301,COMARAPA,estado nutricional en menores de 5 anos,clasificacion a y b,2003-10-01,96,8,96,8,104
20605,COMBAYA,estado nutricional en menores de 5 anos,clasificacion a y b,2003-10-01,3,1,3,1,4
71101,CONCEPCION,estado nutricional en menores de 5 anos,clasificacion a y b,2003-10-01,14,2,14,2,16
21701,COPACABANA,estado nutricional en menores de 5 anos,clasificacion a y b,2003-10-01,19,0,19,0,19
21402,CORIPATA,estado nutricional en menores de 5 anos,clasificacion a y b,2003-10-01,32,1,32,1,33
20301,CORO CORO,estado nutricional en menores de 5 anos,clasificacion a y b,2003-10-01,4,0,4,0,4
21401,COROICO,estado nutricional en menores de 5 anos,clasificacion a y b,2003-10-01,16,7,16,7,23
40301,CORQUE,estado nutricional en menores de 5 anos,clasificacion a y b,2003-10-01,5,2,5,2,7
50601,COTAGAITA,estado nutricional en menores de 5 anos,clasificacion a y b,2003-10-01,41,10,41,10,51
31405,CUCHUMUELA (V. G. VILLARROEL),estado nutricional en menores de 5 anos,clasificacion a y b,2003-10-01,1,0,1,0,1
70704,CUEVO,estado nutricional en menores de 5 anos,clasificacion a y b,2003-10-01,14,3,14,3,17
10902,CULPINA,estado nutricional en menores de 5 anos,clasificacion a y b,2003-10-01,45,16,45,16,61
40401,CURAHUARA DE CARANGAS,estado nutricional en menores de 5 anos,clasificacion a y b,2003-10-01,4,1,4,1,5
21602,CURVA,estado nutricional en menores de 5 anos,clasificacion a y b,2003-10-01,2,0,2,0,2
20804,DESAGUADERO,estado nutricional en menores de 5 anos,clasificacion a y b,2003-10-01,2,1,2,1,3
20105,EL ALTO,estado nutricional en menores de 5 anos,clasificacion a y b,2003-10-01,688,151,688,151,839
40103,EL CHORO,estado nutricional en menores de 5 anos,clasificacion a y b,2003-10-01,6,3,6,3,9
71503,EL PUENTE(STC),estado nutricional en menores de 5 anos,clasificacion a y b,2003-10-01,21,13,21,13,34
60502,EL PUENTE(TJA),estado nutricional en menores de 5 anos,clasificacion a y b,2003-10-01,23,2,23,2,25
70105,EL TORNO,estado nutricional en menores de 5 anos,clasificacion a y b,2003-10-01,146,27,146,27,173
10405,EL VILLAR,estado nutricional en menores de 5 anos,clasificacion a y b,2003-10-01,13,2,13,2,15
60601,ENTRE RIOS,estado nutricional en menores de 5 anos,clasificacion a y b,2003-10-01,70,20,70,20,90
41101,EUCALIPTUS,estado nutricional en menores de 5 anos,clasificacion a y b,2003-10-01,10,3,10,3,13
90503,EUREKA (SANTOS MERCADO),estado nutricional en menores de 5 anos,clasificacion a y b,2003-10-01,2,0,2,0,2
80402,EXALTACION,estado nutricional en menores de 5 anos,clasificacion a y b,2003-10-01,11,13,11,13,24
90203,FILADELFIA,estado nutricional en menores de 5 anos,clasificacion a y b,2003-10-01,3,1,3,1,4
71002,GENERAL SAAVEDRA,estado nutricional en menores de 5 anos,clasificacion a y b,2003-10-01,103,45,103,45,148
21601,GRAL. J.J. PEREZ (CHARAZANI),estado nutricional en menores de 5 anos,clasificacion a y b,2003-10-01,32,3,32,3,35
20602,GUANAY,estado nutricional en menores de 5 anos,clasificacion a y b,2003-10-01,149,74,149,74,223
20802,GUAQUI,estado nutricional en menores de 5 anos,clasificacion a y b,2003-10-01,5,0,5,0,5
80202,GUAYARAMERIN,estado nutricional en menores de 5 anos,clasificacion a y b,2003-10-01,119,23,119,23,142
70705,GUTIERREZ,estado nutricional en menores de 5 anos,clasificacion a y b,2003-10-01,79,26,79,26,105
10502,HUACARETA,estado nutricional en menores de 5 anos,clasificacion a y b,2003-10-01,29,16,29,16,45
11002,HUACAYA (VILLA DE HUACAYA),estado nutricional en menores de 5 anos,clasificacion a y b,2003-10-01,16,1,16,1,17
40501,HUACHACALLA,estado nutricional en menores de 5 anos,clasificacion a y b,2003-10-01,1,1,1,1,2
40701,HUANUNI,estado nutricional en menores de 5 anos,clasificacion a y b,2003-10-01,32,2,32,2,34
80803,HUARACAJE,estado nutricional en menores de 5 anos,clasificacion a y b,2003-10-01,9,10,9,10,19
41601,HUAYLLAMARCA,estado nutricional en menores de 5 anos,clasificacion a y b,2003-10-01,1,0,1,0,1
21005,ICHOCA,estado nutricional en menores de 5 anos,clasificacion a y b,2003-10-01,15,6,15,6,21
10304,ICLA,estado nutricional en menores de 5 anos,clasificacion a y b,2003-10-01,13,3,13,3,16
10703,INCAHUASI,estado nutricional en menores de 5 anos,clasificacion a y b,2003-10-01,38,4,38,4,42
90402,INGAVI (HUMAITA),estado nutricional en menores de 5 anos,clasificacion a y b,2003-10-01,3,0,3,0,3
21001,INQUISIVI,estado nutricional en menores de 5 anos,clasificacion a y b,2003-10-01,16,4,16,4,20
21501,IXIAMAS,estado nutricional en menores de 5 anos,clasificacion a y b,2003-10-01,30,4,30,4,34
21105,LA ASUNTA,estado nutricional en menores de 5 anos,clasificacion a y b,2003-10-01,69,2,69,2,71
70104,LA GUARDIA,estado nutricional en menores de 5 anos,clasificacion a y b,2003-10-01,130,43,130,43,173
20101,LA PAZ,estado nutricional en menores de 5 anos,clasificacion a y b,2003-10-01,833,212,833,212,1045
70701,LAGUNILLAS,estado nutricional en menores de 5 anos,clasificacion a y b,2003-10-01,23,8,23,8,31
21202,LAJA,estado nutricional en menores de 5 anos,clasificacion a y b,2003-10-01,35,12,35,12,47
10903,LAS CARRERAS,estado nutricional en menores de 5 anos,clasificacion a y b,2003-10-01,6,0,6,0,6
50203,LLALLAGUA,estado nutricional en menores de 5 anos,clasificacion a y b,2003-10-01,106,44,106,44,150
51401,LLICA,estado nutricional en menores de 5 anos,clasificacion a y b,2003-10-01,8,9,8,9,17
80601,LORETO,estado nutricional en menores de 5 anos,clasificacion a y b,2003-10-01,4,4,4,4,8
20901,LURIBAY,estado nutricional en menores de 5 anos,clasificacion a y b,2003-10-01,12,0,12,0,12
40702,MACHACAMARCA,estado nutricional en menores de 5 anos,clasificacion a y b,2003-10-01,23,14,23,14,37
11003,MACHARETI,estado nutricional en menores de 5 anos,clasificacion a y b,2003-10-01,46,38,46,38,84
80801,MAGDALENA,estado nutricional en menores de 5 anos,clasificacion a y b,2003-10-01,7,5,7,5,12
70903,MAIRANA,estado nutricional en menores de 5 anos,clasificacion a y b,2003-10-01,36,10,36,10,46
20103,MECAPACA,estado nutricional en menores de 5 anos,clasificacion a y b,2003-10-01,4,4,4,4,8
71003,MINEROS,estado nutricional en menores de 5 anos,clasificacion a y b,2003-10-01,303,84,303,84,387
31301,MIZQUE,estado nutricional en menores de 5 anos,clasificacion a y b,2003-10-01,20,9,20,9,29
20402,MOCOMOCO,estado nutricional en menores de 5 anos,clasificacion a y b,2003-10-01,10,0,10,0,10
51002,MOJINETE,estado nutricional en menores de 5 anos,clasificacion a y b,2003-10-01,1,2,1,2,3
10303,MOJOCOYA,estado nutricional en menores de 5 anos,clasificacion a y b,2003-10-01,37,12,37,12,49
10501,MONTEAGUDO,estado nutricional en menores de 5 anos,clasificacion a y b,2003-10-01,82,37,82,37,119
71001,MONTERO,estado nutricional en menores de 5 anos,clasificacion a y b,2003-10-01,507,115,507,115,622
70803,MORO MORO,estado nutricional en menores de 5 anos,clasificacion a y b,2003-10-01,5,1,5,1,6
30302,MOROCHATA,estado nutricional en menores de 5 anos,clasificacion a y b,2003-10-01,28,33,28,33,61
20307,NAZACARA DE PACAJES,estado nutricional en menores de 5 anos,clasificacion a y b,2003-10-01,1,0,1,0,1
50404,OCURI,estado nutricional en menores de 5 anos,clasificacion a y b,2003-10-01,19,3,19,3,22
30203,OMEREQUE,estado nutricional en menores de 5 anos,clasificacion a y b,2003-10-01,4,0,4,0,4
40101,ORURO,estado nutricional en menores de 5 anos,clasificacion a y b,2003-10-01,355,92,355,92,447
60201,PADCAYA,estado nutricional en menores de 5 anos,clasificacion a y b,2003-10-01,33,68,33,68,101
10401,PADILLA,estado nutricional en menores de 5 anos,clasificacion a y b,2003-10-01,41,6,41,6,47
70502,PAILON,estado nutricional en menores de 5 anos,clasificacion a y b,2003-10-01,52,32,52,32,84
20102,PALCA,estado nutricional en menores de 5 anos,clasificacion a y b,2003-10-01,8,7,8,7,15
21104,PALOS BLANCOS,estado nutricional en menores de 5 anos,clasificacion a y b,2003-10-01,64,11,64,11,75
40802,PAMPA AULLAGAS,estado nutricional en menores de 5 anos,clasificacion a y b,2003-10-01,4,0,4,0,4
70902,PAMPA GRANDE,estado nutricional en menores de 5 anos,clasificacion a y b,2003-10-01,14,1,14,1,15
21802,PAPEL PAMPA,estado nutricional en menores de 5 anos,clasificacion a y b,2003-10-01,9,0,9,0,9
30202,PASORAPA,estado nutricional en menores de 5 anos,clasificacion a y b,2003-10-01,7,0,7,0,7
21305,PATACAMAYA,estado nutricional en menores de 5 anos,clasificacion a y b,2003-10-01,24,6,24,6,30
40602,PAZÃ‘A,estado nutricional en menores de 5 anos,clasificacion a y b,2003-10-01,7,2,7,2,9
20702,PELECHUCO,estado nutricional en menores de 5 anos,clasificacion a y b,2003-10-01,2,0,2,0,2
50403,POCOATA,estado nutricional en menores de 5 anos,clasificacion a y b,2003-10-01,34,11,34,11,45
31203,POCONA,estado nutricional en menores de 5 anos,clasificacion a y b,2003-10-01,7,0,7,0,7
31202,POJO (CBBA),estado nutricional en menores de 5 anos,clasificacion a y b,2003-10-01,147,18,147,18,165
40601,POOPO,estado nutricional en menores de 5 anos,clasificacion a y b,2003-10-01,1,1,1,1,2
51203,PORCO,estado nutricional en menores de 5 anos,clasificacion a y b,2003-10-01,1,0,1,0,1
10103,POROMA,estado nutricional en menores de 5 anos,clasificacion a y b,2003-10-01,53,14,53,14,67
70103,PORONGO,estado nutricional en menores de 5 anos,clasificacion a y b,2003-10-01,15,1,15,1,16
70601,PORTACHUELO,estado nutricional en menores de 5 anos,clasificacion a y b,2003-10-01,94,48,94,48,142
90102,PORVENIR,estado nutricional en menores de 5 anos,clasificacion a y b,2003-10-01,1,0,1,0,1
70804,POSTRER VALLE,estado nutricional en menores de 5 anos,clasificacion a y b,2003-10-01,13,8,13,8,21
50101,POTOSI,estado nutricional en menores de 5 anos,clasificacion a y b,2003-10-01,173,14,173,14,187
10302,PRESTO,estado nutricional en menores de 5 anos,clasificacion a y b,2003-10-01,12,1,12,1,13
70805,PUCARA,estado nutricional en menores de 5 anos,clasificacion a y b,2003-10-01,6,2,6,2,8
21201,PUCARANI,estado nutricional en menores de 5 anos,clasificacion a y b,2003-10-01,36,1,36,1,37
20401,PUERTO ACOSTA,estado nutricional en menores de 5 anos,clasificacion a y b,2003-10-01,8,5,8,5,13
20403,PUERTO CARABUCO,estado nutricional en menores de 5 anos,clasificacion a y b,2003-10-01,24,3,24,3,27
90301,PUERTO GONZALO MORENO,estado nutricional en menores de 5 anos,clasificacion a y b,2003-10-01,7,3,7,3,10
21204,PUERTO PEREZ,estado nutricional en menores de 5 anos,clasificacion a y b,2003-10-01,10,2,10,2,12
71402,PUERTO QUIJARRO,estado nutricional en menores de 5 anos,clasificacion a y b,2003-10-01,45,7,45,7,52
90201,PUERTO RICO,estado nutricional en menores de 5 anos,clasificacion a y b,2003-10-01,5,5,5,5,10
71401,PUERTO SUAREZ,estado nutricional en menores de 5 anos,clasificacion a y b,2003-10-01,108,23,108,23,131
31205,PUERTO VILLARROEL,estado nutricional en menores de 5 anos,clasificacion a y b,2003-10-01,209,68,209,68,277
51101,PUNA,estado nutricional en menores de 5 anos,clasificacion a y b,2003-10-01,45,5,45,5,50
31401,PUNATA,estado nutricional en menores de 5 anos,clasificacion a y b,2003-10-01,21,0,21,0,21
20604,QUIABAYA,estado nutricional en menores de 5 anos,clasificacion a y b,2003-10-01,12,0,12,0,12
30901,QUILLACOLLO,estado nutricional en menores de 5 anos,clasificacion a y b,2003-10-01,78,13,78,13,91
21002,QUIME,estado nutricional en menores de 5 anos,clasificacion a y b,2003-10-01,18,7,18,7,25
70904,QUIRUSILLAS,estado nutricional en menores de 5 anos,clasificacion a y b,2003-10-01,15,2,15,2,17
50402,RAVELO,estado nutricional en menores de 5 anos,clasificacion a y b,2003-10-01,7,4,7,4,11
80301,REYES,estado nutricional en menores de 5 anos,clasificacion a y b,2003-10-01,81,51,81,51,132
80201,RIBERALTA,estado nutricional en menores de 5 anos,clasificacion a y b,2003-10-01,156,42,156,42,198
70503,ROBORE,estado nutricional en menores de 5 anos,clasificacion a y b,2003-10-01,156,48,156,48,204
80304,RURRENABAQUE,estado nutricional en menores de 5 anos,clasificacion a y b,2003-10-01,27,7,27,7,34
40901,SABAYA,estado nutricional en menores de 5 anos,clasificacion a y b,2003-10-01,1,0,1,0,1
31001,SACABA,estado nutricional en menores de 5 anos,clasificacion a y b,2003-10-01,38,1,38,1,39
50701,SACACA,estado nutricional en menores de 5 anos,clasificacion a y b,2003-10-01,9,1,9,1,10
71302,SAIPINA,estado nutricional en menores de 5 anos,clasificacion a y b,2003-10-01,63,16,63,16,79
40801,SALINAS DE GARCI MENDOZA,estado nutricional en menores de 5 anos,clasificacion a y b,2003-10-01,3,3,3,3,6
70901,SAMAIPATA,estado nutricional en menores de 5 anos,clasificacion a y b,2003-10-01,56,33,56,33,89
51601,SAN AGUSTIN,estado nutricional en menores de 5 anos,clasificacion a y b,2003-10-01,8,1,8,1,9
80602,SAN ANDRES,estado nutricional en menores de 5 anos,clasificacion a y b,2003-10-01,3,0,3,0,3
51003,SAN ANTONIO DE ESMORUCO,estado nutricional en menores de 5 anos,clasificacion a y b,2003-10-01,1,0,1,0,1
71105,SAN ANTONIO DE LOMERIO,estado nutricional en menores de 5 anos,clasificacion a y b,2003-10-01,10,9,10,9,19
31403,SAN BENITO,estado nutricional en menores de 5 anos,clasificacion a y b,2003-10-01,5,1,5,1,6
80302,SAN BORJA,estado nutricional en menores de 5 anos,clasificacion a y b,2003-10-01,103,15,103,15,118
21502,SAN BUENA VENTURA,estado nutricional en menores de 5 anos,clasificacion a y b,2003-10-01,37,7,37,7,44
70402,SAN CARLOS,estado nutricional en menores de 5 anos,clasificacion a y b,2003-10-01,129,43,129,43,172
80501,SAN IGNACIO,estado nutricional en menores de 5 anos,clasificacion a y b,2003-10-01,62,17,62,17,79
70301,SAN IGNACIO DE VELASCO,estado nutricional en menores de 5 anos,clasificacion a y b,2003-10-01,187,13,187,13,200
80102,SAN JAVIER(BNI),estado nutricional en menores de 5 anos,clasificacion a y b,2003-10-01,7,1,7,1,8
71102,SAN JAVIER(STC),estado nutricional en menores de 5 anos,clasificacion a y b,2003-10-01,51,7,51,7,58
80701,SAN JOAQUIN,estado nutricional en menores de 5 anos,clasificacion a y b,2003-10-01,16,5,16,5,21
70501,SAN JOSE DE CHIQUITOS,estado nutricional en menores de 5 anos,clasificacion a y b,2003-10-01,37,2,37,2,39
71104,SAN JULIAN,estado nutricional en menores de 5 anos,clasificacion a y b,2003-10-01,129,37,129,37,166
60501,SAN LORENZO(TJA),estado nutricional en menores de 5 anos,clasificacion a y b,2003-10-01,31,15,31,15,46
10702,SAN LUCAS,estado nutricional en menores de 5 anos,clasificacion a y b,2003-10-01,36,5,36,5,41
71201,SAN MATIAS,estado nutricional en menores de 5 anos,clasificacion a y b,2003-10-01,42,5,42,5,47
70302,SAN MIGUEL DE VELASCO,estado nutricional en menores de 5 anos,clasificacion a y b,2003-10-01,19,1,19,1,20
51001,SAN PABLO DE LIPEZ,estado nutricional en menores de 5 anos,clasificacion a y b,2003-10-01,5,0,5,0,5
50501,SAN PEDRO DE BUENA VISTA,estado nutricional en menores de 5 anos,clasificacion a y b,2003-10-01,27,8,27,8,35
21801,SAN PEDRO DE CURAHUARA,estado nutricional en menores de 5 anos,clasificacion a y b,2003-10-01,9,0,9,0,9
50902,SAN PEDRO DE QUEMES,estado nutricional en menores de 5 anos,clasificacion a y b,2003-10-01,2,0,2,0,2
21702,SAN PEDRO DE TIQUINA,estado nutricional en menores de 5 anos,clasificacion a y b,2003-10-01,6,2,6,2,8
90202,SAN PEDRO(PND),estado nutricional en menores de 5 anos,clasificacion a y b,2003-10-01,6,8,6,8,14
70303,SAN RAFAEL,estado nutricional en menores de 5 anos,clasificacion a y b,2003-10-01,34,3,34,3,37
80702,SAN RAMON,estado nutricional en menores de 5 anos,clasificacion a y b,2003-10-01,5,4,5,4,9
80401,SANTA ANA,estado nutricional en menores de 5 anos,clasificacion a y b,2003-10-01,49,12,49,12,61
70101,SANTA CRUZ DE LA SIERRA,estado nutricional en menores de 5 anos,clasificacion a y b,2003-10-01,3099,837,3099,837,3936
80303,SANTA ROSA,estado nutricional en menores de 5 anos,clasificacion a y b,2003-10-01,38,10,38,10,48
70602,SANTA ROSA DEL SARA,estado nutricional en menores de 5 anos,clasificacion a y b,2003-10-01,24,20,24,20,44
20308,SANTIAGO DE CALLAPA,estado nutricional en menores de 5 anos,clasificacion a y b,2003-10-01,9,1,9,1,10
41401,SANTIAGO DE HUARI,estado nutricional en menores de 5 anos,clasificacion a y b,2003-10-01,7,3,7,3,10
21901,SANTIAGO DE MACHACA,estado nutricional en menores de 5 anos,clasificacion a y b,2003-10-01,2,0,2,0,2
30702,SANTIVAÃ‘ES,estado nutricional en menores de 5 anos,clasificacion a y b,2003-10-01,4,2,4,2,6
40202,SANTUARIO DE QUILLACAS,estado nutricional en menores de 5 anos,clasificacion a y b,2003-10-01,18,0,18,0,18
20902,SAPAHAQUI,estado nutricional en menores de 5 anos,clasificacion a y b,2003-10-01,7,2,7,2,9
90303,SENA,estado nutricional en menores de 5 anos,clasificacion a y b,2003-10-01,4,2,4,2,6
21301,SICA SICA (VILLA AROMA),estado nutricional en menores de 5 anos,clasificacion a y b,2003-10-01,18,5,18,5,23
30902,SIPE SIPE,estado nutricional en menores de 5 anos,clasificacion a y b,2003-10-01,116,23,116,23,139
10403,SOPACHUY,estado nutricional en menores de 5 anos,clasificacion a y b,2003-10-01,17,2,17,2,19
20601,SORATA,estado nutricional en menores de 5 anos,clasificacion a y b,2003-10-01,20,7,20,7,27
10101,SUCRE,estado nutricional en menores de 5 anos,clasificacion a y b,2003-10-01,226,53,226,53,279
20603,TACACOMA,estado nutricional en menores de 5 anos,clasificacion a y b,2003-10-01,13,3,13,3,16
50303,TACOBAMBA,estado nutricional en menores de 5 anos,clasificacion a y b,2003-10-01,24,6,24,6,30
30602,TACOPAYA,estado nutricional en menores de 5 anos,clasificacion a y b,2003-10-01,7,2,7,2,9
51402,TAHUA,estado nutricional en menores de 5 anos,clasificacion a y b,2003-10-01,5,0,5,0,5
31101,TAPACARI,estado nutricional en menores de 5 anos,clasificacion a y b,2003-10-01,19,12,19,12,31
10601,TARABUCO,estado nutricional en menores de 5 anos,clasificacion a y b,2003-10-01,44,8,44,8,52
30401,TARATA,estado nutricional en menores de 5 anos,clasificacion a y b,2003-10-01,22,2,22,2,24
60101,TARIJA,estado nutricional en menores de 5 anos,clasificacion a y b,2003-10-01,534,150,534,150,684
10202,TARVITA,estado nutricional en menores de 5 anos,clasificacion a y b,2003-10-01,17,2,17,2,19
20803,TIAWANACU,estado nutricional en menores de 5 anos,clasificacion a y b,2003-10-01,23,5,23,5,28
50102,TINGUIPAYA,estado nutricional en menores de 5 anos,clasificacion a y b,2003-10-01,18,3,18,3,21
20606,TIPUANI,estado nutricional en menores de 5 anos,clasificacion a y b,2003-10-01,53,19,53,19,72
30903,TIQUIPAYA,estado nutricional en menores de 5 anos,clasificacion a y b,2003-10-01,37,9,37,9,46
31601,TIRAQUE (CBBA),estado nutricional en menores de 5 anos,clasificacion a y b,2003-10-01,140,22,140,22,162
21703,TITO YUPANQUI (PARQUIPUJIO),estado nutricional en menores de 5 anos,clasificacion a y b,2003-10-01,1,0,1,0,1
30802,TOCO,estado nutricional en menores de 5 anos,clasificacion a y b,2003-10-01,1,1,1,1,2
41502,TODOS SANTOS,estado nutricional en menores de 5 anos,clasificacion a y b,2003-10-01,1,0,1,0,1
30803,TOLATA,estado nutricional en menores de 5 anos,clasificacion a y b,2003-10-01,9,2,9,2,11
41001,TOLEDO,estado nutricional en menores de 5 anos,clasificacion a y b,2003-10-01,4,3,4,3,7
51202,TOMAVE,estado nutricional en menores de 5 anos,clasificacion a y b,2003-10-01,8,5,8,5,13
10402,TOMINA,estado nutricional en menores de 5 anos,clasificacion a y b,2003-10-01,20,4,20,4,24
50502,TORO TORO,estado nutricional en menores de 5 anos,clasificacion a y b,2003-10-01,11,2,11,2,13
31201,TOTORA(CBBA),estado nutricional en menores de 5 anos,clasificacion a y b,2003-10-01,16,1,16,1,17
41301,TOTORA(ORR),estado nutricional en menores de 5 anos,clasificacion a y b,2003-10-01,2,0,2,0,2
70802,TRIGAL,estado nutricional en menores de 5 anos,clasificacion a y b,2003-10-01,11,1,11,1,12
80101,TRINIDAD,estado nutricional en menores de 5 anos,clasificacion a y b,2003-10-01,228,108,228,108,336
50801,TUPIZA,estado nutricional en menores de 5 anos,clasificacion a y b,2003-10-01,75,23,75,23,98
40402,TURCO,estado nutricional en menores de 5 anos,clasificacion a y b,2003-10-01,5,0,5,0,5
21302,UMALA,estado nutricional en menores de 5 anos,clasificacion a y b,2003-10-01,3,3,3,3,6
50201,UNCIA,estado nutricional en menores de 5 anos,clasificacion a y b,2003-10-01,3,0,3,0,3
60401,URIONDO (A. CONCEPCION),estado nutricional en menores de 5 anos,clasificacion a y b,2003-10-01,83,21,83,21,104
71502,URUBICHA,estado nutricional en menores de 5 anos,clasificacion a y b,2003-10-01,15,9,15,9,24
51201,UYUNI,estado nutricional en menores de 5 anos,clasificacion a y b,2003-10-01,51,12,51,12,63
70801,VALLEGRANDE,estado nutricional en menores de 5 anos,clasificacion a y b,2003-10-01,64,24,64,24,88
20801,VIACHA,estado nutricional en menores de 5 anos,clasificacion a y b,2003-10-01,83,17,83,17,100
31302,VILA VILA,estado nutricional en menores de 5 anos,clasificacion a y b,2003-10-01,7,0,7,0,7
60303,VILLA MONTES,estado nutricional en menores de 5 anos,clasificacion a y b,2003-10-01,65,13,65,13,78
31402,VILLA RIVERO,estado nutricional en menores de 5 anos,clasificacion a y b,2003-10-01,16,1,16,1,17
10801,VILLA SERRANO,estado nutricional en menores de 5 anos,clasificacion a y b,2003-10-01,26,2,26,2,28
31003,VILLA TUNARI,estado nutricional en menores de 5 anos,clasificacion a y b,2003-10-01,97,30,97,30,127
11001,VILLA VACA GUZMAN (MUYUPAMPA),estado nutricional en menores de 5 anos,clasificacion a y b,2003-10-01,47,11,47,11,58
51501,VILLAZON,estado nutricional en menores de 5 anos,clasificacion a y b,2003-10-01,119,36,119,36,155
30904,VINTO,estado nutricional en menores de 5 anos,clasificacion a y b,2003-10-01,42,17,42,17,59
50602,VITICHI,estado nutricional en menores de 5 anos,clasificacion a y b,2003-10-01,28,5,28,5,33
20306,WALDO BALLIVIAN,estado nutricional en menores de 5 anos,clasificacion a y b,2003-10-01,1,0,1,0,1
20903,YACO,estado nutricional en menores de 5 anos,clasificacion a y b,2003-10-01,8,3,8,3,11
60301,YACUIBA,estado nutricional en menores de 5 anos,clasificacion a y b,2003-10-01,99,39,99,39,138
10602,YAMPARAEZ,estado nutricional en menores de 5 anos,clasificacion a y b,2003-10-01,37,8,37,8,45
21103,YANACACHI,estado nutricional en menores de 5 anos,clasificacion a y b,2003-10-01,4,0,4,0,4
70403,YAPACANI,estado nutricional en menores de 5 anos,clasificacion a y b,2003-10-01,207,22,207,22,229
50103,YOCALLA,estado nutricional en menores de 5 anos,clasificacion a y b,2003-10-01,2,1,2,1,3
10102,YOTALA,estado nutricional en menores de 5 anos,clasificacion a y b,2003-10-01,23,16,23,16,39
60402,YUNCHARA,estado nutricional en menores de 5 anos,clasificacion a y b,2003-10-01,10,7,10,7,17
10301,ZUDAÃ‘EZ,estado nutricional en menores de 5 anos,clasificacion a y b,2003-10-01,19,5,19,5,24
51302,ACACIO,estado nutricional en menores de 5 anos,clasificacion a y b,2003-11-01,11,1,11,1,12
20201,ACHACACHI,estado nutricional en menores de 5 anos,clasificacion a y b,2003-11-01,84,54,84,54,138
20104,ACHOCALLA,estado nutricional en menores de 5 anos,clasificacion a y b,2003-11-01,8,1,8,1,9
30201,AIQUILE,estado nutricional en menores de 5 anos,clasificacion a y b,2003-11-01,26,7,26,7,33
31303,ALALAY,estado nutricional en menores de 5 anos,clasificacion a y b,2003-11-01,0,2,0,2,2
10404,ALCALA,estado nutricional en menores de 5 anos,clasificacion a y b,2003-11-01,9,1,9,1,10
20202,ANCORAIMES,estado nutricional en menores de 5 anos,clasificacion a y b,2003-11-01,7,0,7,0,7
41201,ANDAMARCA,estado nutricional en menores de 5 anos,clasificacion a y b,2003-11-01,1,0,1,0,1
40603,ANTEQUERA,estado nutricional en menores de 5 anos,clasificacion a y b,2003-11-01,1,0,1,0,1
30402,ANZALDO,estado nutricional en menores de 5 anos,clasificacion a y b,2003-11-01,8,2,8,2,10
20701,APOLO,estado nutricional en menores de 5 anos,clasificacion a y b,2003-11-01,32,2,32,2,34
51301,ARAMPAMPA,estado nutricional en menores de 5 anos,clasificacion a y b,2003-11-01,5,3,5,3,8
30501,ARANI,estado nutricional en menores de 5 anos,clasificacion a y b,2003-11-01,11,1,11,1,12
30403,ARBIETO,estado nutricional en menores de 5 anos,clasificacion a y b,2003-11-01,23,5,23,5,28
30601,ARQUE,estado nutricional en menores de 5 anos,clasificacion a y b,2003-11-01,10,3,10,3,13
50802,ATOCHA,estado nutricional en menores de 5 anos,clasificacion a y b,2003-11-01,16,15,16,15,31
20503,AUCAPATA,estado nutricional en menores de 5 anos,clasificacion a y b,2003-11-01,18,2,18,2,20
20502,AYATA,estado nutricional en menores de 5 anos,clasificacion a y b,2003-11-01,5,4,5,4,9
21303,AYO AYO,estado nutricional en menores de 5 anos,clasificacion a y b,2003-11-01,12,3,12,3,15
30301,AYOPAYA (V. DE INDEPENDENCIA),estado nutricional en menores de 5 anos,clasificacion a y b,2003-11-01,8,2,8,2,10
10201,AZURDUY,estado nutricional en menores de 5 anos,clasificacion a y b,2003-11-01,11,4,11,4,15
21203,BATALLAS,estado nutricional en menores de 5 anos,clasificacion a y b,2003-11-01,15,4,15,4,19
80802,BAURES,estado nutricional en menores de 5 anos,clasificacion a y b,2003-11-01,18,2,18,2,20
41202,BELEN DE ANDAMARCA,estado nutricional en menores de 5 anos,clasificacion a y b,2003-11-01,1,1,1,1,2
50104,BELEN DE URMIRI,estado nutricional en menores de 5 anos,clasificacion a y b,2003-11-01,3,0,3,0,3
90104,BELLA FLOR,estado nutricional en menores de 5 anos,clasificacion a y b,2003-11-01,6,0,6,0,6
60202,BERMEJO,estado nutricional en menores de 5 anos,clasificacion a y b,2003-11-01,24,28,24,28,52
50301,BETANZOS,estado nutricional en menores de 5 anos,clasificacion a y b,2003-11-01,54,9,54,9,63
31501,BOLIVAR,estado nutricional en menores de 5 anos,clasificacion a y b,2003-11-01,10,0,10,0,10
70707,BOYUIBE,estado nutricional en menores de 5 anos,clasificacion a y b,2003-11-01,9,3,9,3,12
70401,BUENA VISTA,estado nutricional en menores de 5 anos,clasificacion a y b,2003-11-01,67,36,67,36,103
70703,CABEZAS,estado nutricional en menores de 5 anos,clasificacion a y b,2003-11-01,33,24,33,24,57
20905,CAIROMA,estado nutricional en menores de 5 anos,clasificacion a y b,2003-11-01,7,6,7,6,13
51102,"CAIZA ""D""",estado nutricional en menores de 5 anos,clasificacion a y b,2003-11-01,5,0,5,0,5
21003,CAJUATA,estado nutricional en menores de 5 anos,clasificacion a y b,2003-11-01,27,0,27,0,27
20303,CALACOTO,estado nutricional en menores de 5 anos,clasificacion a y b,2003-11-01,3,0,3,0,3
21304,CALAMARCA,estado nutricional en menores de 5 anos,clasificacion a y b,2003-11-01,10,0,10,0,10
10701,CAMARGO,estado nutricional en menores de 5 anos,clasificacion a y b,2003-11-01,25,10,25,10,35
10901,CAMATAQUI (C. VILLA ABECIA),estado nutricional en menores de 5 anos,clasificacion a y b,2003-11-01,9,0,9,0,9
70706,CAMIRI,estado nutricional en menores de 5 anos,clasificacion a y b,2003-11-01,92,19,92,19,111
30701,CAPINOTA,estado nutricional en menores de 5 anos,clasificacion a y b,2003-11-01,6,9,6,9,15
20302,CAQUIAVIRI,estado nutricional en menores de 5 anos,clasificacion a y b,2003-11-01,11,2,11,2,13
40102,CARACOLLO,estado nutricional en menores de 5 anos,clasificacion a y b,2003-11-01,15,4,15,4,19
22001,CARANAVI,estado nutricional en menores de 5 anos,clasificacion a y b,2003-11-01,180,25,180,25,205
60302,CARAPARI,estado nutricional en menores de 5 anos,clasificacion a y b,2003-11-01,26,3,26,3,29
50702,CARIPUYO,estado nutricional en menores de 5 anos,clasificacion a y b,2003-11-01,8,3,8,3,11
21803,CHACARILLA,estado nutricional en menores de 5 anos,clasificacion a y b,2003-11-01,5,1,5,1,6
40201,CHALLAPATA,estado nutricional en menores de 5 anos,clasificacion a y b,2003-11-01,14,7,14,7,21
50302,CHAQUI,estado nutricional en menores de 5 anos,clasificacion a y b,2003-11-01,5,0,5,0,5
70702,CHARAGUA,estado nutricional en menores de 5 anos,clasificacion a y b,2003-11-01,86,35,86,35,121
20305,CHARAÃ‘A,estado nutricional en menores de 5 anos,clasificacion a y b,2003-11-01,1,0,1,0,1
50202,CHAYANTA,estado nutricional en menores de 5 anos,clasificacion a y b,2003-11-01,10,5,10,5,15
31204,CHIMORE,estado nutricional en menores de 5 anos,clasificacion a y b,2003-11-01,25,9,25,9,34
40903,CHIPAYA,estado nutricional en menores de 5 anos,clasificacion a y b,2003-11-01,0,1,0,1,1
21101,CHULUMANI (V. DE LA LIBERTAD),estado nutricional en menores de 5 anos,clasificacion a y b,2003-11-01,4,0,4,0,4
20501,CHUMA,estado nutricional en menores de 5 anos,clasificacion a y b,2003-11-01,19,1,19,1,20
30801,CLIZA,estado nutricional en menores de 5 anos,clasificacion a y b,2003-11-01,0,1,0,1,1
90101,COBIJA,estado nutricional en menores de 5 anos,clasificacion a y b,2003-11-01,151,23,151,23,174
30101,COCHABAMBA,estado nutricional en menores de 5 anos,clasificacion a y b,2003-11-01,427,91,427,91,518
40902,COIPASA,estado nutricional en menores de 5 anos,clasificacion a y b,2003-11-01,0,1,0,1,1
30905,COLCAPIRHUA,estado nutricional en menores de 5 anos,clasificacion a y b,2003-11-01,47,11,47,11,58
50901,"COLCHA ""K""",estado nutricional en menores de 5 anos,clasificacion a y b,2003-11-01,9,5,9,5,14
21307,COLLANA,estado nutricional en menores de 5 anos,clasificacion a y b,2003-11-01,3,0,3,0,3
31002,COLOMI,estado nutricional en menores de 5 anos,clasificacion a y b,2003-11-01,23,6,23,6,29
50401,COLQUECHACA,estado nutricional en menores de 5 anos,clasificacion a y b,2003-11-01,24,29,24,29,53
21306,COLQUENCHA,estado nutricional en menores de 5 anos,clasificacion a y b,2003-11-01,28,0,28,0,28
21004,COLQUIRI,estado nutricional en menores de 5 anos,clasificacion a y b,2003-11-01,25,6,25,6,31
20304,COMANCHE,estado nutricional en menores de 5 anos,clasificacion a y b,2003-11-01,2,1,2,1,3
71301,COMARAPA,estado nutricional en menores de 5 anos,clasificacion a y b,2003-11-01,84,21,84,21,105
20605,COMBAYA,estado nutricional en menores de 5 anos,clasificacion a y b,2003-11-01,1,1,1,1,2
71101,CONCEPCION,estado nutricional en menores de 5 anos,clasificacion a y b,2003-11-01,14,3,14,3,17
21701,COPACABANA,estado nutricional en menores de 5 anos,clasificacion a y b,2003-11-01,23,1,23,1,24
21402,CORIPATA,estado nutricional en menores de 5 anos,clasificacion a y b,2003-11-01,27,0,27,0,27
20301,CORO CORO,estado nutricional en menores de 5 anos,clasificacion a y b,2003-11-01,3,4,3,4,7
21401,COROICO,estado nutricional en menores de 5 anos,clasificacion a y b,2003-11-01,24,14,24,14,38
40301,CORQUE,estado nutricional en menores de 5 anos,clasificacion a y b,2003-11-01,7,1,7,1,8
50601,COTAGAITA,estado nutricional en menores de 5 anos,clasificacion a y b,2003-11-01,34,13,34,13,47
31405,CUCHUMUELA (V. G. VILLARROEL),estado nutricional en menores de 5 anos,clasificacion a y b,2003-11-01,1,0,1,0,1
70704,CUEVO,estado nutricional en menores de 5 anos,clasificacion a y b,2003-11-01,7,1,7,1,8
10902,CULPINA,estado nutricional en menores de 5 anos,clasificacion a y b,2003-11-01,43,23,43,23,66
40401,CURAHUARA DE CARANGAS,estado nutricional en menores de 5 anos,clasificacion a y b,2003-11-01,4,0,4,0,4
21602,CURVA,estado nutricional en menores de 5 anos,clasificacion a y b,2003-11-01,4,1,4,1,5
20804,DESAGUADERO,estado nutricional en menores de 5 anos,clasificacion a y b,2003-11-01,3,2,3,2,5
20105,EL ALTO,estado nutricional en menores de 5 anos,clasificacion a y b,2003-11-01,689,165,689,165,854
40103,EL CHORO,estado nutricional en menores de 5 anos,clasificacion a y b,2003-11-01,5,4,5,4,9
71503,EL PUENTE(STC),estado nutricional en menores de 5 anos,clasificacion a y b,2003-11-01,27,18,27,18,45
60502,EL PUENTE(TJA),estado nutricional en menores de 5 anos,clasificacion a y b,2003-11-01,17,3,17,3,20
70105,EL TORNO,estado nutricional en menores de 5 anos,clasificacion a y b,2003-11-01,109,30,109,30,139
10405,EL VILLAR,estado nutricional en menores de 5 anos,clasificacion a y b,2003-11-01,10,4,10,4,14
60601,ENTRE RIOS,estado nutricional en menores de 5 anos,clasificacion a y b,2003-11-01,49,22,49,22,71
41101,EUCALIPTUS,estado nutricional en menores de 5 anos,clasificacion a y b,2003-11-01,9,9,9,9,18
80402,EXALTACION,estado nutricional en menores de 5 anos,clasificacion a y b,2003-11-01,4,6,4,6,10
90203,FILADELFIA,estado nutricional en menores de 5 anos,clasificacion a y b,2003-11-01,2,0,2,0,2
71002,GENERAL SAAVEDRA,estado nutricional en menores de 5 anos,clasificacion a y b,2003-11-01,73,37,73,37,110
21601,GRAL. J.J. PEREZ (CHARAZANI),estado nutricional en menores de 5 anos,clasificacion a y b,2003-11-01,36,7,36,7,43
20602,GUANAY,estado nutricional en menores de 5 anos,clasificacion a y b,2003-11-01,88,26,88,26,114
20802,GUAQUI,estado nutricional en menores de 5 anos,clasificacion a y b,2003-11-01,10,1,10,1,11
80202,GUAYARAMERIN,estado nutricional en menores de 5 anos,clasificacion a y b,2003-11-01,67,15,67,15,82
70705,GUTIERREZ,estado nutricional en menores de 5 anos,clasificacion a y b,2003-11-01,54,10,54,10,64
10502,HUACARETA,estado nutricional en menores de 5 anos,clasificacion a y b,2003-11-01,22,17,22,17,39
11002,HUACAYA (VILLA DE HUACAYA),estado nutricional en menores de 5 anos,clasificacion a y b,2003-11-01,6,3,6,3,9
40501,HUACHACALLA,estado nutricional en menores de 5 anos,clasificacion a y b,2003-11-01,2,0,2,0,2
40701,HUANUNI,estado nutricional en menores de 5 anos,clasificacion a y b,2003-11-01,29,2,29,2,31
80803,HUARACAJE,estado nutricional en menores de 5 anos,clasificacion a y b,2003-11-01,18,18,18,18,36
41601,HUAYLLAMARCA,estado nutricional en menores de 5 anos,clasificacion a y b,2003-11-01,1,0,1,0,1
21005,ICHOCA,estado nutricional en menores de 5 anos,clasificacion a y b,2003-11-01,17,18,17,18,35
10304,ICLA,estado nutricional en menores de 5 anos,clasificacion a y b,2003-11-01,20,2,20,2,22
10703,INCAHUASI,estado nutricional en menores de 5 anos,clasificacion a y b,2003-11-01,37,16,37,16,53
21001,INQUISIVI,estado nutricional en menores de 5 anos,clasificacion a y b,2003-11-01,31,28,31,28,59
21102,IRUPANA (VILLA DE LANZA),estado nutricional en menores de 5 anos,clasificacion a y b,2003-11-01,42,26,42,26,68
21501,IXIAMAS,estado nutricional en menores de 5 anos,clasificacion a y b,2003-11-01,24,9,24,9,33
21105,LA ASUNTA,estado nutricional en menores de 5 anos,clasificacion a y b,2003-11-01,69,1,69,1,70
70104,LA GUARDIA,estado nutricional en menores de 5 anos,clasificacion a y b,2003-11-01,112,21,112,21,133
20101,LA PAZ,estado nutricional en menores de 5 anos,clasificacion a y b,2003-11-01,629,233,629,233,862
70701,LAGUNILLAS,estado nutricional en menores de 5 anos,clasificacion a y b,2003-11-01,45,11,45,11,56
21202,LAJA,estado nutricional en menores de 5 anos,clasificacion a y b,2003-11-01,25,7,25,7,32
10903,LAS CARRERAS,estado nutricional en menores de 5 anos,clasificacion a y b,2003-11-01,12,6,12,6,18
21006,LICOMA PAMPA,estado nutricional en menores de 5 anos,clasificacion a y b,2003-11-01,1,0,1,0,1
50203,LLALLAGUA,estado nutricional en menores de 5 anos,clasificacion a y b,2003-11-01,92,76,92,76,168
51401,LLICA,estado nutricional en menores de 5 anos,clasificacion a y b,2003-11-01,1,1,1,1,2
80601,LORETO,estado nutricional en menores de 5 anos,clasificacion a y b,2003-11-01,7,4,7,4,11
20901,LURIBAY,estado nutricional en menores de 5 anos,clasificacion a y b,2003-11-01,4,0,4,0,4
40702,MACHACAMARCA,estado nutricional en menores de 5 anos,clasificacion a y b,2003-11-01,3,4,3,4,7
11003,MACHARETI,estado nutricional en menores de 5 anos,clasificacion a y b,2003-11-01,31,19,31,19,50
80801,MAGDALENA,estado nutricional en menores de 5 anos,clasificacion a y b,2003-11-01,20,7,20,7,27
70903,MAIRANA,estado nutricional en menores de 5 anos,clasificacion a y b,2003-11-01,24,2,24,2,26
20103,MECAPACA,estado nutricional en menores de 5 anos,clasificacion a y b,2003-11-01,4,6,4,6,10
31301,MIZQUE,estado nutricional en menores de 5 anos,clasificacion a y b,2003-11-01,15,2,15,2,17
20402,MOCOMOCO,estado nutricional en menores de 5 anos,clasificacion a y b,2003-11-01,19,8,19,8,27
51002,MOJINETE,estado nutricional en menores de 5 anos,clasificacion a y b,2003-11-01,0,1,0,1,1
10303,MOJOCOYA,estado nutricional en menores de 5 anos,clasificacion a y b,2003-11-01,36,13,36,13,49
10501,MONTEAGUDO,estado nutricional en menores de 5 anos,clasificacion a y b,2003-11-01,78,24,78,24,102
70803,MORO MORO,estado nutricional en menores de 5 anos,clasificacion a y b,2003-11-01,8,0,8,0,8
30302,MOROCHATA,estado nutricional en menores de 5 anos,clasificacion a y b,2003-11-01,12,0,12,0,12
90401,NACEBE (SANTA ROSA DEL ABUNA),estado nutricional en menores de 5 anos,clasificacion a y b,2003-11-01,0,1,0,1,1
20307,NAZACARA DE PACAJES,estado nutricional en menores de 5 anos,clasificacion a y b,2003-11-01,4,0,4,0,4
50404,OCURI,estado nutricional en menores de 5 anos,clasificacion a y b,2003-11-01,16,4,16,4,20
30203,OMEREQUE,estado nutricional en menores de 5 anos,clasificacion a y b,2003-11-01,7,1,7,1,8
40101,ORURO,estado nutricional en menores de 5 anos,clasificacion a y b,2003-11-01,322,58,322,58,380
60201,PADCAYA,estado nutricional en menores de 5 anos,clasificacion a y b,2003-11-01,27,25,27,25,52
10401,PADILLA,estado nutricional en menores de 5 anos,clasificacion a y b,2003-11-01,48,8,48,8,56
70502,PAILON,estado nutricional en menores de 5 anos,clasificacion a y b,2003-11-01,29,21,29,21,50
20102,PALCA,estado nutricional en menores de 5 anos,clasificacion a y b,2003-11-01,2,3,2,3,5
21104,PALOS BLANCOS,estado nutricional en menores de 5 anos,clasificacion a y b,2003-11-01,55,13,55,13,68
40802,PAMPA AULLAGAS,estado nutricional en menores de 5 anos,clasificacion a y b,2003-11-01,10,1,10,1,11
70902,PAMPA GRANDE,estado nutricional en menores de 5 anos,clasificacion a y b,2003-11-01,14,3,14,3,17
21802,PAPEL PAMPA,estado nutricional en menores de 5 anos,clasificacion a y b,2003-11-01,0,1,0,1,1
30202,PASORAPA,estado nutricional en menores de 5 anos,clasificacion a y b,2003-11-01,2,0,2,0,2
21305,PATACAMAYA,estado nutricional en menores de 5 anos,clasificacion a y b,2003-11-01,25,3,25,3,28
40602,PAZÃ‘A,estado nutricional en menores de 5 anos,clasificacion a y b,2003-11-01,6,4,6,4,10
20702,PELECHUCO,estado nutricional en menores de 5 anos,clasificacion a y b,2003-11-01,4,2,4,2,6
50403,POCOATA,estado nutricional en menores de 5 anos,clasificacion a y b,2003-11-01,25,10,25,10,35
31203,POCONA,estado nutricional en menores de 5 anos,clasificacion a y b,2003-11-01,9,2,9,2,11
31202,POJO (CBBA),estado nutricional en menores de 5 anos,clasificacion a y b,2003-11-01,102,34,102,34,136
40601,POOPO,estado nutricional en menores de 5 anos,clasificacion a y b,2003-11-01,0,1,0,1,1
51203,PORCO,estado nutricional en menores de 5 anos,clasificacion a y b,2003-11-01,8,3,8,3,11
10103,POROMA,estado nutricional en menores de 5 anos,clasificacion a y b,2003-11-01,40,41,40,41,81
70103,PORONGO,estado nutricional en menores de 5 anos,clasificacion a y b,2003-11-01,15,4,15,4,19
70601,PORTACHUELO,estado nutricional en menores de 5 anos,clasificacion a y b,2003-11-01,102,31,102,31,133
90102,PORVENIR,estado nutricional en menores de 5 anos,clasificacion a y b,2003-11-01,5,3,5,3,8
70804,POSTRER VALLE,estado nutricional en menores de 5 anos,clasificacion a y b,2003-11-01,9,3,9,3,12
50101,POTOSI,estado nutricional en menores de 5 anos,clasificacion a y b,2003-11-01,136,9,136,9,145
10302,PRESTO,estado nutricional en menores de 5 anos,clasificacion a y b,2003-11-01,16,1,16,1,17
21201,PUCARANI,estado nutricional en menores de 5 anos,clasificacion a y b,2003-11-01,42,2,42,2,44
20401,PUERTO ACOSTA,estado nutricional en menores de 5 anos,clasificacion a y b,2003-11-01,32,19,32,19,51
20403,PUERTO CARABUCO,estado nutricional en menores de 5 anos,clasificacion a y b,2003-11-01,19,2,19,2,21
90301,PUERTO GONZALO MORENO,estado nutricional en menores de 5 anos,clasificacion a y b,2003-11-01,19,6,19,6,25
21204,PUERTO PEREZ,estado nutricional en menores de 5 anos,clasificacion a y b,2003-11-01,19,0,19,0,19
71402,PUERTO QUIJARRO,estado nutricional en menores de 5 anos,clasificacion a y b,2003-11-01,40,3,40,3,43
90201,PUERTO RICO,estado nutricional en menores de 5 anos,clasificacion a y b,2003-11-01,6,6,6,6,12
71401,PUERTO SUAREZ,estado nutricional en menores de 5 anos,clasificacion a y b,2003-11-01,75,10,75,10,85
31205,PUERTO VILLARROEL,estado nutricional en menores de 5 anos,clasificacion a y b,2003-11-01,139,87,139,87,226
51101,PUNA,estado nutricional en menores de 5 anos,clasificacion a y b,2003-11-01,39,9,39,9,48
31401,PUNATA,estado nutricional en menores de 5 anos,clasificacion a y b,2003-11-01,17,11,17,11,28
20604,QUIABAYA,estado nutricional en menores de 5 anos,clasificacion a y b,2003-11-01,9,1,9,1,10
30901,QUILLACOLLO,estado nutricional en menores de 5 anos,clasificacion a y b,2003-11-01,92,17,92,17,109
21002,QUIME,estado nutricional en menores de 5 anos,clasificacion a y b,2003-11-01,10,7,10,7,17
70904,QUIRUSILLAS,estado nutricional en menores de 5 anos,clasificacion a y b,2003-11-01,7,0,7,0,7
50402,RAVELO,estado nutricional en menores de 5 anos,clasificacion a y b,2003-11-01,7,1,7,1,8
80301,REYES,estado nutricional en menores de 5 anos,clasificacion a y b,2003-11-01,33,7,33,7,40
80201,RIBERALTA,estado nutricional en menores de 5 anos,clasificacion a y b,2003-11-01,153,53,153,53,206
70503,ROBORE,estado nutricional en menores de 5 anos,clasificacion a y b,2003-11-01,34,6,34,6,40
80304,RURRENABAQUE,estado nutricional en menores de 5 anos,clasificacion a y b,2003-11-01,47,3,47,3,50
40901,SABAYA,estado nutricional en menores de 5 anos,clasificacion a y b,2003-11-01,8,7,8,7,15
31001,SACABA,estado nutricional en menores de 5 anos,clasificacion a y b,2003-11-01,48,7,48,7,55
30404,SACABAMBA,estado nutricional en menores de 5 anos,clasificacion a y b,2003-11-01,3,1,3,1,4
50701,SACACA,estado nutricional en menores de 5 anos,clasificacion a y b,2003-11-01,9,4,9,4,13
71302,SAIPINA,estado nutricional en menores de 5 anos,clasificacion a y b,2003-11-01,66,17,66,17,83
40801,SALINAS DE GARCI MENDOZA,estado nutricional en menores de 5 anos,clasificacion a y b,2003-11-01,4,0,4,0,4
70901,SAMAIPATA,estado nutricional en menores de 5 anos,clasificacion a y b,2003-11-01,52,11,52,11,63
51601,SAN AGUSTIN,estado nutricional en menores de 5 anos,clasificacion a y b,2003-11-01,1,0,1,0,1
80602,SAN ANDRES,estado nutricional en menores de 5 anos,clasificacion a y b,2003-11-01,14,1,14,1,15
71105,SAN ANTONIO DE LOMERIO,estado nutricional en menores de 5 anos,clasificacion a y b,2003-11-01,18,6,18,6,24
31403,SAN BENITO,estado nutricional en menores de 5 anos,clasificacion a y b,2003-11-01,1,0,1,0,1
80302,SAN BORJA,estado nutricional en menores de 5 anos,clasificacion a y b,2003-11-01,84,8,84,8,92
21502,SAN BUENA VENTURA,estado nutricional en menores de 5 anos,clasificacion a y b,2003-11-01,21,1,21,1,22
70402,SAN CARLOS,estado nutricional en menores de 5 anos,clasificacion a y b,2003-11-01,90,42,90,42,132
80501,SAN IGNACIO,estado nutricional en menores de 5 anos,clasificacion a y b,2003-11-01,63,25,63,25,88
70301,SAN IGNACIO DE VELASCO,estado nutricional en menores de 5 anos,clasificacion a y b,2003-11-01,187,9,187,9,196
80102,SAN JAVIER(BNI),estado nutricional en menores de 5 anos,clasificacion a y b,2003-11-01,3,2,3,2,5
71102,SAN JAVIER(STC),estado nutricional en menores de 5 anos,clasificacion a y b,2003-11-01,56,4,56,4,60
80701,SAN JOAQUIN,estado nutricional en menores de 5 anos,clasificacion a y b,2003-11-01,7,3,7,3,10
70501,SAN JOSE DE CHIQUITOS,estado nutricional en menores de 5 anos,clasificacion a y b,2003-11-01,45,8,45,8,53
71104,SAN JULIAN,estado nutricional en menores de 5 anos,clasificacion a y b,2003-11-01,181,54,181,54,235
90302,SAN LORENZO(PND),estado nutricional en menores de 5 anos,clasificacion a y b,2003-11-01,4,0,4,0,4
60501,SAN LORENZO(TJA),estado nutricional en menores de 5 anos,clasificacion a y b,2003-11-01,22,11,22,11,33
10702,SAN LUCAS,estado nutricional en menores de 5 anos,clasificacion a y b,2003-11-01,63,30,63,30,93
70302,SAN MIGUEL DE VELASCO,estado nutricional en menores de 5 anos,clasificacion a y b,2003-11-01,15,2,15,2,17
51001,SAN PABLO DE LIPEZ,estado nutricional en menores de 5 anos,clasificacion a y b,2003-11-01,0,2,0,2,2
50501,SAN PEDRO DE BUENA VISTA,estado nutricional en menores de 5 anos,clasificacion a y b,2003-11-01,20,11,20,11,31
21801,SAN PEDRO DE CURAHUARA,estado nutricional en menores de 5 anos,clasificacion a y b,2003-11-01,7,2,7,2,9
50902,SAN PEDRO DE QUEMES,estado nutricional en menores de 5 anos,clasificacion a y b,2003-11-01,2,1,2,1,3
21702,SAN PEDRO DE TIQUINA,estado nutricional en menores de 5 anos,clasificacion a y b,2003-11-01,4,4,4,4,8
70303,SAN RAFAEL,estado nutricional en menores de 5 anos,clasificacion a y b,2003-11-01,10,2,10,2,12
80702,SAN RAMON,estado nutricional en menores de 5 anos,clasificacion a y b,2003-11-01,12,10,12,10,22
80702,SAN RAMON,estado nutricional en menores de 5 anos,clasificacion a y b,2003-11-01,1,1,1,1,2
80401,SANTA ANA,estado nutricional en menores de 5 anos,clasificacion a y b,2003-11-01,70,12,70,12,82
70101,SANTA CRUZ DE LA SIERRA,estado nutricional en menores de 5 anos,clasificacion a y b,2003-11-01,1229,347,1229,347,1576
80303,SANTA ROSA,estado nutricional en menores de 5 anos,clasificacion a y b,2003-11-01,30,6,30,6,36
70602,SANTA ROSA DEL SARA,estado nutricional en menores de 5 anos,clasificacion a y b,2003-11-01,15,2,15,2,17
20308,SANTIAGO DE CALLAPA,estado nutricional en menores de 5 anos,clasificacion a y b,2003-11-01,7,0,7,0,7
41401,SANTIAGO DE HUARI,estado nutricional en menores de 5 anos,clasificacion a y b,2003-11-01,11,2,11,2,13
21901,SANTIAGO DE MACHACA,estado nutricional en menores de 5 anos,clasificacion a y b,2003-11-01,2,1,2,1,3
30702,SANTIVAÃ‘ES,estado nutricional en menores de 5 anos,clasificacion a y b,2003-11-01,6,0,6,0,6
40202,SANTUARIO DE QUILLACAS,estado nutricional en menores de 5 anos,clasificacion a y b,2003-11-01,5,0,5,0,5
20902,SAPAHAQUI,estado nutricional en menores de 5 anos,clasificacion a y b,2003-11-01,11,3,11,3,14
90303,SENA,estado nutricional en menores de 5 anos,clasificacion a y b,2003-11-01,22,6,22,6,28
21301,SICA SICA (VILLA AROMA),estado nutricional en menores de 5 anos,clasificacion a y b,2003-11-01,15,3,15,3,18
30703,SICAYA,estado nutricional en menores de 5 anos,clasificacion a y b,2003-11-01,7,0,7,0,7
30902,SIPE SIPE,estado nutricional en menores de 5 anos,clasificacion a y b,2003-11-01,64,19,64,19,83
10403,SOPACHUY,estado nutricional en menores de 5 anos,clasificacion a y b,2003-11-01,14,3,14,3,17
20601,SORATA,estado nutricional en menores de 5 anos,clasificacion a y b,2003-11-01,27,6,27,6,33
10101,SUCRE,estado nutricional en menores de 5 anos,clasificacion a y b,2003-11-01,363,85,363,85,448
20603,TACACOMA,estado nutricional en menores de 5 anos,clasificacion a y b,2003-11-01,7,4,7,4,11
50303,TACOBAMBA,estado nutricional en menores de 5 anos,clasificacion a y b,2003-11-01,19,4,19,4,23
30602,TACOPAYA,estado nutricional en menores de 5 anos,clasificacion a y b,2003-11-01,4,1,4,1,5
51402,TAHUA,estado nutricional en menores de 5 anos,clasificacion a y b,2003-11-01,3,0,3,0,3
31101,TAPACARI,estado nutricional en menores de 5 anos,clasificacion a y b,2003-11-01,11,4,11,4,15
10601,TARABUCO,estado nutricional en menores de 5 anos,clasificacion a y b,2003-11-01,43,7,43,7,50
30401,TARATA,estado nutricional en menores de 5 anos,clasificacion a y b,2003-11-01,15,5,15,5,20
60101,TARIJA,estado nutricional en menores de 5 anos,clasificacion a y b,2003-11-01,311,94,311,94,405
10202,TARVITA,estado nutricional en menores de 5 anos,clasificacion a y b,2003-11-01,14,1,14,1,15
20803,TIAWANACU,estado nutricional en menores de 5 anos,clasificacion a y b,2003-11-01,14,3,14,3,17
50102,TINGUIPAYA,estado nutricional en menores de 5 anos,clasificacion a y b,2003-11-01,10,7,10,7,17
20606,TIPUANI,estado nutricional en menores de 5 anos,clasificacion a y b,2003-11-01,67,18,67,18,85
30903,TIQUIPAYA,estado nutricional en menores de 5 anos,clasificacion a y b,2003-11-01,12,3,12,3,15
31601,TIRAQUE (CBBA),estado nutricional en menores de 5 anos,clasificacion a y b,2003-11-01,98,18,98,18,116
21703,TITO YUPANQUI (PARQUIPUJIO),estado nutricional en menores de 5 anos,clasificacion a y b,2003-11-01,1,2,1,2,3
30802,TOCO,estado nutricional en menores de 5 anos,clasificacion a y b,2003-11-01,0,1,0,1,1
41502,TODOS SANTOS,estado nutricional en menores de 5 anos,clasificacion a y b,2003-11-01,1,2,1,2,3
30803,TOLATA,estado nutricional en menores de 5 anos,clasificacion a y b,2003-11-01,11,2,11,2,13
41001,TOLEDO,estado nutricional en menores de 5 anos,clasificacion a y b,2003-11-01,2,1,2,1,3
51202,TOMAVE,estado nutricional en menores de 5 anos,clasificacion a y b,2003-11-01,22,13,22,13,35
10402,TOMINA,estado nutricional en menores de 5 anos,clasificacion a y b,2003-11-01,30,3,30,3,33
50502,TORO TORO,estado nutricional en menores de 5 anos,clasificacion a y b,2003-11-01,17,4,17,4,21
31201,TOTORA(CBBA),estado nutricional en menores de 5 anos,clasificacion a y b,2003-11-01,25,3,25,3,28
41301,TOTORA(ORR),estado nutricional en menores de 5 anos,clasificacion a y b,2003-11-01,1,0,1,0,1
70802,TRIGAL,estado nutricional en menores de 5 anos,clasificacion a y b,2003-11-01,2,0,2,0,2
80101,TRINIDAD,estado nutricional en menores de 5 anos,clasificacion a y b,2003-11-01,216,96,216,96,312
50801,TUPIZA,estado nutricional en menores de 5 anos,clasificacion a y b,2003-11-01,61,24,61,24,85
40402,TURCO,estado nutricional en menores de 5 anos,clasificacion a y b,2003-11-01,8,1,8,1,9
21302,UMALA,estado nutricional en menores de 5 anos,clasificacion a y b,2003-11-01,25,20,25,20,45
50201,UNCIA,estado nutricional en menores de 5 anos,clasificacion a y b,2003-11-01,4,0,4,0,4
60401,URIONDO (A. CONCEPCION),estado nutricional en menores de 5 anos,clasificacion a y b,2003-11-01,40,13,40,13,53
71502,URUBICHA,estado nutricional en menores de 5 anos,clasificacion a y b,2003-11-01,1,0,1,0,1
51201,UYUNI,estado nutricional en menores de 5 anos,clasificacion a y b,2003-11-01,46,3,46,3,49
30502,VACAS,estado nutricional en menores de 5 anos,clasificacion a y b,2003-11-01,6,14,6,14,20
70801,VALLEGRANDE,estado nutricional en menores de 5 anos,clasificacion a y b,2003-11-01,16,1,16,1,17
20801,VIACHA,estado nutricional en menores de 5 anos,clasificacion a y b,2003-11-01,74,17,74,17,91
31302,VILA VILA,estado nutricional en menores de 5 anos,clasificacion a y b,2003-11-01,2,0,2,0,2
60303,VILLA MONTES,estado nutricional en menores de 5 anos,clasificacion a y b,2003-11-01,37,5,37,5,42
90502,VILLA NUEVA (LOMA ALTA),estado nutricional en menores de 5 anos,clasificacion a y b,2003-11-01,1,0,1,0,1
31402,VILLA RIVERO,estado nutricional en menores de 5 anos,clasificacion a y b,2003-11-01,7,1,7,1,8
10801,VILLA SERRANO,estado nutricional en menores de 5 anos,clasificacion a y b,2003-11-01,29,3,29,3,32
31003,VILLA TUNARI,estado nutricional en menores de 5 anos,clasificacion a y b,2003-11-01,86,16,86,16,102
11001,VILLA VACA GUZMAN (MUYUPAMPA),estado nutricional en menores de 5 anos,clasificacion a y b,2003-11-01,43,5,43,5,48
51501,VILLAZON,estado nutricional en menores de 5 anos,clasificacion a y b,2003-11-01,87,14,87,14,101
50602,VITICHI,estado nutricional en menores de 5 anos,clasificacion a y b,2003-11-01,19,6,19,6,25
20903,YACO,estado nutricional en menores de 5 anos,clasificacion a y b,2003-11-01,6,0,6,0,6
60301,YACUIBA,estado nutricional en menores de 5 anos,clasificacion a y b,2003-11-01,93,10,93,10,103
10602,YAMPARAEZ,estado nutricional en menores de 5 anos,clasificacion a y b,2003-11-01,33,7,33,7,40
21103,YANACACHI,estado nutricional en menores de 5 anos,clasificacion a y b,2003-11-01,5,0,5,0,5
70403,YAPACANI,estado nutricional en menores de 5 anos,clasificacion a y b,2003-11-01,142,36,142,36,178
50103,YOCALLA,estado nutricional en menores de 5 anos,clasificacion a y b,2003-11-01,4,2,4,2,6
10102,YOTALA,estado nutricional en menores de 5 anos,clasificacion a y b,2003-11-01,21,11,21,11,32
60402,YUNCHARA,estado nutricional en menores de 5 anos,clasificacion a y b,2003-11-01,11,6,11,6,17
10301,ZUDAÃ‘EZ,estado nutricional en menores de 5 anos,clasificacion a y b,2003-11-01,16,11,16,11,27
51302,ACACIO,estado nutricional en menores de 5 anos,clasificacion a y b,2003-12-01,4,1,4,1,5
20201,ACHACACHI,estado nutricional en menores de 5 anos,clasificacion a y b,2003-12-01,37,16,37,16,53
20104,ACHOCALLA,estado nutricional en menores de 5 anos,clasificacion a y b,2003-12-01,2,2,2,2,4
30201,AIQUILE,estado nutricional en menores de 5 anos,clasificacion a y b,2003-12-01,19,3,19,3,22
31303,ALALAY,estado nutricional en menores de 5 anos,clasificacion a y b,2003-12-01,1,0,1,0,1
10404,ALCALA,estado nutricional en menores de 5 anos,clasificacion a y b,2003-12-01,8,2,8,2,10
20202,ANCORAIMES,estado nutricional en menores de 5 anos,clasificacion a y b,2003-12-01,3,0,3,0,3
40603,ANTEQUERA,estado nutricional en menores de 5 anos,clasificacion a y b,2003-12-01,5,2,5,2,7
30402,ANZALDO,estado nutricional en menores de 5 anos,clasificacion a y b,2003-12-01,7,3,7,3,10
20701,APOLO,estado nutricional en menores de 5 anos,clasificacion a y b,2003-12-01,26,1,26,1,27
51301,ARAMPAMPA,estado nutricional en menores de 5 anos,clasificacion a y b,2003-12-01,2,3,2,3,5
30501,ARANI,estado nutricional en menores de 5 anos,clasificacion a y b,2003-12-01,2,0,2,0,2
71501,ASCENCION DE GUARAYOS,estado nutricional en menores de 5 anos,clasificacion a y b,2003-12-01,73,21,73,21,94
50802,ATOCHA,estado nutricional en menores de 5 anos,clasificacion a y b,2003-12-01,5,19,5,19,24
20503,AUCAPATA,estado nutricional en menores de 5 anos,clasificacion a y b,2003-12-01,6,4,6,4,10
20502,AYATA,estado nutricional en menores de 5 anos,clasificacion a y b,2003-12-01,2,0,2,0,2
21303,AYO AYO,estado nutricional en menores de 5 anos,clasificacion a y b,2003-12-01,10,0,10,0,10
30301,AYOPAYA (V. DE INDEPENDENCIA),estado nutricional en menores de 5 anos,clasificacion a y b,2003-12-01,35,11,35,11,46
10201,AZURDUY,estado nutricional en menores de 5 anos,clasificacion a y b,2003-12-01,16,5,16,5,21
21203,BATALLAS,estado nutricional en menores de 5 anos,clasificacion a y b,2003-12-01,19,1,19,1,20
80802,BAURES,estado nutricional en menores de 5 anos,clasificacion a y b,2003-12-01,16,3,16,3,19
41202,BELEN DE ANDAMARCA,estado nutricional en menores de 5 anos,clasificacion a y b,2003-12-01,1,0,1,0,1
50104,BELEN DE URMIRI,estado nutricional en menores de 5 anos,clasificacion a y b,2003-12-01,2,0,2,0,2
90104,BELLA FLOR,estado nutricional en menores de 5 anos,clasificacion a y b,2003-12-01,9,4,9,4,13
60202,BERMEJO,estado nutricional en menores de 5 anos,clasificacion a y b,2003-12-01,42,21,42,21,63
50301,BETANZOS,estado nutricional en menores de 5 anos,clasificacion a y b,2003-12-01,35,4,35,4,39
90103,BOLPEBRA,estado nutricional en menores de 5 anos,clasificacion a y b,2003-12-01,1,0,1,0,1
70707,BOYUIBE,estado nutricional en menores de 5 anos,clasificacion a y b,2003-12-01,18,7,18,7,25
70401,BUENA VISTA,estado nutricional en menores de 5 anos,clasificacion a y b,2003-12-01,65,23,65,23,88
70703,CABEZAS,estado nutricional en menores de 5 anos,clasificacion a y b,2003-12-01,7,5,7,5,12
20905,CAIROMA,estado nutricional en menores de 5 anos,clasificacion a y b,2003-12-01,5,1,5,1,6
51102,"CAIZA ""D""",estado nutricional en menores de 5 anos,clasificacion a y b,2003-12-01,11,3,11,3,14
21003,CAJUATA,estado nutricional en menores de 5 anos,clasificacion a y b,2003-12-01,43,2,43,2,45
20303,CALACOTO,estado nutricional en menores de 5 anos,clasificacion a y b,2003-12-01,2,1,2,1,3
21304,CALAMARCA,estado nutricional en menores de 5 anos,clasificacion a y b,2003-12-01,25,0,25,0,25
10701,CAMARGO,estado nutricional en menores de 5 anos,clasificacion a y b,2003-12-01,13,1,13,1,14
10901,CAMATAQUI (C. VILLA ABECIA),estado nutricional en menores de 5 anos,clasificacion a y b,2003-12-01,6,1,6,1,7
70706,CAMIRI,estado nutricional en menores de 5 anos,clasificacion a y b,2003-12-01,71,13,71,13,84
30701,CAPINOTA,estado nutricional en menores de 5 anos,clasificacion a y b,2003-12-01,7,9,7,9,16
20302,CAQUIAVIRI,estado nutricional en menores de 5 anos,clasificacion a y b,2003-12-01,6,2,6,2,8
40102,CARACOLLO,estado nutricional en menores de 5 anos,clasificacion a y b,2003-12-01,19,8,19,8,27
22001,CARANAVI,estado nutricional en menores de 5 anos,clasificacion a y b,2003-12-01,110,17,110,17,127
60302,CARAPARI,estado nutricional en menores de 5 anos,clasificacion a y b,2003-12-01,35,12,35,12,47
50702,CARIPUYO,estado nutricional en menores de 5 anos,clasificacion a y b,2003-12-01,7,1,7,1,8
21803,CHACARILLA,estado nutricional en menores de 5 anos,clasificacion a y b,2003-12-01,3,2,3,2,5
40201,CHALLAPATA,estado nutricional en menores de 5 anos,clasificacion a y b,2003-12-01,10,7,10,7,17
50302,CHAQUI,estado nutricional en menores de 5 anos,clasificacion a y b,2003-12-01,13,0,13,0,13
70702,CHARAGUA,estado nutricional en menores de 5 anos,clasificacion a y b,2003-12-01,88,42,88,42,130
50202,CHAYANTA,estado nutricional en menores de 5 anos,clasificacion a y b,2003-12-01,31,8,31,8,39
31204,CHIMORE,estado nutricional en menores de 5 anos,clasificacion a y b,2003-12-01,37,16,37,16,53
21101,CHULUMANI (V. DE LA LIBERTAD),estado nutricional en menores de 5 anos,clasificacion a y b,2003-12-01,5,0,5,0,5
20501,CHUMA,estado nutricional en menores de 5 anos,clasificacion a y b,2003-12-01,4,1,4,1,5
30801,CLIZA,estado nutricional en menores de 5 anos,clasificacion a y b,2003-12-01,2,1,2,1,3
90101,COBIJA,estado nutricional en menores de 5 anos,clasificacion a y b,2003-12-01,95,7,95,7,102
30101,COCHABAMBA,estado nutricional en menores de 5 anos,clasificacion a y b,2003-12-01,1476,203,1476,203,1679
40902,COIPASA,estado nutricional en menores de 5 anos,clasificacion a y b,2003-12-01,1,1,1,1,2
30905,COLCAPIRHUA,estado nutricional en menores de 5 anos,clasificacion a y b,2003-12-01,35,6,35,6,41
50901,"COLCHA ""K""",estado nutricional en menores de 5 anos,clasificacion a y b,2003-12-01,8,1,8,1,9
21307,COLLANA,estado nutricional en menores de 5 anos,clasificacion a y b,2003-12-01,3,0,3,0,3
31002,COLOMI,estado nutricional en menores de 5 anos,clasificacion a y b,2003-12-01,28,8,28,8,36
50401,COLQUECHACA,estado nutricional en menores de 5 anos,clasificacion a y b,2003-12-01,36,30,36,30,66
21306,COLQUENCHA,estado nutricional en menores de 5 anos,clasificacion a y b,2003-12-01,13,3,13,3,16
21004,COLQUIRI,estado nutricional en menores de 5 anos,clasificacion a y b,2003-12-01,10,0,10,0,10
20304,COMANCHE,estado nutricional en menores de 5 anos,clasificacion a y b,2003-12-01,0,1,0,1,1
71301,COMARAPA,estado nutricional en menores de 5 anos,clasificacion a y b,2003-12-01,59,15,59,15,74
20605,COMBAYA,estado nutricional en menores de 5 anos,clasificacion a y b,2003-12-01,1,1,1,1,2
71101,CONCEPCION,estado nutricional en menores de 5 anos,clasificacion a y b,2003-12-01,15,13,15,13,28
21701,COPACABANA,estado nutricional en menores de 5 anos,clasificacion a y b,2003-12-01,14,0,14,0,14
21402,CORIPATA,estado nutricional en menores de 5 anos,clasificacion a y b,2003-12-01,15,1,15,1,16
20301,CORO CORO,estado nutricional en menores de 5 anos,clasificacion a y b,2003-12-01,1,0,1,0,1
21401,COROICO,estado nutricional en menores de 5 anos,clasificacion a y b,2003-12-01,46,11,46,11,57
40301,CORQUE,estado nutricional en menores de 5 anos,clasificacion a y b,2003-12-01,5,1,5,1,6
50601,COTAGAITA,estado nutricional en menores de 5 anos,clasificacion a y b,2003-12-01,21,9,21,9,30
31405,CUCHUMUELA (V. G. VILLARROEL),estado nutricional en menores de 5 anos,clasificacion a y b,2003-12-01,2,1,2,1,3
70704,CUEVO,estado nutricional en menores de 5 anos,clasificacion a y b,2003-12-01,4,3,4,3,7
10902,CULPINA,estado nutricional en menores de 5 anos,clasificacion a y b,2003-12-01,38,23,38,23,61
40401,CURAHUARA DE CARANGAS,estado nutricional en menores de 5 anos,clasificacion a y b,2003-12-01,4,0,4,0,4
20105,EL ALTO,estado nutricional en menores de 5 anos,clasificacion a y b,2003-12-01,660,173,660,173,833
40103,EL CHORO,estado nutricional en menores de 5 anos,clasificacion a y b,2003-12-01,3,2,3,2,5
71503,EL PUENTE(STC),estado nutricional en menores de 5 anos,clasificacion a y b,2003-12-01,7,2,7,2,9
60502,EL PUENTE(TJA),estado nutricional en menores de 5 anos,clasificacion a y b,2003-12-01,15,0,15,0,15
70105,EL TORNO,estado nutricional en menores de 5 anos,clasificacion a y b,2003-12-01,134,23,134,23,157
10405,EL VILLAR,estado nutricional en menores de 5 anos,clasificacion a y b,2003-12-01,15,4,15,4,19
60601,ENTRE RIOS,estado nutricional en menores de 5 anos,clasificacion a y b,2003-12-01,52,15,52,15,67
40502,ESCARA,estado nutricional en menores de 5 anos,clasificacion a y b,2003-12-01,1,0,1,0,1
41101,EUCALIPTUS,estado nutricional en menores de 5 anos,clasificacion a y b,2003-12-01,1,0,1,0,1
80402,EXALTACION,estado nutricional en menores de 5 anos,clasificacion a y b,2003-12-01,3,4,3,4,7
71002,GENERAL SAAVEDRA,estado nutricional en menores de 5 anos,clasificacion a y b,2003-12-01,77,58,77,58,135
21601,GRAL. J.J. PEREZ (CHARAZANI),estado nutricional en menores de 5 anos,clasificacion a y b,2003-12-01,19,5,19,5,24
20602,GUANAY,estado nutricional en menores de 5 anos,clasificacion a y b,2003-12-01,72,23,72,23,95
20802,GUAQUI,estado nutricional en menores de 5 anos,clasificacion a y b,2003-12-01,4,1,4,1,5
80202,GUAYARAMERIN,estado nutricional en menores de 5 anos,clasificacion a y b,2003-12-01,125,19,125,19,144
70705,GUTIERREZ,estado nutricional en menores de 5 anos,clasificacion a y b,2003-12-01,53,16,53,16,69
10502,HUACARETA,estado nutricional en menores de 5 anos,clasificacion a y b,2003-12-01,29,18,29,18,47
11002,HUACAYA (VILLA DE HUACAYA),estado nutricional en menores de 5 anos,clasificacion a y b,2003-12-01,8,1,8,1,9
40501,HUACHACALLA,estado nutricional en menores de 5 anos,clasificacion a y b,2003-12-01,1,2,1,2,3
40701,HUANUNI,estado nutricional en menores de 5 anos,clasificacion a y b,2003-12-01,39,1,39,1,40
80803,HUARACAJE,estado nutricional en menores de 5 anos,clasificacion a y b,2003-12-01,11,3,11,3,14
21005,ICHOCA,estado nutricional en menores de 5 anos,clasificacion a y b,2003-12-01,2,3,2,3,5
10304,ICLA,estado nutricional en menores de 5 anos,clasificacion a y b,2003-12-01,14,5,14,5,19
10703,INCAHUASI,estado nutricional en menores de 5 anos,clasificacion a y b,2003-12-01,9,0,9,0,9
21001,INQUISIVI,estado nutricional en menores de 5 anos,clasificacion a y b,2003-12-01,16,3,16,3,19
21102,IRUPANA (VILLA DE LANZA),estado nutricional en menores de 5 anos,clasificacion a y b,2003-12-01,32,33,32,33,65
21501,IXIAMAS,estado nutricional en menores de 5 anos,clasificacion a y b,2003-12-01,26,13,26,13,39
21105,LA ASUNTA,estado nutricional en menores de 5 anos,clasificacion a y b,2003-12-01,46,6,46,6,52
70104,LA GUARDIA,estado nutricional en menores de 5 anos,clasificacion a y b,2003-12-01,114,18,114,18,132
20101,LA PAZ,estado nutricional en menores de 5 anos,clasificacion a y b,2003-12-01,615,154,615,154,769
70701,LAGUNILLAS,estado nutricional en menores de 5 anos,clasificacion a y b,2003-12-01,11,5,11,5,16
21202,LAJA,estado nutricional en menores de 5 anos,clasificacion a y b,2003-12-01,19,8,19,8,27
10903,LAS CARRERAS,estado nutricional en menores de 5 anos,clasificacion a y b,2003-12-01,8,9,8,9,17
21006,LICOMA PAMPA,estado nutricional en menores de 5 anos,clasificacion a y b,2003-12-01,2,0,2,0,2
50203,LLALLAGUA,estado nutricional en menores de 5 anos,clasificacion a y b,2003-12-01,48,41,48,41,89
51401,LLICA,estado nutricional en menores de 5 anos,clasificacion a y b,2003-12-01,3,2,3,2,5
80601,LORETO,estado nutricional en menores de 5 anos,clasificacion a y b,2003-12-01,1,4,1,4,5
20901,LURIBAY,estado nutricional en menores de 5 anos,clasificacion a y b,2003-12-01,16,2,16,2,18
40702,MACHACAMARCA,estado nutricional en menores de 5 anos,clasificacion a y b,2003-12-01,3,5,3,5,8
11003,MACHARETI,estado nutricional en menores de 5 anos,clasificacion a y b,2003-12-01,26,13,26,13,39
80801,MAGDALENA,estado nutricional en menores de 5 anos,clasificacion a y b,2003-12-01,23,4,23,4,27
70903,MAIRANA,estado nutricional en menores de 5 anos,clasificacion a y b,2003-12-01,48,8,48,8,56
20904,MALLA,estado nutricional en menores de 5 anos,clasificacion a y b,2003-12-01,1,1,1,1,2
20103,MECAPACA,estado nutricional en menores de 5 anos,clasificacion a y b,2003-12-01,18,11,18,11,29
71003,MINEROS,estado nutricional en menores de 5 anos,clasificacion a y b,2003-12-01,156,28,156,28,184
31301,MIZQUE,estado nutricional en menores de 5 anos,clasificacion a y b,2003-12-01,6,0,6,0,6
20402,MOCOMOCO,estado nutricional en menores de 5 anos,clasificacion a y b,2003-12-01,13,0,13,0,13
51002,MOJINETE,estado nutricional en menores de 5 anos,clasificacion a y b,2003-12-01,1,2,1,2,3
10303,MOJOCOYA,estado nutricional en menores de 5 anos,clasificacion a y b,2003-12-01,28,11,28,11,39
10501,MONTEAGUDO,estado nutricional en menores de 5 anos,clasificacion a y b,2003-12-01,77,20,77,20,97
71001,MONTERO,estado nutricional en menores de 5 anos,clasificacion a y b,2003-12-01,253,66,253,66,319
70803,MORO MORO,estado nutricional en menores de 5 anos,clasificacion a y b,2003-12-01,2,0,2,0,2
30302,MOROCHATA,estado nutricional en menores de 5 anos,clasificacion a y b,2003-12-01,10,1,10,1,11
50404,OCURI,estado nutricional en menores de 5 anos,clasificacion a y b,2003-12-01,4,4,4,4,8
30203,OMEREQUE,estado nutricional en menores de 5 anos,clasificacion a y b,2003-12-01,5,2,5,2,7
40101,ORURO,estado nutricional en menores de 5 anos,clasificacion a y b,2003-12-01,306,56,306,56,362
60201,PADCAYA,estado nutricional en menores de 5 anos,clasificacion a y b,2003-12-01,35,24,35,24,59
10401,PADILLA,estado nutricional en menores de 5 anos,clasificacion a y b,2003-12-01,35,2,35,2,37
20102,PALCA,estado nutricional en menores de 5 anos,clasificacion a y b,2003-12-01,16,7,16,7,23
21104,PALOS BLANCOS,estado nutricional en menores de 5 anos,clasificacion a y b,2003-12-01,23,3,23,3,26
40802,PAMPA AULLAGAS,estado nutricional en menores de 5 anos,clasificacion a y b,2003-12-01,2,0,2,0,2
70902,PAMPA GRANDE,estado nutricional en menores de 5 anos,clasificacion a y b,2003-12-01,19,1,19,1,20
21802,PAPEL PAMPA,estado nutricional en menores de 5 anos,clasificacion a y b,2003-12-01,6,1,6,1,7
30202,PASORAPA,estado nutricional en menores de 5 anos,clasificacion a y b,2003-12-01,5,2,5,2,7
21305,PATACAMAYA,estado nutricional en menores de 5 anos,clasificacion a y b,2003-12-01,30,7,30,7,37
40602,PAZÃ‘A,estado nutricional en menores de 5 anos,clasificacion a y b,2003-12-01,8,0,8,0,8
20702,PELECHUCO,estado nutricional en menores de 5 anos,clasificacion a y b,2003-12-01,2,0,2,0,2
50403,POCOATA,estado nutricional en menores de 5 anos,clasificacion a y b,2003-12-01,19,7,19,7,26
31203,POCONA,estado nutricional en menores de 5 anos,clasificacion a y b,2003-12-01,6,2,6,2,8
31202,POJO (CBBA),estado nutricional en menores de 5 anos,clasificacion a y b,2003-12-01,96,40,96,40,136
40601,POOPO,estado nutricional en menores de 5 anos,clasificacion a y b,2003-12-01,0,1,0,1,1
51203,PORCO,estado nutricional en menores de 5 anos,clasificacion a y b,2003-12-01,6,4,6,4,10
10103,POROMA,estado nutricional en menores de 5 anos,clasificacion a y b,2003-12-01,26,8,26,8,34
70103,PORONGO,estado nutricional en menores de 5 anos,clasificacion a y b,2003-12-01,9,0,9,0,9
70601,PORTACHUELO,estado nutricional en menores de 5 anos,clasificacion a y b,2003-12-01,94,43,94,43,137
90102,PORVENIR,estado nutricional en menores de 5 anos,clasificacion a y b,2003-12-01,8,3,8,3,11
50101,POTOSI,estado nutricional en menores de 5 anos,clasificacion a y b,2003-12-01,135,7,135,7,142
10302,PRESTO,estado nutricional en menores de 5 anos,clasificacion a y b,2003-12-01,18,3,18,3,21
70805,PUCARA,estado nutricional en menores de 5 anos,clasificacion a y b,2003-12-01,4,3,4,3,7
21201,PUCARANI,estado nutricional en menores de 5 anos,clasificacion a y b,2003-12-01,31,1,31,1,32
20401,PUERTO ACOSTA,estado nutricional en menores de 5 anos,clasificacion a y b,2003-12-01,11,5,11,5,16
20403,PUERTO CARABUCO,estado nutricional en menores de 5 anos,clasificacion a y b,2003-12-01,18,0,18,0,18
90301,PUERTO GONZALO MORENO,estado nutricional en menores de 5 anos,clasificacion a y b,2003-12-01,2,1,2,1,3
21204,PUERTO PEREZ,estado nutricional en menores de 5 anos,clasificacion a y b,2003-12-01,13,0,13,0,13
90201,PUERTO RICO,estado nutricional en menores de 5 anos,clasificacion a y b,2003-12-01,0,2,0,2,2
80703,PUERTO SILES,estado nutricional en menores de 5 anos,clasificacion a y b,2003-12-01,6,3,6,3,9
31205,PUERTO VILLARROEL,estado nutricional en menores de 5 anos,clasificacion a y b,2003-12-01,138,91,138,91,229
51101,PUNA,estado nutricional en menores de 5 anos,clasificacion a y b,2003-12-01,33,12,33,12,45
31401,PUNATA,estado nutricional en menores de 5 anos,clasificacion a y b,2003-12-01,28,7,28,7,35
20604,QUIABAYA,estado nutricional en menores de 5 anos,clasificacion a y b,2003-12-01,4,0,4,0,4
30901,QUILLACOLLO,estado nutricional en menores de 5 anos,clasificacion a y b,2003-12-01,118,53,118,53,171
21002,QUIME,estado nutricional en menores de 5 anos,clasificacion a y b,2003-12-01,5,2,5,2,7
70904,QUIRUSILLAS,estado nutricional en menores de 5 anos,clasificacion a y b,2003-12-01,6,0,6,0,6
50402,RAVELO,estado nutricional en menores de 5 anos,clasificacion a y b,2003-12-01,10,8,10,8,18
80301,REYES,estado nutricional en menores de 5 anos,clasificacion a y b,2003-12-01,57,36,57,36,93
80201,RIBERALTA,estado nutricional en menores de 5 anos,clasificacion a y b,2003-12-01,109,22,109,22,131
80304,RURRENABAQUE,estado nutricional en menores de 5 anos,clasificacion a y b,2003-12-01,3,1,3,1,4
31001,SACABA,estado nutricional en menores de 5 anos,clasificacion a y b,2003-12-01,64,7,64,7,71
50701,SACACA,estado nutricional en menores de 5 anos,clasificacion a y b,2003-12-01,7,2,7,2,9
71302,SAIPINA,estado nutricional en menores de 5 anos,clasificacion a y b,2003-12-01,50,29,50,29,79
40801,SALINAS DE GARCI MENDOZA,estado nutricional en menores de 5 anos,clasificacion a y b,2003-12-01,8,3,8,3,11
70901,SAMAIPATA,estado nutricional en menores de 5 anos,clasificacion a y b,2003-12-01,30,13,30,13,43
51601,SAN AGUSTIN,estado nutricional en menores de 5 anos,clasificacion a y b,2003-12-01,4,0,4,0,4
80602,SAN ANDRES,estado nutricional en menores de 5 anos,clasificacion a y b,2003-12-01,6,2,6,2,8
31403,SAN BENITO,estado nutricional en menores de 5 anos,clasificacion a y b,2003-12-01,5,0,5,0,5
80302,SAN BORJA,estado nutricional en menores de 5 anos,clasificacion a y b,2003-12-01,94,12,94,12,106
21502,SAN BUENA VENTURA,estado nutricional en menores de 5 anos,clasificacion a y b,2003-12-01,19,1,19,1,20
70402,SAN CARLOS,estado nutricional en menores de 5 anos,clasificacion a y b,2003-12-01,87,52,87,52,139
80501,SAN IGNACIO,estado nutricional en menores de 5 anos,clasificacion a y b,2003-12-01,28,8,28,8,36
70301,SAN IGNACIO DE VELASCO,estado nutricional en menores de 5 anos,clasificacion a y b,2003-12-01,144,12,144,12,156
80102,SAN JAVIER(BNI),estado nutricional en menores de 5 anos,clasificacion a y b,2003-12-01,2,0,2,0,2
71102,SAN JAVIER(STC),estado nutricional en menores de 5 anos,clasificacion a y b,2003-12-01,48,3,48,3,51
80701,SAN JOAQUIN,estado nutricional en menores de 5 anos,clasificacion a y b,2003-12-01,12,6,12,6,18
71104,SAN JULIAN,estado nutricional en menores de 5 anos,clasificacion a y b,2003-12-01,101,33,101,33,134
90302,SAN LORENZO(PND),estado nutricional en menores de 5 anos,clasificacion a y b,2003-12-01,1,0,1,0,1
60501,SAN LORENZO(TJA),estado nutricional en menores de 5 anos,clasificacion a y b,2003-12-01,24,7,24,7,31
10702,SAN LUCAS,estado nutricional en menores de 5 anos,clasificacion a y b,2003-12-01,40,24,40,24,64
71201,SAN MATIAS,estado nutricional en menores de 5 anos,clasificacion a y b,2003-12-01,51,30,51,30,81
70302,SAN MIGUEL DE VELASCO,estado nutricional en menores de 5 anos,clasificacion a y b,2003-12-01,26,5,26,5,31
51001,SAN PABLO DE LIPEZ,estado nutricional en menores de 5 anos,clasificacion a y b,2003-12-01,3,0,3,0,3
50501,SAN PEDRO DE BUENA VISTA,estado nutricional en menores de 5 anos,clasificacion a y b,2003-12-01,11,4,11,4,15
21801,SAN PEDRO DE CURAHUARA,estado nutricional en menores de 5 anos,clasificacion a y b,2003-12-01,6,0,6,0,6
50902,SAN PEDRO DE QUEMES,estado nutricional en menores de 5 anos,clasificacion a y b,2003-12-01,1,0,1,0,1
21702,SAN PEDRO DE TIQUINA,estado nutricional en menores de 5 anos,clasificacion a y b,2003-12-01,1,2,1,2,3
70303,SAN RAFAEL,estado nutricional en menores de 5 anos,clasificacion a y b,2003-12-01,13,2,13,2,15
80702,SAN RAMON,estado nutricional en menores de 5 anos,clasificacion a y b,2003-12-01,10,20,10,20,30
80702,SAN RAMON,estado nutricional en menores de 5 anos,clasificacion a y b,2003-12-01,4,1,4,1,5
80401,SANTA ANA,estado nutricional en menores de 5 anos,clasificacion a y b,2003-12-01,72,16,72,16,88
70101,SANTA CRUZ DE LA SIERRA,estado nutricional en menores de 5 anos,clasificacion a y b,2003-12-01,1423,384,1423,384,1807
80303,SANTA ROSA,estado nutricional en menores de 5 anos,clasificacion a y b,2003-12-01,38,9,38,9,47
70602,SANTA ROSA DEL SARA,estado nutricional en menores de 5 anos,clasificacion a y b,2003-12-01,22,17,22,17,39
20308,SANTIAGO DE CALLAPA,estado nutricional en menores de 5 anos,clasificacion a y b,2003-12-01,6,0,6,0,6
41401,SANTIAGO DE HUARI,estado nutricional en menores de 5 anos,clasificacion a y b,2003-12-01,10,1,10,1,11
21901,SANTIAGO DE MACHACA,estado nutricional en menores de 5 anos,clasificacion a y b,2003-12-01,5,2,5,2,7
30702,SANTIVAÃ‘ES,estado nutricional en menores de 5 anos,clasificacion a y b,2003-12-01,3,0,3,0,3
40202,SANTUARIO DE QUILLACAS,estado nutricional en menores de 5 anos,clasificacion a y b,2003-12-01,2,0,2,0,2
20902,SAPAHAQUI,estado nutricional en menores de 5 anos,clasificacion a y b,2003-12-01,3,2,3,2,5
90303,SENA,estado nutricional en menores de 5 anos,clasificacion a y b,2003-12-01,13,4,13,4,17
21301,SICA SICA (VILLA AROMA),estado nutricional en menores de 5 anos,clasificacion a y b,2003-12-01,19,3,19,3,22
30703,SICAYA,estado nutricional en menores de 5 anos,clasificacion a y b,2003-12-01,2,2,2,2,4
30902,SIPE SIPE,estado nutricional en menores de 5 anos,clasificacion a y b,2003-12-01,53,9,53,9,62
10403,SOPACHUY,estado nutricional en menores de 5 anos,clasificacion a y b,2003-12-01,1,2,1,2,3
20601,SORATA,estado nutricional en menores de 5 anos,clasificacion a y b,2003-12-01,12,8,12,8,20
10101,SUCRE,estado nutricional en menores de 5 anos,clasificacion a y b,2003-12-01,268,62,268,62,330
20603,TACACOMA,estado nutricional en menores de 5 anos,clasificacion a y b,2003-12-01,10,6,10,6,16
50303,TACOBAMBA,estado nutricional en menores de 5 anos,clasificacion a y b,2003-12-01,24,11,24,11,35
30602,TACOPAYA,estado nutricional en menores de 5 anos,clasificacion a y b,2003-12-01,3,2,3,2,5
51402,TAHUA,estado nutricional en menores de 5 anos,clasificacion a y b,2003-12-01,1,0,1,0,1
31101,TAPACARI,estado nutricional en menores de 5 anos,clasificacion a y b,2003-12-01,13,1,13,1,14
10601,TARABUCO,estado nutricional en menores de 5 anos,clasificacion a y b,2003-12-01,33,9,33,9,42
30401,TARATA,estado nutricional en menores de 5 anos,clasificacion a y b,2003-12-01,21,3,21,3,24
60101,TARIJA,estado nutricional en menores de 5 anos,clasificacion a y b,2003-12-01,732,107,732,107,839
10202,TARVITA,estado nutricional en menores de 5 anos,clasificacion a y b,2003-12-01,6,6,6,6,12
20803,TIAWANACU,estado nutricional en menores de 5 anos,clasificacion a y b,2003-12-01,6,2,6,2,8
50102,TINGUIPAYA,estado nutricional en menores de 5 anos,clasificacion a y b,2003-12-01,10,6,10,6,16
20606,TIPUANI,estado nutricional en menores de 5 anos,clasificacion a y b,2003-12-01,46,7,46,7,53
30903,TIQUIPAYA,estado nutricional en menores de 5 anos,clasificacion a y b,2003-12-01,9,3,9,3,12
31601,TIRAQUE (CBBA),estado nutricional en menores de 5 anos,clasificacion a y b,2003-12-01,132,18,132,18,150
21703,TITO YUPANQUI (PARQUIPUJIO),estado nutricional en menores de 5 anos,clasificacion a y b,2003-12-01,2,2,2,2,4
30802,TOCO,estado nutricional en menores de 5 anos,clasificacion a y b,2003-12-01,2,3,2,3,5
30803,TOLATA,estado nutricional en menores de 5 anos,clasificacion a y b,2003-12-01,16,2,16,2,18
51202,TOMAVE,estado nutricional en menores de 5 anos,clasificacion a y b,2003-12-01,8,3,8,3,11
10402,TOMINA,estado nutricional en menores de 5 anos,clasificacion a y b,2003-12-01,26,3,26,3,29
50502,TORO TORO,estado nutricional en menores de 5 anos,clasificacion a y b,2003-12-01,17,7,17,7,24
31201,TOTORA(CBBA),estado nutricional en menores de 5 anos,clasificacion a y b,2003-12-01,19,2,19,2,21
41301,TOTORA(ORR),estado nutricional en menores de 5 anos,clasificacion a y b,2003-12-01,2,0,2,0,2
70802,TRIGAL,estado nutricional en menores de 5 anos,clasificacion a y b,2003-12-01,4,0,4,0,4
80101,TRINIDAD,estado nutricional en menores de 5 anos,clasificacion a y b,2003-12-01,246,58,246,58,304
50801,TUPIZA,estado nutricional en menores de 5 anos,clasificacion a y b,2003-12-01,56,25,56,25,81
40402,TURCO,estado nutricional en menores de 5 anos,clasificacion a y b,2003-12-01,2,2,2,2,4
21302,UMALA,estado nutricional en menores de 5 anos,clasificacion a y b,2003-12-01,14,21,14,21,35
50201,UNCIA,estado nutricional en menores de 5 anos,clasificacion a y b,2003-12-01,1,0,1,0,1
60401,URIONDO (A. CONCEPCION),estado nutricional en menores de 5 anos,clasificacion a y b,2003-12-01,52,24,52,24,76
71502,URUBICHA,estado nutricional en menores de 5 anos,clasificacion a y b,2003-12-01,18,7,18,7,25
51201,UYUNI,estado nutricional en menores de 5 anos,clasificacion a y b,2003-12-01,26,4,26,4,30
30502,VACAS,estado nutricional en menores de 5 anos,clasificacion a y b,2003-12-01,1,0,1,0,1
70801,VALLEGRANDE,estado nutricional en menores de 5 anos,clasificacion a y b,2003-12-01,43,5,43,5,48
20801,VIACHA,estado nutricional en menores de 5 anos,clasificacion a y b,2003-12-01,66,11,66,11,77
60303,VILLA MONTES,estado nutricional en menores de 5 anos,clasificacion a y b,2003-12-01,71,9,71,9,80
31402,VILLA RIVERO,estado nutricional en menores de 5 anos,clasificacion a y b,2003-12-01,17,1,17,1,18
10801,VILLA SERRANO,estado nutricional en menores de 5 anos,clasificacion a y b,2003-12-01,24,2,24,2,26
31003,VILLA TUNARI,estado nutricional en menores de 5 anos,clasificacion a y b,2003-12-01,53,22,53,22,75
11001,VILLA VACA GUZMAN (MUYUPAMPA),estado nutricional en menores de 5 anos,clasificacion a y b,2003-12-01,38,14,38,14,52
51501,VILLAZON,estado nutricional en menores de 5 anos,clasificacion a y b,2003-12-01,90,14,90,14,104
30904,VINTO,estado nutricional en menores de 5 anos,clasificacion a y b,2003-12-01,22,3,22,3,25
50602,VITICHI,estado nutricional en menores de 5 anos,clasificacion a y b,2003-12-01,10,1,10,1,11
20306,WALDO BALLIVIAN,estado nutricional en menores de 5 anos,clasificacion a y b,2003-12-01,2,0,2,0,2
20903,YACO,estado nutricional en menores de 5 anos,clasificacion a y b,2003-12-01,12,6,12,6,18
60301,YACUIBA,estado nutricional en menores de 5 anos,clasificacion a y b,2003-12-01,184,29,184,29,213
10602,YAMPARAEZ,estado nutricional en menores de 5 anos,clasificacion a y b,2003-12-01,31,6,31,6,37
21103,YANACACHI,estado nutricional en menores de 5 anos,clasificacion a y b,2003-12-01,5,1,5,1,6
70403,YAPACANI,estado nutricional en menores de 5 anos,clasificacion a y b,2003-12-01,154,14,154,14,168
10102,YOTALA,estado nutricional en menores de 5 anos,clasificacion a y b,2003-12-01,9,4,9,4,13
60402,YUNCHARA,estado nutricional en menores de 5 anos,clasificacion a y b,2003-12-01,6,4,6,4,10
10301,ZUDAÃ‘EZ,estado nutricional en menores de 5 anos,clasificacion a y b,2003-12-01,17,9,17,9,26
