codigo_municipio,municipio,grupo,variable,mes,Total-H,Total-M,TOTAL-H1,TOTAL-M1,TOTAL
51302,ACACIO,estado nutricional,clasificacion d,2004-01-01,42,80,42,80,122
20201,ACHACACHI,estado nutricional,clasificacion d,2004-01-01,122,144,122,144,266
20104,ACHOCALLA,estado nutricional,clasificacion d,2004-01-01,9,23,9,23,32
30201,AIQUILE,estado nutricional,clasificacion d,2004-01-01,45,90,45,90,135
31303,ALALAY,estado nutricional,clasificacion d,2004-01-01,11,5,11,5,16
10404,ALCALA,estado nutricional,clasificacion d,2004-01-01,32,75,32,75,107
20202,ANCORAIMES,estado nutricional,clasificacion d,2004-01-01,77,135,77,135,212
41201,ANDAMARCA,estado nutricional,clasificacion d,2004-01-01,8,13,8,13,21
40603,ANTEQUERA,estado nutricional,clasificacion d,2004-01-01,5,7,5,7,12
30402,ANZALDO,estado nutricional,clasificacion d,2004-01-01,7,8,7,8,15
20701,APOLO,estado nutricional,clasificacion d,2004-01-01,31,27,31,27,58
51301,ARAMPAMPA,estado nutricional,clasificacion d,2004-01-01,36,56,36,56,92
30501,ARANI,estado nutricional,clasificacion d,2004-01-01,21,18,21,18,39
30403,ARBIETO,estado nutricional,clasificacion d,2004-01-01,16,13,16,13,29
30601,ARQUE,estado nutricional,clasificacion d,2004-01-01,32,37,32,37,69
50802,ATOCHA,estado nutricional,clasificacion d,2004-01-01,32,128,32,128,160
20503,AUCAPATA,estado nutricional,clasificacion d,2004-01-01,11,11,11,11,22
20502,AYATA,estado nutricional,clasificacion d,2004-01-01,22,23,22,23,45
21303,AYO AYO,estado nutricional,clasificacion d,2004-01-01,14,8,14,8,22
30301,AYOPAYA (V. DE INDEPENDENCIA),estado nutricional,clasificacion d,2004-01-01,89,91,89,91,180
10201,AZURDUY,estado nutricional,clasificacion d,2004-01-01,139,258,139,258,397
21203,BATALLAS,estado nutricional,clasificacion d,2004-01-01,17,20,17,20,37
80802,BAURES,estado nutricional,clasificacion d,2004-01-01,7,13,7,13,20
41202,BELEN DE ANDAMARCA,estado nutricional,clasificacion d,2004-01-01,4,6,4,6,10
50104,BELEN DE URMIRI,estado nutricional,clasificacion d,2004-01-01,1,1,1,1,2
90104,BELLA FLOR,estado nutricional,clasificacion d,2004-01-01,7,18,7,18,25
60202,BERMEJO,estado nutricional,clasificacion d,2004-01-01,25,8,25,8,33
50301,BETANZOS,estado nutricional,clasificacion d,2004-01-01,152,260,152,260,412
31501,BOLIVAR,estado nutricional,clasificacion d,2004-01-01,71,82,71,82,153
90103,BOLPEBRA,estado nutricional,clasificacion d,2004-01-01,0,1,0,1,1
70707,BOYUIBE,estado nutricional,clasificacion d,2004-01-01,7,3,7,3,10
70401,BUENA VISTA,estado nutricional,clasificacion d,2004-01-01,0,2,0,2,2
70703,CABEZAS,estado nutricional,clasificacion d,2004-01-01,57,46,57,46,103
20905,CAIROMA,estado nutricional,clasificacion d,2004-01-01,32,31,32,31,63
51102,"CAIZA ""D""",estado nutricional,clasificacion d,2004-01-01,34,42,34,42,76
21003,CAJUATA,estado nutricional,clasificacion d,2004-01-01,35,34,35,34,69
20303,CALACOTO,estado nutricional,clasificacion d,2004-01-01,22,11,22,11,33
21304,CALAMARCA,estado nutricional,clasificacion d,2004-01-01,61,51,61,51,112
10701,CAMARGO,estado nutricional,clasificacion d,2004-01-01,109,147,109,147,256
10901,CAMATAQUI (C. VILLA ABECIA),estado nutricional,clasificacion d,2004-01-01,16,22,16,22,38
70706,CAMIRI,estado nutricional,clasificacion d,2004-01-01,144,102,144,102,246
30701,CAPINOTA,estado nutricional,clasificacion d,2004-01-01,17,31,17,31,48
20302,CAQUIAVIRI,estado nutricional,clasificacion d,2004-01-01,36,28,36,28,64
40102,CARACOLLO,estado nutricional,clasificacion d,2004-01-01,44,43,44,43,87
22001,CARANAVI,estado nutricional,clasificacion d,2004-01-01,161,153,161,153,314
41503,CARANGAS,estado nutricional,clasificacion d,2004-01-01,1,1,1,1,2
60302,CARAPARI,estado nutricional,clasificacion d,2004-01-01,29,39,29,39,68
50702,CARIPUYO,estado nutricional,clasificacion d,2004-01-01,73,123,73,123,196
21902,CATACORA,estado nutricional,clasificacion d,2004-01-01,8,13,8,13,21
21803,CHACARILLA,estado nutricional,clasificacion d,2004-01-01,5,7,5,7,12
40201,CHALLAPATA,estado nutricional,clasificacion d,2004-01-01,44,127,44,127,171
50302,CHAQUI,estado nutricional,clasificacion d,2004-01-01,31,39,31,39,70
70702,CHARAGUA,estado nutricional,clasificacion d,2004-01-01,100,104,100,104,204
20305,CHARAÃ‘A,estado nutricional,clasificacion d,2004-01-01,6,8,6,8,14
50202,CHAYANTA,estado nutricional,clasificacion d,2004-01-01,73,81,73,81,154
31204,CHIMORE,estado nutricional,clasificacion d,2004-01-01,35,41,35,41,76
40903,CHIPAYA,estado nutricional,clasificacion d,2004-01-01,2,1,2,1,3
21101,CHULUMANI (V. DE LA LIBERTAD),estado nutricional,clasificacion d,2004-01-01,3,7,3,7,10
20501,CHUMA,estado nutricional,clasificacion d,2004-01-01,20,40,20,40,60
30801,CLIZA,estado nutricional,clasificacion d,2004-01-01,23,22,23,22,45
90101,COBIJA,estado nutricional,clasificacion d,2004-01-01,109,97,109,97,206
30101,COCHABAMBA,estado nutricional,clasificacion d,2004-01-01,498,392,498,392,890
40902,COIPASA,estado nutricional,clasificacion d,2004-01-01,2,5,2,5,7
30905,COLCAPIRHUA,estado nutricional,clasificacion d,2004-01-01,43,32,43,32,75
50901,"COLCHA ""K""",estado nutricional,clasificacion d,2004-01-01,24,30,24,30,54
21307,COLLANA,estado nutricional,clasificacion d,2004-01-01,3,8,3,8,11
31002,COLOMI,estado nutricional,clasificacion d,2004-01-01,42,52,42,52,94
50401,COLQUECHACA,estado nutricional,clasificacion d,2004-01-01,169,116,169,116,285
21306,COLQUENCHA,estado nutricional,clasificacion d,2004-01-01,29,11,29,11,40
21004,COLQUIRI,estado nutricional,clasificacion d,2004-01-01,90,80,90,80,170
20304,COMANCHE,estado nutricional,clasificacion d,2004-01-01,10,15,10,15,25
71301,COMARAPA,estado nutricional,clasificacion d,2004-01-01,68,45,68,45,113
20605,COMBAYA,estado nutricional,clasificacion d,2004-01-01,7,9,7,9,16
71101,CONCEPCION,estado nutricional,clasificacion d,2004-01-01,37,16,37,16,53
21701,COPACABANA,estado nutricional,clasificacion d,2004-01-01,19,19,19,19,38
21402,CORIPATA,estado nutricional,clasificacion d,2004-01-01,5,0,5,0,5
20301,CORO CORO,estado nutricional,clasificacion d,2004-01-01,23,25,23,25,48
21401,COROICO,estado nutricional,clasificacion d,2004-01-01,18,11,18,11,29
40301,CORQUE,estado nutricional,clasificacion d,2004-01-01,22,13,22,13,35
50601,COTAGAITA,estado nutricional,clasificacion d,2004-01-01,140,196,140,196,336
70102,COTOCA,estado nutricional,clasificacion d,2004-01-01,62,29,62,29,91
31405,CUCHUMUELA (V. G. VILLARROEL),estado nutricional,clasificacion d,2004-01-01,4,9,4,9,13
70704,CUEVO,estado nutricional,clasificacion d,2004-01-01,9,10,9,10,19
10902,CULPINA,estado nutricional,clasificacion d,2004-01-01,158,180,158,180,338
40401,CURAHUARA DE CARANGAS,estado nutricional,clasificacion d,2004-01-01,12,6,12,6,18
21602,CURVA,estado nutricional,clasificacion d,2004-01-01,13,25,13,25,38
20804,DESAGUADERO,estado nutricional,clasificacion d,2004-01-01,13,13,13,13,26
20105,EL ALTO,estado nutricional,clasificacion d,2004-01-01,1606,951,1606,951,2557
40103,EL CHORO,estado nutricional,clasificacion d,2004-01-01,11,10,11,10,21
71503,EL PUENTE(STC),estado nutricional,clasificacion d,2004-01-01,75,55,75,55,130
60502,EL PUENTE(TJA),estado nutricional,clasificacion d,2004-01-01,54,84,54,84,138
70105,EL TORNO,estado nutricional,clasificacion d,2004-01-01,70,94,70,94,164
10405,EL VILLAR,estado nutricional,clasificacion d,2004-01-01,47,134,47,134,181
60601,ENTRE RIOS,estado nutricional,clasificacion d,2004-01-01,45,71,45,71,116
41101,EUCALIPTUS,estado nutricional,clasificacion d,2004-01-01,16,13,16,13,29
90503,EUREKA (SANTOS MERCADO),estado nutricional,clasificacion d,2004-01-01,1,0,1,0,1
80402,EXALTACION,estado nutricional,clasificacion d,2004-01-01,11,14,11,14,25
90203,FILADELFIA,estado nutricional,clasificacion d,2004-01-01,1,2,1,2,3
71002,GENERAL SAAVEDRA,estado nutricional,clasificacion d,2004-01-01,128,175,128,175,303
21601,GRAL. J.J. PEREZ (CHARAZANI),estado nutricional,clasificacion d,2004-01-01,16,38,16,38,54
20602,GUANAY,estado nutricional,clasificacion d,2004-01-01,136,127,136,127,263
20802,GUAQUI,estado nutricional,clasificacion d,2004-01-01,12,7,12,7,19
80202,GUAYARAMERIN,estado nutricional,clasificacion d,2004-01-01,126,107,126,107,233
70705,GUTIERREZ,estado nutricional,clasificacion d,2004-01-01,88,176,88,176,264
10502,HUACARETA,estado nutricional,clasificacion d,2004-01-01,55,85,55,85,140
11002,HUACAYA (VILLA DE HUACAYA),estado nutricional,clasificacion d,2004-01-01,21,29,21,29,50
40501,HUACHACALLA,estado nutricional,clasificacion d,2004-01-01,4,4,4,4,8
40701,HUANUNI,estado nutricional,clasificacion d,2004-01-01,72,60,72,60,132
80803,HUARACAJE,estado nutricional,clasificacion d,2004-01-01,11,5,11,5,16
41601,HUAYLLAMARCA,estado nutricional,clasificacion d,2004-01-01,4,3,4,3,7
21005,ICHOCA,estado nutricional,clasificacion d,2004-01-01,16,32,16,32,48
10304,ICLA,estado nutricional,clasificacion d,2004-01-01,89,202,89,202,291
10703,INCAHUASI,estado nutricional,clasificacion d,2004-01-01,210,225,210,225,435
21001,INQUISIVI,estado nutricional,clasificacion d,2004-01-01,65,71,65,71,136
21102,IRUPANA (VILLA DE LANZA),estado nutricional,clasificacion d,2004-01-01,26,37,26,37,63
21501,IXIAMAS,estado nutricional,clasificacion d,2004-01-01,24,34,24,34,58
21105,LA ASUNTA,estado nutricional,clasificacion d,2004-01-01,42,34,42,34,76
70104,LA GUARDIA,estado nutricional,clasificacion d,2004-01-01,93,60,93,60,153
20101,LA PAZ,estado nutricional,clasificacion d,2004-01-01,1276,1089,1276,1089,2365
70701,LAGUNILLAS,estado nutricional,clasificacion d,2004-01-01,23,23,23,23,46
21202,LAJA,estado nutricional,clasificacion d,2004-01-01,18,15,18,15,33
10903,LAS CARRERAS,estado nutricional,clasificacion d,2004-01-01,13,26,13,26,39
21006,LICOMA PAMPA,estado nutricional,clasificacion d,2004-01-01,1,3,1,3,4
50203,LLALLAGUA,estado nutricional,clasificacion d,2004-01-01,91,242,91,242,333
51401,LLICA,estado nutricional,clasificacion d,2004-01-01,10,12,10,12,22
80601,LORETO,estado nutricional,clasificacion d,2004-01-01,5,14,5,14,19
20901,LURIBAY,estado nutricional,clasificacion d,2004-01-01,31,21,31,21,52
40702,MACHACAMARCA,estado nutricional,clasificacion d,2004-01-01,12,9,12,9,21
11003,MACHARETI,estado nutricional,clasificacion d,2004-01-01,29,116,29,116,145
80801,MAGDALENA,estado nutricional,clasificacion d,2004-01-01,40,43,40,43,83
70903,MAIRANA,estado nutricional,clasificacion d,2004-01-01,27,9,27,9,36
20904,MALLA,estado nutricional,clasificacion d,2004-01-01,2,1,2,1,3
20103,MECAPACA,estado nutricional,clasificacion d,2004-01-01,14,10,14,10,24
71003,MINEROS,estado nutricional,clasificacion d,2004-01-01,141,111,141,111,252
31301,MIZQUE,estado nutricional,clasificacion d,2004-01-01,40,47,40,47,87
20402,MOCOMOCO,estado nutricional,clasificacion d,2004-01-01,35,63,35,63,98
51002,MOJINETE,estado nutricional,clasificacion d,2004-01-01,6,10,6,10,16
10303,MOJOCOYA,estado nutricional,clasificacion d,2004-01-01,51,109,51,109,160
10501,MONTEAGUDO,estado nutricional,clasificacion d,2004-01-01,110,220,110,220,330
71001,MONTERO,estado nutricional,clasificacion d,2004-01-01,322,224,322,224,546
70803,MORO MORO,estado nutricional,clasificacion d,2004-01-01,3,11,3,11,14
30302,MOROCHATA,estado nutricional,clasificacion d,2004-01-01,34,35,34,35,69
50404,OCURI,estado nutricional,clasificacion d,2004-01-01,74,84,74,84,158
70202,OKINAWA,estado nutricional,clasificacion d,2004-01-01,22,21,22,21,43
30203,OMEREQUE,estado nutricional,clasificacion d,2004-01-01,18,4,18,4,22
40101,ORURO,estado nutricional,clasificacion d,2004-01-01,551,528,551,528,1079
60201,PADCAYA,estado nutricional,clasificacion d,2004-01-01,51,55,51,55,106
10401,PADILLA,estado nutricional,clasificacion d,2004-01-01,107,198,107,198,305
70502,PAILON,estado nutricional,clasificacion d,2004-01-01,36,47,36,47,83
20102,PALCA,estado nutricional,clasificacion d,2004-01-01,49,41,49,41,90
21104,PALOS BLANCOS,estado nutricional,clasificacion d,2004-01-01,64,84,64,84,148
40802,PAMPA AULLAGAS,estado nutricional,clasificacion d,2004-01-01,7,14,7,14,21
70902,PAMPA GRANDE,estado nutricional,clasificacion d,2004-01-01,14,10,14,10,24
21802,PAPEL PAMPA,estado nutricional,clasificacion d,2004-01-01,13,11,13,11,24
30202,PASORAPA,estado nutricional,clasificacion d,2004-01-01,5,10,5,10,15
21305,PATACAMAYA,estado nutricional,clasificacion d,2004-01-01,133,85,133,85,218
40602,PAZÃ‘A,estado nutricional,clasificacion d,2004-01-01,15,29,15,29,44
20702,PELECHUCO,estado nutricional,clasificacion d,2004-01-01,27,30,27,30,57
50403,POCOATA,estado nutricional,clasificacion d,2004-01-01,64,108,64,108,172
31203,POCONA,estado nutricional,clasificacion d,2004-01-01,18,23,18,23,41
31202,POJO (CBBA),estado nutricional,clasificacion d,2004-01-01,122,82,122,82,204
40601,POOPO,estado nutricional,clasificacion d,2004-01-01,8,9,8,9,17
51203,PORCO,estado nutricional,clasificacion d,2004-01-01,34,27,34,27,61
10103,POROMA,estado nutricional,clasificacion d,2004-01-01,83,111,83,111,194
70103,PORONGO,estado nutricional,clasificacion d,2004-01-01,11,8,11,8,19
70601,PORTACHUELO,estado nutricional,clasificacion d,2004-01-01,57,53,57,53,110
70804,POSTRER VALLE,estado nutricional,clasificacion d,2004-01-01,4,2,4,2,6
50101,POTOSI,estado nutricional,clasificacion d,2004-01-01,539,417,539,417,956
10302,PRESTO,estado nutricional,clasificacion d,2004-01-01,48,67,48,67,115
70805,PUCARA,estado nutricional,clasificacion d,2004-01-01,2,3,2,3,5
21201,PUCARANI,estado nutricional,clasificacion d,2004-01-01,37,24,37,24,61
20401,PUERTO ACOSTA,estado nutricional,clasificacion d,2004-01-01,55,70,55,70,125
20403,PUERTO CARABUCO,estado nutricional,clasificacion d,2004-01-01,39,65,39,65,104
90301,PUERTO GONZALO MORENO,estado nutricional,clasificacion d,2004-01-01,8,29,8,29,37
21204,PUERTO PEREZ,estado nutricional,clasificacion d,2004-01-01,26,10,26,10,36
71402,PUERTO QUIJARRO,estado nutricional,clasificacion d,2004-01-01,21,6,21,6,27
90201,PUERTO RICO,estado nutricional,clasificacion d,2004-01-01,6,1,6,1,7
80703,PUERTO SILES,estado nutricional,clasificacion d,2004-01-01,1,2,1,2,3
71401,PUERTO SUAREZ,estado nutricional,clasificacion d,2004-01-01,28,23,28,23,51
31205,PUERTO VILLARROEL,estado nutricional,clasificacion d,2004-01-01,193,160,193,160,353
51101,PUNA,estado nutricional,clasificacion d,2004-01-01,141,158,141,158,299
31401,PUNATA,estado nutricional,clasificacion d,2004-01-01,134,74,134,74,208
20604,QUIABAYA,estado nutricional,clasificacion d,2004-01-01,10,24,10,24,34
30901,QUILLACOLLO,estado nutricional,clasificacion d,2004-01-01,101,107,101,107,208
21002,QUIME,estado nutricional,clasificacion d,2004-01-01,56,90,56,90,146
70904,QUIRUSILLAS,estado nutricional,clasificacion d,2004-01-01,3,5,3,5,8
50402,RAVELO,estado nutricional,clasificacion d,2004-01-01,121,115,121,115,236
80301,REYES,estado nutricional,clasificacion d,2004-01-01,33,59,33,59,92
80201,RIBERALTA,estado nutricional,clasificacion d,2004-01-01,305,239,305,239,544
70503,ROBORE,estado nutricional,clasificacion d,2004-01-01,49,52,49,52,101
80304,RURRENABAQUE,estado nutricional,clasificacion d,2004-01-01,18,12,18,12,30
40901,SABAYA,estado nutricional,clasificacion d,2004-01-01,3,4,3,4,7
31001,SACABA,estado nutricional,clasificacion d,2004-01-01,136,119,136,119,255
30404,SACABAMBA,estado nutricional,clasificacion d,2004-01-01,8,18,8,18,26
50701,SACACA,estado nutricional,clasificacion d,2004-01-01,136,210,136,210,346
71302,SAIPINA,estado nutricional,clasificacion d,2004-01-01,33,22,33,22,55
40801,SALINAS DE GARCI MENDOZA,estado nutricional,clasificacion d,2004-01-01,12,14,12,14,26
70901,SAMAIPATA,estado nutricional,clasificacion d,2004-01-01,34,21,34,21,55
51601,SAN AGUSTIN,estado nutricional,clasificacion d,2004-01-01,0,8,0,8,8
80602,SAN ANDRES,estado nutricional,clasificacion d,2004-01-01,39,43,39,43,82
51003,SAN ANTONIO DE ESMORUCO,estado nutricional,clasificacion d,2004-01-01,0,2,0,2,2
71105,SAN ANTONIO DE LOMERIO,estado nutricional,clasificacion d,2004-01-01,82,103,82,103,185
31403,SAN BENITO,estado nutricional,clasificacion d,2004-01-01,25,10,25,10,35
80302,SAN BORJA,estado nutricional,clasificacion d,2004-01-01,146,130,146,130,276
21502,SAN BUENA VENTURA,estado nutricional,clasificacion d,2004-01-01,34,45,34,45,79
70402,SAN CARLOS,estado nutricional,clasificacion d,2004-01-01,65,69,65,69,134
80501,SAN IGNACIO,estado nutricional,clasificacion d,2004-01-01,71,71,71,71,142
70301,SAN IGNACIO DE VELASCO,estado nutricional,clasificacion d,2004-01-01,274,255,274,255,529
80102,SAN JAVIER(BNI),estado nutricional,clasificacion d,2004-01-01,17,23,17,23,40
71102,SAN JAVIER(STC),estado nutricional,clasificacion d,2004-01-01,8,15,8,15,23
80701,SAN JOAQUIN,estado nutricional,clasificacion d,2004-01-01,22,24,22,24,46
70501,SAN JOSE DE CHIQUITOS,estado nutricional,clasificacion d,2004-01-01,58,33,58,33,91
71104,SAN JULIAN,estado nutricional,clasificacion d,2004-01-01,127,194,127,194,321
90302,SAN LORENZO(PND),estado nutricional,clasificacion d,2004-01-01,1,9,1,9,10
60501,SAN LORENZO(TJA),estado nutricional,clasificacion d,2004-01-01,48,74,48,74,122
10702,SAN LUCAS,estado nutricional,clasificacion d,2004-01-01,367,440,367,440,807
71201,SAN MATIAS,estado nutricional,clasificacion d,2004-01-01,14,9,14,9,23
70302,SAN MIGUEL DE VELASCO,estado nutricional,clasificacion d,2004-01-01,40,54,40,54,94
51001,SAN PABLO DE LIPEZ,estado nutricional,clasificacion d,2004-01-01,6,6,6,6,12
50501,SAN PEDRO DE BUENA VISTA,estado nutricional,clasificacion d,2004-01-01,121,195,121,195,316
21801,SAN PEDRO DE CURAHUARA,estado nutricional,clasificacion d,2004-01-01,16,13,16,13,29
50902,SAN PEDRO DE QUEMES,estado nutricional,clasificacion d,2004-01-01,2,2,2,2,4
21702,SAN PEDRO DE TIQUINA,estado nutricional,clasificacion d,2004-01-01,8,9,8,9,17
90202,SAN PEDRO(PND),estado nutricional,clasificacion d,2004-01-01,0,3,0,3,3
70303,SAN RAFAEL,estado nutricional,clasificacion d,2004-01-01,33,39,33,39,72
80702,SAN RAMON,estado nutricional,clasificacion d,2004-01-01,21,11,21,11,32
80401,SANTA ANA,estado nutricional,clasificacion d,2004-01-01,33,26,33,26,59
70101,SANTA CRUZ DE LA SIERRA,estado nutricional,clasificacion d,2004-01-01,1268,734,1268,734,2002
80303,SANTA ROSA,estado nutricional,clasificacion d,2004-01-01,24,11,24,11,35
70602,SANTA ROSA DEL SARA,estado nutricional,clasificacion d,2004-01-01,7,33,7,33,40
20308,SANTIAGO DE CALLAPA,estado nutricional,clasificacion d,2004-01-01,12,6,12,6,18
41401,SANTIAGO DE HUARI,estado nutricional,clasificacion d,2004-01-01,13,27,13,27,40
21901,SANTIAGO DE MACHACA,estado nutricional,clasificacion d,2004-01-01,13,12,13,12,25
30702,SANTIVAÃ‘ES,estado nutricional,clasificacion d,2004-01-01,23,28,23,28,51
40202,SANTUARIO DE QUILLACAS,estado nutricional,clasificacion d,2004-01-01,0,1,0,1,1
20902,SAPAHAQUI,estado nutricional,clasificacion d,2004-01-01,18,14,18,14,32
90303,SENA,estado nutricional,clasificacion d,2004-01-01,7,4,7,4,11
21301,SICA SICA (VILLA AROMA),estado nutricional,clasificacion d,2004-01-01,90,70,90,70,160
30703,SICAYA,estado nutricional,clasificacion d,2004-01-01,4,12,4,12,16
30902,SIPE SIPE,estado nutricional,clasificacion d,2004-01-01,77,55,77,55,132
10403,SOPACHUY,estado nutricional,clasificacion d,2004-01-01,76,155,76,155,231
20601,SORATA,estado nutricional,clasificacion d,2004-01-01,46,88,46,88,134
10101,SUCRE,estado nutricional,clasificacion d,2004-01-01,542,506,542,506,1048
31404,TACACHI,estado nutricional,clasificacion d,2004-01-01,8,1,8,1,9
20603,TACACOMA,estado nutricional,clasificacion d,2004-01-01,16,20,16,20,36
50303,TACOBAMBA,estado nutricional,clasificacion d,2004-01-01,35,46,35,46,81
30602,TACOPAYA,estado nutricional,clasificacion d,2004-01-01,55,41,55,41,96
51402,TAHUA,estado nutricional,clasificacion d,2004-01-01,0,3,0,3,3
31101,TAPACARI,estado nutricional,clasificacion d,2004-01-01,117,90,117,90,207
10601,TARABUCO,estado nutricional,clasificacion d,2004-01-01,257,492,257,492,749
30401,TARATA,estado nutricional,clasificacion d,2004-01-01,21,15,21,15,36
60101,TARIJA,estado nutricional,clasificacion d,2004-01-01,314,241,314,241,555
10202,TARVITA,estado nutricional,clasificacion d,2004-01-01,166,331,166,331,497
20803,TIAWANACU,estado nutricional,clasificacion d,2004-01-01,30,16,30,16,46
50102,TINGUIPAYA,estado nutricional,clasificacion d,2004-01-01,58,50,58,50,108
20606,TIPUANI,estado nutricional,clasificacion d,2004-01-01,16,15,16,15,31
30903,TIQUIPAYA,estado nutricional,clasificacion d,2004-01-01,36,18,36,18,54
31601,TIRAQUE (CBBA),estado nutricional,clasificacion d,2004-01-01,173,124,173,124,297
21703,TITO YUPANQUI (PARQUIPUJIO),estado nutricional,clasificacion d,2004-01-01,5,12,5,12,17
30802,TOCO,estado nutricional,clasificacion d,2004-01-01,8,6,8,6,14
30803,TOLATA,estado nutricional,clasificacion d,2004-01-01,3,10,3,10,13
41001,TOLEDO,estado nutricional,clasificacion d,2004-01-01,10,12,10,12,22
51202,TOMAVE,estado nutricional,clasificacion d,2004-01-01,29,35,29,35,64
10402,TOMINA,estado nutricional,clasificacion d,2004-01-01,98,193,98,193,291
50502,TORO TORO,estado nutricional,clasificacion d,2004-01-01,67,70,67,70,137
31201,TOTORA(CBBA),estado nutricional,clasificacion d,2004-01-01,38,25,38,25,63
41301,TOTORA(ORR),estado nutricional,clasificacion d,2004-01-01,7,4,7,4,11
70802,TRIGAL,estado nutricional,clasificacion d,2004-01-01,0,1,0,1,1
80101,TRINIDAD,estado nutricional,clasificacion d,2004-01-01,224,291,224,291,515
50801,TUPIZA,estado nutricional,clasificacion d,2004-01-01,130,219,130,219,349
21302,UMALA,estado nutricional,clasificacion d,2004-01-01,13,13,13,13,26
50201,UNCIA,estado nutricional,clasificacion d,2004-01-01,75,86,75,86,161
60401,URIONDO (A. CONCEPCION),estado nutricional,clasificacion d,2004-01-01,55,95,55,95,150
71502,URUBICHA,estado nutricional,clasificacion d,2004-01-01,30,45,30,45,75
51201,UYUNI,estado nutricional,clasificacion d,2004-01-01,41,48,41,48,89
30502,VACAS,estado nutricional,clasificacion d,2004-01-01,31,23,31,23,54
70801,VALLEGRANDE,estado nutricional,clasificacion d,2004-01-01,43,35,43,35,78
20801,VIACHA,estado nutricional,clasificacion d,2004-01-01,127,71,127,71,198
31302,VILA VILA,estado nutricional,clasificacion d,2004-01-01,0,2,0,2,2
60303,VILLA MONTES,estado nutricional,clasificacion d,2004-01-01,87,104,87,104,191
90502,VILLA NUEVA (LOMA ALTA),estado nutricional,clasificacion d,2004-01-01,1,2,1,2,3
31402,VILLA RIVERO,estado nutricional,clasificacion d,2004-01-01,13,15,13,15,28
10801,VILLA SERRANO,estado nutricional,clasificacion d,2004-01-01,86,220,86,220,306
31003,VILLA TUNARI,estado nutricional,clasificacion d,2004-01-01,185,196,185,196,381
11001,VILLA VACA GUZMAN (MUYUPAMPA),estado nutricional,clasificacion d,2004-01-01,97,105,97,105,202
51501,VILLAZON,estado nutricional,clasificacion d,2004-01-01,154,176,154,176,330
30904,VINTO,estado nutricional,clasificacion d,2004-01-01,54,22,54,22,76
50602,VITICHI,estado nutricional,clasificacion d,2004-01-01,59,117,59,117,176
20306,WALDO BALLIVIAN,estado nutricional,clasificacion d,2004-01-01,8,10,8,10,18
70201,WARNES,estado nutricional,clasificacion d,2004-01-01,76,52,76,52,128
20903,YACO,estado nutricional,clasificacion d,2004-01-01,21,21,21,21,42
60301,YACUIBA,estado nutricional,clasificacion d,2004-01-01,160,72,160,72,232
10602,YAMPARAEZ,estado nutricional,clasificacion d,2004-01-01,133,291,133,291,424
21103,YANACACHI,estado nutricional,clasificacion d,2004-01-01,17,23,17,23,40
70403,YAPACANI,estado nutricional,clasificacion d,2004-01-01,146,161,146,161,307
50103,YOCALLA,estado nutricional,clasificacion d,2004-01-01,15,37,15,37,52
10102,YOTALA,estado nutricional,clasificacion d,2004-01-01,52,143,52,143,195
60402,YUNCHARA,estado nutricional,clasificacion d,2004-01-01,21,72,21,72,93
10301,ZUDAÃ‘EZ,estado nutricional,clasificacion d,2004-01-01,73,113,73,113,186
51302,ACACIO,estado nutricional,clasificacion d,2004-02-01,47,101,47,101,148
20201,ACHACACHI,estado nutricional,clasificacion d,2004-02-01,149,143,149,143,292
20104,ACHOCALLA,estado nutricional,clasificacion d,2004-02-01,15,45,15,45,60
30201,AIQUILE,estado nutricional,clasificacion d,2004-02-01,45,49,45,49,94
31303,ALALAY,estado nutricional,clasificacion d,2004-02-01,7,14,7,14,21
10404,ALCALA,estado nutricional,clasificacion d,2004-02-01,32,65,32,65,97
20202,ANCORAIMES,estado nutricional,clasificacion d,2004-02-01,47,84,47,84,131
41201,ANDAMARCA,estado nutricional,clasificacion d,2004-02-01,6,3,6,3,9
40603,ANTEQUERA,estado nutricional,clasificacion d,2004-02-01,2,0,2,0,2
30402,ANZALDO,estado nutricional,clasificacion d,2004-02-01,10,29,10,29,39
20701,APOLO,estado nutricional,clasificacion d,2004-02-01,29,44,29,44,73
51301,ARAMPAMPA,estado nutricional,clasificacion d,2004-02-01,17,39,17,39,56
30501,ARANI,estado nutricional,clasificacion d,2004-02-01,28,9,28,9,37
30403,ARBIETO,estado nutricional,clasificacion d,2004-02-01,7,12,7,12,19
30601,ARQUE,estado nutricional,clasificacion d,2004-02-01,57,56,57,56,113
71501,ASCENCION DE GUARAYOS,estado nutricional,clasificacion d,2004-02-01,193,250,193,250,443
50802,ATOCHA,estado nutricional,clasificacion d,2004-02-01,20,134,20,134,154
20503,AUCAPATA,estado nutricional,clasificacion d,2004-02-01,18,14,18,14,32
20502,AYATA,estado nutricional,clasificacion d,2004-02-01,27,47,27,47,74
21303,AYO AYO,estado nutricional,clasificacion d,2004-02-01,22,18,22,18,40
30301,AYOPAYA (V. DE INDEPENDENCIA),estado nutricional,clasificacion d,2004-02-01,91,143,91,143,234
10201,AZURDUY,estado nutricional,clasificacion d,2004-02-01,138,289,138,289,427
21203,BATALLAS,estado nutricional,clasificacion d,2004-02-01,13,15,13,15,28
80802,BAURES,estado nutricional,clasificacion d,2004-02-01,18,13,18,13,31
41202,BELEN DE ANDAMARCA,estado nutricional,clasificacion d,2004-02-01,4,2,4,2,6
50104,BELEN DE URMIRI,estado nutricional,clasificacion d,2004-02-01,10,16,10,16,26
90104,BELLA FLOR,estado nutricional,clasificacion d,2004-02-01,5,9,5,9,14
60202,BERMEJO,estado nutricional,clasificacion d,2004-02-01,12,11,12,11,23
50301,BETANZOS,estado nutricional,clasificacion d,2004-02-01,146,245,146,245,391
31501,BOLIVAR,estado nutricional,clasificacion d,2004-02-01,31,58,31,58,89
90103,BOLPEBRA,estado nutricional,clasificacion d,2004-02-01,3,6,3,6,9
70707,BOYUIBE,estado nutricional,clasificacion d,2004-02-01,5,9,5,9,14
70401,BUENA VISTA,estado nutricional,clasificacion d,2004-02-01,1,0,1,0,1
70703,CABEZAS,estado nutricional,clasificacion d,2004-02-01,47,39,47,39,86
20905,CAIROMA,estado nutricional,clasificacion d,2004-02-01,68,81,68,81,149
51102,"CAIZA ""D""",estado nutricional,clasificacion d,2004-02-01,39,71,39,71,110
21003,CAJUATA,estado nutricional,clasificacion d,2004-02-01,27,37,27,37,64
20303,CALACOTO,estado nutricional,clasificacion d,2004-02-01,14,11,14,11,25
21304,CALAMARCA,estado nutricional,clasificacion d,2004-02-01,154,143,154,143,297
10701,CAMARGO,estado nutricional,clasificacion d,2004-02-01,75,109,75,109,184
10901,CAMATAQUI (C. VILLA ABECIA),estado nutricional,clasificacion d,2004-02-01,17,37,17,37,54
70706,CAMIRI,estado nutricional,clasificacion d,2004-02-01,147,126,147,126,273
30701,CAPINOTA,estado nutricional,clasificacion d,2004-02-01,16,23,16,23,39
20302,CAQUIAVIRI,estado nutricional,clasificacion d,2004-02-01,45,49,45,49,94
40102,CARACOLLO,estado nutricional,clasificacion d,2004-02-01,82,87,82,87,169
22001,CARANAVI,estado nutricional,clasificacion d,2004-02-01,163,168,163,168,331
60302,CARAPARI,estado nutricional,clasificacion d,2004-02-01,20,47,20,47,67
50702,CARIPUYO,estado nutricional,clasificacion d,2004-02-01,84,130,84,130,214
21803,CHACARILLA,estado nutricional,clasificacion d,2004-02-01,11,11,11,11,22
40201,CHALLAPATA,estado nutricional,clasificacion d,2004-02-01,59,116,59,116,175
50302,CHAQUI,estado nutricional,clasificacion d,2004-02-01,15,19,15,19,34
70702,CHARAGUA,estado nutricional,clasificacion d,2004-02-01,143,116,143,116,259
20305,CHARAÃ‘A,estado nutricional,clasificacion d,2004-02-01,4,1,4,1,5
50202,CHAYANTA,estado nutricional,clasificacion d,2004-02-01,44,37,44,37,81
31204,CHIMORE,estado nutricional,clasificacion d,2004-02-01,35,44,35,44,79
40903,CHIPAYA,estado nutricional,clasificacion d,2004-02-01,8,5,8,5,13
40302,CHOQUE COTA,estado nutricional,clasificacion d,2004-02-01,4,6,4,6,10
21101,CHULUMANI (V. DE LA LIBERTAD),estado nutricional,clasificacion d,2004-02-01,13,8,13,8,21
20501,CHUMA,estado nutricional,clasificacion d,2004-02-01,44,21,44,21,65
30801,CLIZA,estado nutricional,clasificacion d,2004-02-01,15,13,15,13,28
90101,COBIJA,estado nutricional,clasificacion d,2004-02-01,50,46,50,46,96
30101,COCHABAMBA,estado nutricional,clasificacion d,2004-02-01,393,366,393,366,759
40902,COIPASA,estado nutricional,clasificacion d,2004-02-01,1,1,1,1,2
30905,COLCAPIRHUA,estado nutricional,clasificacion d,2004-02-01,43,22,43,22,65
50901,"COLCHA ""K""",estado nutricional,clasificacion d,2004-02-01,48,49,48,49,97
21307,COLLANA,estado nutricional,clasificacion d,2004-02-01,7,3,7,3,10
31002,COLOMI,estado nutricional,clasificacion d,2004-02-01,45,37,45,37,82
50401,COLQUECHACA,estado nutricional,clasificacion d,2004-02-01,120,88,120,88,208
21306,COLQUENCHA,estado nutricional,clasificacion d,2004-02-01,23,8,23,8,31
21004,COLQUIRI,estado nutricional,clasificacion d,2004-02-01,97,59,97,59,156
20304,COMANCHE,estado nutricional,clasificacion d,2004-02-01,6,7,6,7,13
71301,COMARAPA,estado nutricional,clasificacion d,2004-02-01,38,36,38,36,74
20605,COMBAYA,estado nutricional,clasificacion d,2004-02-01,9,15,9,15,24
71101,CONCEPCION,estado nutricional,clasificacion d,2004-02-01,38,3,38,3,41
21701,COPACABANA,estado nutricional,clasificacion d,2004-02-01,19,13,19,13,32
21402,CORIPATA,estado nutricional,clasificacion d,2004-02-01,16,1,16,1,17
20301,CORO CORO,estado nutricional,clasificacion d,2004-02-01,31,49,31,49,80
21401,COROICO,estado nutricional,clasificacion d,2004-02-01,13,11,13,11,24
40301,CORQUE,estado nutricional,clasificacion d,2004-02-01,30,32,30,32,62
50601,COTAGAITA,estado nutricional,clasificacion d,2004-02-01,160,211,160,211,371
70102,COTOCA,estado nutricional,clasificacion d,2004-02-01,53,27,53,27,80
31405,CUCHUMUELA (V. G. VILLARROEL),estado nutricional,clasificacion d,2004-02-01,6,11,6,11,17
70704,CUEVO,estado nutricional,clasificacion d,2004-02-01,16,12,16,12,28
10902,CULPINA,estado nutricional,clasificacion d,2004-02-01,193,217,193,217,410
40401,CURAHUARA DE CARANGAS,estado nutricional,clasificacion d,2004-02-01,10,19,10,19,29
21602,CURVA,estado nutricional,clasificacion d,2004-02-01,13,18,13,18,31
20804,DESAGUADERO,estado nutricional,clasificacion d,2004-02-01,12,13,12,13,25
20105,EL ALTO,estado nutricional,clasificacion d,2004-02-01,1365,941,1365,941,2306
40103,EL CHORO,estado nutricional,clasificacion d,2004-02-01,17,27,17,27,44
71503,EL PUENTE(STC),estado nutricional,clasificacion d,2004-02-01,80,89,80,89,169
60502,EL PUENTE(TJA),estado nutricional,clasificacion d,2004-02-01,22,53,22,53,75
70105,EL TORNO,estado nutricional,clasificacion d,2004-02-01,53,36,53,36,89
10405,EL VILLAR,estado nutricional,clasificacion d,2004-02-01,43,146,43,146,189
60601,ENTRE RIOS,estado nutricional,clasificacion d,2004-02-01,66,93,66,93,159
41101,EUCALIPTUS,estado nutricional,clasificacion d,2004-02-01,9,6,9,6,15
90503,EUREKA (SANTOS MERCADO),estado nutricional,clasificacion d,2004-02-01,1,0,1,0,1
80402,EXALTACION,estado nutricional,clasificacion d,2004-02-01,16,11,16,11,27
90203,FILADELFIA,estado nutricional,clasificacion d,2004-02-01,3,1,3,1,4
71002,GENERAL SAAVEDRA,estado nutricional,clasificacion d,2004-02-01,107,148,107,148,255
21601,GRAL. J.J. PEREZ (CHARAZANI),estado nutricional,clasificacion d,2004-02-01,27,57,27,57,84
20602,GUANAY,estado nutricional,clasificacion d,2004-02-01,126,163,126,163,289
20802,GUAQUI,estado nutricional,clasificacion d,2004-02-01,10,12,10,12,22
80202,GUAYARAMERIN,estado nutricional,clasificacion d,2004-02-01,78,84,78,84,162
70705,GUTIERREZ,estado nutricional,clasificacion d,2004-02-01,116,170,116,170,286
10502,HUACARETA,estado nutricional,clasificacion d,2004-02-01,58,91,58,91,149
11002,HUACAYA (VILLA DE HUACAYA),estado nutricional,clasificacion d,2004-02-01,13,15,13,15,28
40501,HUACHACALLA,estado nutricional,clasificacion d,2004-02-01,3,2,3,2,5
40701,HUANUNI,estado nutricional,clasificacion d,2004-02-01,56,46,56,46,102
80803,HUARACAJE,estado nutricional,clasificacion d,2004-02-01,6,7,6,7,13
41601,HUAYLLAMARCA,estado nutricional,clasificacion d,2004-02-01,15,13,15,13,28
21005,ICHOCA,estado nutricional,clasificacion d,2004-02-01,13,10,13,10,23
10304,ICLA,estado nutricional,clasificacion d,2004-02-01,92,246,92,246,338
10703,INCAHUASI,estado nutricional,clasificacion d,2004-02-01,162,178,162,178,340
21001,INQUISIVI,estado nutricional,clasificacion d,2004-02-01,44,36,44,36,80
21102,IRUPANA (VILLA DE LANZA),estado nutricional,clasificacion d,2004-02-01,40,42,40,42,82
21501,IXIAMAS,estado nutricional,clasificacion d,2004-02-01,31,31,31,31,62
21105,LA ASUNTA,estado nutricional,clasificacion d,2004-02-01,32,23,32,23,55
70104,LA GUARDIA,estado nutricional,clasificacion d,2004-02-01,48,42,48,42,90
20101,LA PAZ,estado nutricional,clasificacion d,2004-02-01,1110,951,1110,951,2061
70701,LAGUNILLAS,estado nutricional,clasificacion d,2004-02-01,33,62,33,62,95
21202,LAJA,estado nutricional,clasificacion d,2004-02-01,22,8,22,8,30
10903,LAS CARRERAS,estado nutricional,clasificacion d,2004-02-01,8,13,8,13,21
21006,LICOMA PAMPA,estado nutricional,clasificacion d,2004-02-01,1,0,1,0,1
50203,LLALLAGUA,estado nutricional,clasificacion d,2004-02-01,91,125,91,125,216
51401,LLICA,estado nutricional,clasificacion d,2004-02-01,8,9,8,9,17
80601,LORETO,estado nutricional,clasificacion d,2004-02-01,4,2,4,2,6
20901,LURIBAY,estado nutricional,clasificacion d,2004-02-01,34,47,34,47,81
40702,MACHACAMARCA,estado nutricional,clasificacion d,2004-02-01,7,10,7,10,17
11003,MACHARETI,estado nutricional,clasificacion d,2004-02-01,25,90,25,90,115
80801,MAGDALENA,estado nutricional,clasificacion d,2004-02-01,30,33,30,33,63
70903,MAIRANA,estado nutricional,clasificacion d,2004-02-01,16,31,16,31,47
20904,MALLA,estado nutricional,clasificacion d,2004-02-01,4,8,4,8,12
20103,MECAPACA,estado nutricional,clasificacion d,2004-02-01,7,11,7,11,18
71003,MINEROS,estado nutricional,clasificacion d,2004-02-01,105,118,105,118,223
31301,MIZQUE,estado nutricional,clasificacion d,2004-02-01,36,30,36,30,66
20402,MOCOMOCO,estado nutricional,clasificacion d,2004-02-01,34,61,34,61,95
51002,MOJINETE,estado nutricional,clasificacion d,2004-02-01,11,9,11,9,20
10303,MOJOCOYA,estado nutricional,clasificacion d,2004-02-01,45,109,45,109,154
10501,MONTEAGUDO,estado nutricional,clasificacion d,2004-02-01,130,214,130,214,344
71001,MONTERO,estado nutricional,clasificacion d,2004-02-01,274,194,274,194,468
70803,MORO MORO,estado nutricional,clasificacion d,2004-02-01,11,29,11,29,40
30302,MOROCHATA,estado nutricional,clasificacion d,2004-02-01,38,29,38,29,67
90401,NACEBE (SANTA ROSA DEL ABUNA),estado nutricional,clasificacion d,2004-02-01,4,7,4,7,11
20307,NAZACARA DE PACAJES,estado nutricional,clasificacion d,2004-02-01,1,0,1,0,1
50404,OCURI,estado nutricional,clasificacion d,2004-02-01,121,126,121,126,247
70202,OKINAWA,estado nutricional,clasificacion d,2004-02-01,13,13,13,13,26
30203,OMEREQUE,estado nutricional,clasificacion d,2004-02-01,15,18,15,18,33
40101,ORURO,estado nutricional,clasificacion d,2004-02-01,395,267,395,267,662
60201,PADCAYA,estado nutricional,clasificacion d,2004-02-01,39,48,39,48,87
10401,PADILLA,estado nutricional,clasificacion d,2004-02-01,103,241,103,241,344
70502,PAILON,estado nutricional,clasificacion d,2004-02-01,20,22,20,22,42
20102,PALCA,estado nutricional,clasificacion d,2004-02-01,44,22,44,22,66
21104,PALOS BLANCOS,estado nutricional,clasificacion d,2004-02-01,60,68,60,68,128
40802,PAMPA AULLAGAS,estado nutricional,clasificacion d,2004-02-01,5,10,5,10,15
70902,PAMPA GRANDE,estado nutricional,clasificacion d,2004-02-01,15,46,15,46,61
21802,PAPEL PAMPA,estado nutricional,clasificacion d,2004-02-01,7,19,7,19,26
30202,PASORAPA,estado nutricional,clasificacion d,2004-02-01,10,15,10,15,25
21305,PATACAMAYA,estado nutricional,clasificacion d,2004-02-01,126,118,126,118,244
40602,PAZÃ‘A,estado nutricional,clasificacion d,2004-02-01,12,30,12,30,42
20702,PELECHUCO,estado nutricional,clasificacion d,2004-02-01,29,35,29,35,64
50403,POCOATA,estado nutricional,clasificacion d,2004-02-01,129,159,129,159,288
31203,POCONA,estado nutricional,clasificacion d,2004-02-01,48,47,48,47,95
31202,POJO (CBBA),estado nutricional,clasificacion d,2004-02-01,109,78,109,78,187
40601,POOPO,estado nutricional,clasificacion d,2004-02-01,23,35,23,35,58
51203,PORCO,estado nutricional,clasificacion d,2004-02-01,16,9,16,9,25
10103,POROMA,estado nutricional,clasificacion d,2004-02-01,70,94,70,94,164
70103,PORONGO,estado nutricional,clasificacion d,2004-02-01,16,16,16,16,32
70601,PORTACHUELO,estado nutricional,clasificacion d,2004-02-01,24,48,24,48,72
90102,PORVENIR,estado nutricional,clasificacion d,2004-02-01,11,23,11,23,34
70804,POSTRER VALLE,estado nutricional,clasificacion d,2004-02-01,2,5,2,5,7
50101,POTOSI,estado nutricional,clasificacion d,2004-02-01,523,378,523,378,901
10302,PRESTO,estado nutricional,clasificacion d,2004-02-01,41,52,41,52,93
70805,PUCARA,estado nutricional,clasificacion d,2004-02-01,11,16,11,16,27
21201,PUCARANI,estado nutricional,clasificacion d,2004-02-01,54,42,54,42,96
20401,PUERTO ACOSTA,estado nutricional,clasificacion d,2004-02-01,49,49,49,49,98
20403,PUERTO CARABUCO,estado nutricional,clasificacion d,2004-02-01,35,63,35,63,98
90301,PUERTO GONZALO MORENO,estado nutricional,clasificacion d,2004-02-01,18,20,18,20,38
21204,PUERTO PEREZ,estado nutricional,clasificacion d,2004-02-01,8,13,8,13,21
71402,PUERTO QUIJARRO,estado nutricional,clasificacion d,2004-02-01,28,7,28,7,35
90201,PUERTO RICO,estado nutricional,clasificacion d,2004-02-01,9,10,9,10,19
80703,PUERTO SILES,estado nutricional,clasificacion d,2004-02-01,7,12,7,12,19
71401,PUERTO SUAREZ,estado nutricional,clasificacion d,2004-02-01,15,20,15,20,35
31205,PUERTO VILLARROEL,estado nutricional,clasificacion d,2004-02-01,151,156,151,156,307
51101,PUNA,estado nutricional,clasificacion d,2004-02-01,116,131,116,131,247
31401,PUNATA,estado nutricional,clasificacion d,2004-02-01,22,29,22,29,51
20604,QUIABAYA,estado nutricional,clasificacion d,2004-02-01,9,18,9,18,27
30901,QUILLACOLLO,estado nutricional,clasificacion d,2004-02-01,120,95,120,95,215
21002,QUIME,estado nutricional,clasificacion d,2004-02-01,62,78,62,78,140
70904,QUIRUSILLAS,estado nutricional,clasificacion d,2004-02-01,3,5,3,5,8
50402,RAVELO,estado nutricional,clasificacion d,2004-02-01,222,276,222,276,498
80301,REYES,estado nutricional,clasificacion d,2004-02-01,23,26,23,26,49
80201,RIBERALTA,estado nutricional,clasificacion d,2004-02-01,278,255,278,255,533
70503,ROBORE,estado nutricional,clasificacion d,2004-02-01,39,36,39,36,75
80304,RURRENABAQUE,estado nutricional,clasificacion d,2004-02-01,39,22,39,22,61
40901,SABAYA,estado nutricional,clasificacion d,2004-02-01,1,8,1,8,9
31001,SACABA,estado nutricional,clasificacion d,2004-02-01,49,63,49,63,112
30404,SACABAMBA,estado nutricional,clasificacion d,2004-02-01,17,29,17,29,46
50701,SACACA,estado nutricional,clasificacion d,2004-02-01,295,499,295,499,794
71302,SAIPINA,estado nutricional,clasificacion d,2004-02-01,4,9,4,9,13
40801,SALINAS DE GARCI MENDOZA,estado nutricional,clasificacion d,2004-02-01,6,10,6,10,16
70901,SAMAIPATA,estado nutricional,clasificacion d,2004-02-01,27,16,27,16,43
51601,SAN AGUSTIN,estado nutricional,clasificacion d,2004-02-01,6,1,6,1,7
80602,SAN ANDRES,estado nutricional,clasificacion d,2004-02-01,9,12,9,12,21
51003,SAN ANTONIO DE ESMORUCO,estado nutricional,clasificacion d,2004-02-01,2,0,2,0,2
71105,SAN ANTONIO DE LOMERIO,estado nutricional,clasificacion d,2004-02-01,63,116,63,116,179
31403,SAN BENITO,estado nutricional,clasificacion d,2004-02-01,47,6,47,6,53
80302,SAN BORJA,estado nutricional,clasificacion d,2004-02-01,162,164,162,164,326
21502,SAN BUENA VENTURA,estado nutricional,clasificacion d,2004-02-01,37,39,37,39,76
70402,SAN CARLOS,estado nutricional,clasificacion d,2004-02-01,74,61,74,61,135
80501,SAN IGNACIO,estado nutricional,clasificacion d,2004-02-01,103,85,103,85,188
70301,SAN IGNACIO DE VELASCO,estado nutricional,clasificacion d,2004-02-01,217,302,217,302,519
80102,SAN JAVIER(BNI),estado nutricional,clasificacion d,2004-02-01,17,16,17,16,33
71102,SAN JAVIER(STC),estado nutricional,clasificacion d,2004-02-01,39,33,39,33,72
80701,SAN JOAQUIN,estado nutricional,clasificacion d,2004-02-01,14,32,14,32,46
70501,SAN JOSE DE CHIQUITOS,estado nutricional,clasificacion d,2004-02-01,56,36,56,36,92
71104,SAN JULIAN,estado nutricional,clasificacion d,2004-02-01,139,219,139,219,358
90302,SAN LORENZO(PND),estado nutricional,clasificacion d,2004-02-01,4,9,4,9,13
60501,SAN LORENZO(TJA),estado nutricional,clasificacion d,2004-02-01,36,71,36,71,107
10702,SAN LUCAS,estado nutricional,clasificacion d,2004-02-01,289,411,289,411,700
71201,SAN MATIAS,estado nutricional,clasificacion d,2004-02-01,7,17,7,17,24
70302,SAN MIGUEL DE VELASCO,estado nutricional,clasificacion d,2004-02-01,60,64,60,64,124
51001,SAN PABLO DE LIPEZ,estado nutricional,clasificacion d,2004-02-01,7,11,7,11,18
50501,SAN PEDRO DE BUENA VISTA,estado nutricional,clasificacion d,2004-02-01,95,114,95,114,209
21801,SAN PEDRO DE CURAHUARA,estado nutricional,clasificacion d,2004-02-01,26,24,26,24,50
50902,SAN PEDRO DE QUEMES,estado nutricional,clasificacion d,2004-02-01,1,2,1,2,3
21702,SAN PEDRO DE TIQUINA,estado nutricional,clasificacion d,2004-02-01,3,1,3,1,4
90202,SAN PEDRO(PND),estado nutricional,clasificacion d,2004-02-01,3,6,3,6,9
70303,SAN RAFAEL,estado nutricional,clasificacion d,2004-02-01,34,30,34,30,64
80702,SAN RAMON,estado nutricional,clasificacion d,2004-02-01,16,5,16,5,21
80401,SANTA ANA,estado nutricional,clasificacion d,2004-02-01,18,14,18,14,32
70101,SANTA CRUZ DE LA SIERRA,estado nutricional,clasificacion d,2004-02-01,863,415,863,415,1278
80303,SANTA ROSA,estado nutricional,clasificacion d,2004-02-01,19,9,19,9,28
70602,SANTA ROSA DEL SARA,estado nutricional,clasificacion d,2004-02-01,16,19,16,19,35
20308,SANTIAGO DE CALLAPA,estado nutricional,clasificacion d,2004-02-01,7,12,7,12,19
41401,SANTIAGO DE HUARI,estado nutricional,clasificacion d,2004-02-01,12,17,12,17,29
21901,SANTIAGO DE MACHACA,estado nutricional,clasificacion d,2004-02-01,8,8,8,8,16
30702,SANTIVAÃ‘ES,estado nutricional,clasificacion d,2004-02-01,11,13,11,13,24
40202,SANTUARIO DE QUILLACAS,estado nutricional,clasificacion d,2004-02-01,6,8,6,8,14
20902,SAPAHAQUI,estado nutricional,clasificacion d,2004-02-01,28,38,28,38,66
90303,SENA,estado nutricional,clasificacion d,2004-02-01,9,2,9,2,11
21301,SICA SICA (VILLA AROMA),estado nutricional,clasificacion d,2004-02-01,125,95,125,95,220
30703,SICAYA,estado nutricional,clasificacion d,2004-02-01,10,22,10,22,32
30902,SIPE SIPE,estado nutricional,clasificacion d,2004-02-01,135,121,135,121,256
10403,SOPACHUY,estado nutricional,clasificacion d,2004-02-01,61,88,61,88,149
20601,SORATA,estado nutricional,clasificacion d,2004-02-01,47,86,47,86,133
10101,SUCRE,estado nutricional,clasificacion d,2004-02-01,524,671,524,671,1195
31404,TACACHI,estado nutricional,clasificacion d,2004-02-01,8,4,8,4,12
20603,TACACOMA,estado nutricional,clasificacion d,2004-02-01,14,10,14,10,24
50303,TACOBAMBA,estado nutricional,clasificacion d,2004-02-01,35,30,35,30,65
30602,TACOPAYA,estado nutricional,clasificacion d,2004-02-01,58,86,58,86,144
51402,TAHUA,estado nutricional,clasificacion d,2004-02-01,4,4,4,4,8
31101,TAPACARI,estado nutricional,clasificacion d,2004-02-01,144,129,144,129,273
10601,TARABUCO,estado nutricional,clasificacion d,2004-02-01,231,486,231,486,717
30401,TARATA,estado nutricional,clasificacion d,2004-02-01,41,20,41,20,61
60101,TARIJA,estado nutricional,clasificacion d,2004-02-01,251,224,251,224,475
10202,TARVITA,estado nutricional,clasificacion d,2004-02-01,123,259,123,259,382
20803,TIAWANACU,estado nutricional,clasificacion d,2004-02-01,29,29,29,29,58
50102,TINGUIPAYA,estado nutricional,clasificacion d,2004-02-01,126,137,126,137,263
20606,TIPUANI,estado nutricional,clasificacion d,2004-02-01,14,15,14,15,29
30903,TIQUIPAYA,estado nutricional,clasificacion d,2004-02-01,30,12,30,12,42
31601,TIRAQUE (CBBA),estado nutricional,clasificacion d,2004-02-01,146,119,146,119,265
21703,TITO YUPANQUI (PARQUIPUJIO),estado nutricional,clasificacion d,2004-02-01,2,6,2,6,8
30802,TOCO,estado nutricional,clasificacion d,2004-02-01,9,15,9,15,24
30803,TOLATA,estado nutricional,clasificacion d,2004-02-01,1,1,1,1,2
41001,TOLEDO,estado nutricional,clasificacion d,2004-02-01,10,7,10,7,17
51202,TOMAVE,estado nutricional,clasificacion d,2004-02-01,62,67,62,67,129
10402,TOMINA,estado nutricional,clasificacion d,2004-02-01,111,239,111,239,350
50502,TORO TORO,estado nutricional,clasificacion d,2004-02-01,78,87,78,87,165
31201,TOTORA(CBBA),estado nutricional,clasificacion d,2004-02-01,56,44,56,44,100
41301,TOTORA(ORR),estado nutricional,clasificacion d,2004-02-01,12,11,12,11,23
70802,TRIGAL,estado nutricional,clasificacion d,2004-02-01,4,4,4,4,8
80101,TRINIDAD,estado nutricional,clasificacion d,2004-02-01,166,176,166,176,342
50801,TUPIZA,estado nutricional,clasificacion d,2004-02-01,113,192,113,192,305
21302,UMALA,estado nutricional,clasificacion d,2004-02-01,4,10,4,10,14
50201,UNCIA,estado nutricional,clasificacion d,2004-02-01,65,46,65,46,111
60401,URIONDO (A. CONCEPCION),estado nutricional,clasificacion d,2004-02-01,42,101,42,101,143
71502,URUBICHA,estado nutricional,clasificacion d,2004-02-01,87,170,87,170,257
51201,UYUNI,estado nutricional,clasificacion d,2004-02-01,59,54,59,54,113
30502,VACAS,estado nutricional,clasificacion d,2004-02-01,28,29,28,29,57
70801,VALLEGRANDE,estado nutricional,clasificacion d,2004-02-01,44,52,44,52,96
20801,VIACHA,estado nutricional,clasificacion d,2004-02-01,141,90,141,90,231
31302,VILA VILA,estado nutricional,clasificacion d,2004-02-01,36,81,36,81,117
60303,VILLA MONTES,estado nutricional,clasificacion d,2004-02-01,97,94,97,94,191
90502,VILLA NUEVA (LOMA ALTA),estado nutricional,clasificacion d,2004-02-01,6,10,6,10,16
31402,VILLA RIVERO,estado nutricional,clasificacion d,2004-02-01,20,17,20,17,37
10801,VILLA SERRANO,estado nutricional,clasificacion d,2004-02-01,101,244,101,244,345
31003,VILLA TUNARI,estado nutricional,clasificacion d,2004-02-01,164,155,164,155,319
11001,VILLA VACA GUZMAN (MUYUPAMPA),estado nutricional,clasificacion d,2004-02-01,69,90,69,90,159
51501,VILLAZON,estado nutricional,clasificacion d,2004-02-01,111,144,111,144,255
30904,VINTO,estado nutricional,clasificacion d,2004-02-01,58,30,58,30,88
50602,VITICHI,estado nutricional,clasificacion d,2004-02-01,62,126,62,126,188
20306,WALDO BALLIVIAN,estado nutricional,clasificacion d,2004-02-01,7,7,7,7,14
70201,WARNES,estado nutricional,clasificacion d,2004-02-01,82,56,82,56,138
20903,YACO,estado nutricional,clasificacion d,2004-02-01,39,28,39,28,67
60301,YACUIBA,estado nutricional,clasificacion d,2004-02-01,191,81,191,81,272
10602,YAMPARAEZ,estado nutricional,clasificacion d,2004-02-01,148,304,148,304,452
21103,YANACACHI,estado nutricional,clasificacion d,2004-02-01,7,11,7,11,18
70403,YAPACANI,estado nutricional,clasificacion d,2004-02-01,120,164,120,164,284
50103,YOCALLA,estado nutricional,clasificacion d,2004-02-01,25,46,25,46,71
10102,YOTALA,estado nutricional,clasificacion d,2004-02-01,68,151,68,151,219
60402,YUNCHARA,estado nutricional,clasificacion d,2004-02-01,49,97,49,97,146
10301,ZUDAÃ‘EZ,estado nutricional,clasificacion d,2004-02-01,59,110,59,110,169
51302,ACACIO,estado nutricional,clasificacion d,2004-03-01,66,110,66,110,176
20201,ACHACACHI,estado nutricional,clasificacion d,2004-03-01,141,139,141,139,280
20104,ACHOCALLA,estado nutricional,clasificacion d,2004-03-01,41,30,41,30,71
30201,AIQUILE,estado nutricional,clasificacion d,2004-03-01,93,168,93,168,261
31303,ALALAY,estado nutricional,clasificacion d,2004-03-01,24,20,24,20,44
10404,ALCALA,estado nutricional,clasificacion d,2004-03-01,24,73,24,73,97
20202,ANCORAIMES,estado nutricional,clasificacion d,2004-03-01,94,119,94,119,213
41201,ANDAMARCA,estado nutricional,clasificacion d,2004-03-01,21,40,21,40,61
40603,ANTEQUERA,estado nutricional,clasificacion d,2004-03-01,11,11,11,11,22
30402,ANZALDO,estado nutricional,clasificacion d,2004-03-01,11,32,11,32,43
20701,APOLO,estado nutricional,clasificacion d,2004-03-01,53,77,53,77,130
51301,ARAMPAMPA,estado nutricional,clasificacion d,2004-03-01,58,113,58,113,171
30501,ARANI,estado nutricional,clasificacion d,2004-03-01,45,62,45,62,107
30403,ARBIETO,estado nutricional,clasificacion d,2004-03-01,20,17,20,17,37
30601,ARQUE,estado nutricional,clasificacion d,2004-03-01,111,124,111,124,235
71501,ASCENCION DE GUARAYOS,estado nutricional,clasificacion d,2004-03-01,4,5,4,5,9
50802,ATOCHA,estado nutricional,clasificacion d,2004-03-01,24,166,24,166,190
20503,AUCAPATA,estado nutricional,clasificacion d,2004-03-01,38,51,38,51,89
20502,AYATA,estado nutricional,clasificacion d,2004-03-01,36,18,36,18,54
21303,AYO AYO,estado nutricional,clasificacion d,2004-03-01,25,12,25,12,37
30301,AYOPAYA (V. DE INDEPENDENCIA),estado nutricional,clasificacion d,2004-03-01,107,120,107,120,227
10201,AZURDUY,estado nutricional,clasificacion d,2004-03-01,142,259,142,259,401
21203,BATALLAS,estado nutricional,clasificacion d,2004-03-01,57,64,57,64,121
80802,BAURES,estado nutricional,clasificacion d,2004-03-01,32,27,32,27,59
41202,BELEN DE ANDAMARCA,estado nutricional,clasificacion d,2004-03-01,4,5,4,5,9
50104,BELEN DE URMIRI,estado nutricional,clasificacion d,2004-03-01,9,15,9,15,24
90104,BELLA FLOR,estado nutricional,clasificacion d,2004-03-01,2,8,2,8,10
60202,BERMEJO,estado nutricional,clasificacion d,2004-03-01,34,16,34,16,50
50301,BETANZOS,estado nutricional,clasificacion d,2004-03-01,226,303,226,303,529
31501,BOLIVAR,estado nutricional,clasificacion d,2004-03-01,68,79,68,79,147
90103,BOLPEBRA,estado nutricional,clasificacion d,2004-03-01,7,7,7,7,14
70707,BOYUIBE,estado nutricional,clasificacion d,2004-03-01,17,36,17,36,53
70703,CABEZAS,estado nutricional,clasificacion d,2004-03-01,61,71,61,71,132
20905,CAIROMA,estado nutricional,clasificacion d,2004-03-01,79,111,79,111,190
51102,"CAIZA ""D""",estado nutricional,clasificacion d,2004-03-01,82,125,82,125,207
21003,CAJUATA,estado nutricional,clasificacion d,2004-03-01,49,47,49,47,96
20303,CALACOTO,estado nutricional,clasificacion d,2004-03-01,23,12,23,12,35
21304,CALAMARCA,estado nutricional,clasificacion d,2004-03-01,31,38,31,38,69
10701,CAMARGO,estado nutricional,clasificacion d,2004-03-01,105,116,105,116,221
10901,CAMATAQUI (C. VILLA ABECIA),estado nutricional,clasificacion d,2004-03-01,18,37,18,37,55
70706,CAMIRI,estado nutricional,clasificacion d,2004-03-01,188,152,188,152,340
30701,CAPINOTA,estado nutricional,clasificacion d,2004-03-01,61,120,61,120,181
20302,CAQUIAVIRI,estado nutricional,clasificacion d,2004-03-01,28,32,28,32,60
40102,CARACOLLO,estado nutricional,clasificacion d,2004-03-01,60,60,60,60,120
22001,CARANAVI,estado nutricional,clasificacion d,2004-03-01,229,194,229,194,423
60302,CARAPARI,estado nutricional,clasificacion d,2004-03-01,34,71,34,71,105
50702,CARIPUYO,estado nutricional,clasificacion d,2004-03-01,96,107,96,107,203
21803,CHACARILLA,estado nutricional,clasificacion d,2004-03-01,14,11,14,11,25
40201,CHALLAPATA,estado nutricional,clasificacion d,2004-03-01,53,130,53,130,183
50302,CHAQUI,estado nutricional,clasificacion d,2004-03-01,35,35,35,35,70
70702,CHARAGUA,estado nutricional,clasificacion d,2004-03-01,154,143,154,143,297
20305,CHARAÃ‘A,estado nutricional,clasificacion d,2004-03-01,9,10,9,10,19
50202,CHAYANTA,estado nutricional,clasificacion d,2004-03-01,77,64,77,64,141
31204,CHIMORE,estado nutricional,clasificacion d,2004-03-01,25,49,25,49,74
40903,CHIPAYA,estado nutricional,clasificacion d,2004-03-01,16,9,16,9,25
40302,CHOQUE COTA,estado nutricional,clasificacion d,2004-03-01,3,2,3,2,5
21101,CHULUMANI (V. DE LA LIBERTAD),estado nutricional,clasificacion d,2004-03-01,24,26,24,26,50
20501,CHUMA,estado nutricional,clasificacion d,2004-03-01,23,37,23,37,60
30801,CLIZA,estado nutricional,clasificacion d,2004-03-01,46,30,46,30,76
90101,COBIJA,estado nutricional,clasificacion d,2004-03-01,106,102,106,102,208
30101,COCHABAMBA,estado nutricional,clasificacion d,2004-03-01,742,659,742,659,1401
40902,COIPASA,estado nutricional,clasificacion d,2004-03-01,3,6,3,6,9
30905,COLCAPIRHUA,estado nutricional,clasificacion d,2004-03-01,83,47,83,47,130
50901,"COLCHA ""K""",estado nutricional,clasificacion d,2004-03-01,51,65,51,65,116
21307,COLLANA,estado nutricional,clasificacion d,2004-03-01,8,3,8,3,11
31002,COLOMI,estado nutricional,clasificacion d,2004-03-01,69,27,69,27,96
50401,COLQUECHACA,estado nutricional,clasificacion d,2004-03-01,185,100,185,100,285
21306,COLQUENCHA,estado nutricional,clasificacion d,2004-03-01,39,16,39,16,55
21004,COLQUIRI,estado nutricional,clasificacion d,2004-03-01,115,236,115,236,351
20304,COMANCHE,estado nutricional,clasificacion d,2004-03-01,15,15,15,15,30
71301,COMARAPA,estado nutricional,clasificacion d,2004-03-01,74,66,74,66,140
20605,COMBAYA,estado nutricional,clasificacion d,2004-03-01,4,10,4,10,14
71101,CONCEPCION,estado nutricional,clasificacion d,2004-03-01,35,0,35,0,35
21701,COPACABANA,estado nutricional,clasificacion d,2004-03-01,27,43,27,43,70
21402,CORIPATA,estado nutricional,clasificacion d,2004-03-01,8,2,8,2,10
20301,CORO CORO,estado nutricional,clasificacion d,2004-03-01,32,34,32,34,66
21401,COROICO,estado nutricional,clasificacion d,2004-03-01,21,16,21,16,37
40301,CORQUE,estado nutricional,clasificacion d,2004-03-01,34,38,34,38,72
50601,COTAGAITA,estado nutricional,clasificacion d,2004-03-01,183,284,183,284,467
70102,COTOCA,estado nutricional,clasificacion d,2004-03-01,94,53,94,53,147
31405,CUCHUMUELA (V. G. VILLARROEL),estado nutricional,clasificacion d,2004-03-01,10,7,10,7,17
70704,CUEVO,estado nutricional,clasificacion d,2004-03-01,15,22,15,22,37
10902,CULPINA,estado nutricional,clasificacion d,2004-03-01,196,298,196,298,494
40401,CURAHUARA DE CARANGAS,estado nutricional,clasificacion d,2004-03-01,20,15,20,15,35
21602,CURVA,estado nutricional,clasificacion d,2004-03-01,9,20,9,20,29
20804,DESAGUADERO,estado nutricional,clasificacion d,2004-03-01,10,10,10,10,20
20105,EL ALTO,estado nutricional,clasificacion d,2004-03-01,2351,1685,2351,1685,4036
40103,EL CHORO,estado nutricional,clasificacion d,2004-03-01,15,12,15,12,27
71503,EL PUENTE(STC),estado nutricional,clasificacion d,2004-03-01,90,122,90,122,212
60502,EL PUENTE(TJA),estado nutricional,clasificacion d,2004-03-01,71,122,71,122,193
70105,EL TORNO,estado nutricional,clasificacion d,2004-03-01,62,108,62,108,170
10405,EL VILLAR,estado nutricional,clasificacion d,2004-03-01,50,136,50,136,186
60601,ENTRE RIOS,estado nutricional,clasificacion d,2004-03-01,68,118,68,118,186
41101,EUCALIPTUS,estado nutricional,clasificacion d,2004-03-01,18,26,18,26,44
90503,EUREKA (SANTOS MERCADO),estado nutricional,clasificacion d,2004-03-01,2,0,2,0,2
80402,EXALTACION,estado nutricional,clasificacion d,2004-03-01,8,12,8,12,20
90203,FILADELFIA,estado nutricional,clasificacion d,2004-03-01,5,2,5,2,7
71002,GENERAL SAAVEDRA,estado nutricional,clasificacion d,2004-03-01,123,127,123,127,250
21601,GRAL. J.J. PEREZ (CHARAZANI),estado nutricional,clasificacion d,2004-03-01,60,86,60,86,146
20602,GUANAY,estado nutricional,clasificacion d,2004-03-01,120,173,120,173,293
20802,GUAQUI,estado nutricional,clasificacion d,2004-03-01,10,17,10,17,27
80202,GUAYARAMERIN,estado nutricional,clasificacion d,2004-03-01,123,147,123,147,270
70705,GUTIERREZ,estado nutricional,clasificacion d,2004-03-01,169,278,169,278,447
10502,HUACARETA,estado nutricional,clasificacion d,2004-03-01,58,83,58,83,141
11002,HUACAYA (VILLA DE HUACAYA),estado nutricional,clasificacion d,2004-03-01,17,28,17,28,45
40501,HUACHACALLA,estado nutricional,clasificacion d,2004-03-01,1,7,1,7,8
40701,HUANUNI,estado nutricional,clasificacion d,2004-03-01,116,58,116,58,174
80803,HUARACAJE,estado nutricional,clasificacion d,2004-03-01,11,5,11,5,16
41601,HUAYLLAMARCA,estado nutricional,clasificacion d,2004-03-01,12,13,12,13,25
21005,ICHOCA,estado nutricional,clasificacion d,2004-03-01,22,17,22,17,39
10304,ICLA,estado nutricional,clasificacion d,2004-03-01,119,242,119,242,361
10703,INCAHUASI,estado nutricional,clasificacion d,2004-03-01,208,175,208,175,383
21001,INQUISIVI,estado nutricional,clasificacion d,2004-03-01,123,157,123,157,280
21102,IRUPANA (VILLA DE LANZA),estado nutricional,clasificacion d,2004-03-01,40,48,40,48,88
21501,IXIAMAS,estado nutricional,clasificacion d,2004-03-01,19,38,19,38,57
21105,LA ASUNTA,estado nutricional,clasificacion d,2004-03-01,88,79,88,79,167
70104,LA GUARDIA,estado nutricional,clasificacion d,2004-03-01,79,65,79,65,144
20101,LA PAZ,estado nutricional,clasificacion d,2004-03-01,1867,1763,1867,1763,3630
41501,LA RIVERA,estado nutricional,clasificacion d,2004-03-01,3,2,3,2,5
70701,LAGUNILLAS,estado nutricional,clasificacion d,2004-03-01,39,48,39,48,87
21202,LAJA,estado nutricional,clasificacion d,2004-03-01,35,19,35,19,54
10903,LAS CARRERAS,estado nutricional,clasificacion d,2004-03-01,16,28,16,28,44
21006,LICOMA PAMPA,estado nutricional,clasificacion d,2004-03-01,4,5,4,5,9
50203,LLALLAGUA,estado nutricional,clasificacion d,2004-03-01,92,180,92,180,272
51401,LLICA,estado nutricional,clasificacion d,2004-03-01,12,19,12,19,31
80601,LORETO,estado nutricional,clasificacion d,2004-03-01,7,9,7,9,16
20901,LURIBAY,estado nutricional,clasificacion d,2004-03-01,62,76,62,76,138
40702,MACHACAMARCA,estado nutricional,clasificacion d,2004-03-01,5,11,5,11,16
11003,MACHARETI,estado nutricional,clasificacion d,2004-03-01,38,99,38,99,137
80801,MAGDALENA,estado nutricional,clasificacion d,2004-03-01,35,46,35,46,81
70903,MAIRANA,estado nutricional,clasificacion d,2004-03-01,23,18,23,18,41
20904,MALLA,estado nutricional,clasificacion d,2004-03-01,28,32,28,32,60
20103,MECAPACA,estado nutricional,clasificacion d,2004-03-01,27,17,27,17,44
71003,MINEROS,estado nutricional,clasificacion d,2004-03-01,200,147,200,147,347
31301,MIZQUE,estado nutricional,clasificacion d,2004-03-01,104,83,104,83,187
20402,MOCOMOCO,estado nutricional,clasificacion d,2004-03-01,45,74,45,74,119
51002,MOJINETE,estado nutricional,clasificacion d,2004-03-01,7,11,7,11,18
10303,MOJOCOYA,estado nutricional,clasificacion d,2004-03-01,59,121,59,121,180
10501,MONTEAGUDO,estado nutricional,clasificacion d,2004-03-01,116,184,116,184,300
71001,MONTERO,estado nutricional,clasificacion d,2004-03-01,407,339,407,339,746
70803,MORO MORO,estado nutricional,clasificacion d,2004-03-01,6,12,6,12,18
30302,MOROCHATA,estado nutricional,clasificacion d,2004-03-01,109,115,109,115,224
90401,NACEBE (SANTA ROSA DEL ABUNA),estado nutricional,clasificacion d,2004-03-01,11,11,11,11,22
90501,NUEVO MANOA (NUEVA ESPERANZA),estado nutricional,clasificacion d,2004-03-01,2,0,2,0,2
50404,OCURI,estado nutricional,clasificacion d,2004-03-01,73,92,73,92,165
70202,OKINAWA,estado nutricional,clasificacion d,2004-03-01,34,25,34,25,59
30203,OMEREQUE,estado nutricional,clasificacion d,2004-03-01,33,20,33,20,53
40101,ORURO,estado nutricional,clasificacion d,2004-03-01,768,565,768,565,1333
60201,PADCAYA,estado nutricional,clasificacion d,2004-03-01,52,105,52,105,157
10401,PADILLA,estado nutricional,clasificacion d,2004-03-01,113,248,113,248,361
70502,PAILON,estado nutricional,clasificacion d,2004-03-01,39,32,39,32,71
20102,PALCA,estado nutricional,clasificacion d,2004-03-01,60,29,60,29,89
21104,PALOS BLANCOS,estado nutricional,clasificacion d,2004-03-01,92,137,92,137,229
40802,PAMPA AULLAGAS,estado nutricional,clasificacion d,2004-03-01,8,17,8,17,25
70902,PAMPA GRANDE,estado nutricional,clasificacion d,2004-03-01,27,15,27,15,42
21802,PAPEL PAMPA,estado nutricional,clasificacion d,2004-03-01,17,11,17,11,28
30202,PASORAPA,estado nutricional,clasificacion d,2004-03-01,26,41,26,41,67
21305,PATACAMAYA,estado nutricional,clasificacion d,2004-03-01,152,116,152,116,268
40602,PAZÃ‘A,estado nutricional,clasificacion d,2004-03-01,21,33,21,33,54
20702,PELECHUCO,estado nutricional,clasificacion d,2004-03-01,36,45,36,45,81
50403,POCOATA,estado nutricional,clasificacion d,2004-03-01,164,201,164,201,365
31203,POCONA,estado nutricional,clasificacion d,2004-03-01,37,44,37,44,81
31202,POJO (CBBA),estado nutricional,clasificacion d,2004-03-01,144,140,144,140,284
40601,POOPO,estado nutricional,clasificacion d,2004-03-01,13,17,13,17,30
51203,PORCO,estado nutricional,clasificacion d,2004-03-01,17,18,17,18,35
10103,POROMA,estado nutricional,clasificacion d,2004-03-01,155,183,155,183,338
70103,PORONGO,estado nutricional,clasificacion d,2004-03-01,16,18,16,18,34
70601,PORTACHUELO,estado nutricional,clasificacion d,2004-03-01,64,88,64,88,152
90102,PORVENIR,estado nutricional,clasificacion d,2004-03-01,5,14,5,14,19
70804,POSTRER VALLE,estado nutricional,clasificacion d,2004-03-01,5,5,5,5,10
50101,POTOSI,estado nutricional,clasificacion d,2004-03-01,781,799,781,799,1580
10302,PRESTO,estado nutricional,clasificacion d,2004-03-01,47,101,47,101,148
21201,PUCARANI,estado nutricional,clasificacion d,2004-03-01,74,49,74,49,123
20401,PUERTO ACOSTA,estado nutricional,clasificacion d,2004-03-01,54,58,54,58,112
20403,PUERTO CARABUCO,estado nutricional,clasificacion d,2004-03-01,67,63,67,63,130
90301,PUERTO GONZALO MORENO,estado nutricional,clasificacion d,2004-03-01,20,55,20,55,75
21204,PUERTO PEREZ,estado nutricional,clasificacion d,2004-03-01,15,20,15,20,35
71402,PUERTO QUIJARRO,estado nutricional,clasificacion d,2004-03-01,30,4,30,4,34
90201,PUERTO RICO,estado nutricional,clasificacion d,2004-03-01,23,29,23,29,52
71401,PUERTO SUAREZ,estado nutricional,clasificacion d,2004-03-01,41,30,41,30,71
31205,PUERTO VILLARROEL,estado nutricional,clasificacion d,2004-03-01,237,178,237,178,415
51101,PUNA,estado nutricional,clasificacion d,2004-03-01,223,254,223,254,477
31401,PUNATA,estado nutricional,clasificacion d,2004-03-01,83,45,83,45,128
20604,QUIABAYA,estado nutricional,clasificacion d,2004-03-01,10,24,10,24,34
30901,QUILLACOLLO,estado nutricional,clasificacion d,2004-03-01,206,180,206,180,386
21002,QUIME,estado nutricional,clasificacion d,2004-03-01,43,63,43,63,106
70904,QUIRUSILLAS,estado nutricional,clasificacion d,2004-03-01,4,7,4,7,11
50402,RAVELO,estado nutricional,clasificacion d,2004-03-01,217,301,217,301,518
80301,REYES,estado nutricional,clasificacion d,2004-03-01,39,68,39,68,107
80201,RIBERALTA,estado nutricional,clasificacion d,2004-03-01,483,413,483,413,896
70503,ROBORE,estado nutricional,clasificacion d,2004-03-01,70,54,70,54,124
80304,RURRENABAQUE,estado nutricional,clasificacion d,2004-03-01,23,12,23,12,35
40901,SABAYA,estado nutricional,clasificacion d,2004-03-01,4,14,4,14,18
31001,SACABA,estado nutricional,clasificacion d,2004-03-01,146,144,146,144,290
30404,SACABAMBA,estado nutricional,clasificacion d,2004-03-01,14,43,14,43,57
50701,SACACA,estado nutricional,clasificacion d,2004-03-01,388,578,388,578,966
71302,SAIPINA,estado nutricional,clasificacion d,2004-03-01,16,24,16,24,40
40801,SALINAS DE GARCI MENDOZA,estado nutricional,clasificacion d,2004-03-01,21,43,21,43,64
70901,SAMAIPATA,estado nutricional,clasificacion d,2004-03-01,20,10,20,10,30
51601,SAN AGUSTIN,estado nutricional,clasificacion d,2004-03-01,6,14,6,14,20
80602,SAN ANDRES,estado nutricional,clasificacion d,2004-03-01,55,87,55,87,142
51003,SAN ANTONIO DE ESMORUCO,estado nutricional,clasificacion d,2004-03-01,8,15,8,15,23
71105,SAN ANTONIO DE LOMERIO,estado nutricional,clasificacion d,2004-03-01,82,153,82,153,235
31403,SAN BENITO,estado nutricional,clasificacion d,2004-03-01,19,5,19,5,24
80302,SAN BORJA,estado nutricional,clasificacion d,2004-03-01,250,225,250,225,475
21502,SAN BUENA VENTURA,estado nutricional,clasificacion d,2004-03-01,48,49,48,49,97
70402,SAN CARLOS,estado nutricional,clasificacion d,2004-03-01,89,75,89,75,164
80501,SAN IGNACIO,estado nutricional,clasificacion d,2004-03-01,161,164,161,164,325
70301,SAN IGNACIO DE VELASCO,estado nutricional,clasificacion d,2004-03-01,272,208,272,208,480
80102,SAN JAVIER(BNI),estado nutricional,clasificacion d,2004-03-01,19,33,19,33,52
71102,SAN JAVIER(STC),estado nutricional,clasificacion d,2004-03-01,68,76,68,76,144
80701,SAN JOAQUIN,estado nutricional,clasificacion d,2004-03-01,5,20,5,20,25
70501,SAN JOSE DE CHIQUITOS,estado nutricional,clasificacion d,2004-03-01,55,31,55,31,86
71104,SAN JULIAN,estado nutricional,clasificacion d,2004-03-01,184,222,184,222,406
90302,SAN LORENZO(PND),estado nutricional,clasificacion d,2004-03-01,8,16,8,16,24
60501,SAN LORENZO(TJA),estado nutricional,clasificacion d,2004-03-01,63,106,63,106,169
10702,SAN LUCAS,estado nutricional,clasificacion d,2004-03-01,357,406,357,406,763
71201,SAN MATIAS,estado nutricional,clasificacion d,2004-03-01,59,34,59,34,93
70302,SAN MIGUEL DE VELASCO,estado nutricional,clasificacion d,2004-03-01,82,82,82,82,164
51001,SAN PABLO DE LIPEZ,estado nutricional,clasificacion d,2004-03-01,30,26,30,26,56
50501,SAN PEDRO DE BUENA VISTA,estado nutricional,clasificacion d,2004-03-01,181,320,181,320,501
21801,SAN PEDRO DE CURAHUARA,estado nutricional,clasificacion d,2004-03-01,16,42,16,42,58
21702,SAN PEDRO DE TIQUINA,estado nutricional,clasificacion d,2004-03-01,3,6,3,6,9
90202,SAN PEDRO(PND),estado nutricional,clasificacion d,2004-03-01,5,0,5,0,5
70303,SAN RAFAEL,estado nutricional,clasificacion d,2004-03-01,45,26,45,26,71
80702,SAN RAMON,estado nutricional,clasificacion d,2004-03-01,16,17,16,17,33
80401,SANTA ANA,estado nutricional,clasificacion d,2004-03-01,28,13,28,13,41
70101,SANTA CRUZ DE LA SIERRA,estado nutricional,clasificacion d,2004-03-01,1668,955,1668,955,2623
80303,SANTA ROSA,estado nutricional,clasificacion d,2004-03-01,46,42,46,42,88
70602,SANTA ROSA DEL SARA,estado nutricional,clasificacion d,2004-03-01,23,27,23,27,50
20308,SANTIAGO DE CALLAPA,estado nutricional,clasificacion d,2004-03-01,37,38,37,38,75
41401,SANTIAGO DE HUARI,estado nutricional,clasificacion d,2004-03-01,3,15,3,15,18
21901,SANTIAGO DE MACHACA,estado nutricional,clasificacion d,2004-03-01,19,50,19,50,69
30702,SANTIVAÃ‘ES,estado nutricional,clasificacion d,2004-03-01,49,50,49,50,99
40202,SANTUARIO DE QUILLACAS,estado nutricional,clasificacion d,2004-03-01,9,16,9,16,25
20902,SAPAHAQUI,estado nutricional,clasificacion d,2004-03-01,56,53,56,53,109
90303,SENA,estado nutricional,clasificacion d,2004-03-01,16,8,16,8,24
21301,SICA SICA (VILLA AROMA),estado nutricional,clasificacion d,2004-03-01,124,112,124,112,236
30703,SICAYA,estado nutricional,clasificacion d,2004-03-01,9,14,9,14,23
30902,SIPE SIPE,estado nutricional,clasificacion d,2004-03-01,186,144,186,144,330
10403,SOPACHUY,estado nutricional,clasificacion d,2004-03-01,51,32,51,32,83
20601,SORATA,estado nutricional,clasificacion d,2004-03-01,71,88,71,88,159
10101,SUCRE,estado nutricional,clasificacion d,2004-03-01,875,901,875,901,1776
31404,TACACHI,estado nutricional,clasificacion d,2004-03-01,8,9,8,9,17
20603,TACACOMA,estado nutricional,clasificacion d,2004-03-01,45,41,45,41,86
50303,TACOBAMBA,estado nutricional,clasificacion d,2004-03-01,49,71,49,71,120
30602,TACOPAYA,estado nutricional,clasificacion d,2004-03-01,88,129,88,129,217
51402,TAHUA,estado nutricional,clasificacion d,2004-03-01,3,4,3,4,7
31101,TAPACARI,estado nutricional,clasificacion d,2004-03-01,172,188,172,188,360
10601,TARABUCO,estado nutricional,clasificacion d,2004-03-01,246,542,246,542,788
30401,TARATA,estado nutricional,clasificacion d,2004-03-01,56,30,56,30,86
60101,TARIJA,estado nutricional,clasificacion d,2004-03-01,393,399,393,399,792
10202,TARVITA,estado nutricional,clasificacion d,2004-03-01,170,285,170,285,455
20803,TIAWANACU,estado nutricional,clasificacion d,2004-03-01,44,18,44,18,62
50102,TINGUIPAYA,estado nutricional,clasificacion d,2004-03-01,179,247,179,247,426
20606,TIPUANI,estado nutricional,clasificacion d,2004-03-01,17,18,17,18,35
30903,TIQUIPAYA,estado nutricional,clasificacion d,2004-03-01,63,63,63,63,126
31601,TIRAQUE (CBBA),estado nutricional,clasificacion d,2004-03-01,208,195,208,195,403
21703,TITO YUPANQUI (PARQUIPUJIO),estado nutricional,clasificacion d,2004-03-01,8,16,8,16,24
30802,TOCO,estado nutricional,clasificacion d,2004-03-01,2,13,2,13,15
41502,TODOS SANTOS,estado nutricional,clasificacion d,2004-03-01,3,4,3,4,7
30803,TOLATA,estado nutricional,clasificacion d,2004-03-01,9,16,9,16,25
41001,TOLEDO,estado nutricional,clasificacion d,2004-03-01,16,18,16,18,34
51202,TOMAVE,estado nutricional,clasificacion d,2004-03-01,69,81,69,81,150
10402,TOMINA,estado nutricional,clasificacion d,2004-03-01,118,221,118,221,339
50502,TORO TORO,estado nutricional,clasificacion d,2004-03-01,159,159,159,159,318
31201,TOTORA(CBBA),estado nutricional,clasificacion d,2004-03-01,73,80,73,80,153
41301,TOTORA(ORR),estado nutricional,clasificacion d,2004-03-01,19,31,19,31,50
70802,TRIGAL,estado nutricional,clasificacion d,2004-03-01,2,3,2,3,5
80101,TRINIDAD,estado nutricional,clasificacion d,2004-03-01,231,232,231,232,463
50801,TUPIZA,estado nutricional,clasificacion d,2004-03-01,220,278,220,278,498
21302,UMALA,estado nutricional,clasificacion d,2004-03-01,20,17,20,17,37
50201,UNCIA,estado nutricional,clasificacion d,2004-03-01,114,63,114,63,177
60401,URIONDO (A. CONCEPCION),estado nutricional,clasificacion d,2004-03-01,67,92,67,92,159
71502,URUBICHA,estado nutricional,clasificacion d,2004-03-01,18,37,18,37,55
51201,UYUNI,estado nutricional,clasificacion d,2004-03-01,76,93,76,93,169
30502,VACAS,estado nutricional,clasificacion d,2004-03-01,38,38,38,38,76
70801,VALLEGRANDE,estado nutricional,clasificacion d,2004-03-01,46,50,46,50,96
20801,VIACHA,estado nutricional,clasificacion d,2004-03-01,169,141,169,141,310
31302,VILA VILA,estado nutricional,clasificacion d,2004-03-01,29,18,29,18,47
60303,VILLA MONTES,estado nutricional,clasificacion d,2004-03-01,109,95,109,95,204
90502,VILLA NUEVA (LOMA ALTA),estado nutricional,clasificacion d,2004-03-01,2,2,2,2,4
31402,VILLA RIVERO,estado nutricional,clasificacion d,2004-03-01,19,15,19,15,34
10801,VILLA SERRANO,estado nutricional,clasificacion d,2004-03-01,108,257,108,257,365
31003,VILLA TUNARI,estado nutricional,clasificacion d,2004-03-01,256,201,256,201,457
11001,VILLA VACA GUZMAN (MUYUPAMPA),estado nutricional,clasificacion d,2004-03-01,48,95,48,95,143
51501,VILLAZON,estado nutricional,clasificacion d,2004-03-01,181,239,181,239,420
30904,VINTO,estado nutricional,clasificacion d,2004-03-01,69,34,69,34,103
50602,VITICHI,estado nutricional,clasificacion d,2004-03-01,83,170,83,170,253
20306,WALDO BALLIVIAN,estado nutricional,clasificacion d,2004-03-01,6,10,6,10,16
70201,WARNES,estado nutricional,clasificacion d,2004-03-01,106,79,106,79,185
20903,YACO,estado nutricional,clasificacion d,2004-03-01,50,27,50,27,77
60301,YACUIBA,estado nutricional,clasificacion d,2004-03-01,144,83,144,83,227
10602,YAMPARAEZ,estado nutricional,clasificacion d,2004-03-01,143,295,143,295,438
21103,YANACACHI,estado nutricional,clasificacion d,2004-03-01,12,16,12,16,28
70403,YAPACANI,estado nutricional,clasificacion d,2004-03-01,201,197,201,197,398
50103,YOCALLA,estado nutricional,clasificacion d,2004-03-01,39,57,39,57,96
10102,YOTALA,estado nutricional,clasificacion d,2004-03-01,93,179,93,179,272
60402,YUNCHARA,estado nutricional,clasificacion d,2004-03-01,74,149,74,149,223
10301,ZUDAÃ‘EZ,estado nutricional,clasificacion d,2004-03-01,63,128,63,128,191
51302,ACACIO,estado nutricional,clasificacion d,2004-04-01,69,102,69,102,171
20201,ACHACACHI,estado nutricional,clasificacion d,2004-04-01,91,100,91,100,191
20104,ACHOCALLA,estado nutricional,clasificacion d,2004-04-01,18,24,18,24,42
30201,AIQUILE,estado nutricional,clasificacion d,2004-04-01,62,50,62,50,112
31303,ALALAY,estado nutricional,clasificacion d,2004-04-01,5,10,5,10,15
10404,ALCALA,estado nutricional,clasificacion d,2004-04-01,29,83,29,83,112
20202,ANCORAIMES,estado nutricional,clasificacion d,2004-04-01,57,89,57,89,146
41201,ANDAMARCA,estado nutricional,clasificacion d,2004-04-01,7,7,7,7,14
40603,ANTEQUERA,estado nutricional,clasificacion d,2004-04-01,12,11,12,11,23
30402,ANZALDO,estado nutricional,clasificacion d,2004-04-01,10,19,10,19,29
20701,APOLO,estado nutricional,clasificacion d,2004-04-01,38,34,38,34,72
51301,ARAMPAMPA,estado nutricional,clasificacion d,2004-04-01,38,74,38,74,112
30501,ARANI,estado nutricional,clasificacion d,2004-04-01,25,22,25,22,47
30403,ARBIETO,estado nutricional,clasificacion d,2004-04-01,18,11,18,11,29
30601,ARQUE,estado nutricional,clasificacion d,2004-04-01,100,110,100,110,210
71501,ASCENCION DE GUARAYOS,estado nutricional,clasificacion d,2004-04-01,173,221,173,221,394
50802,ATOCHA,estado nutricional,clasificacion d,2004-04-01,45,157,45,157,202
20503,AUCAPATA,estado nutricional,clasificacion d,2004-04-01,25,27,25,27,52
20502,AYATA,estado nutricional,clasificacion d,2004-04-01,49,42,49,42,91
21303,AYO AYO,estado nutricional,clasificacion d,2004-04-01,26,11,26,11,37
30301,AYOPAYA (V. DE INDEPENDENCIA),estado nutricional,clasificacion d,2004-04-01,137,154,137,154,291
10201,AZURDUY,estado nutricional,clasificacion d,2004-04-01,116,279,116,279,395
21203,BATALLAS,estado nutricional,clasificacion d,2004-04-01,27,18,27,18,45
80802,BAURES,estado nutricional,clasificacion d,2004-04-01,13,9,13,9,22
41202,BELEN DE ANDAMARCA,estado nutricional,clasificacion d,2004-04-01,1,4,1,4,5
50104,BELEN DE URMIRI,estado nutricional,clasificacion d,2004-04-01,6,9,6,9,15
90104,BELLA FLOR,estado nutricional,clasificacion d,2004-04-01,8,29,8,29,37
60202,BERMEJO,estado nutricional,clasificacion d,2004-04-01,34,21,34,21,55
50301,BETANZOS,estado nutricional,clasificacion d,2004-04-01,205,321,205,321,526
31501,BOLIVAR,estado nutricional,clasificacion d,2004-04-01,74,102,74,102,176
90103,BOLPEBRA,estado nutricional,clasificacion d,2004-04-01,3,10,3,10,13
70707,BOYUIBE,estado nutricional,clasificacion d,2004-04-01,10,11,10,11,21
70401,BUENA VISTA,estado nutricional,clasificacion d,2004-04-01,3,0,3,0,3
70703,CABEZAS,estado nutricional,clasificacion d,2004-04-01,32,41,32,41,73
20905,CAIROMA,estado nutricional,clasificacion d,2004-04-01,59,69,59,69,128
51102,"CAIZA ""D""",estado nutricional,clasificacion d,2004-04-01,46,59,46,59,105
21003,CAJUATA,estado nutricional,clasificacion d,2004-04-01,31,21,31,21,52
20303,CALACOTO,estado nutricional,clasificacion d,2004-04-01,24,25,24,25,49
21304,CALAMARCA,estado nutricional,clasificacion d,2004-04-01,157,105,157,105,262
10701,CAMARGO,estado nutricional,clasificacion d,2004-04-01,89,89,89,89,178
10901,CAMATAQUI (C. VILLA ABECIA),estado nutricional,clasificacion d,2004-04-01,19,29,19,29,48
70706,CAMIRI,estado nutricional,clasificacion d,2004-04-01,181,144,181,144,325
30701,CAPINOTA,estado nutricional,clasificacion d,2004-04-01,33,41,33,41,74
20302,CAQUIAVIRI,estado nutricional,clasificacion d,2004-04-01,70,86,70,86,156
40102,CARACOLLO,estado nutricional,clasificacion d,2004-04-01,78,113,78,113,191
22001,CARANAVI,estado nutricional,clasificacion d,2004-04-01,208,213,208,213,421
41503,CARANGAS,estado nutricional,clasificacion d,2004-04-01,0,2,0,2,2
60302,CARAPARI,estado nutricional,clasificacion d,2004-04-01,16,19,16,19,35
50702,CARIPUYO,estado nutricional,clasificacion d,2004-04-01,101,113,101,113,214
21902,CATACORA,estado nutricional,clasificacion d,2004-04-01,7,13,7,13,20
21803,CHACARILLA,estado nutricional,clasificacion d,2004-04-01,5,7,5,7,12
40201,CHALLAPATA,estado nutricional,clasificacion d,2004-04-01,64,171,64,171,235
50302,CHAQUI,estado nutricional,clasificacion d,2004-04-01,35,47,35,47,82
70702,CHARAGUA,estado nutricional,clasificacion d,2004-04-01,89,122,89,122,211
20305,CHARAÃ‘A,estado nutricional,clasificacion d,2004-04-01,5,3,5,3,8
50202,CHAYANTA,estado nutricional,clasificacion d,2004-04-01,61,82,61,82,143
31204,CHIMORE,estado nutricional,clasificacion d,2004-04-01,18,26,18,26,44
40903,CHIPAYA,estado nutricional,clasificacion d,2004-04-01,9,9,9,9,18
40302,CHOQUE COTA,estado nutricional,clasificacion d,2004-04-01,2,8,2,8,10
21101,CHULUMANI (V. DE LA LIBERTAD),estado nutricional,clasificacion d,2004-04-01,21,18,21,18,39
20501,CHUMA,estado nutricional,clasificacion d,2004-04-01,70,61,70,61,131
30801,CLIZA,estado nutricional,clasificacion d,2004-04-01,62,48,62,48,110
90101,COBIJA,estado nutricional,clasificacion d,2004-04-01,109,88,109,88,197
30101,COCHABAMBA,estado nutricional,clasificacion d,2004-04-01,640,627,640,627,1267
40902,COIPASA,estado nutricional,clasificacion d,2004-04-01,1,3,1,3,4
30905,COLCAPIRHUA,estado nutricional,clasificacion d,2004-04-01,79,69,79,69,148
50901,"COLCHA ""K""",estado nutricional,clasificacion d,2004-04-01,46,60,46,60,106
21307,COLLANA,estado nutricional,clasificacion d,2004-04-01,4,0,4,0,4
31002,COLOMI,estado nutricional,clasificacion d,2004-04-01,93,41,93,41,134
50401,COLQUECHACA,estado nutricional,clasificacion d,2004-04-01,165,95,165,95,260
21306,COLQUENCHA,estado nutricional,clasificacion d,2004-04-01,29,15,29,15,44
21004,COLQUIRI,estado nutricional,clasificacion d,2004-04-01,78,67,78,67,145
20304,COMANCHE,estado nutricional,clasificacion d,2004-04-01,11,13,11,13,24
71301,COMARAPA,estado nutricional,clasificacion d,2004-04-01,50,37,50,37,87
20605,COMBAYA,estado nutricional,clasificacion d,2004-04-01,11,8,11,8,19
71101,CONCEPCION,estado nutricional,clasificacion d,2004-04-01,23,7,23,7,30
21701,COPACABANA,estado nutricional,clasificacion d,2004-04-01,32,28,32,28,60
21402,CORIPATA,estado nutricional,clasificacion d,2004-04-01,6,1,6,1,7
20301,CORO CORO,estado nutricional,clasificacion d,2004-04-01,57,84,57,84,141
21401,COROICO,estado nutricional,clasificacion d,2004-04-01,18,21,18,21,39
40301,CORQUE,estado nutricional,clasificacion d,2004-04-01,26,28,26,28,54
50601,COTAGAITA,estado nutricional,clasificacion d,2004-04-01,114,174,114,174,288
70102,COTOCA,estado nutricional,clasificacion d,2004-04-01,58,43,58,43,101
70704,CUEVO,estado nutricional,clasificacion d,2004-04-01,15,11,15,11,26
10902,CULPINA,estado nutricional,clasificacion d,2004-04-01,191,230,191,230,421
40401,CURAHUARA DE CARANGAS,estado nutricional,clasificacion d,2004-04-01,34,22,34,22,56
21602,CURVA,estado nutricional,clasificacion d,2004-04-01,38,28,38,28,66
20804,DESAGUADERO,estado nutricional,clasificacion d,2004-04-01,8,6,8,6,14
20105,EL ALTO,estado nutricional,clasificacion d,2004-04-01,2042,1554,2042,1554,3596
40103,EL CHORO,estado nutricional,clasificacion d,2004-04-01,5,7,5,7,12
71503,EL PUENTE(STC),estado nutricional,clasificacion d,2004-04-01,80,108,80,108,188
60502,EL PUENTE(TJA),estado nutricional,clasificacion d,2004-04-01,35,61,35,61,96
70105,EL TORNO,estado nutricional,clasificacion d,2004-04-01,43,45,43,45,88
10405,EL VILLAR,estado nutricional,clasificacion d,2004-04-01,58,126,58,126,184
60601,ENTRE RIOS,estado nutricional,clasificacion d,2004-04-01,50,52,50,52,102
41101,EUCALIPTUS,estado nutricional,clasificacion d,2004-04-01,8,12,8,12,20
90503,EUREKA (SANTOS MERCADO),estado nutricional,clasificacion d,2004-04-01,3,1,3,1,4
80402,EXALTACION,estado nutricional,clasificacion d,2004-04-01,17,20,17,20,37
90203,FILADELFIA,estado nutricional,clasificacion d,2004-04-01,4,7,4,7,11
71002,GENERAL SAAVEDRA,estado nutricional,clasificacion d,2004-04-01,66,70,66,70,136
21601,GRAL. J.J. PEREZ (CHARAZANI),estado nutricional,clasificacion d,2004-04-01,56,90,56,90,146
20602,GUANAY,estado nutricional,clasificacion d,2004-04-01,129,154,129,154,283
20802,GUAQUI,estado nutricional,clasificacion d,2004-04-01,7,8,7,8,15
80202,GUAYARAMERIN,estado nutricional,clasificacion d,2004-04-01,127,131,127,131,258
70705,GUTIERREZ,estado nutricional,clasificacion d,2004-04-01,106,152,106,152,258
10502,HUACARETA,estado nutricional,clasificacion d,2004-04-01,79,163,79,163,242
11002,HUACAYA (VILLA DE HUACAYA),estado nutricional,clasificacion d,2004-04-01,19,36,19,36,55
40501,HUACHACALLA,estado nutricional,clasificacion d,2004-04-01,2,2,2,2,4
40701,HUANUNI,estado nutricional,clasificacion d,2004-04-01,99,61,99,61,160
80803,HUARACAJE,estado nutricional,clasificacion d,2004-04-01,8,3,8,3,11
41601,HUAYLLAMARCA,estado nutricional,clasificacion d,2004-04-01,8,15,8,15,23
21005,ICHOCA,estado nutricional,clasificacion d,2004-04-01,12,13,12,13,25
10304,ICLA,estado nutricional,clasificacion d,2004-04-01,136,227,136,227,363
10703,INCAHUASI,estado nutricional,clasificacion d,2004-04-01,145,183,145,183,328
21001,INQUISIVI,estado nutricional,clasificacion d,2004-04-01,84,82,84,82,166
21102,IRUPANA (VILLA DE LANZA),estado nutricional,clasificacion d,2004-04-01,38,95,38,95,133
21501,IXIAMAS,estado nutricional,clasificacion d,2004-04-01,29,57,29,57,86
21105,LA ASUNTA,estado nutricional,clasificacion d,2004-04-01,60,69,60,69,129
70104,LA GUARDIA,estado nutricional,clasificacion d,2004-04-01,64,54,64,54,118
20101,LA PAZ,estado nutricional,clasificacion d,2004-04-01,1524,1433,1524,1433,2957
41501,LA RIVERA,estado nutricional,clasificacion d,2004-04-01,1,0,1,0,1
70701,LAGUNILLAS,estado nutricional,clasificacion d,2004-04-01,32,55,32,55,87
21202,LAJA,estado nutricional,clasificacion d,2004-04-01,21,19,21,19,40
10903,LAS CARRERAS,estado nutricional,clasificacion d,2004-04-01,11,42,11,42,53
21006,LICOMA PAMPA,estado nutricional,clasificacion d,2004-04-01,5,2,5,2,7
50203,LLALLAGUA,estado nutricional,clasificacion d,2004-04-01,86,138,86,138,224
51401,LLICA,estado nutricional,clasificacion d,2004-04-01,11,15,11,15,26
80601,LORETO,estado nutricional,clasificacion d,2004-04-01,4,13,4,13,17
20901,LURIBAY,estado nutricional,clasificacion d,2004-04-01,47,72,47,72,119
40702,MACHACAMARCA,estado nutricional,clasificacion d,2004-04-01,9,20,9,20,29
11003,MACHARETI,estado nutricional,clasificacion d,2004-04-01,29,84,29,84,113
80801,MAGDALENA,estado nutricional,clasificacion d,2004-04-01,32,26,32,26,58
70903,MAIRANA,estado nutricional,clasificacion d,2004-04-01,20,26,20,26,46
20904,MALLA,estado nutricional,clasificacion d,2004-04-01,0,2,0,2,2
20103,MECAPACA,estado nutricional,clasificacion d,2004-04-01,35,33,35,33,68
71003,MINEROS,estado nutricional,clasificacion d,2004-04-01,169,110,169,110,279
31301,MIZQUE,estado nutricional,clasificacion d,2004-04-01,59,81,59,81,140
20402,MOCOMOCO,estado nutricional,clasificacion d,2004-04-01,88,143,88,143,231
51002,MOJINETE,estado nutricional,clasificacion d,2004-04-01,6,0,6,0,6
10303,MOJOCOYA,estado nutricional,clasificacion d,2004-04-01,59,105,59,105,164
10501,MONTEAGUDO,estado nutricional,clasificacion d,2004-04-01,124,249,124,249,373
71001,MONTERO,estado nutricional,clasificacion d,2004-04-01,290,263,290,263,553
70803,MORO MORO,estado nutricional,clasificacion d,2004-04-01,3,9,3,9,12
30302,MOROCHATA,estado nutricional,clasificacion d,2004-04-01,125,139,125,139,264
90401,NACEBE (SANTA ROSA DEL ABUNA),estado nutricional,clasificacion d,2004-04-01,11,8,11,8,19
20307,NAZACARA DE PACAJES,estado nutricional,clasificacion d,2004-04-01,2,3,2,3,5
50404,OCURI,estado nutricional,clasificacion d,2004-04-01,87,110,87,110,197
70202,OKINAWA,estado nutricional,clasificacion d,2004-04-01,15,24,15,24,39
30203,OMEREQUE,estado nutricional,clasificacion d,2004-04-01,14,9,14,9,23
40101,ORURO,estado nutricional,clasificacion d,2004-04-01,541,448,541,448,989
60201,PADCAYA,estado nutricional,clasificacion d,2004-04-01,47,65,47,65,112
10401,PADILLA,estado nutricional,clasificacion d,2004-04-01,119,240,119,240,359
70502,PAILON,estado nutricional,clasificacion d,2004-04-01,39,16,39,16,55
20102,PALCA,estado nutricional,clasificacion d,2004-04-01,54,27,54,27,81
21104,PALOS BLANCOS,estado nutricional,clasificacion d,2004-04-01,106,107,106,107,213
40802,PAMPA AULLAGAS,estado nutricional,clasificacion d,2004-04-01,5,11,5,11,16
70902,PAMPA GRANDE,estado nutricional,clasificacion d,2004-04-01,11,6,11,6,17
21802,PAPEL PAMPA,estado nutricional,clasificacion d,2004-04-01,20,18,20,18,38
30202,PASORAPA,estado nutricional,clasificacion d,2004-04-01,20,20,20,20,40
21305,PATACAMAYA,estado nutricional,clasificacion d,2004-04-01,160,155,160,155,315
40602,PAZÃ‘A,estado nutricional,clasificacion d,2004-04-01,8,24,8,24,32
20702,PELECHUCO,estado nutricional,clasificacion d,2004-04-01,42,47,42,47,89
50403,POCOATA,estado nutricional,clasificacion d,2004-04-01,213,270,213,270,483
31203,POCONA,estado nutricional,clasificacion d,2004-04-01,52,41,52,41,93
31202,POJO (CBBA),estado nutricional,clasificacion d,2004-04-01,166,100,166,100,266
40601,POOPO,estado nutricional,clasificacion d,2004-04-01,6,10,6,10,16
51203,PORCO,estado nutricional,clasificacion d,2004-04-01,35,16,35,16,51
10103,POROMA,estado nutricional,clasificacion d,2004-04-01,134,136,134,136,270
70103,PORONGO,estado nutricional,clasificacion d,2004-04-01,17,4,17,4,21
70601,PORTACHUELO,estado nutricional,clasificacion d,2004-04-01,66,49,66,49,115
90102,PORVENIR,estado nutricional,clasificacion d,2004-04-01,10,18,10,18,28
70804,POSTRER VALLE,estado nutricional,clasificacion d,2004-04-01,0,4,0,4,4
50101,POTOSI,estado nutricional,clasificacion d,2004-04-01,702,685,702,685,1387
10302,PRESTO,estado nutricional,clasificacion d,2004-04-01,68,120,68,120,188
70805,PUCARA,estado nutricional,clasificacion d,2004-04-01,7,5,7,5,12
21201,PUCARANI,estado nutricional,clasificacion d,2004-04-01,54,50,54,50,104
20401,PUERTO ACOSTA,estado nutricional,clasificacion d,2004-04-01,75,99,75,99,174
20403,PUERTO CARABUCO,estado nutricional,clasificacion d,2004-04-01,55,94,55,94,149
90301,PUERTO GONZALO MORENO,estado nutricional,clasificacion d,2004-04-01,35,44,35,44,79
21204,PUERTO PEREZ,estado nutricional,clasificacion d,2004-04-01,10,12,10,12,22
71402,PUERTO QUIJARRO,estado nutricional,clasificacion d,2004-04-01,28,6,28,6,34
90201,PUERTO RICO,estado nutricional,clasificacion d,2004-04-01,22,3,22,3,25
80703,PUERTO SILES,estado nutricional,clasificacion d,2004-04-01,18,13,18,13,31
71401,PUERTO SUAREZ,estado nutricional,clasificacion d,2004-04-01,20,18,20,18,38
31205,PUERTO VILLARROEL,estado nutricional,clasificacion d,2004-04-01,176,153,176,153,329
51101,PUNA,estado nutricional,clasificacion d,2004-04-01,80,87,80,87,167
31401,PUNATA,estado nutricional,clasificacion d,2004-04-01,74,24,74,24,98
20604,QUIABAYA,estado nutricional,clasificacion d,2004-04-01,9,30,9,30,39
30901,QUILLACOLLO,estado nutricional,clasificacion d,2004-04-01,125,151,125,151,276
21002,QUIME,estado nutricional,clasificacion d,2004-04-01,59,73,59,73,132
70904,QUIRUSILLAS,estado nutricional,clasificacion d,2004-04-01,6,9,6,9,15
50402,RAVELO,estado nutricional,clasificacion d,2004-04-01,168,188,168,188,356
80301,REYES,estado nutricional,clasificacion d,2004-04-01,62,89,62,89,151
80201,RIBERALTA,estado nutricional,clasificacion d,2004-04-01,395,335,395,335,730
70503,ROBORE,estado nutricional,clasificacion d,2004-04-01,44,39,44,39,83
80304,RURRENABAQUE,estado nutricional,clasificacion d,2004-04-01,38,17,38,17,55
40901,SABAYA,estado nutricional,clasificacion d,2004-04-01,2,13,2,13,15
31001,SACABA,estado nutricional,clasificacion d,2004-04-01,67,34,67,34,101
30404,SACABAMBA,estado nutricional,clasificacion d,2004-04-01,34,47,34,47,81
50701,SACACA,estado nutricional,clasificacion d,2004-04-01,297,433,297,433,730
71302,SAIPINA,estado nutricional,clasificacion d,2004-04-01,17,15,17,15,32
40801,SALINAS DE GARCI MENDOZA,estado nutricional,clasificacion d,2004-04-01,23,37,23,37,60
70901,SAMAIPATA,estado nutricional,clasificacion d,2004-04-01,19,12,19,12,31
51601,SAN AGUSTIN,estado nutricional,clasificacion d,2004-04-01,3,7,3,7,10
80602,SAN ANDRES,estado nutricional,clasificacion d,2004-04-01,29,53,29,53,82
51003,SAN ANTONIO DE ESMORUCO,estado nutricional,clasificacion d,2004-04-01,2,4,2,4,6
71105,SAN ANTONIO DE LOMERIO,estado nutricional,clasificacion d,2004-04-01,65,112,65,112,177
31403,SAN BENITO,estado nutricional,clasificacion d,2004-04-01,20,32,20,32,52
80302,SAN BORJA,estado nutricional,clasificacion d,2004-04-01,135,106,135,106,241
21502,SAN BUENA VENTURA,estado nutricional,clasificacion d,2004-04-01,53,72,53,72,125
70402,SAN CARLOS,estado nutricional,clasificacion d,2004-04-01,101,59,101,59,160
80501,SAN IGNACIO,estado nutricional,clasificacion d,2004-04-01,64,109,64,109,173
70301,SAN IGNACIO DE VELASCO,estado nutricional,clasificacion d,2004-04-01,241,212,241,212,453
80102,SAN JAVIER(BNI),estado nutricional,clasificacion d,2004-04-01,29,47,29,47,76
71102,SAN JAVIER(STC),estado nutricional,clasificacion d,2004-04-01,41,45,41,45,86
80701,SAN JOAQUIN,estado nutricional,clasificacion d,2004-04-01,1,9,1,9,10
70501,SAN JOSE DE CHIQUITOS,estado nutricional,clasificacion d,2004-04-01,61,31,61,31,92
71104,SAN JULIAN,estado nutricional,clasificacion d,2004-04-01,169,222,169,222,391
90302,SAN LORENZO(PND),estado nutricional,clasificacion d,2004-04-01,0,5,0,5,5
60501,SAN LORENZO(TJA),estado nutricional,clasificacion d,2004-04-01,58,104,58,104,162
10702,SAN LUCAS,estado nutricional,clasificacion d,2004-04-01,433,538,433,538,971
71201,SAN MATIAS,estado nutricional,clasificacion d,2004-04-01,28,33,28,33,61
70302,SAN MIGUEL DE VELASCO,estado nutricional,clasificacion d,2004-04-01,88,145,88,145,233
51001,SAN PABLO DE LIPEZ,estado nutricional,clasificacion d,2004-04-01,26,17,26,17,43
50501,SAN PEDRO DE BUENA VISTA,estado nutricional,clasificacion d,2004-04-01,154,300,154,300,454
21801,SAN PEDRO DE CURAHUARA,estado nutricional,clasificacion d,2004-04-01,13,16,13,16,29
50902,SAN PEDRO DE QUEMES,estado nutricional,clasificacion d,2004-04-01,0,4,0,4,4
21702,SAN PEDRO DE TIQUINA,estado nutricional,clasificacion d,2004-04-01,3,5,3,5,8
90202,SAN PEDRO(PND),estado nutricional,clasificacion d,2004-04-01,2,1,2,1,3
70303,SAN RAFAEL,estado nutricional,clasificacion d,2004-04-01,21,31,21,31,52
80401,SANTA ANA,estado nutricional,clasificacion d,2004-04-01,19,11,19,11,30
70101,SANTA CRUZ DE LA SIERRA,estado nutricional,clasificacion d,2004-04-01,968,661,968,661,1629
80303,SANTA ROSA,estado nutricional,clasificacion d,2004-04-01,20,6,20,6,26
70602,SANTA ROSA DEL SARA,estado nutricional,clasificacion d,2004-04-01,29,36,29,36,65
20308,SANTIAGO DE CALLAPA,estado nutricional,clasificacion d,2004-04-01,40,42,40,42,82
41401,SANTIAGO DE HUARI,estado nutricional,clasificacion d,2004-04-01,12,26,12,26,38
21901,SANTIAGO DE MACHACA,estado nutricional,clasificacion d,2004-04-01,16,31,16,31,47
30702,SANTIVAÃ‘ES,estado nutricional,clasificacion d,2004-04-01,29,34,29,34,63
40202,SANTUARIO DE QUILLACAS,estado nutricional,clasificacion d,2004-04-01,8,7,8,7,15
20902,SAPAHAQUI,estado nutricional,clasificacion d,2004-04-01,58,57,58,57,115
90303,SENA,estado nutricional,clasificacion d,2004-04-01,6,4,6,4,10
21301,SICA SICA (VILLA AROMA),estado nutricional,clasificacion d,2004-04-01,147,121,147,121,268
30703,SICAYA,estado nutricional,clasificacion d,2004-04-01,15,9,15,9,24
30902,SIPE SIPE,estado nutricional,clasificacion d,2004-04-01,130,128,130,128,258
10403,SOPACHUY,estado nutricional,clasificacion d,2004-04-01,52,83,52,83,135
20601,SORATA,estado nutricional,clasificacion d,2004-04-01,44,40,44,40,84
10101,SUCRE,estado nutricional,clasificacion d,2004-04-01,634,781,634,781,1415
31404,TACACHI,estado nutricional,clasificacion d,2004-04-01,8,0,8,0,8
20603,TACACOMA,estado nutricional,clasificacion d,2004-04-01,11,20,11,20,31
50303,TACOBAMBA,estado nutricional,clasificacion d,2004-04-01,49,67,49,67,116
30602,TACOPAYA,estado nutricional,clasificacion d,2004-04-01,56,135,56,135,191
51402,TAHUA,estado nutricional,clasificacion d,2004-04-01,3,4,3,4,7
31101,TAPACARI,estado nutricional,clasificacion d,2004-04-01,152,96,152,96,248
10601,TARABUCO,estado nutricional,clasificacion d,2004-04-01,268,505,268,505,773
30401,TARATA,estado nutricional,clasificacion d,2004-04-01,21,19,21,19,40
60101,TARIJA,estado nutricional,clasificacion d,2004-04-01,356,382,356,382,738
10202,TARVITA,estado nutricional,clasificacion d,2004-04-01,71,53,71,53,124
20803,TIAWANACU,estado nutricional,clasificacion d,2004-04-01,30,29,30,29,59
50102,TINGUIPAYA,estado nutricional,clasificacion d,2004-04-01,117,172,117,172,289
20606,TIPUANI,estado nutricional,clasificacion d,2004-04-01,17,11,17,11,28
30903,TIQUIPAYA,estado nutricional,clasificacion d,2004-04-01,54,41,54,41,95
31601,TIRAQUE (CBBA),estado nutricional,clasificacion d,2004-04-01,147,100,147,100,247
21703,TITO YUPANQUI (PARQUIPUJIO),estado nutricional,clasificacion d,2004-04-01,3,7,3,7,10
30802,TOCO,estado nutricional,clasificacion d,2004-04-01,9,20,9,20,29
30803,TOLATA,estado nutricional,clasificacion d,2004-04-01,15,9,15,9,24
41001,TOLEDO,estado nutricional,clasificacion d,2004-04-01,10,4,10,4,14
51202,TOMAVE,estado nutricional,clasificacion d,2004-04-01,68,48,68,48,116
10402,TOMINA,estado nutricional,clasificacion d,2004-04-01,109,214,109,214,323
50502,TORO TORO,estado nutricional,clasificacion d,2004-04-01,123,153,123,153,276
31201,TOTORA(CBBA),estado nutricional,clasificacion d,2004-04-01,66,84,66,84,150
41301,TOTORA(ORR),estado nutricional,clasificacion d,2004-04-01,36,34,36,34,70
70802,TRIGAL,estado nutricional,clasificacion d,2004-04-01,1,0,1,0,1
80101,TRINIDAD,estado nutricional,clasificacion d,2004-04-01,203,239,203,239,442
50801,TUPIZA,estado nutricional,clasificacion d,2004-04-01,155,211,155,211,366
21302,UMALA,estado nutricional,clasificacion d,2004-04-01,35,46,35,46,81
50201,UNCIA,estado nutricional,clasificacion d,2004-04-01,77,37,77,37,114
60401,URIONDO (A. CONCEPCION),estado nutricional,clasificacion d,2004-04-01,55,82,55,82,137
71502,URUBICHA,estado nutricional,clasificacion d,2004-04-01,85,184,85,184,269
51201,UYUNI,estado nutricional,clasificacion d,2004-04-01,64,124,64,124,188
30502,VACAS,estado nutricional,clasificacion d,2004-04-01,65,41,65,41,106
70801,VALLEGRANDE,estado nutricional,clasificacion d,2004-04-01,25,11,25,11,36
20801,VIACHA,estado nutricional,clasificacion d,2004-04-01,137,109,137,109,246
31302,VILA VILA,estado nutricional,clasificacion d,2004-04-01,27,35,27,35,62
60303,VILLA MONTES,estado nutricional,clasificacion d,2004-04-01,113,89,113,89,202
90502,VILLA NUEVA (LOMA ALTA),estado nutricional,clasificacion d,2004-04-01,1,3,1,3,4
31402,VILLA RIVERO,estado nutricional,clasificacion d,2004-04-01,28,24,28,24,52
10801,VILLA SERRANO,estado nutricional,clasificacion d,2004-04-01,98,245,98,245,343
31003,VILLA TUNARI,estado nutricional,clasificacion d,2004-04-01,227,242,227,242,469
11001,VILLA VACA GUZMAN (MUYUPAMPA),estado nutricional,clasificacion d,2004-04-01,55,100,55,100,155
51501,VILLAZON,estado nutricional,clasificacion d,2004-04-01,141,177,141,177,318
30904,VINTO,estado nutricional,clasificacion d,2004-04-01,96,46,96,46,142
50602,VITICHI,estado nutricional,clasificacion d,2004-04-01,27,71,27,71,98
20306,WALDO BALLIVIAN,estado nutricional,clasificacion d,2004-04-01,7,17,7,17,24
70201,WARNES,estado nutricional,clasificacion d,2004-04-01,67,49,67,49,116
20903,YACO,estado nutricional,clasificacion d,2004-04-01,55,34,55,34,89
60301,YACUIBA,estado nutricional,clasificacion d,2004-04-01,66,64,66,64,130
10602,YAMPARAEZ,estado nutricional,clasificacion d,2004-04-01,128,286,128,286,414
21103,YANACACHI,estado nutricional,clasificacion d,2004-04-01,17,31,17,31,48
70403,YAPACANI,estado nutricional,clasificacion d,2004-04-01,183,172,183,172,355
50103,YOCALLA,estado nutricional,clasificacion d,2004-04-01,22,27,22,27,49
10102,YOTALA,estado nutricional,clasificacion d,2004-04-01,87,182,87,182,269
60402,YUNCHARA,estado nutricional,clasificacion d,2004-04-01,32,65,32,65,97
10301,ZUDAÃ‘EZ,estado nutricional,clasificacion d,2004-04-01,69,121,69,121,190
51302,ACACIO,estado nutricional,clasificacion d,2004-05-01,46,88,46,88,134
20201,ACHACACHI,estado nutricional,clasificacion d,2004-05-01,171,145,171,145,316
20104,ACHOCALLA,estado nutricional,clasificacion d,2004-05-01,37,39,37,39,76
30201,AIQUILE,estado nutricional,clasificacion d,2004-05-01,83,104,83,104,187
31303,ALALAY,estado nutricional,clasificacion d,2004-05-01,14,20,14,20,34
10404,ALCALA,estado nutricional,clasificacion d,2004-05-01,37,90,37,90,127
20202,ANCORAIMES,estado nutricional,clasificacion d,2004-05-01,85,108,85,108,193
41201,ANDAMARCA,estado nutricional,clasificacion d,2004-05-01,4,6,4,6,10
40603,ANTEQUERA,estado nutricional,clasificacion d,2004-05-01,15,6,15,6,21
30402,ANZALDO,estado nutricional,clasificacion d,2004-05-01,12,11,12,11,23
20701,APOLO,estado nutricional,clasificacion d,2004-05-01,36,44,36,44,80
51301,ARAMPAMPA,estado nutricional,clasificacion d,2004-05-01,46,122,46,122,168
30501,ARANI,estado nutricional,clasificacion d,2004-05-01,37,32,37,32,69
30403,ARBIETO,estado nutricional,clasificacion d,2004-05-01,13,7,13,7,20
30601,ARQUE,estado nutricional,clasificacion d,2004-05-01,92,105,92,105,197
50802,ATOCHA,estado nutricional,clasificacion d,2004-05-01,70,106,70,106,176
20503,AUCAPATA,estado nutricional,clasificacion d,2004-05-01,14,9,14,9,23
20502,AYATA,estado nutricional,clasificacion d,2004-05-01,48,37,48,37,85
21303,AYO AYO,estado nutricional,clasificacion d,2004-05-01,31,8,31,8,39
30301,AYOPAYA (V. DE INDEPENDENCIA),estado nutricional,clasificacion d,2004-05-01,133,152,133,152,285
10201,AZURDUY,estado nutricional,clasificacion d,2004-05-01,133,255,133,255,388
21203,BATALLAS,estado nutricional,clasificacion d,2004-05-01,41,24,41,24,65
80802,BAURES,estado nutricional,clasificacion d,2004-05-01,11,17,11,17,28
41202,BELEN DE ANDAMARCA,estado nutricional,clasificacion d,2004-05-01,2,2,2,2,4
50104,BELEN DE URMIRI,estado nutricional,clasificacion d,2004-05-01,3,6,3,6,9
90104,BELLA FLOR,estado nutricional,clasificacion d,2004-05-01,3,13,3,13,16
60202,BERMEJO,estado nutricional,clasificacion d,2004-05-01,25,18,25,18,43
50301,BETANZOS,estado nutricional,clasificacion d,2004-05-01,218,395,218,395,613
31501,BOLIVAR,estado nutricional,clasificacion d,2004-05-01,146,99,146,99,245
90103,BOLPEBRA,estado nutricional,clasificacion d,2004-05-01,4,19,4,19,23
70707,BOYUIBE,estado nutricional,clasificacion d,2004-05-01,5,3,5,3,8
70401,BUENA VISTA,estado nutricional,clasificacion d,2004-05-01,21,35,21,35,56
70703,CABEZAS,estado nutricional,clasificacion d,2004-05-01,21,30,21,30,51
20905,CAIROMA,estado nutricional,clasificacion d,2004-05-01,92,112,92,112,204
51102,"CAIZA ""D""",estado nutricional,clasificacion d,2004-05-01,22,42,22,42,64
21003,CAJUATA,estado nutricional,clasificacion d,2004-05-01,34,44,34,44,78
20303,CALACOTO,estado nutricional,clasificacion d,2004-05-01,14,16,14,16,30
21304,CALAMARCA,estado nutricional,clasificacion d,2004-05-01,20,12,20,12,32
10701,CAMARGO,estado nutricional,clasificacion d,2004-05-01,94,150,94,150,244
10901,CAMATAQUI (C. VILLA ABECIA),estado nutricional,clasificacion d,2004-05-01,20,19,20,19,39
70706,CAMIRI,estado nutricional,clasificacion d,2004-05-01,103,96,103,96,199
30701,CAPINOTA,estado nutricional,clasificacion d,2004-05-01,34,46,34,46,80
20302,CAQUIAVIRI,estado nutricional,clasificacion d,2004-05-01,33,46,33,46,79
40102,CARACOLLO,estado nutricional,clasificacion d,2004-05-01,51,62,51,62,113
22001,CARANAVI,estado nutricional,clasificacion d,2004-05-01,147,170,147,170,317
41503,CARANGAS,estado nutricional,clasificacion d,2004-05-01,1,1,1,1,2
60302,CARAPARI,estado nutricional,clasificacion d,2004-05-01,18,31,18,31,49
50702,CARIPUYO,estado nutricional,clasificacion d,2004-05-01,98,141,98,141,239
21902,CATACORA,estado nutricional,clasificacion d,2004-05-01,1,0,1,0,1
21803,CHACARILLA,estado nutricional,clasificacion d,2004-05-01,11,17,11,17,28
40201,CHALLAPATA,estado nutricional,clasificacion d,2004-05-01,61,113,61,113,174
50302,CHAQUI,estado nutricional,clasificacion d,2004-05-01,33,46,33,46,79
70702,CHARAGUA,estado nutricional,clasificacion d,2004-05-01,66,72,66,72,138
20305,CHARAÃ‘A,estado nutricional,clasificacion d,2004-05-01,11,8,11,8,19
50202,CHAYANTA,estado nutricional,clasificacion d,2004-05-01,32,63,32,63,95
31204,CHIMORE,estado nutricional,clasificacion d,2004-05-01,19,35,19,35,54
40903,CHIPAYA,estado nutricional,clasificacion d,2004-05-01,5,5,5,5,10
40302,CHOQUE COTA,estado nutricional,clasificacion d,2004-05-01,7,6,7,6,13
21101,CHULUMANI (V. DE LA LIBERTAD),estado nutricional,clasificacion d,2004-05-01,18,15,18,15,33
20501,CHUMA,estado nutricional,clasificacion d,2004-05-01,61,28,61,28,89
30801,CLIZA,estado nutricional,clasificacion d,2004-05-01,110,30,110,30,140
90101,COBIJA,estado nutricional,clasificacion d,2004-05-01,70,86,70,86,156
30101,COCHABAMBA,estado nutricional,clasificacion d,2004-05-01,526,420,526,420,946
40902,COIPASA,estado nutricional,clasificacion d,2004-05-01,1,6,1,6,7
30905,COLCAPIRHUA,estado nutricional,clasificacion d,2004-05-01,58,43,58,43,101
50901,"COLCHA ""K""",estado nutricional,clasificacion d,2004-05-01,56,79,56,79,135
21307,COLLANA,estado nutricional,clasificacion d,2004-05-01,2,2,2,2,4
31002,COLOMI,estado nutricional,clasificacion d,2004-05-01,94,41,94,41,135
50401,COLQUECHACA,estado nutricional,clasificacion d,2004-05-01,151,80,151,80,231
21306,COLQUENCHA,estado nutricional,clasificacion d,2004-05-01,34,40,34,40,74
21004,COLQUIRI,estado nutricional,clasificacion d,2004-05-01,74,66,74,66,140
20304,COMANCHE,estado nutricional,clasificacion d,2004-05-01,11,12,11,12,23
71301,COMARAPA,estado nutricional,clasificacion d,2004-05-01,64,46,64,46,110
20605,COMBAYA,estado nutricional,clasificacion d,2004-05-01,17,22,17,22,39
71101,CONCEPCION,estado nutricional,clasificacion d,2004-05-01,11,7,11,7,18
21701,COPACABANA,estado nutricional,clasificacion d,2004-05-01,20,12,20,12,32
21402,CORIPATA,estado nutricional,clasificacion d,2004-05-01,3,0,3,0,3
20301,CORO CORO,estado nutricional,clasificacion d,2004-05-01,46,59,46,59,105
21401,COROICO,estado nutricional,clasificacion d,2004-05-01,55,43,55,43,98
40301,CORQUE,estado nutricional,clasificacion d,2004-05-01,33,13,33,13,46
50601,COTAGAITA,estado nutricional,clasificacion d,2004-05-01,175,281,175,281,456
70102,COTOCA,estado nutricional,clasificacion d,2004-05-01,33,22,33,22,55
31405,CUCHUMUELA (V. G. VILLARROEL),estado nutricional,clasificacion d,2004-05-01,15,22,15,22,37
70704,CUEVO,estado nutricional,clasificacion d,2004-05-01,17,8,17,8,25
10902,CULPINA,estado nutricional,clasificacion d,2004-05-01,196,278,196,278,474
40401,CURAHUARA DE CARANGAS,estado nutricional,clasificacion d,2004-05-01,18,7,18,7,25
21602,CURVA,estado nutricional,clasificacion d,2004-05-01,16,25,16,25,41
20804,DESAGUADERO,estado nutricional,clasificacion d,2004-05-01,15,9,15,9,24
20105,EL ALTO,estado nutricional,clasificacion d,2004-05-01,1894,1124,1894,1124,3018
40103,EL CHORO,estado nutricional,clasificacion d,2004-05-01,10,7,10,7,17
71503,EL PUENTE(STC),estado nutricional,clasificacion d,2004-05-01,30,41,30,41,71
60502,EL PUENTE(TJA),estado nutricional,clasificacion d,2004-05-01,24,64,24,64,88
70105,EL TORNO,estado nutricional,clasificacion d,2004-05-01,59,82,59,82,141
10405,EL VILLAR,estado nutricional,clasificacion d,2004-05-01,37,128,37,128,165
60601,ENTRE RIOS,estado nutricional,clasificacion d,2004-05-01,58,90,58,90,148
41101,EUCALIPTUS,estado nutricional,clasificacion d,2004-05-01,19,27,19,27,46
90503,EUREKA (SANTOS MERCADO),estado nutricional,clasificacion d,2004-05-01,2,0,2,0,2
80402,EXALTACION,estado nutricional,clasificacion d,2004-05-01,3,8,3,8,11
90203,FILADELFIA,estado nutricional,clasificacion d,2004-05-01,7,13,7,13,20
71002,GENERAL SAAVEDRA,estado nutricional,clasificacion d,2004-05-01,49,64,49,64,113
21601,GRAL. J.J. PEREZ (CHARAZANI),estado nutricional,clasificacion d,2004-05-01,32,59,32,59,91
20602,GUANAY,estado nutricional,clasificacion d,2004-05-01,123,126,123,126,249
20802,GUAQUI,estado nutricional,clasificacion d,2004-05-01,14,9,14,9,23
80202,GUAYARAMERIN,estado nutricional,clasificacion d,2004-05-01,51,68,51,68,119
70705,GUTIERREZ,estado nutricional,clasificacion d,2004-05-01,58,105,58,105,163
10502,HUACARETA,estado nutricional,clasificacion d,2004-05-01,90,206,90,206,296
11002,HUACAYA (VILLA DE HUACAYA),estado nutricional,clasificacion d,2004-05-01,21,41,21,41,62
40501,HUACHACALLA,estado nutricional,clasificacion d,2004-05-01,1,0,1,0,1
40701,HUANUNI,estado nutricional,clasificacion d,2004-05-01,70,43,70,43,113
80803,HUARACAJE,estado nutricional,clasificacion d,2004-05-01,5,5,5,5,10
41601,HUAYLLAMARCA,estado nutricional,clasificacion d,2004-05-01,3,6,3,6,9
21005,ICHOCA,estado nutricional,clasificacion d,2004-05-01,26,17,26,17,43
10304,ICLA,estado nutricional,clasificacion d,2004-05-01,107,238,107,238,345
10703,INCAHUASI,estado nutricional,clasificacion d,2004-05-01,252,233,252,233,485
21001,INQUISIVI,estado nutricional,clasificacion d,2004-05-01,118,157,118,157,275
21102,IRUPANA (VILLA DE LANZA),estado nutricional,clasificacion d,2004-05-01,35,51,35,51,86
21501,IXIAMAS,estado nutricional,clasificacion d,2004-05-01,24,39,24,39,63
21105,LA ASUNTA,estado nutricional,clasificacion d,2004-05-01,42,40,42,40,82
70104,LA GUARDIA,estado nutricional,clasificacion d,2004-05-01,50,52,50,52,102
20101,LA PAZ,estado nutricional,clasificacion d,2004-05-01,1434,1010,1434,1010,2444
41501,LA RIVERA,estado nutricional,clasificacion d,2004-05-01,3,0,3,0,3
70701,LAGUNILLAS,estado nutricional,clasificacion d,2004-05-01,21,29,21,29,50
21202,LAJA,estado nutricional,clasificacion d,2004-05-01,33,22,33,22,55
10903,LAS CARRERAS,estado nutricional,clasificacion d,2004-05-01,17,33,17,33,50
21006,LICOMA PAMPA,estado nutricional,clasificacion d,2004-05-01,13,40,13,40,53
50203,LLALLAGUA,estado nutricional,clasificacion d,2004-05-01,87,133,87,133,220
51401,LLICA,estado nutricional,clasificacion d,2004-05-01,19,15,19,15,34
80601,LORETO,estado nutricional,clasificacion d,2004-05-01,8,7,8,7,15
20901,LURIBAY,estado nutricional,clasificacion d,2004-05-01,42,35,42,35,77
40702,MACHACAMARCA,estado nutricional,clasificacion d,2004-05-01,11,20,11,20,31
11003,MACHARETI,estado nutricional,clasificacion d,2004-05-01,18,69,18,69,87
80801,MAGDALENA,estado nutricional,clasificacion d,2004-05-01,16,13,16,13,29
70903,MAIRANA,estado nutricional,clasificacion d,2004-05-01,20,28,20,28,48
20904,MALLA,estado nutricional,clasificacion d,2004-05-01,8,7,8,7,15
20103,MECAPACA,estado nutricional,clasificacion d,2004-05-01,18,49,18,49,67
71003,MINEROS,estado nutricional,clasificacion d,2004-05-01,125,63,125,63,188
31301,MIZQUE,estado nutricional,clasificacion d,2004-05-01,34,27,34,27,61
20402,MOCOMOCO,estado nutricional,clasificacion d,2004-05-01,55,74,55,74,129
51002,MOJINETE,estado nutricional,clasificacion d,2004-05-01,5,7,5,7,12
10303,MOJOCOYA,estado nutricional,clasificacion d,2004-05-01,55,125,55,125,180
10501,MONTEAGUDO,estado nutricional,clasificacion d,2004-05-01,99,169,99,169,268
71001,MONTERO,estado nutricional,clasificacion d,2004-05-01,254,187,254,187,441
70803,MORO MORO,estado nutricional,clasificacion d,2004-05-01,2,1,2,1,3
30302,MOROCHATA,estado nutricional,clasificacion d,2004-05-01,101,120,101,120,221
90401,NACEBE (SANTA ROSA DEL ABUNA),estado nutricional,clasificacion d,2004-05-01,4,15,4,15,19
50404,OCURI,estado nutricional,clasificacion d,2004-05-01,107,103,107,103,210
70202,OKINAWA,estado nutricional,clasificacion d,2004-05-01,12,7,12,7,19
30203,OMEREQUE,estado nutricional,clasificacion d,2004-05-01,25,9,25,9,34
40101,ORURO,estado nutricional,clasificacion d,2004-05-01,407,342,407,342,749
60201,PADCAYA,estado nutricional,clasificacion d,2004-05-01,37,53,37,53,90
10401,PADILLA,estado nutricional,clasificacion d,2004-05-01,75,133,75,133,208
70502,PAILON,estado nutricional,clasificacion d,2004-05-01,18,17,18,17,35
20102,PALCA,estado nutricional,clasificacion d,2004-05-01,43,92,43,92,135
21104,PALOS BLANCOS,estado nutricional,clasificacion d,2004-05-01,109,111,109,111,220
40802,PAMPA AULLAGAS,estado nutricional,clasificacion d,2004-05-01,7,15,7,15,22
70902,PAMPA GRANDE,estado nutricional,clasificacion d,2004-05-01,22,11,22,11,33
21802,PAPEL PAMPA,estado nutricional,clasificacion d,2004-05-01,12,15,12,15,27
30202,PASORAPA,estado nutricional,clasificacion d,2004-05-01,12,13,12,13,25
21305,PATACAMAYA,estado nutricional,clasificacion d,2004-05-01,100,72,100,72,172
40602,PAZÃ‘A,estado nutricional,clasificacion d,2004-05-01,7,11,7,11,18
20702,PELECHUCO,estado nutricional,clasificacion d,2004-05-01,36,29,36,29,65
50403,POCOATA,estado nutricional,clasificacion d,2004-05-01,209,227,209,227,436
31203,POCONA,estado nutricional,clasificacion d,2004-05-01,47,66,47,66,113
31202,POJO (CBBA),estado nutricional,clasificacion d,2004-05-01,135,137,135,137,272
40601,POOPO,estado nutricional,clasificacion d,2004-05-01,9,5,9,5,14
51203,PORCO,estado nutricional,clasificacion d,2004-05-01,46,32,46,32,78
10103,POROMA,estado nutricional,clasificacion d,2004-05-01,127,182,127,182,309
70103,PORONGO,estado nutricional,clasificacion d,2004-05-01,11,10,11,10,21
70601,PORTACHUELO,estado nutricional,clasificacion d,2004-05-01,25,35,25,35,60
90102,PORVENIR,estado nutricional,clasificacion d,2004-05-01,7,13,7,13,20
70804,POSTRER VALLE,estado nutricional,clasificacion d,2004-05-01,4,5,4,5,9
50101,POTOSI,estado nutricional,clasificacion d,2004-05-01,661,498,661,498,1159
10302,PRESTO,estado nutricional,clasificacion d,2004-05-01,73,131,73,131,204
70805,PUCARA,estado nutricional,clasificacion d,2004-05-01,1,10,1,10,11
21201,PUCARANI,estado nutricional,clasificacion d,2004-05-01,67,38,67,38,105
20401,PUERTO ACOSTA,estado nutricional,clasificacion d,2004-05-01,66,83,66,83,149
20403,PUERTO CARABUCO,estado nutricional,clasificacion d,2004-05-01,70,121,70,121,191
90301,PUERTO GONZALO MORENO,estado nutricional,clasificacion d,2004-05-01,45,123,45,123,168
21204,PUERTO PEREZ,estado nutricional,clasificacion d,2004-05-01,8,25,8,25,33
71402,PUERTO QUIJARRO,estado nutricional,clasificacion d,2004-05-01,20,6,20,6,26
90201,PUERTO RICO,estado nutricional,clasificacion d,2004-05-01,24,3,24,3,27
80703,PUERTO SILES,estado nutricional,clasificacion d,2004-05-01,0,1,0,1,1
71401,PUERTO SUAREZ,estado nutricional,clasificacion d,2004-05-01,6,13,6,13,19
31205,PUERTO VILLARROEL,estado nutricional,clasificacion d,2004-05-01,101,97,101,97,198
51101,PUNA,estado nutricional,clasificacion d,2004-05-01,135,168,135,168,303
31401,PUNATA,estado nutricional,clasificacion d,2004-05-01,56,17,56,17,73
20604,QUIABAYA,estado nutricional,clasificacion d,2004-05-01,12,34,12,34,46
30901,QUILLACOLLO,estado nutricional,clasificacion d,2004-05-01,121,104,121,104,225
21002,QUIME,estado nutricional,clasificacion d,2004-05-01,79,73,79,73,152
70904,QUIRUSILLAS,estado nutricional,clasificacion d,2004-05-01,4,0,4,0,4
50402,RAVELO,estado nutricional,clasificacion d,2004-05-01,177,201,177,201,378
80301,REYES,estado nutricional,clasificacion d,2004-05-01,65,78,65,78,143
80201,RIBERALTA,estado nutricional,clasificacion d,2004-05-01,319,253,319,253,572
70503,ROBORE,estado nutricional,clasificacion d,2004-05-01,27,14,27,14,41
80304,RURRENABAQUE,estado nutricional,clasificacion d,2004-05-01,31,20,31,20,51
40901,SABAYA,estado nutricional,clasificacion d,2004-05-01,4,6,4,6,10
31001,SACABA,estado nutricional,clasificacion d,2004-05-01,158,104,158,104,262
30404,SACABAMBA,estado nutricional,clasificacion d,2004-05-01,21,25,21,25,46
50701,SACACA,estado nutricional,clasificacion d,2004-05-01,201,326,201,326,527
71302,SAIPINA,estado nutricional,clasificacion d,2004-05-01,16,37,16,37,53
40801,SALINAS DE GARCI MENDOZA,estado nutricional,clasificacion d,2004-05-01,12,25,12,25,37
70901,SAMAIPATA,estado nutricional,clasificacion d,2004-05-01,16,8,16,8,24
51601,SAN AGUSTIN,estado nutricional,clasificacion d,2004-05-01,4,5,4,5,9
80602,SAN ANDRES,estado nutricional,clasificacion d,2004-05-01,17,34,17,34,51
51003,SAN ANTONIO DE ESMORUCO,estado nutricional,clasificacion d,2004-05-01,7,4,7,4,11
71105,SAN ANTONIO DE LOMERIO,estado nutricional,clasificacion d,2004-05-01,53,94,53,94,147
31403,SAN BENITO,estado nutricional,clasificacion d,2004-05-01,33,17,33,17,50
80302,SAN BORJA,estado nutricional,clasificacion d,2004-05-01,119,117,119,117,236
21502,SAN BUENA VENTURA,estado nutricional,clasificacion d,2004-05-01,32,34,32,34,66
70402,SAN CARLOS,estado nutricional,clasificacion d,2004-05-01,65,41,65,41,106
80501,SAN IGNACIO,estado nutricional,clasificacion d,2004-05-01,84,128,84,128,212
70301,SAN IGNACIO DE VELASCO,estado nutricional,clasificacion d,2004-05-01,152,103,152,103,255
80102,SAN JAVIER(BNI),estado nutricional,clasificacion d,2004-05-01,15,38,15,38,53
71102,SAN JAVIER(STC),estado nutricional,clasificacion d,2004-05-01,47,43,47,43,90
80701,SAN JOAQUIN,estado nutricional,clasificacion d,2004-05-01,4,15,4,15,19
70501,SAN JOSE DE CHIQUITOS,estado nutricional,clasificacion d,2004-05-01,28,20,28,20,48
71104,SAN JULIAN,estado nutricional,clasificacion d,2004-05-01,72,152,72,152,224
90302,SAN LORENZO(PND),estado nutricional,clasificacion d,2004-05-01,14,38,14,38,52
60501,SAN LORENZO(TJA),estado nutricional,clasificacion d,2004-05-01,38,71,38,71,109
10702,SAN LUCAS,estado nutricional,clasificacion d,2004-05-01,404,523,404,523,927
71201,SAN MATIAS,estado nutricional,clasificacion d,2004-05-01,40,39,40,39,79
70302,SAN MIGUEL DE VELASCO,estado nutricional,clasificacion d,2004-05-01,24,20,24,20,44
51001,SAN PABLO DE LIPEZ,estado nutricional,clasificacion d,2004-05-01,14,6,14,6,20
50501,SAN PEDRO DE BUENA VISTA,estado nutricional,clasificacion d,2004-05-01,129,257,129,257,386
21801,SAN PEDRO DE CURAHUARA,estado nutricional,clasificacion d,2004-05-01,13,25,13,25,38
50902,SAN PEDRO DE QUEMES,estado nutricional,clasificacion d,2004-05-01,1,0,1,0,1
21702,SAN PEDRO DE TIQUINA,estado nutricional,clasificacion d,2004-05-01,0,7,0,7,7
90202,SAN PEDRO(PND),estado nutricional,clasificacion d,2004-05-01,1,4,1,4,5
70303,SAN RAFAEL,estado nutricional,clasificacion d,2004-05-01,20,16,20,16,36
80401,SANTA ANA,estado nutricional,clasificacion d,2004-05-01,23,22,23,22,45
70101,SANTA CRUZ DE LA SIERRA,estado nutricional,clasificacion d,2004-05-01,699,366,699,366,1065
80303,SANTA ROSA,estado nutricional,clasificacion d,2004-05-01,21,14,21,14,35
70602,SANTA ROSA DEL SARA,estado nutricional,clasificacion d,2004-05-01,19,26,19,26,45
20308,SANTIAGO DE CALLAPA,estado nutricional,clasificacion d,2004-05-01,16,23,16,23,39
41401,SANTIAGO DE HUARI,estado nutricional,clasificacion d,2004-05-01,28,31,28,31,59
21901,SANTIAGO DE MACHACA,estado nutricional,clasificacion d,2004-05-01,11,17,11,17,28
30702,SANTIVAÃ‘ES,estado nutricional,clasificacion d,2004-05-01,35,40,35,40,75
40202,SANTUARIO DE QUILLACAS,estado nutricional,clasificacion d,2004-05-01,7,14,7,14,21
20902,SAPAHAQUI,estado nutricional,clasificacion d,2004-05-01,43,44,43,44,87
90303,SENA,estado nutricional,clasificacion d,2004-05-01,27,17,27,17,44
21301,SICA SICA (VILLA AROMA),estado nutricional,clasificacion d,2004-05-01,112,100,112,100,212
30703,SICAYA,estado nutricional,clasificacion d,2004-05-01,9,4,9,4,13
30902,SIPE SIPE,estado nutricional,clasificacion d,2004-05-01,122,113,122,113,235
10403,SOPACHUY,estado nutricional,clasificacion d,2004-05-01,84,164,84,164,248
20601,SORATA,estado nutricional,clasificacion d,2004-05-01,63,109,63,109,172
10101,SUCRE,estado nutricional,clasificacion d,2004-05-01,616,716,616,716,1332
31404,TACACHI,estado nutricional,clasificacion d,2004-05-01,8,4,8,4,12
20603,TACACOMA,estado nutricional,clasificacion d,2004-05-01,9,2,9,2,11
50303,TACOBAMBA,estado nutricional,clasificacion d,2004-05-01,51,72,51,72,123
30602,TACOPAYA,estado nutricional,clasificacion d,2004-05-01,104,210,104,210,314
51402,TAHUA,estado nutricional,clasificacion d,2004-05-01,3,5,3,5,8
31101,TAPACARI,estado nutricional,clasificacion d,2004-05-01,181,139,181,139,320
10601,TARABUCO,estado nutricional,clasificacion d,2004-05-01,256,492,256,492,748
30401,TARATA,estado nutricional,clasificacion d,2004-05-01,30,22,30,22,52
60101,TARIJA,estado nutricional,clasificacion d,2004-05-01,162,175,162,175,337
10202,TARVITA,estado nutricional,clasificacion d,2004-05-01,191,373,191,373,564
20803,TIAWANACU,estado nutricional,clasificacion d,2004-05-01,35,20,35,20,55
50102,TINGUIPAYA,estado nutricional,clasificacion d,2004-05-01,149,166,149,166,315
20606,TIPUANI,estado nutricional,clasificacion d,2004-05-01,20,11,20,11,31
30903,TIQUIPAYA,estado nutricional,clasificacion d,2004-05-01,58,47,58,47,105
31601,TIRAQUE (CBBA),estado nutricional,clasificacion d,2004-05-01,149,97,149,97,246
21703,TITO YUPANQUI (PARQUIPUJIO),estado nutricional,clasificacion d,2004-05-01,6,9,6,9,15
30802,TOCO,estado nutricional,clasificacion d,2004-05-01,12,48,12,48,60
41502,TODOS SANTOS,estado nutricional,clasificacion d,2004-05-01,1,1,1,1,2
41001,TOLEDO,estado nutricional,clasificacion d,2004-05-01,16,5,16,5,21
51202,TOMAVE,estado nutricional,clasificacion d,2004-05-01,71,93,71,93,164
10402,TOMINA,estado nutricional,clasificacion d,2004-05-01,99,200,99,200,299
50502,TORO TORO,estado nutricional,clasificacion d,2004-05-01,95,114,95,114,209
31201,TOTORA(CBBA),estado nutricional,clasificacion d,2004-05-01,81,46,81,46,127
41301,TOTORA(ORR),estado nutricional,clasificacion d,2004-05-01,31,21,31,21,52
70802,TRIGAL,estado nutricional,clasificacion d,2004-05-01,0,1,0,1,1
80101,TRINIDAD,estado nutricional,clasificacion d,2004-05-01,108,124,108,124,232
50801,TUPIZA,estado nutricional,clasificacion d,2004-05-01,136,182,136,182,318
21302,UMALA,estado nutricional,clasificacion d,2004-05-01,15,8,15,8,23
50201,UNCIA,estado nutricional,clasificacion d,2004-05-01,56,72,56,72,128
60401,URIONDO (A. CONCEPCION),estado nutricional,clasificacion d,2004-05-01,40,63,40,63,103
71502,URUBICHA,estado nutricional,clasificacion d,2004-05-01,17,28,17,28,45
51201,UYUNI,estado nutricional,clasificacion d,2004-05-01,62,80,62,80,142
30502,VACAS,estado nutricional,clasificacion d,2004-05-01,44,18,44,18,62
70801,VALLEGRANDE,estado nutricional,clasificacion d,2004-05-01,19,19,19,19,38
20801,VIACHA,estado nutricional,clasificacion d,2004-05-01,152,116,152,116,268
31302,VILA VILA,estado nutricional,clasificacion d,2004-05-01,42,34,42,34,76
60303,VILLA MONTES,estado nutricional,clasificacion d,2004-05-01,58,50,58,50,108
90502,VILLA NUEVA (LOMA ALTA),estado nutricional,clasificacion d,2004-05-01,0,3,0,3,3
31402,VILLA RIVERO,estado nutricional,clasificacion d,2004-05-01,12,0,12,0,12
10801,VILLA SERRANO,estado nutricional,clasificacion d,2004-05-01,113,256,113,256,369
31003,VILLA TUNARI,estado nutricional,clasificacion d,2004-05-01,194,190,194,190,384
11001,VILLA VACA GUZMAN (MUYUPAMPA),estado nutricional,clasificacion d,2004-05-01,70,124,70,124,194
51501,VILLAZON,estado nutricional,clasificacion d,2004-05-01,128,118,128,118,246
50602,VITICHI,estado nutricional,clasificacion d,2004-05-01,62,156,62,156,218
20306,WALDO BALLIVIAN,estado nutricional,clasificacion d,2004-05-01,3,8,3,8,11
70201,WARNES,estado nutricional,clasificacion d,2004-05-01,28,12,28,12,40
20903,YACO,estado nutricional,clasificacion d,2004-05-01,33,31,33,31,64
60301,YACUIBA,estado nutricional,clasificacion d,2004-05-01,41,54,41,54,95
10602,YAMPARAEZ,estado nutricional,clasificacion d,2004-05-01,105,237,105,237,342
21103,YANACACHI,estado nutricional,clasificacion d,2004-05-01,11,11,11,11,22
70403,YAPACANI,estado nutricional,clasificacion d,2004-05-01,128,115,128,115,243
50103,YOCALLA,estado nutricional,clasificacion d,2004-05-01,37,61,37,61,98
10102,YOTALA,estado nutricional,clasificacion d,2004-05-01,93,167,93,167,260
60402,YUNCHARA,estado nutricional,clasificacion d,2004-05-01,66,122,66,122,188
10301,ZUDAÃ‘EZ,estado nutricional,clasificacion d,2004-05-01,83,143,83,143,226
51302,ACACIO,estado nutricional,clasificacion d,2004-06-01,44,74,44,74,118
20201,ACHACACHI,estado nutricional,clasificacion d,2004-06-01,97,99,97,99,196
20104,ACHOCALLA,estado nutricional,clasificacion d,2004-06-01,27,17,27,17,44
30201,AIQUILE,estado nutricional,clasificacion d,2004-06-01,57,81,57,81,138
31303,ALALAY,estado nutricional,clasificacion d,2004-06-01,14,9,14,9,23
10404,ALCALA,estado nutricional,clasificacion d,2004-06-01,21,68,21,68,89
20202,ANCORAIMES,estado nutricional,clasificacion d,2004-06-01,59,81,59,81,140
41201,ANDAMARCA,estado nutricional,clasificacion d,2004-06-01,13,21,13,21,34
40603,ANTEQUERA,estado nutricional,clasificacion d,2004-06-01,23,15,23,15,38
30402,ANZALDO,estado nutricional,clasificacion d,2004-06-01,12,48,12,48,60
20701,APOLO,estado nutricional,clasificacion d,2004-06-01,71,81,71,81,152
51301,ARAMPAMPA,estado nutricional,clasificacion d,2004-06-01,33,83,33,83,116
30501,ARANI,estado nutricional,clasificacion d,2004-06-01,21,22,21,22,43
30403,ARBIETO,estado nutricional,clasificacion d,2004-06-01,16,19,16,19,35
30601,ARQUE,estado nutricional,clasificacion d,2004-06-01,53,73,53,73,126
71501,ASCENCION DE GUARAYOS,estado nutricional,clasificacion d,2004-06-01,154,186,154,186,340
50802,ATOCHA,estado nutricional,clasificacion d,2004-06-01,108,99,108,99,207
20503,AUCAPATA,estado nutricional,clasificacion d,2004-06-01,56,28,56,28,84
20502,AYATA,estado nutricional,clasificacion d,2004-06-01,37,38,37,38,75
21303,AYO AYO,estado nutricional,clasificacion d,2004-06-01,11,3,11,3,14
30301,AYOPAYA (V. DE INDEPENDENCIA),estado nutricional,clasificacion d,2004-06-01,101,121,101,121,222
10201,AZURDUY,estado nutricional,clasificacion d,2004-06-01,139,235,139,235,374
21203,BATALLAS,estado nutricional,clasificacion d,2004-06-01,29,19,29,19,48
80802,BAURES,estado nutricional,clasificacion d,2004-06-01,29,10,29,10,39
41202,BELEN DE ANDAMARCA,estado nutricional,clasificacion d,2004-06-01,4,1,4,1,5
50104,BELEN DE URMIRI,estado nutricional,clasificacion d,2004-06-01,2,8,2,8,10
90104,BELLA FLOR,estado nutricional,clasificacion d,2004-06-01,13,34,13,34,47
60202,BERMEJO,estado nutricional,clasificacion d,2004-06-01,22,20,22,20,42
50301,BETANZOS,estado nutricional,clasificacion d,2004-06-01,176,245,176,245,421
31501,BOLIVAR,estado nutricional,clasificacion d,2004-06-01,79,112,79,112,191
90103,BOLPEBRA,estado nutricional,clasificacion d,2004-06-01,4,19,4,19,23
70707,BOYUIBE,estado nutricional,clasificacion d,2004-06-01,10,16,10,16,26
70401,BUENA VISTA,estado nutricional,clasificacion d,2004-06-01,30,56,30,56,86
70703,CABEZAS,estado nutricional,clasificacion d,2004-06-01,36,54,36,54,90
20905,CAIROMA,estado nutricional,clasificacion d,2004-06-01,100,105,100,105,205
51102,"CAIZA ""D""",estado nutricional,clasificacion d,2004-06-01,86,135,86,135,221
21003,CAJUATA,estado nutricional,clasificacion d,2004-06-01,26,17,26,17,43
20303,CALACOTO,estado nutricional,clasificacion d,2004-06-01,9,18,9,18,27
21304,CALAMARCA,estado nutricional,clasificacion d,2004-06-01,173,182,173,182,355
10701,CAMARGO,estado nutricional,clasificacion d,2004-06-01,127,156,127,156,283
10901,CAMATAQUI (C. VILLA ABECIA),estado nutricional,clasificacion d,2004-06-01,22,19,22,19,41
70706,CAMIRI,estado nutricional,clasificacion d,2004-06-01,178,115,178,115,293
30701,CAPINOTA,estado nutricional,clasificacion d,2004-06-01,22,42,22,42,64
20302,CAQUIAVIRI,estado nutricional,clasificacion d,2004-06-01,60,49,60,49,109
40102,CARACOLLO,estado nutricional,clasificacion d,2004-06-01,37,47,37,47,84
22001,CARANAVI,estado nutricional,clasificacion d,2004-06-01,153,128,153,128,281
60302,CARAPARI,estado nutricional,clasificacion d,2004-06-01,10,21,10,21,31
50702,CARIPUYO,estado nutricional,clasificacion d,2004-06-01,130,149,130,149,279
21803,CHACARILLA,estado nutricional,clasificacion d,2004-06-01,3,2,3,2,5
40201,CHALLAPATA,estado nutricional,clasificacion d,2004-06-01,60,145,60,145,205
50302,CHAQUI,estado nutricional,clasificacion d,2004-06-01,56,55,56,55,111
70702,CHARAGUA,estado nutricional,clasificacion d,2004-06-01,110,111,110,111,221
20305,CHARAÃ‘A,estado nutricional,clasificacion d,2004-06-01,8,8,8,8,16
50202,CHAYANTA,estado nutricional,clasificacion d,2004-06-01,40,52,40,52,92
31204,CHIMORE,estado nutricional,clasificacion d,2004-06-01,14,20,14,20,34
40903,CHIPAYA,estado nutricional,clasificacion d,2004-06-01,2,10,2,10,12
21101,CHULUMANI (V. DE LA LIBERTAD),estado nutricional,clasificacion d,2004-06-01,8,13,8,13,21
20501,CHUMA,estado nutricional,clasificacion d,2004-06-01,51,30,51,30,81
30801,CLIZA,estado nutricional,clasificacion d,2004-06-01,81,28,81,28,109
90101,COBIJA,estado nutricional,clasificacion d,2004-06-01,75,100,75,100,175
30101,COCHABAMBA,estado nutricional,clasificacion d,2004-06-01,632,542,632,542,1174
40902,COIPASA,estado nutricional,clasificacion d,2004-06-01,1,0,1,0,1
30905,COLCAPIRHUA,estado nutricional,clasificacion d,2004-06-01,65,71,65,71,136
50901,"COLCHA ""K""",estado nutricional,clasificacion d,2004-06-01,45,71,45,71,116
21307,COLLANA,estado nutricional,clasificacion d,2004-06-01,4,1,4,1,5
31002,COLOMI,estado nutricional,clasificacion d,2004-06-01,89,45,89,45,134
50401,COLQUECHACA,estado nutricional,clasificacion d,2004-06-01,192,122,192,122,314
21306,COLQUENCHA,estado nutricional,clasificacion d,2004-06-01,38,44,38,44,82
21004,COLQUIRI,estado nutricional,clasificacion d,2004-06-01,108,59,108,59,167
20304,COMANCHE,estado nutricional,clasificacion d,2004-06-01,4,11,4,11,15
71301,COMARAPA,estado nutricional,clasificacion d,2004-06-01,88,40,88,40,128
20605,COMBAYA,estado nutricional,clasificacion d,2004-06-01,10,5,10,5,15
71101,CONCEPCION,estado nutricional,clasificacion d,2004-06-01,18,0,18,0,18
21701,COPACABANA,estado nutricional,clasificacion d,2004-06-01,23,11,23,11,34
21402,CORIPATA,estado nutricional,clasificacion d,2004-06-01,12,6,12,6,18
20301,CORO CORO,estado nutricional,clasificacion d,2004-06-01,32,40,32,40,72
21401,COROICO,estado nutricional,clasificacion d,2004-06-01,57,28,57,28,85
40301,CORQUE,estado nutricional,clasificacion d,2004-06-01,35,44,35,44,79
50601,COTAGAITA,estado nutricional,clasificacion d,2004-06-01,63,79,63,79,142
70102,COTOCA,estado nutricional,clasificacion d,2004-06-01,49,69,49,69,118
31405,CUCHUMUELA (V. G. VILLARROEL),estado nutricional,clasificacion d,2004-06-01,9,15,9,15,24
70704,CUEVO,estado nutricional,clasificacion d,2004-06-01,16,16,16,16,32
10902,CULPINA,estado nutricional,clasificacion d,2004-06-01,175,258,175,258,433
40401,CURAHUARA DE CARANGAS,estado nutricional,clasificacion d,2004-06-01,20,22,20,22,42
21602,CURVA,estado nutricional,clasificacion d,2004-06-01,20,17,20,17,37
20804,DESAGUADERO,estado nutricional,clasificacion d,2004-06-01,8,4,8,4,12
20105,EL ALTO,estado nutricional,clasificacion d,2004-06-01,2355,1391,2355,1391,3746
40103,EL CHORO,estado nutricional,clasificacion d,2004-06-01,6,10,6,10,16
71503,EL PUENTE(STC),estado nutricional,clasificacion d,2004-06-01,53,57,53,57,110
60502,EL PUENTE(TJA),estado nutricional,clasificacion d,2004-06-01,61,105,61,105,166
70105,EL TORNO,estado nutricional,clasificacion d,2004-06-01,55,51,55,51,106
10405,EL VILLAR,estado nutricional,clasificacion d,2004-06-01,41,103,41,103,144
60601,ENTRE RIOS,estado nutricional,clasificacion d,2004-06-01,51,46,51,46,97
41101,EUCALIPTUS,estado nutricional,clasificacion d,2004-06-01,15,14,15,14,29
90503,EUREKA (SANTOS MERCADO),estado nutricional,clasificacion d,2004-06-01,2,0,2,0,2
80402,EXALTACION,estado nutricional,clasificacion d,2004-06-01,7,10,7,10,17
90203,FILADELFIA,estado nutricional,clasificacion d,2004-06-01,16,12,16,12,28
71002,GENERAL SAAVEDRA,estado nutricional,clasificacion d,2004-06-01,92,67,92,67,159
21601,GRAL. J.J. PEREZ (CHARAZANI),estado nutricional,clasificacion d,2004-06-01,35,65,35,65,100
20602,GUANAY,estado nutricional,clasificacion d,2004-06-01,109,102,109,102,211
20802,GUAQUI,estado nutricional,clasificacion d,2004-06-01,7,6,7,6,13
80202,GUAYARAMERIN,estado nutricional,clasificacion d,2004-06-01,139,151,139,151,290
70705,GUTIERREZ,estado nutricional,clasificacion d,2004-06-01,115,204,115,204,319
10502,HUACARETA,estado nutricional,clasificacion d,2004-06-01,58,83,58,83,141
11002,HUACAYA (VILLA DE HUACAYA),estado nutricional,clasificacion d,2004-06-01,16,26,16,26,42
40701,HUANUNI,estado nutricional,clasificacion d,2004-06-01,98,40,98,40,138
80803,HUARACAJE,estado nutricional,clasificacion d,2004-06-01,6,6,6,6,12
41601,HUAYLLAMARCA,estado nutricional,clasificacion d,2004-06-01,12,10,12,10,22
21005,ICHOCA,estado nutricional,clasificacion d,2004-06-01,29,38,29,38,67
10304,ICLA,estado nutricional,clasificacion d,2004-06-01,124,243,124,243,367
10703,INCAHUASI,estado nutricional,clasificacion d,2004-06-01,224,232,224,232,456
21001,INQUISIVI,estado nutricional,clasificacion d,2004-06-01,72,81,72,81,153
21102,IRUPANA (VILLA DE LANZA),estado nutricional,clasificacion d,2004-06-01,37,35,37,35,72
21501,IXIAMAS,estado nutricional,clasificacion d,2004-06-01,22,26,22,26,48
21105,LA ASUNTA,estado nutricional,clasificacion d,2004-06-01,72,40,72,40,112
70104,LA GUARDIA,estado nutricional,clasificacion d,2004-06-01,74,50,74,50,124
20101,LA PAZ,estado nutricional,clasificacion d,2004-06-01,1703,1207,1703,1207,2910
41501,LA RIVERA,estado nutricional,clasificacion d,2004-06-01,2,0,2,0,2
70701,LAGUNILLAS,estado nutricional,clasificacion d,2004-06-01,18,39,18,39,57
21202,LAJA,estado nutricional,clasificacion d,2004-06-01,30,15,30,15,45
10903,LAS CARRERAS,estado nutricional,clasificacion d,2004-06-01,17,55,17,55,72
21006,LICOMA PAMPA,estado nutricional,clasificacion d,2004-06-01,7,10,7,10,17
50203,LLALLAGUA,estado nutricional,clasificacion d,2004-06-01,130,311,130,311,441
51401,LLICA,estado nutricional,clasificacion d,2004-06-01,6,9,6,9,15
80601,LORETO,estado nutricional,clasificacion d,2004-06-01,9,11,9,11,20
20901,LURIBAY,estado nutricional,clasificacion d,2004-06-01,33,51,33,51,84
40702,MACHACAMARCA,estado nutricional,clasificacion d,2004-06-01,13,9,13,9,22
11003,MACHARETI,estado nutricional,clasificacion d,2004-06-01,35,85,35,85,120
80801,MAGDALENA,estado nutricional,clasificacion d,2004-06-01,22,35,22,35,57
70903,MAIRANA,estado nutricional,clasificacion d,2004-06-01,20,16,20,16,36
20904,MALLA,estado nutricional,clasificacion d,2004-06-01,19,19,19,19,38
20103,MECAPACA,estado nutricional,clasificacion d,2004-06-01,13,22,13,22,35
71003,MINEROS,estado nutricional,clasificacion d,2004-06-01,174,108,174,108,282
31301,MIZQUE,estado nutricional,clasificacion d,2004-06-01,31,28,31,28,59
20402,MOCOMOCO,estado nutricional,clasificacion d,2004-06-01,72,108,72,108,180
51002,MOJINETE,estado nutricional,clasificacion d,2004-06-01,7,12,7,12,19
10303,MOJOCOYA,estado nutricional,clasificacion d,2004-06-01,69,119,69,119,188
10501,MONTEAGUDO,estado nutricional,clasificacion d,2004-06-01,124,208,124,208,332
71001,MONTERO,estado nutricional,clasificacion d,2004-06-01,308,192,308,192,500
70803,MORO MORO,estado nutricional,clasificacion d,2004-06-01,7,17,7,17,24
30302,MOROCHATA,estado nutricional,clasificacion d,2004-06-01,164,172,164,172,336
90401,NACEBE (SANTA ROSA DEL ABUNA),estado nutricional,clasificacion d,2004-06-01,10,6,10,6,16
20307,NAZACARA DE PACAJES,estado nutricional,clasificacion d,2004-06-01,0,1,0,1,1
90501,NUEVO MANOA (NUEVA ESPERANZA),estado nutricional,clasificacion d,2004-06-01,1,2,1,2,3
50404,OCURI,estado nutricional,clasificacion d,2004-06-01,140,171,140,171,311
70202,OKINAWA,estado nutricional,clasificacion d,2004-06-01,22,13,22,13,35
30203,OMEREQUE,estado nutricional,clasificacion d,2004-06-01,22,14,22,14,36
40101,ORURO,estado nutricional,clasificacion d,2004-06-01,482,397,482,397,879
60201,PADCAYA,estado nutricional,clasificacion d,2004-06-01,43,58,43,58,101
10401,PADILLA,estado nutricional,clasificacion d,2004-06-01,119,236,119,236,355
70502,PAILON,estado nutricional,clasificacion d,2004-06-01,28,25,28,25,53
20102,PALCA,estado nutricional,clasificacion d,2004-06-01,19,26,19,26,45
21104,PALOS BLANCOS,estado nutricional,clasificacion d,2004-06-01,133,133,133,133,266
40802,PAMPA AULLAGAS,estado nutricional,clasificacion d,2004-06-01,12,11,12,11,23
70902,PAMPA GRANDE,estado nutricional,clasificacion d,2004-06-01,15,14,15,14,29
21802,PAPEL PAMPA,estado nutricional,clasificacion d,2004-06-01,13,13,13,13,26
30202,PASORAPA,estado nutricional,clasificacion d,2004-06-01,12,20,12,20,32
21305,PATACAMAYA,estado nutricional,clasificacion d,2004-06-01,181,130,181,130,311
40602,PAZÃ‘A,estado nutricional,clasificacion d,2004-06-01,10,13,10,13,23
20702,PELECHUCO,estado nutricional,clasificacion d,2004-06-01,30,29,30,29,59
50403,POCOATA,estado nutricional,clasificacion d,2004-06-01,230,256,230,256,486
31203,POCONA,estado nutricional,clasificacion d,2004-06-01,48,49,48,49,97
31202,POJO (CBBA),estado nutricional,clasificacion d,2004-06-01,134,161,134,161,295
40601,POOPO,estado nutricional,clasificacion d,2004-06-01,25,34,25,34,59
51203,PORCO,estado nutricional,clasificacion d,2004-06-01,20,40,20,40,60
10103,POROMA,estado nutricional,clasificacion d,2004-06-01,121,212,121,212,333
70103,PORONGO,estado nutricional,clasificacion d,2004-06-01,20,4,20,4,24
70601,PORTACHUELO,estado nutricional,clasificacion d,2004-06-01,43,41,43,41,84
90102,PORVENIR,estado nutricional,clasificacion d,2004-06-01,5,6,5,6,11
70804,POSTRER VALLE,estado nutricional,clasificacion d,2004-06-01,4,7,4,7,11
50101,POTOSI,estado nutricional,clasificacion d,2004-06-01,679,558,679,558,1237
10302,PRESTO,estado nutricional,clasificacion d,2004-06-01,67,89,67,89,156
70805,PUCARA,estado nutricional,clasificacion d,2004-06-01,4,6,4,6,10
21201,PUCARANI,estado nutricional,clasificacion d,2004-06-01,40,34,40,34,74
20401,PUERTO ACOSTA,estado nutricional,clasificacion d,2004-06-01,75,97,75,97,172
20403,PUERTO CARABUCO,estado nutricional,clasificacion d,2004-06-01,51,99,51,99,150
90301,PUERTO GONZALO MORENO,estado nutricional,clasificacion d,2004-06-01,24,14,24,14,38
21204,PUERTO PEREZ,estado nutricional,clasificacion d,2004-06-01,14,5,14,5,19
71402,PUERTO QUIJARRO,estado nutricional,clasificacion d,2004-06-01,23,10,23,10,33
90201,PUERTO RICO,estado nutricional,clasificacion d,2004-06-01,17,33,17,33,50
80703,PUERTO SILES,estado nutricional,clasificacion d,2004-06-01,2,0,2,0,2
71401,PUERTO SUAREZ,estado nutricional,clasificacion d,2004-06-01,42,14,42,14,56
31205,PUERTO VILLARROEL,estado nutricional,clasificacion d,2004-06-01,262,221,262,221,483
51101,PUNA,estado nutricional,clasificacion d,2004-06-01,165,217,165,217,382
31401,PUNATA,estado nutricional,clasificacion d,2004-06-01,60,54,60,54,114
20604,QUIABAYA,estado nutricional,clasificacion d,2004-06-01,3,18,3,18,21
30901,QUILLACOLLO,estado nutricional,clasificacion d,2004-06-01,128,167,128,167,295
21002,QUIME,estado nutricional,clasificacion d,2004-06-01,43,44,43,44,87
70904,QUIRUSILLAS,estado nutricional,clasificacion d,2004-06-01,1,0,1,0,1
50402,RAVELO,estado nutricional,clasificacion d,2004-06-01,245,286,245,286,531
80301,REYES,estado nutricional,clasificacion d,2004-06-01,34,30,34,30,64
80201,RIBERALTA,estado nutricional,clasificacion d,2004-06-01,641,420,641,420,1061
70503,ROBORE,estado nutricional,clasificacion d,2004-06-01,28,16,28,16,44
80304,RURRENABAQUE,estado nutricional,clasificacion d,2004-06-01,55,33,55,33,88
40901,SABAYA,estado nutricional,clasificacion d,2004-06-01,4,11,4,11,15
31001,SACABA,estado nutricional,clasificacion d,2004-06-01,81,56,81,56,137
30404,SACABAMBA,estado nutricional,clasificacion d,2004-06-01,23,41,23,41,64
50701,SACACA,estado nutricional,clasificacion d,2004-06-01,356,586,356,586,942
71302,SAIPINA,estado nutricional,clasificacion d,2004-06-01,13,7,13,7,20
40801,SALINAS DE GARCI MENDOZA,estado nutricional,clasificacion d,2004-06-01,12,14,12,14,26
70901,SAMAIPATA,estado nutricional,clasificacion d,2004-06-01,19,19,19,19,38
51601,SAN AGUSTIN,estado nutricional,clasificacion d,2004-06-01,2,7,2,7,9
80602,SAN ANDRES,estado nutricional,clasificacion d,2004-06-01,55,76,55,76,131
51003,SAN ANTONIO DE ESMORUCO,estado nutricional,clasificacion d,2004-06-01,14,26,14,26,40
71105,SAN ANTONIO DE LOMERIO,estado nutricional,clasificacion d,2004-06-01,61,108,61,108,169
31403,SAN BENITO,estado nutricional,clasificacion d,2004-06-01,26,43,26,43,69
80302,SAN BORJA,estado nutricional,clasificacion d,2004-06-01,99,124,99,124,223
21502,SAN BUENA VENTURA,estado nutricional,clasificacion d,2004-06-01,29,24,29,24,53
70402,SAN CARLOS,estado nutricional,clasificacion d,2004-06-01,67,54,67,54,121
80501,SAN IGNACIO,estado nutricional,clasificacion d,2004-06-01,81,105,81,105,186
70301,SAN IGNACIO DE VELASCO,estado nutricional,clasificacion d,2004-06-01,212,263,212,263,475
80102,SAN JAVIER(BNI),estado nutricional,clasificacion d,2004-06-01,22,36,22,36,58
71102,SAN JAVIER(STC),estado nutricional,clasificacion d,2004-06-01,26,46,26,46,72
80701,SAN JOAQUIN,estado nutricional,clasificacion d,2004-06-01,5,10,5,10,15
70501,SAN JOSE DE CHIQUITOS,estado nutricional,clasificacion d,2004-06-01,38,17,38,17,55
71104,SAN JULIAN,estado nutricional,clasificacion d,2004-06-01,120,156,120,156,276
90302,SAN LORENZO(PND),estado nutricional,clasificacion d,2004-06-01,15,11,15,11,26
60501,SAN LORENZO(TJA),estado nutricional,clasificacion d,2004-06-01,59,105,59,105,164
10702,SAN LUCAS,estado nutricional,clasificacion d,2004-06-01,382,476,382,476,858
71201,SAN MATIAS,estado nutricional,clasificacion d,2004-06-01,7,21,7,21,28
70302,SAN MIGUEL DE VELASCO,estado nutricional,clasificacion d,2004-06-01,68,87,68,87,155
51001,SAN PABLO DE LIPEZ,estado nutricional,clasificacion d,2004-06-01,13,18,13,18,31
50501,SAN PEDRO DE BUENA VISTA,estado nutricional,clasificacion d,2004-06-01,179,281,179,281,460
21801,SAN PEDRO DE CURAHUARA,estado nutricional,clasificacion d,2004-06-01,18,26,18,26,44
50902,SAN PEDRO DE QUEMES,estado nutricional,clasificacion d,2004-06-01,1,1,1,1,2
21702,SAN PEDRO DE TIQUINA,estado nutricional,clasificacion d,2004-06-01,2,2,2,2,4
90202,SAN PEDRO(PND),estado nutricional,clasificacion d,2004-06-01,8,8,8,8,16
70303,SAN RAFAEL,estado nutricional,clasificacion d,2004-06-01,38,31,38,31,69
80702,SAN RAMON,estado nutricional,clasificacion d,2004-06-01,11,6,11,6,17
80702,SAN RAMON,estado nutricional,clasificacion d,2004-06-01,10,11,10,11,21
80401,SANTA ANA,estado nutricional,clasificacion d,2004-06-01,29,8,29,8,37
70101,SANTA CRUZ DE LA SIERRA,estado nutricional,clasificacion d,2004-06-01,929,643,929,643,1572
80303,SANTA ROSA,estado nutricional,clasificacion d,2004-06-01,37,28,37,28,65
70602,SANTA ROSA DEL SARA,estado nutricional,clasificacion d,2004-06-01,20,18,20,18,38
20308,SANTIAGO DE CALLAPA,estado nutricional,clasificacion d,2004-06-01,26,32,26,32,58
41401,SANTIAGO DE HUARI,estado nutricional,clasificacion d,2004-06-01,21,23,21,23,44
21901,SANTIAGO DE MACHACA,estado nutricional,clasificacion d,2004-06-01,14,18,14,18,32
30702,SANTIVAÃ‘ES,estado nutricional,clasificacion d,2004-06-01,45,34,45,34,79
40202,SANTUARIO DE QUILLACAS,estado nutricional,clasificacion d,2004-06-01,7,15,7,15,22
20902,SAPAHAQUI,estado nutricional,clasificacion d,2004-06-01,51,43,51,43,94
90303,SENA,estado nutricional,clasificacion d,2004-06-01,15,6,15,6,21
21301,SICA SICA (VILLA AROMA),estado nutricional,clasificacion d,2004-06-01,168,111,168,111,279
30703,SICAYA,estado nutricional,clasificacion d,2004-06-01,18,29,18,29,47
30902,SIPE SIPE,estado nutricional,clasificacion d,2004-06-01,176,145,176,145,321
10403,SOPACHUY,estado nutricional,clasificacion d,2004-06-01,39,57,39,57,96
20601,SORATA,estado nutricional,clasificacion d,2004-06-01,41,32,41,32,73
10101,SUCRE,estado nutricional,clasificacion d,2004-06-01,653,741,653,741,1394
31404,TACACHI,estado nutricional,clasificacion d,2004-06-01,5,5,5,5,10
20603,TACACOMA,estado nutricional,clasificacion d,2004-06-01,10,23,10,23,33
50303,TACOBAMBA,estado nutricional,clasificacion d,2004-06-01,68,104,68,104,172
30602,TACOPAYA,estado nutricional,clasificacion d,2004-06-01,85,126,85,126,211
51402,TAHUA,estado nutricional,clasificacion d,2004-06-01,1,1,1,1,2
31101,TAPACARI,estado nutricional,clasificacion d,2004-06-01,130,127,130,127,257
10601,TARABUCO,estado nutricional,clasificacion d,2004-06-01,266,500,266,500,766
30401,TARATA,estado nutricional,clasificacion d,2004-06-01,46,24,46,24,70
60101,TARIJA,estado nutricional,clasificacion d,2004-06-01,392,394,392,394,786
10202,TARVITA,estado nutricional,clasificacion d,2004-06-01,68,71,68,71,139
20803,TIAWANACU,estado nutricional,clasificacion d,2004-06-01,23,14,23,14,37
50102,TINGUIPAYA,estado nutricional,clasificacion d,2004-06-01,192,261,192,261,453
20606,TIPUANI,estado nutricional,clasificacion d,2004-06-01,18,20,18,20,38
30903,TIQUIPAYA,estado nutricional,clasificacion d,2004-06-01,59,29,59,29,88
31601,TIRAQUE (CBBA),estado nutricional,clasificacion d,2004-06-01,123,87,123,87,210
21703,TITO YUPANQUI (PARQUIPUJIO),estado nutricional,clasificacion d,2004-06-01,3,8,3,8,11
30802,TOCO,estado nutricional,clasificacion d,2004-06-01,15,9,15,9,24
30803,TOLATA,estado nutricional,clasificacion d,2004-06-01,1,0,1,0,1
41001,TOLEDO,estado nutricional,clasificacion d,2004-06-01,9,12,9,12,21
51202,TOMAVE,estado nutricional,clasificacion d,2004-06-01,45,76,45,76,121
10402,TOMINA,estado nutricional,clasificacion d,2004-06-01,94,213,94,213,307
50502,TORO TORO,estado nutricional,clasificacion d,2004-06-01,163,192,163,192,355
31201,TOTORA(CBBA),estado nutricional,clasificacion d,2004-06-01,44,41,44,41,85
41301,TOTORA(ORR),estado nutricional,clasificacion d,2004-06-01,20,27,20,27,47
70802,TRIGAL,estado nutricional,clasificacion d,2004-06-01,2,2,2,2,4
80101,TRINIDAD,estado nutricional,clasificacion d,2004-06-01,238,223,238,223,461
50801,TUPIZA,estado nutricional,clasificacion d,2004-06-01,159,274,159,274,433
21302,UMALA,estado nutricional,clasificacion d,2004-06-01,31,51,31,51,82
50201,UNCIA,estado nutricional,clasificacion d,2004-06-01,101,67,101,67,168
60401,URIONDO (A. CONCEPCION),estado nutricional,clasificacion d,2004-06-01,44,67,44,67,111
71502,URUBICHA,estado nutricional,clasificacion d,2004-06-01,59,148,59,148,207
51201,UYUNI,estado nutricional,clasificacion d,2004-06-01,71,75,71,75,146
30502,VACAS,estado nutricional,clasificacion d,2004-06-01,64,72,64,72,136
70801,VALLEGRANDE,estado nutricional,clasificacion d,2004-06-01,50,68,50,68,118
20801,VIACHA,estado nutricional,clasificacion d,2004-06-01,129,91,129,91,220
31302,VILA VILA,estado nutricional,clasificacion d,2004-06-01,25,18,25,18,43
60303,VILLA MONTES,estado nutricional,clasificacion d,2004-06-01,77,62,77,62,139
90502,VILLA NUEVA (LOMA ALTA),estado nutricional,clasificacion d,2004-06-01,1,1,1,1,2
31402,VILLA RIVERO,estado nutricional,clasificacion d,2004-06-01,25,18,25,18,43
10801,VILLA SERRANO,estado nutricional,clasificacion d,2004-06-01,97,201,97,201,298
31003,VILLA TUNARI,estado nutricional,clasificacion d,2004-06-01,182,229,182,229,411
11001,VILLA VACA GUZMAN (MUYUPAMPA),estado nutricional,clasificacion d,2004-06-01,58,81,58,81,139
51501,VILLAZON,estado nutricional,clasificacion d,2004-06-01,149,174,149,174,323
30904,VINTO,estado nutricional,clasificacion d,2004-06-01,44,24,44,24,68
50602,VITICHI,estado nutricional,clasificacion d,2004-06-01,58,123,58,123,181
20306,WALDO BALLIVIAN,estado nutricional,clasificacion d,2004-06-01,6,6,6,6,12
70201,WARNES,estado nutricional,clasificacion d,2004-06-01,69,49,69,49,118
20903,YACO,estado nutricional,clasificacion d,2004-06-01,52,60,52,60,112
60301,YACUIBA,estado nutricional,clasificacion d,2004-06-01,57,60,57,60,117
10602,YAMPARAEZ,estado nutricional,clasificacion d,2004-06-01,116,247,116,247,363
21103,YANACACHI,estado nutricional,clasificacion d,2004-06-01,10,7,10,7,17
70403,YAPACANI,estado nutricional,clasificacion d,2004-06-01,163,158,163,158,321
50103,YOCALLA,estado nutricional,clasificacion d,2004-06-01,22,39,22,39,61
10102,YOTALA,estado nutricional,clasificacion d,2004-06-01,86,152,86,152,238
60402,YUNCHARA,estado nutricional,clasificacion d,2004-06-01,28,73,28,73,101
10301,ZUDAÃ‘EZ,estado nutricional,clasificacion d,2004-06-01,59,110,59,110,169
51302,ACACIO,estado nutricional,clasificacion d,2004-07-01,57,113,57,113,170
20201,ACHACACHI,estado nutricional,clasificacion d,2004-07-01,104,100,104,100,204
20104,ACHOCALLA,estado nutricional,clasificacion d,2004-07-01,23,14,23,14,37
30201,AIQUILE,estado nutricional,clasificacion d,2004-07-01,37,65,37,65,102
31303,ALALAY,estado nutricional,clasificacion d,2004-07-01,21,9,21,9,30
10404,ALCALA,estado nutricional,clasificacion d,2004-07-01,17,73,17,73,90
20202,ANCORAIMES,estado nutricional,clasificacion d,2004-07-01,83,132,83,132,215
41201,ANDAMARCA,estado nutricional,clasificacion d,2004-07-01,8,14,8,14,22
40603,ANTEQUERA,estado nutricional,clasificacion d,2004-07-01,27,21,27,21,48
30402,ANZALDO,estado nutricional,clasificacion d,2004-07-01,15,19,15,19,34
20701,APOLO,estado nutricional,clasificacion d,2004-07-01,46,59,46,59,105
51301,ARAMPAMPA,estado nutricional,clasificacion d,2004-07-01,32,64,32,64,96
30501,ARANI,estado nutricional,clasificacion d,2004-07-01,29,40,29,40,69
30403,ARBIETO,estado nutricional,clasificacion d,2004-07-01,13,20,13,20,33
30601,ARQUE,estado nutricional,clasificacion d,2004-07-01,87,74,87,74,161
71501,ASCENCION DE GUARAYOS,estado nutricional,clasificacion d,2004-07-01,13,0,13,0,13
50802,ATOCHA,estado nutricional,clasificacion d,2004-07-01,45,63,45,63,108
20503,AUCAPATA,estado nutricional,clasificacion d,2004-07-01,9,17,9,17,26
20502,AYATA,estado nutricional,clasificacion d,2004-07-01,39,13,39,13,52
21303,AYO AYO,estado nutricional,clasificacion d,2004-07-01,18,4,18,4,22
30301,AYOPAYA (V. DE INDEPENDENCIA),estado nutricional,clasificacion d,2004-07-01,54,69,54,69,123
10201,AZURDUY,estado nutricional,clasificacion d,2004-07-01,84,156,84,156,240
21203,BATALLAS,estado nutricional,clasificacion d,2004-07-01,31,10,31,10,41
80802,BAURES,estado nutricional,clasificacion d,2004-07-01,17,18,17,18,35
41202,BELEN DE ANDAMARCA,estado nutricional,clasificacion d,2004-07-01,3,1,3,1,4
50104,BELEN DE URMIRI,estado nutricional,clasificacion d,2004-07-01,3,10,3,10,13
90104,BELLA FLOR,estado nutricional,clasificacion d,2004-07-01,8,32,8,32,40
60202,BERMEJO,estado nutricional,clasificacion d,2004-07-01,12,17,12,17,29
50301,BETANZOS,estado nutricional,clasificacion d,2004-07-01,165,269,165,269,434
31501,BOLIVAR,estado nutricional,clasificacion d,2004-07-01,65,75,65,75,140
90103,BOLPEBRA,estado nutricional,clasificacion d,2004-07-01,6,19,6,19,25
70707,BOYUIBE,estado nutricional,clasificacion d,2004-07-01,4,4,4,4,8
70401,BUENA VISTA,estado nutricional,clasificacion d,2004-07-01,23,29,23,29,52
70703,CABEZAS,estado nutricional,clasificacion d,2004-07-01,18,22,18,22,40
20905,CAIROMA,estado nutricional,clasificacion d,2004-07-01,95,109,95,109,204
51102,"CAIZA ""D""",estado nutricional,clasificacion d,2004-07-01,65,81,65,81,146
21003,CAJUATA,estado nutricional,clasificacion d,2004-07-01,26,28,26,28,54
20303,CALACOTO,estado nutricional,clasificacion d,2004-07-01,14,16,14,16,30
21304,CALAMARCA,estado nutricional,clasificacion d,2004-07-01,39,39,39,39,78
10701,CAMARGO,estado nutricional,clasificacion d,2004-07-01,122,182,122,182,304
10901,CAMATAQUI (C. VILLA ABECIA),estado nutricional,clasificacion d,2004-07-01,22,24,22,24,46
70706,CAMIRI,estado nutricional,clasificacion d,2004-07-01,79,74,79,74,153
30701,CAPINOTA,estado nutricional,clasificacion d,2004-07-01,58,42,58,42,100
20302,CAQUIAVIRI,estado nutricional,clasificacion d,2004-07-01,33,88,33,88,121
40102,CARACOLLO,estado nutricional,clasificacion d,2004-07-01,69,49,69,49,118
22001,CARANAVI,estado nutricional,clasificacion d,2004-07-01,167,140,167,140,307
41503,CARANGAS,estado nutricional,clasificacion d,2004-07-01,1,1,1,1,2
60302,CARAPARI,estado nutricional,clasificacion d,2004-07-01,9,27,9,27,36
50702,CARIPUYO,estado nutricional,clasificacion d,2004-07-01,122,125,122,125,247
21902,CATACORA,estado nutricional,clasificacion d,2004-07-01,12,16,12,16,28
21803,CHACARILLA,estado nutricional,clasificacion d,2004-07-01,10,13,10,13,23
40201,CHALLAPATA,estado nutricional,clasificacion d,2004-07-01,47,61,47,61,108
50302,CHAQUI,estado nutricional,clasificacion d,2004-07-01,20,31,20,31,51
70702,CHARAGUA,estado nutricional,clasificacion d,2004-07-01,84,83,84,83,167
20305,CHARAÃ‘A,estado nutricional,clasificacion d,2004-07-01,11,7,11,7,18
50202,CHAYANTA,estado nutricional,clasificacion d,2004-07-01,84,112,84,112,196
31204,CHIMORE,estado nutricional,clasificacion d,2004-07-01,27,44,27,44,71
40903,CHIPAYA,estado nutricional,clasificacion d,2004-07-01,12,9,12,9,21
21101,CHULUMANI (V. DE LA LIBERTAD),estado nutricional,clasificacion d,2004-07-01,18,12,18,12,30
20501,CHUMA,estado nutricional,clasificacion d,2004-07-01,64,50,64,50,114
30801,CLIZA,estado nutricional,clasificacion d,2004-07-01,56,24,56,24,80
90101,COBIJA,estado nutricional,clasificacion d,2004-07-01,65,82,65,82,147
30101,COCHABAMBA,estado nutricional,clasificacion d,2004-07-01,518,382,518,382,900
40902,COIPASA,estado nutricional,clasificacion d,2004-07-01,3,3,3,3,6
30905,COLCAPIRHUA,estado nutricional,clasificacion d,2004-07-01,56,39,56,39,95
50901,"COLCHA ""K""",estado nutricional,clasificacion d,2004-07-01,34,48,34,48,82
21307,COLLANA,estado nutricional,clasificacion d,2004-07-01,5,1,5,1,6
31002,COLOMI,estado nutricional,clasificacion d,2004-07-01,68,39,68,39,107
50401,COLQUECHACA,estado nutricional,clasificacion d,2004-07-01,98,56,98,56,154
21306,COLQUENCHA,estado nutricional,clasificacion d,2004-07-01,19,25,19,25,44
21004,COLQUIRI,estado nutricional,clasificacion d,2004-07-01,70,48,70,48,118
20304,COMANCHE,estado nutricional,clasificacion d,2004-07-01,11,7,11,7,18
71301,COMARAPA,estado nutricional,clasificacion d,2004-07-01,52,29,52,29,81
20605,COMBAYA,estado nutricional,clasificacion d,2004-07-01,11,14,11,14,25
71101,CONCEPCION,estado nutricional,clasificacion d,2004-07-01,23,4,23,4,27
21701,COPACABANA,estado nutricional,clasificacion d,2004-07-01,19,10,19,10,29
21402,CORIPATA,estado nutricional,clasificacion d,2004-07-01,8,5,8,5,13
20301,CORO CORO,estado nutricional,clasificacion d,2004-07-01,42,84,42,84,126
21401,COROICO,estado nutricional,clasificacion d,2004-07-01,24,26,24,26,50
40301,CORQUE,estado nutricional,clasificacion d,2004-07-01,28,13,28,13,41
50601,COTAGAITA,estado nutricional,clasificacion d,2004-07-01,185,220,185,220,405
70102,COTOCA,estado nutricional,clasificacion d,2004-07-01,39,37,39,37,76
31405,CUCHUMUELA (V. G. VILLARROEL),estado nutricional,clasificacion d,2004-07-01,3,8,3,8,11
70704,CUEVO,estado nutricional,clasificacion d,2004-07-01,5,9,5,9,14
10902,CULPINA,estado nutricional,clasificacion d,2004-07-01,162,278,162,278,440
40401,CURAHUARA DE CARANGAS,estado nutricional,clasificacion d,2004-07-01,17,10,17,10,27
21602,CURVA,estado nutricional,clasificacion d,2004-07-01,33,30,33,30,63
20804,DESAGUADERO,estado nutricional,clasificacion d,2004-07-01,4,1,4,1,5
20105,EL ALTO,estado nutricional,clasificacion d,2004-07-01,1721,1127,1721,1127,2848
40103,EL CHORO,estado nutricional,clasificacion d,2004-07-01,4,4,4,4,8
71503,EL PUENTE(STC),estado nutricional,clasificacion d,2004-07-01,34,36,34,36,70
60502,EL PUENTE(TJA),estado nutricional,clasificacion d,2004-07-01,23,49,23,49,72
70105,EL TORNO,estado nutricional,clasificacion d,2004-07-01,58,55,58,55,113
10405,EL VILLAR,estado nutricional,clasificacion d,2004-07-01,37,113,37,113,150
60601,ENTRE RIOS,estado nutricional,clasificacion d,2004-07-01,41,69,41,69,110
41101,EUCALIPTUS,estado nutricional,clasificacion d,2004-07-01,9,20,9,20,29
90503,EUREKA (SANTOS MERCADO),estado nutricional,clasificacion d,2004-07-01,1,0,1,0,1
80402,EXALTACION,estado nutricional,clasificacion d,2004-07-01,3,6,3,6,9
90203,FILADELFIA,estado nutricional,clasificacion d,2004-07-01,27,15,27,15,42
71002,GENERAL SAAVEDRA,estado nutricional,clasificacion d,2004-07-01,55,75,55,75,130
21601,GRAL. J.J. PEREZ (CHARAZANI),estado nutricional,clasificacion d,2004-07-01,76,106,76,106,182
20602,GUANAY,estado nutricional,clasificacion d,2004-07-01,150,161,150,161,311
20802,GUAQUI,estado nutricional,clasificacion d,2004-07-01,12,14,12,14,26
80202,GUAYARAMERIN,estado nutricional,clasificacion d,2004-07-01,81,115,81,115,196
70705,GUTIERREZ,estado nutricional,clasificacion d,2004-07-01,51,92,51,92,143
10502,HUACARETA,estado nutricional,clasificacion d,2004-07-01,44,75,44,75,119
11002,HUACAYA (VILLA DE HUACAYA),estado nutricional,clasificacion d,2004-07-01,10,15,10,15,25
40501,HUACHACALLA,estado nutricional,clasificacion d,2004-07-01,6,3,6,3,9
40701,HUANUNI,estado nutricional,clasificacion d,2004-07-01,55,35,55,35,90
80803,HUARACAJE,estado nutricional,clasificacion d,2004-07-01,6,4,6,4,10
41601,HUAYLLAMARCA,estado nutricional,clasificacion d,2004-07-01,7,2,7,2,9
21005,ICHOCA,estado nutricional,clasificacion d,2004-07-01,32,22,32,22,54
10304,ICLA,estado nutricional,clasificacion d,2004-07-01,123,248,123,248,371
10703,INCAHUASI,estado nutricional,clasificacion d,2004-07-01,220,242,220,242,462
21001,INQUISIVI,estado nutricional,clasificacion d,2004-07-01,98,86,98,86,184
21102,IRUPANA (VILLA DE LANZA),estado nutricional,clasificacion d,2004-07-01,40,54,40,54,94
21501,IXIAMAS,estado nutricional,clasificacion d,2004-07-01,22,38,22,38,60
21105,LA ASUNTA,estado nutricional,clasificacion d,2004-07-01,64,39,64,39,103
70104,LA GUARDIA,estado nutricional,clasificacion d,2004-07-01,35,49,35,49,84
20101,LA PAZ,estado nutricional,clasificacion d,2004-07-01,1096,951,1096,951,2047
41501,LA RIVERA,estado nutricional,clasificacion d,2004-07-01,1,2,1,2,3
70701,LAGUNILLAS,estado nutricional,clasificacion d,2004-07-01,32,32,32,32,64
21202,LAJA,estado nutricional,clasificacion d,2004-07-01,19,7,19,7,26
10903,LAS CARRERAS,estado nutricional,clasificacion d,2004-07-01,18,34,18,34,52
21006,LICOMA PAMPA,estado nutricional,clasificacion d,2004-07-01,2,4,2,4,6
50203,LLALLAGUA,estado nutricional,clasificacion d,2004-07-01,148,321,148,321,469
51401,LLICA,estado nutricional,clasificacion d,2004-07-01,8,13,8,13,21
80601,LORETO,estado nutricional,clasificacion d,2004-07-01,4,7,4,7,11
20901,LURIBAY,estado nutricional,clasificacion d,2004-07-01,48,52,48,52,100
40702,MACHACAMARCA,estado nutricional,clasificacion d,2004-07-01,7,6,7,6,13
11003,MACHARETI,estado nutricional,clasificacion d,2004-07-01,35,75,35,75,110
80801,MAGDALENA,estado nutricional,clasificacion d,2004-07-01,32,37,32,37,69
70903,MAIRANA,estado nutricional,clasificacion d,2004-07-01,7,14,7,14,21
20904,MALLA,estado nutricional,clasificacion d,2004-07-01,3,77,3,77,80
20103,MECAPACA,estado nutricional,clasificacion d,2004-07-01,20,24,20,24,44
71003,MINEROS,estado nutricional,clasificacion d,2004-07-01,121,108,121,108,229
31301,MIZQUE,estado nutricional,clasificacion d,2004-07-01,18,25,18,25,43
20402,MOCOMOCO,estado nutricional,clasificacion d,2004-07-01,66,115,66,115,181
51002,MOJINETE,estado nutricional,clasificacion d,2004-07-01,5,11,5,11,16
10303,MOJOCOYA,estado nutricional,clasificacion d,2004-07-01,58,108,58,108,166
10501,MONTEAGUDO,estado nutricional,clasificacion d,2004-07-01,104,164,104,164,268
71001,MONTERO,estado nutricional,clasificacion d,2004-07-01,262,218,262,218,480
70803,MORO MORO,estado nutricional,clasificacion d,2004-07-01,10,20,10,20,30
30302,MOROCHATA,estado nutricional,clasificacion d,2004-07-01,111,118,111,118,229
90401,NACEBE (SANTA ROSA DEL ABUNA),estado nutricional,clasificacion d,2004-07-01,3,10,3,10,13
20307,NAZACARA DE PACAJES,estado nutricional,clasificacion d,2004-07-01,2,3,2,3,5
50404,OCURI,estado nutricional,clasificacion d,2004-07-01,98,98,98,98,196
70202,OKINAWA,estado nutricional,clasificacion d,2004-07-01,18,24,18,24,42
30203,OMEREQUE,estado nutricional,clasificacion d,2004-07-01,22,14,22,14,36
40101,ORURO,estado nutricional,clasificacion d,2004-07-01,591,437,591,437,1028
60201,PADCAYA,estado nutricional,clasificacion d,2004-07-01,62,96,62,96,158
10401,PADILLA,estado nutricional,clasificacion d,2004-07-01,106,207,106,207,313
70502,PAILON,estado nutricional,clasificacion d,2004-07-01,17,15,17,15,32
20102,PALCA,estado nutricional,clasificacion d,2004-07-01,20,23,20,23,43
21104,PALOS BLANCOS,estado nutricional,clasificacion d,2004-07-01,100,115,100,115,215
40802,PAMPA AULLAGAS,estado nutricional,clasificacion d,2004-07-01,8,19,8,19,27
70902,PAMPA GRANDE,estado nutricional,clasificacion d,2004-07-01,8,5,8,5,13
21802,PAPEL PAMPA,estado nutricional,clasificacion d,2004-07-01,10,1,10,1,11
30202,PASORAPA,estado nutricional,clasificacion d,2004-07-01,16,13,16,13,29
21305,PATACAMAYA,estado nutricional,clasificacion d,2004-07-01,104,78,104,78,182
40602,PAZÃ‘A,estado nutricional,clasificacion d,2004-07-01,19,15,19,15,34
20702,PELECHUCO,estado nutricional,clasificacion d,2004-07-01,33,56,33,56,89
50403,POCOATA,estado nutricional,clasificacion d,2004-07-01,126,173,126,173,299
31203,POCONA,estado nutricional,clasificacion d,2004-07-01,29,28,29,28,57
31202,POJO (CBBA),estado nutricional,clasificacion d,2004-07-01,150,168,150,168,318
40601,POOPO,estado nutricional,clasificacion d,2004-07-01,15,5,15,5,20
51203,PORCO,estado nutricional,clasificacion d,2004-07-01,19,16,19,16,35
10103,POROMA,estado nutricional,clasificacion d,2004-07-01,114,149,114,149,263
70103,PORONGO,estado nutricional,clasificacion d,2004-07-01,11,10,11,10,21
70601,PORTACHUELO,estado nutricional,clasificacion d,2004-07-01,23,25,23,25,48
90102,PORVENIR,estado nutricional,clasificacion d,2004-07-01,11,12,11,12,23
70804,POSTRER VALLE,estado nutricional,clasificacion d,2004-07-01,5,3,5,3,8
50101,POTOSI,estado nutricional,clasificacion d,2004-07-01,596,425,596,425,1021
10302,PRESTO,estado nutricional,clasificacion d,2004-07-01,73,110,73,110,183
70805,PUCARA,estado nutricional,clasificacion d,2004-07-01,4,1,4,1,5
21201,PUCARANI,estado nutricional,clasificacion d,2004-07-01,58,47,58,47,105
20401,PUERTO ACOSTA,estado nutricional,clasificacion d,2004-07-01,75,67,75,67,142
20403,PUERTO CARABUCO,estado nutricional,clasificacion d,2004-07-01,51,86,51,86,137
90301,PUERTO GONZALO MORENO,estado nutricional,clasificacion d,2004-07-01,11,51,11,51,62
21204,PUERTO PEREZ,estado nutricional,clasificacion d,2004-07-01,13,4,13,4,17
71402,PUERTO QUIJARRO,estado nutricional,clasificacion d,2004-07-01,35,10,35,10,45
90201,PUERTO RICO,estado nutricional,clasificacion d,2004-07-01,15,10,15,10,25
80703,PUERTO SILES,estado nutricional,clasificacion d,2004-07-01,0,4,0,4,4
71401,PUERTO SUAREZ,estado nutricional,clasificacion d,2004-07-01,15,12,15,12,27
31205,PUERTO VILLARROEL,estado nutricional,clasificacion d,2004-07-01,147,130,147,130,277
51101,PUNA,estado nutricional,clasificacion d,2004-07-01,149,189,149,189,338
31401,PUNATA,estado nutricional,clasificacion d,2004-07-01,34,25,34,25,59
20604,QUIABAYA,estado nutricional,clasificacion d,2004-07-01,11,12,11,12,23
30901,QUILLACOLLO,estado nutricional,clasificacion d,2004-07-01,101,75,101,75,176
21002,QUIME,estado nutricional,clasificacion d,2004-07-01,36,36,36,36,72
70904,QUIRUSILLAS,estado nutricional,clasificacion d,2004-07-01,1,2,1,2,3
50402,RAVELO,estado nutricional,clasificacion d,2004-07-01,194,197,194,197,391
80301,REYES,estado nutricional,clasificacion d,2004-07-01,31,33,31,33,64
80201,RIBERALTA,estado nutricional,clasificacion d,2004-07-01,442,342,442,342,784
70503,ROBORE,estado nutricional,clasificacion d,2004-07-01,23,21,23,21,44
80304,RURRENABAQUE,estado nutricional,clasificacion d,2004-07-01,28,21,28,21,49
40901,SABAYA,estado nutricional,clasificacion d,2004-07-01,5,3,5,3,8
31001,SACABA,estado nutricional,clasificacion d,2004-07-01,78,104,78,104,182
30404,SACABAMBA,estado nutricional,clasificacion d,2004-07-01,7,15,7,15,22
50701,SACACA,estado nutricional,clasificacion d,2004-07-01,249,460,249,460,709
71302,SAIPINA,estado nutricional,clasificacion d,2004-07-01,18,7,18,7,25
40801,SALINAS DE GARCI MENDOZA,estado nutricional,clasificacion d,2004-07-01,13,22,13,22,35
70901,SAMAIPATA,estado nutricional,clasificacion d,2004-07-01,16,12,16,12,28
51601,SAN AGUSTIN,estado nutricional,clasificacion d,2004-07-01,9,1,9,1,10
80602,SAN ANDRES,estado nutricional,clasificacion d,2004-07-01,28,24,28,24,52
51003,SAN ANTONIO DE ESMORUCO,estado nutricional,clasificacion d,2004-07-01,9,5,9,5,14
71105,SAN ANTONIO DE LOMERIO,estado nutricional,clasificacion d,2004-07-01,75,101,75,101,176
31403,SAN BENITO,estado nutricional,clasificacion d,2004-07-01,16,13,16,13,29
80302,SAN BORJA,estado nutricional,clasificacion d,2004-07-01,85,48,85,48,133
21502,SAN BUENA VENTURA,estado nutricional,clasificacion d,2004-07-01,32,28,32,28,60
70402,SAN CARLOS,estado nutricional,clasificacion d,2004-07-01,52,58,52,58,110
80501,SAN IGNACIO,estado nutricional,clasificacion d,2004-07-01,75,69,75,69,144
70301,SAN IGNACIO DE VELASCO,estado nutricional,clasificacion d,2004-07-01,147,128,147,128,275
80102,SAN JAVIER(BNI),estado nutricional,clasificacion d,2004-07-01,10,24,10,24,34
71102,SAN JAVIER(STC),estado nutricional,clasificacion d,2004-07-01,37,43,37,43,80
80701,SAN JOAQUIN,estado nutricional,clasificacion d,2004-07-01,6,14,6,14,20
70501,SAN JOSE DE CHIQUITOS,estado nutricional,clasificacion d,2004-07-01,38,23,38,23,61
71104,SAN JULIAN,estado nutricional,clasificacion d,2004-07-01,63,64,63,64,127
90302,SAN LORENZO(PND),estado nutricional,clasificacion d,2004-07-01,27,65,27,65,92
60501,SAN LORENZO(TJA),estado nutricional,clasificacion d,2004-07-01,46,78,46,78,124
10702,SAN LUCAS,estado nutricional,clasificacion d,2004-07-01,385,467,385,467,852
71201,SAN MATIAS,estado nutricional,clasificacion d,2004-07-01,32,26,32,26,58
70302,SAN MIGUEL DE VELASCO,estado nutricional,clasificacion d,2004-07-01,40,90,40,90,130
51001,SAN PABLO DE LIPEZ,estado nutricional,clasificacion d,2004-07-01,11,16,11,16,27
50501,SAN PEDRO DE BUENA VISTA,estado nutricional,clasificacion d,2004-07-01,134,255,134,255,389
21801,SAN PEDRO DE CURAHUARA,estado nutricional,clasificacion d,2004-07-01,5,6,5,6,11
50902,SAN PEDRO DE QUEMES,estado nutricional,clasificacion d,2004-07-01,1,0,1,0,1
21702,SAN PEDRO DE TIQUINA,estado nutricional,clasificacion d,2004-07-01,7,13,7,13,20
90202,SAN PEDRO(PND),estado nutricional,clasificacion d,2004-07-01,2,6,2,6,8
70303,SAN RAFAEL,estado nutricional,clasificacion d,2004-07-01,30,25,30,25,55
80702,SAN RAMON,estado nutricional,clasificacion d,2004-07-01,14,6,14,6,20
80401,SANTA ANA,estado nutricional,clasificacion d,2004-07-01,33,26,33,26,59
70101,SANTA CRUZ DE LA SIERRA,estado nutricional,clasificacion d,2004-07-01,879,440,879,440,1319
80303,SANTA ROSA,estado nutricional,clasificacion d,2004-07-01,10,12,10,12,22
70602,SANTA ROSA DEL SARA,estado nutricional,clasificacion d,2004-07-01,8,11,8,11,19
20308,SANTIAGO DE CALLAPA,estado nutricional,clasificacion d,2004-07-01,59,61,59,61,120
41401,SANTIAGO DE HUARI,estado nutricional,clasificacion d,2004-07-01,13,29,13,29,42
21901,SANTIAGO DE MACHACA,estado nutricional,clasificacion d,2004-07-01,15,44,15,44,59
30702,SANTIVAÃ‘ES,estado nutricional,clasificacion d,2004-07-01,20,8,20,8,28
40202,SANTUARIO DE QUILLACAS,estado nutricional,clasificacion d,2004-07-01,5,9,5,9,14
20902,SAPAHAQUI,estado nutricional,clasificacion d,2004-07-01,49,44,49,44,93
90303,SENA,estado nutricional,clasificacion d,2004-07-01,64,74,64,74,138
21301,SICA SICA (VILLA AROMA),estado nutricional,clasificacion d,2004-07-01,67,59,67,59,126
30703,SICAYA,estado nutricional,clasificacion d,2004-07-01,17,19,17,19,36
30902,SIPE SIPE,estado nutricional,clasificacion d,2004-07-01,102,74,102,74,176
10403,SOPACHUY,estado nutricional,clasificacion d,2004-07-01,67,73,67,73,140
20601,SORATA,estado nutricional,clasificacion d,2004-07-01,48,76,48,76,124
10101,SUCRE,estado nutricional,clasificacion d,2004-07-01,441,567,441,567,1008
31404,TACACHI,estado nutricional,clasificacion d,2004-07-01,6,2,6,2,8
20603,TACACOMA,estado nutricional,clasificacion d,2004-07-01,7,8,7,8,15
50303,TACOBAMBA,estado nutricional,clasificacion d,2004-07-01,51,74,51,74,125
30602,TACOPAYA,estado nutricional,clasificacion d,2004-07-01,102,149,102,149,251
51402,TAHUA,estado nutricional,clasificacion d,2004-07-01,1,1,1,1,2
31101,TAPACARI,estado nutricional,clasificacion d,2004-07-01,195,150,195,150,345
10601,TARABUCO,estado nutricional,clasificacion d,2004-07-01,280,497,280,497,777
30401,TARATA,estado nutricional,clasificacion d,2004-07-01,31,20,31,20,51
60101,TARIJA,estado nutricional,clasificacion d,2004-07-01,300,329,300,329,629
10202,TARVITA,estado nutricional,clasificacion d,2004-07-01,163,338,163,338,501
20803,TIAWANACU,estado nutricional,clasificacion d,2004-07-01,26,24,26,24,50
50102,TINGUIPAYA,estado nutricional,clasificacion d,2004-07-01,170,175,170,175,345
20606,TIPUANI,estado nutricional,clasificacion d,2004-07-01,10,16,10,16,26
30903,TIQUIPAYA,estado nutricional,clasificacion d,2004-07-01,45,18,45,18,63
31601,TIRAQUE (CBBA),estado nutricional,clasificacion d,2004-07-01,158,117,158,117,275
21703,TITO YUPANQUI (PARQUIPUJIO),estado nutricional,clasificacion d,2004-07-01,1,1,1,1,2
30802,TOCO,estado nutricional,clasificacion d,2004-07-01,11,29,11,29,40
30803,TOLATA,estado nutricional,clasificacion d,2004-07-01,2,2,2,2,4
41001,TOLEDO,estado nutricional,clasificacion d,2004-07-01,6,3,6,3,9
51202,TOMAVE,estado nutricional,clasificacion d,2004-07-01,43,53,43,53,96
10402,TOMINA,estado nutricional,clasificacion d,2004-07-01,93,184,93,184,277
50502,TORO TORO,estado nutricional,clasificacion d,2004-07-01,110,103,110,103,213
31201,TOTORA(CBBA),estado nutricional,clasificacion d,2004-07-01,46,44,46,44,90
41301,TOTORA(ORR),estado nutricional,clasificacion d,2004-07-01,12,16,12,16,28
70802,TRIGAL,estado nutricional,clasificacion d,2004-07-01,1,2,1,2,3
80101,TRINIDAD,estado nutricional,clasificacion d,2004-07-01,163,171,163,171,334
50801,TUPIZA,estado nutricional,clasificacion d,2004-07-01,165,200,165,200,365
21302,UMALA,estado nutricional,clasificacion d,2004-07-01,4,4,4,4,8
50201,UNCIA,estado nutricional,clasificacion d,2004-07-01,69,80,69,80,149
60401,URIONDO (A. CONCEPCION),estado nutricional,clasificacion d,2004-07-01,51,90,51,90,141
71502,URUBICHA,estado nutricional,clasificacion d,2004-07-01,4,4,4,4,8
51201,UYUNI,estado nutricional,clasificacion d,2004-07-01,49,89,49,89,138
30502,VACAS,estado nutricional,clasificacion d,2004-07-01,38,23,38,23,61
70801,VALLEGRANDE,estado nutricional,clasificacion d,2004-07-01,8,12,8,12,20
20801,VIACHA,estado nutricional,clasificacion d,2004-07-01,93,74,93,74,167
31302,VILA VILA,estado nutricional,clasificacion d,2004-07-01,18,16,18,16,34
60303,VILLA MONTES,estado nutricional,clasificacion d,2004-07-01,59,63,59,63,122
90502,VILLA NUEVA (LOMA ALTA),estado nutricional,clasificacion d,2004-07-01,2,3,2,3,5
31402,VILLA RIVERO,estado nutricional,clasificacion d,2004-07-01,32,19,32,19,51
10801,VILLA SERRANO,estado nutricional,clasificacion d,2004-07-01,113,243,113,243,356
31003,VILLA TUNARI,estado nutricional,clasificacion d,2004-07-01,196,243,196,243,439
11001,VILLA VACA GUZMAN (MUYUPAMPA),estado nutricional,clasificacion d,2004-07-01,49,73,49,73,122
51501,VILLAZON,estado nutricional,clasificacion d,2004-07-01,114,117,114,117,231
30904,VINTO,estado nutricional,clasificacion d,2004-07-01,34,15,34,15,49
50602,VITICHI,estado nutricional,clasificacion d,2004-07-01,87,183,87,183,270
20306,WALDO BALLIVIAN,estado nutricional,clasificacion d,2004-07-01,6,28,6,28,34
70201,WARNES,estado nutricional,clasificacion d,2004-07-01,60,45,60,45,105
20903,YACO,estado nutricional,clasificacion d,2004-07-01,5,15,5,15,20
60301,YACUIBA,estado nutricional,clasificacion d,2004-07-01,52,30,52,30,82
10602,YAMPARAEZ,estado nutricional,clasificacion d,2004-07-01,133,259,133,259,392
21103,YANACACHI,estado nutricional,clasificacion d,2004-07-01,3,7,3,7,10
70403,YAPACANI,estado nutricional,clasificacion d,2004-07-01,104,89,104,89,193
50103,YOCALLA,estado nutricional,clasificacion d,2004-07-01,17,28,17,28,45
10102,YOTALA,estado nutricional,clasificacion d,2004-07-01,80,170,80,170,250
60402,YUNCHARA,estado nutricional,clasificacion d,2004-07-01,58,87,58,87,145
10301,ZUDAÃ‘EZ,estado nutricional,clasificacion d,2004-07-01,58,103,58,103,161
51302,ACACIO,estado nutricional,clasificacion d,2004-08-01,85,134,85,134,219
20201,ACHACACHI,estado nutricional,clasificacion d,2004-08-01,143,142,143,142,285
20104,ACHOCALLA,estado nutricional,clasificacion d,2004-08-01,27,15,27,15,42
30201,AIQUILE,estado nutricional,clasificacion d,2004-08-01,19,29,19,29,48
31303,ALALAY,estado nutricional,clasificacion d,2004-08-01,11,4,11,4,15
10404,ALCALA,estado nutricional,clasificacion d,2004-08-01,30,76,30,76,106
20202,ANCORAIMES,estado nutricional,clasificacion d,2004-08-01,58,73,58,73,131
41201,ANDAMARCA,estado nutricional,clasificacion d,2004-08-01,8,17,8,17,25
40603,ANTEQUERA,estado nutricional,clasificacion d,2004-08-01,1,6,1,6,7
30402,ANZALDO,estado nutricional,clasificacion d,2004-08-01,12,35,12,35,47
20701,APOLO,estado nutricional,clasificacion d,2004-08-01,40,25,40,25,65
51301,ARAMPAMPA,estado nutricional,clasificacion d,2004-08-01,32,52,32,52,84
30501,ARANI,estado nutricional,clasificacion d,2004-08-01,22,18,22,18,40
30403,ARBIETO,estado nutricional,clasificacion d,2004-08-01,14,28,14,28,42
30601,ARQUE,estado nutricional,clasificacion d,2004-08-01,29,25,29,25,54
50802,ATOCHA,estado nutricional,clasificacion d,2004-08-01,57,53,57,53,110
20503,AUCAPATA,estado nutricional,clasificacion d,2004-08-01,6,10,6,10,16
20502,AYATA,estado nutricional,clasificacion d,2004-08-01,33,43,33,43,76
21303,AYO AYO,estado nutricional,clasificacion d,2004-08-01,24,11,24,11,35
30301,AYOPAYA (V. DE INDEPENDENCIA),estado nutricional,clasificacion d,2004-08-01,114,158,114,158,272
10201,AZURDUY,estado nutricional,clasificacion d,2004-08-01,89,165,89,165,254
21203,BATALLAS,estado nutricional,clasificacion d,2004-08-01,32,20,32,20,52
80802,BAURES,estado nutricional,clasificacion d,2004-08-01,20,18,20,18,38
41202,BELEN DE ANDAMARCA,estado nutricional,clasificacion d,2004-08-01,1,1,1,1,2
50104,BELEN DE URMIRI,estado nutricional,clasificacion d,2004-08-01,3,6,3,6,9
90104,BELLA FLOR,estado nutricional,clasificacion d,2004-08-01,6,37,6,37,43
60202,BERMEJO,estado nutricional,clasificacion d,2004-08-01,20,8,20,8,28
50301,BETANZOS,estado nutricional,clasificacion d,2004-08-01,157,234,157,234,391
31501,BOLIVAR,estado nutricional,clasificacion d,2004-08-01,63,80,63,80,143
90103,BOLPEBRA,estado nutricional,clasificacion d,2004-08-01,4,10,4,10,14
70707,BOYUIBE,estado nutricional,clasificacion d,2004-08-01,7,11,7,11,18
70401,BUENA VISTA,estado nutricional,clasificacion d,2004-08-01,22,47,22,47,69
70703,CABEZAS,estado nutricional,clasificacion d,2004-08-01,43,53,43,53,96
20905,CAIROMA,estado nutricional,clasificacion d,2004-08-01,75,80,75,80,155
51102,"CAIZA ""D""",estado nutricional,clasificacion d,2004-08-01,58,68,58,68,126
21003,CAJUATA,estado nutricional,clasificacion d,2004-08-01,27,44,27,44,71
20303,CALACOTO,estado nutricional,clasificacion d,2004-08-01,22,20,22,20,42
21304,CALAMARCA,estado nutricional,clasificacion d,2004-08-01,182,215,182,215,397
10701,CAMARGO,estado nutricional,clasificacion d,2004-08-01,108,137,108,137,245
10901,CAMATAQUI (C. VILLA ABECIA),estado nutricional,clasificacion d,2004-08-01,20,20,20,20,40
70706,CAMIRI,estado nutricional,clasificacion d,2004-08-01,111,81,111,81,192
30701,CAPINOTA,estado nutricional,clasificacion d,2004-08-01,46,28,46,28,74
20302,CAQUIAVIRI,estado nutricional,clasificacion d,2004-08-01,30,43,30,43,73
40102,CARACOLLO,estado nutricional,clasificacion d,2004-08-01,31,54,31,54,85
22001,CARANAVI,estado nutricional,clasificacion d,2004-08-01,125,106,125,106,231
41503,CARANGAS,estado nutricional,clasificacion d,2004-08-01,0,2,0,2,2
60302,CARAPARI,estado nutricional,clasificacion d,2004-08-01,17,18,17,18,35
50702,CARIPUYO,estado nutricional,clasificacion d,2004-08-01,116,174,116,174,290
21902,CATACORA,estado nutricional,clasificacion d,2004-08-01,1,0,1,0,1
21803,CHACARILLA,estado nutricional,clasificacion d,2004-08-01,1,5,1,5,6
40201,CHALLAPATA,estado nutricional,clasificacion d,2004-08-01,99,121,99,121,220
50302,CHAQUI,estado nutricional,clasificacion d,2004-08-01,44,63,44,63,107
70702,CHARAGUA,estado nutricional,clasificacion d,2004-08-01,97,114,97,114,211
20305,CHARAÃ‘A,estado nutricional,clasificacion d,2004-08-01,4,1,4,1,5
50202,CHAYANTA,estado nutricional,clasificacion d,2004-08-01,90,94,90,94,184
31204,CHIMORE,estado nutricional,clasificacion d,2004-08-01,25,34,25,34,59
40903,CHIPAYA,estado nutricional,clasificacion d,2004-08-01,5,9,5,9,14
40302,CHOQUE COTA,estado nutricional,clasificacion d,2004-08-01,3,6,3,6,9
21101,CHULUMANI (V. DE LA LIBERTAD),estado nutricional,clasificacion d,2004-08-01,12,14,12,14,26
20501,CHUMA,estado nutricional,clasificacion d,2004-08-01,42,20,42,20,62
30801,CLIZA,estado nutricional,clasificacion d,2004-08-01,33,23,33,23,56
90101,COBIJA,estado nutricional,clasificacion d,2004-08-01,85,113,85,113,198
30101,COCHABAMBA,estado nutricional,clasificacion d,2004-08-01,475,354,475,354,829
40902,COIPASA,estado nutricional,clasificacion d,2004-08-01,2,4,2,4,6
30905,COLCAPIRHUA,estado nutricional,clasificacion d,2004-08-01,27,36,27,36,63
50901,"COLCHA ""K""",estado nutricional,clasificacion d,2004-08-01,47,72,47,72,119
21307,COLLANA,estado nutricional,clasificacion d,2004-08-01,4,4,4,4,8
31002,COLOMI,estado nutricional,clasificacion d,2004-08-01,58,63,58,63,121
50401,COLQUECHACA,estado nutricional,clasificacion d,2004-08-01,149,88,149,88,237
21306,COLQUENCHA,estado nutricional,clasificacion d,2004-08-01,38,22,38,22,60
21004,COLQUIRI,estado nutricional,clasificacion d,2004-08-01,84,48,84,48,132
20304,COMANCHE,estado nutricional,clasificacion d,2004-08-01,5,4,5,4,9
71301,COMARAPA,estado nutricional,clasificacion d,2004-08-01,49,52,49,52,101
20605,COMBAYA,estado nutricional,clasificacion d,2004-08-01,10,9,10,9,19
71101,CONCEPCION,estado nutricional,clasificacion d,2004-08-01,27,14,27,14,41
21701,COPACABANA,estado nutricional,clasificacion d,2004-08-01,16,16,16,16,32
21402,CORIPATA,estado nutricional,clasificacion d,2004-08-01,7,8,7,8,15
20301,CORO CORO,estado nutricional,clasificacion d,2004-08-01,40,37,40,37,77
21401,COROICO,estado nutricional,clasificacion d,2004-08-01,22,14,22,14,36
40301,CORQUE,estado nutricional,clasificacion d,2004-08-01,32,18,32,18,50
50601,COTAGAITA,estado nutricional,clasificacion d,2004-08-01,56,118,56,118,174
70102,COTOCA,estado nutricional,clasificacion d,2004-08-01,41,39,41,39,80
31405,CUCHUMUELA (V. G. VILLARROEL),estado nutricional,clasificacion d,2004-08-01,1,3,1,3,4
70704,CUEVO,estado nutricional,clasificacion d,2004-08-01,5,16,5,16,21
10902,CULPINA,estado nutricional,clasificacion d,2004-08-01,199,260,199,260,459
40401,CURAHUARA DE CARANGAS,estado nutricional,clasificacion d,2004-08-01,17,17,17,17,34
21602,CURVA,estado nutricional,clasificacion d,2004-08-01,24,16,24,16,40
20804,DESAGUADERO,estado nutricional,clasificacion d,2004-08-01,5,7,5,7,12
20105,EL ALTO,estado nutricional,clasificacion d,2004-08-01,1818,1087,1818,1087,2905
40103,EL CHORO,estado nutricional,clasificacion d,2004-08-01,6,2,6,2,8
60502,EL PUENTE(TJA),estado nutricional,clasificacion d,2004-08-01,39,77,39,77,116
70105,EL TORNO,estado nutricional,clasificacion d,2004-08-01,41,50,41,50,91
10405,EL VILLAR,estado nutricional,clasificacion d,2004-08-01,40,120,40,120,160
60601,ENTRE RIOS,estado nutricional,clasificacion d,2004-08-01,33,22,33,22,55
40502,ESCARA,estado nutricional,clasificacion d,2004-08-01,2,2,2,2,4
41101,EUCALIPTUS,estado nutricional,clasificacion d,2004-08-01,8,5,8,5,13
90503,EUREKA (SANTOS MERCADO),estado nutricional,clasificacion d,2004-08-01,0,1,0,1,1
80402,EXALTACION,estado nutricional,clasificacion d,2004-08-01,13,19,13,19,32
90203,FILADELFIA,estado nutricional,clasificacion d,2004-08-01,13,18,13,18,31
71002,GENERAL SAAVEDRA,estado nutricional,clasificacion d,2004-08-01,61,72,61,72,133
21601,GRAL. J.J. PEREZ (CHARAZANI),estado nutricional,clasificacion d,2004-08-01,28,48,28,48,76
20602,GUANAY,estado nutricional,clasificacion d,2004-08-01,97,144,97,144,241
20802,GUAQUI,estado nutricional,clasificacion d,2004-08-01,10,8,10,8,18
80202,GUAYARAMERIN,estado nutricional,clasificacion d,2004-08-01,78,129,78,129,207
70705,GUTIERREZ,estado nutricional,clasificacion d,2004-08-01,111,132,111,132,243
10502,HUACARETA,estado nutricional,clasificacion d,2004-08-01,51,77,51,77,128
11002,HUACAYA (VILLA DE HUACAYA),estado nutricional,clasificacion d,2004-08-01,17,14,17,14,31
40501,HUACHACALLA,estado nutricional,clasificacion d,2004-08-01,5,1,5,1,6
40701,HUANUNI,estado nutricional,clasificacion d,2004-08-01,37,32,37,32,69
80803,HUARACAJE,estado nutricional,clasificacion d,2004-08-01,10,14,10,14,24
41601,HUAYLLAMARCA,estado nutricional,clasificacion d,2004-08-01,7,8,7,8,15
21005,ICHOCA,estado nutricional,clasificacion d,2004-08-01,20,32,20,32,52
10304,ICLA,estado nutricional,clasificacion d,2004-08-01,116,232,116,232,348
10703,INCAHUASI,estado nutricional,clasificacion d,2004-08-01,254,270,254,270,524
90402,INGAVI (HUMAITA),estado nutricional,clasificacion d,2004-08-01,2,1,2,1,3
21001,INQUISIVI,estado nutricional,clasificacion d,2004-08-01,81,86,81,86,167
21102,IRUPANA (VILLA DE LANZA),estado nutricional,clasificacion d,2004-08-01,26,43,26,43,69
21501,IXIAMAS,estado nutricional,clasificacion d,2004-08-01,30,45,30,45,75
21105,LA ASUNTA,estado nutricional,clasificacion d,2004-08-01,47,33,47,33,80
70104,LA GUARDIA,estado nutricional,clasificacion d,2004-08-01,58,46,58,46,104
20101,LA PAZ,estado nutricional,clasificacion d,2004-08-01,1064,917,1064,917,1981
41501,LA RIVERA,estado nutricional,clasificacion d,2004-08-01,0,2,0,2,2
70701,LAGUNILLAS,estado nutricional,clasificacion d,2004-08-01,36,46,36,46,82
21202,LAJA,estado nutricional,clasificacion d,2004-08-01,22,6,22,6,28
10903,LAS CARRERAS,estado nutricional,clasificacion d,2004-08-01,8,40,8,40,48
21006,LICOMA PAMPA,estado nutricional,clasificacion d,2004-08-01,6,21,6,21,27
50203,LLALLAGUA,estado nutricional,clasificacion d,2004-08-01,131,155,131,155,286
51401,LLICA,estado nutricional,clasificacion d,2004-08-01,11,15,11,15,26
80601,LORETO,estado nutricional,clasificacion d,2004-08-01,8,7,8,7,15
20901,LURIBAY,estado nutricional,clasificacion d,2004-08-01,60,60,60,60,120
40702,MACHACAMARCA,estado nutricional,clasificacion d,2004-08-01,7,0,7,0,7
11003,MACHARETI,estado nutricional,clasificacion d,2004-08-01,24,45,24,45,69
80801,MAGDALENA,estado nutricional,clasificacion d,2004-08-01,31,16,31,16,47
70903,MAIRANA,estado nutricional,clasificacion d,2004-08-01,16,14,16,14,30
20904,MALLA,estado nutricional,clasificacion d,2004-08-01,1,0,1,0,1
20103,MECAPACA,estado nutricional,clasificacion d,2004-08-01,17,10,17,10,27
71003,MINEROS,estado nutricional,clasificacion d,2004-08-01,133,115,133,115,248
31301,MIZQUE,estado nutricional,clasificacion d,2004-08-01,44,10,44,10,54
20402,MOCOMOCO,estado nutricional,clasificacion d,2004-08-01,45,79,45,79,124
51002,MOJINETE,estado nutricional,clasificacion d,2004-08-01,7,7,7,7,14
10303,MOJOCOYA,estado nutricional,clasificacion d,2004-08-01,54,101,54,101,155
10501,MONTEAGUDO,estado nutricional,clasificacion d,2004-08-01,99,178,99,178,277
71001,MONTERO,estado nutricional,clasificacion d,2004-08-01,240,176,240,176,416
70803,MORO MORO,estado nutricional,clasificacion d,2004-08-01,5,22,5,22,27
30302,MOROCHATA,estado nutricional,clasificacion d,2004-08-01,99,89,99,89,188
90401,NACEBE (SANTA ROSA DEL ABUNA),estado nutricional,clasificacion d,2004-08-01,0,2,0,2,2
50404,OCURI,estado nutricional,clasificacion d,2004-08-01,118,106,118,106,224
70202,OKINAWA,estado nutricional,clasificacion d,2004-08-01,15,11,15,11,26
30203,OMEREQUE,estado nutricional,clasificacion d,2004-08-01,21,16,21,16,37
40101,ORURO,estado nutricional,clasificacion d,2004-08-01,481,354,481,354,835
60201,PADCAYA,estado nutricional,clasificacion d,2004-08-01,39,75,39,75,114
10401,PADILLA,estado nutricional,clasificacion d,2004-08-01,89,197,89,197,286
70502,PAILON,estado nutricional,clasificacion d,2004-08-01,23,39,23,39,62
20102,PALCA,estado nutricional,clasificacion d,2004-08-01,30,27,30,27,57
21104,PALOS BLANCOS,estado nutricional,clasificacion d,2004-08-01,62,79,62,79,141
40802,PAMPA AULLAGAS,estado nutricional,clasificacion d,2004-08-01,7,12,7,12,19
70902,PAMPA GRANDE,estado nutricional,clasificacion d,2004-08-01,15,22,15,22,37
21802,PAPEL PAMPA,estado nutricional,clasificacion d,2004-08-01,13,10,13,10,23
30202,PASORAPA,estado nutricional,clasificacion d,2004-08-01,22,19,22,19,41
21305,PATACAMAYA,estado nutricional,clasificacion d,2004-08-01,179,111,179,111,290
40602,PAZÃ‘A,estado nutricional,clasificacion d,2004-08-01,12,28,12,28,40
20702,PELECHUCO,estado nutricional,clasificacion d,2004-08-01,28,34,28,34,62
50403,POCOATA,estado nutricional,clasificacion d,2004-08-01,202,217,202,217,419
31203,POCONA,estado nutricional,clasificacion d,2004-08-01,49,44,49,44,93
31202,POJO (CBBA),estado nutricional,clasificacion d,2004-08-01,110,84,110,84,194
40601,POOPO,estado nutricional,clasificacion d,2004-08-01,8,7,8,7,15
51203,PORCO,estado nutricional,clasificacion d,2004-08-01,13,10,13,10,23
10103,POROMA,estado nutricional,clasificacion d,2004-08-01,91,137,91,137,228
70103,PORONGO,estado nutricional,clasificacion d,2004-08-01,15,11,15,11,26
70601,PORTACHUELO,estado nutricional,clasificacion d,2004-08-01,25,37,25,37,62
90102,PORVENIR,estado nutricional,clasificacion d,2004-08-01,13,11,13,11,24
70804,POSTRER VALLE,estado nutricional,clasificacion d,2004-08-01,3,13,3,13,16
50101,POTOSI,estado nutricional,clasificacion d,2004-08-01,544,419,544,419,963
10302,PRESTO,estado nutricional,clasificacion d,2004-08-01,74,113,74,113,187
70805,PUCARA,estado nutricional,clasificacion d,2004-08-01,4,10,4,10,14
21201,PUCARANI,estado nutricional,clasificacion d,2004-08-01,57,38,57,38,95
20401,PUERTO ACOSTA,estado nutricional,clasificacion d,2004-08-01,49,66,49,66,115
20403,PUERTO CARABUCO,estado nutricional,clasificacion d,2004-08-01,62,106,62,106,168
90301,PUERTO GONZALO MORENO,estado nutricional,clasificacion d,2004-08-01,11,15,11,15,26
21204,PUERTO PEREZ,estado nutricional,clasificacion d,2004-08-01,13,8,13,8,21
90201,PUERTO RICO,estado nutricional,clasificacion d,2004-08-01,36,25,36,25,61
31205,PUERTO VILLARROEL,estado nutricional,clasificacion d,2004-08-01,194,153,194,153,347
51101,PUNA,estado nutricional,clasificacion d,2004-08-01,65,74,65,74,139
31401,PUNATA,estado nutricional,clasificacion d,2004-08-01,42,31,42,31,73
20604,QUIABAYA,estado nutricional,clasificacion d,2004-08-01,5,21,5,21,26
30901,QUILLACOLLO,estado nutricional,clasificacion d,2004-08-01,69,48,69,48,117
21002,QUIME,estado nutricional,clasificacion d,2004-08-01,35,65,35,65,100
70904,QUIRUSILLAS,estado nutricional,clasificacion d,2004-08-01,0,5,0,5,5
50402,RAVELO,estado nutricional,clasificacion d,2004-08-01,226,249,226,249,475
80301,REYES,estado nutricional,clasificacion d,2004-08-01,51,88,51,88,139
80201,RIBERALTA,estado nutricional,clasificacion d,2004-08-01,423,304,423,304,727
70503,ROBORE,estado nutricional,clasificacion d,2004-08-01,33,23,33,23,56
80304,RURRENABAQUE,estado nutricional,clasificacion d,2004-08-01,36,13,36,13,49
40901,SABAYA,estado nutricional,clasificacion d,2004-08-01,2,8,2,8,10
31001,SACABA,estado nutricional,clasificacion d,2004-08-01,33,16,33,16,49
30404,SACABAMBA,estado nutricional,clasificacion d,2004-08-01,5,21,5,21,26
50701,SACACA,estado nutricional,clasificacion d,2004-08-01,350,694,350,694,1044
71302,SAIPINA,estado nutricional,clasificacion d,2004-08-01,11,5,11,5,16
40801,SALINAS DE GARCI MENDOZA,estado nutricional,clasificacion d,2004-08-01,21,23,21,23,44
70901,SAMAIPATA,estado nutricional,clasificacion d,2004-08-01,18,23,18,23,41
51601,SAN AGUSTIN,estado nutricional,clasificacion d,2004-08-01,5,4,5,4,9
80602,SAN ANDRES,estado nutricional,clasificacion d,2004-08-01,25,25,25,25,50
51003,SAN ANTONIO DE ESMORUCO,estado nutricional,clasificacion d,2004-08-01,8,6,8,6,14
71105,SAN ANTONIO DE LOMERIO,estado nutricional,clasificacion d,2004-08-01,46,83,46,83,129
31403,SAN BENITO,estado nutricional,clasificacion d,2004-08-01,16,12,16,12,28
80302,SAN BORJA,estado nutricional,clasificacion d,2004-08-01,125,125,125,125,250
21502,SAN BUENA VENTURA,estado nutricional,clasificacion d,2004-08-01,21,22,21,22,43
70402,SAN CARLOS,estado nutricional,clasificacion d,2004-08-01,48,48,48,48,96
80501,SAN IGNACIO,estado nutricional,clasificacion d,2004-08-01,86,58,86,58,144
70301,SAN IGNACIO DE VELASCO,estado nutricional,clasificacion d,2004-08-01,213,140,213,140,353
80102,SAN JAVIER(BNI),estado nutricional,clasificacion d,2004-08-01,5,7,5,7,12
71102,SAN JAVIER(STC),estado nutricional,clasificacion d,2004-08-01,21,29,21,29,50
80701,SAN JOAQUIN,estado nutricional,clasificacion d,2004-08-01,5,16,5,16,21
70501,SAN JOSE DE CHIQUITOS,estado nutricional,clasificacion d,2004-08-01,27,17,27,17,44
71104,SAN JULIAN,estado nutricional,clasificacion d,2004-08-01,115,124,115,124,239
90302,SAN LORENZO(PND),estado nutricional,clasificacion d,2004-08-01,23,21,23,21,44
60501,SAN LORENZO(TJA),estado nutricional,clasificacion d,2004-08-01,19,45,19,45,64
10702,SAN LUCAS,estado nutricional,clasificacion d,2004-08-01,419,563,419,563,982
71201,SAN MATIAS,estado nutricional,clasificacion d,2004-08-01,1,4,1,4,5
70302,SAN MIGUEL DE VELASCO,estado nutricional,clasificacion d,2004-08-01,38,58,38,58,96
51001,SAN PABLO DE LIPEZ,estado nutricional,clasificacion d,2004-08-01,15,16,15,16,31
50501,SAN PEDRO DE BUENA VISTA,estado nutricional,clasificacion d,2004-08-01,183,338,183,338,521
21801,SAN PEDRO DE CURAHUARA,estado nutricional,clasificacion d,2004-08-01,14,28,14,28,42
21702,SAN PEDRO DE TIQUINA,estado nutricional,clasificacion d,2004-08-01,9,9,9,9,18
90202,SAN PEDRO(PND),estado nutricional,clasificacion d,2004-08-01,0,2,0,2,2
70303,SAN RAFAEL,estado nutricional,clasificacion d,2004-08-01,44,44,44,44,88
80702,SAN RAMON,estado nutricional,clasificacion d,2004-08-01,0,2,0,2,2
80702,SAN RAMON,estado nutricional,clasificacion d,2004-08-01,10,1,10,1,11
80401,SANTA ANA,estado nutricional,clasificacion d,2004-08-01,19,11,19,11,30
70101,SANTA CRUZ DE LA SIERRA,estado nutricional,clasificacion d,2004-08-01,981,540,981,540,1521
80303,SANTA ROSA,estado nutricional,clasificacion d,2004-08-01,11,10,11,10,21
70602,SANTA ROSA DEL SARA,estado nutricional,clasificacion d,2004-08-01,19,27,19,27,46
20308,SANTIAGO DE CALLAPA,estado nutricional,clasificacion d,2004-08-01,30,31,30,31,61
41401,SANTIAGO DE HUARI,estado nutricional,clasificacion d,2004-08-01,22,44,22,44,66
21901,SANTIAGO DE MACHACA,estado nutricional,clasificacion d,2004-08-01,8,7,8,7,15
30702,SANTIVAÃ‘ES,estado nutricional,clasificacion d,2004-08-01,17,15,17,15,32
40202,SANTUARIO DE QUILLACAS,estado nutricional,clasificacion d,2004-08-01,10,5,10,5,15
20902,SAPAHAQUI,estado nutricional,clasificacion d,2004-08-01,77,84,77,84,161
90303,SENA,estado nutricional,clasificacion d,2004-08-01,2,16,2,16,18
21301,SICA SICA (VILLA AROMA),estado nutricional,clasificacion d,2004-08-01,146,106,146,106,252
30703,SICAYA,estado nutricional,clasificacion d,2004-08-01,25,18,25,18,43
30902,SIPE SIPE,estado nutricional,clasificacion d,2004-08-01,160,110,160,110,270
10403,SOPACHUY,estado nutricional,clasificacion d,2004-08-01,70,97,70,97,167
20601,SORATA,estado nutricional,clasificacion d,2004-08-01,59,93,59,93,152
10101,SUCRE,estado nutricional,clasificacion d,2004-08-01,371,492,371,492,863
31404,TACACHI,estado nutricional,clasificacion d,2004-08-01,6,5,6,5,11
20603,TACACOMA,estado nutricional,clasificacion d,2004-08-01,7,10,7,10,17
50303,TACOBAMBA,estado nutricional,clasificacion d,2004-08-01,15,19,15,19,34
30602,TACOPAYA,estado nutricional,clasificacion d,2004-08-01,87,144,87,144,231
51402,TAHUA,estado nutricional,clasificacion d,2004-08-01,6,6,6,6,12
31101,TAPACARI,estado nutricional,clasificacion d,2004-08-01,157,152,157,152,309
10601,TARABUCO,estado nutricional,clasificacion d,2004-08-01,245,481,245,481,726
30401,TARATA,estado nutricional,clasificacion d,2004-08-01,22,18,22,18,40
60101,TARIJA,estado nutricional,clasificacion d,2004-08-01,221,255,221,255,476
10202,TARVITA,estado nutricional,clasificacion d,2004-08-01,67,94,67,94,161
20803,TIAWANACU,estado nutricional,clasificacion d,2004-08-01,23,16,23,16,39
50102,TINGUIPAYA,estado nutricional,clasificacion d,2004-08-01,156,138,156,138,294
20606,TIPUANI,estado nutricional,clasificacion d,2004-08-01,15,8,15,8,23
30903,TIQUIPAYA,estado nutricional,clasificacion d,2004-08-01,58,32,58,32,90
31601,TIRAQUE (CBBA),estado nutricional,clasificacion d,2004-08-01,95,63,95,63,158
21703,TITO YUPANQUI (PARQUIPUJIO),estado nutricional,clasificacion d,2004-08-01,2,3,2,3,5
30802,TOCO,estado nutricional,clasificacion d,2004-08-01,9,16,9,16,25
30803,TOLATA,estado nutricional,clasificacion d,2004-08-01,3,2,3,2,5
41001,TOLEDO,estado nutricional,clasificacion d,2004-08-01,7,5,7,5,12
51202,TOMAVE,estado nutricional,clasificacion d,2004-08-01,47,52,47,52,99
10402,TOMINA,estado nutricional,clasificacion d,2004-08-01,115,221,115,221,336
50502,TORO TORO,estado nutricional,clasificacion d,2004-08-01,91,104,91,104,195
31201,TOTORA(CBBA),estado nutricional,clasificacion d,2004-08-01,58,49,58,49,107
41301,TOTORA(ORR),estado nutricional,clasificacion d,2004-08-01,17,13,17,13,30
70802,TRIGAL,estado nutricional,clasificacion d,2004-08-01,2,3,2,3,5
80101,TRINIDAD,estado nutricional,clasificacion d,2004-08-01,158,198,158,198,356
50801,TUPIZA,estado nutricional,clasificacion d,2004-08-01,103,154,103,154,257
21302,UMALA,estado nutricional,clasificacion d,2004-08-01,24,29,24,29,53
50201,UNCIA,estado nutricional,clasificacion d,2004-08-01,44,108,44,108,152
60401,URIONDO (A. CONCEPCION),estado nutricional,clasificacion d,2004-08-01,49,87,49,87,136
51201,UYUNI,estado nutricional,clasificacion d,2004-08-01,46,89,46,89,135
30502,VACAS,estado nutricional,clasificacion d,2004-08-01,62,42,62,42,104
70801,VALLEGRANDE,estado nutricional,clasificacion d,2004-08-01,39,51,39,51,90
20801,VIACHA,estado nutricional,clasificacion d,2004-08-01,129,79,129,79,208
31302,VILA VILA,estado nutricional,clasificacion d,2004-08-01,18,19,18,19,37
60303,VILLA MONTES,estado nutricional,clasificacion d,2004-08-01,73,58,73,58,131
90502,VILLA NUEVA (LOMA ALTA),estado nutricional,clasificacion d,2004-08-01,2,1,2,1,3
31402,VILLA RIVERO,estado nutricional,clasificacion d,2004-08-01,19,28,19,28,47
10801,VILLA SERRANO,estado nutricional,clasificacion d,2004-08-01,103,228,103,228,331
31003,VILLA TUNARI,estado nutricional,clasificacion d,2004-08-01,169,179,169,179,348
11001,VILLA VACA GUZMAN (MUYUPAMPA),estado nutricional,clasificacion d,2004-08-01,52,60,52,60,112
51501,VILLAZON,estado nutricional,clasificacion d,2004-08-01,96,129,96,129,225
30904,VINTO,estado nutricional,clasificacion d,2004-08-01,68,28,68,28,96
50602,VITICHI,estado nutricional,clasificacion d,2004-08-01,34,43,34,43,77
70201,WARNES,estado nutricional,clasificacion d,2004-08-01,61,34,61,34,95
20903,YACO,estado nutricional,clasificacion d,2004-08-01,28,30,28,30,58
60301,YACUIBA,estado nutricional,clasificacion d,2004-08-01,62,92,62,92,154
10602,YAMPARAEZ,estado nutricional,clasificacion d,2004-08-01,125,257,125,257,382
21103,YANACACHI,estado nutricional,clasificacion d,2004-08-01,11,6,11,6,17
70403,YAPACANI,estado nutricional,clasificacion d,2004-08-01,134,138,134,138,272
50103,YOCALLA,estado nutricional,clasificacion d,2004-08-01,28,33,28,33,61
10102,YOTALA,estado nutricional,clasificacion d,2004-08-01,64,145,64,145,209
60402,YUNCHARA,estado nutricional,clasificacion d,2004-08-01,30,71,30,71,101
10301,ZUDAÃ‘EZ,estado nutricional,clasificacion d,2004-08-01,59,130,59,130,189
51302,ACACIO,estado nutricional,clasificacion d,2004-09-01,88,158,88,158,246
20201,ACHACACHI,estado nutricional,clasificacion d,2004-09-01,124,113,124,113,237
20104,ACHOCALLA,estado nutricional,clasificacion d,2004-09-01,30,21,30,21,51
30201,AIQUILE,estado nutricional,clasificacion d,2004-09-01,51,22,51,22,73
31303,ALALAY,estado nutricional,clasificacion d,2004-09-01,26,14,26,14,40
10404,ALCALA,estado nutricional,clasificacion d,2004-09-01,25,81,25,81,106
20202,ANCORAIMES,estado nutricional,clasificacion d,2004-09-01,93,130,93,130,223
41201,ANDAMARCA,estado nutricional,clasificacion d,2004-09-01,8,10,8,10,18
40603,ANTEQUERA,estado nutricional,clasificacion d,2004-09-01,9,11,9,11,20
30402,ANZALDO,estado nutricional,clasificacion d,2004-09-01,14,33,14,33,47
20701,APOLO,estado nutricional,clasificacion d,2004-09-01,52,85,52,85,137
51301,ARAMPAMPA,estado nutricional,clasificacion d,2004-09-01,40,62,40,62,102
30501,ARANI,estado nutricional,clasificacion d,2004-09-01,22,34,22,34,56
30403,ARBIETO,estado nutricional,clasificacion d,2004-09-01,10,23,10,23,33
30601,ARQUE,estado nutricional,clasificacion d,2004-09-01,75,93,75,93,168
50802,ATOCHA,estado nutricional,clasificacion d,2004-09-01,80,91,80,91,171
20503,AUCAPATA,estado nutricional,clasificacion d,2004-09-01,16,18,16,18,34
20502,AYATA,estado nutricional,clasificacion d,2004-09-01,24,41,24,41,65
21303,AYO AYO,estado nutricional,clasificacion d,2004-09-01,19,8,19,8,27
30301,AYOPAYA (V. DE INDEPENDENCIA),estado nutricional,clasificacion d,2004-09-01,115,101,115,101,216
10201,AZURDUY,estado nutricional,clasificacion d,2004-09-01,81,219,81,219,300
21203,BATALLAS,estado nutricional,clasificacion d,2004-09-01,57,40,57,40,97
80802,BAURES,estado nutricional,clasificacion d,2004-09-01,22,20,22,20,42
41202,BELEN DE ANDAMARCA,estado nutricional,clasificacion d,2004-09-01,2,2,2,2,4
50104,BELEN DE URMIRI,estado nutricional,clasificacion d,2004-09-01,9,21,9,21,30
90104,BELLA FLOR,estado nutricional,clasificacion d,2004-09-01,10,43,10,43,53
60202,BERMEJO,estado nutricional,clasificacion d,2004-09-01,49,49,49,49,98
50301,BETANZOS,estado nutricional,clasificacion d,2004-09-01,194,297,194,297,491
31501,BOLIVAR,estado nutricional,clasificacion d,2004-09-01,100,168,100,168,268
90103,BOLPEBRA,estado nutricional,clasificacion d,2004-09-01,6,9,6,9,15
70707,BOYUIBE,estado nutricional,clasificacion d,2004-09-01,11,14,11,14,25
70401,BUENA VISTA,estado nutricional,clasificacion d,2004-09-01,32,54,32,54,86
70703,CABEZAS,estado nutricional,clasificacion d,2004-09-01,43,38,43,38,81
20905,CAIROMA,estado nutricional,clasificacion d,2004-09-01,82,111,82,111,193
51102,"CAIZA ""D""",estado nutricional,clasificacion d,2004-09-01,64,78,64,78,142
21003,CAJUATA,estado nutricional,clasificacion d,2004-09-01,33,35,33,35,68
20303,CALACOTO,estado nutricional,clasificacion d,2004-09-01,19,35,19,35,54
21304,CALAMARCA,estado nutricional,clasificacion d,2004-09-01,45,37,45,37,82
10701,CAMARGO,estado nutricional,clasificacion d,2004-09-01,147,220,147,220,367
10901,CAMATAQUI (C. VILLA ABECIA),estado nutricional,clasificacion d,2004-09-01,14,25,14,25,39
70706,CAMIRI,estado nutricional,clasificacion d,2004-09-01,95,89,95,89,184
30701,CAPINOTA,estado nutricional,clasificacion d,2004-09-01,63,63,63,63,126
20302,CAQUIAVIRI,estado nutricional,clasificacion d,2004-09-01,30,44,30,44,74
40102,CARACOLLO,estado nutricional,clasificacion d,2004-09-01,61,61,61,61,122
22001,CARANAVI,estado nutricional,clasificacion d,2004-09-01,167,167,167,167,334
60302,CARAPARI,estado nutricional,clasificacion d,2004-09-01,15,17,15,17,32
50702,CARIPUYO,estado nutricional,clasificacion d,2004-09-01,105,148,105,148,253
21902,CATACORA,estado nutricional,clasificacion d,2004-09-01,2,1,2,1,3
21803,CHACARILLA,estado nutricional,clasificacion d,2004-09-01,2,7,2,7,9
40201,CHALLAPATA,estado nutricional,clasificacion d,2004-09-01,48,61,48,61,109
50302,CHAQUI,estado nutricional,clasificacion d,2004-09-01,34,62,34,62,96
70702,CHARAGUA,estado nutricional,clasificacion d,2004-09-01,102,99,102,99,201
20305,CHARAÃ‘A,estado nutricional,clasificacion d,2004-09-01,24,13,24,13,37
50202,CHAYANTA,estado nutricional,clasificacion d,2004-09-01,99,125,99,125,224
31204,CHIMORE,estado nutricional,clasificacion d,2004-09-01,46,45,46,45,91
40903,CHIPAYA,estado nutricional,clasificacion d,2004-09-01,11,10,11,10,21
40302,CHOQUE COTA,estado nutricional,clasificacion d,2004-09-01,7,6,7,6,13
21101,CHULUMANI (V. DE LA LIBERTAD),estado nutricional,clasificacion d,2004-09-01,14,8,14,8,22
20501,CHUMA,estado nutricional,clasificacion d,2004-09-01,37,30,37,30,67
30801,CLIZA,estado nutricional,clasificacion d,2004-09-01,71,29,71,29,100
90101,COBIJA,estado nutricional,clasificacion d,2004-09-01,91,87,91,87,178
30101,COCHABAMBA,estado nutricional,clasificacion d,2004-09-01,629,498,629,498,1127
40902,COIPASA,estado nutricional,clasificacion d,2004-09-01,0,3,0,3,3
30905,COLCAPIRHUA,estado nutricional,clasificacion d,2004-09-01,61,40,61,40,101
50901,"COLCHA ""K""",estado nutricional,clasificacion d,2004-09-01,65,61,65,61,126
21307,COLLANA,estado nutricional,clasificacion d,2004-09-01,1,2,1,2,3
31002,COLOMI,estado nutricional,clasificacion d,2004-09-01,60,35,60,35,95
50401,COLQUECHACA,estado nutricional,clasificacion d,2004-09-01,131,75,131,75,206
21306,COLQUENCHA,estado nutricional,clasificacion d,2004-09-01,46,42,46,42,88
21004,COLQUIRI,estado nutricional,clasificacion d,2004-09-01,57,50,57,50,107
20304,COMANCHE,estado nutricional,clasificacion d,2004-09-01,7,9,7,9,16
71301,COMARAPA,estado nutricional,clasificacion d,2004-09-01,77,77,77,77,154
20605,COMBAYA,estado nutricional,clasificacion d,2004-09-01,12,14,12,14,26
71101,CONCEPCION,estado nutricional,clasificacion d,2004-09-01,16,1,16,1,17
21701,COPACABANA,estado nutricional,clasificacion d,2004-09-01,29,19,29,19,48
21402,CORIPATA,estado nutricional,clasificacion d,2004-09-01,6,5,6,5,11
20301,CORO CORO,estado nutricional,clasificacion d,2004-09-01,42,61,42,61,103
21401,COROICO,estado nutricional,clasificacion d,2004-09-01,25,20,25,20,45
40301,CORQUE,estado nutricional,clasificacion d,2004-09-01,26,21,26,21,47
50601,COTAGAITA,estado nutricional,clasificacion d,2004-09-01,188,289,188,289,477
70102,COTOCA,estado nutricional,clasificacion d,2004-09-01,49,44,49,44,93
31405,CUCHUMUELA (V. G. VILLARROEL),estado nutricional,clasificacion d,2004-09-01,8,6,8,6,14
70704,CUEVO,estado nutricional,clasificacion d,2004-09-01,5,11,5,11,16
10902,CULPINA,estado nutricional,clasificacion d,2004-09-01,205,295,205,295,500
40401,CURAHUARA DE CARANGAS,estado nutricional,clasificacion d,2004-09-01,17,16,17,16,33
21602,CURVA,estado nutricional,clasificacion d,2004-09-01,27,20,27,20,47
20804,DESAGUADERO,estado nutricional,clasificacion d,2004-09-01,19,11,19,11,30
20105,EL ALTO,estado nutricional,clasificacion d,2004-09-01,2355,1683,2355,1683,4038
40103,EL CHORO,estado nutricional,clasificacion d,2004-09-01,8,4,8,4,12
71503,EL PUENTE(STC),estado nutricional,clasificacion d,2004-09-01,42,65,42,65,107
60502,EL PUENTE(TJA),estado nutricional,clasificacion d,2004-09-01,28,84,28,84,112
70105,EL TORNO,estado nutricional,clasificacion d,2004-09-01,81,81,81,81,162
10405,EL VILLAR,estado nutricional,clasificacion d,2004-09-01,29,69,29,69,98
60601,ENTRE RIOS,estado nutricional,clasificacion d,2004-09-01,55,60,55,60,115
40502,ESCARA,estado nutricional,clasificacion d,2004-09-01,0,2,0,2,2
41101,EUCALIPTUS,estado nutricional,clasificacion d,2004-09-01,12,16,12,16,28
90503,EUREKA (SANTOS MERCADO),estado nutricional,clasificacion d,2004-09-01,2,0,2,0,2
80402,EXALTACION,estado nutricional,clasificacion d,2004-09-01,5,4,5,4,9
90203,FILADELFIA,estado nutricional,clasificacion d,2004-09-01,11,7,11,7,18
71002,GENERAL SAAVEDRA,estado nutricional,clasificacion d,2004-09-01,58,67,58,67,125
21601,GRAL. J.J. PEREZ (CHARAZANI),estado nutricional,clasificacion d,2004-09-01,35,52,35,52,87
20602,GUANAY,estado nutricional,clasificacion d,2004-09-01,88,93,88,93,181
20802,GUAQUI,estado nutricional,clasificacion d,2004-09-01,12,11,12,11,23
80202,GUAYARAMERIN,estado nutricional,clasificacion d,2004-09-01,102,139,102,139,241
70705,GUTIERREZ,estado nutricional,clasificacion d,2004-09-01,119,175,119,175,294
10502,HUACARETA,estado nutricional,clasificacion d,2004-09-01,33,81,33,81,114
11002,HUACAYA (VILLA DE HUACAYA),estado nutricional,clasificacion d,2004-09-01,15,16,15,16,31
40501,HUACHACALLA,estado nutricional,clasificacion d,2004-09-01,1,2,1,2,3
40701,HUANUNI,estado nutricional,clasificacion d,2004-09-01,83,72,83,72,155
80803,HUARACAJE,estado nutricional,clasificacion d,2004-09-01,19,24,19,24,43
41601,HUAYLLAMARCA,estado nutricional,clasificacion d,2004-09-01,9,8,9,8,17
21005,ICHOCA,estado nutricional,clasificacion d,2004-09-01,9,31,9,31,40
10304,ICLA,estado nutricional,clasificacion d,2004-09-01,124,231,124,231,355
10703,INCAHUASI,estado nutricional,clasificacion d,2004-09-01,241,229,241,229,470
21001,INQUISIVI,estado nutricional,clasificacion d,2004-09-01,59,77,59,77,136
21102,IRUPANA (VILLA DE LANZA),estado nutricional,clasificacion d,2004-09-01,23,42,23,42,65
21501,IXIAMAS,estado nutricional,clasificacion d,2004-09-01,18,24,18,24,42
21105,LA ASUNTA,estado nutricional,clasificacion d,2004-09-01,33,57,33,57,90
70104,LA GUARDIA,estado nutricional,clasificacion d,2004-09-01,66,53,66,53,119
20101,LA PAZ,estado nutricional,clasificacion d,2004-09-01,1534,1159,1534,1159,2693
70701,LAGUNILLAS,estado nutricional,clasificacion d,2004-09-01,16,23,16,23,39
21202,LAJA,estado nutricional,clasificacion d,2004-09-01,30,14,30,14,44
10903,LAS CARRERAS,estado nutricional,clasificacion d,2004-09-01,21,34,21,34,55
21006,LICOMA PAMPA,estado nutricional,clasificacion d,2004-09-01,11,2,11,2,13
50203,LLALLAGUA,estado nutricional,clasificacion d,2004-09-01,102,225,102,225,327
51401,LLICA,estado nutricional,clasificacion d,2004-09-01,11,17,11,17,28
80601,LORETO,estado nutricional,clasificacion d,2004-09-01,12,11,12,11,23
20901,LURIBAY,estado nutricional,clasificacion d,2004-09-01,34,39,34,39,73
40702,MACHACAMARCA,estado nutricional,clasificacion d,2004-09-01,1,0,1,0,1
11003,MACHARETI,estado nutricional,clasificacion d,2004-09-01,35,64,35,64,99
80801,MAGDALENA,estado nutricional,clasificacion d,2004-09-01,51,45,51,45,96
70903,MAIRANA,estado nutricional,clasificacion d,2004-09-01,25,18,25,18,43
20904,MALLA,estado nutricional,clasificacion d,2004-09-01,6,29,6,29,35
20103,MECAPACA,estado nutricional,clasificacion d,2004-09-01,25,29,25,29,54
71003,MINEROS,estado nutricional,clasificacion d,2004-09-01,148,123,148,123,271
31301,MIZQUE,estado nutricional,clasificacion d,2004-09-01,26,18,26,18,44
20402,MOCOMOCO,estado nutricional,clasificacion d,2004-09-01,60,87,60,87,147
51002,MOJINETE,estado nutricional,clasificacion d,2004-09-01,12,14,12,14,26
10303,MOJOCOYA,estado nutricional,clasificacion d,2004-09-01,41,89,41,89,130
10501,MONTEAGUDO,estado nutricional,clasificacion d,2004-09-01,107,195,107,195,302
71001,MONTERO,estado nutricional,clasificacion d,2004-09-01,306,268,306,268,574
70803,MORO MORO,estado nutricional,clasificacion d,2004-09-01,9,24,9,24,33
30302,MOROCHATA,estado nutricional,clasificacion d,2004-09-01,122,124,122,124,246
90401,NACEBE (SANTA ROSA DEL ABUNA),estado nutricional,clasificacion d,2004-09-01,7,9,7,9,16
20307,NAZACARA DE PACAJES,estado nutricional,clasificacion d,2004-09-01,1,0,1,0,1
90501,NUEVO MANOA (NUEVA ESPERANZA),estado nutricional,clasificacion d,2004-09-01,1,0,1,0,1
50404,OCURI,estado nutricional,clasificacion d,2004-09-01,142,144,142,144,286
70202,OKINAWA,estado nutricional,clasificacion d,2004-09-01,15,10,15,10,25
30203,OMEREQUE,estado nutricional,clasificacion d,2004-09-01,7,2,7,2,9
40101,ORURO,estado nutricional,clasificacion d,2004-09-01,710,517,710,517,1227
60201,PADCAYA,estado nutricional,clasificacion d,2004-09-01,49,72,49,72,121
10401,PADILLA,estado nutricional,clasificacion d,2004-09-01,103,212,103,212,315
70502,PAILON,estado nutricional,clasificacion d,2004-09-01,21,15,21,15,36
20102,PALCA,estado nutricional,clasificacion d,2004-09-01,58,47,58,47,105
21104,PALOS BLANCOS,estado nutricional,clasificacion d,2004-09-01,96,133,96,133,229
40802,PAMPA AULLAGAS,estado nutricional,clasificacion d,2004-09-01,9,11,9,11,20
70902,PAMPA GRANDE,estado nutricional,clasificacion d,2004-09-01,17,13,17,13,30
21802,PAPEL PAMPA,estado nutricional,clasificacion d,2004-09-01,4,12,4,12,16
30202,PASORAPA,estado nutricional,clasificacion d,2004-09-01,15,22,15,22,37
21305,PATACAMAYA,estado nutricional,clasificacion d,2004-09-01,113,63,113,63,176
40602,PAZÃ‘A,estado nutricional,clasificacion d,2004-09-01,8,21,8,21,29
20702,PELECHUCO,estado nutricional,clasificacion d,2004-09-01,41,26,41,26,67
50403,POCOATA,estado nutricional,clasificacion d,2004-09-01,122,139,122,139,261
31203,POCONA,estado nutricional,clasificacion d,2004-09-01,44,56,44,56,100
31202,POJO (CBBA),estado nutricional,clasificacion d,2004-09-01,185,196,185,196,381
40601,POOPO,estado nutricional,clasificacion d,2004-09-01,12,5,12,5,17
51203,PORCO,estado nutricional,clasificacion d,2004-09-01,33,18,33,18,51
10103,POROMA,estado nutricional,clasificacion d,2004-09-01,135,224,135,224,359
70103,PORONGO,estado nutricional,clasificacion d,2004-09-01,12,11,12,11,23
70601,PORTACHUELO,estado nutricional,clasificacion d,2004-09-01,45,73,45,73,118
90102,PORVENIR,estado nutricional,clasificacion d,2004-09-01,8,5,8,5,13
70804,POSTRER VALLE,estado nutricional,clasificacion d,2004-09-01,5,8,5,8,13
50101,POTOSI,estado nutricional,clasificacion d,2004-09-01,784,608,784,608,1392
10302,PRESTO,estado nutricional,clasificacion d,2004-09-01,60,107,60,107,167
21201,PUCARANI,estado nutricional,clasificacion d,2004-09-01,62,43,62,43,105
20401,PUERTO ACOSTA,estado nutricional,clasificacion d,2004-09-01,36,31,36,31,67
20403,PUERTO CARABUCO,estado nutricional,clasificacion d,2004-09-01,42,86,42,86,128
90301,PUERTO GONZALO MORENO,estado nutricional,clasificacion d,2004-09-01,13,13,13,13,26
21204,PUERTO PEREZ,estado nutricional,clasificacion d,2004-09-01,10,12,10,12,22
71402,PUERTO QUIJARRO,estado nutricional,clasificacion d,2004-09-01,4,2,4,2,6
90201,PUERTO RICO,estado nutricional,clasificacion d,2004-09-01,13,5,13,5,18
80703,PUERTO SILES,estado nutricional,clasificacion d,2004-09-01,0,1,0,1,1
71401,PUERTO SUAREZ,estado nutricional,clasificacion d,2004-09-01,5,3,5,3,8
31205,PUERTO VILLARROEL,estado nutricional,clasificacion d,2004-09-01,278,253,278,253,531
51101,PUNA,estado nutricional,clasificacion d,2004-09-01,174,211,174,211,385
31401,PUNATA,estado nutricional,clasificacion d,2004-09-01,62,31,62,31,93
20604,QUIABAYA,estado nutricional,clasificacion d,2004-09-01,22,30,22,30,52
30901,QUILLACOLLO,estado nutricional,clasificacion d,2004-09-01,79,91,79,91,170
21002,QUIME,estado nutricional,clasificacion d,2004-09-01,40,56,40,56,96
70904,QUIRUSILLAS,estado nutricional,clasificacion d,2004-09-01,2,4,2,4,6
50402,RAVELO,estado nutricional,clasificacion d,2004-09-01,227,254,227,254,481
80301,REYES,estado nutricional,clasificacion d,2004-09-01,27,53,27,53,80
80201,RIBERALTA,estado nutricional,clasificacion d,2004-09-01,451,410,451,410,861
70503,ROBORE,estado nutricional,clasificacion d,2004-09-01,31,24,31,24,55
80304,RURRENABAQUE,estado nutricional,clasificacion d,2004-09-01,26,16,26,16,42
40901,SABAYA,estado nutricional,clasificacion d,2004-09-01,4,1,4,1,5
31001,SACABA,estado nutricional,clasificacion d,2004-09-01,107,114,107,114,221
30404,SACABAMBA,estado nutricional,clasificacion d,2004-09-01,14,20,14,20,34
50701,SACACA,estado nutricional,clasificacion d,2004-09-01,267,464,267,464,731
71302,SAIPINA,estado nutricional,clasificacion d,2004-09-01,14,9,14,9,23
40801,SALINAS DE GARCI MENDOZA,estado nutricional,clasificacion d,2004-09-01,20,31,20,31,51
70901,SAMAIPATA,estado nutricional,clasificacion d,2004-09-01,21,9,21,9,30
51601,SAN AGUSTIN,estado nutricional,clasificacion d,2004-09-01,2,11,2,11,13
80602,SAN ANDRES,estado nutricional,clasificacion d,2004-09-01,35,56,35,56,91
51003,SAN ANTONIO DE ESMORUCO,estado nutricional,clasificacion d,2004-09-01,8,17,8,17,25
71105,SAN ANTONIO DE LOMERIO,estado nutricional,clasificacion d,2004-09-01,74,118,74,118,192
31403,SAN BENITO,estado nutricional,clasificacion d,2004-09-01,10,21,10,21,31
80302,SAN BORJA,estado nutricional,clasificacion d,2004-09-01,124,92,124,92,216
21502,SAN BUENA VENTURA,estado nutricional,clasificacion d,2004-09-01,46,50,46,50,96
70402,SAN CARLOS,estado nutricional,clasificacion d,2004-09-01,70,68,70,68,138
80501,SAN IGNACIO,estado nutricional,clasificacion d,2004-09-01,102,92,102,92,194
70301,SAN IGNACIO DE VELASCO,estado nutricional,clasificacion d,2004-09-01,254,332,254,332,586
80102,SAN JAVIER(BNI),estado nutricional,clasificacion d,2004-09-01,18,21,18,21,39
71102,SAN JAVIER(STC),estado nutricional,clasificacion d,2004-09-01,26,49,26,49,75
80701,SAN JOAQUIN,estado nutricional,clasificacion d,2004-09-01,10,9,10,9,19
70501,SAN JOSE DE CHIQUITOS,estado nutricional,clasificacion d,2004-09-01,30,17,30,17,47
71104,SAN JULIAN,estado nutricional,clasificacion d,2004-09-01,76,95,76,95,171
90302,SAN LORENZO(PND),estado nutricional,clasificacion d,2004-09-01,2,5,2,5,7
60501,SAN LORENZO(TJA),estado nutricional,clasificacion d,2004-09-01,39,66,39,66,105
10702,SAN LUCAS,estado nutricional,clasificacion d,2004-09-01,434,517,434,517,951
71201,SAN MATIAS,estado nutricional,clasificacion d,2004-09-01,15,11,15,11,26
70302,SAN MIGUEL DE VELASCO,estado nutricional,clasificacion d,2004-09-01,43,62,43,62,105
51001,SAN PABLO DE LIPEZ,estado nutricional,clasificacion d,2004-09-01,21,14,21,14,35
50501,SAN PEDRO DE BUENA VISTA,estado nutricional,clasificacion d,2004-09-01,173,278,173,278,451
21801,SAN PEDRO DE CURAHUARA,estado nutricional,clasificacion d,2004-09-01,23,30,23,30,53
50902,SAN PEDRO DE QUEMES,estado nutricional,clasificacion d,2004-09-01,1,0,1,0,1
21702,SAN PEDRO DE TIQUINA,estado nutricional,clasificacion d,2004-09-01,12,16,12,16,28
90202,SAN PEDRO(PND),estado nutricional,clasificacion d,2004-09-01,2,1,2,1,3
70303,SAN RAFAEL,estado nutricional,clasificacion d,2004-09-01,41,27,41,27,68
80702,SAN RAMON,estado nutricional,clasificacion d,2004-09-01,18,8,18,8,26
80401,SANTA ANA,estado nutricional,clasificacion d,2004-09-01,40,27,40,27,67
70101,SANTA CRUZ DE LA SIERRA,estado nutricional,clasificacion d,2004-09-01,1066,473,1066,473,1539
80303,SANTA ROSA,estado nutricional,clasificacion d,2004-09-01,23,18,23,18,41
70602,SANTA ROSA DEL SARA,estado nutricional,clasificacion d,2004-09-01,40,44,40,44,84
20308,SANTIAGO DE CALLAPA,estado nutricional,clasificacion d,2004-09-01,44,46,44,46,90
41401,SANTIAGO DE HUARI,estado nutricional,clasificacion d,2004-09-01,21,33,21,33,54
21901,SANTIAGO DE MACHACA,estado nutricional,clasificacion d,2004-09-01,15,14,15,14,29
30702,SANTIVAÃ‘ES,estado nutricional,clasificacion d,2004-09-01,24,29,24,29,53
40202,SANTUARIO DE QUILLACAS,estado nutricional,clasificacion d,2004-09-01,7,9,7,9,16
20902,SAPAHAQUI,estado nutricional,clasificacion d,2004-09-01,25,35,25,35,60
90303,SENA,estado nutricional,clasificacion d,2004-09-01,17,18,17,18,35
21301,SICA SICA (VILLA AROMA),estado nutricional,clasificacion d,2004-09-01,135,123,135,123,258
30703,SICAYA,estado nutricional,clasificacion d,2004-09-01,13,21,13,21,34
30902,SIPE SIPE,estado nutricional,clasificacion d,2004-09-01,206,162,206,162,368
10403,SOPACHUY,estado nutricional,clasificacion d,2004-09-01,61,155,61,155,216
20601,SORATA,estado nutricional,clasificacion d,2004-09-01,31,49,31,49,80
10101,SUCRE,estado nutricional,clasificacion d,2004-09-01,539,609,539,609,1148
31404,TACACHI,estado nutricional,clasificacion d,2004-09-01,9,12,9,12,21
20603,TACACOMA,estado nutricional,clasificacion d,2004-09-01,37,58,37,58,95
50303,TACOBAMBA,estado nutricional,clasificacion d,2004-09-01,39,52,39,52,91
30602,TACOPAYA,estado nutricional,clasificacion d,2004-09-01,90,97,90,97,187
51402,TAHUA,estado nutricional,clasificacion d,2004-09-01,4,3,4,3,7
31101,TAPACARI,estado nutricional,clasificacion d,2004-09-01,189,182,189,182,371
10601,TARABUCO,estado nutricional,clasificacion d,2004-09-01,241,486,241,486,727
30401,TARATA,estado nutricional,clasificacion d,2004-09-01,29,31,29,31,60
60101,TARIJA,estado nutricional,clasificacion d,2004-09-01,365,385,365,385,750
10202,TARVITA,estado nutricional,clasificacion d,2004-09-01,139,351,139,351,490
20803,TIAWANACU,estado nutricional,clasificacion d,2004-09-01,32,34,32,34,66
50102,TINGUIPAYA,estado nutricional,clasificacion d,2004-09-01,236,242,236,242,478
20606,TIPUANI,estado nutricional,clasificacion d,2004-09-01,4,7,4,7,11
30903,TIQUIPAYA,estado nutricional,clasificacion d,2004-09-01,41,26,41,26,67
31601,TIRAQUE (CBBA),estado nutricional,clasificacion d,2004-09-01,187,171,187,171,358
21703,TITO YUPANQUI (PARQUIPUJIO),estado nutricional,clasificacion d,2004-09-01,1,1,1,1,2
30802,TOCO,estado nutricional,clasificacion d,2004-09-01,4,17,4,17,21
41502,TODOS SANTOS,estado nutricional,clasificacion d,2004-09-01,0,1,0,1,1
30803,TOLATA,estado nutricional,clasificacion d,2004-09-01,3,5,3,5,8
41001,TOLEDO,estado nutricional,clasificacion d,2004-09-01,12,3,12,3,15
51202,TOMAVE,estado nutricional,clasificacion d,2004-09-01,54,63,54,63,117
10402,TOMINA,estado nutricional,clasificacion d,2004-09-01,120,219,120,219,339
50502,TORO TORO,estado nutricional,clasificacion d,2004-09-01,99,131,99,131,230
31201,TOTORA(CBBA),estado nutricional,clasificacion d,2004-09-01,88,88,88,88,176
41301,TOTORA(ORR),estado nutricional,clasificacion d,2004-09-01,12,19,12,19,31
70802,TRIGAL,estado nutricional,clasificacion d,2004-09-01,0,3,0,3,3
80101,TRINIDAD,estado nutricional,clasificacion d,2004-09-01,213,213,213,213,426
50801,TUPIZA,estado nutricional,clasificacion d,2004-09-01,196,226,196,226,422
21302,UMALA,estado nutricional,clasificacion d,2004-09-01,12,5,12,5,17
50201,UNCIA,estado nutricional,clasificacion d,2004-09-01,83,94,83,94,177
60401,URIONDO (A. CONCEPCION),estado nutricional,clasificacion d,2004-09-01,64,101,64,101,165
71502,URUBICHA,estado nutricional,clasificacion d,2004-09-01,4,7,4,7,11
51201,UYUNI,estado nutricional,clasificacion d,2004-09-01,78,116,78,116,194
30502,VACAS,estado nutricional,clasificacion d,2004-09-01,27,28,27,28,55
70801,VALLEGRANDE,estado nutricional,clasificacion d,2004-09-01,50,62,50,62,112
20801,VIACHA,estado nutricional,clasificacion d,2004-09-01,145,112,145,112,257
31302,VILA VILA,estado nutricional,clasificacion d,2004-09-01,34,31,34,31,65
60303,VILLA MONTES,estado nutricional,clasificacion d,2004-09-01,102,79,102,79,181
90502,VILLA NUEVA (LOMA ALTA),estado nutricional,clasificacion d,2004-09-01,4,1,4,1,5
31402,VILLA RIVERO,estado nutricional,clasificacion d,2004-09-01,14,10,14,10,24
10801,VILLA SERRANO,estado nutricional,clasificacion d,2004-09-01,86,218,86,218,304
31003,VILLA TUNARI,estado nutricional,clasificacion d,2004-09-01,257,235,257,235,492
11001,VILLA VACA GUZMAN (MUYUPAMPA),estado nutricional,clasificacion d,2004-09-01,60,108,60,108,168
51501,VILLAZON,estado nutricional,clasificacion d,2004-09-01,108,146,108,146,254
30904,VINTO,estado nutricional,clasificacion d,2004-09-01,37,22,37,22,59
50602,VITICHI,estado nutricional,clasificacion d,2004-09-01,77,189,77,189,266
70201,WARNES,estado nutricional,clasificacion d,2004-09-01,61,33,61,33,94
20903,YACO,estado nutricional,clasificacion d,2004-09-01,49,70,49,70,119
60301,YACUIBA,estado nutricional,clasificacion d,2004-09-01,118,78,118,78,196
10602,YAMPARAEZ,estado nutricional,clasificacion d,2004-09-01,123,228,123,228,351
21103,YANACACHI,estado nutricional,clasificacion d,2004-09-01,7,10,7,10,17
70403,YAPACANI,estado nutricional,clasificacion d,2004-09-01,142,153,142,153,295
50103,YOCALLA,estado nutricional,clasificacion d,2004-09-01,22,25,22,25,47
10102,YOTALA,estado nutricional,clasificacion d,2004-09-01,72,169,72,169,241
60402,YUNCHARA,estado nutricional,clasificacion d,2004-09-01,37,82,37,82,119
10301,ZUDAÃ‘EZ,estado nutricional,clasificacion d,2004-09-01,62,128,62,128,190
51302,ACACIO,estado nutricional,clasificacion d,2004-10-01,65,109,65,109,174
20201,ACHACACHI,estado nutricional,clasificacion d,2004-10-01,125,144,125,144,269
20104,ACHOCALLA,estado nutricional,clasificacion d,2004-10-01,24,24,24,24,48
30201,AIQUILE,estado nutricional,clasificacion d,2004-10-01,40,67,40,67,107
31303,ALALAY,estado nutricional,clasificacion d,2004-10-01,6,5,6,5,11
10404,ALCALA,estado nutricional,clasificacion d,2004-10-01,19,82,19,82,101
20202,ANCORAIMES,estado nutricional,clasificacion d,2004-10-01,75,118,75,118,193
41201,ANDAMARCA,estado nutricional,clasificacion d,2004-10-01,6,8,6,8,14
40603,ANTEQUERA,estado nutricional,clasificacion d,2004-10-01,6,8,6,8,14
30402,ANZALDO,estado nutricional,clasificacion d,2004-10-01,9,15,9,15,24
20701,APOLO,estado nutricional,clasificacion d,2004-10-01,50,76,50,76,126
51301,ARAMPAMPA,estado nutricional,clasificacion d,2004-10-01,56,52,56,52,108
30501,ARANI,estado nutricional,clasificacion d,2004-10-01,22,7,22,7,29
30403,ARBIETO,estado nutricional,clasificacion d,2004-10-01,22,24,22,24,46
30601,ARQUE,estado nutricional,clasificacion d,2004-10-01,25,19,25,19,44
71501,ASCENCION DE GUARAYOS,estado nutricional,clasificacion d,2004-10-01,126,260,126,260,386
50802,ATOCHA,estado nutricional,clasificacion d,2004-10-01,66,77,66,77,143
20503,AUCAPATA,estado nutricional,clasificacion d,2004-10-01,9,9,9,9,18
20502,AYATA,estado nutricional,clasificacion d,2004-10-01,22,27,22,27,49
21303,AYO AYO,estado nutricional,clasificacion d,2004-10-01,23,8,23,8,31
30301,AYOPAYA (V. DE INDEPENDENCIA),estado nutricional,clasificacion d,2004-10-01,122,135,122,135,257
10201,AZURDUY,estado nutricional,clasificacion d,2004-10-01,50,96,50,96,146
21203,BATALLAS,estado nutricional,clasificacion d,2004-10-01,35,19,35,19,54
80802,BAURES,estado nutricional,clasificacion d,2004-10-01,13,19,13,19,32
41202,BELEN DE ANDAMARCA,estado nutricional,clasificacion d,2004-10-01,2,1,2,1,3
50104,BELEN DE URMIRI,estado nutricional,clasificacion d,2004-10-01,12,13,12,13,25
90104,BELLA FLOR,estado nutricional,clasificacion d,2004-10-01,11,26,11,26,37
60202,BERMEJO,estado nutricional,clasificacion d,2004-10-01,31,18,31,18,49
50301,BETANZOS,estado nutricional,clasificacion d,2004-10-01,184,272,184,272,456
31501,BOLIVAR,estado nutricional,clasificacion d,2004-10-01,56,103,56,103,159
90103,BOLPEBRA,estado nutricional,clasificacion d,2004-10-01,6,9,6,9,15
70707,BOYUIBE,estado nutricional,clasificacion d,2004-10-01,18,24,18,24,42
70401,BUENA VISTA,estado nutricional,clasificacion d,2004-10-01,18,52,18,52,70
70703,CABEZAS,estado nutricional,clasificacion d,2004-10-01,5,6,5,6,11
20905,CAIROMA,estado nutricional,clasificacion d,2004-10-01,91,98,91,98,189
51102,"CAIZA ""D""",estado nutricional,clasificacion d,2004-10-01,39,64,39,64,103
21003,CAJUATA,estado nutricional,clasificacion d,2004-10-01,33,28,33,28,61
20303,CALACOTO,estado nutricional,clasificacion d,2004-10-01,11,13,11,13,24
21304,CALAMARCA,estado nutricional,clasificacion d,2004-10-01,181,195,181,195,376
10701,CAMARGO,estado nutricional,clasificacion d,2004-10-01,148,185,148,185,333
10901,CAMATAQUI (C. VILLA ABECIA),estado nutricional,clasificacion d,2004-10-01,14,24,14,24,38
70706,CAMIRI,estado nutricional,clasificacion d,2004-10-01,119,92,119,92,211
30701,CAPINOTA,estado nutricional,clasificacion d,2004-10-01,77,57,77,57,134
20302,CAQUIAVIRI,estado nutricional,clasificacion d,2004-10-01,37,44,37,44,81
40102,CARACOLLO,estado nutricional,clasificacion d,2004-10-01,40,37,40,37,77
22001,CARANAVI,estado nutricional,clasificacion d,2004-10-01,127,123,127,123,250
41503,CARANGAS,estado nutricional,clasificacion d,2004-10-01,1,0,1,0,1
60302,CARAPARI,estado nutricional,clasificacion d,2004-10-01,20,39,20,39,59
50702,CARIPUYO,estado nutricional,clasificacion d,2004-10-01,89,105,89,105,194
21803,CHACARILLA,estado nutricional,clasificacion d,2004-10-01,1,4,1,4,5
40201,CHALLAPATA,estado nutricional,clasificacion d,2004-10-01,71,88,71,88,159
50302,CHAQUI,estado nutricional,clasificacion d,2004-10-01,29,53,29,53,82
70702,CHARAGUA,estado nutricional,clasificacion d,2004-10-01,134,101,134,101,235
20305,CHARAÃ‘A,estado nutricional,clasificacion d,2004-10-01,9,3,9,3,12
50202,CHAYANTA,estado nutricional,clasificacion d,2004-10-01,65,105,65,105,170
31204,CHIMORE,estado nutricional,clasificacion d,2004-10-01,28,41,28,41,69
40903,CHIPAYA,estado nutricional,clasificacion d,2004-10-01,9,7,9,7,16
40302,CHOQUE COTA,estado nutricional,clasificacion d,2004-10-01,7,0,7,0,7
21101,CHULUMANI (V. DE LA LIBERTAD),estado nutricional,clasificacion d,2004-10-01,13,17,13,17,30
20501,CHUMA,estado nutricional,clasificacion d,2004-10-01,31,35,31,35,66
30801,CLIZA,estado nutricional,clasificacion d,2004-10-01,43,37,43,37,80
90101,COBIJA,estado nutricional,clasificacion d,2004-10-01,87,84,87,84,171
30101,COCHABAMBA,estado nutricional,clasificacion d,2004-10-01,566,425,566,425,991
40902,COIPASA,estado nutricional,clasificacion d,2004-10-01,1,2,1,2,3
30905,COLCAPIRHUA,estado nutricional,clasificacion d,2004-10-01,38,24,38,24,62
50901,"COLCHA ""K""",estado nutricional,clasificacion d,2004-10-01,41,53,41,53,94
21307,COLLANA,estado nutricional,clasificacion d,2004-10-01,2,2,2,2,4
31002,COLOMI,estado nutricional,clasificacion d,2004-10-01,63,50,63,50,113
50401,COLQUECHACA,estado nutricional,clasificacion d,2004-10-01,159,77,159,77,236
21306,COLQUENCHA,estado nutricional,clasificacion d,2004-10-01,42,40,42,40,82
21004,COLQUIRI,estado nutricional,clasificacion d,2004-10-01,74,56,74,56,130
20304,COMANCHE,estado nutricional,clasificacion d,2004-10-01,11,7,11,7,18
71301,COMARAPA,estado nutricional,clasificacion d,2004-10-01,72,51,72,51,123
20605,COMBAYA,estado nutricional,clasificacion d,2004-10-01,6,8,6,8,14
71101,CONCEPCION,estado nutricional,clasificacion d,2004-10-01,13,3,13,3,16
21701,COPACABANA,estado nutricional,clasificacion d,2004-10-01,44,24,44,24,68
21402,CORIPATA,estado nutricional,clasificacion d,2004-10-01,14,6,14,6,20
20301,CORO CORO,estado nutricional,clasificacion d,2004-10-01,49,48,49,48,97
21401,COROICO,estado nutricional,clasificacion d,2004-10-01,38,18,38,18,56
40301,CORQUE,estado nutricional,clasificacion d,2004-10-01,24,22,24,22,46
50601,COTAGAITA,estado nutricional,clasificacion d,2004-10-01,57,78,57,78,135
70102,COTOCA,estado nutricional,clasificacion d,2004-10-01,48,43,48,43,91
31405,CUCHUMUELA (V. G. VILLARROEL),estado nutricional,clasificacion d,2004-10-01,10,5,10,5,15
70704,CUEVO,estado nutricional,clasificacion d,2004-10-01,9,13,9,13,22
10902,CULPINA,estado nutricional,clasificacion d,2004-10-01,199,295,199,295,494
40401,CURAHUARA DE CARANGAS,estado nutricional,clasificacion d,2004-10-01,23,29,23,29,52
21602,CURVA,estado nutricional,clasificacion d,2004-10-01,18,14,18,14,32
20804,DESAGUADERO,estado nutricional,clasificacion d,2004-10-01,13,10,13,10,23
20105,EL ALTO,estado nutricional,clasificacion d,2004-10-01,2216,1600,2216,1600,3816
40103,EL CHORO,estado nutricional,clasificacion d,2004-10-01,12,7,12,7,19
71503,EL PUENTE(STC),estado nutricional,clasificacion d,2004-10-01,33,75,33,75,108
60502,EL PUENTE(TJA),estado nutricional,clasificacion d,2004-10-01,57,83,57,83,140
70105,EL TORNO,estado nutricional,clasificacion d,2004-10-01,52,56,52,56,108
10405,EL VILLAR,estado nutricional,clasificacion d,2004-10-01,29,79,29,79,108
60601,ENTRE RIOS,estado nutricional,clasificacion d,2004-10-01,26,52,26,52,78
41101,EUCALIPTUS,estado nutricional,clasificacion d,2004-10-01,9,4,9,4,13
90503,EUREKA (SANTOS MERCADO),estado nutricional,clasificacion d,2004-10-01,0,1,0,1,1
80402,EXALTACION,estado nutricional,clasificacion d,2004-10-01,17,19,17,19,36
90203,FILADELFIA,estado nutricional,clasificacion d,2004-10-01,6,1,6,1,7
71002,GENERAL SAAVEDRA,estado nutricional,clasificacion d,2004-10-01,54,89,54,89,143
21601,GRAL. J.J. PEREZ (CHARAZANI),estado nutricional,clasificacion d,2004-10-01,41,49,41,49,90
20602,GUANAY,estado nutricional,clasificacion d,2004-10-01,99,118,99,118,217
20802,GUAQUI,estado nutricional,clasificacion d,2004-10-01,14,10,14,10,24
80202,GUAYARAMERIN,estado nutricional,clasificacion d,2004-10-01,102,113,102,113,215
70705,GUTIERREZ,estado nutricional,clasificacion d,2004-10-01,103,171,103,171,274
10502,HUACARETA,estado nutricional,clasificacion d,2004-10-01,46,75,46,75,121
11002,HUACAYA (VILLA DE HUACAYA),estado nutricional,clasificacion d,2004-10-01,15,20,15,20,35
40501,HUACHACALLA,estado nutricional,clasificacion d,2004-10-01,1,1,1,1,2
40701,HUANUNI,estado nutricional,clasificacion d,2004-10-01,80,58,80,58,138
80803,HUARACAJE,estado nutricional,clasificacion d,2004-10-01,22,7,22,7,29
41601,HUAYLLAMARCA,estado nutricional,clasificacion d,2004-10-01,9,8,9,8,17
21005,ICHOCA,estado nutricional,clasificacion d,2004-10-01,29,30,29,30,59
10304,ICLA,estado nutricional,clasificacion d,2004-10-01,100,143,100,143,243
10703,INCAHUASI,estado nutricional,clasificacion d,2004-10-01,271,334,271,334,605
90402,INGAVI (HUMAITA),estado nutricional,clasificacion d,2004-10-01,4,2,4,2,6
21001,INQUISIVI,estado nutricional,clasificacion d,2004-10-01,80,81,80,81,161
21102,IRUPANA (VILLA DE LANZA),estado nutricional,clasificacion d,2004-10-01,34,20,34,20,54
21501,IXIAMAS,estado nutricional,clasificacion d,2004-10-01,20,34,20,34,54
21105,LA ASUNTA,estado nutricional,clasificacion d,2004-10-01,33,22,33,22,55
70104,LA GUARDIA,estado nutricional,clasificacion d,2004-10-01,64,69,64,69,133
20101,LA PAZ,estado nutricional,clasificacion d,2004-10-01,1368,1114,1368,1114,2482
41501,LA RIVERA,estado nutricional,clasificacion d,2004-10-01,0,1,0,1,1
70701,LAGUNILLAS,estado nutricional,clasificacion d,2004-10-01,25,45,25,45,70
21202,LAJA,estado nutricional,clasificacion d,2004-10-01,38,27,38,27,65
10903,LAS CARRERAS,estado nutricional,clasificacion d,2004-10-01,18,28,18,28,46
50203,LLALLAGUA,estado nutricional,clasificacion d,2004-10-01,149,182,149,182,331
51401,LLICA,estado nutricional,clasificacion d,2004-10-01,7,9,7,9,16
80601,LORETO,estado nutricional,clasificacion d,2004-10-01,7,12,7,12,19
20901,LURIBAY,estado nutricional,clasificacion d,2004-10-01,62,75,62,75,137
40702,MACHACAMARCA,estado nutricional,clasificacion d,2004-10-01,10,3,10,3,13
11003,MACHARETI,estado nutricional,clasificacion d,2004-10-01,41,87,41,87,128
80801,MAGDALENA,estado nutricional,clasificacion d,2004-10-01,29,20,29,20,49
70903,MAIRANA,estado nutricional,clasificacion d,2004-10-01,20,18,20,18,38
20904,MALLA,estado nutricional,clasificacion d,2004-10-01,1,6,1,6,7
20103,MECAPACA,estado nutricional,clasificacion d,2004-10-01,32,33,32,33,65
71003,MINEROS,estado nutricional,clasificacion d,2004-10-01,155,141,155,141,296
31301,MIZQUE,estado nutricional,clasificacion d,2004-10-01,56,22,56,22,78
20402,MOCOMOCO,estado nutricional,clasificacion d,2004-10-01,41,76,41,76,117
51002,MOJINETE,estado nutricional,clasificacion d,2004-10-01,2,6,2,6,8
10303,MOJOCOYA,estado nutricional,clasificacion d,2004-10-01,52,106,52,106,158
10501,MONTEAGUDO,estado nutricional,clasificacion d,2004-10-01,101,197,101,197,298
71001,MONTERO,estado nutricional,clasificacion d,2004-10-01,233,191,233,191,424
70803,MORO MORO,estado nutricional,clasificacion d,2004-10-01,16,28,16,28,44
30302,MOROCHATA,estado nutricional,clasificacion d,2004-10-01,103,116,103,116,219
90401,NACEBE (SANTA ROSA DEL ABUNA),estado nutricional,clasificacion d,2004-10-01,4,5,4,5,9
20307,NAZACARA DE PACAJES,estado nutricional,clasificacion d,2004-10-01,0,1,0,1,1
90501,NUEVO MANOA (NUEVA ESPERANZA),estado nutricional,clasificacion d,2004-10-01,0,2,0,2,2
50404,OCURI,estado nutricional,clasificacion d,2004-10-01,69,97,69,97,166
70202,OKINAWA,estado nutricional,clasificacion d,2004-10-01,30,10,30,10,40
30203,OMEREQUE,estado nutricional,clasificacion d,2004-10-01,7,12,7,12,19
40101,ORURO,estado nutricional,clasificacion d,2004-10-01,661,466,661,466,1127
60201,PADCAYA,estado nutricional,clasificacion d,2004-10-01,43,83,43,83,126
10401,PADILLA,estado nutricional,clasificacion d,2004-10-01,77,192,77,192,269
70502,PAILON,estado nutricional,clasificacion d,2004-10-01,35,22,35,22,57
20102,PALCA,estado nutricional,clasificacion d,2004-10-01,39,21,39,21,60
21104,PALOS BLANCOS,estado nutricional,clasificacion d,2004-10-01,129,138,129,138,267
40802,PAMPA AULLAGAS,estado nutricional,clasificacion d,2004-10-01,10,17,10,17,27
70902,PAMPA GRANDE,estado nutricional,clasificacion d,2004-10-01,15,13,15,13,28
21802,PAPEL PAMPA,estado nutricional,clasificacion d,2004-10-01,19,21,19,21,40
30202,PASORAPA,estado nutricional,clasificacion d,2004-10-01,18,24,18,24,42
21305,PATACAMAYA,estado nutricional,clasificacion d,2004-10-01,222,111,222,111,333
40602,PAZÃ‘A,estado nutricional,clasificacion d,2004-10-01,11,14,11,14,25
20702,PELECHUCO,estado nutricional,clasificacion d,2004-10-01,39,23,39,23,62
50403,POCOATA,estado nutricional,clasificacion d,2004-10-01,180,301,180,301,481
31203,POCONA,estado nutricional,clasificacion d,2004-10-01,33,53,33,53,86
31202,POJO (CBBA),estado nutricional,clasificacion d,2004-10-01,139,121,139,121,260
40601,POOPO,estado nutricional,clasificacion d,2004-10-01,3,2,3,2,5
51203,PORCO,estado nutricional,clasificacion d,2004-10-01,30,23,30,23,53
10103,POROMA,estado nutricional,clasificacion d,2004-10-01,106,194,106,194,300
70103,PORONGO,estado nutricional,clasificacion d,2004-10-01,22,7,22,7,29
70601,PORTACHUELO,estado nutricional,clasificacion d,2004-10-01,56,57,56,57,113
90102,PORVENIR,estado nutricional,clasificacion d,2004-10-01,12,13,12,13,25
70804,POSTRER VALLE,estado nutricional,clasificacion d,2004-10-01,2,9,2,9,11
50101,POTOSI,estado nutricional,clasificacion d,2004-10-01,668,530,668,530,1198
10302,PRESTO,estado nutricional,clasificacion d,2004-10-01,64,109,64,109,173
70805,PUCARA,estado nutricional,clasificacion d,2004-10-01,12,23,12,23,35
21201,PUCARANI,estado nutricional,clasificacion d,2004-10-01,68,57,68,57,125
20401,PUERTO ACOSTA,estado nutricional,clasificacion d,2004-10-01,87,102,87,102,189
20403,PUERTO CARABUCO,estado nutricional,clasificacion d,2004-10-01,30,48,30,48,78
90301,PUERTO GONZALO MORENO,estado nutricional,clasificacion d,2004-10-01,12,22,12,22,34
21204,PUERTO PEREZ,estado nutricional,clasificacion d,2004-10-01,13,13,13,13,26
90201,PUERTO RICO,estado nutricional,clasificacion d,2004-10-01,13,9,13,9,22
31205,PUERTO VILLARROEL,estado nutricional,clasificacion d,2004-10-01,236,176,236,176,412
51101,PUNA,estado nutricional,clasificacion d,2004-10-01,90,108,90,108,198
31401,PUNATA,estado nutricional,clasificacion d,2004-10-01,39,23,39,23,62
20604,QUIABAYA,estado nutricional,clasificacion d,2004-10-01,11,43,11,43,54
30901,QUILLACOLLO,estado nutricional,clasificacion d,2004-10-01,91,63,91,63,154
21002,QUIME,estado nutricional,clasificacion d,2004-10-01,63,82,63,82,145
70904,QUIRUSILLAS,estado nutricional,clasificacion d,2004-10-01,4,3,4,3,7
50402,RAVELO,estado nutricional,clasificacion d,2004-10-01,159,195,159,195,354
80301,REYES,estado nutricional,clasificacion d,2004-10-01,19,31,19,31,50
80201,RIBERALTA,estado nutricional,clasificacion d,2004-10-01,363,376,363,376,739
70503,ROBORE,estado nutricional,clasificacion d,2004-10-01,36,22,36,22,58
80304,RURRENABAQUE,estado nutricional,clasificacion d,2004-10-01,58,29,58,29,87
40901,SABAYA,estado nutricional,clasificacion d,2004-10-01,7,9,7,9,16
31001,SACABA,estado nutricional,clasificacion d,2004-10-01,51,31,51,31,82
30404,SACABAMBA,estado nutricional,clasificacion d,2004-10-01,12,29,12,29,41
50701,SACACA,estado nutricional,clasificacion d,2004-10-01,344,577,344,577,921
71302,SAIPINA,estado nutricional,clasificacion d,2004-10-01,25,14,25,14,39
40801,SALINAS DE GARCI MENDOZA,estado nutricional,clasificacion d,2004-10-01,14,20,14,20,34
70901,SAMAIPATA,estado nutricional,clasificacion d,2004-10-01,15,25,15,25,40
51601,SAN AGUSTIN,estado nutricional,clasificacion d,2004-10-01,1,5,1,5,6
80602,SAN ANDRES,estado nutricional,clasificacion d,2004-10-01,31,35,31,35,66
51003,SAN ANTONIO DE ESMORUCO,estado nutricional,clasificacion d,2004-10-01,0,7,0,7,7
71105,SAN ANTONIO DE LOMERIO,estado nutricional,clasificacion d,2004-10-01,64,134,64,134,198
31403,SAN BENITO,estado nutricional,clasificacion d,2004-10-01,16,17,16,17,33
80302,SAN BORJA,estado nutricional,clasificacion d,2004-10-01,147,106,147,106,253
21502,SAN BUENA VENTURA,estado nutricional,clasificacion d,2004-10-01,20,43,20,43,63
70402,SAN CARLOS,estado nutricional,clasificacion d,2004-10-01,58,56,58,56,114
80501,SAN IGNACIO,estado nutricional,clasificacion d,2004-10-01,95,91,95,91,186
70301,SAN IGNACIO DE VELASCO,estado nutricional,clasificacion d,2004-10-01,152,143,152,143,295
80102,SAN JAVIER(BNI),estado nutricional,clasificacion d,2004-10-01,8,12,8,12,20
71102,SAN JAVIER(STC),estado nutricional,clasificacion d,2004-10-01,22,46,22,46,68
80701,SAN JOAQUIN,estado nutricional,clasificacion d,2004-10-01,9,6,9,6,15
70501,SAN JOSE DE CHIQUITOS,estado nutricional,clasificacion d,2004-10-01,24,7,24,7,31
71104,SAN JULIAN,estado nutricional,clasificacion d,2004-10-01,86,114,86,114,200
90302,SAN LORENZO(PND),estado nutricional,clasificacion d,2004-10-01,11,23,11,23,34
60501,SAN LORENZO(TJA),estado nutricional,clasificacion d,2004-10-01,69,103,69,103,172
10702,SAN LUCAS,estado nutricional,clasificacion d,2004-10-01,396,540,396,540,936
70302,SAN MIGUEL DE VELASCO,estado nutricional,clasificacion d,2004-10-01,51,85,51,85,136
51001,SAN PABLO DE LIPEZ,estado nutricional,clasificacion d,2004-10-01,16,21,16,21,37
50501,SAN PEDRO DE BUENA VISTA,estado nutricional,clasificacion d,2004-10-01,154,227,154,227,381
21801,SAN PEDRO DE CURAHUARA,estado nutricional,clasificacion d,2004-10-01,18,51,18,51,69
21702,SAN PEDRO DE TIQUINA,estado nutricional,clasificacion d,2004-10-01,12,19,12,19,31
90202,SAN PEDRO(PND),estado nutricional,clasificacion d,2004-10-01,3,4,3,4,7
70303,SAN RAFAEL,estado nutricional,clasificacion d,2004-10-01,28,53,28,53,81
80702,SAN RAMON,estado nutricional,clasificacion d,2004-10-01,11,4,11,4,15
80401,SANTA ANA,estado nutricional,clasificacion d,2004-10-01,27,17,27,17,44
70101,SANTA CRUZ DE LA SIERRA,estado nutricional,clasificacion d,2004-10-01,1033,481,1033,481,1514
80303,SANTA ROSA,estado nutricional,clasificacion d,2004-10-01,41,34,41,34,75
70602,SANTA ROSA DEL SARA,estado nutricional,clasificacion d,2004-10-01,25,27,25,27,52
20308,SANTIAGO DE CALLAPA,estado nutricional,clasificacion d,2004-10-01,28,23,28,23,51
41401,SANTIAGO DE HUARI,estado nutricional,clasificacion d,2004-10-01,17,13,17,13,30
21901,SANTIAGO DE MACHACA,estado nutricional,clasificacion d,2004-10-01,15,27,15,27,42
30702,SANTIVAÃ‘ES,estado nutricional,clasificacion d,2004-10-01,29,21,29,21,50
40202,SANTUARIO DE QUILLACAS,estado nutricional,clasificacion d,2004-10-01,6,16,6,16,22
20902,SAPAHAQUI,estado nutricional,clasificacion d,2004-10-01,89,86,89,86,175
90303,SENA,estado nutricional,clasificacion d,2004-10-01,0,5,0,5,5
21301,SICA SICA (VILLA AROMA),estado nutricional,clasificacion d,2004-10-01,120,124,120,124,244
30703,SICAYA,estado nutricional,clasificacion d,2004-10-01,17,29,17,29,46
30902,SIPE SIPE,estado nutricional,clasificacion d,2004-10-01,151,127,151,127,278
10403,SOPACHUY,estado nutricional,clasificacion d,2004-10-01,40,53,40,53,93
20601,SORATA,estado nutricional,clasificacion d,2004-10-01,44,97,44,97,141
10101,SUCRE,estado nutricional,clasificacion d,2004-10-01,437,707,437,707,1144
31404,TACACHI,estado nutricional,clasificacion d,2004-10-01,7,4,7,4,11
20603,TACACOMA,estado nutricional,clasificacion d,2004-10-01,24,18,24,18,42
30602,TACOPAYA,estado nutricional,clasificacion d,2004-10-01,100,123,100,123,223
51402,TAHUA,estado nutricional,clasificacion d,2004-10-01,4,5,4,5,9
31101,TAPACARI,estado nutricional,clasificacion d,2004-10-01,125,100,125,100,225
10601,TARABUCO,estado nutricional,clasificacion d,2004-10-01,241,471,241,471,712
30401,TARATA,estado nutricional,clasificacion d,2004-10-01,31,44,31,44,75
60101,TARIJA,estado nutricional,clasificacion d,2004-10-01,181,236,181,236,417
10202,TARVITA,estado nutricional,clasificacion d,2004-10-01,78,96,78,96,174
20803,TIAWANACU,estado nutricional,clasificacion d,2004-10-01,42,40,42,40,82
50102,TINGUIPAYA,estado nutricional,clasificacion d,2004-10-01,134,216,134,216,350
20606,TIPUANI,estado nutricional,clasificacion d,2004-10-01,9,26,9,26,35
30903,TIQUIPAYA,estado nutricional,clasificacion d,2004-10-01,80,60,80,60,140
31601,TIRAQUE (CBBA),estado nutricional,clasificacion d,2004-10-01,159,88,159,88,247
21703,TITO YUPANQUI (PARQUIPUJIO),estado nutricional,clasificacion d,2004-10-01,2,1,2,1,3
30802,TOCO,estado nutricional,clasificacion d,2004-10-01,12,19,12,19,31
30803,TOLATA,estado nutricional,clasificacion d,2004-10-01,4,5,4,5,9
41001,TOLEDO,estado nutricional,clasificacion d,2004-10-01,5,11,5,11,16
51202,TOMAVE,estado nutricional,clasificacion d,2004-10-01,60,72,60,72,132
10402,TOMINA,estado nutricional,clasificacion d,2004-10-01,116,216,116,216,332
50502,TORO TORO,estado nutricional,clasificacion d,2004-10-01,83,104,83,104,187
31201,TOTORA(CBBA),estado nutricional,clasificacion d,2004-10-01,97,90,97,90,187
41301,TOTORA(ORR),estado nutricional,clasificacion d,2004-10-01,8,4,8,4,12
70802,TRIGAL,estado nutricional,clasificacion d,2004-10-01,3,2,3,2,5
80101,TRINIDAD,estado nutricional,clasificacion d,2004-10-01,143,119,143,119,262
50801,TUPIZA,estado nutricional,clasificacion d,2004-10-01,138,191,138,191,329
21302,UMALA,estado nutricional,clasificacion d,2004-10-01,34,38,34,38,72
50201,UNCIA,estado nutricional,clasificacion d,2004-10-01,61,66,61,66,127
60401,URIONDO (A. CONCEPCION),estado nutricional,clasificacion d,2004-10-01,16,54,16,54,70
71502,URUBICHA,estado nutricional,clasificacion d,2004-10-01,67,189,67,189,256
51201,UYUNI,estado nutricional,clasificacion d,2004-10-01,59,83,59,83,142
30502,VACAS,estado nutricional,clasificacion d,2004-10-01,60,53,60,53,113
70801,VALLEGRANDE,estado nutricional,clasificacion d,2004-10-01,30,32,30,32,62
20801,VIACHA,estado nutricional,clasificacion d,2004-10-01,122,98,122,98,220
31302,VILA VILA,estado nutricional,clasificacion d,2004-10-01,17,15,17,15,32
60303,VILLA MONTES,estado nutricional,clasificacion d,2004-10-01,45,52,45,52,97
90502,VILLA NUEVA (LOMA ALTA),estado nutricional,clasificacion d,2004-10-01,2,2,2,2,4
31402,VILLA RIVERO,estado nutricional,clasificacion d,2004-10-01,23,20,23,20,43
10801,VILLA SERRANO,estado nutricional,clasificacion d,2004-10-01,86,228,86,228,314
31003,VILLA TUNARI,estado nutricional,clasificacion d,2004-10-01,194,197,194,197,391
11001,VILLA VACA GUZMAN (MUYUPAMPA),estado nutricional,clasificacion d,2004-10-01,63,110,63,110,173
51501,VILLAZON,estado nutricional,clasificacion d,2004-10-01,95,141,95,141,236
30904,VINTO,estado nutricional,clasificacion d,2004-10-01,44,28,44,28,72
50602,VITICHI,estado nutricional,clasificacion d,2004-10-01,40,44,40,44,84
20306,WALDO BALLIVIAN,estado nutricional,clasificacion d,2004-10-01,3,3,3,3,6
70201,WARNES,estado nutricional,clasificacion d,2004-10-01,49,28,49,28,77
20903,YACO,estado nutricional,clasificacion d,2004-10-01,28,35,28,35,63
60301,YACUIBA,estado nutricional,clasificacion d,2004-10-01,118,113,118,113,231
10602,YAMPARAEZ,estado nutricional,clasificacion d,2004-10-01,118,259,118,259,377
21103,YANACACHI,estado nutricional,clasificacion d,2004-10-01,11,8,11,8,19
70403,YAPACANI,estado nutricional,clasificacion d,2004-10-01,116,116,116,116,232
50103,YOCALLA,estado nutricional,clasificacion d,2004-10-01,23,23,23,23,46
10102,YOTALA,estado nutricional,clasificacion d,2004-10-01,81,165,81,165,246
60402,YUNCHARA,estado nutricional,clasificacion d,2004-10-01,36,67,36,67,103
10301,ZUDAÃ‘EZ,estado nutricional,clasificacion d,2004-10-01,42,106,42,106,148
51302,ACACIO,estado nutricional,clasificacion d,2004-11-01,43,116,43,116,159
20201,ACHACACHI,estado nutricional,clasificacion d,2004-11-01,90,127,90,127,217
20104,ACHOCALLA,estado nutricional,clasificacion d,2004-11-01,21,20,21,20,41
30201,AIQUILE,estado nutricional,clasificacion d,2004-11-01,34,51,34,51,85
31303,ALALAY,estado nutricional,clasificacion d,2004-11-01,1,1,1,1,2
10404,ALCALA,estado nutricional,clasificacion d,2004-11-01,28,77,28,77,105
20202,ANCORAIMES,estado nutricional,clasificacion d,2004-11-01,73,84,73,84,157
41201,ANDAMARCA,estado nutricional,clasificacion d,2004-11-01,1,2,1,2,3
40603,ANTEQUERA,estado nutricional,clasificacion d,2004-11-01,12,26,12,26,38
30402,ANZALDO,estado nutricional,clasificacion d,2004-11-01,7,41,7,41,48
20701,APOLO,estado nutricional,clasificacion d,2004-11-01,43,53,43,53,96
51301,ARAMPAMPA,estado nutricional,clasificacion d,2004-11-01,61,125,61,125,186
30501,ARANI,estado nutricional,clasificacion d,2004-11-01,22,31,22,31,53
30403,ARBIETO,estado nutricional,clasificacion d,2004-11-01,22,20,22,20,42
30601,ARQUE,estado nutricional,clasificacion d,2004-11-01,49,50,49,50,99
71501,ASCENCION DE GUARAYOS,estado nutricional,clasificacion d,2004-11-01,2,4,2,4,6
50802,ATOCHA,estado nutricional,clasificacion d,2004-11-01,73,76,73,76,149
20503,AUCAPATA,estado nutricional,clasificacion d,2004-11-01,11,16,11,16,27
20502,AYATA,estado nutricional,clasificacion d,2004-11-01,48,64,48,64,112
21303,AYO AYO,estado nutricional,clasificacion d,2004-11-01,24,14,24,14,38
30301,AYOPAYA (V. DE INDEPENDENCIA),estado nutricional,clasificacion d,2004-11-01,80,108,80,108,188
10201,AZURDUY,estado nutricional,clasificacion d,2004-11-01,93,206,93,206,299
21203,BATALLAS,estado nutricional,clasificacion d,2004-11-01,38,61,38,61,99
80802,BAURES,estado nutricional,clasificacion d,2004-11-01,6,10,6,10,16
41202,BELEN DE ANDAMARCA,estado nutricional,clasificacion d,2004-11-01,1,4,1,4,5
50104,BELEN DE URMIRI,estado nutricional,clasificacion d,2004-11-01,8,14,8,14,22
90104,BELLA FLOR,estado nutricional,clasificacion d,2004-11-01,5,15,5,15,20
60202,BERMEJO,estado nutricional,clasificacion d,2004-11-01,35,19,35,19,54
50301,BETANZOS,estado nutricional,clasificacion d,2004-11-01,215,363,215,363,578
31501,BOLIVAR,estado nutricional,clasificacion d,2004-11-01,65,90,65,90,155
90103,BOLPEBRA,estado nutricional,clasificacion d,2004-11-01,10,6,10,6,16
70707,BOYUIBE,estado nutricional,clasificacion d,2004-11-01,20,20,20,20,40
70401,BUENA VISTA,estado nutricional,clasificacion d,2004-11-01,33,40,33,40,73
70703,CABEZAS,estado nutricional,clasificacion d,2004-11-01,41,30,41,30,71
20905,CAIROMA,estado nutricional,clasificacion d,2004-11-01,77,65,77,65,142
51102,"CAIZA ""D""",estado nutricional,clasificacion d,2004-11-01,42,77,42,77,119
21003,CAJUATA,estado nutricional,clasificacion d,2004-11-01,20,20,20,20,40
20303,CALACOTO,estado nutricional,clasificacion d,2004-11-01,17,25,17,25,42
21304,CALAMARCA,estado nutricional,clasificacion d,2004-11-01,36,37,36,37,73
10701,CAMARGO,estado nutricional,clasificacion d,2004-11-01,112,135,112,135,247
10901,CAMATAQUI (C. VILLA ABECIA),estado nutricional,clasificacion d,2004-11-01,27,43,27,43,70
70706,CAMIRI,estado nutricional,clasificacion d,2004-11-01,66,86,66,86,152
30701,CAPINOTA,estado nutricional,clasificacion d,2004-11-01,72,47,72,47,119
20302,CAQUIAVIRI,estado nutricional,clasificacion d,2004-11-01,31,38,31,38,69
40102,CARACOLLO,estado nutricional,clasificacion d,2004-11-01,32,40,32,40,72
22001,CARANAVI,estado nutricional,clasificacion d,2004-11-01,128,143,128,143,271
41503,CARANGAS,estado nutricional,clasificacion d,2004-11-01,0,1,0,1,1
60302,CARAPARI,estado nutricional,clasificacion d,2004-11-01,12,17,12,17,29
50702,CARIPUYO,estado nutricional,clasificacion d,2004-11-01,110,168,110,168,278
21902,CATACORA,estado nutricional,clasificacion d,2004-11-01,6,8,6,8,14
21803,CHACARILLA,estado nutricional,clasificacion d,2004-11-01,4,10,4,10,14
40201,CHALLAPATA,estado nutricional,clasificacion d,2004-11-01,67,58,67,58,125
50302,CHAQUI,estado nutricional,clasificacion d,2004-11-01,37,75,37,75,112
70702,CHARAGUA,estado nutricional,clasificacion d,2004-11-01,85,79,85,79,164
20305,CHARAÃ‘A,estado nutricional,clasificacion d,2004-11-01,5,1,5,1,6
50202,CHAYANTA,estado nutricional,clasificacion d,2004-11-01,69,79,69,79,148
31204,CHIMORE,estado nutricional,clasificacion d,2004-11-01,15,44,15,44,59
40903,CHIPAYA,estado nutricional,clasificacion d,2004-11-01,6,6,6,6,12
40302,CHOQUE COTA,estado nutricional,clasificacion d,2004-11-01,6,7,6,7,13
21101,CHULUMANI (V. DE LA LIBERTAD),estado nutricional,clasificacion d,2004-11-01,11,11,11,11,22
20501,CHUMA,estado nutricional,clasificacion d,2004-11-01,41,26,41,26,67
30801,CLIZA,estado nutricional,clasificacion d,2004-11-01,62,39,62,39,101
90101,COBIJA,estado nutricional,clasificacion d,2004-11-01,157,107,157,107,264
30101,COCHABAMBA,estado nutricional,clasificacion d,2004-11-01,597,355,597,355,952
40902,COIPASA,estado nutricional,clasificacion d,2004-11-01,2,2,2,2,4
30905,COLCAPIRHUA,estado nutricional,clasificacion d,2004-11-01,38,30,38,30,68
50901,"COLCHA ""K""",estado nutricional,clasificacion d,2004-11-01,53,83,53,83,136
21307,COLLANA,estado nutricional,clasificacion d,2004-11-01,2,8,2,8,10
31002,COLOMI,estado nutricional,clasificacion d,2004-11-01,57,67,57,67,124
50401,COLQUECHACA,estado nutricional,clasificacion d,2004-11-01,199,159,199,159,358
21306,COLQUENCHA,estado nutricional,clasificacion d,2004-11-01,59,30,59,30,89
21004,COLQUIRI,estado nutricional,clasificacion d,2004-11-01,53,48,53,48,101
20304,COMANCHE,estado nutricional,clasificacion d,2004-11-01,9,5,9,5,14
71301,COMARAPA,estado nutricional,clasificacion d,2004-11-01,48,46,48,46,94
20605,COMBAYA,estado nutricional,clasificacion d,2004-11-01,14,13,14,13,27
71101,CONCEPCION,estado nutricional,clasificacion d,2004-11-01,21,1,21,1,22
21701,COPACABANA,estado nutricional,clasificacion d,2004-11-01,24,14,24,14,38
21402,CORIPATA,estado nutricional,clasificacion d,2004-11-01,21,7,21,7,28
20301,CORO CORO,estado nutricional,clasificacion d,2004-11-01,42,60,42,60,102
21401,COROICO,estado nutricional,clasificacion d,2004-11-01,20,5,20,5,25
40301,CORQUE,estado nutricional,clasificacion d,2004-11-01,20,5,20,5,25
50601,COTAGAITA,estado nutricional,clasificacion d,2004-11-01,154,240,154,240,394
70102,COTOCA,estado nutricional,clasificacion d,2004-11-01,75,34,75,34,109
31405,CUCHUMUELA (V. G. VILLARROEL),estado nutricional,clasificacion d,2004-11-01,6,7,6,7,13
70704,CUEVO,estado nutricional,clasificacion d,2004-11-01,6,11,6,11,17
10902,CULPINA,estado nutricional,clasificacion d,2004-11-01,162,250,162,250,412
40401,CURAHUARA DE CARANGAS,estado nutricional,clasificacion d,2004-11-01,17,15,17,15,32
21602,CURVA,estado nutricional,clasificacion d,2004-11-01,21,12,21,12,33
20804,DESAGUADERO,estado nutricional,clasificacion d,2004-11-01,11,12,11,12,23
20105,EL ALTO,estado nutricional,clasificacion d,2004-11-01,2192,1522,2192,1522,3714
40103,EL CHORO,estado nutricional,clasificacion d,2004-11-01,4,4,4,4,8
71503,EL PUENTE(STC),estado nutricional,clasificacion d,2004-11-01,23,26,23,26,49
60502,EL PUENTE(TJA),estado nutricional,clasificacion d,2004-11-01,17,43,17,43,60
70105,EL TORNO,estado nutricional,clasificacion d,2004-11-01,67,104,67,104,171
10405,EL VILLAR,estado nutricional,clasificacion d,2004-11-01,24,86,24,86,110
60601,ENTRE RIOS,estado nutricional,clasificacion d,2004-11-01,46,57,46,57,103
41101,EUCALIPTUS,estado nutricional,clasificacion d,2004-11-01,6,16,6,16,22
90503,EUREKA (SANTOS MERCADO),estado nutricional,clasificacion d,2004-11-01,4,0,4,0,4
80402,EXALTACION,estado nutricional,clasificacion d,2004-11-01,5,10,5,10,15
90203,FILADELFIA,estado nutricional,clasificacion d,2004-11-01,3,6,3,6,9
71002,GENERAL SAAVEDRA,estado nutricional,clasificacion d,2004-11-01,72,94,72,94,166
21601,GRAL. J.J. PEREZ (CHARAZANI),estado nutricional,clasificacion d,2004-11-01,16,39,16,39,55
20602,GUANAY,estado nutricional,clasificacion d,2004-11-01,87,98,87,98,185
20802,GUAQUI,estado nutricional,clasificacion d,2004-11-01,15,16,15,16,31
80202,GUAYARAMERIN,estado nutricional,clasificacion d,2004-11-01,106,127,106,127,233
70705,GUTIERREZ,estado nutricional,clasificacion d,2004-11-01,98,161,98,161,259
10502,HUACARETA,estado nutricional,clasificacion d,2004-11-01,51,89,51,89,140
11002,HUACAYA (VILLA DE HUACAYA),estado nutricional,clasificacion d,2004-11-01,16,34,16,34,50
40501,HUACHACALLA,estado nutricional,clasificacion d,2004-11-01,0,1,0,1,1
40701,HUANUNI,estado nutricional,clasificacion d,2004-11-01,87,57,87,57,144
80803,HUARACAJE,estado nutricional,clasificacion d,2004-11-01,7,7,7,7,14
41601,HUAYLLAMARCA,estado nutricional,clasificacion d,2004-11-01,10,7,10,7,17
21005,ICHOCA,estado nutricional,clasificacion d,2004-11-01,33,29,33,29,62
10304,ICLA,estado nutricional,clasificacion d,2004-11-01,109,191,109,191,300
10703,INCAHUASI,estado nutricional,clasificacion d,2004-11-01,222,278,222,278,500
90402,INGAVI (HUMAITA),estado nutricional,clasificacion d,2004-11-01,1,7,1,7,8
21001,INQUISIVI,estado nutricional,clasificacion d,2004-11-01,69,58,69,58,127
21102,IRUPANA (VILLA DE LANZA),estado nutricional,clasificacion d,2004-11-01,34,32,34,32,66
21501,IXIAMAS,estado nutricional,clasificacion d,2004-11-01,23,45,23,45,68
21105,LA ASUNTA,estado nutricional,clasificacion d,2004-11-01,52,40,52,40,92
70104,LA GUARDIA,estado nutricional,clasificacion d,2004-11-01,53,51,53,51,104
20101,LA PAZ,estado nutricional,clasificacion d,2004-11-01,1356,1209,1356,1209,2565
70701,LAGUNILLAS,estado nutricional,clasificacion d,2004-11-01,7,26,7,26,33
21202,LAJA,estado nutricional,clasificacion d,2004-11-01,18,5,18,5,23
10903,LAS CARRERAS,estado nutricional,clasificacion d,2004-11-01,15,38,15,38,53
21006,LICOMA PAMPA,estado nutricional,clasificacion d,2004-11-01,3,1,3,1,4
50203,LLALLAGUA,estado nutricional,clasificacion d,2004-11-01,123,162,123,162,285
51401,LLICA,estado nutricional,clasificacion d,2004-11-01,16,16,16,16,32
80601,LORETO,estado nutricional,clasificacion d,2004-11-01,7,8,7,8,15
20901,LURIBAY,estado nutricional,clasificacion d,2004-11-01,41,52,41,52,93
40702,MACHACAMARCA,estado nutricional,clasificacion d,2004-11-01,6,3,6,3,9
11003,MACHARETI,estado nutricional,clasificacion d,2004-11-01,37,95,37,95,132
80801,MAGDALENA,estado nutricional,clasificacion d,2004-11-01,39,23,39,23,62
70903,MAIRANA,estado nutricional,clasificacion d,2004-11-01,11,11,11,11,22
20904,MALLA,estado nutricional,clasificacion d,2004-11-01,3,0,3,0,3
20103,MECAPACA,estado nutricional,clasificacion d,2004-11-01,28,37,28,37,65
71003,MINEROS,estado nutricional,clasificacion d,2004-11-01,154,120,154,120,274
31301,MIZQUE,estado nutricional,clasificacion d,2004-11-01,56,35,56,35,91
20402,MOCOMOCO,estado nutricional,clasificacion d,2004-11-01,65,79,65,79,144
10303,MOJOCOYA,estado nutricional,clasificacion d,2004-11-01,42,82,42,82,124
10501,MONTEAGUDO,estado nutricional,clasificacion d,2004-11-01,115,211,115,211,326
71001,MONTERO,estado nutricional,clasificacion d,2004-11-01,247,229,247,229,476
70803,MORO MORO,estado nutricional,clasificacion d,2004-11-01,10,15,10,15,25
30302,MOROCHATA,estado nutricional,clasificacion d,2004-11-01,124,128,124,128,252
90401,NACEBE (SANTA ROSA DEL ABUNA),estado nutricional,clasificacion d,2004-11-01,2,3,2,3,5
20307,NAZACARA DE PACAJES,estado nutricional,clasificacion d,2004-11-01,0,1,0,1,1
90501,NUEVO MANOA (NUEVA ESPERANZA),estado nutricional,clasificacion d,2004-11-01,5,4,5,4,9
50404,OCURI,estado nutricional,clasificacion d,2004-11-01,86,161,86,161,247
70202,OKINAWA,estado nutricional,clasificacion d,2004-11-01,28,11,28,11,39
30203,OMEREQUE,estado nutricional,clasificacion d,2004-11-01,14,3,14,3,17
40101,ORURO,estado nutricional,clasificacion d,2004-11-01,585,412,585,412,997
60201,PADCAYA,estado nutricional,clasificacion d,2004-11-01,43,48,43,48,91
10401,PADILLA,estado nutricional,clasificacion d,2004-11-01,87,167,87,167,254
70502,PAILON,estado nutricional,clasificacion d,2004-11-01,24,13,24,13,37
20102,PALCA,estado nutricional,clasificacion d,2004-11-01,60,52,60,52,112
21104,PALOS BLANCOS,estado nutricional,clasificacion d,2004-11-01,105,126,105,126,231
40802,PAMPA AULLAGAS,estado nutricional,clasificacion d,2004-11-01,14,11,14,11,25
70902,PAMPA GRANDE,estado nutricional,clasificacion d,2004-11-01,14,13,14,13,27
21802,PAPEL PAMPA,estado nutricional,clasificacion d,2004-11-01,11,17,11,17,28
30202,PASORAPA,estado nutricional,clasificacion d,2004-11-01,17,13,17,13,30
21305,PATACAMAYA,estado nutricional,clasificacion d,2004-11-01,134,87,134,87,221
40602,PAZÃ‘A,estado nutricional,clasificacion d,2004-11-01,12,16,12,16,28
20702,PELECHUCO,estado nutricional,clasificacion d,2004-11-01,37,22,37,22,59
50403,POCOATA,estado nutricional,clasificacion d,2004-11-01,192,294,192,294,486
31203,POCONA,estado nutricional,clasificacion d,2004-11-01,20,37,20,37,57
31202,POJO (CBBA),estado nutricional,clasificacion d,2004-11-01,146,143,146,143,289
40601,POOPO,estado nutricional,clasificacion d,2004-11-01,7,5,7,5,12
51203,PORCO,estado nutricional,clasificacion d,2004-11-01,31,12,31,12,43
10103,POROMA,estado nutricional,clasificacion d,2004-11-01,129,245,129,245,374
70103,PORONGO,estado nutricional,clasificacion d,2004-11-01,10,3,10,3,13
70601,PORTACHUELO,estado nutricional,clasificacion d,2004-11-01,34,45,34,45,79
90102,PORVENIR,estado nutricional,clasificacion d,2004-11-01,10,14,10,14,24
70804,POSTRER VALLE,estado nutricional,clasificacion d,2004-11-01,2,4,2,4,6
50101,POTOSI,estado nutricional,clasificacion d,2004-11-01,547,371,547,371,918
10302,PRESTO,estado nutricional,clasificacion d,2004-11-01,86,137,86,137,223
70805,PUCARA,estado nutricional,clasificacion d,2004-11-01,1,2,1,2,3
21201,PUCARANI,estado nutricional,clasificacion d,2004-11-01,71,37,71,37,108
20401,PUERTO ACOSTA,estado nutricional,clasificacion d,2004-11-01,54,57,54,57,111
20403,PUERTO CARABUCO,estado nutricional,clasificacion d,2004-11-01,43,53,43,53,96
90301,PUERTO GONZALO MORENO,estado nutricional,clasificacion d,2004-11-01,15,21,15,21,36
21204,PUERTO PEREZ,estado nutricional,clasificacion d,2004-11-01,13,8,13,8,21
90201,PUERTO RICO,estado nutricional,clasificacion d,2004-11-01,6,7,6,7,13
31205,PUERTO VILLARROEL,estado nutricional,clasificacion d,2004-11-01,246,175,246,175,421
51101,PUNA,estado nutricional,clasificacion d,2004-11-01,192,283,192,283,475
31401,PUNATA,estado nutricional,clasificacion d,2004-11-01,56,36,56,36,92
20604,QUIABAYA,estado nutricional,clasificacion d,2004-11-01,6,13,6,13,19
30901,QUILLACOLLO,estado nutricional,clasificacion d,2004-11-01,90,64,90,64,154
21002,QUIME,estado nutricional,clasificacion d,2004-11-01,42,52,42,52,94
70904,QUIRUSILLAS,estado nutricional,clasificacion d,2004-11-01,1,5,1,5,6
50402,RAVELO,estado nutricional,clasificacion d,2004-11-01,190,294,190,294,484
80301,REYES,estado nutricional,clasificacion d,2004-11-01,32,48,32,48,80
80201,RIBERALTA,estado nutricional,clasificacion d,2004-11-01,303,295,303,295,598
70503,ROBORE,estado nutricional,clasificacion d,2004-11-01,24,21,24,21,45
80304,RURRENABAQUE,estado nutricional,clasificacion d,2004-11-01,33,26,33,26,59
40901,SABAYA,estado nutricional,clasificacion d,2004-11-01,2,5,2,5,7
31001,SACABA,estado nutricional,clasificacion d,2004-11-01,77,116,77,116,193
30404,SACABAMBA,estado nutricional,clasificacion d,2004-11-01,7,18,7,18,25
50701,SACACA,estado nutricional,clasificacion d,2004-11-01,373,618,373,618,991
71302,SAIPINA,estado nutricional,clasificacion d,2004-11-01,6,8,6,8,14
40801,SALINAS DE GARCI MENDOZA,estado nutricional,clasificacion d,2004-11-01,21,23,21,23,44
70901,SAMAIPATA,estado nutricional,clasificacion d,2004-11-01,23,21,23,21,44
51601,SAN AGUSTIN,estado nutricional,clasificacion d,2004-11-01,9,15,9,15,24
80602,SAN ANDRES,estado nutricional,clasificacion d,2004-11-01,43,27,43,27,70
51003,SAN ANTONIO DE ESMORUCO,estado nutricional,clasificacion d,2004-11-01,3,11,3,11,14
71105,SAN ANTONIO DE LOMERIO,estado nutricional,clasificacion d,2004-11-01,43,96,43,96,139
31403,SAN BENITO,estado nutricional,clasificacion d,2004-11-01,30,28,30,28,58
80302,SAN BORJA,estado nutricional,clasificacion d,2004-11-01,165,132,165,132,297
21502,SAN BUENA VENTURA,estado nutricional,clasificacion d,2004-11-01,23,19,23,19,42
70402,SAN CARLOS,estado nutricional,clasificacion d,2004-11-01,58,47,58,47,105
80501,SAN IGNACIO,estado nutricional,clasificacion d,2004-11-01,77,89,77,89,166
70301,SAN IGNACIO DE VELASCO,estado nutricional,clasificacion d,2004-11-01,293,270,293,270,563
80102,SAN JAVIER(BNI),estado nutricional,clasificacion d,2004-11-01,4,4,4,4,8
71102,SAN JAVIER(STC),estado nutricional,clasificacion d,2004-11-01,19,22,19,22,41
80701,SAN JOAQUIN,estado nutricional,clasificacion d,2004-11-01,8,15,8,15,23
70501,SAN JOSE DE CHIQUITOS,estado nutricional,clasificacion d,2004-11-01,32,8,32,8,40
71104,SAN JULIAN,estado nutricional,clasificacion d,2004-11-01,100,119,100,119,219
90302,SAN LORENZO(PND),estado nutricional,clasificacion d,2004-11-01,5,7,5,7,12
60501,SAN LORENZO(TJA),estado nutricional,clasificacion d,2004-11-01,63,99,63,99,162
10702,SAN LUCAS,estado nutricional,clasificacion d,2004-11-01,314,459,314,459,773
70302,SAN MIGUEL DE VELASCO,estado nutricional,clasificacion d,2004-11-01,42,78,42,78,120
51001,SAN PABLO DE LIPEZ,estado nutricional,clasificacion d,2004-11-01,6,10,6,10,16
50501,SAN PEDRO DE BUENA VISTA,estado nutricional,clasificacion d,2004-11-01,200,314,200,314,514
21801,SAN PEDRO DE CURAHUARA,estado nutricional,clasificacion d,2004-11-01,17,39,17,39,56
50902,SAN PEDRO DE QUEMES,estado nutricional,clasificacion d,2004-11-01,0,4,0,4,4
21702,SAN PEDRO DE TIQUINA,estado nutricional,clasificacion d,2004-11-01,15,12,15,12,27
90202,SAN PEDRO(PND),estado nutricional,clasificacion d,2004-11-01,14,5,14,5,19
70303,SAN RAFAEL,estado nutricional,clasificacion d,2004-11-01,19,38,19,38,57
80702,SAN RAMON,estado nutricional,clasificacion d,2004-11-01,23,11,23,11,34
80702,SAN RAMON,estado nutricional,clasificacion d,2004-11-01,10,7,10,7,17
80401,SANTA ANA,estado nutricional,clasificacion d,2004-11-01,40,35,40,35,75
70101,SANTA CRUZ DE LA SIERRA,estado nutricional,clasificacion d,2004-11-01,965,428,965,428,1393
80303,SANTA ROSA,estado nutricional,clasificacion d,2004-11-01,24,13,24,13,37
70602,SANTA ROSA DEL SARA,estado nutricional,clasificacion d,2004-11-01,39,42,39,42,81
20308,SANTIAGO DE CALLAPA,estado nutricional,clasificacion d,2004-11-01,29,33,29,33,62
41401,SANTIAGO DE HUARI,estado nutricional,clasificacion d,2004-11-01,15,27,15,27,42
21901,SANTIAGO DE MACHACA,estado nutricional,clasificacion d,2004-11-01,16,7,16,7,23
30702,SANTIVAÃ‘ES,estado nutricional,clasificacion d,2004-11-01,25,37,25,37,62
40202,SANTUARIO DE QUILLACAS,estado nutricional,clasificacion d,2004-11-01,14,17,14,17,31
20902,SAPAHAQUI,estado nutricional,clasificacion d,2004-11-01,38,35,38,35,73
90303,SENA,estado nutricional,clasificacion d,2004-11-01,22,12,22,12,34
21301,SICA SICA (VILLA AROMA),estado nutricional,clasificacion d,2004-11-01,117,82,117,82,199
30703,SICAYA,estado nutricional,clasificacion d,2004-11-01,16,12,16,12,28
30902,SIPE SIPE,estado nutricional,clasificacion d,2004-11-01,146,104,146,104,250
10403,SOPACHUY,estado nutricional,clasificacion d,2004-11-01,61,140,61,140,201
20601,SORATA,estado nutricional,clasificacion d,2004-11-01,74,116,74,116,190
10101,SUCRE,estado nutricional,clasificacion d,2004-11-01,421,549,421,549,970
31404,TACACHI,estado nutricional,clasificacion d,2004-11-01,7,10,7,10,17
20603,TACACOMA,estado nutricional,clasificacion d,2004-11-01,9,30,9,30,39
50303,TACOBAMBA,estado nutricional,clasificacion d,2004-11-01,56,77,56,77,133
30602,TACOPAYA,estado nutricional,clasificacion d,2004-11-01,74,76,74,76,150
51402,TAHUA,estado nutricional,clasificacion d,2004-11-01,3,5,3,5,8
31101,TAPACARI,estado nutricional,clasificacion d,2004-11-01,156,155,156,155,311
10601,TARABUCO,estado nutricional,clasificacion d,2004-11-01,256,485,256,485,741
30401,TARATA,estado nutricional,clasificacion d,2004-11-01,42,23,42,23,65
60101,TARIJA,estado nutricional,clasificacion d,2004-11-01,282,266,282,266,548
10202,TARVITA,estado nutricional,clasificacion d,2004-11-01,169,381,169,381,550
20803,TIAWANACU,estado nutricional,clasificacion d,2004-11-01,37,43,37,43,80
50102,TINGUIPAYA,estado nutricional,clasificacion d,2004-11-01,141,246,141,246,387
20606,TIPUANI,estado nutricional,clasificacion d,2004-11-01,14,13,14,13,27
30903,TIQUIPAYA,estado nutricional,clasificacion d,2004-11-01,59,41,59,41,100
31601,TIRAQUE (CBBA),estado nutricional,clasificacion d,2004-11-01,139,138,139,138,277
21703,TITO YUPANQUI (PARQUIPUJIO),estado nutricional,clasificacion d,2004-11-01,4,3,4,3,7
30802,TOCO,estado nutricional,clasificacion d,2004-11-01,7,15,7,15,22
30803,TOLATA,estado nutricional,clasificacion d,2004-11-01,1,0,1,0,1
41001,TOLEDO,estado nutricional,clasificacion d,2004-11-01,12,7,12,7,19
51202,TOMAVE,estado nutricional,clasificacion d,2004-11-01,44,54,44,54,98
10402,TOMINA,estado nutricional,clasificacion d,2004-11-01,92,234,92,234,326
50502,TORO TORO,estado nutricional,clasificacion d,2004-11-01,106,131,106,131,237
31201,TOTORA(CBBA),estado nutricional,clasificacion d,2004-11-01,60,49,60,49,109
41301,TOTORA(ORR),estado nutricional,clasificacion d,2004-11-01,20,34,20,34,54
70802,TRIGAL,estado nutricional,clasificacion d,2004-11-01,3,4,3,4,7
80101,TRINIDAD,estado nutricional,clasificacion d,2004-11-01,176,172,176,172,348
50801,TUPIZA,estado nutricional,clasificacion d,2004-11-01,111,153,111,153,264
21302,UMALA,estado nutricional,clasificacion d,2004-11-01,22,18,22,18,40
50201,UNCIA,estado nutricional,clasificacion d,2004-11-01,61,48,61,48,109
60401,URIONDO (A. CONCEPCION),estado nutricional,clasificacion d,2004-11-01,43,93,43,93,136
71502,URUBICHA,estado nutricional,clasificacion d,2004-11-01,10,27,10,27,37
51201,UYUNI,estado nutricional,clasificacion d,2004-11-01,49,99,49,99,148
30502,VACAS,estado nutricional,clasificacion d,2004-11-01,43,20,43,20,63
70801,VALLEGRANDE,estado nutricional,clasificacion d,2004-11-01,38,59,38,59,97
20801,VIACHA,estado nutricional,clasificacion d,2004-11-01,138,117,138,117,255
31302,VILA VILA,estado nutricional,clasificacion d,2004-11-01,24,29,24,29,53
60303,VILLA MONTES,estado nutricional,clasificacion d,2004-11-01,44,40,44,40,84
90502,VILLA NUEVA (LOMA ALTA),estado nutricional,clasificacion d,2004-11-01,6,1,6,1,7
31402,VILLA RIVERO,estado nutricional,clasificacion d,2004-11-01,24,18,24,18,42
10801,VILLA SERRANO,estado nutricional,clasificacion d,2004-11-01,120,254,120,254,374
31003,VILLA TUNARI,estado nutricional,clasificacion d,2004-11-01,171,185,171,185,356
11001,VILLA VACA GUZMAN (MUYUPAMPA),estado nutricional,clasificacion d,2004-11-01,56,120,56,120,176
51501,VILLAZON,estado nutricional,clasificacion d,2004-11-01,124,154,124,154,278
30904,VINTO,estado nutricional,clasificacion d,2004-11-01,64,29,64,29,93
50602,VITICHI,estado nutricional,clasificacion d,2004-11-01,87,196,87,196,283
20306,WALDO BALLIVIAN,estado nutricional,clasificacion d,2004-11-01,9,17,9,17,26
70201,WARNES,estado nutricional,clasificacion d,2004-11-01,53,48,53,48,101
20903,YACO,estado nutricional,clasificacion d,2004-11-01,36,27,36,27,63
60301,YACUIBA,estado nutricional,clasificacion d,2004-11-01,66,40,66,40,106
10602,YAMPARAEZ,estado nutricional,clasificacion d,2004-11-01,109,271,109,271,380
21103,YANACACHI,estado nutricional,clasificacion d,2004-11-01,3,2,3,2,5
70403,YAPACANI,estado nutricional,clasificacion d,2004-11-01,118,117,118,117,235
50103,YOCALLA,estado nutricional,clasificacion d,2004-11-01,21,39,21,39,60
10102,YOTALA,estado nutricional,clasificacion d,2004-11-01,66,151,66,151,217
60402,YUNCHARA,estado nutricional,clasificacion d,2004-11-01,32,91,32,91,123
10301,ZUDAÃ‘EZ,estado nutricional,clasificacion d,2004-11-01,77,135,77,135,212
51302,ACACIO,estado nutricional,clasificacion d,2004-12-01,42,67,42,67,109
20201,ACHACACHI,estado nutricional,clasificacion d,2004-12-01,55,64,55,64,119
20104,ACHOCALLA,estado nutricional,clasificacion d,2004-12-01,6,26,6,26,32
30201,AIQUILE,estado nutricional,clasificacion d,2004-12-01,39,44,39,44,83
10404,ALCALA,estado nutricional,clasificacion d,2004-12-01,28,70,28,70,98
20202,ANCORAIMES,estado nutricional,clasificacion d,2004-12-01,43,62,43,62,105
41201,ANDAMARCA,estado nutricional,clasificacion d,2004-12-01,9,17,9,17,26
40603,ANTEQUERA,estado nutricional,clasificacion d,2004-12-01,5,1,5,1,6
30402,ANZALDO,estado nutricional,clasificacion d,2004-12-01,5,14,5,14,19
20701,APOLO,estado nutricional,clasificacion d,2004-12-01,26,36,26,36,62
51301,ARAMPAMPA,estado nutricional,clasificacion d,2004-12-01,37,81,37,81,118
30501,ARANI,estado nutricional,clasificacion d,2004-12-01,23,24,23,24,47
30403,ARBIETO,estado nutricional,clasificacion d,2004-12-01,12,14,12,14,26
30601,ARQUE,estado nutricional,clasificacion d,2004-12-01,49,44,49,44,93
50802,ATOCHA,estado nutricional,clasificacion d,2004-12-01,61,79,61,79,140
20503,AUCAPATA,estado nutricional,clasificacion d,2004-12-01,6,15,6,15,21
20502,AYATA,estado nutricional,clasificacion d,2004-12-01,17,17,17,17,34
21303,AYO AYO,estado nutricional,clasificacion d,2004-12-01,15,8,15,8,23
30301,AYOPAYA (V. DE INDEPENDENCIA),estado nutricional,clasificacion d,2004-12-01,98,115,98,115,213
10201,AZURDUY,estado nutricional,clasificacion d,2004-12-01,36,65,36,65,101
21203,BATALLAS,estado nutricional,clasificacion d,2004-12-01,33,33,33,33,66
80802,BAURES,estado nutricional,clasificacion d,2004-12-01,19,14,19,14,33
50104,BELEN DE URMIRI,estado nutricional,clasificacion d,2004-12-01,7,35,7,35,42
90104,BELLA FLOR,estado nutricional,clasificacion d,2004-12-01,3,2,3,2,5
60202,BERMEJO,estado nutricional,clasificacion d,2004-12-01,11,11,11,11,22
50301,BETANZOS,estado nutricional,clasificacion d,2004-12-01,143,250,143,250,393
31501,BOLIVAR,estado nutricional,clasificacion d,2004-12-01,40,72,40,72,112
90103,BOLPEBRA,estado nutricional,clasificacion d,2004-12-01,4,16,4,16,20
70707,BOYUIBE,estado nutricional,clasificacion d,2004-12-01,8,11,8,11,19
70401,BUENA VISTA,estado nutricional,clasificacion d,2004-12-01,40,77,40,77,117
70703,CABEZAS,estado nutricional,clasificacion d,2004-12-01,36,41,36,41,77
20905,CAIROMA,estado nutricional,clasificacion d,2004-12-01,61,55,61,55,116
51102,"CAIZA ""D""",estado nutricional,clasificacion d,2004-12-01,52,61,52,61,113
21003,CAJUATA,estado nutricional,clasificacion d,2004-12-01,23,16,23,16,39
20303,CALACOTO,estado nutricional,clasificacion d,2004-12-01,11,16,11,16,27
21304,CALAMARCA,estado nutricional,clasificacion d,2004-12-01,173,193,173,193,366
10701,CAMARGO,estado nutricional,clasificacion d,2004-12-01,94,127,94,127,221
10901,CAMATAQUI (C. VILLA ABECIA),estado nutricional,clasificacion d,2004-12-01,12,33,12,33,45
70706,CAMIRI,estado nutricional,clasificacion d,2004-12-01,133,154,133,154,287
30701,CAPINOTA,estado nutricional,clasificacion d,2004-12-01,32,42,32,42,74
20302,CAQUIAVIRI,estado nutricional,clasificacion d,2004-12-01,18,14,18,14,32
40102,CARACOLLO,estado nutricional,clasificacion d,2004-12-01,50,59,50,59,109
22001,CARANAVI,estado nutricional,clasificacion d,2004-12-01,155,145,155,145,300
60302,CARAPARI,estado nutricional,clasificacion d,2004-12-01,15,42,15,42,57
50702,CARIPUYO,estado nutricional,clasificacion d,2004-12-01,48,72,48,72,120
21803,CHACARILLA,estado nutricional,clasificacion d,2004-12-01,1,4,1,4,5
40201,CHALLAPATA,estado nutricional,clasificacion d,2004-12-01,64,99,64,99,163
50302,CHAQUI,estado nutricional,clasificacion d,2004-12-01,32,68,32,68,100
20305,CHARAÃ‘A,estado nutricional,clasificacion d,2004-12-01,5,10,5,10,15
50202,CHAYANTA,estado nutricional,clasificacion d,2004-12-01,78,80,78,80,158
31204,CHIMORE,estado nutricional,clasificacion d,2004-12-01,7,5,7,5,12
40903,CHIPAYA,estado nutricional,clasificacion d,2004-12-01,4,3,4,3,7
21101,CHULUMANI (V. DE LA LIBERTAD),estado nutricional,clasificacion d,2004-12-01,5,6,5,6,11
20501,CHUMA,estado nutricional,clasificacion d,2004-12-01,36,23,36,23,59
30801,CLIZA,estado nutricional,clasificacion d,2004-12-01,54,37,54,37,91
90101,COBIJA,estado nutricional,clasificacion d,2004-12-01,36,64,36,64,100
30101,COCHABAMBA,estado nutricional,clasificacion d,2004-12-01,508,317,508,317,825
40902,COIPASA,estado nutricional,clasificacion d,2004-12-01,2,0,2,0,2
30905,COLCAPIRHUA,estado nutricional,clasificacion d,2004-12-01,46,36,46,36,82
50901,"COLCHA ""K""",estado nutricional,clasificacion d,2004-12-01,38,42,38,42,80
21307,COLLANA,estado nutricional,clasificacion d,2004-12-01,4,3,4,3,7
31002,COLOMI,estado nutricional,clasificacion d,2004-12-01,83,49,83,49,132
50401,COLQUECHACA,estado nutricional,clasificacion d,2004-12-01,107,95,107,95,202
21306,COLQUENCHA,estado nutricional,clasificacion d,2004-12-01,42,26,42,26,68
21004,COLQUIRI,estado nutricional,clasificacion d,2004-12-01,94,131,94,131,225
20304,COMANCHE,estado nutricional,clasificacion d,2004-12-01,18,13,18,13,31
71301,COMARAPA,estado nutricional,clasificacion d,2004-12-01,69,58,69,58,127
20605,COMBAYA,estado nutricional,clasificacion d,2004-12-01,6,6,6,6,12
71101,CONCEPCION,estado nutricional,clasificacion d,2004-12-01,16,2,16,2,18
21701,COPACABANA,estado nutricional,clasificacion d,2004-12-01,20,17,20,17,37
21402,CORIPATA,estado nutricional,clasificacion d,2004-12-01,5,3,5,3,8
20301,CORO CORO,estado nutricional,clasificacion d,2004-12-01,43,39,43,39,82
21401,COROICO,estado nutricional,clasificacion d,2004-12-01,27,12,27,12,39
40301,CORQUE,estado nutricional,clasificacion d,2004-12-01,30,44,30,44,74
50601,COTAGAITA,estado nutricional,clasificacion d,2004-12-01,76,92,76,92,168
70102,COTOCA,estado nutricional,clasificacion d,2004-12-01,62,73,62,73,135
31405,CUCHUMUELA (V. G. VILLARROEL),estado nutricional,clasificacion d,2004-12-01,8,5,8,5,13
70704,CUEVO,estado nutricional,clasificacion d,2004-12-01,2,3,2,3,5
10902,CULPINA,estado nutricional,clasificacion d,2004-12-01,178,230,178,230,408
40401,CURAHUARA DE CARANGAS,estado nutricional,clasificacion d,2004-12-01,21,37,21,37,58
21602,CURVA,estado nutricional,clasificacion d,2004-12-01,20,19,20,19,39
20804,DESAGUADERO,estado nutricional,clasificacion d,2004-12-01,12,18,12,18,30
20105,EL ALTO,estado nutricional,clasificacion d,2004-12-01,2380,1581,2380,1581,3961
40103,EL CHORO,estado nutricional,clasificacion d,2004-12-01,4,2,4,2,6
60502,EL PUENTE(TJA),estado nutricional,clasificacion d,2004-12-01,74,107,74,107,181
70105,EL TORNO,estado nutricional,clasificacion d,2004-12-01,81,71,81,71,152
10405,EL VILLAR,estado nutricional,clasificacion d,2004-12-01,28,84,28,84,112
60601,ENTRE RIOS,estado nutricional,clasificacion d,2004-12-01,35,34,35,34,69
41101,EUCALIPTUS,estado nutricional,clasificacion d,2004-12-01,6,14,6,14,20
90503,EUREKA (SANTOS MERCADO),estado nutricional,clasificacion d,2004-12-01,3,0,3,0,3
80402,EXALTACION,estado nutricional,clasificacion d,2004-12-01,12,22,12,22,34
90203,FILADELFIA,estado nutricional,clasificacion d,2004-12-01,7,3,7,3,10
71002,GENERAL SAAVEDRA,estado nutricional,clasificacion d,2004-12-01,88,102,88,102,190
21601,GRAL. J.J. PEREZ (CHARAZANI),estado nutricional,clasificacion d,2004-12-01,22,35,22,35,57
20602,GUANAY,estado nutricional,clasificacion d,2004-12-01,85,75,85,75,160
20802,GUAQUI,estado nutricional,clasificacion d,2004-12-01,15,9,15,9,24
80202,GUAYARAMERIN,estado nutricional,clasificacion d,2004-12-01,103,128,103,128,231
70705,GUTIERREZ,estado nutricional,clasificacion d,2004-12-01,119,166,119,166,285
10502,HUACARETA,estado nutricional,clasificacion d,2004-12-01,70,96,70,96,166
11002,HUACAYA (VILLA DE HUACAYA),estado nutricional,clasificacion d,2004-12-01,19,30,19,30,49
40501,HUACHACALLA,estado nutricional,clasificacion d,2004-12-01,5,1,5,1,6
40701,HUANUNI,estado nutricional,clasificacion d,2004-12-01,80,33,80,33,113
80803,HUARACAJE,estado nutricional,clasificacion d,2004-12-01,11,9,11,9,20
41601,HUAYLLAMARCA,estado nutricional,clasificacion d,2004-12-01,2,3,2,3,5
21005,ICHOCA,estado nutricional,clasificacion d,2004-12-01,28,35,28,35,63
10304,ICLA,estado nutricional,clasificacion d,2004-12-01,104,197,104,197,301
10703,INCAHUASI,estado nutricional,clasificacion d,2004-12-01,172,175,172,175,347
90402,INGAVI (HUMAITA),estado nutricional,clasificacion d,2004-12-01,0,1,0,1,1
21001,INQUISIVI,estado nutricional,clasificacion d,2004-12-01,73,90,73,90,163
21102,IRUPANA (VILLA DE LANZA),estado nutricional,clasificacion d,2004-12-01,34,32,34,32,66
21501,IXIAMAS,estado nutricional,clasificacion d,2004-12-01,15,11,15,11,26
21105,LA ASUNTA,estado nutricional,clasificacion d,2004-12-01,44,34,44,34,78
70104,LA GUARDIA,estado nutricional,clasificacion d,2004-12-01,110,75,110,75,185
20101,LA PAZ,estado nutricional,clasificacion d,2004-12-01,1227,1043,1227,1043,2270
41501,LA RIVERA,estado nutricional,clasificacion d,2004-12-01,0,1,0,1,1
70701,LAGUNILLAS,estado nutricional,clasificacion d,2004-12-01,26,34,26,34,60
21202,LAJA,estado nutricional,clasificacion d,2004-12-01,45,27,45,27,72
10903,LAS CARRERAS,estado nutricional,clasificacion d,2004-12-01,17,46,17,46,63
21006,LICOMA PAMPA,estado nutricional,clasificacion d,2004-12-01,14,13,14,13,27
50203,LLALLAGUA,estado nutricional,clasificacion d,2004-12-01,100,155,100,155,255
51401,LLICA,estado nutricional,clasificacion d,2004-12-01,11,17,11,17,28
80601,LORETO,estado nutricional,clasificacion d,2004-12-01,12,19,12,19,31
20901,LURIBAY,estado nutricional,clasificacion d,2004-12-01,35,52,35,52,87
40702,MACHACAMARCA,estado nutricional,clasificacion d,2004-12-01,14,11,14,11,25
11003,MACHARETI,estado nutricional,clasificacion d,2004-12-01,42,78,42,78,120
80801,MAGDALENA,estado nutricional,clasificacion d,2004-12-01,29,23,29,23,52
70903,MAIRANA,estado nutricional,clasificacion d,2004-12-01,19,13,19,13,32
20904,MALLA,estado nutricional,clasificacion d,2004-12-01,20,43,20,43,63
20103,MECAPACA,estado nutricional,clasificacion d,2004-12-01,26,17,26,17,43
71003,MINEROS,estado nutricional,clasificacion d,2004-12-01,142,126,142,126,268
31301,MIZQUE,estado nutricional,clasificacion d,2004-12-01,3,4,3,4,7
20402,MOCOMOCO,estado nutricional,clasificacion d,2004-12-01,30,29,30,29,59
51002,MOJINETE,estado nutricional,clasificacion d,2004-12-01,13,15,13,15,28
10303,MOJOCOYA,estado nutricional,clasificacion d,2004-12-01,42,89,42,89,131
10501,MONTEAGUDO,estado nutricional,clasificacion d,2004-12-01,110,207,110,207,317
71001,MONTERO,estado nutricional,clasificacion d,2004-12-01,406,289,406,289,695
70803,MORO MORO,estado nutricional,clasificacion d,2004-12-01,6,17,6,17,23
30302,MOROCHATA,estado nutricional,clasificacion d,2004-12-01,127,98,127,98,225
90401,NACEBE (SANTA ROSA DEL ABUNA),estado nutricional,clasificacion d,2004-12-01,3,0,3,0,3
20307,NAZACARA DE PACAJES,estado nutricional,clasificacion d,2004-12-01,0,2,0,2,2
90501,NUEVO MANOA (NUEVA ESPERANZA),estado nutricional,clasificacion d,2004-12-01,3,3,3,3,6
50404,OCURI,estado nutricional,clasificacion d,2004-12-01,75,78,75,78,153
70202,OKINAWA,estado nutricional,clasificacion d,2004-12-01,41,33,41,33,74
30203,OMEREQUE,estado nutricional,clasificacion d,2004-12-01,5,5,5,5,10
40101,ORURO,estado nutricional,clasificacion d,2004-12-01,688,473,688,473,1161
60201,PADCAYA,estado nutricional,clasificacion d,2004-12-01,36,67,36,67,103
10401,PADILLA,estado nutricional,clasificacion d,2004-12-01,107,220,107,220,327
70502,PAILON,estado nutricional,clasificacion d,2004-12-01,37,21,37,21,58
20102,PALCA,estado nutricional,clasificacion d,2004-12-01,30,46,30,46,76
21104,PALOS BLANCOS,estado nutricional,clasificacion d,2004-12-01,146,140,146,140,286
40802,PAMPA AULLAGAS,estado nutricional,clasificacion d,2004-12-01,8,9,8,9,17
70902,PAMPA GRANDE,estado nutricional,clasificacion d,2004-12-01,16,6,16,6,22
21802,PAPEL PAMPA,estado nutricional,clasificacion d,2004-12-01,17,23,17,23,40
30202,PASORAPA,estado nutricional,clasificacion d,2004-12-01,6,15,6,15,21
21305,PATACAMAYA,estado nutricional,clasificacion d,2004-12-01,68,53,68,53,121
40602,PAZÃ‘A,estado nutricional,clasificacion d,2004-12-01,18,22,18,22,40
20702,PELECHUCO,estado nutricional,clasificacion d,2004-12-01,26,33,26,33,59
50403,POCOATA,estado nutricional,clasificacion d,2004-12-01,149,318,149,318,467
31203,POCONA,estado nutricional,clasificacion d,2004-12-01,17,36,17,36,53
31202,POJO (CBBA),estado nutricional,clasificacion d,2004-12-01,121,118,121,118,239
40601,POOPO,estado nutricional,clasificacion d,2004-12-01,1,0,1,0,1
51203,PORCO,estado nutricional,clasificacion d,2004-12-01,25,27,25,27,52
10103,POROMA,estado nutricional,clasificacion d,2004-12-01,110,137,110,137,247
70103,PORONGO,estado nutricional,clasificacion d,2004-12-01,5,5,5,5,10
70601,PORTACHUELO,estado nutricional,clasificacion d,2004-12-01,58,66,58,66,124
90102,PORVENIR,estado nutricional,clasificacion d,2004-12-01,10,7,10,7,17
70804,POSTRER VALLE,estado nutricional,clasificacion d,2004-12-01,3,11,3,11,14
50101,POTOSI,estado nutricional,clasificacion d,2004-12-01,589,373,589,373,962
10302,PRESTO,estado nutricional,clasificacion d,2004-12-01,70,74,70,74,144
70805,PUCARA,estado nutricional,clasificacion d,2004-12-01,3,11,3,11,14
21201,PUCARANI,estado nutricional,clasificacion d,2004-12-01,56,39,56,39,95
20401,PUERTO ACOSTA,estado nutricional,clasificacion d,2004-12-01,54,55,54,55,109
20403,PUERTO CARABUCO,estado nutricional,clasificacion d,2004-12-01,39,43,39,43,82
90301,PUERTO GONZALO MORENO,estado nutricional,clasificacion d,2004-12-01,9,8,9,8,17
21204,PUERTO PEREZ,estado nutricional,clasificacion d,2004-12-01,14,5,14,5,19
90201,PUERTO RICO,estado nutricional,clasificacion d,2004-12-01,21,23,21,23,44
80703,PUERTO SILES,estado nutricional,clasificacion d,2004-12-01,1,0,1,0,1
31205,PUERTO VILLARROEL,estado nutricional,clasificacion d,2004-12-01,258,221,258,221,479
51101,PUNA,estado nutricional,clasificacion d,2004-12-01,109,123,109,123,232
31401,PUNATA,estado nutricional,clasificacion d,2004-12-01,68,42,68,42,110
30901,QUILLACOLLO,estado nutricional,clasificacion d,2004-12-01,113,134,113,134,247
21002,QUIME,estado nutricional,clasificacion d,2004-12-01,23,30,23,30,53
70904,QUIRUSILLAS,estado nutricional,clasificacion d,2004-12-01,8,6,8,6,14
50402,RAVELO,estado nutricional,clasificacion d,2004-12-01,288,270,288,270,558
80301,REYES,estado nutricional,clasificacion d,2004-12-01,14,19,14,19,33
80201,RIBERALTA,estado nutricional,clasificacion d,2004-12-01,400,436,400,436,836
70503,ROBORE,estado nutricional,clasificacion d,2004-12-01,37,25,37,25,62
80304,RURRENABAQUE,estado nutricional,clasificacion d,2004-12-01,10,7,10,7,17
40901,SABAYA,estado nutricional,clasificacion d,2004-12-01,4,9,4,9,13
31001,SACABA,estado nutricional,clasificacion d,2004-12-01,46,29,46,29,75
30404,SACABAMBA,estado nutricional,clasificacion d,2004-12-01,12,15,12,15,27
50701,SACACA,estado nutricional,clasificacion d,2004-12-01,390,633,390,633,1023
71302,SAIPINA,estado nutricional,clasificacion d,2004-12-01,25,27,25,27,52
40801,SALINAS DE GARCI MENDOZA,estado nutricional,clasificacion d,2004-12-01,28,22,28,22,50
70901,SAMAIPATA,estado nutricional,clasificacion d,2004-12-01,19,24,19,24,43
51601,SAN AGUSTIN,estado nutricional,clasificacion d,2004-12-01,6,1,6,1,7
80602,SAN ANDRES,estado nutricional,clasificacion d,2004-12-01,32,42,32,42,74
51003,SAN ANTONIO DE ESMORUCO,estado nutricional,clasificacion d,2004-12-01,5,7,5,7,12
71105,SAN ANTONIO DE LOMERIO,estado nutricional,clasificacion d,2004-12-01,91,184,91,184,275
31403,SAN BENITO,estado nutricional,clasificacion d,2004-12-01,14,9,14,9,23
80302,SAN BORJA,estado nutricional,clasificacion d,2004-12-01,136,122,136,122,258
21502,SAN BUENA VENTURA,estado nutricional,clasificacion d,2004-12-01,36,42,36,42,78
70402,SAN CARLOS,estado nutricional,clasificacion d,2004-12-01,102,60,102,60,162
80501,SAN IGNACIO,estado nutricional,clasificacion d,2004-12-01,42,65,42,65,107
70301,SAN IGNACIO DE VELASCO,estado nutricional,clasificacion d,2004-12-01,231,403,231,403,634
80102,SAN JAVIER(BNI),estado nutricional,clasificacion d,2004-12-01,8,11,8,11,19
71102,SAN JAVIER(STC),estado nutricional,clasificacion d,2004-12-01,13,5,13,5,18
80701,SAN JOAQUIN,estado nutricional,clasificacion d,2004-12-01,7,4,7,4,11
70501,SAN JOSE DE CHIQUITOS,estado nutricional,clasificacion d,2004-12-01,18,16,18,16,34
71104,SAN JULIAN,estado nutricional,clasificacion d,2004-12-01,114,104,114,104,218
90302,SAN LORENZO(PND),estado nutricional,clasificacion d,2004-12-01,8,6,8,6,14
60501,SAN LORENZO(TJA),estado nutricional,clasificacion d,2004-12-01,62,91,62,91,153
10702,SAN LUCAS,estado nutricional,clasificacion d,2004-12-01,396,500,396,500,896
70302,SAN MIGUEL DE VELASCO,estado nutricional,clasificacion d,2004-12-01,72,109,72,109,181
51001,SAN PABLO DE LIPEZ,estado nutricional,clasificacion d,2004-12-01,24,28,24,28,52
50501,SAN PEDRO DE BUENA VISTA,estado nutricional,clasificacion d,2004-12-01,99,160,99,160,259
21801,SAN PEDRO DE CURAHUARA,estado nutricional,clasificacion d,2004-12-01,23,19,23,19,42
50902,SAN PEDRO DE QUEMES,estado nutricional,clasificacion d,2004-12-01,1,4,1,4,5
21702,SAN PEDRO DE TIQUINA,estado nutricional,clasificacion d,2004-12-01,14,13,14,13,27
90202,SAN PEDRO(PND),estado nutricional,clasificacion d,2004-12-01,2,4,2,4,6
70303,SAN RAFAEL,estado nutricional,clasificacion d,2004-12-01,23,29,23,29,52
80702,SAN RAMON,estado nutricional,clasificacion d,2004-12-01,24,16,24,16,40
80702,SAN RAMON,estado nutricional,clasificacion d,2004-12-01,16,8,16,8,24
80401,SANTA ANA,estado nutricional,clasificacion d,2004-12-01,22,9,22,9,31
70101,SANTA CRUZ DE LA SIERRA,estado nutricional,clasificacion d,2004-12-01,1389,680,1389,680,2069
80303,SANTA ROSA,estado nutricional,clasificacion d,2004-12-01,27,6,27,6,33
70602,SANTA ROSA DEL SARA,estado nutricional,clasificacion d,2004-12-01,23,30,23,30,53
20308,SANTIAGO DE CALLAPA,estado nutricional,clasificacion d,2004-12-01,31,30,31,30,61
41401,SANTIAGO DE HUARI,estado nutricional,clasificacion d,2004-12-01,12,14,12,14,26
21901,SANTIAGO DE MACHACA,estado nutricional,clasificacion d,2004-12-01,15,11,15,11,26
30702,SANTIVAÃ‘ES,estado nutricional,clasificacion d,2004-12-01,36,28,36,28,64
40202,SANTUARIO DE QUILLACAS,estado nutricional,clasificacion d,2004-12-01,8,10,8,10,18
20902,SAPAHAQUI,estado nutricional,clasificacion d,2004-12-01,58,47,58,47,105
90303,SENA,estado nutricional,clasificacion d,2004-12-01,2,3,2,3,5
21301,SICA SICA (VILLA AROMA),estado nutricional,clasificacion d,2004-12-01,56,62,56,62,118
30703,SICAYA,estado nutricional,clasificacion d,2004-12-01,12,12,12,12,24
30902,SIPE SIPE,estado nutricional,clasificacion d,2004-12-01,167,118,167,118,285
10403,SOPACHUY,estado nutricional,clasificacion d,2004-12-01,22,50,22,50,72
20601,SORATA,estado nutricional,clasificacion d,2004-12-01,52,67,52,67,119
10101,SUCRE,estado nutricional,clasificacion d,2004-12-01,467,551,467,551,1018
31404,TACACHI,estado nutricional,clasificacion d,2004-12-01,7,5,7,5,12
20603,TACACOMA,estado nutricional,clasificacion d,2004-12-01,4,5,4,5,9
50303,TACOBAMBA,estado nutricional,clasificacion d,2004-12-01,58,96,58,96,154
30602,TACOPAYA,estado nutricional,clasificacion d,2004-12-01,69,79,69,79,148
51402,TAHUA,estado nutricional,clasificacion d,2004-12-01,1,1,1,1,2
31101,TAPACARI,estado nutricional,clasificacion d,2004-12-01,117,104,117,104,221
10601,TARABUCO,estado nutricional,clasificacion d,2004-12-01,263,490,263,490,753
30401,TARATA,estado nutricional,clasificacion d,2004-12-01,38,12,38,12,50
60101,TARIJA,estado nutricional,clasificacion d,2004-12-01,308,291,308,291,599
10202,TARVITA,estado nutricional,clasificacion d,2004-12-01,42,109,42,109,151
20803,TIAWANACU,estado nutricional,clasificacion d,2004-12-01,37,56,37,56,93
50102,TINGUIPAYA,estado nutricional,clasificacion d,2004-12-01,166,245,166,245,411
20606,TIPUANI,estado nutricional,clasificacion d,2004-12-01,13,10,13,10,23
30903,TIQUIPAYA,estado nutricional,clasificacion d,2004-12-01,86,53,86,53,139
31601,TIRAQUE (CBBA),estado nutricional,clasificacion d,2004-12-01,149,107,149,107,256
21703,TITO YUPANQUI (PARQUIPUJIO),estado nutricional,clasificacion d,2004-12-01,1,6,1,6,7
30802,TOCO,estado nutricional,clasificacion d,2004-12-01,1,0,1,0,1
30803,TOLATA,estado nutricional,clasificacion d,2004-12-01,7,0,7,0,7
41001,TOLEDO,estado nutricional,clasificacion d,2004-12-01,18,8,18,8,26
51202,TOMAVE,estado nutricional,clasificacion d,2004-12-01,49,72,49,72,121
10402,TOMINA,estado nutricional,clasificacion d,2004-12-01,130,254,130,254,384
50502,TORO TORO,estado nutricional,clasificacion d,2004-12-01,110,158,110,158,268
31201,TOTORA(CBBA),estado nutricional,clasificacion d,2004-12-01,41,37,41,37,78
41301,TOTORA(ORR),estado nutricional,clasificacion d,2004-12-01,16,9,16,9,25
70802,TRIGAL,estado nutricional,clasificacion d,2004-12-01,3,6,3,6,9
80101,TRINIDAD,estado nutricional,clasificacion d,2004-12-01,240,199,240,199,439
50801,TUPIZA,estado nutricional,clasificacion d,2004-12-01,167,234,167,234,401
21302,UMALA,estado nutricional,clasificacion d,2004-12-01,6,11,6,11,17
50201,UNCIA,estado nutricional,clasificacion d,2004-12-01,56,83,56,83,139
60401,URIONDO (A. CONCEPCION),estado nutricional,clasificacion d,2004-12-01,50,100,50,100,150
51201,UYUNI,estado nutricional,clasificacion d,2004-12-01,55,99,55,99,154
30502,VACAS,estado nutricional,clasificacion d,2004-12-01,115,61,115,61,176
70801,VALLEGRANDE,estado nutricional,clasificacion d,2004-12-01,48,60,48,60,108
20801,VIACHA,estado nutricional,clasificacion d,2004-12-01,115,83,115,83,198
31302,VILA VILA,estado nutricional,clasificacion d,2004-12-01,15,23,15,23,38
60303,VILLA MONTES,estado nutricional,clasificacion d,2004-12-01,60,62,60,62,122
90502,VILLA NUEVA (LOMA ALTA),estado nutricional,clasificacion d,2004-12-01,1,1,1,1,2
31402,VILLA RIVERO,estado nutricional,clasificacion d,2004-12-01,28,9,28,9,37
10801,VILLA SERRANO,estado nutricional,clasificacion d,2004-12-01,93,236,93,236,329
31003,VILLA TUNARI,estado nutricional,clasificacion d,2004-12-01,249,252,249,252,501
11001,VILLA VACA GUZMAN (MUYUPAMPA),estado nutricional,clasificacion d,2004-12-01,52,113,52,113,165
51501,VILLAZON,estado nutricional,clasificacion d,2004-12-01,147,155,147,155,302
30904,VINTO,estado nutricional,clasificacion d,2004-12-01,22,9,22,9,31
50602,VITICHI,estado nutricional,clasificacion d,2004-12-01,50,92,50,92,142
20306,WALDO BALLIVIAN,estado nutricional,clasificacion d,2004-12-01,6,8,6,8,14
70201,WARNES,estado nutricional,clasificacion d,2004-12-01,75,46,75,46,121
20903,YACO,estado nutricional,clasificacion d,2004-12-01,18,26,18,26,44
60301,YACUIBA,estado nutricional,clasificacion d,2004-12-01,128,82,128,82,210
10602,YAMPARAEZ,estado nutricional,clasificacion d,2004-12-01,101,257,101,257,358
21103,YANACACHI,estado nutricional,clasificacion d,2004-12-01,5,1,5,1,6
70403,YAPACANI,estado nutricional,clasificacion d,2004-12-01,201,192,201,192,393
50103,YOCALLA,estado nutricional,clasificacion d,2004-12-01,16,25,16,25,41
10102,YOTALA,estado nutricional,clasificacion d,2004-12-01,49,134,49,134,183
60402,YUNCHARA,estado nutricional,clasificacion d,2004-12-01,31,62,31,62,93
10301,ZUDAÃ‘EZ,estado nutricional,clasificacion d,2004-12-01,57,116,57,116,173
