codigo_municipio,municipio,grupo,variable,mes,hombres total,mujeres total,hombres total,mujeres total,total
51302,ACACIO,estado nutricional en menores de 5 anos,clasificacion d,2001-01-01,1,116,1,116,117
20201,ACHACACHI,estado nutricional en menores de 5 anos,clasificacion d,2001-01-01,3,81,3,81,84
20104,ACHOCALLA,estado nutricional en menores de 5 anos,clasificacion d,2001-01-01,0,6,0,6,6
30201,AIQUILE,estado nutricional en menores de 5 anos,clasificacion d,2001-01-01,18,27,18,27,45
31303,ALALAY,estado nutricional en menores de 5 anos,clasificacion d,2001-01-01,12,3,12,3,15
10404,ALCALA,estado nutricional en menores de 5 anos,clasificacion d,2001-01-01,0,52,0,52,52
20202,ANCORAIMES,estado nutricional en menores de 5 anos,clasificacion d,2001-01-01,0,115,0,115,115
41201,ANDAMARCA,estado nutricional en menores de 5 anos,clasificacion d,2001-01-01,3,10,3,10,13
40603,ANTEQUERA,estado nutricional en menores de 5 anos,clasificacion d,2001-01-01,0,2,0,2,2
20701,APOLO,estado nutricional en menores de 5 anos,clasificacion d,2001-01-01,9,3,9,3,12
51301,ARAMPAMPA,estado nutricional en menores de 5 anos,clasificacion d,2001-01-01,0,25,0,25,25
30501,ARANI,estado nutricional en menores de 5 anos,clasificacion d,2001-01-01,1,37,1,37,38
71501,ASCENCION DE GUARAYOS,estado nutricional en menores de 5 anos,clasificacion d,2001-01-01,0,13,0,13,13
50802,ATOCHA,estado nutricional en menores de 5 anos,clasificacion d,2001-01-01,0,3,0,3,3
20503,AUCAPATA,estado nutricional en menores de 5 anos,clasificacion d,2001-01-01,22,5,22,5,27
30301,AYOPAYA (V. DE INDEPENDENCIA),estado nutricional en menores de 5 anos,clasificacion d,2001-01-01,6,84,6,84,90
10201,AZURDUY,estado nutricional en menores de 5 anos,clasificacion d,2001-01-01,0,128,0,128,128
21203,BATALLAS,estado nutricional en menores de 5 anos,clasificacion d,2001-01-01,1,7,1,7,8
80802,BAURES,estado nutricional en menores de 5 anos,clasificacion d,2001-01-01,0,48,0,48,48
41202,BELEN DE ANDAMARCA,estado nutricional en menores de 5 anos,clasificacion d,2001-01-01,0,4,0,4,4
50104,BELEN DE URMIRI,estado nutricional en menores de 5 anos,clasificacion d,2001-01-01,4,13,4,13,17
90104,BELLA FLOR,estado nutricional en menores de 5 anos,clasificacion d,2001-01-01,1,7,1,7,8
60202,BERMEJO,estado nutricional en menores de 5 anos,clasificacion d,2001-01-01,1,95,1,95,96
50301,BETANZOS,estado nutricional en menores de 5 anos,clasificacion d,2001-01-01,21,315,21,315,336
31501,BOLIVAR,estado nutricional en menores de 5 anos,clasificacion d,2001-01-01,1,53,1,53,54
90103,BOLPEBRA,estado nutricional en menores de 5 anos,clasificacion d,2001-01-01,0,6,0,6,6
70707,BOYUIBE,estado nutricional en menores de 5 anos,clasificacion d,2001-01-01,0,13,0,13,13
70703,CABEZAS,estado nutricional en menores de 5 anos,clasificacion d,2001-01-01,36,67,36,67,103
20905,CAIROMA,estado nutricional en menores de 5 anos,clasificacion d,2001-01-01,32,18,32,18,50
51102,"CAIZA ""D""",estado nutricional en menores de 5 anos,clasificacion d,2001-01-01,1,37,1,37,38
21003,CAJUATA,estado nutricional en menores de 5 anos,clasificacion d,2001-01-01,2,39,2,39,41
20303,CALACOTO,estado nutricional en menores de 5 anos,clasificacion d,2001-01-01,2,4,2,4,6
21304,CALAMARCA,estado nutricional en menores de 5 anos,clasificacion d,2001-01-01,1,28,1,28,29
10701,CAMARGO,estado nutricional en menores de 5 anos,clasificacion d,2001-01-01,3,64,3,64,67
10901,CAMATAQUI (C. VILLA ABECIA),estado nutricional en menores de 5 anos,clasificacion d,2001-01-01,1,25,1,25,26
70706,CAMIRI,estado nutricional en menores de 5 anos,clasificacion d,2001-01-01,3,321,3,321,324
30701,CAPINOTA,estado nutricional en menores de 5 anos,clasificacion d,2001-01-01,8,13,8,13,21
20302,CAQUIAVIRI,estado nutricional en menores de 5 anos,clasificacion d,2001-01-01,1,19,1,19,20
40102,CARACOLLO,estado nutricional en menores de 5 anos,clasificacion d,2001-01-01,0,64,0,64,64
22001,CARANAVI,estado nutricional en menores de 5 anos,clasificacion d,2001-01-01,7,114,7,114,121
60302,CARAPARI,estado nutricional en menores de 5 anos,clasificacion d,2001-01-01,3,59,3,59,62
50702,CARIPUYO,estado nutricional en menores de 5 anos,clasificacion d,2001-01-01,0,40,0,40,40
40201,CHALLAPATA,estado nutricional en menores de 5 anos,clasificacion d,2001-01-01,3,62,3,62,65
50302,CHAQUI,estado nutricional en menores de 5 anos,clasificacion d,2001-01-01,2,131,2,131,133
70702,CHARAGUA,estado nutricional en menores de 5 anos,clasificacion d,2001-01-01,70,138,70,138,208
20305,CHARAÃ‘A,estado nutricional en menores de 5 anos,clasificacion d,2001-01-01,0,1,0,1,1
50202,CHAYANTA,estado nutricional en menores de 5 anos,clasificacion d,2001-01-01,31,174,31,174,205
31204,CHIMORE,estado nutricional en menores de 5 anos,clasificacion d,2001-01-01,2,41,2,41,43
40903,CHIPAYA,estado nutricional en menores de 5 anos,clasificacion d,2001-01-01,0,1,0,1,1
21101,CHULUMANI (V. DE LA LIBERTAD),estado nutricional en menores de 5 anos,clasificacion d,2001-01-01,2,38,2,38,40
20501,CHUMA,estado nutricional en menores de 5 anos,clasificacion d,2001-01-01,0,16,0,16,16
90101,COBIJA,estado nutricional en menores de 5 anos,clasificacion d,2001-01-01,6,119,6,119,125
30101,COCHABAMBA,estado nutricional en menores de 5 anos,clasificacion d,2001-01-01,361,385,361,385,746
30905,COLCAPIRHUA,estado nutricional en menores de 5 anos,clasificacion d,2001-01-01,9,113,9,113,122
50901,"COLCHA ""K""",estado nutricional en menores de 5 anos,clasificacion d,2001-01-01,3,57,3,57,60
31002,COLOMI,estado nutricional en menores de 5 anos,clasificacion d,2001-01-01,2,44,2,44,46
70603,COLPA BELGICA,estado nutricional en menores de 5 anos,clasificacion d,2001-01-01,7,7,7,7,14
50401,COLQUECHACA,estado nutricional en menores de 5 anos,clasificacion d,2001-01-01,5,128,5,128,133
21306,COLQUENCHA,estado nutricional en menores de 5 anos,clasificacion d,2001-01-01,1,12,1,12,13
21004,COLQUIRI,estado nutricional en menores de 5 anos,clasificacion d,2001-01-01,9,287,9,287,296
20304,COMANCHE,estado nutricional en menores de 5 anos,clasificacion d,2001-01-01,0,15,0,15,15
71301,COMARAPA,estado nutricional en menores de 5 anos,clasificacion d,2001-01-01,2,14,2,14,16
20605,COMBAYA,estado nutricional en menores de 5 anos,clasificacion d,2001-01-01,0,14,0,14,14
71101,CONCEPCION,estado nutricional en menores de 5 anos,clasificacion d,2001-01-01,32,0,32,0,32
21701,COPACABANA,estado nutricional en menores de 5 anos,clasificacion d,2001-01-01,1,38,1,38,39
21402,CORIPATA,estado nutricional en menores de 5 anos,clasificacion d,2001-01-01,0,7,0,7,7
20301,CORO CORO,estado nutricional en menores de 5 anos,clasificacion d,2001-01-01,2,43,2,43,45
21401,COROICO,estado nutricional en menores de 5 anos,clasificacion d,2001-01-01,2,7,2,7,9
40301,CORQUE,estado nutricional en menores de 5 anos,clasificacion d,2001-01-01,4,22,4,22,26
50601,COTAGAITA,estado nutricional en menores de 5 anos,clasificacion d,2001-01-01,0,65,0,65,65
31405,CUCHUMUELA (V. G. VILLARROEL),estado nutricional en menores de 5 anos,clasificacion d,2001-01-01,1,0,1,0,1
70704,CUEVO,estado nutricional en menores de 5 anos,clasificacion d,2001-01-01,17,70,17,70,87
10902,CULPINA,estado nutricional en menores de 5 anos,clasificacion d,2001-01-01,4,190,4,190,194
40401,CURAHUARA DE CARANGAS,estado nutricional en menores de 5 anos,clasificacion d,2001-01-01,0,20,0,20,20
21602,CURVA,estado nutricional en menores de 5 anos,clasificacion d,2001-01-01,1,10,1,10,11
20804,DESAGUADERO,estado nutricional en menores de 5 anos,clasificacion d,2001-01-01,7,22,7,22,29
20105,EL ALTO,estado nutricional en menores de 5 anos,clasificacion d,2001-01-01,388,1451,388,1451,1839
71503,EL PUENTE(STC),estado nutricional en menores de 5 anos,clasificacion d,2001-01-01,2,89,2,89,91
60502,EL PUENTE(TJA),estado nutricional en menores de 5 anos,clasificacion d,2001-01-01,3,66,3,66,69
70105,EL TORNO,estado nutricional en menores de 5 anos,clasificacion d,2001-01-01,8,103,8,103,111
10405,EL VILLAR,estado nutricional en menores de 5 anos,clasificacion d,2001-01-01,14,161,14,161,175
60601,ENTRE RIOS,estado nutricional en menores de 5 anos,clasificacion d,2001-01-01,4,74,4,74,78
41101,EUCALIPTUS,estado nutricional en menores de 5 anos,clasificacion d,2001-01-01,1,17,1,17,18
80402,EXALTACION,estado nutricional en menores de 5 anos,clasificacion d,2001-01-01,3,0,3,0,3
90203,FILADELFIA,estado nutricional en menores de 5 anos,clasificacion d,2001-01-01,1,4,1,4,5
71002,GENERAL SAAVEDRA,estado nutricional en menores de 5 anos,clasificacion d,2001-01-01,69,91,69,91,160
21601,GRAL. J.J. PEREZ (CHARAZANI),estado nutricional en menores de 5 anos,clasificacion d,2001-01-01,0,2,0,2,2
20602,GUANAY,estado nutricional en menores de 5 anos,clasificacion d,2001-01-01,20,17,20,17,37
20802,GUAQUI,estado nutricional en menores de 5 anos,clasificacion d,2001-01-01,1,8,1,8,9
80202,GUAYARAMERIN,estado nutricional en menores de 5 anos,clasificacion d,2001-01-01,7,111,7,111,118
70705,GUTIERREZ,estado nutricional en menores de 5 anos,clasificacion d,2001-01-01,3,260,3,260,263
10502,HUACARETA,estado nutricional en menores de 5 anos,clasificacion d,2001-01-01,6,174,6,174,180
11002,HUACAYA (VILLA DE HUACAYA),estado nutricional en menores de 5 anos,clasificacion d,2001-01-01,5,11,5,11,16
40501,HUACHACALLA,estado nutricional en menores de 5 anos,clasificacion d,2001-01-01,0,6,0,6,6
40701,HUANUNI,estado nutricional en menores de 5 anos,clasificacion d,2001-01-01,0,18,0,18,18
80803,HUARACAJE,estado nutricional en menores de 5 anos,clasificacion d,2001-01-01,1,7,1,7,8
41601,HUAYLLAMARCA,estado nutricional en menores de 5 anos,clasificacion d,2001-01-01,2,3,2,3,5
21005,ICHOCA,estado nutricional en menores de 5 anos,clasificacion d,2001-01-01,2,40,2,40,42
10304,ICLA,estado nutricional en menores de 5 anos,clasificacion d,2001-01-01,7,312,7,312,319
10703,INCAHUASI,estado nutricional en menores de 5 anos,clasificacion d,2001-01-01,1,147,1,147,148
21001,INQUISIVI,estado nutricional en menores de 5 anos,clasificacion d,2001-01-01,1,134,1,134,135
21102,IRUPANA (VILLA DE LANZA),estado nutricional en menores de 5 anos,clasificacion d,2001-01-01,2,46,2,46,48
21501,IXIAMAS,estado nutricional en menores de 5 anos,clasificacion d,2001-01-01,0,10,0,10,10
21105,LA ASUNTA,estado nutricional en menores de 5 anos,clasificacion d,2001-01-01,1,24,1,24,25
70104,LA GUARDIA,estado nutricional en menores de 5 anos,clasificacion d,2001-01-01,4,158,4,158,162
20101,LA PAZ,estado nutricional en menores de 5 anos,clasificacion d,2001-01-01,93,808,93,808,901
41501,LA RIVERA,estado nutricional en menores de 5 anos,clasificacion d,2001-01-01,0,1,0,1,1
70701,LAGUNILLAS,estado nutricional en menores de 5 anos,clasificacion d,2001-01-01,12,54,12,54,66
21202,LAJA,estado nutricional en menores de 5 anos,clasificacion d,2001-01-01,0,25,0,25,25
10903,LAS CARRERAS,estado nutricional en menores de 5 anos,clasificacion d,2001-01-01,2,93,2,93,95
21006,LICOMA PAMPA,estado nutricional en menores de 5 anos,clasificacion d,2001-01-01,0,8,0,8,8
50203,LLALLAGUA,estado nutricional en menores de 5 anos,clasificacion d,2001-01-01,2,27,2,27,29
51401,LLICA,estado nutricional en menores de 5 anos,clasificacion d,2001-01-01,7,14,7,14,21
80601,LORETO,estado nutricional en menores de 5 anos,clasificacion d,2001-01-01,0,8,0,8,8
40702,MACHACAMARCA,estado nutricional en menores de 5 anos,clasificacion d,2001-01-01,0,19,0,19,19
11003,MACHARETI,estado nutricional en menores de 5 anos,clasificacion d,2001-01-01,6,146,6,146,152
80801,MAGDALENA,estado nutricional en menores de 5 anos,clasificacion d,2001-01-01,1,34,1,34,35
70903,MAIRANA,estado nutricional en menores de 5 anos,clasificacion d,2001-01-01,2,26,2,26,28
71003,MINEROS,estado nutricional en menores de 5 anos,clasificacion d,2001-01-01,8,217,8,217,225
31301,MIZQUE,estado nutricional en menores de 5 anos,clasificacion d,2001-01-01,26,8,26,8,34
20402,MOCOMOCO,estado nutricional en menores de 5 anos,clasificacion d,2001-01-01,2,34,2,34,36
51002,MOJINETE,estado nutricional en menores de 5 anos,clasificacion d,2001-01-01,0,7,0,7,7
10303,MOJOCOYA,estado nutricional en menores de 5 anos,clasificacion d,2001-01-01,3,89,3,89,92
10501,MONTEAGUDO,estado nutricional en menores de 5 anos,clasificacion d,2001-01-01,23,361,23,361,384
71001,MONTERO,estado nutricional en menores de 5 anos,clasificacion d,2001-01-01,82,475,82,475,557
70803,MORO MORO,estado nutricional en menores de 5 anos,clasificacion d,2001-01-01,1,16,1,16,17
30302,MOROCHATA,estado nutricional en menores de 5 anos,clasificacion d,2001-01-01,1,36,1,36,37
50404,OCURI,estado nutricional en menores de 5 anos,clasificacion d,2001-01-01,8,38,8,38,46
70202,OKINAWA,estado nutricional en menores de 5 anos,clasificacion d,2001-01-01,1,7,1,7,8
30203,OMEREQUE,estado nutricional en menores de 5 anos,clasificacion d,2001-01-01,0,35,0,35,35
40101,ORURO,estado nutricional en menores de 5 anos,clasificacion d,2001-01-01,39,572,39,572,611
60201,PADCAYA,estado nutricional en menores de 5 anos,clasificacion d,2001-01-01,4,45,4,45,49
10401,PADILLA,estado nutricional en menores de 5 anos,clasificacion d,2001-01-01,4,194,4,194,198
70502,PAILON,estado nutricional en menores de 5 anos,clasificacion d,2001-01-01,0,10,0,10,10
20102,PALCA,estado nutricional en menores de 5 anos,clasificacion d,2001-01-01,0,2,0,2,2
21104,PALOS BLANCOS,estado nutricional en menores de 5 anos,clasificacion d,2001-01-01,1,134,1,134,135
40802,PAMPA AULLAGAS,estado nutricional en menores de 5 anos,clasificacion d,2001-01-01,0,21,0,21,21
70902,PAMPA GRANDE,estado nutricional en menores de 5 anos,clasificacion d,2001-01-01,0,32,0,32,32
30202,PASORAPA,estado nutricional en menores de 5 anos,clasificacion d,2001-01-01,1,78,1,78,79
40602,PAZÃ‘A,estado nutricional en menores de 5 anos,clasificacion d,2001-01-01,1,10,1,10,11
20702,PELECHUCO,estado nutricional en menores de 5 anos,clasificacion d,2001-01-01,7,5,7,5,12
50403,POCOATA,estado nutricional en menores de 5 anos,clasificacion d,2001-01-01,3,149,3,149,152
31203,POCONA,estado nutricional en menores de 5 anos,clasificacion d,2001-01-01,4,35,4,35,39
31202,POJO (CBBA),estado nutricional en menores de 5 anos,clasificacion d,2001-01-01,6,138,6,138,144
40601,POOPO,estado nutricional en menores de 5 anos,clasificacion d,2001-01-01,15,12,15,12,27
51203,PORCO,estado nutricional en menores de 5 anos,clasificacion d,2001-01-01,0,12,0,12,12
10103,POROMA,estado nutricional en menores de 5 anos,clasificacion d,2001-01-01,35,171,35,171,206
70103,PORONGO,estado nutricional en menores de 5 anos,clasificacion d,2001-01-01,2,41,2,41,43
70601,PORTACHUELO,estado nutricional en menores de 5 anos,clasificacion d,2001-01-01,0,30,0,30,30
90102,PORVENIR,estado nutricional en menores de 5 anos,clasificacion d,2001-01-01,2,29,2,29,31
50101,POTOSI,estado nutricional en menores de 5 anos,clasificacion d,2001-01-01,23,446,23,446,469
10302,PRESTO,estado nutricional en menores de 5 anos,clasificacion d,2001-01-01,0,111,0,111,111
70805,PUCARA,estado nutricional en menores de 5 anos,clasificacion d,2001-01-01,0,7,0,7,7
21201,PUCARANI,estado nutricional en menores de 5 anos,clasificacion d,2001-01-01,3,46,3,46,49
20401,PUERTO ACOSTA,estado nutricional en menores de 5 anos,clasificacion d,2001-01-01,1,13,1,13,14
20403,PUERTO CARABUCO,estado nutricional en menores de 5 anos,clasificacion d,2001-01-01,4,110,4,110,114
21204,PUERTO PEREZ,estado nutricional en menores de 5 anos,clasificacion d,2001-01-01,1,17,1,17,18
71402,PUERTO QUIJARRO,estado nutricional en menores de 5 anos,clasificacion d,2001-01-01,4,62,4,62,66
90201,PUERTO RICO,estado nutricional en menores de 5 anos,clasificacion d,2001-01-01,1,20,1,20,21
71401,PUERTO SUAREZ,estado nutricional en menores de 5 anos,clasificacion d,2001-01-01,6,90,6,90,96
31205,PUERTO VILLARROEL,estado nutricional en menores de 5 anos,clasificacion d,2001-01-01,32,157,32,157,189
51101,PUNA,estado nutricional en menores de 5 anos,clasificacion d,2001-01-01,7,280,7,280,287
31401,PUNATA,estado nutricional en menores de 5 anos,clasificacion d,2001-01-01,14,66,14,66,80
20604,QUIABAYA,estado nutricional en menores de 5 anos,clasificacion d,2001-01-01,0,14,0,14,14
30901,QUILLACOLLO,estado nutricional en menores de 5 anos,clasificacion d,2001-01-01,0,1,0,1,1
21002,QUIME,estado nutricional en menores de 5 anos,clasificacion d,2001-01-01,3,71,3,71,74
70904,QUIRUSILLAS,estado nutricional en menores de 5 anos,clasificacion d,2001-01-01,0,2,0,2,2
50402,RAVELO,estado nutricional en menores de 5 anos,clasificacion d,2001-01-01,5,156,5,156,161
80301,REYES,estado nutricional en menores de 5 anos,clasificacion d,2001-01-01,1,61,1,61,62
80201,RIBERALTA,estado nutricional en menores de 5 anos,clasificacion d,2001-01-01,12,506,12,506,518
70503,ROBORE,estado nutricional en menores de 5 anos,clasificacion d,2001-01-01,5,60,5,60,65
80304,RURRENABAQUE,estado nutricional en menores de 5 anos,clasificacion d,2001-01-01,1,23,1,23,24
40901,SABAYA,estado nutricional en menores de 5 anos,clasificacion d,2001-01-01,0,1,0,1,1
31001,SACABA,estado nutricional en menores de 5 anos,clasificacion d,2001-01-01,102,58,102,58,160
50701,SACACA,estado nutricional en menores de 5 anos,clasificacion d,2001-01-01,23,122,23,122,145
71302,SAIPINA,estado nutricional en menores de 5 anos,clasificacion d,2001-01-01,16,14,16,14,30
40801,SALINAS DE GARCI MENDOZA,estado nutricional en menores de 5 anos,clasificacion d,2001-01-01,0,12,0,12,12
70901,SAMAIPATA,estado nutricional en menores de 5 anos,clasificacion d,2001-01-01,0,15,0,15,15
51601,SAN AGUSTIN,estado nutricional en menores de 5 anos,clasificacion d,2001-01-01,4,6,4,6,10
80602,SAN ANDRES,estado nutricional en menores de 5 anos,clasificacion d,2001-01-01,0,31,0,31,31
51003,SAN ANTONIO DE ESMORUCO,estado nutricional en menores de 5 anos,clasificacion d,2001-01-01,0,7,0,7,7
71105,SAN ANTONIO DE LOMERIO,estado nutricional en menores de 5 anos,clasificacion d,2001-01-01,33,127,33,127,160
31403,SAN BENITO,estado nutricional en menores de 5 anos,clasificacion d,2001-01-01,8,27,8,27,35
80302,SAN BORJA,estado nutricional en menores de 5 anos,clasificacion d,2001-01-01,10,117,10,117,127
21502,SAN BUENA VENTURA,estado nutricional en menores de 5 anos,clasificacion d,2001-01-01,7,85,7,85,92
80501,SAN IGNACIO,estado nutricional en menores de 5 anos,clasificacion d,2001-01-01,25,73,25,73,98
70301,SAN IGNACIO DE VELASCO,estado nutricional en menores de 5 anos,clasificacion d,2001-01-01,21,362,21,362,383
80102,SAN JAVIER(BNI),estado nutricional en menores de 5 anos,clasificacion d,2001-01-01,0,14,0,14,14
71102,SAN JAVIER(STC),estado nutricional en menores de 5 anos,clasificacion d,2001-01-01,39,96,39,96,135
80701,SAN JOAQUIN,estado nutricional en menores de 5 anos,clasificacion d,2001-01-01,0,16,0,16,16
70501,SAN JOSE DE CHIQUITOS,estado nutricional en menores de 5 anos,clasificacion d,2001-01-01,20,143,20,143,163
71104,SAN JULIAN,estado nutricional en menores de 5 anos,clasificacion d,2001-01-01,2,272,2,272,274
90302,SAN LORENZO(PND),estado nutricional en menores de 5 anos,clasificacion d,2001-01-01,4,1,4,1,5
60501,SAN LORENZO(TJA),estado nutricional en menores de 5 anos,clasificacion d,2001-01-01,2,34,2,34,36
10702,SAN LUCAS,estado nutricional en menores de 5 anos,clasificacion d,2001-01-01,15,352,15,352,367
71201,SAN MATIAS,estado nutricional en menores de 5 anos,clasificacion d,2001-01-01,1,45,1,45,46
70302,SAN MIGUEL DE VELASCO,estado nutricional en menores de 5 anos,clasificacion d,2001-01-01,1,172,1,172,173
51001,SAN PABLO DE LIPEZ,estado nutricional en menores de 5 anos,clasificacion d,2001-01-01,1,25,1,25,26
50501,SAN PEDRO DE BUENA VISTA,estado nutricional en menores de 5 anos,clasificacion d,2001-01-01,6,131,6,131,137
21801,SAN PEDRO DE CURAHUARA,estado nutricional en menores de 5 anos,clasificacion d,2001-01-01,0,19,0,19,19
50902,SAN PEDRO DE QUEMES,estado nutricional en menores de 5 anos,clasificacion d,2001-01-01,0,15,0,15,15
21702,SAN PEDRO DE TIQUINA,estado nutricional en menores de 5 anos,clasificacion d,2001-01-01,2,4,2,4,6
70303,SAN RAFAEL,estado nutricional en menores de 5 anos,clasificacion d,2001-01-01,5,42,5,42,47
80702,SAN RAMON,estado nutricional en menores de 5 anos,clasificacion d,2001-01-01,1,65,1,65,66
80702,SAN RAMON,estado nutricional en menores de 5 anos,clasificacion d,2001-01-01,0,8,0,8,8
70101,SANTA CRUZ DE LA SIERRA,estado nutricional en menores de 5 anos,clasificacion d,2001-01-01,72,244,72,244,316
80303,SANTA ROSA,estado nutricional en menores de 5 anos,clasificacion d,2001-01-01,1,14,1,14,15
70602,SANTA ROSA DEL SARA,estado nutricional en menores de 5 anos,clasificacion d,2001-01-01,0,1,0,1,1
41401,SANTIAGO DE HUARI,estado nutricional en menores de 5 anos,clasificacion d,2001-01-01,0,29,0,29,29
21901,SANTIAGO DE MACHACA,estado nutricional en menores de 5 anos,clasificacion d,2001-01-01,0,1,0,1,1
30702,SANTIVAÃ‘ES,estado nutricional en menores de 5 anos,clasificacion d,2001-01-01,12,10,12,10,22
40202,SANTUARIO DE QUILLACAS,estado nutricional en menores de 5 anos,clasificacion d,2001-01-01,0,11,0,11,11
90303,SENA,estado nutricional en menores de 5 anos,clasificacion d,2001-01-01,0,2,0,2,2
21301,SICA SICA (VILLA AROMA),estado nutricional en menores de 5 anos,clasificacion d,2001-01-01,4,33,4,33,37
30703,SICAYA,estado nutricional en menores de 5 anos,clasificacion d,2001-01-01,1,3,1,3,4
30902,SIPE SIPE,estado nutricional en menores de 5 anos,clasificacion d,2001-01-01,5,222,5,222,227
10403,SOPACHUY,estado nutricional en menores de 5 anos,clasificacion d,2001-01-01,1,138,1,138,139
20601,SORATA,estado nutricional en menores de 5 anos,clasificacion d,2001-01-01,5,38,5,38,43
10101,SUCRE,estado nutricional en menores de 5 anos,clasificacion d,2001-01-01,71,1268,71,1268,1339
31404,TACACHI,estado nutricional en menores de 5 anos,clasificacion d,2001-01-01,0,14,0,14,14
20603,TACACOMA,estado nutricional en menores de 5 anos,clasificacion d,2001-01-01,4,44,4,44,48
50303,TACOBAMBA,estado nutricional en menores de 5 anos,clasificacion d,2001-01-01,1,83,1,83,84
30602,TACOPAYA,estado nutricional en menores de 5 anos,clasificacion d,2001-01-01,0,22,0,22,22
51402,TAHUA,estado nutricional en menores de 5 anos,clasificacion d,2001-01-01,0,2,0,2,2
31101,TAPACARI,estado nutricional en menores de 5 anos,clasificacion d,2001-01-01,1,49,1,49,50
10601,TARABUCO,estado nutricional en menores de 5 anos,clasificacion d,2001-01-01,23,683,23,683,706
60101,TARIJA,estado nutricional en menores de 5 anos,clasificacion d,2001-01-01,6,184,6,184,190
10202,TARVITA,estado nutricional en menores de 5 anos,clasificacion d,2001-01-01,3,133,3,133,136
20803,TIAWANACU,estado nutricional en menores de 5 anos,clasificacion d,2001-01-01,4,27,4,27,31
50102,TINGUIPAYA,estado nutricional en menores de 5 anos,clasificacion d,2001-01-01,7,35,7,35,42
20606,TIPUANI,estado nutricional en menores de 5 anos,clasificacion d,2001-01-01,3,9,3,9,12
30903,TIQUIPAYA,estado nutricional en menores de 5 anos,clasificacion d,2001-01-01,0,12,0,12,12
31601,TIRAQUE (CBBA),estado nutricional en menores de 5 anos,clasificacion d,2001-01-01,5,91,5,91,96
21703,TITO YUPANQUI (PARQUIPUJIO),estado nutricional en menores de 5 anos,clasificacion d,2001-01-01,0,6,0,6,6
41502,TODOS SANTOS,estado nutricional en menores de 5 anos,clasificacion d,2001-01-01,0,1,0,1,1
41001,TOLEDO,estado nutricional en menores de 5 anos,clasificacion d,2001-01-01,1,9,1,9,10
51202,TOMAVE,estado nutricional en menores de 5 anos,clasificacion d,2001-01-01,8,55,8,55,63
10402,TOMINA,estado nutricional en menores de 5 anos,clasificacion d,2001-01-01,1,195,1,195,196
31201,TOTORA(CBBA),estado nutricional en menores de 5 anos,clasificacion d,2001-01-01,4,73,4,73,77
41301,TOTORA(ORR),estado nutricional en menores de 5 anos,clasificacion d,2001-01-01,0,4,0,4,4
70802,TRIGAL,estado nutricional en menores de 5 anos,clasificacion d,2001-01-01,0,12,0,12,12
80101,TRINIDAD,estado nutricional en menores de 5 anos,clasificacion d,2001-01-01,1,11,1,11,12
50801,TUPIZA,estado nutricional en menores de 5 anos,clasificacion d,2001-01-01,17,422,17,422,439
40402,TURCO,estado nutricional en menores de 5 anos,clasificacion d,2001-01-01,0,3,0,3,3
21302,UMALA,estado nutricional en menores de 5 anos,clasificacion d,2001-01-01,0,8,0,8,8
50201,UNCIA,estado nutricional en menores de 5 anos,clasificacion d,2001-01-01,1,46,1,46,47
60401,URIONDO (A. CONCEPCION),estado nutricional en menores de 5 anos,clasificacion d,2001-01-01,3,35,3,35,38
71502,URUBICHA,estado nutricional en menores de 5 anos,clasificacion d,2001-01-01,0,24,0,24,24
51201,UYUNI,estado nutricional en menores de 5 anos,clasificacion d,2001-01-01,7,77,7,77,84
30502,VACAS,estado nutricional en menores de 5 anos,clasificacion d,2001-01-01,3,11,3,11,14
70801,VALLEGRANDE,estado nutricional en menores de 5 anos,clasificacion d,2001-01-01,3,18,3,18,21
20801,VIACHA,estado nutricional en menores de 5 anos,clasificacion d,2001-01-01,14,80,14,80,94
31302,VILA VILA,estado nutricional en menores de 5 anos,clasificacion d,2001-01-01,1,0,1,0,1
60303,VILLA MONTES,estado nutricional en menores de 5 anos,clasificacion d,2001-01-01,19,217,19,217,236
31402,VILLA RIVERO,estado nutricional en menores de 5 anos,clasificacion d,2001-01-01,0,7,0,7,7
10801,VILLA SERRANO,estado nutricional en menores de 5 anos,clasificacion d,2001-01-01,48,223,48,223,271
31003,VILLA TUNARI,estado nutricional en menores de 5 anos,clasificacion d,2001-01-01,6,29,6,29,35
11001,VILLA VACA GUZMAN (MUYUPAMPA),estado nutricional en menores de 5 anos,clasificacion d,2001-01-01,4,174,4,174,178
51501,VILLAZON,estado nutricional en menores de 5 anos,clasificacion d,2001-01-01,4,224,4,224,228
70201,WARNES,estado nutricional en menores de 5 anos,clasificacion d,2001-01-01,0,2,0,2,2
20903,YACO,estado nutricional en menores de 5 anos,clasificacion d,2001-01-01,15,13,15,13,28
60301,YACUIBA,estado nutricional en menores de 5 anos,clasificacion d,2001-01-01,7,236,7,236,243
10602,YAMPARAEZ,estado nutricional en menores de 5 anos,clasificacion d,2001-01-01,7,373,7,373,380
21103,YANACACHI,estado nutricional en menores de 5 anos,clasificacion d,2001-01-01,0,7,0,7,7
50103,YOCALLA,estado nutricional en menores de 5 anos,clasificacion d,2001-01-01,1,41,1,41,42
10102,YOTALA,estado nutricional en menores de 5 anos,clasificacion d,2001-01-01,2,272,2,272,274
60402,YUNCHARA,estado nutricional en menores de 5 anos,clasificacion d,2001-01-01,3,54,3,54,57
10301,ZUDAÃ‘EZ,estado nutricional en menores de 5 anos,clasificacion d,2001-01-01,2,195,2,195,197
51302,ACACIO,estado nutricional en menores de 5 anos,clasificacion d,2001-02-01,2,149,2,149,151
20201,ACHACACHI,estado nutricional en menores de 5 anos,clasificacion d,2001-02-01,8,106,8,106,114
20104,ACHOCALLA,estado nutricional en menores de 5 anos,clasificacion d,2001-02-01,0,5,0,5,5
30201,AIQUILE,estado nutricional en menores de 5 anos,clasificacion d,2001-02-01,16,26,16,26,42
31303,ALALAY,estado nutricional en menores de 5 anos,clasificacion d,2001-02-01,8,0,8,0,8
10404,ALCALA,estado nutricional en menores de 5 anos,clasificacion d,2001-02-01,0,71,0,71,71
20202,ANCORAIMES,estado nutricional en menores de 5 anos,clasificacion d,2001-02-01,10,132,10,132,142
40603,ANTEQUERA,estado nutricional en menores de 5 anos,clasificacion d,2001-02-01,0,7,0,7,7
30402,ANZALDO,estado nutricional en menores de 5 anos,clasificacion d,2001-02-01,5,36,5,36,41
20701,APOLO,estado nutricional en menores de 5 anos,clasificacion d,2001-02-01,5,2,5,2,7
51301,ARAMPAMPA,estado nutricional en menores de 5 anos,clasificacion d,2001-02-01,0,63,0,63,63
30501,ARANI,estado nutricional en menores de 5 anos,clasificacion d,2001-02-01,1,37,1,37,38
30403,ARBIETO,estado nutricional en menores de 5 anos,clasificacion d,2001-02-01,1,13,1,13,14
30601,ARQUE,estado nutricional en menores de 5 anos,clasificacion d,2001-02-01,1,34,1,34,35
71501,ASCENCION DE GUARAYOS,estado nutricional en menores de 5 anos,clasificacion d,2001-02-01,1,431,1,431,432
50802,ATOCHA,estado nutricional en menores de 5 anos,clasificacion d,2001-02-01,0,7,0,7,7
20503,AUCAPATA,estado nutricional en menores de 5 anos,clasificacion d,2001-02-01,2,19,2,19,21
20502,AYATA,estado nutricional en menores de 5 anos,clasificacion d,2001-02-01,0,2,0,2,2
30301,AYOPAYA (V. DE INDEPENDENCIA),estado nutricional en menores de 5 anos,clasificacion d,2001-02-01,7,163,7,163,170
10201,AZURDUY,estado nutricional en menores de 5 anos,clasificacion d,2001-02-01,8,173,8,173,181
21203,BATALLAS,estado nutricional en menores de 5 anos,clasificacion d,2001-02-01,0,20,0,20,20
80802,BAURES,estado nutricional en menores de 5 anos,clasificacion d,2001-02-01,0,35,0,35,35
41202,BELEN DE ANDAMARCA,estado nutricional en menores de 5 anos,clasificacion d,2001-02-01,0,3,0,3,3
50104,BELEN DE URMIRI,estado nutricional en menores de 5 anos,clasificacion d,2001-02-01,1,23,1,23,24
90104,BELLA FLOR,estado nutricional en menores de 5 anos,clasificacion d,2001-02-01,0,17,0,17,17
60202,BERMEJO,estado nutricional en menores de 5 anos,clasificacion d,2001-02-01,3,29,3,29,32
50301,BETANZOS,estado nutricional en menores de 5 anos,clasificacion d,2001-02-01,19,264,19,264,283
31501,BOLIVAR,estado nutricional en menores de 5 anos,clasificacion d,2001-02-01,2,134,2,134,136
90103,BOLPEBRA,estado nutricional en menores de 5 anos,clasificacion d,2001-02-01,0,10,0,10,10
70707,BOYUIBE,estado nutricional en menores de 5 anos,clasificacion d,2001-02-01,1,24,1,24,25
70703,CABEZAS,estado nutricional en menores de 5 anos,clasificacion d,2001-02-01,54,80,54,80,134
20905,CAIROMA,estado nutricional en menores de 5 anos,clasificacion d,2001-02-01,15,11,15,11,26
51102,"CAIZA ""D""",estado nutricional en menores de 5 anos,clasificacion d,2001-02-01,6,137,6,137,143
21003,CAJUATA,estado nutricional en menores de 5 anos,clasificacion d,2001-02-01,0,57,0,57,57
21304,CALAMARCA,estado nutricional en menores de 5 anos,clasificacion d,2001-02-01,0,18,0,18,18
10701,CAMARGO,estado nutricional en menores de 5 anos,clasificacion d,2001-02-01,0,53,0,53,53
10901,CAMATAQUI (C. VILLA ABECIA),estado nutricional en menores de 5 anos,clasificacion d,2001-02-01,0,44,0,44,44
70706,CAMIRI,estado nutricional en menores de 5 anos,clasificacion d,2001-02-01,1,194,1,194,195
30701,CAPINOTA,estado nutricional en menores de 5 anos,clasificacion d,2001-02-01,34,10,34,10,44
20302,CAQUIAVIRI,estado nutricional en menores de 5 anos,clasificacion d,2001-02-01,2,29,2,29,31
40102,CARACOLLO,estado nutricional en menores de 5 anos,clasificacion d,2001-02-01,2,69,2,69,71
22001,CARANAVI,estado nutricional en menores de 5 anos,clasificacion d,2001-02-01,2,134,2,134,136
41503,CARANGAS,estado nutricional en menores de 5 anos,clasificacion d,2001-02-01,0,2,0,2,2
60302,CARAPARI,estado nutricional en menores de 5 anos,clasificacion d,2001-02-01,1,56,1,56,57
50702,CARIPUYO,estado nutricional en menores de 5 anos,clasificacion d,2001-02-01,1,115,1,115,116
40201,CHALLAPATA,estado nutricional en menores de 5 anos,clasificacion d,2001-02-01,1,48,1,48,49
50302,CHAQUI,estado nutricional en menores de 5 anos,clasificacion d,2001-02-01,0,124,0,124,124
70702,CHARAGUA,estado nutricional en menores de 5 anos,clasificacion d,2001-02-01,104,169,104,169,273
20305,CHARAÃ‘A,estado nutricional en menores de 5 anos,clasificacion d,2001-02-01,0,6,0,6,6
50202,CHAYANTA,estado nutricional en menores de 5 anos,clasificacion d,2001-02-01,2,132,2,132,134
31204,CHIMORE,estado nutricional en menores de 5 anos,clasificacion d,2001-02-01,2,53,2,53,55
40903,CHIPAYA,estado nutricional en menores de 5 anos,clasificacion d,2001-02-01,0,2,0,2,2
40302,CHOQUE COTA,estado nutricional en menores de 5 anos,clasificacion d,2001-02-01,0,16,0,16,16
21101,CHULUMANI (V. DE LA LIBERTAD),estado nutricional en menores de 5 anos,clasificacion d,2001-02-01,2,24,2,24,26
20501,CHUMA,estado nutricional en menores de 5 anos,clasificacion d,2001-02-01,0,14,0,14,14
30801,CLIZA,estado nutricional en menores de 5 anos,clasificacion d,2001-02-01,2,20,2,20,22
90101,COBIJA,estado nutricional en menores de 5 anos,clasificacion d,2001-02-01,0,63,0,63,63
30101,COCHABAMBA,estado nutricional en menores de 5 anos,clasificacion d,2001-02-01,323,339,323,339,662
40902,COIPASA,estado nutricional en menores de 5 anos,clasificacion d,2001-02-01,0,4,0,4,4
30905,COLCAPIRHUA,estado nutricional en menores de 5 anos,clasificacion d,2001-02-01,3,104,3,104,107
50901,"COLCHA ""K""",estado nutricional en menores de 5 anos,clasificacion d,2001-02-01,4,61,4,61,65
31002,COLOMI,estado nutricional en menores de 5 anos,clasificacion d,2001-02-01,3,11,3,11,14
70603,COLPA BELGICA,estado nutricional en menores de 5 anos,clasificacion d,2001-02-01,6,7,6,7,13
50401,COLQUECHACA,estado nutricional en menores de 5 anos,clasificacion d,2001-02-01,11,125,11,125,136
21306,COLQUENCHA,estado nutricional en menores de 5 anos,clasificacion d,2001-02-01,2,3,2,3,5
21004,COLQUIRI,estado nutricional en menores de 5 anos,clasificacion d,2001-02-01,1,99,1,99,100
20304,COMANCHE,estado nutricional en menores de 5 anos,clasificacion d,2001-02-01,0,21,0,21,21
71301,COMARAPA,estado nutricional en menores de 5 anos,clasificacion d,2001-02-01,1,42,1,42,43
20605,COMBAYA,estado nutricional en menores de 5 anos,clasificacion d,2001-02-01,1,12,1,12,13
71101,CONCEPCION,estado nutricional en menores de 5 anos,clasificacion d,2001-02-01,12,79,12,79,91
21701,COPACABANA,estado nutricional en menores de 5 anos,clasificacion d,2001-02-01,0,71,0,71,71
21402,CORIPATA,estado nutricional en menores de 5 anos,clasificacion d,2001-02-01,4,22,4,22,26
20301,CORO CORO,estado nutricional en menores de 5 anos,clasificacion d,2001-02-01,1,29,1,29,30
21401,COROICO,estado nutricional en menores de 5 anos,clasificacion d,2001-02-01,0,14,0,14,14
40301,CORQUE,estado nutricional en menores de 5 anos,clasificacion d,2001-02-01,1,14,1,14,15
50601,COTAGAITA,estado nutricional en menores de 5 anos,clasificacion d,2001-02-01,7,137,7,137,144
70102,COTOCA,estado nutricional en menores de 5 anos,clasificacion d,2001-02-01,5,49,5,49,54
70704,CUEVO,estado nutricional en menores de 5 anos,clasificacion d,2001-02-01,0,55,0,55,55
10902,CULPINA,estado nutricional en menores de 5 anos,clasificacion d,2001-02-01,14,185,14,185,199
40401,CURAHUARA DE CARANGAS,estado nutricional en menores de 5 anos,clasificacion d,2001-02-01,0,17,0,17,17
21602,CURVA,estado nutricional en menores de 5 anos,clasificacion d,2001-02-01,0,12,0,12,12
20804,DESAGUADERO,estado nutricional en menores de 5 anos,clasificacion d,2001-02-01,2,20,2,20,22
20105,EL ALTO,estado nutricional en menores de 5 anos,clasificacion d,2001-02-01,242,1351,242,1351,1593
40103,EL CHORO,estado nutricional en menores de 5 anos,clasificacion d,2001-02-01,0,3,0,3,3
71503,EL PUENTE(STC),estado nutricional en menores de 5 anos,clasificacion d,2001-02-01,10,76,10,76,86
60502,EL PUENTE(TJA),estado nutricional en menores de 5 anos,clasificacion d,2001-02-01,0,59,0,59,59
70105,EL TORNO,estado nutricional en menores de 5 anos,clasificacion d,2001-02-01,7,62,7,62,69
10405,EL VILLAR,estado nutricional en menores de 5 anos,clasificacion d,2001-02-01,14,190,14,190,204
60601,ENTRE RIOS,estado nutricional en menores de 5 anos,clasificacion d,2001-02-01,2,90,2,90,92
41101,EUCALIPTUS,estado nutricional en menores de 5 anos,clasificacion d,2001-02-01,0,19,0,19,19
80402,EXALTACION,estado nutricional en menores de 5 anos,clasificacion d,2001-02-01,1,1,1,1,2
90203,FILADELFIA,estado nutricional en menores de 5 anos,clasificacion d,2001-02-01,0,1,0,1,1
71002,GENERAL SAAVEDRA,estado nutricional en menores de 5 anos,clasificacion d,2001-02-01,2,147,2,147,149
21601,GRAL. J.J. PEREZ (CHARAZANI),estado nutricional en menores de 5 anos,clasificacion d,2001-02-01,1,25,1,25,26
20602,GUANAY,estado nutricional en menores de 5 anos,clasificacion d,2001-02-01,0,56,0,56,56
20802,GUAQUI,estado nutricional en menores de 5 anos,clasificacion d,2001-02-01,2,6,2,6,8
80202,GUAYARAMERIN,estado nutricional en menores de 5 anos,clasificacion d,2001-02-01,4,74,4,74,78
70705,GUTIERREZ,estado nutricional en menores de 5 anos,clasificacion d,2001-02-01,17,187,17,187,204
10502,HUACARETA,estado nutricional en menores de 5 anos,clasificacion d,2001-02-01,9,175,9,175,184
11002,HUACAYA (VILLA DE HUACAYA),estado nutricional en menores de 5 anos,clasificacion d,2001-02-01,0,10,0,10,10
40501,HUACHACALLA,estado nutricional en menores de 5 anos,clasificacion d,2001-02-01,2,0,2,0,2
40701,HUANUNI,estado nutricional en menores de 5 anos,clasificacion d,2001-02-01,2,144,2,144,146
80803,HUARACAJE,estado nutricional en menores de 5 anos,clasificacion d,2001-02-01,1,5,1,5,6
41601,HUAYLLAMARCA,estado nutricional en menores de 5 anos,clasificacion d,2001-02-01,0,16,0,16,16
21005,ICHOCA,estado nutricional en menores de 5 anos,clasificacion d,2001-02-01,2,19,2,19,21
10304,ICLA,estado nutricional en menores de 5 anos,clasificacion d,2001-02-01,4,268,4,268,272
10703,INCAHUASI,estado nutricional en menores de 5 anos,clasificacion d,2001-02-01,1,185,1,185,186
21001,INQUISIVI,estado nutricional en menores de 5 anos,clasificacion d,2001-02-01,0,59,0,59,59
21102,IRUPANA (VILLA DE LANZA),estado nutricional en menores de 5 anos,clasificacion d,2001-02-01,5,81,5,81,86
21501,IXIAMAS,estado nutricional en menores de 5 anos,clasificacion d,2001-02-01,3,47,3,47,50
21105,LA ASUNTA,estado nutricional en menores de 5 anos,clasificacion d,2001-02-01,17,107,17,107,124
70104,LA GUARDIA,estado nutricional en menores de 5 anos,clasificacion d,2001-02-01,5,94,5,94,99
20101,LA PAZ,estado nutricional en menores de 5 anos,clasificacion d,2001-02-01,103,939,103,939,1042
70701,LAGUNILLAS,estado nutricional en menores de 5 anos,clasificacion d,2001-02-01,18,22,18,22,40
21202,LAJA,estado nutricional en menores de 5 anos,clasificacion d,2001-02-01,1,39,1,39,40
10903,LAS CARRERAS,estado nutricional en menores de 5 anos,clasificacion d,2001-02-01,0,69,0,69,69
21006,LICOMA PAMPA,estado nutricional en menores de 5 anos,clasificacion d,2001-02-01,0,8,0,8,8
50203,LLALLAGUA,estado nutricional en menores de 5 anos,clasificacion d,2001-02-01,8,101,8,101,109
51401,LLICA,estado nutricional en menores de 5 anos,clasificacion d,2001-02-01,0,5,0,5,5
80601,LORETO,estado nutricional en menores de 5 anos,clasificacion d,2001-02-01,0,8,0,8,8
20901,LURIBAY,estado nutricional en menores de 5 anos,clasificacion d,2001-02-01,5,2,5,2,7
40702,MACHACAMARCA,estado nutricional en menores de 5 anos,clasificacion d,2001-02-01,0,1,0,1,1
11003,MACHARETI,estado nutricional en menores de 5 anos,clasificacion d,2001-02-01,4,132,4,132,136
80801,MAGDALENA,estado nutricional en menores de 5 anos,clasificacion d,2001-02-01,1,3,1,3,4
70903,MAIRANA,estado nutricional en menores de 5 anos,clasificacion d,2001-02-01,2,21,2,21,23
20904,MALLA,estado nutricional en menores de 5 anos,clasificacion d,2001-02-01,6,4,6,4,10
71003,MINEROS,estado nutricional en menores de 5 anos,clasificacion d,2001-02-01,13,237,13,237,250
31301,MIZQUE,estado nutricional en menores de 5 anos,clasificacion d,2001-02-01,32,9,32,9,41
20402,MOCOMOCO,estado nutricional en menores de 5 anos,clasificacion d,2001-02-01,7,79,7,79,86
51002,MOJINETE,estado nutricional en menores de 5 anos,clasificacion d,2001-02-01,0,13,0,13,13
10303,MOJOCOYA,estado nutricional en menores de 5 anos,clasificacion d,2001-02-01,4,180,4,180,184
10501,MONTEAGUDO,estado nutricional en menores de 5 anos,clasificacion d,2001-02-01,10,271,10,271,281
71001,MONTERO,estado nutricional en menores de 5 anos,clasificacion d,2001-02-01,73,330,73,330,403
70803,MORO MORO,estado nutricional en menores de 5 anos,clasificacion d,2001-02-01,0,3,0,3,3
30302,MOROCHATA,estado nutricional en menores de 5 anos,clasificacion d,2001-02-01,14,49,14,49,63
90401,NACEBE (SANTA ROSA DEL ABUNA),estado nutricional en menores de 5 anos,clasificacion d,2001-02-01,0,12,0,12,12
50404,OCURI,estado nutricional en menores de 5 anos,clasificacion d,2001-02-01,19,95,19,95,114
70202,OKINAWA,estado nutricional en menores de 5 anos,clasificacion d,2001-02-01,0,25,0,25,25
30203,OMEREQUE,estado nutricional en menores de 5 anos,clasificacion d,2001-02-01,0,37,0,37,37
40101,ORURO,estado nutricional en menores de 5 anos,clasificacion d,2001-02-01,45,556,45,556,601
60201,PADCAYA,estado nutricional en menores de 5 anos,clasificacion d,2001-02-01,2,63,2,63,65
10401,PADILLA,estado nutricional en menores de 5 anos,clasificacion d,2001-02-01,2,230,2,230,232
70502,PAILON,estado nutricional en menores de 5 anos,clasificacion d,2001-02-01,3,9,3,9,12
21104,PALOS BLANCOS,estado nutricional en menores de 5 anos,clasificacion d,2001-02-01,9,167,9,167,176
40802,PAMPA AULLAGAS,estado nutricional en menores de 5 anos,clasificacion d,2001-02-01,0,9,0,9,9
70902,PAMPA GRANDE,estado nutricional en menores de 5 anos,clasificacion d,2001-02-01,1,27,1,27,28
21802,PAPEL PAMPA,estado nutricional en menores de 5 anos,clasificacion d,2001-02-01,0,5,0,5,5
30202,PASORAPA,estado nutricional en menores de 5 anos,clasificacion d,2001-02-01,0,15,0,15,15
40602,PAZÃ‘A,estado nutricional en menores de 5 anos,clasificacion d,2001-02-01,1,30,1,30,31
20702,PELECHUCO,estado nutricional en menores de 5 anos,clasificacion d,2001-02-01,1,14,1,14,15
50403,POCOATA,estado nutricional en menores de 5 anos,clasificacion d,2001-02-01,11,120,11,120,131
31203,POCONA,estado nutricional en menores de 5 anos,clasificacion d,2001-02-01,2,23,2,23,25
31202,POJO (CBBA),estado nutricional en menores de 5 anos,clasificacion d,2001-02-01,20,131,20,131,151
40601,POOPO,estado nutricional en menores de 5 anos,clasificacion d,2001-02-01,2,6,2,6,8
51203,PORCO,estado nutricional en menores de 5 anos,clasificacion d,2001-02-01,0,28,0,28,28
10103,POROMA,estado nutricional en menores de 5 anos,clasificacion d,2001-02-01,3,161,3,161,164
70103,PORONGO,estado nutricional en menores de 5 anos,clasificacion d,2001-02-01,0,30,0,30,30
70601,PORTACHUELO,estado nutricional en menores de 5 anos,clasificacion d,2001-02-01,4,101,4,101,105
90102,PORVENIR,estado nutricional en menores de 5 anos,clasificacion d,2001-02-01,6,24,6,24,30
50101,POTOSI,estado nutricional en menores de 5 anos,clasificacion d,2001-02-01,15,433,15,433,448
10302,PRESTO,estado nutricional en menores de 5 anos,clasificacion d,2001-02-01,4,137,4,137,141
70805,PUCARA,estado nutricional en menores de 5 anos,clasificacion d,2001-02-01,0,1,0,1,1
21201,PUCARANI,estado nutricional en menores de 5 anos,clasificacion d,2001-02-01,3,40,3,40,43
20401,PUERTO ACOSTA,estado nutricional en menores de 5 anos,clasificacion d,2001-02-01,31,152,31,152,183
20403,PUERTO CARABUCO,estado nutricional en menores de 5 anos,clasificacion d,2001-02-01,15,116,15,116,131
90301,PUERTO GONZALO MORENO,estado nutricional en menores de 5 anos,clasificacion d,2001-02-01,0,18,0,18,18
21204,PUERTO PEREZ,estado nutricional en menores de 5 anos,clasificacion d,2001-02-01,5,17,5,17,22
71402,PUERTO QUIJARRO,estado nutricional en menores de 5 anos,clasificacion d,2001-02-01,4,39,4,39,43
90201,PUERTO RICO,estado nutricional en menores de 5 anos,clasificacion d,2001-02-01,2,30,2,30,32
80703,PUERTO SILES,estado nutricional en menores de 5 anos,clasificacion d,2001-02-01,1,2,1,2,3
71401,PUERTO SUAREZ,estado nutricional en menores de 5 anos,clasificacion d,2001-02-01,11,46,11,46,57
31205,PUERTO VILLARROEL,estado nutricional en menores de 5 anos,clasificacion d,2001-02-01,17,125,17,125,142
51101,PUNA,estado nutricional en menores de 5 anos,clasificacion d,2001-02-01,0,228,0,228,228
31401,PUNATA,estado nutricional en menores de 5 anos,clasificacion d,2001-02-01,8,35,8,35,43
20604,QUIABAYA,estado nutricional en menores de 5 anos,clasificacion d,2001-02-01,1,46,1,46,47
30901,QUILLACOLLO,estado nutricional en menores de 5 anos,clasificacion d,2001-02-01,1,14,1,14,15
21002,QUIME,estado nutricional en menores de 5 anos,clasificacion d,2001-02-01,2,86,2,86,88
70904,QUIRUSILLAS,estado nutricional en menores de 5 anos,clasificacion d,2001-02-01,3,0,3,0,3
50402,RAVELO,estado nutricional en menores de 5 anos,clasificacion d,2001-02-01,13,191,13,191,204
80301,REYES,estado nutricional en menores de 5 anos,clasificacion d,2001-02-01,2,62,2,62,64
80201,RIBERALTA,estado nutricional en menores de 5 anos,clasificacion d,2001-02-01,6,264,6,264,270
70503,ROBORE,estado nutricional en menores de 5 anos,clasificacion d,2001-02-01,9,51,9,51,60
80304,RURRENABAQUE,estado nutricional en menores de 5 anos,clasificacion d,2001-02-01,7,5,7,5,12
40901,SABAYA,estado nutricional en menores de 5 anos,clasificacion d,2001-02-01,0,3,0,3,3
31001,SACABA,estado nutricional en menores de 5 anos,clasificacion d,2001-02-01,37,105,37,105,142
30404,SACABAMBA,estado nutricional en menores de 5 anos,clasificacion d,2001-02-01,3,64,3,64,67
50701,SACACA,estado nutricional en menores de 5 anos,clasificacion d,2001-02-01,10,514,10,514,524
71302,SAIPINA,estado nutricional en menores de 5 anos,clasificacion d,2001-02-01,0,28,0,28,28
40801,SALINAS DE GARCI MENDOZA,estado nutricional en menores de 5 anos,clasificacion d,2001-02-01,0,3,0,3,3
70901,SAMAIPATA,estado nutricional en menores de 5 anos,clasificacion d,2001-02-01,1,31,1,31,32
51601,SAN AGUSTIN,estado nutricional en menores de 5 anos,clasificacion d,2001-02-01,2,11,2,11,13
80602,SAN ANDRES,estado nutricional en menores de 5 anos,clasificacion d,2001-02-01,1,45,1,45,46
71105,SAN ANTONIO DE LOMERIO,estado nutricional en menores de 5 anos,clasificacion d,2001-02-01,28,175,28,175,203
31403,SAN BENITO,estado nutricional en menores de 5 anos,clasificacion d,2001-02-01,1,75,1,75,76
80302,SAN BORJA,estado nutricional en menores de 5 anos,clasificacion d,2001-02-01,4,152,4,152,156
21502,SAN BUENA VENTURA,estado nutricional en menores de 5 anos,clasificacion d,2001-02-01,1,83,1,83,84
70402,SAN CARLOS,estado nutricional en menores de 5 anos,clasificacion d,2001-02-01,0,7,0,7,7
80501,SAN IGNACIO,estado nutricional en menores de 5 anos,clasificacion d,2001-02-01,5,83,5,83,88
70301,SAN IGNACIO DE VELASCO,estado nutricional en menores de 5 anos,clasificacion d,2001-02-01,15,259,15,259,274
80102,SAN JAVIER(BNI),estado nutricional en menores de 5 anos,clasificacion d,2001-02-01,0,17,0,17,17
80701,SAN JOAQUIN,estado nutricional en menores de 5 anos,clasificacion d,2001-02-01,1,16,1,16,17
70501,SAN JOSE DE CHIQUITOS,estado nutricional en menores de 5 anos,clasificacion d,2001-02-01,2,51,2,51,53
71104,SAN JULIAN,estado nutricional en menores de 5 anos,clasificacion d,2001-02-01,3,216,3,216,219
90302,SAN LORENZO(PND),estado nutricional en menores de 5 anos,clasificacion d,2001-02-01,1,0,1,0,1
60501,SAN LORENZO(TJA),estado nutricional en menores de 5 anos,clasificacion d,2001-02-01,0,34,0,34,34
10702,SAN LUCAS,estado nutricional en menores de 5 anos,clasificacion d,2001-02-01,9,362,9,362,371
71201,SAN MATIAS,estado nutricional en menores de 5 anos,clasificacion d,2001-02-01,4,50,4,50,54
70302,SAN MIGUEL DE VELASCO,estado nutricional en menores de 5 anos,clasificacion d,2001-02-01,15,200,15,200,215
51001,SAN PABLO DE LIPEZ,estado nutricional en menores de 5 anos,clasificacion d,2001-02-01,0,4,0,4,4
50501,SAN PEDRO DE BUENA VISTA,estado nutricional en menores de 5 anos,clasificacion d,2001-02-01,8,161,8,161,169
50902,SAN PEDRO DE QUEMES,estado nutricional en menores de 5 anos,clasificacion d,2001-02-01,0,1,0,1,1
21702,SAN PEDRO DE TIQUINA,estado nutricional en menores de 5 anos,clasificacion d,2001-02-01,0,4,0,4,4
90202,SAN PEDRO(PND),estado nutricional en menores de 5 anos,clasificacion d,2001-02-01,0,1,0,1,1
70303,SAN RAFAEL,estado nutricional en menores de 5 anos,clasificacion d,2001-02-01,2,13,2,13,15
80702,SAN RAMON,estado nutricional en menores de 5 anos,clasificacion d,2001-02-01,0,3,0,3,3
80702,SAN RAMON,estado nutricional en menores de 5 anos,clasificacion d,2001-02-01,0,6,0,6,6
80401,SANTA ANA,estado nutricional en menores de 5 anos,clasificacion d,2001-02-01,34,23,34,23,57
70101,SANTA CRUZ DE LA SIERRA,estado nutricional en menores de 5 anos,clasificacion d,2001-02-01,61,225,61,225,286
80303,SANTA ROSA,estado nutricional en menores de 5 anos,clasificacion d,2001-02-01,1,23,1,23,24
70602,SANTA ROSA DEL SARA,estado nutricional en menores de 5 anos,clasificacion d,2001-02-01,0,1,0,1,1
20308,SANTIAGO DE CALLAPA,estado nutricional en menores de 5 anos,clasificacion d,2001-02-01,0,2,0,2,2
41401,SANTIAGO DE HUARI,estado nutricional en menores de 5 anos,clasificacion d,2001-02-01,1,35,1,35,36
30702,SANTIVAÃ‘ES,estado nutricional en menores de 5 anos,clasificacion d,2001-02-01,8,24,8,24,32
40202,SANTUARIO DE QUILLACAS,estado nutricional en menores de 5 anos,clasificacion d,2001-02-01,1,12,1,12,13
90303,SENA,estado nutricional en menores de 5 anos,clasificacion d,2001-02-01,1,0,1,0,1
21301,SICA SICA (VILLA AROMA),estado nutricional en menores de 5 anos,clasificacion d,2001-02-01,0,37,0,37,37
30703,SICAYA,estado nutricional en menores de 5 anos,clasificacion d,2001-02-01,1,23,1,23,24
30902,SIPE SIPE,estado nutricional en menores de 5 anos,clasificacion d,2001-02-01,5,191,5,191,196
10403,SOPACHUY,estado nutricional en menores de 5 anos,clasificacion d,2001-02-01,176,186,176,186,362
20601,SORATA,estado nutricional en menores de 5 anos,clasificacion d,2001-02-01,4,70,4,70,74
10101,SUCRE,estado nutricional en menores de 5 anos,clasificacion d,2001-02-01,51,1104,51,1104,1155
31404,TACACHI,estado nutricional en menores de 5 anos,clasificacion d,2001-02-01,1,8,1,8,9
20603,TACACOMA,estado nutricional en menores de 5 anos,clasificacion d,2001-02-01,14,43,14,43,57
50303,TACOBAMBA,estado nutricional en menores de 5 anos,clasificacion d,2001-02-01,0,56,0,56,56
30602,TACOPAYA,estado nutricional en menores de 5 anos,clasificacion d,2001-02-01,4,101,4,101,105
51402,TAHUA,estado nutricional en menores de 5 anos,clasificacion d,2001-02-01,0,2,0,2,2
31101,TAPACARI,estado nutricional en menores de 5 anos,clasificacion d,2001-02-01,8,59,8,59,67
10601,TARABUCO,estado nutricional en menores de 5 anos,clasificacion d,2001-02-01,14,625,14,625,639
30401,TARATA,estado nutricional en menores de 5 anos,clasificacion d,2001-02-01,0,37,0,37,37
60101,TARIJA,estado nutricional en menores de 5 anos,clasificacion d,2001-02-01,4,194,4,194,198
10202,TARVITA,estado nutricional en menores de 5 anos,clasificacion d,2001-02-01,2,131,2,131,133
20803,TIAWANACU,estado nutricional en menores de 5 anos,clasificacion d,2001-02-01,3,22,3,22,25
50102,TINGUIPAYA,estado nutricional en menores de 5 anos,clasificacion d,2001-02-01,3,66,3,66,69
20606,TIPUANI,estado nutricional en menores de 5 anos,clasificacion d,2001-02-01,3,9,3,9,12
30903,TIQUIPAYA,estado nutricional en menores de 5 anos,clasificacion d,2001-02-01,16,44,16,44,60
31601,TIRAQUE (CBBA),estado nutricional en menores de 5 anos,clasificacion d,2001-02-01,4,109,4,109,113
21703,TITO YUPANQUI (PARQUIPUJIO),estado nutricional en menores de 5 anos,clasificacion d,2001-02-01,0,10,0,10,10
30802,TOCO,estado nutricional en menores de 5 anos,clasificacion d,2001-02-01,0,2,0,2,2
30803,TOLATA,estado nutricional en menores de 5 anos,clasificacion d,2001-02-01,2,5,2,5,7
41001,TOLEDO,estado nutricional en menores de 5 anos,clasificacion d,2001-02-01,1,16,1,16,17
51202,TOMAVE,estado nutricional en menores de 5 anos,clasificacion d,2001-02-01,11,104,11,104,115
10402,TOMINA,estado nutricional en menores de 5 anos,clasificacion d,2001-02-01,2,215,2,215,217
50502,TORO TORO,estado nutricional en menores de 5 anos,clasificacion d,2001-02-01,0,10,0,10,10
31201,TOTORA(CBBA),estado nutricional en menores de 5 anos,clasificacion d,2001-02-01,2,71,2,71,73
41301,TOTORA(ORR),estado nutricional en menores de 5 anos,clasificacion d,2001-02-01,0,21,0,21,21
70802,TRIGAL,estado nutricional en menores de 5 anos,clasificacion d,2001-02-01,1,7,1,7,8
80101,TRINIDAD,estado nutricional en menores de 5 anos,clasificacion d,2001-02-01,14,136,14,136,150
50801,TUPIZA,estado nutricional en menores de 5 anos,clasificacion d,2001-02-01,4,213,4,213,217
40402,TURCO,estado nutricional en menores de 5 anos,clasificacion d,2001-02-01,0,2,0,2,2
21302,UMALA,estado nutricional en menores de 5 anos,clasificacion d,2001-02-01,0,5,0,5,5
50201,UNCIA,estado nutricional en menores de 5 anos,clasificacion d,2001-02-01,9,142,9,142,151
60401,URIONDO (A. CONCEPCION),estado nutricional en menores de 5 anos,clasificacion d,2001-02-01,2,31,2,31,33
51201,UYUNI,estado nutricional en menores de 5 anos,clasificacion d,2001-02-01,1,52,1,52,53
30502,VACAS,estado nutricional en menores de 5 anos,clasificacion d,2001-02-01,2,16,2,16,18
70801,VALLEGRANDE,estado nutricional en menores de 5 anos,clasificacion d,2001-02-01,1,50,1,50,51
20801,VIACHA,estado nutricional en menores de 5 anos,clasificacion d,2001-02-01,5,91,5,91,96
31302,VILA VILA,estado nutricional en menores de 5 anos,clasificacion d,2001-02-01,14,6,14,6,20
60303,VILLA MONTES,estado nutricional en menores de 5 anos,clasificacion d,2001-02-01,10,103,10,103,113
31402,VILLA RIVERO,estado nutricional en menores de 5 anos,clasificacion d,2001-02-01,3,28,3,28,31
10801,VILLA SERRANO,estado nutricional en menores de 5 anos,clasificacion d,2001-02-01,28,225,28,225,253
31003,VILLA TUNARI,estado nutricional en menores de 5 anos,clasificacion d,2001-02-01,6,74,6,74,80
11001,VILLA VACA GUZMAN (MUYUPAMPA),estado nutricional en menores de 5 anos,clasificacion d,2001-02-01,1,209,1,209,210
51501,VILLAZON,estado nutricional en menores de 5 anos,clasificacion d,2001-02-01,4,170,4,170,174
50602,VITICHI,estado nutricional en menores de 5 anos,clasificacion d,2001-02-01,0,11,0,11,11
20306,WALDO BALLIVIAN,estado nutricional en menores de 5 anos,clasificacion d,2001-02-01,0,12,0,12,12
70201,WARNES,estado nutricional en menores de 5 anos,clasificacion d,2001-02-01,2,80,2,80,82
60301,YACUIBA,estado nutricional en menores de 5 anos,clasificacion d,2001-02-01,13,158,13,158,171
10602,YAMPARAEZ,estado nutricional en menores de 5 anos,clasificacion d,2001-02-01,4,397,4,397,401
21103,YANACACHI,estado nutricional en menores de 5 anos,clasificacion d,2001-02-01,0,19,0,19,19
50103,YOCALLA,estado nutricional en menores de 5 anos,clasificacion d,2001-02-01,2,116,2,116,118
10102,YOTALA,estado nutricional en menores de 5 anos,clasificacion d,2001-02-01,5,324,5,324,329
60402,YUNCHARA,estado nutricional en menores de 5 anos,clasificacion d,2001-02-01,3,30,3,30,33
10301,ZUDAÃ‘EZ,estado nutricional en menores de 5 anos,clasificacion d,2001-02-01,2,205,2,205,207
51302,ACACIO,estado nutricional en menores de 5 anos,clasificacion d,2001-03-01,1,116,1,116,117
20201,ACHACACHI,estado nutricional en menores de 5 anos,clasificacion d,2001-03-01,11,232,11,232,243
20104,ACHOCALLA,estado nutricional en menores de 5 anos,clasificacion d,2001-03-01,0,8,0,8,8
30201,AIQUILE,estado nutricional en menores de 5 anos,clasificacion d,2001-03-01,7,97,7,97,104
31303,ALALAY,estado nutricional en menores de 5 anos,clasificacion d,2001-03-01,16,5,16,5,21
10404,ALCALA,estado nutricional en menores de 5 anos,clasificacion d,2001-03-01,1,99,1,99,100
20202,ANCORAIMES,estado nutricional en menores de 5 anos,clasificacion d,2001-03-01,2,181,2,181,183
41201,ANDAMARCA,estado nutricional en menores de 5 anos,clasificacion d,2001-03-01,0,10,0,10,10
40603,ANTEQUERA,estado nutricional en menores de 5 anos,clasificacion d,2001-03-01,0,10,0,10,10
30402,ANZALDO,estado nutricional en menores de 5 anos,clasificacion d,2001-03-01,4,88,4,88,92
20701,APOLO,estado nutricional en menores de 5 anos,clasificacion d,2001-03-01,1,10,1,10,11
51301,ARAMPAMPA,estado nutricional en menores de 5 anos,clasificacion d,2001-03-01,1,64,1,64,65
30501,ARANI,estado nutricional en menores de 5 anos,clasificacion d,2001-03-01,5,44,5,44,49
30403,ARBIETO,estado nutricional en menores de 5 anos,clasificacion d,2001-03-01,0,21,0,21,21
30601,ARQUE,estado nutricional en menores de 5 anos,clasificacion d,2001-03-01,0,57,0,57,57
50802,ATOCHA,estado nutricional en menores de 5 anos,clasificacion d,2001-03-01,0,47,0,47,47
20503,AUCAPATA,estado nutricional en menores de 5 anos,clasificacion d,2001-03-01,0,18,0,18,18
20502,AYATA,estado nutricional en menores de 5 anos,clasificacion d,2001-03-01,0,3,0,3,3
21303,AYO AYO,estado nutricional en menores de 5 anos,clasificacion d,2001-03-01,0,8,0,8,8
30301,AYOPAYA (V. DE INDEPENDENCIA),estado nutricional en menores de 5 anos,clasificacion d,2001-03-01,9,176,9,176,185
10201,AZURDUY,estado nutricional en menores de 5 anos,clasificacion d,2001-03-01,8,230,8,230,238
21203,BATALLAS,estado nutricional en menores de 5 anos,clasificacion d,2001-03-01,0,27,0,27,27
80802,BAURES,estado nutricional en menores de 5 anos,clasificacion d,2001-03-01,3,55,3,55,58
50104,BELEN DE URMIRI,estado nutricional en menores de 5 anos,clasificacion d,2001-03-01,1,26,1,26,27
90104,BELLA FLOR,estado nutricional en menores de 5 anos,clasificacion d,2001-03-01,0,16,0,16,16
60202,BERMEJO,estado nutricional en menores de 5 anos,clasificacion d,2001-03-01,4,9,4,9,13
50301,BETANZOS,estado nutricional en menores de 5 anos,clasificacion d,2001-03-01,22,308,22,308,330
31501,BOLIVAR,estado nutricional en menores de 5 anos,clasificacion d,2001-03-01,9,57,9,57,66
90103,BOLPEBRA,estado nutricional en menores de 5 anos,clasificacion d,2001-03-01,0,8,0,8,8
70707,BOYUIBE,estado nutricional en menores de 5 anos,clasificacion d,2001-03-01,1,46,1,46,47
70401,BUENA VISTA,estado nutricional en menores de 5 anos,clasificacion d,2001-03-01,9,59,9,59,68
70703,CABEZAS,estado nutricional en menores de 5 anos,clasificacion d,2001-03-01,2,25,2,25,27
20905,CAIROMA,estado nutricional en menores de 5 anos,clasificacion d,2001-03-01,20,30,20,30,50
51102,"CAIZA ""D""",estado nutricional en menores de 5 anos,clasificacion d,2001-03-01,14,206,14,206,220
21003,CAJUATA,estado nutricional en menores de 5 anos,clasificacion d,2001-03-01,1,57,1,57,58
20303,CALACOTO,estado nutricional en menores de 5 anos,clasificacion d,2001-03-01,3,1,3,1,4
21304,CALAMARCA,estado nutricional en menores de 5 anos,clasificacion d,2001-03-01,1,36,1,36,37
10701,CAMARGO,estado nutricional en menores de 5 anos,clasificacion d,2001-03-01,3,116,3,116,119
10901,CAMATAQUI (C. VILLA ABECIA),estado nutricional en menores de 5 anos,clasificacion d,2001-03-01,1,53,1,53,54
70706,CAMIRI,estado nutricional en menores de 5 anos,clasificacion d,2001-03-01,9,191,9,191,200
30701,CAPINOTA,estado nutricional en menores de 5 anos,clasificacion d,2001-03-01,25,29,25,29,54
20302,CAQUIAVIRI,estado nutricional en menores de 5 anos,clasificacion d,2001-03-01,1,34,1,34,35
40102,CARACOLLO,estado nutricional en menores de 5 anos,clasificacion d,2001-03-01,2,77,2,77,79
22001,CARANAVI,estado nutricional en menores de 5 anos,clasificacion d,2001-03-01,7,260,7,260,267
41503,CARANGAS,estado nutricional en menores de 5 anos,clasificacion d,2001-03-01,0,1,0,1,1
60302,CARAPARI,estado nutricional en menores de 5 anos,clasificacion d,2001-03-01,2,49,2,49,51
50702,CARIPUYO,estado nutricional en menores de 5 anos,clasificacion d,2001-03-01,3,120,3,120,123
21902,CATACORA,estado nutricional en menores de 5 anos,clasificacion d,2001-03-01,0,5,0,5,5
21803,CHACARILLA,estado nutricional en menores de 5 anos,clasificacion d,2001-03-01,0,5,0,5,5
40201,CHALLAPATA,estado nutricional en menores de 5 anos,clasificacion d,2001-03-01,1,60,1,60,61
50302,CHAQUI,estado nutricional en menores de 5 anos,clasificacion d,2001-03-01,0,87,0,87,87
70702,CHARAGUA,estado nutricional en menores de 5 anos,clasificacion d,2001-03-01,7,260,7,260,267
20305,CHARAÃ‘A,estado nutricional en menores de 5 anos,clasificacion d,2001-03-01,0,5,0,5,5
50202,CHAYANTA,estado nutricional en menores de 5 anos,clasificacion d,2001-03-01,0,119,0,119,119
31204,CHIMORE,estado nutricional en menores de 5 anos,clasificacion d,2001-03-01,1,48,1,48,49
40903,CHIPAYA,estado nutricional en menores de 5 anos,clasificacion d,2001-03-01,0,9,0,9,9
40302,CHOQUE COTA,estado nutricional en menores de 5 anos,clasificacion d,2001-03-01,0,2,0,2,2
21101,CHULUMANI (V. DE LA LIBERTAD),estado nutricional en menores de 5 anos,clasificacion d,2001-03-01,0,6,0,6,6
20501,CHUMA,estado nutricional en menores de 5 anos,clasificacion d,2001-03-01,0,33,0,33,33
30801,CLIZA,estado nutricional en menores de 5 anos,clasificacion d,2001-03-01,3,26,3,26,29
90101,COBIJA,estado nutricional en menores de 5 anos,clasificacion d,2001-03-01,10,124,10,124,134
30101,COCHABAMBA,estado nutricional en menores de 5 anos,clasificacion d,2001-03-01,93,555,93,555,648
40902,COIPASA,estado nutricional en menores de 5 anos,clasificacion d,2001-03-01,0,4,0,4,4
30905,COLCAPIRHUA,estado nutricional en menores de 5 anos,clasificacion d,2001-03-01,1,27,1,27,28
50901,"COLCHA ""K""",estado nutricional en menores de 5 anos,clasificacion d,2001-03-01,0,84,0,84,84
21307,COLLANA,estado nutricional en menores de 5 anos,clasificacion d,2001-03-01,0,7,0,7,7
31002,COLOMI,estado nutricional en menores de 5 anos,clasificacion d,2001-03-01,3,31,3,31,34
70603,COLPA BELGICA,estado nutricional en menores de 5 anos,clasificacion d,2001-03-01,0,2,0,2,2
50401,COLQUECHACA,estado nutricional en menores de 5 anos,clasificacion d,2001-03-01,8,168,8,168,176
21306,COLQUENCHA,estado nutricional en menores de 5 anos,clasificacion d,2001-03-01,0,10,0,10,10
21004,COLQUIRI,estado nutricional en menores de 5 anos,clasificacion d,2001-03-01,5,185,5,185,190
20304,COMANCHE,estado nutricional en menores de 5 anos,clasificacion d,2001-03-01,0,18,0,18,18
71301,COMARAPA,estado nutricional en menores de 5 anos,clasificacion d,2001-03-01,0,13,0,13,13
20605,COMBAYA,estado nutricional en menores de 5 anos,clasificacion d,2001-03-01,0,14,0,14,14
71101,CONCEPCION,estado nutricional en menores de 5 anos,clasificacion d,2001-03-01,0,41,0,41,41
21701,COPACABANA,estado nutricional en menores de 5 anos,clasificacion d,2001-03-01,3,82,3,82,85
21402,CORIPATA,estado nutricional en menores de 5 anos,clasificacion d,2001-03-01,2,21,2,21,23
20301,CORO CORO,estado nutricional en menores de 5 anos,clasificacion d,2001-03-01,0,49,0,49,49
21401,COROICO,estado nutricional en menores de 5 anos,clasificacion d,2001-03-01,10,31,10,31,41
40301,CORQUE,estado nutricional en menores de 5 anos,clasificacion d,2001-03-01,0,30,0,30,30
50601,COTAGAITA,estado nutricional en menores de 5 anos,clasificacion d,2001-03-01,4,190,4,190,194
70102,COTOCA,estado nutricional en menores de 5 anos,clasificacion d,2001-03-01,1,64,1,64,65
31405,CUCHUMUELA (V. G. VILLARROEL),estado nutricional en menores de 5 anos,clasificacion d,2001-03-01,0,33,0,33,33
70704,CUEVO,estado nutricional en menores de 5 anos,clasificacion d,2001-03-01,1,61,1,61,62
10902,CULPINA,estado nutricional en menores de 5 anos,clasificacion d,2001-03-01,3,365,3,365,368
40401,CURAHUARA DE CARANGAS,estado nutricional en menores de 5 anos,clasificacion d,2001-03-01,1,19,1,19,20
21602,CURVA,estado nutricional en menores de 5 anos,clasificacion d,2001-03-01,0,16,0,16,16
20804,DESAGUADERO,estado nutricional en menores de 5 anos,clasificacion d,2001-03-01,3,20,3,20,23
20105,EL ALTO,estado nutricional en menores de 5 anos,clasificacion d,2001-03-01,269,1941,269,1941,2210
40103,EL CHORO,estado nutricional en menores de 5 anos,clasificacion d,2001-03-01,0,1,0,1,1
71503,EL PUENTE(STC),estado nutricional en menores de 5 anos,clasificacion d,2001-03-01,1,103,1,103,104
60502,EL PUENTE(TJA),estado nutricional en menores de 5 anos,clasificacion d,2001-03-01,1,46,1,46,47
70105,EL TORNO,estado nutricional en menores de 5 anos,clasificacion d,2001-03-01,5,85,5,85,90
10405,EL VILLAR,estado nutricional en menores de 5 anos,clasificacion d,2001-03-01,15,172,15,172,187
60601,ENTRE RIOS,estado nutricional en menores de 5 anos,clasificacion d,2001-03-01,5,96,5,96,101
41101,EUCALIPTUS,estado nutricional en menores de 5 anos,clasificacion d,2001-03-01,1,30,1,30,31
80402,EXALTACION,estado nutricional en menores de 5 anos,clasificacion d,2001-03-01,0,5,0,5,5
90203,FILADELFIA,estado nutricional en menores de 5 anos,clasificacion d,2001-03-01,1,2,1,2,3
71002,GENERAL SAAVEDRA,estado nutricional en menores de 5 anos,clasificacion d,2001-03-01,2,98,2,98,100
21601,GRAL. J.J. PEREZ (CHARAZANI),estado nutricional en menores de 5 anos,clasificacion d,2001-03-01,5,13,5,13,18
20602,GUANAY,estado nutricional en menores de 5 anos,clasificacion d,2001-03-01,4,86,4,86,90
20802,GUAQUI,estado nutricional en menores de 5 anos,clasificacion d,2001-03-01,2,10,2,10,12
80202,GUAYARAMERIN,estado nutricional en menores de 5 anos,clasificacion d,2001-03-01,10,123,10,123,133
70705,GUTIERREZ,estado nutricional en menores de 5 anos,clasificacion d,2001-03-01,13,195,13,195,208
10502,HUACARETA,estado nutricional en menores de 5 anos,clasificacion d,2001-03-01,16,256,16,256,272
11002,HUACAYA (VILLA DE HUACAYA),estado nutricional en menores de 5 anos,clasificacion d,2001-03-01,0,19,0,19,19
40501,HUACHACALLA,estado nutricional en menores de 5 anos,clasificacion d,2001-03-01,1,15,1,15,16
40701,HUANUNI,estado nutricional en menores de 5 anos,clasificacion d,2001-03-01,3,64,3,64,67
80803,HUARACAJE,estado nutricional en menores de 5 anos,clasificacion d,2001-03-01,0,16,0,16,16
41601,HUAYLLAMARCA,estado nutricional en menores de 5 anos,clasificacion d,2001-03-01,0,22,0,22,22
21005,ICHOCA,estado nutricional en menores de 5 anos,clasificacion d,2001-03-01,0,51,0,51,51
10304,ICLA,estado nutricional en menores de 5 anos,clasificacion d,2001-03-01,18,360,18,360,378
10703,INCAHUASI,estado nutricional en menores de 5 anos,clasificacion d,2001-03-01,13,277,13,277,290
21001,INQUISIVI,estado nutricional en menores de 5 anos,clasificacion d,2001-03-01,0,90,0,90,90
21102,IRUPANA (VILLA DE LANZA),estado nutricional en menores de 5 anos,clasificacion d,2001-03-01,2,68,2,68,70
21501,IXIAMAS,estado nutricional en menores de 5 anos,clasificacion d,2001-03-01,2,36,2,36,38
21105,LA ASUNTA,estado nutricional en menores de 5 anos,clasificacion d,2001-03-01,0,48,0,48,48
70104,LA GUARDIA,estado nutricional en menores de 5 anos,clasificacion d,2001-03-01,3,105,3,105,108
20101,LA PAZ,estado nutricional en menores de 5 anos,clasificacion d,2001-03-01,178,1138,178,1138,1316
41501,LA RIVERA,estado nutricional en menores de 5 anos,clasificacion d,2001-03-01,0,1,0,1,1
70701,LAGUNILLAS,estado nutricional en menores de 5 anos,clasificacion d,2001-03-01,19,65,19,65,84
21202,LAJA,estado nutricional en menores de 5 anos,clasificacion d,2001-03-01,3,33,3,33,36
10903,LAS CARRERAS,estado nutricional en menores de 5 anos,clasificacion d,2001-03-01,3,92,3,92,95
21006,LICOMA PAMPA,estado nutricional en menores de 5 anos,clasificacion d,2001-03-01,1,14,1,14,15
50203,LLALLAGUA,estado nutricional en menores de 5 anos,clasificacion d,2001-03-01,0,50,0,50,50
51401,LLICA,estado nutricional en menores de 5 anos,clasificacion d,2001-03-01,1,14,1,14,15
80601,LORETO,estado nutricional en menores de 5 anos,clasificacion d,2001-03-01,1,10,1,10,11
20901,LURIBAY,estado nutricional en menores de 5 anos,clasificacion d,2001-03-01,0,8,0,8,8
40702,MACHACAMARCA,estado nutricional en menores de 5 anos,clasificacion d,2001-03-01,1,6,1,6,7
11003,MACHARETI,estado nutricional en menores de 5 anos,clasificacion d,2001-03-01,6,173,6,173,179
80801,MAGDALENA,estado nutricional en menores de 5 anos,clasificacion d,2001-03-01,3,27,3,27,30
70903,MAIRANA,estado nutricional en menores de 5 anos,clasificacion d,2001-03-01,7,16,7,16,23
20904,MALLA,estado nutricional en menores de 5 anos,clasificacion d,2001-03-01,0,1,0,1,1
71003,MINEROS,estado nutricional en menores de 5 anos,clasificacion d,2001-03-01,5,328,5,328,333
31301,MIZQUE,estado nutricional en menores de 5 anos,clasificacion d,2001-03-01,65,41,65,41,106
20402,MOCOMOCO,estado nutricional en menores de 5 anos,clasificacion d,2001-03-01,4,102,4,102,106
51002,MOJINETE,estado nutricional en menores de 5 anos,clasificacion d,2001-03-01,2,22,2,22,24
10303,MOJOCOYA,estado nutricional en menores de 5 anos,clasificacion d,2001-03-01,3,196,3,196,199
10501,MONTEAGUDO,estado nutricional en menores de 5 anos,clasificacion d,2001-03-01,3,353,3,353,356
71001,MONTERO,estado nutricional en menores de 5 anos,clasificacion d,2001-03-01,58,478,58,478,536
70803,MORO MORO,estado nutricional en menores de 5 anos,clasificacion d,2001-03-01,0,11,0,11,11
30302,MOROCHATA,estado nutricional en menores de 5 anos,clasificacion d,2001-03-01,9,68,9,68,77
90401,NACEBE (SANTA ROSA DEL ABUNA),estado nutricional en menores de 5 anos,clasificacion d,2001-03-01,0,1,0,1,1
50404,OCURI,estado nutricional en menores de 5 anos,clasificacion d,2001-03-01,3,60,3,60,63
70202,OKINAWA,estado nutricional en menores de 5 anos,clasificacion d,2001-03-01,0,41,0,41,41
30203,OMEREQUE,estado nutricional en menores de 5 anos,clasificacion d,2001-03-01,0,56,0,56,56
40101,ORURO,estado nutricional en menores de 5 anos,clasificacion d,2001-03-01,79,856,79,856,935
60201,PADCAYA,estado nutricional en menores de 5 anos,clasificacion d,2001-03-01,0,55,0,55,55
10401,PADILLA,estado nutricional en menores de 5 anos,clasificacion d,2001-03-01,3,375,3,375,378
70502,PAILON,estado nutricional en menores de 5 anos,clasificacion d,2001-03-01,2,37,2,37,39
21104,PALOS BLANCOS,estado nutricional en menores de 5 anos,clasificacion d,2001-03-01,3,129,3,129,132
40802,PAMPA AULLAGAS,estado nutricional en menores de 5 anos,clasificacion d,2001-03-01,0,34,0,34,34
70902,PAMPA GRANDE,estado nutricional en menores de 5 anos,clasificacion d,2001-03-01,1,33,1,33,34
21802,PAPEL PAMPA,estado nutricional en menores de 5 anos,clasificacion d,2001-03-01,0,2,0,2,2
30202,PASORAPA,estado nutricional en menores de 5 anos,clasificacion d,2001-03-01,2,10,2,10,12
21305,PATACAMAYA,estado nutricional en menores de 5 anos,clasificacion d,2001-03-01,1,28,1,28,29
40602,PAZÃ‘A,estado nutricional en menores de 5 anos,clasificacion d,2001-03-01,0,45,0,45,45
20702,PELECHUCO,estado nutricional en menores de 5 anos,clasificacion d,2001-03-01,3,22,3,22,25
50403,POCOATA,estado nutricional en menores de 5 anos,clasificacion d,2001-03-01,23,174,23,174,197
31203,POCONA,estado nutricional en menores de 5 anos,clasificacion d,2001-03-01,3,122,3,122,125
31202,POJO (CBBA),estado nutricional en menores de 5 anos,clasificacion d,2001-03-01,11,154,11,154,165
40601,POOPO,estado nutricional en menores de 5 anos,clasificacion d,2001-03-01,1,20,1,20,21
51203,PORCO,estado nutricional en menores de 5 anos,clasificacion d,2001-03-01,2,62,2,62,64
10103,POROMA,estado nutricional en menores de 5 anos,clasificacion d,2001-03-01,8,231,8,231,239
70103,PORONGO,estado nutricional en menores de 5 anos,clasificacion d,2001-03-01,2,21,2,21,23
70601,PORTACHUELO,estado nutricional en menores de 5 anos,clasificacion d,2001-03-01,29,49,29,49,78
90102,PORVENIR,estado nutricional en menores de 5 anos,clasificacion d,2001-03-01,1,34,1,34,35
70804,POSTRER VALLE,estado nutricional en menores de 5 anos,clasificacion d,2001-03-01,8,2,8,2,10
50101,POTOSI,estado nutricional en menores de 5 anos,clasificacion d,2001-03-01,17,397,17,397,414
10302,PRESTO,estado nutricional en menores de 5 anos,clasificacion d,2001-03-01,4,152,4,152,156
70805,PUCARA,estado nutricional en menores de 5 anos,clasificacion d,2001-03-01,0,8,0,8,8
21201,PUCARANI,estado nutricional en menores de 5 anos,clasificacion d,2001-03-01,4,69,4,69,73
20401,PUERTO ACOSTA,estado nutricional en menores de 5 anos,clasificacion d,2001-03-01,16,156,16,156,172
20403,PUERTO CARABUCO,estado nutricional en menores de 5 anos,clasificacion d,2001-03-01,3,100,3,100,103
90301,PUERTO GONZALO MORENO,estado nutricional en menores de 5 anos,clasificacion d,2001-03-01,2,13,2,13,15
21204,PUERTO PEREZ,estado nutricional en menores de 5 anos,clasificacion d,2001-03-01,0,13,0,13,13
71402,PUERTO QUIJARRO,estado nutricional en menores de 5 anos,clasificacion d,2001-03-01,3,41,3,41,44
90201,PUERTO RICO,estado nutricional en menores de 5 anos,clasificacion d,2001-03-01,1,34,1,34,35
71401,PUERTO SUAREZ,estado nutricional en menores de 5 anos,clasificacion d,2001-03-01,12,71,12,71,83
31205,PUERTO VILLARROEL,estado nutricional en menores de 5 anos,clasificacion d,2001-03-01,24,110,24,110,134
51101,PUNA,estado nutricional en menores de 5 anos,clasificacion d,2001-03-01,11,266,11,266,277
31401,PUNATA,estado nutricional en menores de 5 anos,clasificacion d,2001-03-01,10,52,10,52,62
20604,QUIABAYA,estado nutricional en menores de 5 anos,clasificacion d,2001-03-01,0,39,0,39,39
30901,QUILLACOLLO,estado nutricional en menores de 5 anos,clasificacion d,2001-03-01,4,29,4,29,33
21002,QUIME,estado nutricional en menores de 5 anos,clasificacion d,2001-03-01,3,109,3,109,112
70904,QUIRUSILLAS,estado nutricional en menores de 5 anos,clasificacion d,2001-03-01,0,6,0,6,6
50402,RAVELO,estado nutricional en menores de 5 anos,clasificacion d,2001-03-01,4,227,4,227,231
80301,REYES,estado nutricional en menores de 5 anos,clasificacion d,2001-03-01,1,36,1,36,37
80201,RIBERALTA,estado nutricional en menores de 5 anos,clasificacion d,2001-03-01,15,318,15,318,333
70503,ROBORE,estado nutricional en menores de 5 anos,clasificacion d,2001-03-01,3,79,3,79,82
80304,RURRENABAQUE,estado nutricional en menores de 5 anos,clasificacion d,2001-03-01,11,5,11,5,16
40901,SABAYA,estado nutricional en menores de 5 anos,clasificacion d,2001-03-01,0,8,0,8,8
31001,SACABA,estado nutricional en menores de 5 anos,clasificacion d,2001-03-01,67,104,67,104,171
30404,SACABAMBA,estado nutricional en menores de 5 anos,clasificacion d,2001-03-01,0,106,0,106,106
50701,SACACA,estado nutricional en menores de 5 anos,clasificacion d,2001-03-01,7,333,7,333,340
71302,SAIPINA,estado nutricional en menores de 5 anos,clasificacion d,2001-03-01,0,4,0,4,4
40801,SALINAS DE GARCI MENDOZA,estado nutricional en menores de 5 anos,clasificacion d,2001-03-01,0,22,0,22,22
70901,SAMAIPATA,estado nutricional en menores de 5 anos,clasificacion d,2001-03-01,2,36,2,36,38
51601,SAN AGUSTIN,estado nutricional en menores de 5 anos,clasificacion d,2001-03-01,0,24,0,24,24
80602,SAN ANDRES,estado nutricional en menores de 5 anos,clasificacion d,2001-03-01,0,44,0,44,44
51003,SAN ANTONIO DE ESMORUCO,estado nutricional en menores de 5 anos,clasificacion d,2001-03-01,0,12,0,12,12
71105,SAN ANTONIO DE LOMERIO,estado nutricional en menores de 5 anos,clasificacion d,2001-03-01,23,212,23,212,235
31403,SAN BENITO,estado nutricional en menores de 5 anos,clasificacion d,2001-03-01,4,38,4,38,42
80302,SAN BORJA,estado nutricional en menores de 5 anos,clasificacion d,2001-03-01,4,128,4,128,132
21502,SAN BUENA VENTURA,estado nutricional en menores de 5 anos,clasificacion d,2001-03-01,1,106,1,106,107
70402,SAN CARLOS,estado nutricional en menores de 5 anos,clasificacion d,2001-03-01,2,95,2,95,97
80501,SAN IGNACIO,estado nutricional en menores de 5 anos,clasificacion d,2001-03-01,12,83,12,83,95
70301,SAN IGNACIO DE VELASCO,estado nutricional en menores de 5 anos,clasificacion d,2001-03-01,8,175,8,175,183
80102,SAN JAVIER(BNI),estado nutricional en menores de 5 anos,clasificacion d,2001-03-01,3,21,3,21,24
71102,SAN JAVIER(STC),estado nutricional en menores de 5 anos,clasificacion d,2001-03-01,0,127,0,127,127
80701,SAN JOAQUIN,estado nutricional en menores de 5 anos,clasificacion d,2001-03-01,0,15,0,15,15
70501,SAN JOSE DE CHIQUITOS,estado nutricional en menores de 5 anos,clasificacion d,2001-03-01,8,79,8,79,87
71104,SAN JULIAN,estado nutricional en menores de 5 anos,clasificacion d,2001-03-01,13,285,13,285,298
90302,SAN LORENZO(PND),estado nutricional en menores de 5 anos,clasificacion d,2001-03-01,1,24,1,24,25
60501,SAN LORENZO(TJA),estado nutricional en menores de 5 anos,clasificacion d,2001-03-01,4,95,4,95,99
10702,SAN LUCAS,estado nutricional en menores de 5 anos,clasificacion d,2001-03-01,11,600,11,600,611
71201,SAN MATIAS,estado nutricional en menores de 5 anos,clasificacion d,2001-03-01,6,62,6,62,68
70302,SAN MIGUEL DE VELASCO,estado nutricional en menores de 5 anos,clasificacion d,2001-03-01,2,60,2,60,62
51001,SAN PABLO DE LIPEZ,estado nutricional en menores de 5 anos,clasificacion d,2001-03-01,1,54,1,54,55
50501,SAN PEDRO DE BUENA VISTA,estado nutricional en menores de 5 anos,clasificacion d,2001-03-01,6,272,6,272,278
21801,SAN PEDRO DE CURAHUARA,estado nutricional en menores de 5 anos,clasificacion d,2001-03-01,0,14,0,14,14
50902,SAN PEDRO DE QUEMES,estado nutricional en menores de 5 anos,clasificacion d,2001-03-01,1,9,1,9,10
21702,SAN PEDRO DE TIQUINA,estado nutricional en menores de 5 anos,clasificacion d,2001-03-01,1,11,1,11,12
70303,SAN RAFAEL,estado nutricional en menores de 5 anos,clasificacion d,2001-03-01,4,49,4,49,53
80702,SAN RAMON,estado nutricional en menores de 5 anos,clasificacion d,2001-03-01,0,95,0,95,95
80702,SAN RAMON,estado nutricional en menores de 5 anos,clasificacion d,2001-03-01,1,4,1,4,5
70101,SANTA CRUZ DE LA SIERRA,estado nutricional en menores de 5 anos,clasificacion d,2001-03-01,78,327,78,327,405
80303,SANTA ROSA,estado nutricional en menores de 5 anos,clasificacion d,2001-03-01,0,14,0,14,14
70602,SANTA ROSA DEL SARA,estado nutricional en menores de 5 anos,clasificacion d,2001-03-01,5,27,5,27,32
20308,SANTIAGO DE CALLAPA,estado nutricional en menores de 5 anos,clasificacion d,2001-03-01,0,1,0,1,1
41401,SANTIAGO DE HUARI,estado nutricional en menores de 5 anos,clasificacion d,2001-03-01,1,28,1,28,29
21901,SANTIAGO DE MACHACA,estado nutricional en menores de 5 anos,clasificacion d,2001-03-01,0,1,0,1,1
30702,SANTIVAÃ‘ES,estado nutricional en menores de 5 anos,clasificacion d,2001-03-01,16,37,16,37,53
40202,SANTUARIO DE QUILLACAS,estado nutricional en menores de 5 anos,clasificacion d,2001-03-01,0,27,0,27,27
20902,SAPAHAQUI,estado nutricional en menores de 5 anos,clasificacion d,2001-03-01,1,14,1,14,15
90303,SENA,estado nutricional en menores de 5 anos,clasificacion d,2001-03-01,0,4,0,4,4
21301,SICA SICA (VILLA AROMA),estado nutricional en menores de 5 anos,clasificacion d,2001-03-01,1,36,1,36,37
30703,SICAYA,estado nutricional en menores de 5 anos,clasificacion d,2001-03-01,0,7,0,7,7
30902,SIPE SIPE,estado nutricional en menores de 5 anos,clasificacion d,2001-03-01,25,171,25,171,196
10403,SOPACHUY,estado nutricional en menores de 5 anos,clasificacion d,2001-03-01,2,175,2,175,177
20601,SORATA,estado nutricional en menores de 5 anos,clasificacion d,2001-03-01,2,79,2,79,81
10101,SUCRE,estado nutricional en menores de 5 anos,clasificacion d,2001-03-01,54,1488,54,1488,1542
31404,TACACHI,estado nutricional en menores de 5 anos,clasificacion d,2001-03-01,2,26,2,26,28
20603,TACACOMA,estado nutricional en menores de 5 anos,clasificacion d,2001-03-01,2,43,2,43,45
50303,TACOBAMBA,estado nutricional en menores de 5 anos,clasificacion d,2001-03-01,7,66,7,66,73
30602,TACOPAYA,estado nutricional en menores de 5 anos,clasificacion d,2001-03-01,0,135,0,135,135
51402,TAHUA,estado nutricional en menores de 5 anos,clasificacion d,2001-03-01,0,13,0,13,13
31101,TAPACARI,estado nutricional en menores de 5 anos,clasificacion d,2001-03-01,20,119,20,119,139
10601,TARABUCO,estado nutricional en menores de 5 anos,clasificacion d,2001-03-01,8,716,8,716,724
30401,TARATA,estado nutricional en menores de 5 anos,clasificacion d,2001-03-01,4,34,4,34,38
60101,TARIJA,estado nutricional en menores de 5 anos,clasificacion d,2001-03-01,15,310,15,310,325
10202,TARVITA,estado nutricional en menores de 5 anos,clasificacion d,2001-03-01,5,193,5,193,198
20803,TIAWANACU,estado nutricional en menores de 5 anos,clasificacion d,2001-03-01,1,53,1,53,54
50102,TINGUIPAYA,estado nutricional en menores de 5 anos,clasificacion d,2001-03-01,3,111,3,111,114
20606,TIPUANI,estado nutricional en menores de 5 anos,clasificacion d,2001-03-01,11,12,11,12,23
30903,TIQUIPAYA,estado nutricional en menores de 5 anos,clasificacion d,2001-03-01,6,209,6,209,215
31601,TIRAQUE (CBBA),estado nutricional en menores de 5 anos,clasificacion d,2001-03-01,6,34,6,34,40
21703,TITO YUPANQUI (PARQUIPUJIO),estado nutricional en menores de 5 anos,clasificacion d,2001-03-01,0,17,0,17,17
30802,TOCO,estado nutricional en menores de 5 anos,clasificacion d,2001-03-01,2,3,2,3,5
41502,TODOS SANTOS,estado nutricional en menores de 5 anos,clasificacion d,2001-03-01,0,1,0,1,1
30803,TOLATA,estado nutricional en menores de 5 anos,clasificacion d,2001-03-01,0,15,0,15,15
41001,TOLEDO,estado nutricional en menores de 5 anos,clasificacion d,2001-03-01,0,18,0,18,18
51202,TOMAVE,estado nutricional en menores de 5 anos,clasificacion d,2001-03-01,11,62,11,62,73
10402,TOMINA,estado nutricional en menores de 5 anos,clasificacion d,2001-03-01,3,211,3,211,214
50502,TORO TORO,estado nutricional en menores de 5 anos,clasificacion d,2001-03-01,0,15,0,15,15
31201,TOTORA(CBBA),estado nutricional en menores de 5 anos,clasificacion d,2001-03-01,6,114,6,114,120
41301,TOTORA(ORR),estado nutricional en menores de 5 anos,clasificacion d,2001-03-01,1,45,1,45,46
70802,TRIGAL,estado nutricional en menores de 5 anos,clasificacion d,2001-03-01,1,7,1,7,8
80101,TRINIDAD,estado nutricional en menores de 5 anos,clasificacion d,2001-03-01,12,145,12,145,157
50801,TUPIZA,estado nutricional en menores de 5 anos,clasificacion d,2001-03-01,11,489,11,489,500
40402,TURCO,estado nutricional en menores de 5 anos,clasificacion d,2001-03-01,1,15,1,15,16
21302,UMALA,estado nutricional en menores de 5 anos,clasificacion d,2001-03-01,0,14,0,14,14
50201,UNCIA,estado nutricional en menores de 5 anos,clasificacion d,2001-03-01,2,122,2,122,124
60401,URIONDO (A. CONCEPCION),estado nutricional en menores de 5 anos,clasificacion d,2001-03-01,0,21,0,21,21
71502,URUBICHA,estado nutricional en menores de 5 anos,clasificacion d,2001-03-01,2,197,2,197,199
51201,UYUNI,estado nutricional en menores de 5 anos,clasificacion d,2001-03-01,7,72,7,72,79
30502,VACAS,estado nutricional en menores de 5 anos,clasificacion d,2001-03-01,3,20,3,20,23
70801,VALLEGRANDE,estado nutricional en menores de 5 anos,clasificacion d,2001-03-01,3,60,3,60,63
20801,VIACHA,estado nutricional en menores de 5 anos,clasificacion d,2001-03-01,13,136,13,136,149
31302,VILA VILA,estado nutricional en menores de 5 anos,clasificacion d,2001-03-01,119,67,119,67,186
60303,VILLA MONTES,estado nutricional en menores de 5 anos,clasificacion d,2001-03-01,1,100,1,100,101
31402,VILLA RIVERO,estado nutricional en menores de 5 anos,clasificacion d,2001-03-01,0,17,0,17,17
10801,VILLA SERRANO,estado nutricional en menores de 5 anos,clasificacion d,2001-03-01,4,322,4,322,326
31003,VILLA TUNARI,estado nutricional en menores de 5 anos,clasificacion d,2001-03-01,5,111,5,111,116
11001,VILLA VACA GUZMAN (MUYUPAMPA),estado nutricional en menores de 5 anos,clasificacion d,2001-03-01,1,187,1,187,188
51501,VILLAZON,estado nutricional en menores de 5 anos,clasificacion d,2001-03-01,1,238,1,238,239
50602,VITICHI,estado nutricional en menores de 5 anos,clasificacion d,2001-03-01,3,104,3,104,107
20306,WALDO BALLIVIAN,estado nutricional en menores de 5 anos,clasificacion d,2001-03-01,0,5,0,5,5
70201,WARNES,estado nutricional en menores de 5 anos,clasificacion d,2001-03-01,4,147,4,147,151
20903,YACO,estado nutricional en menores de 5 anos,clasificacion d,2001-03-01,0,26,0,26,26
60301,YACUIBA,estado nutricional en menores de 5 anos,clasificacion d,2001-03-01,11,143,11,143,154
10602,YAMPARAEZ,estado nutricional en menores de 5 anos,clasificacion d,2001-03-01,6,410,6,410,416
21103,YANACACHI,estado nutricional en menores de 5 anos,clasificacion d,2001-03-01,0,18,0,18,18
70403,YAPACANI,estado nutricional en menores de 5 anos,clasificacion d,2001-03-01,42,61,42,61,103
50103,YOCALLA,estado nutricional en menores de 5 anos,clasificacion d,2001-03-01,0,57,0,57,57
10102,YOTALA,estado nutricional en menores de 5 anos,clasificacion d,2001-03-01,2,319,2,319,321
60402,YUNCHARA,estado nutricional en menores de 5 anos,clasificacion d,2001-03-01,2,13,2,13,15
10301,ZUDAÃ‘EZ,estado nutricional en menores de 5 anos,clasificacion d,2001-03-01,6,232,6,232,238
51302,ACACIO,estado nutricional en menores de 5 anos,clasificacion d,2001-04-01,4,156,4,156,160
20201,ACHACACHI,estado nutricional en menores de 5 anos,clasificacion d,2001-04-01,16,147,16,147,163
20104,ACHOCALLA,estado nutricional en menores de 5 anos,clasificacion d,2001-04-01,0,54,0,54,54
30201,AIQUILE,estado nutricional en menores de 5 anos,clasificacion d,2001-04-01,23,97,23,97,120
31303,ALALAY,estado nutricional en menores de 5 anos,clasificacion d,2001-04-01,29,9,29,9,38
10404,ALCALA,estado nutricional en menores de 5 anos,clasificacion d,2001-04-01,2,92,2,92,94
20202,ANCORAIMES,estado nutricional en menores de 5 anos,clasificacion d,2001-04-01,2,142,2,142,144
41201,ANDAMARCA,estado nutricional en menores de 5 anos,clasificacion d,2001-04-01,0,16,0,16,16
40603,ANTEQUERA,estado nutricional en menores de 5 anos,clasificacion d,2001-04-01,1,18,1,18,19
30402,ANZALDO,estado nutricional en menores de 5 anos,clasificacion d,2001-04-01,3,67,3,67,70
20701,APOLO,estado nutricional en menores de 5 anos,clasificacion d,2001-04-01,7,0,7,0,7
51301,ARAMPAMPA,estado nutricional en menores de 5 anos,clasificacion d,2001-04-01,2,78,2,78,80
30501,ARANI,estado nutricional en menores de 5 anos,clasificacion d,2001-04-01,4,21,4,21,25
30403,ARBIETO,estado nutricional en menores de 5 anos,clasificacion d,2001-04-01,0,23,0,23,23
30601,ARQUE,estado nutricional en menores de 5 anos,clasificacion d,2001-04-01,0,112,0,112,112
71501,ASCENCION DE GUARAYOS,estado nutricional en menores de 5 anos,clasificacion d,2001-04-01,7,369,7,369,376
50802,ATOCHA,estado nutricional en menores de 5 anos,clasificacion d,2001-04-01,1,39,1,39,40
20503,AUCAPATA,estado nutricional en menores de 5 anos,clasificacion d,2001-04-01,0,11,0,11,11
20502,AYATA,estado nutricional en menores de 5 anos,clasificacion d,2001-04-01,0,3,0,3,3
21303,AYO AYO,estado nutricional en menores de 5 anos,clasificacion d,2001-04-01,0,17,0,17,17
30301,AYOPAYA (V. DE INDEPENDENCIA),estado nutricional en menores de 5 anos,clasificacion d,2001-04-01,7,120,7,120,127
10201,AZURDUY,estado nutricional en menores de 5 anos,clasificacion d,2001-04-01,3,205,3,205,208
21203,BATALLAS,estado nutricional en menores de 5 anos,clasificacion d,2001-04-01,1,51,1,51,52
80802,BAURES,estado nutricional en menores de 5 anos,clasificacion d,2001-04-01,1,48,1,48,49
41202,BELEN DE ANDAMARCA,estado nutricional en menores de 5 anos,clasificacion d,2001-04-01,0,3,0,3,3
50104,BELEN DE URMIRI,estado nutricional en menores de 5 anos,clasificacion d,2001-04-01,9,46,9,46,55
90104,BELLA FLOR,estado nutricional en menores de 5 anos,clasificacion d,2001-04-01,1,13,1,13,14
60202,BERMEJO,estado nutricional en menores de 5 anos,clasificacion d,2001-04-01,3,3,3,3,6
50301,BETANZOS,estado nutricional en menores de 5 anos,clasificacion d,2001-04-01,3,257,3,257,260
90103,BOLPEBRA,estado nutricional en menores de 5 anos,clasificacion d,2001-04-01,0,11,0,11,11
70707,BOYUIBE,estado nutricional en menores de 5 anos,clasificacion d,2001-04-01,0,39,0,39,39
70401,BUENA VISTA,estado nutricional en menores de 5 anos,clasificacion d,2001-04-01,1,97,1,97,98
70703,CABEZAS,estado nutricional en menores de 5 anos,clasificacion d,2001-04-01,2,35,2,35,37
20905,CAIROMA,estado nutricional en menores de 5 anos,clasificacion d,2001-04-01,2,12,2,12,14
51102,"CAIZA ""D""",estado nutricional en menores de 5 anos,clasificacion d,2001-04-01,3,137,3,137,140
21003,CAJUATA,estado nutricional en menores de 5 anos,clasificacion d,2001-04-01,1,29,1,29,30
20303,CALACOTO,estado nutricional en menores de 5 anos,clasificacion d,2001-04-01,2,13,2,13,15
21304,CALAMARCA,estado nutricional en menores de 5 anos,clasificacion d,2001-04-01,3,37,3,37,40
10701,CAMARGO,estado nutricional en menores de 5 anos,clasificacion d,2001-04-01,1,82,1,82,83
10901,CAMATAQUI (C. VILLA ABECIA),estado nutricional en menores de 5 anos,clasificacion d,2001-04-01,0,56,0,56,56
70706,CAMIRI,estado nutricional en menores de 5 anos,clasificacion d,2001-04-01,11,162,11,162,173
20302,CAQUIAVIRI,estado nutricional en menores de 5 anos,clasificacion d,2001-04-01,0,62,0,62,62
40102,CARACOLLO,estado nutricional en menores de 5 anos,clasificacion d,2001-04-01,0,87,0,87,87
22001,CARANAVI,estado nutricional en menores de 5 anos,clasificacion d,2001-04-01,8,293,8,293,301
41503,CARANGAS,estado nutricional en menores de 5 anos,clasificacion d,2001-04-01,0,2,0,2,2
60302,CARAPARI,estado nutricional en menores de 5 anos,clasificacion d,2001-04-01,2,50,2,50,52
50702,CARIPUYO,estado nutricional en menores de 5 anos,clasificacion d,2001-04-01,4,102,4,102,106
21902,CATACORA,estado nutricional en menores de 5 anos,clasificacion d,2001-04-01,0,13,0,13,13
21803,CHACARILLA,estado nutricional en menores de 5 anos,clasificacion d,2001-04-01,0,8,0,8,8
40201,CHALLAPATA,estado nutricional en menores de 5 anos,clasificacion d,2001-04-01,2,88,2,88,90
50302,CHAQUI,estado nutricional en menores de 5 anos,clasificacion d,2001-04-01,0,120,0,120,120
70702,CHARAGUA,estado nutricional en menores de 5 anos,clasificacion d,2001-04-01,9,212,9,212,221
20305,CHARAÃ‘A,estado nutricional en menores de 5 anos,clasificacion d,2001-04-01,0,13,0,13,13
50202,CHAYANTA,estado nutricional en menores de 5 anos,clasificacion d,2001-04-01,0,15,0,15,15
31204,CHIMORE,estado nutricional en menores de 5 anos,clasificacion d,2001-04-01,1,74,1,74,75
40302,CHOQUE COTA,estado nutricional en menores de 5 anos,clasificacion d,2001-04-01,0,4,0,4,4
21101,CHULUMANI (V. DE LA LIBERTAD),estado nutricional en menores de 5 anos,clasificacion d,2001-04-01,1,78,1,78,79
20501,CHUMA,estado nutricional en menores de 5 anos,clasificacion d,2001-04-01,7,6,7,6,13
30801,CLIZA,estado nutricional en menores de 5 anos,clasificacion d,2001-04-01,5,24,5,24,29
90101,COBIJA,estado nutricional en menores de 5 anos,clasificacion d,2001-04-01,15,92,15,92,107
30101,COCHABAMBA,estado nutricional en menores de 5 anos,clasificacion d,2001-04-01,92,555,92,555,647
40902,COIPASA,estado nutricional en menores de 5 anos,clasificacion d,2001-04-01,1,3,1,3,4
30905,COLCAPIRHUA,estado nutricional en menores de 5 anos,clasificacion d,2001-04-01,2,11,2,11,13
50901,"COLCHA ""K""",estado nutricional en menores de 5 anos,clasificacion d,2001-04-01,1,96,1,96,97
31002,COLOMI,estado nutricional en menores de 5 anos,clasificacion d,2001-04-01,0,89,0,89,89
70603,COLPA BELGICA,estado nutricional en menores de 5 anos,clasificacion d,2001-04-01,2,5,2,5,7
50401,COLQUECHACA,estado nutricional en menores de 5 anos,clasificacion d,2001-04-01,3,143,3,143,146
21306,COLQUENCHA,estado nutricional en menores de 5 anos,clasificacion d,2001-04-01,7,49,7,49,56
21004,COLQUIRI,estado nutricional en menores de 5 anos,clasificacion d,2001-04-01,2,186,2,186,188
20304,COMANCHE,estado nutricional en menores de 5 anos,clasificacion d,2001-04-01,0,38,0,38,38
71301,COMARAPA,estado nutricional en menores de 5 anos,clasificacion d,2001-04-01,0,52,0,52,52
20605,COMBAYA,estado nutricional en menores de 5 anos,clasificacion d,2001-04-01,0,24,0,24,24
71101,CONCEPCION,estado nutricional en menores de 5 anos,clasificacion d,2001-04-01,0,91,0,91,91
21701,COPACABANA,estado nutricional en menores de 5 anos,clasificacion d,2001-04-01,1,80,1,80,81
21402,CORIPATA,estado nutricional en menores de 5 anos,clasificacion d,2001-04-01,1,20,1,20,21
20301,CORO CORO,estado nutricional en menores de 5 anos,clasificacion d,2001-04-01,1,97,1,97,98
21401,COROICO,estado nutricional en menores de 5 anos,clasificacion d,2001-04-01,3,65,3,65,68
40301,CORQUE,estado nutricional en menores de 5 anos,clasificacion d,2001-04-01,1,35,1,35,36
50601,COTAGAITA,estado nutricional en menores de 5 anos,clasificacion d,2001-04-01,7,275,7,275,282
31405,CUCHUMUELA (V. G. VILLARROEL),estado nutricional en menores de 5 anos,clasificacion d,2001-04-01,0,8,0,8,8
70704,CUEVO,estado nutricional en menores de 5 anos,clasificacion d,2001-04-01,0,44,0,44,44
10902,CULPINA,estado nutricional en menores de 5 anos,clasificacion d,2001-04-01,5,298,5,298,303
40401,CURAHUARA DE CARANGAS,estado nutricional en menores de 5 anos,clasificacion d,2001-04-01,1,28,1,28,29
21602,CURVA,estado nutricional en menores de 5 anos,clasificacion d,2001-04-01,0,4,0,4,4
20804,DESAGUADERO,estado nutricional en menores de 5 anos,clasificacion d,2001-04-01,3,18,3,18,21
20105,EL ALTO,estado nutricional en menores de 5 anos,clasificacion d,2001-04-01,265,2118,265,2118,2383
40103,EL CHORO,estado nutricional en menores de 5 anos,clasificacion d,2001-04-01,0,3,0,3,3
71503,EL PUENTE(STC),estado nutricional en menores de 5 anos,clasificacion d,2001-04-01,2,77,2,77,79
60502,EL PUENTE(TJA),estado nutricional en menores de 5 anos,clasificacion d,2001-04-01,7,37,7,37,44
70105,EL TORNO,estado nutricional en menores de 5 anos,clasificacion d,2001-04-01,6,20,6,20,26
10405,EL VILLAR,estado nutricional en menores de 5 anos,clasificacion d,2001-04-01,9,202,9,202,211
60601,ENTRE RIOS,estado nutricional en menores de 5 anos,clasificacion d,2001-04-01,7,87,7,87,94
40502,ESCARA,estado nutricional en menores de 5 anos,clasificacion d,2001-04-01,0,2,0,2,2
41101,EUCALIPTUS,estado nutricional en menores de 5 anos,clasificacion d,2001-04-01,0,32,0,32,32
80402,EXALTACION,estado nutricional en menores de 5 anos,clasificacion d,2001-04-01,1,18,1,18,19
90203,FILADELFIA,estado nutricional en menores de 5 anos,clasificacion d,2001-04-01,0,6,0,6,6
71002,GENERAL SAAVEDRA,estado nutricional en menores de 5 anos,clasificacion d,2001-04-01,0,120,0,120,120
21601,GRAL. J.J. PEREZ (CHARAZANI),estado nutricional en menores de 5 anos,clasificacion d,2001-04-01,1,31,1,31,32
20602,GUANAY,estado nutricional en menores de 5 anos,clasificacion d,2001-04-01,8,94,8,94,102
20802,GUAQUI,estado nutricional en menores de 5 anos,clasificacion d,2001-04-01,0,12,0,12,12
80202,GUAYARAMERIN,estado nutricional en menores de 5 anos,clasificacion d,2001-04-01,9,124,9,124,133
70705,GUTIERREZ,estado nutricional en menores de 5 anos,clasificacion d,2001-04-01,10,242,10,242,252
10502,HUACARETA,estado nutricional en menores de 5 anos,clasificacion d,2001-04-01,2,253,2,253,255
11002,HUACAYA (VILLA DE HUACAYA),estado nutricional en menores de 5 anos,clasificacion d,2001-04-01,0,29,0,29,29
40501,HUACHACALLA,estado nutricional en menores de 5 anos,clasificacion d,2001-04-01,0,8,0,8,8
40701,HUANUNI,estado nutricional en menores de 5 anos,clasificacion d,2001-04-01,2,46,2,46,48
80803,HUARACAJE,estado nutricional en menores de 5 anos,clasificacion d,2001-04-01,0,23,0,23,23
41601,HUAYLLAMARCA,estado nutricional en menores de 5 anos,clasificacion d,2001-04-01,0,28,0,28,28
21005,ICHOCA,estado nutricional en menores de 5 anos,clasificacion d,2001-04-01,0,27,0,27,27
10304,ICLA,estado nutricional en menores de 5 anos,clasificacion d,2001-04-01,5,385,5,385,390
10703,INCAHUASI,estado nutricional en menores de 5 anos,clasificacion d,2001-04-01,5,156,5,156,161
21001,INQUISIVI,estado nutricional en menores de 5 anos,clasificacion d,2001-04-01,8,60,8,60,68
21102,IRUPANA (VILLA DE LANZA),estado nutricional en menores de 5 anos,clasificacion d,2001-04-01,2,89,2,89,91
21501,IXIAMAS,estado nutricional en menores de 5 anos,clasificacion d,2001-04-01,0,56,0,56,56
21105,LA ASUNTA,estado nutricional en menores de 5 anos,clasificacion d,2001-04-01,1,86,1,86,87
20101,LA PAZ,estado nutricional en menores de 5 anos,clasificacion d,2001-04-01,196,1064,196,1064,1260
41501,LA RIVERA,estado nutricional en menores de 5 anos,clasificacion d,2001-04-01,0,1,0,1,1
70701,LAGUNILLAS,estado nutricional en menores de 5 anos,clasificacion d,2001-04-01,20,114,20,114,134
21202,LAJA,estado nutricional en menores de 5 anos,clasificacion d,2001-04-01,0,21,0,21,21
10903,LAS CARRERAS,estado nutricional en menores de 5 anos,clasificacion d,2001-04-01,1,63,1,63,64
21006,LICOMA PAMPA,estado nutricional en menores de 5 anos,clasificacion d,2001-04-01,0,8,0,8,8
50203,LLALLAGUA,estado nutricional en menores de 5 anos,clasificacion d,2001-04-01,1,173,1,173,174
51401,LLICA,estado nutricional en menores de 5 anos,clasificacion d,2001-04-01,0,27,0,27,27
80601,LORETO,estado nutricional en menores de 5 anos,clasificacion d,2001-04-01,1,9,1,9,10
20901,LURIBAY,estado nutricional en menores de 5 anos,clasificacion d,2001-04-01,0,25,0,25,25
40702,MACHACAMARCA,estado nutricional en menores de 5 anos,clasificacion d,2001-04-01,2,17,2,17,19
11003,MACHARETI,estado nutricional en menores de 5 anos,clasificacion d,2001-04-01,2,119,2,119,121
80801,MAGDALENA,estado nutricional en menores de 5 anos,clasificacion d,2001-04-01,0,22,0,22,22
70903,MAIRANA,estado nutricional en menores de 5 anos,clasificacion d,2001-04-01,1,16,1,16,17
20904,MALLA,estado nutricional en menores de 5 anos,clasificacion d,2001-04-01,0,4,0,4,4
20103,MECAPACA,estado nutricional en menores de 5 anos,clasificacion d,2001-04-01,9,38,9,38,47
71003,MINEROS,estado nutricional en menores de 5 anos,clasificacion d,2001-04-01,9,223,9,223,232
31301,MIZQUE,estado nutricional en menores de 5 anos,clasificacion d,2001-04-01,77,38,77,38,115
20402,MOCOMOCO,estado nutricional en menores de 5 anos,clasificacion d,2001-04-01,1,101,1,101,102
51002,MOJINETE,estado nutricional en menores de 5 anos,clasificacion d,2001-04-01,0,8,0,8,8
10303,MOJOCOYA,estado nutricional en menores de 5 anos,clasificacion d,2001-04-01,2,206,2,206,208
10501,MONTEAGUDO,estado nutricional en menores de 5 anos,clasificacion d,2001-04-01,6,293,6,293,299
71001,MONTERO,estado nutricional en menores de 5 anos,clasificacion d,2001-04-01,41,441,41,441,482
70803,MORO MORO,estado nutricional en menores de 5 anos,clasificacion d,2001-04-01,1,7,1,7,8
30302,MOROCHATA,estado nutricional en menores de 5 anos,clasificacion d,2001-04-01,1,73,1,73,74
90401,NACEBE (SANTA ROSA DEL ABUNA),estado nutricional en menores de 5 anos,clasificacion d,2001-04-01,0,3,0,3,3
90501,NUEVO MANOA (NUEVA ESPERANZA),estado nutricional en menores de 5 anos,clasificacion d,2001-04-01,0,3,0,3,3
50404,OCURI,estado nutricional en menores de 5 anos,clasificacion d,2001-04-01,5,87,5,87,92
70202,OKINAWA,estado nutricional en menores de 5 anos,clasificacion d,2001-04-01,0,29,0,29,29
30203,OMEREQUE,estado nutricional en menores de 5 anos,clasificacion d,2001-04-01,0,29,0,29,29
40101,ORURO,estado nutricional en menores de 5 anos,clasificacion d,2001-04-01,26,774,26,774,800
60201,PADCAYA,estado nutricional en menores de 5 anos,clasificacion d,2001-04-01,2,77,2,77,79
10401,PADILLA,estado nutricional en menores de 5 anos,clasificacion d,2001-04-01,6,334,6,334,340
70502,PAILON,estado nutricional en menores de 5 anos,clasificacion d,2001-04-01,0,78,0,78,78
20102,PALCA,estado nutricional en menores de 5 anos,clasificacion d,2001-04-01,3,42,3,42,45
21104,PALOS BLANCOS,estado nutricional en menores de 5 anos,clasificacion d,2001-04-01,2,194,2,194,196
40802,PAMPA AULLAGAS,estado nutricional en menores de 5 anos,clasificacion d,2001-04-01,0,6,0,6,6
70902,PAMPA GRANDE,estado nutricional en menores de 5 anos,clasificacion d,2001-04-01,4,28,4,28,32
21802,PAPEL PAMPA,estado nutricional en menores de 5 anos,clasificacion d,2001-04-01,0,5,0,5,5
30202,PASORAPA,estado nutricional en menores de 5 anos,clasificacion d,2001-04-01,0,20,0,20,20
21305,PATACAMAYA,estado nutricional en menores de 5 anos,clasificacion d,2001-04-01,3,36,3,36,39
40602,PAZÃ‘A,estado nutricional en menores de 5 anos,clasificacion d,2001-04-01,1,18,1,18,19
20702,PELECHUCO,estado nutricional en menores de 5 anos,clasificacion d,2001-04-01,6,29,6,29,35
50403,POCOATA,estado nutricional en menores de 5 anos,clasificacion d,2001-04-01,8,189,8,189,197
31203,POCONA,estado nutricional en menores de 5 anos,clasificacion d,2001-04-01,1,59,1,59,60
31202,POJO (CBBA),estado nutricional en menores de 5 anos,clasificacion d,2001-04-01,39,180,39,180,219
40601,POOPO,estado nutricional en menores de 5 anos,clasificacion d,2001-04-01,1,27,1,27,28
51203,PORCO,estado nutricional en menores de 5 anos,clasificacion d,2001-04-01,2,34,2,34,36
10103,POROMA,estado nutricional en menores de 5 anos,clasificacion d,2001-04-01,4,256,4,256,260
70103,PORONGO,estado nutricional en menores de 5 anos,clasificacion d,2001-04-01,2,49,2,49,51
70601,PORTACHUELO,estado nutricional en menores de 5 anos,clasificacion d,2001-04-01,14,68,14,68,82
90102,PORVENIR,estado nutricional en menores de 5 anos,clasificacion d,2001-04-01,0,45,0,45,45
50101,POTOSI,estado nutricional en menores de 5 anos,clasificacion d,2001-04-01,32,642,32,642,674
10302,PRESTO,estado nutricional en menores de 5 anos,clasificacion d,2001-04-01,1,164,1,164,165
70805,PUCARA,estado nutricional en menores de 5 anos,clasificacion d,2001-04-01,0,9,0,9,9
21201,PUCARANI,estado nutricional en menores de 5 anos,clasificacion d,2001-04-01,4,59,4,59,63
20401,PUERTO ACOSTA,estado nutricional en menores de 5 anos,clasificacion d,2001-04-01,10,135,10,135,145
20403,PUERTO CARABUCO,estado nutricional en menores de 5 anos,clasificacion d,2001-04-01,0,172,0,172,172
90301,PUERTO GONZALO MORENO,estado nutricional en menores de 5 anos,clasificacion d,2001-04-01,0,6,0,6,6
21204,PUERTO PEREZ,estado nutricional en menores de 5 anos,clasificacion d,2001-04-01,1,21,1,21,22
71402,PUERTO QUIJARRO,estado nutricional en menores de 5 anos,clasificacion d,2001-04-01,0,33,0,33,33
90201,PUERTO RICO,estado nutricional en menores de 5 anos,clasificacion d,2001-04-01,2,18,2,18,20
80703,PUERTO SILES,estado nutricional en menores de 5 anos,clasificacion d,2001-04-01,0,1,0,1,1
71401,PUERTO SUAREZ,estado nutricional en menores de 5 anos,clasificacion d,2001-04-01,7,41,7,41,48
31205,PUERTO VILLARROEL,estado nutricional en menores de 5 anos,clasificacion d,2001-04-01,1,146,1,146,147
51101,PUNA,estado nutricional en menores de 5 anos,clasificacion d,2001-04-01,5,322,5,322,327
31401,PUNATA,estado nutricional en menores de 5 anos,clasificacion d,2001-04-01,8,52,8,52,60
20604,QUIABAYA,estado nutricional en menores de 5 anos,clasificacion d,2001-04-01,0,42,0,42,42
30901,QUILLACOLLO,estado nutricional en menores de 5 anos,clasificacion d,2001-04-01,1,34,1,34,35
21002,QUIME,estado nutricional en menores de 5 anos,clasificacion d,2001-04-01,1,72,1,72,73
70904,QUIRUSILLAS,estado nutricional en menores de 5 anos,clasificacion d,2001-04-01,0,1,0,1,1
50402,RAVELO,estado nutricional en menores de 5 anos,clasificacion d,2001-04-01,7,350,7,350,357
80301,REYES,estado nutricional en menores de 5 anos,clasificacion d,2001-04-01,1,29,1,29,30
80201,RIBERALTA,estado nutricional en menores de 5 anos,clasificacion d,2001-04-01,17,315,17,315,332
70503,ROBORE,estado nutricional en menores de 5 anos,clasificacion d,2001-04-01,2,71,2,71,73
80304,RURRENABAQUE,estado nutricional en menores de 5 anos,clasificacion d,2001-04-01,12,7,12,7,19
40901,SABAYA,estado nutricional en menores de 5 anos,clasificacion d,2001-04-01,0,3,0,3,3
31001,SACABA,estado nutricional en menores de 5 anos,clasificacion d,2001-04-01,17,46,17,46,63
30404,SACABAMBA,estado nutricional en menores de 5 anos,clasificacion d,2001-04-01,2,84,2,84,86
50701,SACACA,estado nutricional en menores de 5 anos,clasificacion d,2001-04-01,8,429,8,429,437
71302,SAIPINA,estado nutricional en menores de 5 anos,clasificacion d,2001-04-01,0,9,0,9,9
40801,SALINAS DE GARCI MENDOZA,estado nutricional en menores de 5 anos,clasificacion d,2001-04-01,3,8,3,8,11
70901,SAMAIPATA,estado nutricional en menores de 5 anos,clasificacion d,2001-04-01,0,27,0,27,27
51601,SAN AGUSTIN,estado nutricional en menores de 5 anos,clasificacion d,2001-04-01,0,12,0,12,12
80602,SAN ANDRES,estado nutricional en menores de 5 anos,clasificacion d,2001-04-01,0,20,0,20,20
51003,SAN ANTONIO DE ESMORUCO,estado nutricional en menores de 5 anos,clasificacion d,2001-04-01,0,10,0,10,10
71105,SAN ANTONIO DE LOMERIO,estado nutricional en menores de 5 anos,clasificacion d,2001-04-01,18,113,18,113,131
31403,SAN BENITO,estado nutricional en menores de 5 anos,clasificacion d,2001-04-01,0,49,0,49,49
80302,SAN BORJA,estado nutricional en menores de 5 anos,clasificacion d,2001-04-01,3,112,3,112,115
21502,SAN BUENA VENTURA,estado nutricional en menores de 5 anos,clasificacion d,2001-04-01,3,69,3,69,72
70402,SAN CARLOS,estado nutricional en menores de 5 anos,clasificacion d,2001-04-01,16,60,16,60,76
80501,SAN IGNACIO,estado nutricional en menores de 5 anos,clasificacion d,2001-04-01,1,115,1,115,116
70301,SAN IGNACIO DE VELASCO,estado nutricional en menores de 5 anos,clasificacion d,2001-04-01,12,427,12,427,439
80102,SAN JAVIER(BNI),estado nutricional en menores de 5 anos,clasificacion d,2001-04-01,1,11,1,11,12
71102,SAN JAVIER(STC),estado nutricional en menores de 5 anos,clasificacion d,2001-04-01,5,10,5,10,15
80701,SAN JOAQUIN,estado nutricional en menores de 5 anos,clasificacion d,2001-04-01,1,8,1,8,9
70501,SAN JOSE DE CHIQUITOS,estado nutricional en menores de 5 anos,clasificacion d,2001-04-01,0,81,0,81,81
71104,SAN JULIAN,estado nutricional en menores de 5 anos,clasificacion d,2001-04-01,8,289,8,289,297
90302,SAN LORENZO(PND),estado nutricional en menores de 5 anos,clasificacion d,2001-04-01,0,10,0,10,10
60501,SAN LORENZO(TJA),estado nutricional en menores de 5 anos,clasificacion d,2001-04-01,2,56,2,56,58
10702,SAN LUCAS,estado nutricional en menores de 5 anos,clasificacion d,2001-04-01,7,580,7,580,587
71201,SAN MATIAS,estado nutricional en menores de 5 anos,clasificacion d,2001-04-01,2,45,2,45,47
70302,SAN MIGUEL DE VELASCO,estado nutricional en menores de 5 anos,clasificacion d,2001-04-01,1,99,1,99,100
51001,SAN PABLO DE LIPEZ,estado nutricional en menores de 5 anos,clasificacion d,2001-04-01,2,18,2,18,20
50501,SAN PEDRO DE BUENA VISTA,estado nutricional en menores de 5 anos,clasificacion d,2001-04-01,3,216,3,216,219
21801,SAN PEDRO DE CURAHUARA,estado nutricional en menores de 5 anos,clasificacion d,2001-04-01,1,31,1,31,32
50902,SAN PEDRO DE QUEMES,estado nutricional en menores de 5 anos,clasificacion d,2001-04-01,1,5,1,5,6
21702,SAN PEDRO DE TIQUINA,estado nutricional en menores de 5 anos,clasificacion d,2001-04-01,0,8,0,8,8
70303,SAN RAFAEL,estado nutricional en menores de 5 anos,clasificacion d,2001-04-01,0,55,0,55,55
80702,SAN RAMON,estado nutricional en menores de 5 anos,clasificacion d,2001-04-01,0,2,0,2,2
80702,SAN RAMON,estado nutricional en menores de 5 anos,clasificacion d,2001-04-01,3,12,3,12,15
80401,SANTA ANA,estado nutricional en menores de 5 anos,clasificacion d,2001-04-01,6,59,6,59,65
70101,SANTA CRUZ DE LA SIERRA,estado nutricional en menores de 5 anos,clasificacion d,2001-04-01,66,390,66,390,456
80303,SANTA ROSA,estado nutricional en menores de 5 anos,clasificacion d,2001-04-01,5,19,5,19,24
70602,SANTA ROSA DEL SARA,estado nutricional en menores de 5 anos,clasificacion d,2001-04-01,2,22,2,22,24
20308,SANTIAGO DE CALLAPA,estado nutricional en menores de 5 anos,clasificacion d,2001-04-01,2,31,2,31,33
41401,SANTIAGO DE HUARI,estado nutricional en menores de 5 anos,clasificacion d,2001-04-01,2,31,2,31,33
21901,SANTIAGO DE MACHACA,estado nutricional en menores de 5 anos,clasificacion d,2001-04-01,1,5,1,5,6
30702,SANTIVAÃ‘ES,estado nutricional en menores de 5 anos,clasificacion d,2001-04-01,14,29,14,29,43
40202,SANTUARIO DE QUILLACAS,estado nutricional en menores de 5 anos,clasificacion d,2001-04-01,0,26,0,26,26
20902,SAPAHAQUI,estado nutricional en menores de 5 anos,clasificacion d,2001-04-01,3,37,3,37,40
21301,SICA SICA (VILLA AROMA),estado nutricional en menores de 5 anos,clasificacion d,2001-04-01,2,52,2,52,54
30703,SICAYA,estado nutricional en menores de 5 anos,clasificacion d,2001-04-01,1,27,1,27,28
10403,SOPACHUY,estado nutricional en menores de 5 anos,clasificacion d,2001-04-01,3,228,3,228,231
20601,SORATA,estado nutricional en menores de 5 anos,clasificacion d,2001-04-01,3,65,3,65,68
10101,SUCRE,estado nutricional en menores de 5 anos,clasificacion d,2001-04-01,31,1439,31,1439,1470
31404,TACACHI,estado nutricional en menores de 5 anos,clasificacion d,2001-04-01,0,3,0,3,3
20603,TACACOMA,estado nutricional en menores de 5 anos,clasificacion d,2001-04-01,0,11,0,11,11
50303,TACOBAMBA,estado nutricional en menores de 5 anos,clasificacion d,2001-04-01,3,100,3,100,103
30602,TACOPAYA,estado nutricional en menores de 5 anos,clasificacion d,2001-04-01,1,161,1,161,162
51402,TAHUA,estado nutricional en menores de 5 anos,clasificacion d,2001-04-01,0,8,0,8,8
31101,TAPACARI,estado nutricional en menores de 5 anos,clasificacion d,2001-04-01,14,112,14,112,126
10601,TARABUCO,estado nutricional en menores de 5 anos,clasificacion d,2001-04-01,10,591,10,591,601
30401,TARATA,estado nutricional en menores de 5 anos,clasificacion d,2001-04-01,2,37,2,37,39
60101,TARIJA,estado nutricional en menores de 5 anos,clasificacion d,2001-04-01,5,227,5,227,232
10202,TARVITA,estado nutricional en menores de 5 anos,clasificacion d,2001-04-01,4,231,4,231,235
20803,TIAWANACU,estado nutricional en menores de 5 anos,clasificacion d,2001-04-01,3,35,3,35,38
50102,TINGUIPAYA,estado nutricional en menores de 5 anos,clasificacion d,2001-04-01,6,83,6,83,89
20606,TIPUANI,estado nutricional en menores de 5 anos,clasificacion d,2001-04-01,0,6,0,6,6
30903,TIQUIPAYA,estado nutricional en menores de 5 anos,clasificacion d,2001-04-01,1,87,1,87,88
31601,TIRAQUE (CBBA),estado nutricional en menores de 5 anos,clasificacion d,2001-04-01,2,64,2,64,66
21703,TITO YUPANQUI (PARQUIPUJIO),estado nutricional en menores de 5 anos,clasificacion d,2001-04-01,0,8,0,8,8
30802,TOCO,estado nutricional en menores de 5 anos,clasificacion d,2001-04-01,5,11,5,11,16
30803,TOLATA,estado nutricional en menores de 5 anos,clasificacion d,2001-04-01,0,10,0,10,10
41001,TOLEDO,estado nutricional en menores de 5 anos,clasificacion d,2001-04-01,0,9,0,9,9
51202,TOMAVE,estado nutricional en menores de 5 anos,clasificacion d,2001-04-01,8,146,8,146,154
10402,TOMINA,estado nutricional en menores de 5 anos,clasificacion d,2001-04-01,2,305,2,305,307
50502,TORO TORO,estado nutricional en menores de 5 anos,clasificacion d,2001-04-01,0,11,0,11,11
31201,TOTORA(CBBA),estado nutricional en menores de 5 anos,clasificacion d,2001-04-01,3,150,3,150,153
41301,TOTORA(ORR),estado nutricional en menores de 5 anos,clasificacion d,2001-04-01,1,15,1,15,16
70802,TRIGAL,estado nutricional en menores de 5 anos,clasificacion d,2001-04-01,0,9,0,9,9
80101,TRINIDAD,estado nutricional en menores de 5 anos,clasificacion d,2001-04-01,19,159,19,159,178
50801,TUPIZA,estado nutricional en menores de 5 anos,clasificacion d,2001-04-01,6,413,6,413,419
40402,TURCO,estado nutricional en menores de 5 anos,clasificacion d,2001-04-01,0,13,0,13,13
21302,UMALA,estado nutricional en menores de 5 anos,clasificacion d,2001-04-01,0,14,0,14,14
50201,UNCIA,estado nutricional en menores de 5 anos,clasificacion d,2001-04-01,6,39,6,39,45
60401,URIONDO (A. CONCEPCION),estado nutricional en menores de 5 anos,clasificacion d,2001-04-01,1,30,1,30,31
71502,URUBICHA,estado nutricional en menores de 5 anos,clasificacion d,2001-04-01,0,24,0,24,24
51201,UYUNI,estado nutricional en menores de 5 anos,clasificacion d,2001-04-01,0,192,0,192,192
30502,VACAS,estado nutricional en menores de 5 anos,clasificacion d,2001-04-01,0,7,0,7,7
70801,VALLEGRANDE,estado nutricional en menores de 5 anos,clasificacion d,2001-04-01,9,68,9,68,77
20801,VIACHA,estado nutricional en menores de 5 anos,clasificacion d,2001-04-01,19,133,19,133,152
31302,VILA VILA,estado nutricional en menores de 5 anos,clasificacion d,2001-04-01,25,13,25,13,38
60303,VILLA MONTES,estado nutricional en menores de 5 anos,clasificacion d,2001-04-01,5,72,5,72,77
31402,VILLA RIVERO,estado nutricional en menores de 5 anos,clasificacion d,2001-04-01,1,13,1,13,14
10801,VILLA SERRANO,estado nutricional en menores de 5 anos,clasificacion d,2001-04-01,4,340,4,340,344
31003,VILLA TUNARI,estado nutricional en menores de 5 anos,clasificacion d,2001-04-01,3,58,3,58,61
11001,VILLA VACA GUZMAN (MUYUPAMPA),estado nutricional en menores de 5 anos,clasificacion d,2001-04-01,1,203,1,203,204
51501,VILLAZON,estado nutricional en menores de 5 anos,clasificacion d,2001-04-01,4,224,4,224,228
30904,VINTO,estado nutricional en menores de 5 anos,clasificacion d,2001-04-01,5,107,5,107,112
50602,VITICHI,estado nutricional en menores de 5 anos,clasificacion d,2001-04-01,2,113,2,113,115
20306,WALDO BALLIVIAN,estado nutricional en menores de 5 anos,clasificacion d,2001-04-01,0,8,0,8,8
70201,WARNES,estado nutricional en menores de 5 anos,clasificacion d,2001-04-01,3,89,3,89,92
20903,YACO,estado nutricional en menores de 5 anos,clasificacion d,2001-04-01,0,24,0,24,24
60301,YACUIBA,estado nutricional en menores de 5 anos,clasificacion d,2001-04-01,5,111,5,111,116
10602,YAMPARAEZ,estado nutricional en menores de 5 anos,clasificacion d,2001-04-01,6,388,6,388,394
21103,YANACACHI,estado nutricional en menores de 5 anos,clasificacion d,2001-04-01,1,23,1,23,24
70403,YAPACANI,estado nutricional en menores de 5 anos,clasificacion d,2001-04-01,3,56,3,56,59
50103,YOCALLA,estado nutricional en menores de 5 anos,clasificacion d,2001-04-01,6,129,6,129,135
10102,YOTALA,estado nutricional en menores de 5 anos,clasificacion d,2001-04-01,0,348,0,348,348
60402,YUNCHARA,estado nutricional en menores de 5 anos,clasificacion d,2001-04-01,0,24,0,24,24
10301,ZUDAÃ‘EZ,estado nutricional en menores de 5 anos,clasificacion d,2001-04-01,5,241,5,241,246
51302,ACACIO,estado nutricional en menores de 5 anos,clasificacion d,2001-05-01,0,122,0,122,122
20201,ACHACACHI,estado nutricional en menores de 5 anos,clasificacion d,2001-05-01,8,222,8,222,230
20104,ACHOCALLA,estado nutricional en menores de 5 anos,clasificacion d,2001-05-01,1,41,1,41,42
30201,AIQUILE,estado nutricional en menores de 5 anos,clasificacion d,2001-05-01,33,103,33,103,136
31303,ALALAY,estado nutricional en menores de 5 anos,clasificacion d,2001-05-01,19,2,19,2,21
10404,ALCALA,estado nutricional en menores de 5 anos,clasificacion d,2001-05-01,1,90,1,90,91
20202,ANCORAIMES,estado nutricional en menores de 5 anos,clasificacion d,2001-05-01,1,223,1,223,224
41201,ANDAMARCA,estado nutricional en menores de 5 anos,clasificacion d,2001-05-01,0,7,0,7,7
40603,ANTEQUERA,estado nutricional en menores de 5 anos,clasificacion d,2001-05-01,0,9,0,9,9
30402,ANZALDO,estado nutricional en menores de 5 anos,clasificacion d,2001-05-01,6,94,6,94,100
20701,APOLO,estado nutricional en menores de 5 anos,clasificacion d,2001-05-01,9,1,9,1,10
51301,ARAMPAMPA,estado nutricional en menores de 5 anos,clasificacion d,2001-05-01,3,34,3,34,37
30501,ARANI,estado nutricional en menores de 5 anos,clasificacion d,2001-05-01,1,22,1,22,23
30403,ARBIETO,estado nutricional en menores de 5 anos,clasificacion d,2001-05-01,0,20,0,20,20
30601,ARQUE,estado nutricional en menores de 5 anos,clasificacion d,2001-05-01,2,50,2,50,52
71501,ASCENCION DE GUARAYOS,estado nutricional en menores de 5 anos,clasificacion d,2001-05-01,0,36,0,36,36
50802,ATOCHA,estado nutricional en menores de 5 anos,clasificacion d,2001-05-01,2,36,2,36,38
20503,AUCAPATA,estado nutricional en menores de 5 anos,clasificacion d,2001-05-01,7,16,7,16,23
20502,AYATA,estado nutricional en menores de 5 anos,clasificacion d,2001-05-01,9,15,9,15,24
21303,AYO AYO,estado nutricional en menores de 5 anos,clasificacion d,2001-05-01,5,4,5,4,9
30301,AYOPAYA (V. DE INDEPENDENCIA),estado nutricional en menores de 5 anos,clasificacion d,2001-05-01,5,201,5,201,206
10201,AZURDUY,estado nutricional en menores de 5 anos,clasificacion d,2001-05-01,3,190,3,190,193
21203,BATALLAS,estado nutricional en menores de 5 anos,clasificacion d,2001-05-01,2,69,2,69,71
80802,BAURES,estado nutricional en menores de 5 anos,clasificacion d,2001-05-01,2,61,2,61,63
41202,BELEN DE ANDAMARCA,estado nutricional en menores de 5 anos,clasificacion d,2001-05-01,0,5,0,5,5
50104,BELEN DE URMIRI,estado nutricional en menores de 5 anos,clasificacion d,2001-05-01,1,59,1,59,60
90104,BELLA FLOR,estado nutricional en menores de 5 anos,clasificacion d,2001-05-01,0,11,0,11,11
60202,BERMEJO,estado nutricional en menores de 5 anos,clasificacion d,2001-05-01,1,7,1,7,8
50301,BETANZOS,estado nutricional en menores de 5 anos,clasificacion d,2001-05-01,10,507,10,507,517
31501,BOLIVAR,estado nutricional en menores de 5 anos,clasificacion d,2001-05-01,10,179,10,179,189
90103,BOLPEBRA,estado nutricional en menores de 5 anos,clasificacion d,2001-05-01,0,22,0,22,22
70707,BOYUIBE,estado nutricional en menores de 5 anos,clasificacion d,2001-05-01,2,37,2,37,39
70401,BUENA VISTA,estado nutricional en menores de 5 anos,clasificacion d,2001-05-01,9,66,9,66,75
70703,CABEZAS,estado nutricional en menores de 5 anos,clasificacion d,2001-05-01,7,121,7,121,128
20905,CAIROMA,estado nutricional en menores de 5 anos,clasificacion d,2001-05-01,1,22,1,22,23
51102,"CAIZA ""D""",estado nutricional en menores de 5 anos,clasificacion d,2001-05-01,3,216,3,216,219
21003,CAJUATA,estado nutricional en menores de 5 anos,clasificacion d,2001-05-01,0,7,0,7,7
20303,CALACOTO,estado nutricional en menores de 5 anos,clasificacion d,2001-05-01,2,2,2,2,4
21304,CALAMARCA,estado nutricional en menores de 5 anos,clasificacion d,2001-05-01,11,35,11,35,46
10701,CAMARGO,estado nutricional en menores de 5 anos,clasificacion d,2001-05-01,2,148,2,148,150
10901,CAMATAQUI (C. VILLA ABECIA),estado nutricional en menores de 5 anos,clasificacion d,2001-05-01,0,64,0,64,64
70706,CAMIRI,estado nutricional en menores de 5 anos,clasificacion d,2001-05-01,0,169,0,169,169
30701,CAPINOTA,estado nutricional en menores de 5 anos,clasificacion d,2001-05-01,23,88,23,88,111
20302,CAQUIAVIRI,estado nutricional en menores de 5 anos,clasificacion d,2001-05-01,1,43,1,43,44
40102,CARACOLLO,estado nutricional en menores de 5 anos,clasificacion d,2001-05-01,0,83,0,83,83
22001,CARANAVI,estado nutricional en menores de 5 anos,clasificacion d,2001-05-01,10,248,10,248,258
41503,CARANGAS,estado nutricional en menores de 5 anos,clasificacion d,2001-05-01,0,1,0,1,1
60302,CARAPARI,estado nutricional en menores de 5 anos,clasificacion d,2001-05-01,1,58,1,58,59
50702,CARIPUYO,estado nutricional en menores de 5 anos,clasificacion d,2001-05-01,1,140,1,140,141
21902,CATACORA,estado nutricional en menores de 5 anos,clasificacion d,2001-05-01,0,7,0,7,7
21803,CHACARILLA,estado nutricional en menores de 5 anos,clasificacion d,2001-05-01,0,2,0,2,2
40201,CHALLAPATA,estado nutricional en menores de 5 anos,clasificacion d,2001-05-01,50,73,50,73,123
50302,CHAQUI,estado nutricional en menores de 5 anos,clasificacion d,2001-05-01,1,95,1,95,96
70702,CHARAGUA,estado nutricional en menores de 5 anos,clasificacion d,2001-05-01,9,222,9,222,231
20305,CHARAÃ‘A,estado nutricional en menores de 5 anos,clasificacion d,2001-05-01,1,8,1,8,9
50202,CHAYANTA,estado nutricional en menores de 5 anos,clasificacion d,2001-05-01,2,150,2,150,152
31204,CHIMORE,estado nutricional en menores de 5 anos,clasificacion d,2001-05-01,14,67,14,67,81
40903,CHIPAYA,estado nutricional en menores de 5 anos,clasificacion d,2001-05-01,1,2,1,2,3
40302,CHOQUE COTA,estado nutricional en menores de 5 anos,clasificacion d,2001-05-01,0,21,0,21,21
21101,CHULUMANI (V. DE LA LIBERTAD),estado nutricional en menores de 5 anos,clasificacion d,2001-05-01,5,7,5,7,12
20501,CHUMA,estado nutricional en menores de 5 anos,clasificacion d,2001-05-01,6,20,6,20,26
30801,CLIZA,estado nutricional en menores de 5 anos,clasificacion d,2001-05-01,2,22,2,22,24
90101,COBIJA,estado nutricional en menores de 5 anos,clasificacion d,2001-05-01,3,121,3,121,124
30101,COCHABAMBA,estado nutricional en menores de 5 anos,clasificacion d,2001-05-01,96,597,96,597,693
30905,COLCAPIRHUA,estado nutricional en menores de 5 anos,clasificacion d,2001-05-01,5,17,5,17,22
50901,"COLCHA ""K""",estado nutricional en menores de 5 anos,clasificacion d,2001-05-01,2,108,2,108,110
21307,COLLANA,estado nutricional en menores de 5 anos,clasificacion d,2001-05-01,0,3,0,3,3
31002,COLOMI,estado nutricional en menores de 5 anos,clasificacion d,2001-05-01,2,83,2,83,85
70603,COLPA BELGICA,estado nutricional en menores de 5 anos,clasificacion d,2001-05-01,2,17,2,17,19
50401,COLQUECHACA,estado nutricional en menores de 5 anos,clasificacion d,2001-05-01,4,164,4,164,168
21306,COLQUENCHA,estado nutricional en menores de 5 anos,clasificacion d,2001-05-01,4,29,4,29,33
21004,COLQUIRI,estado nutricional en menores de 5 anos,clasificacion d,2001-05-01,5,175,5,175,180
20304,COMANCHE,estado nutricional en menores de 5 anos,clasificacion d,2001-05-01,6,12,6,12,18
71301,COMARAPA,estado nutricional en menores de 5 anos,clasificacion d,2001-05-01,1,7,1,7,8
20605,COMBAYA,estado nutricional en menores de 5 anos,clasificacion d,2001-05-01,0,3,0,3,3
71101,CONCEPCION,estado nutricional en menores de 5 anos,clasificacion d,2001-05-01,3,65,3,65,68
21701,COPACABANA,estado nutricional en menores de 5 anos,clasificacion d,2001-05-01,3,93,3,93,96
21402,CORIPATA,estado nutricional en menores de 5 anos,clasificacion d,2001-05-01,2,11,2,11,13
20301,CORO CORO,estado nutricional en menores de 5 anos,clasificacion d,2001-05-01,2,39,2,39,41
21401,COROICO,estado nutricional en menores de 5 anos,clasificacion d,2001-05-01,2,39,2,39,41
40301,CORQUE,estado nutricional en menores de 5 anos,clasificacion d,2001-05-01,2,33,2,33,35
50601,COTAGAITA,estado nutricional en menores de 5 anos,clasificacion d,2001-05-01,2,187,2,187,189
70102,COTOCA,estado nutricional en menores de 5 anos,clasificacion d,2001-05-01,1,11,1,11,12
31405,CUCHUMUELA (V. G. VILLARROEL),estado nutricional en menores de 5 anos,clasificacion d,2001-05-01,0,11,0,11,11
70704,CUEVO,estado nutricional en menores de 5 anos,clasificacion d,2001-05-01,0,42,0,42,42
10902,CULPINA,estado nutricional en menores de 5 anos,clasificacion d,2001-05-01,5,341,5,341,346
40401,CURAHUARA DE CARANGAS,estado nutricional en menores de 5 anos,clasificacion d,2001-05-01,11,11,11,11,22
21602,CURVA,estado nutricional en menores de 5 anos,clasificacion d,2001-05-01,0,13,0,13,13
20804,DESAGUADERO,estado nutricional en menores de 5 anos,clasificacion d,2001-05-01,8,26,8,26,34
20105,EL ALTO,estado nutricional en menores de 5 anos,clasificacion d,2001-05-01,350,2551,350,2551,2901
40103,EL CHORO,estado nutricional en menores de 5 anos,clasificacion d,2001-05-01,0,3,0,3,3
71503,EL PUENTE(STC),estado nutricional en menores de 5 anos,clasificacion d,2001-05-01,4,126,4,126,130
60502,EL PUENTE(TJA),estado nutricional en menores de 5 anos,clasificacion d,2001-05-01,4,74,4,74,78
70105,EL TORNO,estado nutricional en menores de 5 anos,clasificacion d,2001-05-01,13,107,13,107,120
10405,EL VILLAR,estado nutricional en menores de 5 anos,clasificacion d,2001-05-01,1,186,1,186,187
60601,ENTRE RIOS,estado nutricional en menores de 5 anos,clasificacion d,2001-05-01,2,118,2,118,120
41101,EUCALIPTUS,estado nutricional en menores de 5 anos,clasificacion d,2001-05-01,0,23,0,23,23
80402,EXALTACION,estado nutricional en menores de 5 anos,clasificacion d,2001-05-01,0,40,0,40,40
90203,FILADELFIA,estado nutricional en menores de 5 anos,clasificacion d,2001-05-01,0,4,0,4,4
71002,GENERAL SAAVEDRA,estado nutricional en menores de 5 anos,clasificacion d,2001-05-01,3,127,3,127,130
21601,GRAL. J.J. PEREZ (CHARAZANI),estado nutricional en menores de 5 anos,clasificacion d,2001-05-01,1,17,1,17,18
20602,GUANAY,estado nutricional en menores de 5 anos,clasificacion d,2001-05-01,6,120,6,120,126
20802,GUAQUI,estado nutricional en menores de 5 anos,clasificacion d,2001-05-01,0,38,0,38,38
80202,GUAYARAMERIN,estado nutricional en menores de 5 anos,clasificacion d,2001-05-01,13,122,13,122,135
70705,GUTIERREZ,estado nutricional en menores de 5 anos,clasificacion d,2001-05-01,3,207,3,207,210
10502,HUACARETA,estado nutricional en menores de 5 anos,clasificacion d,2001-05-01,4,261,4,261,265
11002,HUACAYA (VILLA DE HUACAYA),estado nutricional en menores de 5 anos,clasificacion d,2001-05-01,0,35,0,35,35
40501,HUACHACALLA,estado nutricional en menores de 5 anos,clasificacion d,2001-05-01,4,1,4,1,5
40701,HUANUNI,estado nutricional en menores de 5 anos,clasificacion d,2001-05-01,9,15,9,15,24
80803,HUARACAJE,estado nutricional en menores de 5 anos,clasificacion d,2001-05-01,0,27,0,27,27
41601,HUAYLLAMARCA,estado nutricional en menores de 5 anos,clasificacion d,2001-05-01,0,34,0,34,34
21005,ICHOCA,estado nutricional en menores de 5 anos,clasificacion d,2001-05-01,0,13,0,13,13
10304,ICLA,estado nutricional en menores de 5 anos,clasificacion d,2001-05-01,4,358,4,358,362
10703,INCAHUASI,estado nutricional en menores de 5 anos,clasificacion d,2001-05-01,3,219,3,219,222
21001,INQUISIVI,estado nutricional en menores de 5 anos,clasificacion d,2001-05-01,3,117,3,117,120
21102,IRUPANA (VILLA DE LANZA),estado nutricional en menores de 5 anos,clasificacion d,2001-05-01,4,72,4,72,76
21501,IXIAMAS,estado nutricional en menores de 5 anos,clasificacion d,2001-05-01,3,39,3,39,42
21105,LA ASUNTA,estado nutricional en menores de 5 anos,clasificacion d,2001-05-01,2,124,2,124,126
70104,LA GUARDIA,estado nutricional en menores de 5 anos,clasificacion d,2001-05-01,1,135,1,135,136
20101,LA PAZ,estado nutricional en menores de 5 anos,clasificacion d,2001-05-01,248,1668,248,1668,1916
41501,LA RIVERA,estado nutricional en menores de 5 anos,clasificacion d,2001-05-01,0,2,0,2,2
70701,LAGUNILLAS,estado nutricional en menores de 5 anos,clasificacion d,2001-05-01,6,20,6,20,26
21202,LAJA,estado nutricional en menores de 5 anos,clasificacion d,2001-05-01,1,35,1,35,36
10903,LAS CARRERAS,estado nutricional en menores de 5 anos,clasificacion d,2001-05-01,0,46,0,46,46
21006,LICOMA PAMPA,estado nutricional en menores de 5 anos,clasificacion d,2001-05-01,0,16,0,16,16
50203,LLALLAGUA,estado nutricional en menores de 5 anos,clasificacion d,2001-05-01,5,217,5,217,222
51401,LLICA,estado nutricional en menores de 5 anos,clasificacion d,2001-05-01,0,31,0,31,31
80601,LORETO,estado nutricional en menores de 5 anos,clasificacion d,2001-05-01,0,4,0,4,4
20901,LURIBAY,estado nutricional en menores de 5 anos,clasificacion d,2001-05-01,3,19,3,19,22
40702,MACHACAMARCA,estado nutricional en menores de 5 anos,clasificacion d,2001-05-01,1,9,1,9,10
11003,MACHARETI,estado nutricional en menores de 5 anos,clasificacion d,2001-05-01,3,98,3,98,101
80801,MAGDALENA,estado nutricional en menores de 5 anos,clasificacion d,2001-05-01,0,8,0,8,8
70903,MAIRANA,estado nutricional en menores de 5 anos,clasificacion d,2001-05-01,1,38,1,38,39
20103,MECAPACA,estado nutricional en menores de 5 anos,clasificacion d,2001-05-01,5,41,5,41,46
71003,MINEROS,estado nutricional en menores de 5 anos,clasificacion d,2001-05-01,9,267,9,267,276
31301,MIZQUE,estado nutricional en menores de 5 anos,clasificacion d,2001-05-01,66,89,66,89,155
20402,MOCOMOCO,estado nutricional en menores de 5 anos,clasificacion d,2001-05-01,20,54,20,54,74
51002,MOJINETE,estado nutricional en menores de 5 anos,clasificacion d,2001-05-01,0,14,0,14,14
10303,MOJOCOYA,estado nutricional en menores de 5 anos,clasificacion d,2001-05-01,1,78,1,78,79
10501,MONTEAGUDO,estado nutricional en menores de 5 anos,clasificacion d,2001-05-01,11,359,11,359,370
71001,MONTERO,estado nutricional en menores de 5 anos,clasificacion d,2001-05-01,27,479,27,479,506
70803,MORO MORO,estado nutricional en menores de 5 anos,clasificacion d,2001-05-01,0,22,0,22,22
30302,MOROCHATA,estado nutricional en menores de 5 anos,clasificacion d,2001-05-01,10,23,10,23,33
90401,NACEBE (SANTA ROSA DEL ABUNA),estado nutricional en menores de 5 anos,clasificacion d,2001-05-01,0,7,0,7,7
90501,NUEVO MANOA (NUEVA ESPERANZA),estado nutricional en menores de 5 anos,clasificacion d,2001-05-01,0,1,0,1,1
50404,OCURI,estado nutricional en menores de 5 anos,clasificacion d,2001-05-01,1,139,1,139,140
70202,OKINAWA,estado nutricional en menores de 5 anos,clasificacion d,2001-05-01,1,46,1,46,47
30203,OMEREQUE,estado nutricional en menores de 5 anos,clasificacion d,2001-05-01,1,39,1,39,40
40101,ORURO,estado nutricional en menores de 5 anos,clasificacion d,2001-05-01,55,654,55,654,709
60201,PADCAYA,estado nutricional en menores de 5 anos,clasificacion d,2001-05-01,2,114,2,114,116
10401,PADILLA,estado nutricional en menores de 5 anos,clasificacion d,2001-05-01,4,381,4,381,385
70502,PAILON,estado nutricional en menores de 5 anos,clasificacion d,2001-05-01,2,39,2,39,41
20102,PALCA,estado nutricional en menores de 5 anos,clasificacion d,2001-05-01,3,89,3,89,92
21104,PALOS BLANCOS,estado nutricional en menores de 5 anos,clasificacion d,2001-05-01,12,101,12,101,113
40802,PAMPA AULLAGAS,estado nutricional en menores de 5 anos,clasificacion d,2001-05-01,13,7,13,7,20
70902,PAMPA GRANDE,estado nutricional en menores de 5 anos,clasificacion d,2001-05-01,0,43,0,43,43
21802,PAPEL PAMPA,estado nutricional en menores de 5 anos,clasificacion d,2001-05-01,0,7,0,7,7
30202,PASORAPA,estado nutricional en menores de 5 anos,clasificacion d,2001-05-01,0,36,0,36,36
21305,PATACAMAYA,estado nutricional en menores de 5 anos,clasificacion d,2001-05-01,34,37,34,37,71
40602,PAZÃ‘A,estado nutricional en menores de 5 anos,clasificacion d,2001-05-01,3,36,3,36,39
20702,PELECHUCO,estado nutricional en menores de 5 anos,clasificacion d,2001-05-01,5,23,5,23,28
50403,POCOATA,estado nutricional en menores de 5 anos,clasificacion d,2001-05-01,17,195,17,195,212
31203,POCONA,estado nutricional en menores de 5 anos,clasificacion d,2001-05-01,0,81,0,81,81
31202,POJO (CBBA),estado nutricional en menores de 5 anos,clasificacion d,2001-05-01,52,202,52,202,254
40601,POOPO,estado nutricional en menores de 5 anos,clasificacion d,2001-05-01,0,23,0,23,23
51203,PORCO,estado nutricional en menores de 5 anos,clasificacion d,2001-05-01,2,47,2,47,49
10103,POROMA,estado nutricional en menores de 5 anos,clasificacion d,2001-05-01,13,269,13,269,282
70103,PORONGO,estado nutricional en menores de 5 anos,clasificacion d,2001-05-01,0,56,0,56,56
70601,PORTACHUELO,estado nutricional en menores de 5 anos,clasificacion d,2001-05-01,45,53,45,53,98
90102,PORVENIR,estado nutricional en menores de 5 anos,clasificacion d,2001-05-01,0,43,0,43,43
50101,POTOSI,estado nutricional en menores de 5 anos,clasificacion d,2001-05-01,32,884,32,884,916
10302,PRESTO,estado nutricional en menores de 5 anos,clasificacion d,2001-05-01,3,149,3,149,152
21201,PUCARANI,estado nutricional en menores de 5 anos,clasificacion d,2001-05-01,10,91,10,91,101
20401,PUERTO ACOSTA,estado nutricional en menores de 5 anos,clasificacion d,2001-05-01,10,135,10,135,145
20403,PUERTO CARABUCO,estado nutricional en menores de 5 anos,clasificacion d,2001-05-01,1,110,1,110,111
90301,PUERTO GONZALO MORENO,estado nutricional en menores de 5 anos,clasificacion d,2001-05-01,0,16,0,16,16
21204,PUERTO PEREZ,estado nutricional en menores de 5 anos,clasificacion d,2001-05-01,8,25,8,25,33
71402,PUERTO QUIJARRO,estado nutricional en menores de 5 anos,clasificacion d,2001-05-01,2,28,2,28,30
90201,PUERTO RICO,estado nutricional en menores de 5 anos,clasificacion d,2001-05-01,0,11,0,11,11
80703,PUERTO SILES,estado nutricional en menores de 5 anos,clasificacion d,2001-05-01,1,8,1,8,9
71401,PUERTO SUAREZ,estado nutricional en menores de 5 anos,clasificacion d,2001-05-01,49,21,49,21,70
31205,PUERTO VILLARROEL,estado nutricional en menores de 5 anos,clasificacion d,2001-05-01,74,157,74,157,231
51101,PUNA,estado nutricional en menores de 5 anos,clasificacion d,2001-05-01,7,467,7,467,474
31401,PUNATA,estado nutricional en menores de 5 anos,clasificacion d,2001-05-01,5,46,5,46,51
20604,QUIABAYA,estado nutricional en menores de 5 anos,clasificacion d,2001-05-01,0,43,0,43,43
30901,QUILLACOLLO,estado nutricional en menores de 5 anos,clasificacion d,2001-05-01,1,3,1,3,4
21002,QUIME,estado nutricional en menores de 5 anos,clasificacion d,2001-05-01,0,67,0,67,67
70904,QUIRUSILLAS,estado nutricional en menores de 5 anos,clasificacion d,2001-05-01,0,3,0,3,3
50402,RAVELO,estado nutricional en menores de 5 anos,clasificacion d,2001-05-01,10,333,10,333,343
80301,REYES,estado nutricional en menores de 5 anos,clasificacion d,2001-05-01,5,60,5,60,65
80201,RIBERALTA,estado nutricional en menores de 5 anos,clasificacion d,2001-05-01,14,435,14,435,449
70503,ROBORE,estado nutricional en menores de 5 anos,clasificacion d,2001-05-01,2,112,2,112,114
80304,RURRENABAQUE,estado nutricional en menores de 5 anos,clasificacion d,2001-05-01,10,3,10,3,13
40901,SABAYA,estado nutricional en menores de 5 anos,clasificacion d,2001-05-01,0,3,0,3,3
31001,SACABA,estado nutricional en menores de 5 anos,clasificacion d,2001-05-01,116,104,116,104,220
30404,SACABAMBA,estado nutricional en menores de 5 anos,clasificacion d,2001-05-01,0,79,0,79,79
50701,SACACA,estado nutricional en menores de 5 anos,clasificacion d,2001-05-01,5,531,5,531,536
71302,SAIPINA,estado nutricional en menores de 5 anos,clasificacion d,2001-05-01,0,4,0,4,4
40801,SALINAS DE GARCI MENDOZA,estado nutricional en menores de 5 anos,clasificacion d,2001-05-01,10,18,10,18,28
70901,SAMAIPATA,estado nutricional en menores de 5 anos,clasificacion d,2001-05-01,0,29,0,29,29
51601,SAN AGUSTIN,estado nutricional en menores de 5 anos,clasificacion d,2001-05-01,1,16,1,16,17
80602,SAN ANDRES,estado nutricional en menores de 5 anos,clasificacion d,2001-05-01,0,40,0,40,40
51003,SAN ANTONIO DE ESMORUCO,estado nutricional en menores de 5 anos,clasificacion d,2001-05-01,0,4,0,4,4
71105,SAN ANTONIO DE LOMERIO,estado nutricional en menores de 5 anos,clasificacion d,2001-05-01,5,189,5,189,194
31403,SAN BENITO,estado nutricional en menores de 5 anos,clasificacion d,2001-05-01,6,56,6,56,62
80302,SAN BORJA,estado nutricional en menores de 5 anos,clasificacion d,2001-05-01,5,134,5,134,139
21502,SAN BUENA VENTURA,estado nutricional en menores de 5 anos,clasificacion d,2001-05-01,1,109,1,109,110
70402,SAN CARLOS,estado nutricional en menores de 5 anos,clasificacion d,2001-05-01,3,58,3,58,61
80501,SAN IGNACIO,estado nutricional en menores de 5 anos,clasificacion d,2001-05-01,4,74,4,74,78
70301,SAN IGNACIO DE VELASCO,estado nutricional en menores de 5 anos,clasificacion d,2001-05-01,15,402,15,402,417
80102,SAN JAVIER(BNI),estado nutricional en menores de 5 anos,clasificacion d,2001-05-01,3,24,3,24,27
71102,SAN JAVIER(STC),estado nutricional en menores de 5 anos,clasificacion d,2001-05-01,4,67,4,67,71
80701,SAN JOAQUIN,estado nutricional en menores de 5 anos,clasificacion d,2001-05-01,2,13,2,13,15
70501,SAN JOSE DE CHIQUITOS,estado nutricional en menores de 5 anos,clasificacion d,2001-05-01,2,89,2,89,91
71104,SAN JULIAN,estado nutricional en menores de 5 anos,clasificacion d,2001-05-01,20,249,20,249,269
90302,SAN LORENZO(PND),estado nutricional en menores de 5 anos,clasificacion d,2001-05-01,0,1,0,1,1
60501,SAN LORENZO(TJA),estado nutricional en menores de 5 anos,clasificacion d,2001-05-01,1,48,1,48,49
10702,SAN LUCAS,estado nutricional en menores de 5 anos,clasificacion d,2001-05-01,11,667,11,667,678
71201,SAN MATIAS,estado nutricional en menores de 5 anos,clasificacion d,2001-05-01,10,82,10,82,92
70302,SAN MIGUEL DE VELASCO,estado nutricional en menores de 5 anos,clasificacion d,2001-05-01,3,143,3,143,146
51001,SAN PABLO DE LIPEZ,estado nutricional en menores de 5 anos,clasificacion d,2001-05-01,2,35,2,35,37
50501,SAN PEDRO DE BUENA VISTA,estado nutricional en menores de 5 anos,clasificacion d,2001-05-01,9,402,9,402,411
21801,SAN PEDRO DE CURAHUARA,estado nutricional en menores de 5 anos,clasificacion d,2001-05-01,0,27,0,27,27
50902,SAN PEDRO DE QUEMES,estado nutricional en menores de 5 anos,clasificacion d,2001-05-01,1,11,1,11,12
21702,SAN PEDRO DE TIQUINA,estado nutricional en menores de 5 anos,clasificacion d,2001-05-01,0,21,0,21,21
90202,SAN PEDRO(PND),estado nutricional en menores de 5 anos,clasificacion d,2001-05-01,0,2,0,2,2
70303,SAN RAFAEL,estado nutricional en menores de 5 anos,clasificacion d,2001-05-01,8,65,8,65,73
80702,SAN RAMON,estado nutricional en menores de 5 anos,clasificacion d,2001-05-01,0,37,0,37,37
80702,SAN RAMON,estado nutricional en menores de 5 anos,clasificacion d,2001-05-01,0,7,0,7,7
80401,SANTA ANA,estado nutricional en menores de 5 anos,clasificacion d,2001-05-01,7,52,7,52,59
70101,SANTA CRUZ DE LA SIERRA,estado nutricional en menores de 5 anos,clasificacion d,2001-05-01,86,378,86,378,464
80303,SANTA ROSA,estado nutricional en menores de 5 anos,clasificacion d,2001-05-01,0,12,0,12,12
70602,SANTA ROSA DEL SARA,estado nutricional en menores de 5 anos,clasificacion d,2001-05-01,5,30,5,30,35
20308,SANTIAGO DE CALLAPA,estado nutricional en menores de 5 anos,clasificacion d,2001-05-01,0,13,0,13,13
41401,SANTIAGO DE HUARI,estado nutricional en menores de 5 anos,clasificacion d,2001-05-01,18,22,18,22,40
21901,SANTIAGO DE MACHACA,estado nutricional en menores de 5 anos,clasificacion d,2001-05-01,1,1,1,1,2
30702,SANTIVAÃ‘ES,estado nutricional en menores de 5 anos,clasificacion d,2001-05-01,12,7,12,7,19
40202,SANTUARIO DE QUILLACAS,estado nutricional en menores de 5 anos,clasificacion d,2001-05-01,10,26,10,26,36
20902,SAPAHAQUI,estado nutricional en menores de 5 anos,clasificacion d,2001-05-01,0,22,0,22,22
21301,SICA SICA (VILLA AROMA),estado nutricional en menores de 5 anos,clasificacion d,2001-05-01,9,34,9,34,43
30703,SICAYA,estado nutricional en menores de 5 anos,clasificacion d,2001-05-01,0,14,0,14,14
30902,SIPE SIPE,estado nutricional en menores de 5 anos,clasificacion d,2001-05-01,28,263,28,263,291
10403,SOPACHUY,estado nutricional en menores de 5 anos,clasificacion d,2001-05-01,4,245,4,245,249
20601,SORATA,estado nutricional en menores de 5 anos,clasificacion d,2001-05-01,4,104,4,104,108
10101,SUCRE,estado nutricional en menores de 5 anos,clasificacion d,2001-05-01,69,1642,69,1642,1711
31404,TACACHI,estado nutricional en menores de 5 anos,clasificacion d,2001-05-01,0,5,0,5,5
20603,TACACOMA,estado nutricional en menores de 5 anos,clasificacion d,2001-05-01,1,30,1,30,31
50303,TACOBAMBA,estado nutricional en menores de 5 anos,clasificacion d,2001-05-01,2,107,2,107,109
30602,TACOPAYA,estado nutricional en menores de 5 anos,clasificacion d,2001-05-01,0,52,0,52,52
51402,TAHUA,estado nutricional en menores de 5 anos,clasificacion d,2001-05-01,2,11,2,11,13
31101,TAPACARI,estado nutricional en menores de 5 anos,clasificacion d,2001-05-01,2,108,2,108,110
10601,TARABUCO,estado nutricional en menores de 5 anos,clasificacion d,2001-05-01,8,720,8,720,728
30401,TARATA,estado nutricional en menores de 5 anos,clasificacion d,2001-05-01,2,82,2,82,84
60101,TARIJA,estado nutricional en menores de 5 anos,clasificacion d,2001-05-01,16,376,16,376,392
10202,TARVITA,estado nutricional en menores de 5 anos,clasificacion d,2001-05-01,2,237,2,237,239
20803,TIAWANACU,estado nutricional en menores de 5 anos,clasificacion d,2001-05-01,4,33,4,33,37
50102,TINGUIPAYA,estado nutricional en menores de 5 anos,clasificacion d,2001-05-01,4,89,4,89,93
20606,TIPUANI,estado nutricional en menores de 5 anos,clasificacion d,2001-05-01,10,2,10,2,12
30903,TIQUIPAYA,estado nutricional en menores de 5 anos,clasificacion d,2001-05-01,0,10,0,10,10
31601,TIRAQUE (CBBA),estado nutricional en menores de 5 anos,clasificacion d,2001-05-01,58,72,58,72,130
21703,TITO YUPANQUI (PARQUIPUJIO),estado nutricional en menores de 5 anos,clasificacion d,2001-05-01,0,9,0,9,9
30802,TOCO,estado nutricional en menores de 5 anos,clasificacion d,2001-05-01,0,21,0,21,21
41502,TODOS SANTOS,estado nutricional en menores de 5 anos,clasificacion d,2001-05-01,0,1,0,1,1
30803,TOLATA,estado nutricional en menores de 5 anos,clasificacion d,2001-05-01,0,5,0,5,5
41001,TOLEDO,estado nutricional en menores de 5 anos,clasificacion d,2001-05-01,1,15,1,15,16
51202,TOMAVE,estado nutricional en menores de 5 anos,clasificacion d,2001-05-01,8,136,8,136,144
10402,TOMINA,estado nutricional en menores de 5 anos,clasificacion d,2001-05-01,3,269,3,269,272
50502,TORO TORO,estado nutricional en menores de 5 anos,clasificacion d,2001-05-01,3,13,3,13,16
31201,TOTORA(CBBA),estado nutricional en menores de 5 anos,clasificacion d,2001-05-01,2,82,2,82,84
41301,TOTORA(ORR),estado nutricional en menores de 5 anos,clasificacion d,2001-05-01,1,20,1,20,21
70802,TRIGAL,estado nutricional en menores de 5 anos,clasificacion d,2001-05-01,0,12,0,12,12
80101,TRINIDAD,estado nutricional en menores de 5 anos,clasificacion d,2001-05-01,22,116,22,116,138
50801,TUPIZA,estado nutricional en menores de 5 anos,clasificacion d,2001-05-01,1,394,1,394,395
40402,TURCO,estado nutricional en menores de 5 anos,clasificacion d,2001-05-01,8,8,8,8,16
21302,UMALA,estado nutricional en menores de 5 anos,clasificacion d,2001-05-01,0,17,0,17,17
50201,UNCIA,estado nutricional en menores de 5 anos,clasificacion d,2001-05-01,2,148,2,148,150
60401,URIONDO (A. CONCEPCION),estado nutricional en menores de 5 anos,clasificacion d,2001-05-01,1,18,1,18,19
71502,URUBICHA,estado nutricional en menores de 5 anos,clasificacion d,2001-05-01,0,118,0,118,118
51201,UYUNI,estado nutricional en menores de 5 anos,clasificacion d,2001-05-01,2,152,2,152,154
30502,VACAS,estado nutricional en menores de 5 anos,clasificacion d,2001-05-01,2,10,2,10,12
70801,VALLEGRANDE,estado nutricional en menores de 5 anos,clasificacion d,2001-05-01,2,51,2,51,53
20801,VIACHA,estado nutricional en menores de 5 anos,clasificacion d,2001-05-01,11,188,11,188,199
31302,VILA VILA,estado nutricional en menores de 5 anos,clasificacion d,2001-05-01,18,14,18,14,32
60303,VILLA MONTES,estado nutricional en menores de 5 anos,clasificacion d,2001-05-01,4,82,4,82,86
90502,VILLA NUEVA (LOMA ALTA),estado nutricional en menores de 5 anos,clasificacion d,2001-05-01,0,9,0,9,9
31402,VILLA RIVERO,estado nutricional en menores de 5 anos,clasificacion d,2001-05-01,0,17,0,17,17
10801,VILLA SERRANO,estado nutricional en menores de 5 anos,clasificacion d,2001-05-01,4,377,4,377,381
31003,VILLA TUNARI,estado nutricional en menores de 5 anos,clasificacion d,2001-05-01,27,109,27,109,136
11001,VILLA VACA GUZMAN (MUYUPAMPA),estado nutricional en menores de 5 anos,clasificacion d,2001-05-01,4,166,4,166,170
51501,VILLAZON,estado nutricional en menores de 5 anos,clasificacion d,2001-05-01,11,268,11,268,279
30904,VINTO,estado nutricional en menores de 5 anos,clasificacion d,2001-05-01,3,71,3,71,74
50602,VITICHI,estado nutricional en menores de 5 anos,clasificacion d,2001-05-01,0,70,0,70,70
20306,WALDO BALLIVIAN,estado nutricional en menores de 5 anos,clasificacion d,2001-05-01,7,2,7,2,9
70201,WARNES,estado nutricional en menores de 5 anos,clasificacion d,2001-05-01,6,139,6,139,145
20903,YACO,estado nutricional en menores de 5 anos,clasificacion d,2001-05-01,0,28,0,28,28
60301,YACUIBA,estado nutricional en menores de 5 anos,clasificacion d,2001-05-01,5,138,5,138,143
10602,YAMPARAEZ,estado nutricional en menores de 5 anos,clasificacion d,2001-05-01,4,399,4,399,403
21103,YANACACHI,estado nutricional en menores de 5 anos,clasificacion d,2001-05-01,0,31,0,31,31
70403,YAPACANI,estado nutricional en menores de 5 anos,clasificacion d,2001-05-01,5,88,5,88,93
50103,YOCALLA,estado nutricional en menores de 5 anos,clasificacion d,2001-05-01,0,100,0,100,100
10102,YOTALA,estado nutricional en menores de 5 anos,clasificacion d,2001-05-01,2,343,2,343,345
60402,YUNCHARA,estado nutricional en menores de 5 anos,clasificacion d,2001-05-01,2,19,2,19,21
10301,ZUDAÃ‘EZ,estado nutricional en menores de 5 anos,clasificacion d,2001-05-01,1,244,1,244,245
51302,ACACIO,estado nutricional en menores de 5 anos,clasificacion d,2001-06-01,0,85,0,85,85
20201,ACHACACHI,estado nutricional en menores de 5 anos,clasificacion d,2001-06-01,9,290,9,290,299
20104,ACHOCALLA,estado nutricional en menores de 5 anos,clasificacion d,2001-06-01,1,38,1,38,39
30201,AIQUILE,estado nutricional en menores de 5 anos,clasificacion d,2001-06-01,5,64,5,64,69
31303,ALALAY,estado nutricional en menores de 5 anos,clasificacion d,2001-06-01,17,17,17,17,34
10404,ALCALA,estado nutricional en menores de 5 anos,clasificacion d,2001-06-01,0,76,0,76,76
20202,ANCORAIMES,estado nutricional en menores de 5 anos,clasificacion d,2001-06-01,1,220,1,220,221
41201,ANDAMARCA,estado nutricional en menores de 5 anos,clasificacion d,2001-06-01,0,14,0,14,14
30402,ANZALDO,estado nutricional en menores de 5 anos,clasificacion d,2001-06-01,0,65,0,65,65
20701,APOLO,estado nutricional en menores de 5 anos,clasificacion d,2001-06-01,6,5,6,5,11
51301,ARAMPAMPA,estado nutricional en menores de 5 anos,clasificacion d,2001-06-01,2,111,2,111,113
30501,ARANI,estado nutricional en menores de 5 anos,clasificacion d,2001-06-01,2,38,2,38,40
30403,ARBIETO,estado nutricional en menores de 5 anos,clasificacion d,2001-06-01,0,38,0,38,38
30601,ARQUE,estado nutricional en menores de 5 anos,clasificacion d,2001-06-01,2,94,2,94,96
71501,ASCENCION DE GUARAYOS,estado nutricional en menores de 5 anos,clasificacion d,2001-06-01,23,377,23,377,400
50802,ATOCHA,estado nutricional en menores de 5 anos,clasificacion d,2001-06-01,3,30,3,30,33
20503,AUCAPATA,estado nutricional en menores de 5 anos,clasificacion d,2001-06-01,4,6,4,6,10
21303,AYO AYO,estado nutricional en menores de 5 anos,clasificacion d,2001-06-01,1,17,1,17,18
30301,AYOPAYA (V. DE INDEPENDENCIA),estado nutricional en menores de 5 anos,clasificacion d,2001-06-01,4,177,4,177,181
10201,AZURDUY,estado nutricional en menores de 5 anos,clasificacion d,2001-06-01,4,324,4,324,328
21203,BATALLAS,estado nutricional en menores de 5 anos,clasificacion d,2001-06-01,3,65,3,65,68
80802,BAURES,estado nutricional en menores de 5 anos,clasificacion d,2001-06-01,0,46,0,46,46
50104,BELEN DE URMIRI,estado nutricional en menores de 5 anos,clasificacion d,2001-06-01,0,54,0,54,54
90104,BELLA FLOR,estado nutricional en menores de 5 anos,clasificacion d,2001-06-01,0,4,0,4,4
60202,BERMEJO,estado nutricional en menores de 5 anos,clasificacion d,2001-06-01,1,12,1,12,13
50301,BETANZOS,estado nutricional en menores de 5 anos,clasificacion d,2001-06-01,5,178,5,178,183
31501,BOLIVAR,estado nutricional en menores de 5 anos,clasificacion d,2001-06-01,1,42,1,42,43
90103,BOLPEBRA,estado nutricional en menores de 5 anos,clasificacion d,2001-06-01,0,7,0,7,7
70707,BOYUIBE,estado nutricional en menores de 5 anos,clasificacion d,2001-06-01,0,39,0,39,39
70401,BUENA VISTA,estado nutricional en menores de 5 anos,clasificacion d,2001-06-01,60,43,60,43,103
70703,CABEZAS,estado nutricional en menores de 5 anos,clasificacion d,2001-06-01,0,85,0,85,85
20905,CAIROMA,estado nutricional en menores de 5 anos,clasificacion d,2001-06-01,0,97,0,97,97
51102,"CAIZA ""D""",estado nutricional en menores de 5 anos,clasificacion d,2001-06-01,14,238,14,238,252
21003,CAJUATA,estado nutricional en menores de 5 anos,clasificacion d,2001-06-01,2,13,2,13,15
20303,CALACOTO,estado nutricional en menores de 5 anos,clasificacion d,2001-06-01,4,8,4,8,12
21304,CALAMARCA,estado nutricional en menores de 5 anos,clasificacion d,2001-06-01,15,38,15,38,53
10701,CAMARGO,estado nutricional en menores de 5 anos,clasificacion d,2001-06-01,0,125,0,125,125
10901,CAMATAQUI (C. VILLA ABECIA),estado nutricional en menores de 5 anos,clasificacion d,2001-06-01,1,59,1,59,60
70706,CAMIRI,estado nutricional en menores de 5 anos,clasificacion d,2001-06-01,17,87,17,87,104
30701,CAPINOTA,estado nutricional en menores de 5 anos,clasificacion d,2001-06-01,29,9,29,9,38
20302,CAQUIAVIRI,estado nutricional en menores de 5 anos,clasificacion d,2001-06-01,0,35,0,35,35
40102,CARACOLLO,estado nutricional en menores de 5 anos,clasificacion d,2001-06-01,1,46,1,46,47
22001,CARANAVI,estado nutricional en menores de 5 anos,clasificacion d,2001-06-01,70,185,70,185,255
41503,CARANGAS,estado nutricional en menores de 5 anos,clasificacion d,2001-06-01,0,2,0,2,2
60302,CARAPARI,estado nutricional en menores de 5 anos,clasificacion d,2001-06-01,0,75,0,75,75
50702,CARIPUYO,estado nutricional en menores de 5 anos,clasificacion d,2001-06-01,2,211,2,211,213
21803,CHACARILLA,estado nutricional en menores de 5 anos,clasificacion d,2001-06-01,0,6,0,6,6
40201,CHALLAPATA,estado nutricional en menores de 5 anos,clasificacion d,2001-06-01,4,10,4,10,14
50302,CHAQUI,estado nutricional en menores de 5 anos,clasificacion d,2001-06-01,0,92,0,92,92
70702,CHARAGUA,estado nutricional en menores de 5 anos,clasificacion d,2001-06-01,3,139,3,139,142
20305,CHARAÃ‘A,estado nutricional en menores de 5 anos,clasificacion d,2001-06-01,0,8,0,8,8
50202,CHAYANTA,estado nutricional en menores de 5 anos,clasificacion d,2001-06-01,2,119,2,119,121
31204,CHIMORE,estado nutricional en menores de 5 anos,clasificacion d,2001-06-01,17,49,17,49,66
40903,CHIPAYA,estado nutricional en menores de 5 anos,clasificacion d,2001-06-01,0,5,0,5,5
40302,CHOQUE COTA,estado nutricional en menores de 5 anos,clasificacion d,2001-06-01,1,4,1,4,5
21101,CHULUMANI (V. DE LA LIBERTAD),estado nutricional en menores de 5 anos,clasificacion d,2001-06-01,3,24,3,24,27
20501,CHUMA,estado nutricional en menores de 5 anos,clasificacion d,2001-06-01,15,20,15,20,35
30801,CLIZA,estado nutricional en menores de 5 anos,clasificacion d,2001-06-01,2,33,2,33,35
90101,COBIJA,estado nutricional en menores de 5 anos,clasificacion d,2001-06-01,49,56,49,56,105
30101,COCHABAMBA,estado nutricional en menores de 5 anos,clasificacion d,2001-06-01,105,398,105,398,503
30905,COLCAPIRHUA,estado nutricional en menores de 5 anos,clasificacion d,2001-06-01,4,13,4,13,17
50901,"COLCHA ""K""",estado nutricional en menores de 5 anos,clasificacion d,2001-06-01,3,110,3,110,113
21307,COLLANA,estado nutricional en menores de 5 anos,clasificacion d,2001-06-01,3,0,3,0,3
31002,COLOMI,estado nutricional en menores de 5 anos,clasificacion d,2001-06-01,11,108,11,108,119
70603,COLPA BELGICA,estado nutricional en menores de 5 anos,clasificacion d,2001-06-01,0,18,0,18,18
50401,COLQUECHACA,estado nutricional en menores de 5 anos,clasificacion d,2001-06-01,6,252,6,252,258
21306,COLQUENCHA,estado nutricional en menores de 5 anos,clasificacion d,2001-06-01,11,18,11,18,29
21004,COLQUIRI,estado nutricional en menores de 5 anos,clasificacion d,2001-06-01,4,244,4,244,248
20304,COMANCHE,estado nutricional en menores de 5 anos,clasificacion d,2001-06-01,0,22,0,22,22
71301,COMARAPA,estado nutricional en menores de 5 anos,clasificacion d,2001-06-01,1,38,1,38,39
20605,COMBAYA,estado nutricional en menores de 5 anos,clasificacion d,2001-06-01,0,17,0,17,17
71101,CONCEPCION,estado nutricional en menores de 5 anos,clasificacion d,2001-06-01,1,102,1,102,103
21701,COPACABANA,estado nutricional en menores de 5 anos,clasificacion d,2001-06-01,3,104,3,104,107
21402,CORIPATA,estado nutricional en menores de 5 anos,clasificacion d,2001-06-01,1,28,1,28,29
20301,CORO CORO,estado nutricional en menores de 5 anos,clasificacion d,2001-06-01,4,90,4,90,94
21401,COROICO,estado nutricional en menores de 5 anos,clasificacion d,2001-06-01,17,18,17,18,35
40301,CORQUE,estado nutricional en menores de 5 anos,clasificacion d,2001-06-01,3,28,3,28,31
50601,COTAGAITA,estado nutricional en menores de 5 anos,clasificacion d,2001-06-01,3,250,3,250,253
70102,COTOCA,estado nutricional en menores de 5 anos,clasificacion d,2001-06-01,0,10,0,10,10
31405,CUCHUMUELA (V. G. VILLARROEL),estado nutricional en menores de 5 anos,clasificacion d,2001-06-01,0,31,0,31,31
70704,CUEVO,estado nutricional en menores de 5 anos,clasificacion d,2001-06-01,30,35,30,35,65
10902,CULPINA,estado nutricional en menores de 5 anos,clasificacion d,2001-06-01,5,361,5,361,366
40401,CURAHUARA DE CARANGAS,estado nutricional en menores de 5 anos,clasificacion d,2001-06-01,14,12,14,12,26
21602,CURVA,estado nutricional en menores de 5 anos,clasificacion d,2001-06-01,0,13,0,13,13
20804,DESAGUADERO,estado nutricional en menores de 5 anos,clasificacion d,2001-06-01,21,11,21,11,32
20105,EL ALTO,estado nutricional en menores de 5 anos,clasificacion d,2001-06-01,718,1560,718,1560,2278
71503,EL PUENTE(STC),estado nutricional en menores de 5 anos,clasificacion d,2001-06-01,2,91,2,91,93
60502,EL PUENTE(TJA),estado nutricional en menores de 5 anos,clasificacion d,2001-06-01,1,50,1,50,51
70105,EL TORNO,estado nutricional en menores de 5 anos,clasificacion d,2001-06-01,3,114,3,114,117
10405,EL VILLAR,estado nutricional en menores de 5 anos,clasificacion d,2001-06-01,1,178,1,178,179
60601,ENTRE RIOS,estado nutricional en menores de 5 anos,clasificacion d,2001-06-01,0,65,0,65,65
41101,EUCALIPTUS,estado nutricional en menores de 5 anos,clasificacion d,2001-06-01,2,10,2,10,12
80402,EXALTACION,estado nutricional en menores de 5 anos,clasificacion d,2001-06-01,4,15,4,15,19
90203,FILADELFIA,estado nutricional en menores de 5 anos,clasificacion d,2001-06-01,0,4,0,4,4
71002,GENERAL SAAVEDRA,estado nutricional en menores de 5 anos,clasificacion d,2001-06-01,17,67,17,67,84
21601,GRAL. J.J. PEREZ (CHARAZANI),estado nutricional en menores de 5 anos,clasificacion d,2001-06-01,6,21,6,21,27
20602,GUANAY,estado nutricional en menores de 5 anos,clasificacion d,2001-06-01,18,155,18,155,173
20802,GUAQUI,estado nutricional en menores de 5 anos,clasificacion d,2001-06-01,0,18,0,18,18
80202,GUAYARAMERIN,estado nutricional en menores de 5 anos,clasificacion d,2001-06-01,3,87,3,87,90
70705,GUTIERREZ,estado nutricional en menores de 5 anos,clasificacion d,2001-06-01,24,151,24,151,175
10502,HUACARETA,estado nutricional en menores de 5 anos,clasificacion d,2001-06-01,2,265,2,265,267
11002,HUACAYA (VILLA DE HUACAYA),estado nutricional en menores de 5 anos,clasificacion d,2001-06-01,0,19,0,19,19
40501,HUACHACALLA,estado nutricional en menores de 5 anos,clasificacion d,2001-06-01,2,0,2,0,2
40701,HUANUNI,estado nutricional en menores de 5 anos,clasificacion d,2001-06-01,2,5,2,5,7
80803,HUARACAJE,estado nutricional en menores de 5 anos,clasificacion d,2001-06-01,0,17,0,17,17
41601,HUAYLLAMARCA,estado nutricional en menores de 5 anos,clasificacion d,2001-06-01,3,38,3,38,41
21005,ICHOCA,estado nutricional en menores de 5 anos,clasificacion d,2001-06-01,0,21,0,21,21
10304,ICLA,estado nutricional en menores de 5 anos,clasificacion d,2001-06-01,66,323,66,323,389
10703,INCAHUASI,estado nutricional en menores de 5 anos,clasificacion d,2001-06-01,4,296,4,296,300
21001,INQUISIVI,estado nutricional en menores de 5 anos,clasificacion d,2001-06-01,1,88,1,88,89
21102,IRUPANA (VILLA DE LANZA),estado nutricional en menores de 5 anos,clasificacion d,2001-06-01,5,63,5,63,68
21501,IXIAMAS,estado nutricional en menores de 5 anos,clasificacion d,2001-06-01,21,96,21,96,117
21105,LA ASUNTA,estado nutricional en menores de 5 anos,clasificacion d,2001-06-01,25,86,25,86,111
70104,LA GUARDIA,estado nutricional en menores de 5 anos,clasificacion d,2001-06-01,3,121,3,121,124
20101,LA PAZ,estado nutricional en menores de 5 anos,clasificacion d,2001-06-01,489,966,489,966,1455
41501,LA RIVERA,estado nutricional en menores de 5 anos,clasificacion d,2001-06-01,0,2,0,2,2
70701,LAGUNILLAS,estado nutricional en menores de 5 anos,clasificacion d,2001-06-01,11,62,11,62,73
21202,LAJA,estado nutricional en menores de 5 anos,clasificacion d,2001-06-01,0,41,0,41,41
10903,LAS CARRERAS,estado nutricional en menores de 5 anos,clasificacion d,2001-06-01,0,34,0,34,34
21006,LICOMA PAMPA,estado nutricional en menores de 5 anos,clasificacion d,2001-06-01,11,2,11,2,13
50203,LLALLAGUA,estado nutricional en menores de 5 anos,clasificacion d,2001-06-01,10,131,10,131,141
51401,LLICA,estado nutricional en menores de 5 anos,clasificacion d,2001-06-01,0,27,0,27,27
80601,LORETO,estado nutricional en menores de 5 anos,clasificacion d,2001-06-01,0,3,0,3,3
20901,LURIBAY,estado nutricional en menores de 5 anos,clasificacion d,2001-06-01,0,22,0,22,22
40702,MACHACAMARCA,estado nutricional en menores de 5 anos,clasificacion d,2001-06-01,6,1,6,1,7
11003,MACHARETI,estado nutricional en menores de 5 anos,clasificacion d,2001-06-01,0,120,0,120,120
80801,MAGDALENA,estado nutricional en menores de 5 anos,clasificacion d,2001-06-01,1,24,1,24,25
70903,MAIRANA,estado nutricional en menores de 5 anos,clasificacion d,2001-06-01,11,33,11,33,44
20904,MALLA,estado nutricional en menores de 5 anos,clasificacion d,2001-06-01,0,9,0,9,9
20103,MECAPACA,estado nutricional en menores de 5 anos,clasificacion d,2001-06-01,2,77,2,77,79
71003,MINEROS,estado nutricional en menores de 5 anos,clasificacion d,2001-06-01,3,139,3,139,142
31301,MIZQUE,estado nutricional en menores de 5 anos,clasificacion d,2001-06-01,60,110,60,110,170
20402,MOCOMOCO,estado nutricional en menores de 5 anos,clasificacion d,2001-06-01,37,18,37,18,55
51002,MOJINETE,estado nutricional en menores de 5 anos,clasificacion d,2001-06-01,0,20,0,20,20
10303,MOJOCOYA,estado nutricional en menores de 5 anos,clasificacion d,2001-06-01,0,197,0,197,197
10501,MONTEAGUDO,estado nutricional en menores de 5 anos,clasificacion d,2001-06-01,15,376,15,376,391
71001,MONTERO,estado nutricional en menores de 5 anos,clasificacion d,2001-06-01,4,159,4,159,163
70803,MORO MORO,estado nutricional en menores de 5 anos,clasificacion d,2001-06-01,0,2,0,2,2
30302,MOROCHATA,estado nutricional en menores de 5 anos,clasificacion d,2001-06-01,28,77,28,77,105
90401,NACEBE (SANTA ROSA DEL ABUNA),estado nutricional en menores de 5 anos,clasificacion d,2001-06-01,1,7,1,7,8
90501,NUEVO MANOA (NUEVA ESPERANZA),estado nutricional en menores de 5 anos,clasificacion d,2001-06-01,0,6,0,6,6
50404,OCURI,estado nutricional en menores de 5 anos,clasificacion d,2001-06-01,0,218,0,218,218
70202,OKINAWA,estado nutricional en menores de 5 anos,clasificacion d,2001-06-01,0,9,0,9,9
30203,OMEREQUE,estado nutricional en menores de 5 anos,clasificacion d,2001-06-01,0,27,0,27,27
40101,ORURO,estado nutricional en menores de 5 anos,clasificacion d,2001-06-01,35,854,35,854,889
60201,PADCAYA,estado nutricional en menores de 5 anos,clasificacion d,2001-06-01,4,52,4,52,56
10401,PADILLA,estado nutricional en menores de 5 anos,clasificacion d,2001-06-01,3,393,3,393,396
70502,PAILON,estado nutricional en menores de 5 anos,clasificacion d,2001-06-01,2,39,2,39,41
20102,PALCA,estado nutricional en menores de 5 anos,clasificacion d,2001-06-01,23,38,23,38,61
21104,PALOS BLANCOS,estado nutricional en menores de 5 anos,clasificacion d,2001-06-01,41,87,41,87,128
40802,PAMPA AULLAGAS,estado nutricional en menores de 5 anos,clasificacion d,2001-06-01,9,19,9,19,28
70902,PAMPA GRANDE,estado nutricional en menores de 5 anos,clasificacion d,2001-06-01,1,46,1,46,47
21802,PAPEL PAMPA,estado nutricional en menores de 5 anos,clasificacion d,2001-06-01,2,5,2,5,7
30202,PASORAPA,estado nutricional en menores de 5 anos,clasificacion d,2001-06-01,0,27,0,27,27
21305,PATACAMAYA,estado nutricional en menores de 5 anos,clasificacion d,2001-06-01,37,21,37,21,58
40602,PAZÃ‘A,estado nutricional en menores de 5 anos,clasificacion d,2001-06-01,0,12,0,12,12
20702,PELECHUCO,estado nutricional en menores de 5 anos,clasificacion d,2001-06-01,5,17,5,17,22
50403,POCOATA,estado nutricional en menores de 5 anos,clasificacion d,2001-06-01,19,327,19,327,346
31203,POCONA,estado nutricional en menores de 5 anos,clasificacion d,2001-06-01,4,84,4,84,88
31202,POJO (CBBA),estado nutricional en menores de 5 anos,clasificacion d,2001-06-01,16,201,16,201,217
40601,POOPO,estado nutricional en menores de 5 anos,clasificacion d,2001-06-01,1,26,1,26,27
51203,PORCO,estado nutricional en menores de 5 anos,clasificacion d,2001-06-01,1,95,1,95,96
10103,POROMA,estado nutricional en menores de 5 anos,clasificacion d,2001-06-01,4,302,4,302,306
70103,PORONGO,estado nutricional en menores de 5 anos,clasificacion d,2001-06-01,1,34,1,34,35
70601,PORTACHUELO,estado nutricional en menores de 5 anos,clasificacion d,2001-06-01,18,17,18,17,35
90102,PORVENIR,estado nutricional en menores de 5 anos,clasificacion d,2001-06-01,0,23,0,23,23
50101,POTOSI,estado nutricional en menores de 5 anos,clasificacion d,2001-06-01,13,969,13,969,982
10302,PRESTO,estado nutricional en menores de 5 anos,clasificacion d,2001-06-01,1,149,1,149,150
70805,PUCARA,estado nutricional en menores de 5 anos,clasificacion d,2001-06-01,0,6,0,6,6
21201,PUCARANI,estado nutricional en menores de 5 anos,clasificacion d,2001-06-01,2,109,2,109,111
20401,PUERTO ACOSTA,estado nutricional en menores de 5 anos,clasificacion d,2001-06-01,96,84,96,84,180
20403,PUERTO CARABUCO,estado nutricional en menores de 5 anos,clasificacion d,2001-06-01,42,126,42,126,168
90301,PUERTO GONZALO MORENO,estado nutricional en menores de 5 anos,clasificacion d,2001-06-01,0,2,0,2,2
21204,PUERTO PEREZ,estado nutricional en menores de 5 anos,clasificacion d,2001-06-01,4,18,4,18,22
71402,PUERTO QUIJARRO,estado nutricional en menores de 5 anos,clasificacion d,2001-06-01,19,16,19,16,35
90201,PUERTO RICO,estado nutricional en menores de 5 anos,clasificacion d,2001-06-01,0,10,0,10,10
80703,PUERTO SILES,estado nutricional en menores de 5 anos,clasificacion d,2001-06-01,1,19,1,19,20
71401,PUERTO SUAREZ,estado nutricional en menores de 5 anos,clasificacion d,2001-06-01,58,20,58,20,78
31205,PUERTO VILLARROEL,estado nutricional en menores de 5 anos,clasificacion d,2001-06-01,101,127,101,127,228
51101,PUNA,estado nutricional en menores de 5 anos,clasificacion d,2001-06-01,9,281,9,281,290
31401,PUNATA,estado nutricional en menores de 5 anos,clasificacion d,2001-06-01,4,43,4,43,47
20604,QUIABAYA,estado nutricional en menores de 5 anos,clasificacion d,2001-06-01,2,41,2,41,43
30901,QUILLACOLLO,estado nutricional en menores de 5 anos,clasificacion d,2001-06-01,1,0,1,0,1
21002,QUIME,estado nutricional en menores de 5 anos,clasificacion d,2001-06-01,54,30,54,30,84
70904,QUIRUSILLAS,estado nutricional en menores de 5 anos,clasificacion d,2001-06-01,0,7,0,7,7
50402,RAVELO,estado nutricional en menores de 5 anos,clasificacion d,2001-06-01,21,516,21,516,537
80301,REYES,estado nutricional en menores de 5 anos,clasificacion d,2001-06-01,2,49,2,49,51
80201,RIBERALTA,estado nutricional en menores de 5 anos,clasificacion d,2001-06-01,15,98,15,98,113
70503,ROBORE,estado nutricional en menores de 5 anos,clasificacion d,2001-06-01,3,54,3,54,57
80304,RURRENABAQUE,estado nutricional en menores de 5 anos,clasificacion d,2001-06-01,4,5,4,5,9
40901,SABAYA,estado nutricional en menores de 5 anos,clasificacion d,2001-06-01,0,8,0,8,8
31001,SACABA,estado nutricional en menores de 5 anos,clasificacion d,2001-06-01,89,104,89,104,193
30404,SACABAMBA,estado nutricional en menores de 5 anos,clasificacion d,2001-06-01,0,78,0,78,78
50701,SACACA,estado nutricional en menores de 5 anos,clasificacion d,2001-06-01,13,609,13,609,622
71302,SAIPINA,estado nutricional en menores de 5 anos,clasificacion d,2001-06-01,0,58,0,58,58
40801,SALINAS DE GARCI MENDOZA,estado nutricional en menores de 5 anos,clasificacion d,2001-06-01,11,6,11,6,17
70901,SAMAIPATA,estado nutricional en menores de 5 anos,clasificacion d,2001-06-01,6,24,6,24,30
51601,SAN AGUSTIN,estado nutricional en menores de 5 anos,clasificacion d,2001-06-01,0,10,0,10,10
80602,SAN ANDRES,estado nutricional en menores de 5 anos,clasificacion d,2001-06-01,0,5,0,5,5
51003,SAN ANTONIO DE ESMORUCO,estado nutricional en menores de 5 anos,clasificacion d,2001-06-01,1,12,1,12,13
71105,SAN ANTONIO DE LOMERIO,estado nutricional en menores de 5 anos,clasificacion d,2001-06-01,25,161,25,161,186
31403,SAN BENITO,estado nutricional en menores de 5 anos,clasificacion d,2001-06-01,2,61,2,61,63
80302,SAN BORJA,estado nutricional en menores de 5 anos,clasificacion d,2001-06-01,2,90,2,90,92
21502,SAN BUENA VENTURA,estado nutricional en menores de 5 anos,clasificacion d,2001-06-01,0,53,0,53,53
70402,SAN CARLOS,estado nutricional en menores de 5 anos,clasificacion d,2001-06-01,2,55,2,55,57
80501,SAN IGNACIO,estado nutricional en menores de 5 anos,clasificacion d,2001-06-01,0,59,0,59,59
70301,SAN IGNACIO DE VELASCO,estado nutricional en menores de 5 anos,clasificacion d,2001-06-01,39,388,39,388,427
80102,SAN JAVIER(BNI),estado nutricional en menores de 5 anos,clasificacion d,2001-06-01,0,7,0,7,7
71102,SAN JAVIER(STC),estado nutricional en menores de 5 anos,clasificacion d,2001-06-01,7,69,7,69,76
80701,SAN JOAQUIN,estado nutricional en menores de 5 anos,clasificacion d,2001-06-01,0,12,0,12,12
70501,SAN JOSE DE CHIQUITOS,estado nutricional en menores de 5 anos,clasificacion d,2001-06-01,50,30,50,30,80
71104,SAN JULIAN,estado nutricional en menores de 5 anos,clasificacion d,2001-06-01,37,332,37,332,369
60501,SAN LORENZO(TJA),estado nutricional en menores de 5 anos,clasificacion d,2001-06-01,3,56,3,56,59
10702,SAN LUCAS,estado nutricional en menores de 5 anos,clasificacion d,2001-06-01,16,758,16,758,774
71201,SAN MATIAS,estado nutricional en menores de 5 anos,clasificacion d,2001-06-01,3,111,3,111,114
70302,SAN MIGUEL DE VELASCO,estado nutricional en menores de 5 anos,clasificacion d,2001-06-01,0,71,0,71,71
51001,SAN PABLO DE LIPEZ,estado nutricional en menores de 5 anos,clasificacion d,2001-06-01,3,9,3,9,12
50501,SAN PEDRO DE BUENA VISTA,estado nutricional en menores de 5 anos,clasificacion d,2001-06-01,7,468,7,468,475
21801,SAN PEDRO DE CURAHUARA,estado nutricional en menores de 5 anos,clasificacion d,2001-06-01,0,53,0,53,53
50902,SAN PEDRO DE QUEMES,estado nutricional en menores de 5 anos,clasificacion d,2001-06-01,0,7,0,7,7
21702,SAN PEDRO DE TIQUINA,estado nutricional en menores de 5 anos,clasificacion d,2001-06-01,0,14,0,14,14
90202,SAN PEDRO(PND),estado nutricional en menores de 5 anos,clasificacion d,2001-06-01,0,5,0,5,5
70303,SAN RAFAEL,estado nutricional en menores de 5 anos,clasificacion d,2001-06-01,11,23,11,23,34
80702,SAN RAMON,estado nutricional en menores de 5 anos,clasificacion d,2001-06-01,1,6,1,6,7
80702,SAN RAMON,estado nutricional en menores de 5 anos,clasificacion d,2001-06-01,0,5,0,5,5
70101,SANTA CRUZ DE LA SIERRA,estado nutricional en menores de 5 anos,clasificacion d,2001-06-01,177,430,177,430,607
80303,SANTA ROSA,estado nutricional en menores de 5 anos,clasificacion d,2001-06-01,2,16,2,16,18
70602,SANTA ROSA DEL SARA,estado nutricional en menores de 5 anos,clasificacion d,2001-06-01,5,28,5,28,33
20308,SANTIAGO DE CALLAPA,estado nutricional en menores de 5 anos,clasificacion d,2001-06-01,8,6,8,6,14
41401,SANTIAGO DE HUARI,estado nutricional en menores de 5 anos,clasificacion d,2001-06-01,15,12,15,12,27
21901,SANTIAGO DE MACHACA,estado nutricional en menores de 5 anos,clasificacion d,2001-06-01,1,5,1,5,6
30702,SANTIVAÃ‘ES,estado nutricional en menores de 5 anos,clasificacion d,2001-06-01,1,40,1,40,41
40202,SANTUARIO DE QUILLACAS,estado nutricional en menores de 5 anos,clasificacion d,2001-06-01,9,17,9,17,26
20902,SAPAHAQUI,estado nutricional en menores de 5 anos,clasificacion d,2001-06-01,2,34,2,34,36
90303,SENA,estado nutricional en menores de 5 anos,clasificacion d,2001-06-01,0,2,0,2,2
21301,SICA SICA (VILLA AROMA),estado nutricional en menores de 5 anos,clasificacion d,2001-06-01,17,44,17,44,61
30703,SICAYA,estado nutricional en menores de 5 anos,clasificacion d,2001-06-01,1,19,1,19,20
30902,SIPE SIPE,estado nutricional en menores de 5 anos,clasificacion d,2001-06-01,6,127,6,127,133
10403,SOPACHUY,estado nutricional en menores de 5 anos,clasificacion d,2001-06-01,5,220,5,220,225
20601,SORATA,estado nutricional en menores de 5 anos,clasificacion d,2001-06-01,1,92,1,92,93
10101,SUCRE,estado nutricional en menores de 5 anos,clasificacion d,2001-06-01,44,1491,44,1491,1535
31404,TACACHI,estado nutricional en menores de 5 anos,clasificacion d,2001-06-01,0,9,0,9,9
20603,TACACOMA,estado nutricional en menores de 5 anos,clasificacion d,2001-06-01,1,15,1,15,16
50303,TACOBAMBA,estado nutricional en menores de 5 anos,clasificacion d,2001-06-01,3,123,3,123,126
30602,TACOPAYA,estado nutricional en menores de 5 anos,clasificacion d,2001-06-01,1,29,1,29,30
51402,TAHUA,estado nutricional en menores de 5 anos,clasificacion d,2001-06-01,1,12,1,12,13
31101,TAPACARI,estado nutricional en menores de 5 anos,clasificacion d,2001-06-01,7,184,7,184,191
10601,TARABUCO,estado nutricional en menores de 5 anos,clasificacion d,2001-06-01,5,722,5,722,727
30401,TARATA,estado nutricional en menores de 5 anos,clasificacion d,2001-06-01,1,35,1,35,36
60101,TARIJA,estado nutricional en menores de 5 anos,clasificacion d,2001-06-01,17,203,17,203,220
10202,TARVITA,estado nutricional en menores de 5 anos,clasificacion d,2001-06-01,3,237,3,237,240
20803,TIAWANACU,estado nutricional en menores de 5 anos,clasificacion d,2001-06-01,6,15,6,15,21
50102,TINGUIPAYA,estado nutricional en menores de 5 anos,clasificacion d,2001-06-01,4,173,4,173,177
20606,TIPUANI,estado nutricional en menores de 5 anos,clasificacion d,2001-06-01,8,20,8,20,28
30903,TIQUIPAYA,estado nutricional en menores de 5 anos,clasificacion d,2001-06-01,0,15,0,15,15
31601,TIRAQUE (CBBA),estado nutricional en menores de 5 anos,clasificacion d,2001-06-01,52,255,52,255,307
21703,TITO YUPANQUI (PARQUIPUJIO),estado nutricional en menores de 5 anos,clasificacion d,2001-06-01,0,8,0,8,8
30802,TOCO,estado nutricional en menores de 5 anos,clasificacion d,2001-06-01,0,9,0,9,9
30803,TOLATA,estado nutricional en menores de 5 anos,clasificacion d,2001-06-01,0,7,0,7,7
41001,TOLEDO,estado nutricional en menores de 5 anos,clasificacion d,2001-06-01,0,14,0,14,14
51202,TOMAVE,estado nutricional en menores de 5 anos,clasificacion d,2001-06-01,3,182,3,182,185
10402,TOMINA,estado nutricional en menores de 5 anos,clasificacion d,2001-06-01,4,229,4,229,233
50502,TORO TORO,estado nutricional en menores de 5 anos,clasificacion d,2001-06-01,4,16,4,16,20
31201,TOTORA(CBBA),estado nutricional en menores de 5 anos,clasificacion d,2001-06-01,0,95,0,95,95
41301,TOTORA(ORR),estado nutricional en menores de 5 anos,clasificacion d,2001-06-01,2,51,2,51,53
70802,TRIGAL,estado nutricional en menores de 5 anos,clasificacion d,2001-06-01,3,2,3,2,5
80101,TRINIDAD,estado nutricional en menores de 5 anos,clasificacion d,2001-06-01,11,131,11,131,142
50801,TUPIZA,estado nutricional en menores de 5 anos,clasificacion d,2001-06-01,7,396,7,396,403
40402,TURCO,estado nutricional en menores de 5 anos,clasificacion d,2001-06-01,7,3,7,3,10
21302,UMALA,estado nutricional en menores de 5 anos,clasificacion d,2001-06-01,1,14,1,14,15
50201,UNCIA,estado nutricional en menores de 5 anos,clasificacion d,2001-06-01,2,68,2,68,70
60401,URIONDO (A. CONCEPCION),estado nutricional en menores de 5 anos,clasificacion d,2001-06-01,0,28,0,28,28
71502,URUBICHA,estado nutricional en menores de 5 anos,clasificacion d,2001-06-01,0,19,0,19,19
51201,UYUNI,estado nutricional en menores de 5 anos,clasificacion d,2001-06-01,4,178,4,178,182
30502,VACAS,estado nutricional en menores de 5 anos,clasificacion d,2001-06-01,5,25,5,25,30
70801,VALLEGRANDE,estado nutricional en menores de 5 anos,clasificacion d,2001-06-01,23,65,23,65,88
20801,VIACHA,estado nutricional en menores de 5 anos,clasificacion d,2001-06-01,4,165,4,165,169
31302,VILA VILA,estado nutricional en menores de 5 anos,clasificacion d,2001-06-01,25,24,25,24,49
60303,VILLA MONTES,estado nutricional en menores de 5 anos,clasificacion d,2001-06-01,21,58,21,58,79
90502,VILLA NUEVA (LOMA ALTA),estado nutricional en menores de 5 anos,clasificacion d,2001-06-01,0,2,0,2,2
31402,VILLA RIVERO,estado nutricional en menores de 5 anos,clasificacion d,2001-06-01,0,29,0,29,29
10801,VILLA SERRANO,estado nutricional en menores de 5 anos,clasificacion d,2001-06-01,8,367,8,367,375
31003,VILLA TUNARI,estado nutricional en menores de 5 anos,clasificacion d,2001-06-01,64,48,64,48,112
11001,VILLA VACA GUZMAN (MUYUPAMPA),estado nutricional en menores de 5 anos,clasificacion d,2001-06-01,2,184,2,184,186
51501,VILLAZON,estado nutricional en menores de 5 anos,clasificacion d,2001-06-01,1,284,1,284,285
50602,VITICHI,estado nutricional en menores de 5 anos,clasificacion d,2001-06-01,0,122,0,122,122
20306,WALDO BALLIVIAN,estado nutricional en menores de 5 anos,clasificacion d,2001-06-01,2,8,2,8,10
70201,WARNES,estado nutricional en menores de 5 anos,clasificacion d,2001-06-01,6,127,6,127,133
20903,YACO,estado nutricional en menores de 5 anos,clasificacion d,2001-06-01,4,20,4,20,24
60301,YACUIBA,estado nutricional en menores de 5 anos,clasificacion d,2001-06-01,1,117,1,117,118
10602,YAMPARAEZ,estado nutricional en menores de 5 anos,clasificacion d,2001-06-01,4,400,4,400,404
21103,YANACACHI,estado nutricional en menores de 5 anos,clasificacion d,2001-06-01,4,6,4,6,10
70403,YAPACANI,estado nutricional en menores de 5 anos,clasificacion d,2001-06-01,14,195,14,195,209
50103,YOCALLA,estado nutricional en menores de 5 anos,clasificacion d,2001-06-01,0,121,0,121,121
10102,YOTALA,estado nutricional en menores de 5 anos,clasificacion d,2001-06-01,2,326,2,326,328
60402,YUNCHARA,estado nutricional en menores de 5 anos,clasificacion d,2001-06-01,4,47,4,47,51
10301,ZUDAÃ‘EZ,estado nutricional en menores de 5 anos,clasificacion d,2001-06-01,0,209,0,209,209
51302,ACACIO,estado nutricional en menores de 5 anos,clasificacion d,2001-07-01,1,129,1,129,130
20201,ACHACACHI,estado nutricional en menores de 5 anos,clasificacion d,2001-07-01,10,185,10,185,195
20104,ACHOCALLA,estado nutricional en menores de 5 anos,clasificacion d,2001-07-01,0,13,0,13,13
30201,AIQUILE,estado nutricional en menores de 5 anos,clasificacion d,2001-07-01,23,93,23,93,116
31303,ALALAY,estado nutricional en menores de 5 anos,clasificacion d,2001-07-01,21,9,21,9,30
10404,ALCALA,estado nutricional en menores de 5 anos,clasificacion d,2001-07-01,0,67,0,67,67
20202,ANCORAIMES,estado nutricional en menores de 5 anos,clasificacion d,2001-07-01,2,266,2,266,268
41201,ANDAMARCA,estado nutricional en menores de 5 anos,clasificacion d,2001-07-01,0,3,0,3,3
40603,ANTEQUERA,estado nutricional en menores de 5 anos,clasificacion d,2001-07-01,2,0,2,0,2
30402,ANZALDO,estado nutricional en menores de 5 anos,clasificacion d,2001-07-01,3,50,3,50,53
20701,APOLO,estado nutricional en menores de 5 anos,clasificacion d,2001-07-01,12,6,12,6,18
51301,ARAMPAMPA,estado nutricional en menores de 5 anos,clasificacion d,2001-07-01,3,90,3,90,93
30501,ARANI,estado nutricional en menores de 5 anos,clasificacion d,2001-07-01,2,67,2,67,69
30403,ARBIETO,estado nutricional en menores de 5 anos,clasificacion d,2001-07-01,1,30,1,30,31
30601,ARQUE,estado nutricional en menores de 5 anos,clasificacion d,2001-07-01,6,37,6,37,43
71501,ASCENCION DE GUARAYOS,estado nutricional en menores de 5 anos,clasificacion d,2001-07-01,0,21,0,21,21
50802,ATOCHA,estado nutricional en menores de 5 anos,clasificacion d,2001-07-01,4,57,4,57,61
20503,AUCAPATA,estado nutricional en menores de 5 anos,clasificacion d,2001-07-01,0,4,0,4,4
20502,AYATA,estado nutricional en menores de 5 anos,clasificacion d,2001-07-01,3,0,3,0,3
21303,AYO AYO,estado nutricional en menores de 5 anos,clasificacion d,2001-07-01,1,7,1,7,8
30301,AYOPAYA (V. DE INDEPENDENCIA),estado nutricional en menores de 5 anos,clasificacion d,2001-07-01,104,165,104,165,269
10201,AZURDUY,estado nutricional en menores de 5 anos,clasificacion d,2001-07-01,0,123,0,123,123
21203,BATALLAS,estado nutricional en menores de 5 anos,clasificacion d,2001-07-01,1,65,1,65,66
80802,BAURES,estado nutricional en menores de 5 anos,clasificacion d,2001-07-01,15,18,15,18,33
41202,BELEN DE ANDAMARCA,estado nutricional en menores de 5 anos,clasificacion d,2001-07-01,0,4,0,4,4
50104,BELEN DE URMIRI,estado nutricional en menores de 5 anos,clasificacion d,2001-07-01,2,36,2,36,38
90104,BELLA FLOR,estado nutricional en menores de 5 anos,clasificacion d,2001-07-01,0,9,0,9,9
60202,BERMEJO,estado nutricional en menores de 5 anos,clasificacion d,2001-07-01,1,7,1,7,8
50301,BETANZOS,estado nutricional en menores de 5 anos,clasificacion d,2001-07-01,6,420,6,420,426
31501,BOLIVAR,estado nutricional en menores de 5 anos,clasificacion d,2001-07-01,3,165,3,165,168
90103,BOLPEBRA,estado nutricional en menores de 5 anos,clasificacion d,2001-07-01,0,10,0,10,10
70707,BOYUIBE,estado nutricional en menores de 5 anos,clasificacion d,2001-07-01,2,22,2,22,24
70401,BUENA VISTA,estado nutricional en menores de 5 anos,clasificacion d,2001-07-01,50,66,50,66,116
70703,CABEZAS,estado nutricional en menores de 5 anos,clasificacion d,2001-07-01,1,59,1,59,60
20905,CAIROMA,estado nutricional en menores de 5 anos,clasificacion d,2001-07-01,3,58,3,58,61
51102,"CAIZA ""D""",estado nutricional en menores de 5 anos,clasificacion d,2001-07-01,4,147,4,147,151
21003,CAJUATA,estado nutricional en menores de 5 anos,clasificacion d,2001-07-01,17,6,17,6,23
20303,CALACOTO,estado nutricional en menores de 5 anos,clasificacion d,2001-07-01,2,19,2,19,21
21304,CALAMARCA,estado nutricional en menores de 5 anos,clasificacion d,2001-07-01,20,21,20,21,41
10701,CAMARGO,estado nutricional en menores de 5 anos,clasificacion d,2001-07-01,0,51,0,51,51
10901,CAMATAQUI (C. VILLA ABECIA),estado nutricional en menores de 5 anos,clasificacion d,2001-07-01,1,53,1,53,54
70706,CAMIRI,estado nutricional en menores de 5 anos,clasificacion d,2001-07-01,57,64,57,64,121
30701,CAPINOTA,estado nutricional en menores de 5 anos,clasificacion d,2001-07-01,47,35,47,35,82
20302,CAQUIAVIRI,estado nutricional en menores de 5 anos,clasificacion d,2001-07-01,1,21,1,21,22
40102,CARACOLLO,estado nutricional en menores de 5 anos,clasificacion d,2001-07-01,1,58,1,58,59
22001,CARANAVI,estado nutricional en menores de 5 anos,clasificacion d,2001-07-01,89,158,89,158,247
41503,CARANGAS,estado nutricional en menores de 5 anos,clasificacion d,2001-07-01,0,2,0,2,2
60302,CARAPARI,estado nutricional en menores de 5 anos,clasificacion d,2001-07-01,4,48,4,48,52
50702,CARIPUYO,estado nutricional en menores de 5 anos,clasificacion d,2001-07-01,1,75,1,75,76
21803,CHACARILLA,estado nutricional en menores de 5 anos,clasificacion d,2001-07-01,0,5,0,5,5
40201,CHALLAPATA,estado nutricional en menores de 5 anos,clasificacion d,2001-07-01,26,33,26,33,59
50302,CHAQUI,estado nutricional en menores de 5 anos,clasificacion d,2001-07-01,0,104,0,104,104
70702,CHARAGUA,estado nutricional en menores de 5 anos,clasificacion d,2001-07-01,3,206,3,206,209
20305,CHARAÃ‘A,estado nutricional en menores de 5 anos,clasificacion d,2001-07-01,0,13,0,13,13
50202,CHAYANTA,estado nutricional en menores de 5 anos,clasificacion d,2001-07-01,4,156,4,156,160
31204,CHIMORE,estado nutricional en menores de 5 anos,clasificacion d,2001-07-01,14,52,14,52,66
40903,CHIPAYA,estado nutricional en menores de 5 anos,clasificacion d,2001-07-01,0,4,0,4,4
40302,CHOQUE COTA,estado nutricional en menores de 5 anos,clasificacion d,2001-07-01,0,17,0,17,17
21101,CHULUMANI (V. DE LA LIBERTAD),estado nutricional en menores de 5 anos,clasificacion d,2001-07-01,0,18,0,18,18
20501,CHUMA,estado nutricional en menores de 5 anos,clasificacion d,2001-07-01,13,14,13,14,27
30801,CLIZA,estado nutricional en menores de 5 anos,clasificacion d,2001-07-01,3,41,3,41,44
90101,COBIJA,estado nutricional en menores de 5 anos,clasificacion d,2001-07-01,75,71,75,71,146
30101,COCHABAMBA,estado nutricional en menores de 5 anos,clasificacion d,2001-07-01,234,229,234,229,463
40902,COIPASA,estado nutricional en menores de 5 anos,clasificacion d,2001-07-01,0,2,0,2,2
30905,COLCAPIRHUA,estado nutricional en menores de 5 anos,clasificacion d,2001-07-01,8,14,8,14,22
50901,"COLCHA ""K""",estado nutricional en menores de 5 anos,clasificacion d,2001-07-01,0,48,0,48,48
21307,COLLANA,estado nutricional en menores de 5 anos,clasificacion d,2001-07-01,3,0,3,0,3
31002,COLOMI,estado nutricional en menores de 5 anos,clasificacion d,2001-07-01,11,126,11,126,137
50401,COLQUECHACA,estado nutricional en menores de 5 anos,clasificacion d,2001-07-01,13,122,13,122,135
21306,COLQUENCHA,estado nutricional en menores de 5 anos,clasificacion d,2001-07-01,19,28,19,28,47
21004,COLQUIRI,estado nutricional en menores de 5 anos,clasificacion d,2001-07-01,8,205,8,205,213
20304,COMANCHE,estado nutricional en menores de 5 anos,clasificacion d,2001-07-01,4,16,4,16,20
71301,COMARAPA,estado nutricional en menores de 5 anos,clasificacion d,2001-07-01,2,48,2,48,50
20605,COMBAYA,estado nutricional en menores de 5 anos,clasificacion d,2001-07-01,0,28,0,28,28
71101,CONCEPCION,estado nutricional en menores de 5 anos,clasificacion d,2001-07-01,5,13,5,13,18
21701,COPACABANA,estado nutricional en menores de 5 anos,clasificacion d,2001-07-01,0,88,0,88,88
21402,CORIPATA,estado nutricional en menores de 5 anos,clasificacion d,2001-07-01,1,20,1,20,21
20301,CORO CORO,estado nutricional en menores de 5 anos,clasificacion d,2001-07-01,0,45,0,45,45
21401,COROICO,estado nutricional en menores de 5 anos,clasificacion d,2001-07-01,9,36,9,36,45
40301,CORQUE,estado nutricional en menores de 5 anos,clasificacion d,2001-07-01,1,53,1,53,54
50601,COTAGAITA,estado nutricional en menores de 5 anos,clasificacion d,2001-07-01,7,143,7,143,150
70102,COTOCA,estado nutricional en menores de 5 anos,clasificacion d,2001-07-01,5,35,5,35,40
31405,CUCHUMUELA (V. G. VILLARROEL),estado nutricional en menores de 5 anos,clasificacion d,2001-07-01,0,3,0,3,3
70704,CUEVO,estado nutricional en menores de 5 anos,clasificacion d,2001-07-01,12,24,12,24,36
10902,CULPINA,estado nutricional en menores de 5 anos,clasificacion d,2001-07-01,7,232,7,232,239
40401,CURAHUARA DE CARANGAS,estado nutricional en menores de 5 anos,clasificacion d,2001-07-01,32,19,32,19,51
21602,CURVA,estado nutricional en menores de 5 anos,clasificacion d,2001-07-01,5,17,5,17,22
20804,DESAGUADERO,estado nutricional en menores de 5 anos,clasificacion d,2001-07-01,4,20,4,20,24
20105,EL ALTO,estado nutricional en menores de 5 anos,clasificacion d,2001-07-01,1034,1692,1034,1692,2726
40103,EL CHORO,estado nutricional en menores de 5 anos,clasificacion d,2001-07-01,0,2,0,2,2
71503,EL PUENTE(STC),estado nutricional en menores de 5 anos,clasificacion d,2001-07-01,10,108,10,108,118
60502,EL PUENTE(TJA),estado nutricional en menores de 5 anos,clasificacion d,2001-07-01,4,51,4,51,55
70105,EL TORNO,estado nutricional en menores de 5 anos,clasificacion d,2001-07-01,15,98,15,98,113
10405,EL VILLAR,estado nutricional en menores de 5 anos,clasificacion d,2001-07-01,2,181,2,181,183
60601,ENTRE RIOS,estado nutricional en menores de 5 anos,clasificacion d,2001-07-01,29,92,29,92,121
41101,EUCALIPTUS,estado nutricional en menores de 5 anos,clasificacion d,2001-07-01,0,53,0,53,53
90203,FILADELFIA,estado nutricional en menores de 5 anos,clasificacion d,2001-07-01,0,3,0,3,3
71002,GENERAL SAAVEDRA,estado nutricional en menores de 5 anos,clasificacion d,2001-07-01,6,113,6,113,119
21601,GRAL. J.J. PEREZ (CHARAZANI),estado nutricional en menores de 5 anos,clasificacion d,2001-07-01,2,15,2,15,17
20602,GUANAY,estado nutricional en menores de 5 anos,clasificacion d,2001-07-01,2,153,2,153,155
20802,GUAQUI,estado nutricional en menores de 5 anos,clasificacion d,2001-07-01,0,20,0,20,20
80202,GUAYARAMERIN,estado nutricional en menores de 5 anos,clasificacion d,2001-07-01,7,165,7,165,172
70705,GUTIERREZ,estado nutricional en menores de 5 anos,clasificacion d,2001-07-01,19,158,19,158,177
10502,HUACARETA,estado nutricional en menores de 5 anos,clasificacion d,2001-07-01,1,210,1,210,211
40501,HUACHACALLA,estado nutricional en menores de 5 anos,clasificacion d,2001-07-01,2,0,2,0,2
40701,HUANUNI,estado nutricional en menores de 5 anos,clasificacion d,2001-07-01,2,48,2,48,50
80803,HUARACAJE,estado nutricional en menores de 5 anos,clasificacion d,2001-07-01,2,9,2,9,11
41601,HUAYLLAMARCA,estado nutricional en menores de 5 anos,clasificacion d,2001-07-01,0,50,0,50,50
21005,ICHOCA,estado nutricional en menores de 5 anos,clasificacion d,2001-07-01,1,11,1,11,12
10304,ICLA,estado nutricional en menores de 5 anos,clasificacion d,2001-07-01,109,248,109,248,357
10703,INCAHUASI,estado nutricional en menores de 5 anos,clasificacion d,2001-07-01,4,215,4,215,219
21001,INQUISIVI,estado nutricional en menores de 5 anos,clasificacion d,2001-07-01,2,117,2,117,119
21102,IRUPANA (VILLA DE LANZA),estado nutricional en menores de 5 anos,clasificacion d,2001-07-01,10,56,10,56,66
21501,IXIAMAS,estado nutricional en menores de 5 anos,clasificacion d,2001-07-01,1,66,1,66,67
21105,LA ASUNTA,estado nutricional en menores de 5 anos,clasificacion d,2001-07-01,30,39,30,39,69
70104,LA GUARDIA,estado nutricional en menores de 5 anos,clasificacion d,2001-07-01,4,124,4,124,128
20101,LA PAZ,estado nutricional en menores de 5 anos,clasificacion d,2001-07-01,698,1061,698,1061,1759
70701,LAGUNILLAS,estado nutricional en menores de 5 anos,clasificacion d,2001-07-01,6,11,6,11,17
21202,LAJA,estado nutricional en menores de 5 anos,clasificacion d,2001-07-01,3,63,3,63,66
10903,LAS CARRERAS,estado nutricional en menores de 5 anos,clasificacion d,2001-07-01,1,90,1,90,91
21006,LICOMA PAMPA,estado nutricional en menores de 5 anos,clasificacion d,2001-07-01,8,4,8,4,12
50203,LLALLAGUA,estado nutricional en menores de 5 anos,clasificacion d,2001-07-01,11,129,11,129,140
51401,LLICA,estado nutricional en menores de 5 anos,clasificacion d,2001-07-01,0,18,0,18,18
80601,LORETO,estado nutricional en menores de 5 anos,clasificacion d,2001-07-01,1,16,1,16,17
20901,LURIBAY,estado nutricional en menores de 5 anos,clasificacion d,2001-07-01,2,33,2,33,35
40702,MACHACAMARCA,estado nutricional en menores de 5 anos,clasificacion d,2001-07-01,0,9,0,9,9
11003,MACHARETI,estado nutricional en menores de 5 anos,clasificacion d,2001-07-01,2,84,2,84,86
80801,MAGDALENA,estado nutricional en menores de 5 anos,clasificacion d,2001-07-01,1,24,1,24,25
70903,MAIRANA,estado nutricional en menores de 5 anos,clasificacion d,2001-07-01,11,14,11,14,25
20904,MALLA,estado nutricional en menores de 5 anos,clasificacion d,2001-07-01,0,5,0,5,5
20103,MECAPACA,estado nutricional en menores de 5 anos,clasificacion d,2001-07-01,0,39,0,39,39
71003,MINEROS,estado nutricional en menores de 5 anos,clasificacion d,2001-07-01,5,132,5,132,137
31301,MIZQUE,estado nutricional en menores de 5 anos,clasificacion d,2001-07-01,78,51,78,51,129
20402,MOCOMOCO,estado nutricional en menores de 5 anos,clasificacion d,2001-07-01,37,30,37,30,67
51002,MOJINETE,estado nutricional en menores de 5 anos,clasificacion d,2001-07-01,0,7,0,7,7
10303,MOJOCOYA,estado nutricional en menores de 5 anos,clasificacion d,2001-07-01,1,194,1,194,195
10501,MONTEAGUDO,estado nutricional en menores de 5 anos,clasificacion d,2001-07-01,6,311,6,311,317
71001,MONTERO,estado nutricional en menores de 5 anos,clasificacion d,2001-07-01,24,383,24,383,407
70803,MORO MORO,estado nutricional en menores de 5 anos,clasificacion d,2001-07-01,12,5,12,5,17
30302,MOROCHATA,estado nutricional en menores de 5 anos,clasificacion d,2001-07-01,22,19,22,19,41
90401,NACEBE (SANTA ROSA DEL ABUNA),estado nutricional en menores de 5 anos,clasificacion d,2001-07-01,0,9,0,9,9
50404,OCURI,estado nutricional en menores de 5 anos,clasificacion d,2001-07-01,6,136,6,136,142
70202,OKINAWA,estado nutricional en menores de 5 anos,clasificacion d,2001-07-01,3,18,3,18,21
30203,OMEREQUE,estado nutricional en menores de 5 anos,clasificacion d,2001-07-01,1,24,1,24,25
40101,ORURO,estado nutricional en menores de 5 anos,clasificacion d,2001-07-01,38,807,38,807,845
60201,PADCAYA,estado nutricional en menores de 5 anos,clasificacion d,2001-07-01,7,113,7,113,120
10401,PADILLA,estado nutricional en menores de 5 anos,clasificacion d,2001-07-01,8,401,8,401,409
70502,PAILON,estado nutricional en menores de 5 anos,clasificacion d,2001-07-01,4,80,4,80,84
20102,PALCA,estado nutricional en menores de 5 anos,clasificacion d,2001-07-01,24,16,24,16,40
21104,PALOS BLANCOS,estado nutricional en menores de 5 anos,clasificacion d,2001-07-01,30,96,30,96,126
40802,PAMPA AULLAGAS,estado nutricional en menores de 5 anos,clasificacion d,2001-07-01,10,13,10,13,23
70902,PAMPA GRANDE,estado nutricional en menores de 5 anos,clasificacion d,2001-07-01,1,21,1,21,22
21802,PAPEL PAMPA,estado nutricional en menores de 5 anos,clasificacion d,2001-07-01,0,11,0,11,11
30202,PASORAPA,estado nutricional en menores de 5 anos,clasificacion d,2001-07-01,1,34,1,34,35
21305,PATACAMAYA,estado nutricional en menores de 5 anos,clasificacion d,2001-07-01,25,24,25,24,49
40602,PAZÃ‘A,estado nutricional en menores de 5 anos,clasificacion d,2001-07-01,3,33,3,33,36
20702,PELECHUCO,estado nutricional en menores de 5 anos,clasificacion d,2001-07-01,7,4,7,4,11
50403,POCOATA,estado nutricional en menores de 5 anos,clasificacion d,2001-07-01,18,154,18,154,172
31203,POCONA,estado nutricional en menores de 5 anos,clasificacion d,2001-07-01,4,12,4,12,16
31202,POJO (CBBA),estado nutricional en menores de 5 anos,clasificacion d,2001-07-01,56,188,56,188,244
40601,POOPO,estado nutricional en menores de 5 anos,clasificacion d,2001-07-01,2,40,2,40,42
51203,PORCO,estado nutricional en menores de 5 anos,clasificacion d,2001-07-01,1,38,1,38,39
10103,POROMA,estado nutricional en menores de 5 anos,clasificacion d,2001-07-01,0,359,0,359,359
70103,PORONGO,estado nutricional en menores de 5 anos,clasificacion d,2001-07-01,5,34,5,34,39
70601,PORTACHUELO,estado nutricional en menores de 5 anos,clasificacion d,2001-07-01,34,38,34,38,72
90102,PORVENIR,estado nutricional en menores de 5 anos,clasificacion d,2001-07-01,0,47,0,47,47
70804,POSTRER VALLE,estado nutricional en menores de 5 anos,clasificacion d,2001-07-01,0,9,0,9,9
50101,POTOSI,estado nutricional en menores de 5 anos,clasificacion d,2001-07-01,15,799,15,799,814
10302,PRESTO,estado nutricional en menores de 5 anos,clasificacion d,2001-07-01,2,103,2,103,105
21201,PUCARANI,estado nutricional en menores de 5 anos,clasificacion d,2001-07-01,2,54,2,54,56
20401,PUERTO ACOSTA,estado nutricional en menores de 5 anos,clasificacion d,2001-07-01,63,69,63,69,132
20403,PUERTO CARABUCO,estado nutricional en menores de 5 anos,clasificacion d,2001-07-01,31,84,31,84,115
90301,PUERTO GONZALO MORENO,estado nutricional en menores de 5 anos,clasificacion d,2001-07-01,22,35,22,35,57
21204,PUERTO PEREZ,estado nutricional en menores de 5 anos,clasificacion d,2001-07-01,4,16,4,16,20
71402,PUERTO QUIJARRO,estado nutricional en menores de 5 anos,clasificacion d,2001-07-01,39,13,39,13,52
90201,PUERTO RICO,estado nutricional en menores de 5 anos,clasificacion d,2001-07-01,1,66,1,66,67
80703,PUERTO SILES,estado nutricional en menores de 5 anos,clasificacion d,2001-07-01,1,2,1,2,3
71401,PUERTO SUAREZ,estado nutricional en menores de 5 anos,clasificacion d,2001-07-01,57,25,57,25,82
31205,PUERTO VILLARROEL,estado nutricional en menores de 5 anos,clasificacion d,2001-07-01,97,146,97,146,243
51101,PUNA,estado nutricional en menores de 5 anos,clasificacion d,2001-07-01,19,191,19,191,210
31401,PUNATA,estado nutricional en menores de 5 anos,clasificacion d,2001-07-01,7,23,7,23,30
20604,QUIABAYA,estado nutricional en menores de 5 anos,clasificacion d,2001-07-01,0,24,0,24,24
30901,QUILLACOLLO,estado nutricional en menores de 5 anos,clasificacion d,2001-07-01,0,16,0,16,16
21002,QUIME,estado nutricional en menores de 5 anos,clasificacion d,2001-07-01,50,40,50,40,90
70904,QUIRUSILLAS,estado nutricional en menores de 5 anos,clasificacion d,2001-07-01,0,2,0,2,2
50402,RAVELO,estado nutricional en menores de 5 anos,clasificacion d,2001-07-01,3,178,3,178,181
80301,REYES,estado nutricional en menores de 5 anos,clasificacion d,2001-07-01,3,46,3,46,49
80201,RIBERALTA,estado nutricional en menores de 5 anos,clasificacion d,2001-07-01,18,407,18,407,425
70503,ROBORE,estado nutricional en menores de 5 anos,clasificacion d,2001-07-01,2,117,2,117,119
80304,RURRENABAQUE,estado nutricional en menores de 5 anos,clasificacion d,2001-07-01,12,13,12,13,25
40901,SABAYA,estado nutricional en menores de 5 anos,clasificacion d,2001-07-01,0,9,0,9,9
31001,SACABA,estado nutricional en menores de 5 anos,clasificacion d,2001-07-01,16,132,16,132,148
30404,SACABAMBA,estado nutricional en menores de 5 anos,clasificacion d,2001-07-01,0,56,0,56,56
50701,SACACA,estado nutricional en menores de 5 anos,clasificacion d,2001-07-01,5,134,5,134,139
71302,SAIPINA,estado nutricional en menores de 5 anos,clasificacion d,2001-07-01,1,34,1,34,35
40801,SALINAS DE GARCI MENDOZA,estado nutricional en menores de 5 anos,clasificacion d,2001-07-01,13,11,13,11,24
70901,SAMAIPATA,estado nutricional en menores de 5 anos,clasificacion d,2001-07-01,0,16,0,16,16
51601,SAN AGUSTIN,estado nutricional en menores de 5 anos,clasificacion d,2001-07-01,0,11,0,11,11
80602,SAN ANDRES,estado nutricional en menores de 5 anos,clasificacion d,2001-07-01,0,23,0,23,23
51003,SAN ANTONIO DE ESMORUCO,estado nutricional en menores de 5 anos,clasificacion d,2001-07-01,0,18,0,18,18
71105,SAN ANTONIO DE LOMERIO,estado nutricional en menores de 5 anos,clasificacion d,2001-07-01,81,174,81,174,255
31403,SAN BENITO,estado nutricional en menores de 5 anos,clasificacion d,2001-07-01,1,34,1,34,35
80302,SAN BORJA,estado nutricional en menores de 5 anos,clasificacion d,2001-07-01,10,169,10,169,179
21502,SAN BUENA VENTURA,estado nutricional en menores de 5 anos,clasificacion d,2001-07-01,2,92,2,92,94
70402,SAN CARLOS,estado nutricional en menores de 5 anos,clasificacion d,2001-07-01,5,56,5,56,61
80501,SAN IGNACIO,estado nutricional en menores de 5 anos,clasificacion d,2001-07-01,5,97,5,97,102
70301,SAN IGNACIO DE VELASCO,estado nutricional en menores de 5 anos,clasificacion d,2001-07-01,118,257,118,257,375
80102,SAN JAVIER(BNI),estado nutricional en menores de 5 anos,clasificacion d,2001-07-01,1,24,1,24,25
71102,SAN JAVIER(STC),estado nutricional en menores de 5 anos,clasificacion d,2001-07-01,5,80,5,80,85
80701,SAN JOAQUIN,estado nutricional en menores de 5 anos,clasificacion d,2001-07-01,1,11,1,11,12
70501,SAN JOSE DE CHIQUITOS,estado nutricional en menores de 5 anos,clasificacion d,2001-07-01,54,30,54,30,84
71104,SAN JULIAN,estado nutricional en menores de 5 anos,clasificacion d,2001-07-01,55,207,55,207,262
60501,SAN LORENZO(TJA),estado nutricional en menores de 5 anos,clasificacion d,2001-07-01,1,56,1,56,57
10702,SAN LUCAS,estado nutricional en menores de 5 anos,clasificacion d,2001-07-01,7,683,7,683,690
71201,SAN MATIAS,estado nutricional en menores de 5 anos,clasificacion d,2001-07-01,10,63,10,63,73
70302,SAN MIGUEL DE VELASCO,estado nutricional en menores de 5 anos,clasificacion d,2001-07-01,4,44,4,44,48
51001,SAN PABLO DE LIPEZ,estado nutricional en menores de 5 anos,clasificacion d,2001-07-01,4,38,4,38,42
50501,SAN PEDRO DE BUENA VISTA,estado nutricional en menores de 5 anos,clasificacion d,2001-07-01,3,190,3,190,193
21801,SAN PEDRO DE CURAHUARA,estado nutricional en menores de 5 anos,clasificacion d,2001-07-01,0,13,0,13,13
50902,SAN PEDRO DE QUEMES,estado nutricional en menores de 5 anos,clasificacion d,2001-07-01,0,7,0,7,7
21702,SAN PEDRO DE TIQUINA,estado nutricional en menores de 5 anos,clasificacion d,2001-07-01,0,13,0,13,13
90202,SAN PEDRO(PND),estado nutricional en menores de 5 anos,clasificacion d,2001-07-01,2,6,2,6,8
70303,SAN RAFAEL,estado nutricional en menores de 5 anos,clasificacion d,2001-07-01,26,17,26,17,43
80702,SAN RAMON,estado nutricional en menores de 5 anos,clasificacion d,2001-07-01,2,12,2,12,14
80401,SANTA ANA,estado nutricional en menores de 5 anos,clasificacion d,2001-07-01,0,17,0,17,17
70101,SANTA CRUZ DE LA SIERRA,estado nutricional en menores de 5 anos,clasificacion d,2001-07-01,301,476,301,476,777
80303,SANTA ROSA,estado nutricional en menores de 5 anos,clasificacion d,2001-07-01,0,4,0,4,4
70602,SANTA ROSA DEL SARA,estado nutricional en menores de 5 anos,clasificacion d,2001-07-01,7,31,7,31,38
20308,SANTIAGO DE CALLAPA,estado nutricional en menores de 5 anos,clasificacion d,2001-07-01,0,12,0,12,12
41401,SANTIAGO DE HUARI,estado nutricional en menores de 5 anos,clasificacion d,2001-07-01,17,11,17,11,28
21901,SANTIAGO DE MACHACA,estado nutricional en menores de 5 anos,clasificacion d,2001-07-01,0,17,0,17,17
30702,SANTIVAÃ‘ES,estado nutricional en menores de 5 anos,clasificacion d,2001-07-01,23,19,23,19,42
40202,SANTUARIO DE QUILLACAS,estado nutricional en menores de 5 anos,clasificacion d,2001-07-01,3,11,3,11,14
20902,SAPAHAQUI,estado nutricional en menores de 5 anos,clasificacion d,2001-07-01,1,39,1,39,40
90303,SENA,estado nutricional en menores de 5 anos,clasificacion d,2001-07-01,1,15,1,15,16
21301,SICA SICA (VILLA AROMA),estado nutricional en menores de 5 anos,clasificacion d,2001-07-01,18,51,18,51,69
30703,SICAYA,estado nutricional en menores de 5 anos,clasificacion d,2001-07-01,0,14,0,14,14
30902,SIPE SIPE,estado nutricional en menores de 5 anos,clasificacion d,2001-07-01,87,123,87,123,210
10403,SOPACHUY,estado nutricional en menores de 5 anos,clasificacion d,2001-07-01,7,289,7,289,296
20601,SORATA,estado nutricional en menores de 5 anos,clasificacion d,2001-07-01,2,51,2,51,53
10101,SUCRE,estado nutricional en menores de 5 anos,clasificacion d,2001-07-01,32,1624,32,1624,1656
20603,TACACOMA,estado nutricional en menores de 5 anos,clasificacion d,2001-07-01,0,41,0,41,41
50303,TACOBAMBA,estado nutricional en menores de 5 anos,clasificacion d,2001-07-01,2,117,2,117,119
30602,TACOPAYA,estado nutricional en menores de 5 anos,clasificacion d,2001-07-01,0,25,0,25,25
51402,TAHUA,estado nutricional en menores de 5 anos,clasificacion d,2001-07-01,0,2,0,2,2
31101,TAPACARI,estado nutricional en menores de 5 anos,clasificacion d,2001-07-01,0,89,0,89,89
10601,TARABUCO,estado nutricional en menores de 5 anos,clasificacion d,2001-07-01,10,741,10,741,751
30401,TARATA,estado nutricional en menores de 5 anos,clasificacion d,2001-07-01,4,46,4,46,50
60101,TARIJA,estado nutricional en menores de 5 anos,clasificacion d,2001-07-01,60,315,60,315,375
10202,TARVITA,estado nutricional en menores de 5 anos,clasificacion d,2001-07-01,2,246,2,246,248
20803,TIAWANACU,estado nutricional en menores de 5 anos,clasificacion d,2001-07-01,18,10,18,10,28
50102,TINGUIPAYA,estado nutricional en menores de 5 anos,clasificacion d,2001-07-01,6,52,6,52,58
20606,TIPUANI,estado nutricional en menores de 5 anos,clasificacion d,2001-07-01,11,8,11,8,19
30903,TIQUIPAYA,estado nutricional en menores de 5 anos,clasificacion d,2001-07-01,14,110,14,110,124
31601,TIRAQUE (CBBA),estado nutricional en menores de 5 anos,clasificacion d,2001-07-01,36,119,36,119,155
30802,TOCO,estado nutricional en menores de 5 anos,clasificacion d,2001-07-01,1,9,1,9,10
41502,TODOS SANTOS,estado nutricional en menores de 5 anos,clasificacion d,2001-07-01,0,1,0,1,1
30803,TOLATA,estado nutricional en menores de 5 anos,clasificacion d,2001-07-01,1,11,1,11,12
41001,TOLEDO,estado nutricional en menores de 5 anos,clasificacion d,2001-07-01,1,10,1,10,11
51202,TOMAVE,estado nutricional en menores de 5 anos,clasificacion d,2001-07-01,14,89,14,89,103
10402,TOMINA,estado nutricional en menores de 5 anos,clasificacion d,2001-07-01,4,290,4,290,294
50502,TORO TORO,estado nutricional en menores de 5 anos,clasificacion d,2001-07-01,0,40,0,40,40
31201,TOTORA(CBBA),estado nutricional en menores de 5 anos,clasificacion d,2001-07-01,29,62,29,62,91
41301,TOTORA(ORR),estado nutricional en menores de 5 anos,clasificacion d,2001-07-01,1,23,1,23,24
70802,TRIGAL,estado nutricional en menores de 5 anos,clasificacion d,2001-07-01,5,5,5,5,10
80101,TRINIDAD,estado nutricional en menores de 5 anos,clasificacion d,2001-07-01,25,224,25,224,249
50801,TUPIZA,estado nutricional en menores de 5 anos,clasificacion d,2001-07-01,6,242,6,242,248
40402,TURCO,estado nutricional en menores de 5 anos,clasificacion d,2001-07-01,11,5,11,5,16
21302,UMALA,estado nutricional en menores de 5 anos,clasificacion d,2001-07-01,1,10,1,10,11
50201,UNCIA,estado nutricional en menores de 5 anos,clasificacion d,2001-07-01,3,239,3,239,242
60401,URIONDO (A. CONCEPCION),estado nutricional en menores de 5 anos,clasificacion d,2001-07-01,0,14,0,14,14
71502,URUBICHA,estado nutricional en menores de 5 anos,clasificacion d,2001-07-01,0,25,0,25,25
51201,UYUNI,estado nutricional en menores de 5 anos,clasificacion d,2001-07-01,2,122,2,122,124
30502,VACAS,estado nutricional en menores de 5 anos,clasificacion d,2001-07-01,0,18,0,18,18
70801,VALLEGRANDE,estado nutricional en menores de 5 anos,clasificacion d,2001-07-01,53,66,53,66,119
20801,VIACHA,estado nutricional en menores de 5 anos,clasificacion d,2001-07-01,10,136,10,136,146
31302,VILA VILA,estado nutricional en menores de 5 anos,clasificacion d,2001-07-01,23,10,23,10,33
60303,VILLA MONTES,estado nutricional en menores de 5 anos,clasificacion d,2001-07-01,25,100,25,100,125
31402,VILLA RIVERO,estado nutricional en menores de 5 anos,clasificacion d,2001-07-01,0,3,0,3,3
10801,VILLA SERRANO,estado nutricional en menores de 5 anos,clasificacion d,2001-07-01,2,383,2,383,385
31003,VILLA TUNARI,estado nutricional en menores de 5 anos,clasificacion d,2001-07-01,88,66,88,66,154
11001,VILLA VACA GUZMAN (MUYUPAMPA),estado nutricional en menores de 5 anos,clasificacion d,2001-07-01,6,134,6,134,140
51501,VILLAZON,estado nutricional en menores de 5 anos,clasificacion d,2001-07-01,2,240,2,240,242
30904,VINTO,estado nutricional en menores de 5 anos,clasificacion d,2001-07-01,21,9,21,9,30
50602,VITICHI,estado nutricional en menores de 5 anos,clasificacion d,2001-07-01,0,31,0,31,31
20306,WALDO BALLIVIAN,estado nutricional en menores de 5 anos,clasificacion d,2001-07-01,1,14,1,14,15
70201,WARNES,estado nutricional en menores de 5 anos,clasificacion d,2001-07-01,26,113,26,113,139
20903,YACO,estado nutricional en menores de 5 anos,clasificacion d,2001-07-01,0,24,0,24,24
60301,YACUIBA,estado nutricional en menores de 5 anos,clasificacion d,2001-07-01,12,164,12,164,176
10602,YAMPARAEZ,estado nutricional en menores de 5 anos,clasificacion d,2001-07-01,2,395,2,395,397
21103,YANACACHI,estado nutricional en menores de 5 anos,clasificacion d,2001-07-01,6,9,6,9,15
70403,YAPACANI,estado nutricional en menores de 5 anos,clasificacion d,2001-07-01,15,162,15,162,177
50103,YOCALLA,estado nutricional en menores de 5 anos,clasificacion d,2001-07-01,9,104,9,104,113
10102,YOTALA,estado nutricional en menores de 5 anos,clasificacion d,2001-07-01,4,344,4,344,348
60402,YUNCHARA,estado nutricional en menores de 5 anos,clasificacion d,2001-07-01,4,30,4,30,34
10301,ZUDAÃ‘EZ,estado nutricional en menores de 5 anos,clasificacion d,2001-07-01,2,259,2,259,261
51302,ACACIO,estado nutricional en menores de 5 anos,clasificacion d,2001-08-01,3,131,3,131,134
20201,ACHACACHI,estado nutricional en menores de 5 anos,clasificacion d,2001-08-01,11,280,11,280,291
20104,ACHOCALLA,estado nutricional en menores de 5 anos,clasificacion d,2001-08-01,1,20,1,20,21
30201,AIQUILE,estado nutricional en menores de 5 anos,clasificacion d,2001-08-01,8,114,8,114,122
31303,ALALAY,estado nutricional en menores de 5 anos,clasificacion d,2001-08-01,19,3,19,3,22
10404,ALCALA,estado nutricional en menores de 5 anos,clasificacion d,2001-08-01,1,122,1,122,123
20202,ANCORAIMES,estado nutricional en menores de 5 anos,clasificacion d,2001-08-01,2,178,2,178,180
41201,ANDAMARCA,estado nutricional en menores de 5 anos,clasificacion d,2001-08-01,1,4,1,4,5
30402,ANZALDO,estado nutricional en menores de 5 anos,clasificacion d,2001-08-01,1,59,1,59,60
20701,APOLO,estado nutricional en menores de 5 anos,clasificacion d,2001-08-01,19,20,19,20,39
51301,ARAMPAMPA,estado nutricional en menores de 5 anos,clasificacion d,2001-08-01,2,113,2,113,115
30501,ARANI,estado nutricional en menores de 5 anos,clasificacion d,2001-08-01,1,104,1,104,105
30403,ARBIETO,estado nutricional en menores de 5 anos,clasificacion d,2001-08-01,0,13,0,13,13
30601,ARQUE,estado nutricional en menores de 5 anos,clasificacion d,2001-08-01,54,79,54,79,133
71501,ASCENCION DE GUARAYOS,estado nutricional en menores de 5 anos,clasificacion d,2001-08-01,154,219,154,219,373
50802,ATOCHA,estado nutricional en menores de 5 anos,clasificacion d,2001-08-01,1,75,1,75,76
20503,AUCAPATA,estado nutricional en menores de 5 anos,clasificacion d,2001-08-01,1,9,1,9,10
20502,AYATA,estado nutricional en menores de 5 anos,clasificacion d,2001-08-01,16,5,16,5,21
21303,AYO AYO,estado nutricional en menores de 5 anos,clasificacion d,2001-08-01,1,38,1,38,39
30301,AYOPAYA (V. DE INDEPENDENCIA),estado nutricional en menores de 5 anos,clasificacion d,2001-08-01,64,95,64,95,159
10201,AZURDUY,estado nutricional en menores de 5 anos,clasificacion d,2001-08-01,2,184,2,184,186
21203,BATALLAS,estado nutricional en menores de 5 anos,clasificacion d,2001-08-01,1,72,1,72,73
80802,BAURES,estado nutricional en menores de 5 anos,clasificacion d,2001-08-01,9,7,9,7,16
41202,BELEN DE ANDAMARCA,estado nutricional en menores de 5 anos,clasificacion d,2001-08-01,0,3,0,3,3
50104,BELEN DE URMIRI,estado nutricional en menores de 5 anos,clasificacion d,2001-08-01,0,39,0,39,39
90104,BELLA FLOR,estado nutricional en menores de 5 anos,clasificacion d,2001-08-01,0,12,0,12,12
60202,BERMEJO,estado nutricional en menores de 5 anos,clasificacion d,2001-08-01,1,11,1,11,12
50301,BETANZOS,estado nutricional en menores de 5 anos,clasificacion d,2001-08-01,0,147,0,147,147
31501,BOLIVAR,estado nutricional en menores de 5 anos,clasificacion d,2001-08-01,63,46,63,46,109
90103,BOLPEBRA,estado nutricional en menores de 5 anos,clasificacion d,2001-08-01,0,11,0,11,11
70707,BOYUIBE,estado nutricional en menores de 5 anos,clasificacion d,2001-08-01,2,53,2,53,55
70401,BUENA VISTA,estado nutricional en menores de 5 anos,clasificacion d,2001-08-01,73,65,73,65,138
70703,CABEZAS,estado nutricional en menores de 5 anos,clasificacion d,2001-08-01,1,56,1,56,57
20905,CAIROMA,estado nutricional en menores de 5 anos,clasificacion d,2001-08-01,0,18,0,18,18
51102,"CAIZA ""D""",estado nutricional en menores de 5 anos,clasificacion d,2001-08-01,3,150,3,150,153
21003,CAJUATA,estado nutricional en menores de 5 anos,clasificacion d,2001-08-01,11,22,11,22,33
20303,CALACOTO,estado nutricional en menores de 5 anos,clasificacion d,2001-08-01,4,4,4,4,8
21304,CALAMARCA,estado nutricional en menores de 5 anos,clasificacion d,2001-08-01,5,45,5,45,50
10701,CAMARGO,estado nutricional en menores de 5 anos,clasificacion d,2001-08-01,0,129,0,129,129
10901,CAMATAQUI (C. VILLA ABECIA),estado nutricional en menores de 5 anos,clasificacion d,2001-08-01,0,73,0,73,73
70706,CAMIRI,estado nutricional en menores de 5 anos,clasificacion d,2001-08-01,35,100,35,100,135
30701,CAPINOTA,estado nutricional en menores de 5 anos,clasificacion d,2001-08-01,27,32,27,32,59
20302,CAQUIAVIRI,estado nutricional en menores de 5 anos,clasificacion d,2001-08-01,7,31,7,31,38
40102,CARACOLLO,estado nutricional en menores de 5 anos,clasificacion d,2001-08-01,18,18,18,18,36
22001,CARANAVI,estado nutricional en menores de 5 anos,clasificacion d,2001-08-01,70,208,70,208,278
60302,CARAPARI,estado nutricional en menores de 5 anos,clasificacion d,2001-08-01,17,28,17,28,45
50702,CARIPUYO,estado nutricional en menores de 5 anos,clasificacion d,2001-08-01,3,176,3,176,179
21902,CATACORA,estado nutricional en menores de 5 anos,clasificacion d,2001-08-01,0,13,0,13,13
21803,CHACARILLA,estado nutricional en menores de 5 anos,clasificacion d,2001-08-01,1,4,1,4,5
40201,CHALLAPATA,estado nutricional en menores de 5 anos,clasificacion d,2001-08-01,38,34,38,34,72
50302,CHAQUI,estado nutricional en menores de 5 anos,clasificacion d,2001-08-01,3,89,3,89,92
70702,CHARAGUA,estado nutricional en menores de 5 anos,clasificacion d,2001-08-01,5,218,5,218,223
20305,CHARAÃ‘A,estado nutricional en menores de 5 anos,clasificacion d,2001-08-01,0,26,0,26,26
50202,CHAYANTA,estado nutricional en menores de 5 anos,clasificacion d,2001-08-01,7,144,7,144,151
31204,CHIMORE,estado nutricional en menores de 5 anos,clasificacion d,2001-08-01,3,52,3,52,55
21101,CHULUMANI (V. DE LA LIBERTAD),estado nutricional en menores de 5 anos,clasificacion d,2001-08-01,1,37,1,37,38
20501,CHUMA,estado nutricional en menores de 5 anos,clasificacion d,2001-08-01,12,12,12,12,24
30801,CLIZA,estado nutricional en menores de 5 anos,clasificacion d,2001-08-01,8,34,8,34,42
90101,COBIJA,estado nutricional en menores de 5 anos,clasificacion d,2001-08-01,77,71,77,71,148
30101,COCHABAMBA,estado nutricional en menores de 5 anos,clasificacion d,2001-08-01,280,295,280,295,575
40902,COIPASA,estado nutricional en menores de 5 anos,clasificacion d,2001-08-01,0,2,0,2,2
30905,COLCAPIRHUA,estado nutricional en menores de 5 anos,clasificacion d,2001-08-01,17,41,17,41,58
50901,"COLCHA ""K""",estado nutricional en menores de 5 anos,clasificacion d,2001-08-01,9,109,9,109,118
21307,COLLANA,estado nutricional en menores de 5 anos,clasificacion d,2001-08-01,3,0,3,0,3
31002,COLOMI,estado nutricional en menores de 5 anos,clasificacion d,2001-08-01,14,151,14,151,165
70603,COLPA BELGICA,estado nutricional en menores de 5 anos,clasificacion d,2001-08-01,17,3,17,3,20
50401,COLQUECHACA,estado nutricional en menores de 5 anos,clasificacion d,2001-08-01,26,123,26,123,149
21306,COLQUENCHA,estado nutricional en menores de 5 anos,clasificacion d,2001-08-01,9,18,9,18,27
21004,COLQUIRI,estado nutricional en menores de 5 anos,clasificacion d,2001-08-01,80,96,80,96,176
20304,COMANCHE,estado nutricional en menores de 5 anos,clasificacion d,2001-08-01,2,17,2,17,19
71301,COMARAPA,estado nutricional en menores de 5 anos,clasificacion d,2001-08-01,0,25,0,25,25
20605,COMBAYA,estado nutricional en menores de 5 anos,clasificacion d,2001-08-01,0,15,0,15,15
71101,CONCEPCION,estado nutricional en menores de 5 anos,clasificacion d,2001-08-01,26,12,26,12,38
21701,COPACABANA,estado nutricional en menores de 5 anos,clasificacion d,2001-08-01,1,65,1,65,66
21402,CORIPATA,estado nutricional en menores de 5 anos,clasificacion d,2001-08-01,0,11,0,11,11
20301,CORO CORO,estado nutricional en menores de 5 anos,clasificacion d,2001-08-01,2,90,2,90,92
21401,COROICO,estado nutricional en menores de 5 anos,clasificacion d,2001-08-01,21,37,21,37,58
40301,CORQUE,estado nutricional en menores de 5 anos,clasificacion d,2001-08-01,8,23,8,23,31
50601,COTAGAITA,estado nutricional en menores de 5 anos,clasificacion d,2001-08-01,10,181,10,181,191
70102,COTOCA,estado nutricional en menores de 5 anos,clasificacion d,2001-08-01,4,47,4,47,51
31405,CUCHUMUELA (V. G. VILLARROEL),estado nutricional en menores de 5 anos,clasificacion d,2001-08-01,1,31,1,31,32
70704,CUEVO,estado nutricional en menores de 5 anos,clasificacion d,2001-08-01,11,47,11,47,58
10902,CULPINA,estado nutricional en menores de 5 anos,clasificacion d,2001-08-01,11,488,11,488,499
40401,CURAHUARA DE CARANGAS,estado nutricional en menores de 5 anos,clasificacion d,2001-08-01,23,9,23,9,32
21602,CURVA,estado nutricional en menores de 5 anos,clasificacion d,2001-08-01,7,2,7,2,9
20804,DESAGUADERO,estado nutricional en menores de 5 anos,clasificacion d,2001-08-01,8,20,8,20,28
20105,EL ALTO,estado nutricional en menores de 5 anos,clasificacion d,2001-08-01,1168,1550,1168,1550,2718
71503,EL PUENTE(STC),estado nutricional en menores de 5 anos,clasificacion d,2001-08-01,11,115,11,115,126
60502,EL PUENTE(TJA),estado nutricional en menores de 5 anos,clasificacion d,2001-08-01,7,46,7,46,53
70105,EL TORNO,estado nutricional en menores de 5 anos,clasificacion d,2001-08-01,13,122,13,122,135
10405,EL VILLAR,estado nutricional en menores de 5 anos,clasificacion d,2001-08-01,1,204,1,204,205
60601,ENTRE RIOS,estado nutricional en menores de 5 anos,clasificacion d,2001-08-01,31,74,31,74,105
41101,EUCALIPTUS,estado nutricional en menores de 5 anos,clasificacion d,2001-08-01,1,17,1,17,18
80402,EXALTACION,estado nutricional en menores de 5 anos,clasificacion d,2001-08-01,0,31,0,31,31
90203,FILADELFIA,estado nutricional en menores de 5 anos,clasificacion d,2001-08-01,0,13,0,13,13
71002,GENERAL SAAVEDRA,estado nutricional en menores de 5 anos,clasificacion d,2001-08-01,2,120,2,120,122
21601,GRAL. J.J. PEREZ (CHARAZANI),estado nutricional en menores de 5 anos,clasificacion d,2001-08-01,20,22,20,22,42
20602,GUANAY,estado nutricional en menores de 5 anos,clasificacion d,2001-08-01,1,103,1,103,104
20802,GUAQUI,estado nutricional en menores de 5 anos,clasificacion d,2001-08-01,0,23,0,23,23
80202,GUAYARAMERIN,estado nutricional en menores de 5 anos,clasificacion d,2001-08-01,21,247,21,247,268
70705,GUTIERREZ,estado nutricional en menores de 5 anos,clasificacion d,2001-08-01,38,127,38,127,165
10502,HUACARETA,estado nutricional en menores de 5 anos,clasificacion d,2001-08-01,5,203,5,203,208
40501,HUACHACALLA,estado nutricional en menores de 5 anos,clasificacion d,2001-08-01,2,1,2,1,3
40701,HUANUNI,estado nutricional en menores de 5 anos,clasificacion d,2001-08-01,1,3,1,3,4
80803,HUARACAJE,estado nutricional en menores de 5 anos,clasificacion d,2001-08-01,3,4,3,4,7
41601,HUAYLLAMARCA,estado nutricional en menores de 5 anos,clasificacion d,2001-08-01,2,60,2,60,62
21005,ICHOCA,estado nutricional en menores de 5 anos,clasificacion d,2001-08-01,1,5,1,5,6
10304,ICLA,estado nutricional en menores de 5 anos,clasificacion d,2001-08-01,124,205,124,205,329
10703,INCAHUASI,estado nutricional en menores de 5 anos,clasificacion d,2001-08-01,5,266,5,266,271
21001,INQUISIVI,estado nutricional en menores de 5 anos,clasificacion d,2001-08-01,2,112,2,112,114
21102,IRUPANA (VILLA DE LANZA),estado nutricional en menores de 5 anos,clasificacion d,2001-08-01,9,54,9,54,63
21501,IXIAMAS,estado nutricional en menores de 5 anos,clasificacion d,2001-08-01,1,56,1,56,57
21105,LA ASUNTA,estado nutricional en menores de 5 anos,clasificacion d,2001-08-01,15,44,15,44,59
70104,LA GUARDIA,estado nutricional en menores de 5 anos,clasificacion d,2001-08-01,4,130,4,130,134
20101,LA PAZ,estado nutricional en menores de 5 anos,clasificacion d,2001-08-01,758,1009,758,1009,1767
41501,LA RIVERA,estado nutricional en menores de 5 anos,clasificacion d,2001-08-01,0,1,0,1,1
70701,LAGUNILLAS,estado nutricional en menores de 5 anos,clasificacion d,2001-08-01,35,50,35,50,85
21202,LAJA,estado nutricional en menores de 5 anos,clasificacion d,2001-08-01,10,41,10,41,51
10903,LAS CARRERAS,estado nutricional en menores de 5 anos,clasificacion d,2001-08-01,0,64,0,64,64
50203,LLALLAGUA,estado nutricional en menores de 5 anos,clasificacion d,2001-08-01,9,99,9,99,108
51401,LLICA,estado nutricional en menores de 5 anos,clasificacion d,2001-08-01,0,28,0,28,28
80601,LORETO,estado nutricional en menores de 5 anos,clasificacion d,2001-08-01,0,13,0,13,13
20901,LURIBAY,estado nutricional en menores de 5 anos,clasificacion d,2001-08-01,0,32,0,32,32
40702,MACHACAMARCA,estado nutricional en menores de 5 anos,clasificacion d,2001-08-01,9,9,9,9,18
11003,MACHARETI,estado nutricional en menores de 5 anos,clasificacion d,2001-08-01,0,198,0,198,198
80801,MAGDALENA,estado nutricional en menores de 5 anos,clasificacion d,2001-08-01,22,32,22,32,54
70903,MAIRANA,estado nutricional en menores de 5 anos,clasificacion d,2001-08-01,19,19,19,19,38
20904,MALLA,estado nutricional en menores de 5 anos,clasificacion d,2001-08-01,2,21,2,21,23
20103,MECAPACA,estado nutricional en menores de 5 anos,clasificacion d,2001-08-01,2,51,2,51,53
71003,MINEROS,estado nutricional en menores de 5 anos,clasificacion d,2001-08-01,5,152,5,152,157
31301,MIZQUE,estado nutricional en menores de 5 anos,clasificacion d,2001-08-01,91,52,91,52,143
20402,MOCOMOCO,estado nutricional en menores de 5 anos,clasificacion d,2001-08-01,37,63,37,63,100
51002,MOJINETE,estado nutricional en menores de 5 anos,clasificacion d,2001-08-01,0,15,0,15,15
10303,MOJOCOYA,estado nutricional en menores de 5 anos,clasificacion d,2001-08-01,0,213,0,213,213
10501,MONTEAGUDO,estado nutricional en menores de 5 anos,clasificacion d,2001-08-01,9,431,9,431,440
71001,MONTERO,estado nutricional en menores de 5 anos,clasificacion d,2001-08-01,33,548,33,548,581
70803,MORO MORO,estado nutricional en menores de 5 anos,clasificacion d,2001-08-01,7,7,7,7,14
30302,MOROCHATA,estado nutricional en menores de 5 anos,clasificacion d,2001-08-01,53,104,53,104,157
90401,NACEBE (SANTA ROSA DEL ABUNA),estado nutricional en menores de 5 anos,clasificacion d,2001-08-01,0,6,0,6,6
20307,NAZACARA DE PACAJES,estado nutricional en menores de 5 anos,clasificacion d,2001-08-01,0,1,0,1,1
90501,NUEVO MANOA (NUEVA ESPERANZA),estado nutricional en menores de 5 anos,clasificacion d,2001-08-01,1,7,1,7,8
50404,OCURI,estado nutricional en menores de 5 anos,clasificacion d,2001-08-01,4,127,4,127,131
70202,OKINAWA,estado nutricional en menores de 5 anos,clasificacion d,2001-08-01,2,15,2,15,17
30203,OMEREQUE,estado nutricional en menores de 5 anos,clasificacion d,2001-08-01,2,12,2,12,14
40101,ORURO,estado nutricional en menores de 5 anos,clasificacion d,2001-08-01,43,933,43,933,976
60201,PADCAYA,estado nutricional en menores de 5 anos,clasificacion d,2001-08-01,16,67,16,67,83
10401,PADILLA,estado nutricional en menores de 5 anos,clasificacion d,2001-08-01,4,434,4,434,438
70502,PAILON,estado nutricional en menores de 5 anos,clasificacion d,2001-08-01,0,59,0,59,59
20102,PALCA,estado nutricional en menores de 5 anos,clasificacion d,2001-08-01,44,52,44,52,96
21104,PALOS BLANCOS,estado nutricional en menores de 5 anos,clasificacion d,2001-08-01,33,59,33,59,92
40802,PAMPA AULLAGAS,estado nutricional en menores de 5 anos,clasificacion d,2001-08-01,16,6,16,6,22
70902,PAMPA GRANDE,estado nutricional en menores de 5 anos,clasificacion d,2001-08-01,0,36,0,36,36
21802,PAPEL PAMPA,estado nutricional en menores de 5 anos,clasificacion d,2001-08-01,0,7,0,7,7
30202,PASORAPA,estado nutricional en menores de 5 anos,clasificacion d,2001-08-01,1,26,1,26,27
21305,PATACAMAYA,estado nutricional en menores de 5 anos,clasificacion d,2001-08-01,24,24,24,24,48
40602,PAZÃ‘A,estado nutricional en menores de 5 anos,clasificacion d,2001-08-01,0,13,0,13,13
20702,PELECHUCO,estado nutricional en menores de 5 anos,clasificacion d,2001-08-01,9,1,9,1,10
50403,POCOATA,estado nutricional en menores de 5 anos,clasificacion d,2001-08-01,58,269,58,269,327
31203,POCONA,estado nutricional en menores de 5 anos,clasificacion d,2001-08-01,25,73,25,73,98
31202,POJO (CBBA),estado nutricional en menores de 5 anos,clasificacion d,2001-08-01,50,156,50,156,206
40601,POOPO,estado nutricional en menores de 5 anos,clasificacion d,2001-08-01,7,39,7,39,46
51203,PORCO,estado nutricional en menores de 5 anos,clasificacion d,2001-08-01,2,40,2,40,42
10103,POROMA,estado nutricional en menores de 5 anos,clasificacion d,2001-08-01,6,279,6,279,285
70103,PORONGO,estado nutricional en menores de 5 anos,clasificacion d,2001-08-01,1,58,1,58,59
70601,PORTACHUELO,estado nutricional en menores de 5 anos,clasificacion d,2001-08-01,23,43,23,43,66
90102,PORVENIR,estado nutricional en menores de 5 anos,clasificacion d,2001-08-01,2,35,2,35,37
70804,POSTRER VALLE,estado nutricional en menores de 5 anos,clasificacion d,2001-08-01,6,4,6,4,10
50101,POTOSI,estado nutricional en menores de 5 anos,clasificacion d,2001-08-01,40,890,40,890,930
10302,PRESTO,estado nutricional en menores de 5 anos,clasificacion d,2001-08-01,1,207,1,207,208
70805,PUCARA,estado nutricional en menores de 5 anos,clasificacion d,2001-08-01,1,10,1,10,11
21201,PUCARANI,estado nutricional en menores de 5 anos,clasificacion d,2001-08-01,7,105,7,105,112
20401,PUERTO ACOSTA,estado nutricional en menores de 5 anos,clasificacion d,2001-08-01,100,76,100,76,176
20403,PUERTO CARABUCO,estado nutricional en menores de 5 anos,clasificacion d,2001-08-01,34,64,34,64,98
90301,PUERTO GONZALO MORENO,estado nutricional en menores de 5 anos,clasificacion d,2001-08-01,0,31,0,31,31
21204,PUERTO PEREZ,estado nutricional en menores de 5 anos,clasificacion d,2001-08-01,2,9,2,9,11
71402,PUERTO QUIJARRO,estado nutricional en menores de 5 anos,clasificacion d,2001-08-01,38,12,38,12,50
90201,PUERTO RICO,estado nutricional en menores de 5 anos,clasificacion d,2001-08-01,0,6,0,6,6
80703,PUERTO SILES,estado nutricional en menores de 5 anos,clasificacion d,2001-08-01,5,44,5,44,49
71401,PUERTO SUAREZ,estado nutricional en menores de 5 anos,clasificacion d,2001-08-01,66,19,66,19,85
31205,PUERTO VILLARROEL,estado nutricional en menores de 5 anos,clasificacion d,2001-08-01,122,139,122,139,261
51101,PUNA,estado nutricional en menores de 5 anos,clasificacion d,2001-08-01,15,288,15,288,303
31401,PUNATA,estado nutricional en menores de 5 anos,clasificacion d,2001-08-01,16,91,16,91,107
20604,QUIABAYA,estado nutricional en menores de 5 anos,clasificacion d,2001-08-01,0,53,0,53,53
30901,QUILLACOLLO,estado nutricional en menores de 5 anos,clasificacion d,2001-08-01,0,26,0,26,26
21002,QUIME,estado nutricional en menores de 5 anos,clasificacion d,2001-08-01,71,28,71,28,99
70904,QUIRUSILLAS,estado nutricional en menores de 5 anos,clasificacion d,2001-08-01,2,2,2,2,4
50402,RAVELO,estado nutricional en menores de 5 anos,clasificacion d,2001-08-01,17,368,17,368,385
80301,REYES,estado nutricional en menores de 5 anos,clasificacion d,2001-08-01,2,57,2,57,59
80201,RIBERALTA,estado nutricional en menores de 5 anos,clasificacion d,2001-08-01,26,558,26,558,584
70503,ROBORE,estado nutricional en menores de 5 anos,clasificacion d,2001-08-01,2,48,2,48,50
80304,RURRENABAQUE,estado nutricional en menores de 5 anos,clasificacion d,2001-08-01,28,22,28,22,50
40901,SABAYA,estado nutricional en menores de 5 anos,clasificacion d,2001-08-01,0,5,0,5,5
31001,SACABA,estado nutricional en menores de 5 anos,clasificacion d,2001-08-01,179,108,179,108,287
30404,SACABAMBA,estado nutricional en menores de 5 anos,clasificacion d,2001-08-01,0,105,0,105,105
50701,SACACA,estado nutricional en menores de 5 anos,clasificacion d,2001-08-01,3,350,3,350,353
71302,SAIPINA,estado nutricional en menores de 5 anos,clasificacion d,2001-08-01,2,8,2,8,10
40801,SALINAS DE GARCI MENDOZA,estado nutricional en menores de 5 anos,clasificacion d,2001-08-01,9,6,9,6,15
70901,SAMAIPATA,estado nutricional en menores de 5 anos,clasificacion d,2001-08-01,1,14,1,14,15
51601,SAN AGUSTIN,estado nutricional en menores de 5 anos,clasificacion d,2001-08-01,1,18,1,18,19
80602,SAN ANDRES,estado nutricional en menores de 5 anos,clasificacion d,2001-08-01,0,55,0,55,55
51003,SAN ANTONIO DE ESMORUCO,estado nutricional en menores de 5 anos,clasificacion d,2001-08-01,0,16,0,16,16
71105,SAN ANTONIO DE LOMERIO,estado nutricional en menores de 5 anos,clasificacion d,2001-08-01,93,141,93,141,234
31403,SAN BENITO,estado nutricional en menores de 5 anos,clasificacion d,2001-08-01,1,24,1,24,25
80302,SAN BORJA,estado nutricional en menores de 5 anos,clasificacion d,2001-08-01,4,165,4,165,169
21502,SAN BUENA VENTURA,estado nutricional en menores de 5 anos,clasificacion d,2001-08-01,0,49,0,49,49
70402,SAN CARLOS,estado nutricional en menores de 5 anos,clasificacion d,2001-08-01,4,65,4,65,69
80501,SAN IGNACIO,estado nutricional en menores de 5 anos,clasificacion d,2001-08-01,6,111,6,111,117
70301,SAN IGNACIO DE VELASCO,estado nutricional en menores de 5 anos,clasificacion d,2001-08-01,130,266,130,266,396
80102,SAN JAVIER(BNI),estado nutricional en menores de 5 anos,clasificacion d,2001-08-01,1,25,1,25,26
71102,SAN JAVIER(STC),estado nutricional en menores de 5 anos,clasificacion d,2001-08-01,9,85,9,85,94
80701,SAN JOAQUIN,estado nutricional en menores de 5 anos,clasificacion d,2001-08-01,0,20,0,20,20
70501,SAN JOSE DE CHIQUITOS,estado nutricional en menores de 5 anos,clasificacion d,2001-08-01,54,23,54,23,77
71104,SAN JULIAN,estado nutricional en menores de 5 anos,clasificacion d,2001-08-01,67,240,67,240,307
90302,SAN LORENZO(PND),estado nutricional en menores de 5 anos,clasificacion d,2001-08-01,3,9,3,9,12
60501,SAN LORENZO(TJA),estado nutricional en menores de 5 anos,clasificacion d,2001-08-01,20,81,20,81,101
10702,SAN LUCAS,estado nutricional en menores de 5 anos,clasificacion d,2001-08-01,15,675,15,675,690
71201,SAN MATIAS,estado nutricional en menores de 5 anos,clasificacion d,2001-08-01,9,100,9,100,109
70302,SAN MIGUEL DE VELASCO,estado nutricional en menores de 5 anos,clasificacion d,2001-08-01,6,64,6,64,70
51001,SAN PABLO DE LIPEZ,estado nutricional en menores de 5 anos,clasificacion d,2001-08-01,0,28,0,28,28
50501,SAN PEDRO DE BUENA VISTA,estado nutricional en menores de 5 anos,clasificacion d,2001-08-01,4,379,4,379,383
21801,SAN PEDRO DE CURAHUARA,estado nutricional en menores de 5 anos,clasificacion d,2001-08-01,0,28,0,28,28
50902,SAN PEDRO DE QUEMES,estado nutricional en menores de 5 anos,clasificacion d,2001-08-01,0,13,0,13,13
21702,SAN PEDRO DE TIQUINA,estado nutricional en menores de 5 anos,clasificacion d,2001-08-01,0,17,0,17,17
90202,SAN PEDRO(PND),estado nutricional en menores de 5 anos,clasificacion d,2001-08-01,6,12,6,12,18
70303,SAN RAFAEL,estado nutricional en menores de 5 anos,clasificacion d,2001-08-01,27,37,27,37,64
80702,SAN RAMON,estado nutricional en menores de 5 anos,clasificacion d,2001-08-01,1,5,1,5,6
80702,SAN RAMON,estado nutricional en menores de 5 anos,clasificacion d,2001-08-01,0,12,0,12,12
80401,SANTA ANA,estado nutricional en menores de 5 anos,clasificacion d,2001-08-01,2,2,2,2,4
70101,SANTA CRUZ DE LA SIERRA,estado nutricional en menores de 5 anos,clasificacion d,2001-08-01,389,464,389,464,853
80303,SANTA ROSA,estado nutricional en menores de 5 anos,clasificacion d,2001-08-01,20,54,20,54,74
70602,SANTA ROSA DEL SARA,estado nutricional en menores de 5 anos,clasificacion d,2001-08-01,14,55,14,55,69
20308,SANTIAGO DE CALLAPA,estado nutricional en menores de 5 anos,clasificacion d,2001-08-01,1,16,1,16,17
41401,SANTIAGO DE HUARI,estado nutricional en menores de 5 anos,clasificacion d,2001-08-01,9,35,9,35,44
21901,SANTIAGO DE MACHACA,estado nutricional en menores de 5 anos,clasificacion d,2001-08-01,0,30,0,30,30
30702,SANTIVAÃ‘ES,estado nutricional en menores de 5 anos,clasificacion d,2001-08-01,25,30,25,30,55
40202,SANTUARIO DE QUILLACAS,estado nutricional en menores de 5 anos,clasificacion d,2001-08-01,9,21,9,21,30
20902,SAPAHAQUI,estado nutricional en menores de 5 anos,clasificacion d,2001-08-01,1,34,1,34,35
90303,SENA,estado nutricional en menores de 5 anos,clasificacion d,2001-08-01,1,13,1,13,14
21301,SICA SICA (VILLA AROMA),estado nutricional en menores de 5 anos,clasificacion d,2001-08-01,25,48,25,48,73
30703,SICAYA,estado nutricional en menores de 5 anos,clasificacion d,2001-08-01,0,12,0,12,12
30902,SIPE SIPE,estado nutricional en menores de 5 anos,clasificacion d,2001-08-01,113,91,113,91,204
10403,SOPACHUY,estado nutricional en menores de 5 anos,clasificacion d,2001-08-01,0,247,0,247,247
20601,SORATA,estado nutricional en menores de 5 anos,clasificacion d,2001-08-01,1,88,1,88,89
10101,SUCRE,estado nutricional en menores de 5 anos,clasificacion d,2001-08-01,42,1534,42,1534,1576
31404,TACACHI,estado nutricional en menores de 5 anos,clasificacion d,2001-08-01,0,6,0,6,6
20603,TACACOMA,estado nutricional en menores de 5 anos,clasificacion d,2001-08-01,1,20,1,20,21
50303,TACOBAMBA,estado nutricional en menores de 5 anos,clasificacion d,2001-08-01,1,181,1,181,182
30602,TACOPAYA,estado nutricional en menores de 5 anos,clasificacion d,2001-08-01,2,152,2,152,154
51402,TAHUA,estado nutricional en menores de 5 anos,clasificacion d,2001-08-01,0,4,0,4,4
31101,TAPACARI,estado nutricional en menores de 5 anos,clasificacion d,2001-08-01,10,124,10,124,134
10601,TARABUCO,estado nutricional en menores de 5 anos,clasificacion d,2001-08-01,14,755,14,755,769
30401,TARATA,estado nutricional en menores de 5 anos,clasificacion d,2001-08-01,3,62,3,62,65
60101,TARIJA,estado nutricional en menores de 5 anos,clasificacion d,2001-08-01,58,354,58,354,412
10202,TARVITA,estado nutricional en menores de 5 anos,clasificacion d,2001-08-01,9,170,9,170,179
20803,TIAWANACU,estado nutricional en menores de 5 anos,clasificacion d,2001-08-01,22,9,22,9,31
50102,TINGUIPAYA,estado nutricional en menores de 5 anos,clasificacion d,2001-08-01,11,130,11,130,141
20606,TIPUANI,estado nutricional en menores de 5 anos,clasificacion d,2001-08-01,5,16,5,16,21
30903,TIQUIPAYA,estado nutricional en menores de 5 anos,clasificacion d,2001-08-01,21,44,21,44,65
31601,TIRAQUE (CBBA),estado nutricional en menores de 5 anos,clasificacion d,2001-08-01,42,79,42,79,121
21703,TITO YUPANQUI (PARQUIPUJIO),estado nutricional en menores de 5 anos,clasificacion d,2001-08-01,0,6,0,6,6
30802,TOCO,estado nutricional en menores de 5 anos,clasificacion d,2001-08-01,0,19,0,19,19
41502,TODOS SANTOS,estado nutricional en menores de 5 anos,clasificacion d,2001-08-01,0,1,0,1,1
30803,TOLATA,estado nutricional en menores de 5 anos,clasificacion d,2001-08-01,0,5,0,5,5
41001,TOLEDO,estado nutricional en menores de 5 anos,clasificacion d,2001-08-01,7,14,7,14,21
51202,TOMAVE,estado nutricional en menores de 5 anos,clasificacion d,2001-08-01,4,177,4,177,181
10402,TOMINA,estado nutricional en menores de 5 anos,clasificacion d,2001-08-01,3,293,3,293,296
50502,TORO TORO,estado nutricional en menores de 5 anos,clasificacion d,2001-08-01,5,18,5,18,23
31201,TOTORA(CBBA),estado nutricional en menores de 5 anos,clasificacion d,2001-08-01,47,75,47,75,122
41301,TOTORA(ORR),estado nutricional en menores de 5 anos,clasificacion d,2001-08-01,1,35,1,35,36
70802,TRIGAL,estado nutricional en menores de 5 anos,clasificacion d,2001-08-01,4,4,4,4,8
80101,TRINIDAD,estado nutricional en menores de 5 anos,clasificacion d,2001-08-01,26,175,26,175,201
50801,TUPIZA,estado nutricional en menores de 5 anos,clasificacion d,2001-08-01,6,419,6,419,425
40402,TURCO,estado nutricional en menores de 5 anos,clasificacion d,2001-08-01,9,7,9,7,16
21302,UMALA,estado nutricional en menores de 5 anos,clasificacion d,2001-08-01,2,31,2,31,33
50201,UNCIA,estado nutricional en menores de 5 anos,clasificacion d,2001-08-01,4,91,4,91,95
60401,URIONDO (A. CONCEPCION),estado nutricional en menores de 5 anos,clasificacion d,2001-08-01,0,14,0,14,14
71502,URUBICHA,estado nutricional en menores de 5 anos,clasificacion d,2001-08-01,4,285,4,285,289
51201,UYUNI,estado nutricional en menores de 5 anos,clasificacion d,2001-08-01,3,189,3,189,192
30502,VACAS,estado nutricional en menores de 5 anos,clasificacion d,2001-08-01,2,9,2,9,11
70801,VALLEGRANDE,estado nutricional en menores de 5 anos,clasificacion d,2001-08-01,48,94,48,94,142
20801,VIACHA,estado nutricional en menores de 5 anos,clasificacion d,2001-08-01,9,149,9,149,158
31302,VILA VILA,estado nutricional en menores de 5 anos,clasificacion d,2001-08-01,27,11,27,11,38
60303,VILLA MONTES,estado nutricional en menores de 5 anos,clasificacion d,2001-08-01,40,50,40,50,90
31402,VILLA RIVERO,estado nutricional en menores de 5 anos,clasificacion d,2001-08-01,1,14,1,14,15
10801,VILLA SERRANO,estado nutricional en menores de 5 anos,clasificacion d,2001-08-01,5,294,5,294,299
31003,VILLA TUNARI,estado nutricional en menores de 5 anos,clasificacion d,2001-08-01,88,63,88,63,151
11001,VILLA VACA GUZMAN (MUYUPAMPA),estado nutricional en menores de 5 anos,clasificacion d,2001-08-01,8,212,8,212,220
51501,VILLAZON,estado nutricional en menores de 5 anos,clasificacion d,2001-08-01,1,240,1,240,241
30904,VINTO,estado nutricional en menores de 5 anos,clasificacion d,2001-08-01,21,7,21,7,28
50602,VITICHI,estado nutricional en menores de 5 anos,clasificacion d,2001-08-01,0,86,0,86,86
20306,WALDO BALLIVIAN,estado nutricional en menores de 5 anos,clasificacion d,2001-08-01,1,7,1,7,8
70201,WARNES,estado nutricional en menores de 5 anos,clasificacion d,2001-08-01,64,157,64,157,221
20903,YACO,estado nutricional en menores de 5 anos,clasificacion d,2001-08-01,0,20,0,20,20
60301,YACUIBA,estado nutricional en menores de 5 anos,clasificacion d,2001-08-01,76,29,76,29,105
10602,YAMPARAEZ,estado nutricional en menores de 5 anos,clasificacion d,2001-08-01,7,420,7,420,427
21103,YANACACHI,estado nutricional en menores de 5 anos,clasificacion d,2001-08-01,7,20,7,20,27
70403,YAPACANI,estado nutricional en menores de 5 anos,clasificacion d,2001-08-01,36,134,36,134,170
50103,YOCALLA,estado nutricional en menores de 5 anos,clasificacion d,2001-08-01,1,83,1,83,84
10102,YOTALA,estado nutricional en menores de 5 anos,clasificacion d,2001-08-01,1,331,1,331,332
60402,YUNCHARA,estado nutricional en menores de 5 anos,clasificacion d,2001-08-01,2,46,2,46,48
10301,ZUDAÃ‘EZ,estado nutricional en menores de 5 anos,clasificacion d,2001-08-01,2,288,2,288,290
51302,ACACIO,estado nutricional en menores de 5 anos,clasificacion d,2001-09-01,2,168,2,168,170
20201,ACHACACHI,estado nutricional en menores de 5 anos,clasificacion d,2001-09-01,10,224,10,224,234
20104,ACHOCALLA,estado nutricional en menores de 5 anos,clasificacion d,2001-09-01,0,3,0,3,3
30201,AIQUILE,estado nutricional en menores de 5 anos,clasificacion d,2001-09-01,22,122,22,122,144
31303,ALALAY,estado nutricional en menores de 5 anos,clasificacion d,2001-09-01,17,9,17,9,26
10404,ALCALA,estado nutricional en menores de 5 anos,clasificacion d,2001-09-01,0,83,0,83,83
20202,ANCORAIMES,estado nutricional en menores de 5 anos,clasificacion d,2001-09-01,2,165,2,165,167
41201,ANDAMARCA,estado nutricional en menores de 5 anos,clasificacion d,2001-09-01,3,8,3,8,11
40603,ANTEQUERA,estado nutricional en menores de 5 anos,clasificacion d,2001-09-01,1,0,1,0,1
30402,ANZALDO,estado nutricional en menores de 5 anos,clasificacion d,2001-09-01,0,46,0,46,46
20701,APOLO,estado nutricional en menores de 5 anos,clasificacion d,2001-09-01,13,5,13,5,18
51301,ARAMPAMPA,estado nutricional en menores de 5 anos,clasificacion d,2001-09-01,1,60,1,60,61
30501,ARANI,estado nutricional en menores de 5 anos,clasificacion d,2001-09-01,1,30,1,30,31
30403,ARBIETO,estado nutricional en menores de 5 anos,clasificacion d,2001-09-01,0,7,0,7,7
30601,ARQUE,estado nutricional en menores de 5 anos,clasificacion d,2001-09-01,66,73,66,73,139
71501,ASCENCION DE GUARAYOS,estado nutricional en menores de 5 anos,clasificacion d,2001-09-01,1,27,1,27,28
50802,ATOCHA,estado nutricional en menores de 5 anos,clasificacion d,2001-09-01,1,65,1,65,66
20503,AUCAPATA,estado nutricional en menores de 5 anos,clasificacion d,2001-09-01,10,12,10,12,22
20502,AYATA,estado nutricional en menores de 5 anos,clasificacion d,2001-09-01,9,4,9,4,13
21303,AYO AYO,estado nutricional en menores de 5 anos,clasificacion d,2001-09-01,1,11,1,11,12
30301,AYOPAYA (V. DE INDEPENDENCIA),estado nutricional en menores de 5 anos,clasificacion d,2001-09-01,113,143,113,143,256
10201,AZURDUY,estado nutricional en menores de 5 anos,clasificacion d,2001-09-01,3,124,3,124,127
21203,BATALLAS,estado nutricional en menores de 5 anos,clasificacion d,2001-09-01,0,61,0,61,61
80802,BAURES,estado nutricional en menores de 5 anos,clasificacion d,2001-09-01,21,28,21,28,49
41202,BELEN DE ANDAMARCA,estado nutricional en menores de 5 anos,clasificacion d,2001-09-01,0,1,0,1,1
50104,BELEN DE URMIRI,estado nutricional en menores de 5 anos,clasificacion d,2001-09-01,1,41,1,41,42
90104,BELLA FLOR,estado nutricional en menores de 5 anos,clasificacion d,2001-09-01,0,2,0,2,2
60202,BERMEJO,estado nutricional en menores de 5 anos,clasificacion d,2001-09-01,1,9,1,9,10
50301,BETANZOS,estado nutricional en menores de 5 anos,clasificacion d,2001-09-01,12,471,12,471,483
31501,BOLIVAR,estado nutricional en menores de 5 anos,clasificacion d,2001-09-01,39,26,39,26,65
90103,BOLPEBRA,estado nutricional en menores de 5 anos,clasificacion d,2001-09-01,0,11,0,11,11
70707,BOYUIBE,estado nutricional en menores de 5 anos,clasificacion d,2001-09-01,1,16,1,16,17
70401,BUENA VISTA,estado nutricional en menores de 5 anos,clasificacion d,2001-09-01,63,73,63,73,136
70703,CABEZAS,estado nutricional en menores de 5 anos,clasificacion d,2001-09-01,1,53,1,53,54
20905,CAIROMA,estado nutricional en menores de 5 anos,clasificacion d,2001-09-01,3,43,3,43,46
51102,"CAIZA ""D""",estado nutricional en menores de 5 anos,clasificacion d,2001-09-01,14,170,14,170,184
21003,CAJUATA,estado nutricional en menores de 5 anos,clasificacion d,2001-09-01,7,6,7,6,13
20303,CALACOTO,estado nutricional en menores de 5 anos,clasificacion d,2001-09-01,3,4,3,4,7
21304,CALAMARCA,estado nutricional en menores de 5 anos,clasificacion d,2001-09-01,1,36,1,36,37
10701,CAMARGO,estado nutricional en menores de 5 anos,clasificacion d,2001-09-01,0,137,0,137,137
10901,CAMATAQUI (C. VILLA ABECIA),estado nutricional en menores de 5 anos,clasificacion d,2001-09-01,0,49,0,49,49
70706,CAMIRI,estado nutricional en menores de 5 anos,clasificacion d,2001-09-01,44,73,44,73,117
30701,CAPINOTA,estado nutricional en menores de 5 anos,clasificacion d,2001-09-01,19,37,19,37,56
20302,CAQUIAVIRI,estado nutricional en menores de 5 anos,clasificacion d,2001-09-01,4,27,4,27,31
40102,CARACOLLO,estado nutricional en menores de 5 anos,clasificacion d,2001-09-01,26,42,26,42,68
22001,CARANAVI,estado nutricional en menores de 5 anos,clasificacion d,2001-09-01,62,206,62,206,268
60302,CARAPARI,estado nutricional en menores de 5 anos,clasificacion d,2001-09-01,2,5,2,5,7
50702,CARIPUYO,estado nutricional en menores de 5 anos,clasificacion d,2001-09-01,1,200,1,200,201
21902,CATACORA,estado nutricional en menores de 5 anos,clasificacion d,2001-09-01,0,18,0,18,18
21803,CHACARILLA,estado nutricional en menores de 5 anos,clasificacion d,2001-09-01,0,4,0,4,4
40201,CHALLAPATA,estado nutricional en menores de 5 anos,clasificacion d,2001-09-01,23,33,23,33,56
50302,CHAQUI,estado nutricional en menores de 5 anos,clasificacion d,2001-09-01,0,69,0,69,69
70702,CHARAGUA,estado nutricional en menores de 5 anos,clasificacion d,2001-09-01,3,193,3,193,196
20305,CHARAÃ‘A,estado nutricional en menores de 5 anos,clasificacion d,2001-09-01,0,29,0,29,29
50202,CHAYANTA,estado nutricional en menores de 5 anos,clasificacion d,2001-09-01,3,122,3,122,125
31204,CHIMORE,estado nutricional en menores de 5 anos,clasificacion d,2001-09-01,23,48,23,48,71
40302,CHOQUE COTA,estado nutricional en menores de 5 anos,clasificacion d,2001-09-01,0,18,0,18,18
21101,CHULUMANI (V. DE LA LIBERTAD),estado nutricional en menores de 5 anos,clasificacion d,2001-09-01,2,18,2,18,20
20501,CHUMA,estado nutricional en menores de 5 anos,clasificacion d,2001-09-01,16,7,16,7,23
30801,CLIZA,estado nutricional en menores de 5 anos,clasificacion d,2001-09-01,9,27,9,27,36
90101,COBIJA,estado nutricional en menores de 5 anos,clasificacion d,2001-09-01,59,70,59,70,129
30101,COCHABAMBA,estado nutricional en menores de 5 anos,clasificacion d,2001-09-01,278,280,278,280,558
40902,COIPASA,estado nutricional en menores de 5 anos,clasificacion d,2001-09-01,0,2,0,2,2
30905,COLCAPIRHUA,estado nutricional en menores de 5 anos,clasificacion d,2001-09-01,196,123,196,123,319
50901,"COLCHA ""K""",estado nutricional en menores de 5 anos,clasificacion d,2001-09-01,1,64,1,64,65
21307,COLLANA,estado nutricional en menores de 5 anos,clasificacion d,2001-09-01,2,0,2,0,2
31002,COLOMI,estado nutricional en menores de 5 anos,clasificacion d,2001-09-01,18,58,18,58,76
70603,COLPA BELGICA,estado nutricional en menores de 5 anos,clasificacion d,2001-09-01,27,6,27,6,33
50401,COLQUECHACA,estado nutricional en menores de 5 anos,clasificacion d,2001-09-01,24,163,24,163,187
21306,COLQUENCHA,estado nutricional en menores de 5 anos,clasificacion d,2001-09-01,21,18,21,18,39
21004,COLQUIRI,estado nutricional en menores de 5 anos,clasificacion d,2001-09-01,103,34,103,34,137
20304,COMANCHE,estado nutricional en menores de 5 anos,clasificacion d,2001-09-01,4,20,4,20,24
71301,COMARAPA,estado nutricional en menores de 5 anos,clasificacion d,2001-09-01,10,24,10,24,34
20605,COMBAYA,estado nutricional en menores de 5 anos,clasificacion d,2001-09-01,0,15,0,15,15
71101,CONCEPCION,estado nutricional en menores de 5 anos,clasificacion d,2001-09-01,11,6,11,6,17
21701,COPACABANA,estado nutricional en menores de 5 anos,clasificacion d,2001-09-01,1,54,1,54,55
21402,CORIPATA,estado nutricional en menores de 5 anos,clasificacion d,2001-09-01,1,16,1,16,17
20301,CORO CORO,estado nutricional en menores de 5 anos,clasificacion d,2001-09-01,27,33,27,33,60
21401,COROICO,estado nutricional en menores de 5 anos,clasificacion d,2001-09-01,28,25,28,25,53
40301,CORQUE,estado nutricional en menores de 5 anos,clasificacion d,2001-09-01,0,11,0,11,11
50601,COTAGAITA,estado nutricional en menores de 5 anos,clasificacion d,2001-09-01,8,200,8,200,208
70102,COTOCA,estado nutricional en menores de 5 anos,clasificacion d,2001-09-01,1,25,1,25,26
31405,CUCHUMUELA (V. G. VILLARROEL),estado nutricional en menores de 5 anos,clasificacion d,2001-09-01,0,2,0,2,2
70704,CUEVO,estado nutricional en menores de 5 anos,clasificacion d,2001-09-01,23,45,23,45,68
10902,CULPINA,estado nutricional en menores de 5 anos,clasificacion d,2001-09-01,4,385,4,385,389
40401,CURAHUARA DE CARANGAS,estado nutricional en menores de 5 anos,clasificacion d,2001-09-01,10,12,10,12,22
21602,CURVA,estado nutricional en menores de 5 anos,clasificacion d,2001-09-01,12,7,12,7,19
20804,DESAGUADERO,estado nutricional en menores de 5 anos,clasificacion d,2001-09-01,4,39,4,39,43
20105,EL ALTO,estado nutricional en menores de 5 anos,clasificacion d,2001-09-01,840,1409,840,1409,2249
40103,EL CHORO,estado nutricional en menores de 5 anos,clasificacion d,2001-09-01,0,1,0,1,1
71503,EL PUENTE(STC),estado nutricional en menores de 5 anos,clasificacion d,2001-09-01,3,121,3,121,124
60502,EL PUENTE(TJA),estado nutricional en menores de 5 anos,clasificacion d,2001-09-01,21,32,21,32,53
70105,EL TORNO,estado nutricional en menores de 5 anos,clasificacion d,2001-09-01,2,147,2,147,149
10405,EL VILLAR,estado nutricional en menores de 5 anos,clasificacion d,2001-09-01,3,195,3,195,198
60601,ENTRE RIOS,estado nutricional en menores de 5 anos,clasificacion d,2001-09-01,13,65,13,65,78
40502,ESCARA,estado nutricional en menores de 5 anos,clasificacion d,2001-09-01,1,0,1,0,1
41101,EUCALIPTUS,estado nutricional en menores de 5 anos,clasificacion d,2001-09-01,0,31,0,31,31
80402,EXALTACION,estado nutricional en menores de 5 anos,clasificacion d,2001-09-01,4,25,4,25,29
90203,FILADELFIA,estado nutricional en menores de 5 anos,clasificacion d,2001-09-01,0,14,0,14,14
71002,GENERAL SAAVEDRA,estado nutricional en menores de 5 anos,clasificacion d,2001-09-01,0,131,0,131,131
21601,GRAL. J.J. PEREZ (CHARAZANI),estado nutricional en menores de 5 anos,clasificacion d,2001-09-01,6,8,6,8,14
20602,GUANAY,estado nutricional en menores de 5 anos,clasificacion d,2001-09-01,22,136,22,136,158
20802,GUAQUI,estado nutricional en menores de 5 anos,clasificacion d,2001-09-01,2,23,2,23,25
80202,GUAYARAMERIN,estado nutricional en menores de 5 anos,clasificacion d,2001-09-01,76,119,76,119,195
70705,GUTIERREZ,estado nutricional en menores de 5 anos,clasificacion d,2001-09-01,10,136,10,136,146
10502,HUACARETA,estado nutricional en menores de 5 anos,clasificacion d,2001-09-01,3,185,3,185,188
40501,HUACHACALLA,estado nutricional en menores de 5 anos,clasificacion d,2001-09-01,2,2,2,2,4
40701,HUANUNI,estado nutricional en menores de 5 anos,clasificacion d,2001-09-01,2,13,2,13,15
80803,HUARACAJE,estado nutricional en menores de 5 anos,clasificacion d,2001-09-01,4,0,4,0,4
41601,HUAYLLAMARCA,estado nutricional en menores de 5 anos,clasificacion d,2001-09-01,0,42,0,42,42
21005,ICHOCA,estado nutricional en menores de 5 anos,clasificacion d,2001-09-01,0,20,0,20,20
10304,ICLA,estado nutricional en menores de 5 anos,clasificacion d,2001-09-01,130,259,130,259,389
10703,INCAHUASI,estado nutricional en menores de 5 anos,clasificacion d,2001-09-01,17,226,17,226,243
21001,INQUISIVI,estado nutricional en menores de 5 anos,clasificacion d,2001-09-01,1,55,1,55,56
21102,IRUPANA (VILLA DE LANZA),estado nutricional en menores de 5 anos,clasificacion d,2001-09-01,14,40,14,40,54
21501,IXIAMAS,estado nutricional en menores de 5 anos,clasificacion d,2001-09-01,28,43,28,43,71
21105,LA ASUNTA,estado nutricional en menores de 5 anos,clasificacion d,2001-09-01,17,63,17,63,80
70104,LA GUARDIA,estado nutricional en menores de 5 anos,clasificacion d,2001-09-01,4,88,4,88,92
20101,LA PAZ,estado nutricional en menores de 5 anos,clasificacion d,2001-09-01,624,943,624,943,1567
41501,LA RIVERA,estado nutricional en menores de 5 anos,clasificacion d,2001-09-01,0,5,0,5,5
70701,LAGUNILLAS,estado nutricional en menores de 5 anos,clasificacion d,2001-09-01,16,54,16,54,70
21202,LAJA,estado nutricional en menores de 5 anos,clasificacion d,2001-09-01,1,73,1,73,74
10903,LAS CARRERAS,estado nutricional en menores de 5 anos,clasificacion d,2001-09-01,1,49,1,49,50
50203,LLALLAGUA,estado nutricional en menores de 5 anos,clasificacion d,2001-09-01,4,126,4,126,130
51401,LLICA,estado nutricional en menores de 5 anos,clasificacion d,2001-09-01,1,31,1,31,32
80601,LORETO,estado nutricional en menores de 5 anos,clasificacion d,2001-09-01,0,19,0,19,19
20901,LURIBAY,estado nutricional en menores de 5 anos,clasificacion d,2001-09-01,0,13,0,13,13
40702,MACHACAMARCA,estado nutricional en menores de 5 anos,clasificacion d,2001-09-01,3,2,3,2,5
11003,MACHARETI,estado nutricional en menores de 5 anos,clasificacion d,2001-09-01,4,121,4,121,125
80801,MAGDALENA,estado nutricional en menores de 5 anos,clasificacion d,2001-09-01,12,14,12,14,26
70903,MAIRANA,estado nutricional en menores de 5 anos,clasificacion d,2001-09-01,8,16,8,16,24
20103,MECAPACA,estado nutricional en menores de 5 anos,clasificacion d,2001-09-01,13,39,13,39,52
71003,MINEROS,estado nutricional en menores de 5 anos,clasificacion d,2001-09-01,3,134,3,134,137
31301,MIZQUE,estado nutricional en menores de 5 anos,clasificacion d,2001-09-01,9,24,9,24,33
20402,MOCOMOCO,estado nutricional en menores de 5 anos,clasificacion d,2001-09-01,44,99,44,99,143
51002,MOJINETE,estado nutricional en menores de 5 anos,clasificacion d,2001-09-01,2,18,2,18,20
10303,MOJOCOYA,estado nutricional en menores de 5 anos,clasificacion d,2001-09-01,1,222,1,222,223
10501,MONTEAGUDO,estado nutricional en menores de 5 anos,clasificacion d,2001-09-01,6,344,6,344,350
71001,MONTERO,estado nutricional en menores de 5 anos,clasificacion d,2001-09-01,15,412,15,412,427
70803,MORO MORO,estado nutricional en menores de 5 anos,clasificacion d,2001-09-01,18,9,18,9,27
30302,MOROCHATA,estado nutricional en menores de 5 anos,clasificacion d,2001-09-01,44,87,44,87,131
90401,NACEBE (SANTA ROSA DEL ABUNA),estado nutricional en menores de 5 anos,clasificacion d,2001-09-01,1,18,1,18,19
20307,NAZACARA DE PACAJES,estado nutricional en menores de 5 anos,clasificacion d,2001-09-01,0,3,0,3,3
50404,OCURI,estado nutricional en menores de 5 anos,clasificacion d,2001-09-01,68,130,68,130,198
70202,OKINAWA,estado nutricional en menores de 5 anos,clasificacion d,2001-09-01,0,17,0,17,17
30203,OMEREQUE,estado nutricional en menores de 5 anos,clasificacion d,2001-09-01,1,19,1,19,20
40101,ORURO,estado nutricional en menores de 5 anos,clasificacion d,2001-09-01,47,680,47,680,727
60201,PADCAYA,estado nutricional en menores de 5 anos,clasificacion d,2001-09-01,12,44,12,44,56
10401,PADILLA,estado nutricional en menores de 5 anos,clasificacion d,2001-09-01,9,411,9,411,420
70502,PAILON,estado nutricional en menores de 5 anos,clasificacion d,2001-09-01,5,32,5,32,37
20102,PALCA,estado nutricional en menores de 5 anos,clasificacion d,2001-09-01,63,51,63,51,114
21104,PALOS BLANCOS,estado nutricional en menores de 5 anos,clasificacion d,2001-09-01,41,91,41,91,132
40802,PAMPA AULLAGAS,estado nutricional en menores de 5 anos,clasificacion d,2001-09-01,14,11,14,11,25
70902,PAMPA GRANDE,estado nutricional en menores de 5 anos,clasificacion d,2001-09-01,7,18,7,18,25
21802,PAPEL PAMPA,estado nutricional en menores de 5 anos,clasificacion d,2001-09-01,0,11,0,11,11
30202,PASORAPA,estado nutricional en menores de 5 anos,clasificacion d,2001-09-01,0,23,0,23,23
21305,PATACAMAYA,estado nutricional en menores de 5 anos,clasificacion d,2001-09-01,24,10,24,10,34
40602,PAZÃ‘A,estado nutricional en menores de 5 anos,clasificacion d,2001-09-01,4,37,4,37,41
20702,PELECHUCO,estado nutricional en menores de 5 anos,clasificacion d,2001-09-01,11,5,11,5,16
50403,POCOATA,estado nutricional en menores de 5 anos,clasificacion d,2001-09-01,80,157,80,157,237
31203,POCONA,estado nutricional en menores de 5 anos,clasificacion d,2001-09-01,26,102,26,102,128
31202,POJO (CBBA),estado nutricional en menores de 5 anos,clasificacion d,2001-09-01,48,160,48,160,208
40601,POOPO,estado nutricional en menores de 5 anos,clasificacion d,2001-09-01,9,37,9,37,46
51203,PORCO,estado nutricional en menores de 5 anos,clasificacion d,2001-09-01,2,48,2,48,50
10103,POROMA,estado nutricional en menores de 5 anos,clasificacion d,2001-09-01,3,270,3,270,273
70103,PORONGO,estado nutricional en menores de 5 anos,clasificacion d,2001-09-01,1,48,1,48,49
70601,PORTACHUELO,estado nutricional en menores de 5 anos,clasificacion d,2001-09-01,26,26,26,26,52
90102,PORVENIR,estado nutricional en menores de 5 anos,clasificacion d,2001-09-01,1,26,1,26,27
70804,POSTRER VALLE,estado nutricional en menores de 5 anos,clasificacion d,2001-09-01,4,12,4,12,16
50101,POTOSI,estado nutricional en menores de 5 anos,clasificacion d,2001-09-01,33,780,33,780,813
10302,PRESTO,estado nutricional en menores de 5 anos,clasificacion d,2001-09-01,0,127,0,127,127
70805,PUCARA,estado nutricional en menores de 5 anos,clasificacion d,2001-09-01,0,1,0,1,1
21201,PUCARANI,estado nutricional en menores de 5 anos,clasificacion d,2001-09-01,3,84,3,84,87
20403,PUERTO CARABUCO,estado nutricional en menores de 5 anos,clasificacion d,2001-09-01,52,103,52,103,155
90301,PUERTO GONZALO MORENO,estado nutricional en menores de 5 anos,clasificacion d,2001-09-01,0,41,0,41,41
21204,PUERTO PEREZ,estado nutricional en menores de 5 anos,clasificacion d,2001-09-01,4,13,4,13,17
71402,PUERTO QUIJARRO,estado nutricional en menores de 5 anos,clasificacion d,2001-09-01,25,10,25,10,35
90201,PUERTO RICO,estado nutricional en menores de 5 anos,clasificacion d,2001-09-01,5,11,5,11,16
80703,PUERTO SILES,estado nutricional en menores de 5 anos,clasificacion d,2001-09-01,0,2,0,2,2
71401,PUERTO SUAREZ,estado nutricional en menores de 5 anos,clasificacion d,2001-09-01,66,36,66,36,102
31205,PUERTO VILLARROEL,estado nutricional en menores de 5 anos,clasificacion d,2001-09-01,106,73,106,73,179
51101,PUNA,estado nutricional en menores de 5 anos,clasificacion d,2001-09-01,31,339,31,339,370
31401,PUNATA,estado nutricional en menores de 5 anos,clasificacion d,2001-09-01,9,40,9,40,49
20604,QUIABAYA,estado nutricional en menores de 5 anos,clasificacion d,2001-09-01,3,88,3,88,91
30901,QUILLACOLLO,estado nutricional en menores de 5 anos,clasificacion d,2001-09-01,0,5,0,5,5
21002,QUIME,estado nutricional en menores de 5 anos,clasificacion d,2001-09-01,28,53,28,53,81
70904,QUIRUSILLAS,estado nutricional en menores de 5 anos,clasificacion d,2001-09-01,0,4,0,4,4
50402,RAVELO,estado nutricional en menores de 5 anos,clasificacion d,2001-09-01,40,394,40,394,434
80301,REYES,estado nutricional en menores de 5 anos,clasificacion d,2001-09-01,1,124,1,124,125
80201,RIBERALTA,estado nutricional en menores de 5 anos,clasificacion d,2001-09-01,12,409,12,409,421
70503,ROBORE,estado nutricional en menores de 5 anos,clasificacion d,2001-09-01,2,72,2,72,74
80304,RURRENABAQUE,estado nutricional en menores de 5 anos,clasificacion d,2001-09-01,10,8,10,8,18
40901,SABAYA,estado nutricional en menores de 5 anos,clasificacion d,2001-09-01,0,1,0,1,1
31001,SACABA,estado nutricional en menores de 5 anos,clasificacion d,2001-09-01,54,153,54,153,207
30404,SACABAMBA,estado nutricional en menores de 5 anos,clasificacion d,2001-09-01,4,63,4,63,67
50701,SACACA,estado nutricional en menores de 5 anos,clasificacion d,2001-09-01,0,331,0,331,331
71302,SAIPINA,estado nutricional en menores de 5 anos,clasificacion d,2001-09-01,12,16,12,16,28
40801,SALINAS DE GARCI MENDOZA,estado nutricional en menores de 5 anos,clasificacion d,2001-09-01,5,5,5,5,10
70901,SAMAIPATA,estado nutricional en menores de 5 anos,clasificacion d,2001-09-01,2,15,2,15,17
51601,SAN AGUSTIN,estado nutricional en menores de 5 anos,clasificacion d,2001-09-01,0,26,0,26,26
80602,SAN ANDRES,estado nutricional en menores de 5 anos,clasificacion d,2001-09-01,1,61,1,61,62
51003,SAN ANTONIO DE ESMORUCO,estado nutricional en menores de 5 anos,clasificacion d,2001-09-01,0,10,0,10,10
71105,SAN ANTONIO DE LOMERIO,estado nutricional en menores de 5 anos,clasificacion d,2001-09-01,73,150,73,150,223
31403,SAN BENITO,estado nutricional en menores de 5 anos,clasificacion d,2001-09-01,0,10,0,10,10
80302,SAN BORJA,estado nutricional en menores de 5 anos,clasificacion d,2001-09-01,92,69,92,69,161
21502,SAN BUENA VENTURA,estado nutricional en menores de 5 anos,clasificacion d,2001-09-01,5,94,5,94,99
70402,SAN CARLOS,estado nutricional en menores de 5 anos,clasificacion d,2001-09-01,0,71,0,71,71
80501,SAN IGNACIO,estado nutricional en menores de 5 anos,clasificacion d,2001-09-01,24,114,24,114,138
70301,SAN IGNACIO DE VELASCO,estado nutricional en menores de 5 anos,clasificacion d,2001-09-01,177,213,177,213,390
80102,SAN JAVIER(BNI),estado nutricional en menores de 5 anos,clasificacion d,2001-09-01,0,56,0,56,56
71102,SAN JAVIER(STC),estado nutricional en menores de 5 anos,clasificacion d,2001-09-01,5,35,5,35,40
80701,SAN JOAQUIN,estado nutricional en menores de 5 anos,clasificacion d,2001-09-01,1,14,1,14,15
70501,SAN JOSE DE CHIQUITOS,estado nutricional en menores de 5 anos,clasificacion d,2001-09-01,34,13,34,13,47
71104,SAN JULIAN,estado nutricional en menores de 5 anos,clasificacion d,2001-09-01,50,177,50,177,227
90302,SAN LORENZO(PND),estado nutricional en menores de 5 anos,clasificacion d,2001-09-01,0,10,0,10,10
60501,SAN LORENZO(TJA),estado nutricional en menores de 5 anos,clasificacion d,2001-09-01,16,63,16,63,79
10702,SAN LUCAS,estado nutricional en menores de 5 anos,clasificacion d,2001-09-01,6,750,6,750,756
71201,SAN MATIAS,estado nutricional en menores de 5 anos,clasificacion d,2001-09-01,20,29,20,29,49
70302,SAN MIGUEL DE VELASCO,estado nutricional en menores de 5 anos,clasificacion d,2001-09-01,1,166,1,166,167
51001,SAN PABLO DE LIPEZ,estado nutricional en menores de 5 anos,clasificacion d,2001-09-01,0,45,0,45,45
50501,SAN PEDRO DE BUENA VISTA,estado nutricional en menores de 5 anos,clasificacion d,2001-09-01,8,306,8,306,314
21801,SAN PEDRO DE CURAHUARA,estado nutricional en menores de 5 anos,clasificacion d,2001-09-01,0,11,0,11,11
50902,SAN PEDRO DE QUEMES,estado nutricional en menores de 5 anos,clasificacion d,2001-09-01,0,12,0,12,12
21702,SAN PEDRO DE TIQUINA,estado nutricional en menores de 5 anos,clasificacion d,2001-09-01,0,11,0,11,11
90202,SAN PEDRO(PND),estado nutricional en menores de 5 anos,clasificacion d,2001-09-01,1,0,1,0,1
70303,SAN RAFAEL,estado nutricional en menores de 5 anos,clasificacion d,2001-09-01,38,30,38,30,68
80702,SAN RAMON,estado nutricional en menores de 5 anos,clasificacion d,2001-09-01,8,10,8,10,18
80702,SAN RAMON,estado nutricional en menores de 5 anos,clasificacion d,2001-09-01,1,10,1,10,11
80401,SANTA ANA,estado nutricional en menores de 5 anos,clasificacion d,2001-09-01,0,31,0,31,31
70101,SANTA CRUZ DE LA SIERRA,estado nutricional en menores de 5 anos,clasificacion d,2001-09-01,290,283,290,283,573
80303,SANTA ROSA,estado nutricional en menores de 5 anos,clasificacion d,2001-09-01,13,10,13,10,23
70602,SANTA ROSA DEL SARA,estado nutricional en menores de 5 anos,clasificacion d,2001-09-01,14,29,14,29,43
20308,SANTIAGO DE CALLAPA,estado nutricional en menores de 5 anos,clasificacion d,2001-09-01,0,10,0,10,10
41401,SANTIAGO DE HUARI,estado nutricional en menores de 5 anos,clasificacion d,2001-09-01,12,16,12,16,28
21901,SANTIAGO DE MACHACA,estado nutricional en menores de 5 anos,clasificacion d,2001-09-01,1,19,1,19,20
30702,SANTIVAÃ‘ES,estado nutricional en menores de 5 anos,clasificacion d,2001-09-01,10,12,10,12,22
40202,SANTUARIO DE QUILLACAS,estado nutricional en menores de 5 anos,clasificacion d,2001-09-01,3,14,3,14,17
20902,SAPAHAQUI,estado nutricional en menores de 5 anos,clasificacion d,2001-09-01,0,21,0,21,21
90303,SENA,estado nutricional en menores de 5 anos,clasificacion d,2001-09-01,0,5,0,5,5
21301,SICA SICA (VILLA AROMA),estado nutricional en menores de 5 anos,clasificacion d,2001-09-01,22,26,22,26,48
30703,SICAYA,estado nutricional en menores de 5 anos,clasificacion d,2001-09-01,2,15,2,15,17
30902,SIPE SIPE,estado nutricional en menores de 5 anos,clasificacion d,2001-09-01,79,90,79,90,169
10403,SOPACHUY,estado nutricional en menores de 5 anos,clasificacion d,2001-09-01,5,38,5,38,43
20601,SORATA,estado nutricional en menores de 5 anos,clasificacion d,2001-09-01,0,81,0,81,81
10101,SUCRE,estado nutricional en menores de 5 anos,clasificacion d,2001-09-01,51,1171,51,1171,1222
31404,TACACHI,estado nutricional en menores de 5 anos,clasificacion d,2001-09-01,0,3,0,3,3
20603,TACACOMA,estado nutricional en menores de 5 anos,clasificacion d,2001-09-01,0,31,0,31,31
50303,TACOBAMBA,estado nutricional en menores de 5 anos,clasificacion d,2001-09-01,4,155,4,155,159
30602,TACOPAYA,estado nutricional en menores de 5 anos,clasificacion d,2001-09-01,6,35,6,35,41
51402,TAHUA,estado nutricional en menores de 5 anos,clasificacion d,2001-09-01,1,0,1,0,1
31101,TAPACARI,estado nutricional en menores de 5 anos,clasificacion d,2001-09-01,7,108,7,108,115
10601,TARABUCO,estado nutricional en menores de 5 anos,clasificacion d,2001-09-01,14,692,14,692,706
30401,TARATA,estado nutricional en menores de 5 anos,clasificacion d,2001-09-01,12,46,12,46,58
60101,TARIJA,estado nutricional en menores de 5 anos,clasificacion d,2001-09-01,59,209,59,209,268
10202,TARVITA,estado nutricional en menores de 5 anos,clasificacion d,2001-09-01,6,145,6,145,151
20803,TIAWANACU,estado nutricional en menores de 5 anos,clasificacion d,2001-09-01,11,25,11,25,36
50102,TINGUIPAYA,estado nutricional en menores de 5 anos,clasificacion d,2001-09-01,24,85,24,85,109
20606,TIPUANI,estado nutricional en menores de 5 anos,clasificacion d,2001-09-01,1,2,1,2,3
30903,TIQUIPAYA,estado nutricional en menores de 5 anos,clasificacion d,2001-09-01,2,11,2,11,13
31601,TIRAQUE (CBBA),estado nutricional en menores de 5 anos,clasificacion d,2001-09-01,59,121,59,121,180
21703,TITO YUPANQUI (PARQUIPUJIO),estado nutricional en menores de 5 anos,clasificacion d,2001-09-01,0,8,0,8,8
30802,TOCO,estado nutricional en menores de 5 anos,clasificacion d,2001-09-01,0,12,0,12,12
41001,TOLEDO,estado nutricional en menores de 5 anos,clasificacion d,2001-09-01,6,2,6,2,8
51202,TOMAVE,estado nutricional en menores de 5 anos,clasificacion d,2001-09-01,1,150,1,150,151
10402,TOMINA,estado nutricional en menores de 5 anos,clasificacion d,2001-09-01,6,252,6,252,258
50502,TORO TORO,estado nutricional en menores de 5 anos,clasificacion d,2001-09-01,3,49,3,49,52
31201,TOTORA(CBBA),estado nutricional en menores de 5 anos,clasificacion d,2001-09-01,24,27,24,27,51
41301,TOTORA(ORR),estado nutricional en menores de 5 anos,clasificacion d,2001-09-01,2,22,2,22,24
70802,TRIGAL,estado nutricional en menores de 5 anos,clasificacion d,2001-09-01,6,9,6,9,15
80101,TRINIDAD,estado nutricional en menores de 5 anos,clasificacion d,2001-09-01,28,176,28,176,204
50801,TUPIZA,estado nutricional en menores de 5 anos,clasificacion d,2001-09-01,6,235,6,235,241
40402,TURCO,estado nutricional en menores de 5 anos,clasificacion d,2001-09-01,7,2,7,2,9
21302,UMALA,estado nutricional en menores de 5 anos,clasificacion d,2001-09-01,3,27,3,27,30
50201,UNCIA,estado nutricional en menores de 5 anos,clasificacion d,2001-09-01,1,105,1,105,106
60401,URIONDO (A. CONCEPCION),estado nutricional en menores de 5 anos,clasificacion d,2001-09-01,4,35,4,35,39
71502,URUBICHA,estado nutricional en menores de 5 anos,clasificacion d,2001-09-01,1,168,1,168,169
51201,UYUNI,estado nutricional en menores de 5 anos,clasificacion d,2001-09-01,5,218,5,218,223
30502,VACAS,estado nutricional en menores de 5 anos,clasificacion d,2001-09-01,2,12,2,12,14
70801,VALLEGRANDE,estado nutricional en menores de 5 anos,clasificacion d,2001-09-01,14,51,14,51,65
20801,VIACHA,estado nutricional en menores de 5 anos,clasificacion d,2001-09-01,10,150,10,150,160
31302,VILA VILA,estado nutricional en menores de 5 anos,clasificacion d,2001-09-01,44,17,44,17,61
60303,VILLA MONTES,estado nutricional en menores de 5 anos,clasificacion d,2001-09-01,39,44,39,44,83
31402,VILLA RIVERO,estado nutricional en menores de 5 anos,clasificacion d,2001-09-01,0,13,0,13,13
10801,VILLA SERRANO,estado nutricional en menores de 5 anos,clasificacion d,2001-09-01,7,290,7,290,297
31003,VILLA TUNARI,estado nutricional en menores de 5 anos,clasificacion d,2001-09-01,65,67,65,67,132
11001,VILLA VACA GUZMAN (MUYUPAMPA),estado nutricional en menores de 5 anos,clasificacion d,2001-09-01,0,174,0,174,174
51501,VILLAZON,estado nutricional en menores de 5 anos,clasificacion d,2001-09-01,4,207,4,207,211
50602,VITICHI,estado nutricional en menores de 5 anos,clasificacion d,2001-09-01,6,119,6,119,125
20306,WALDO BALLIVIAN,estado nutricional en menores de 5 anos,clasificacion d,2001-09-01,0,5,0,5,5
70201,WARNES,estado nutricional en menores de 5 anos,clasificacion d,2001-09-01,56,97,56,97,153
20903,YACO,estado nutricional en menores de 5 anos,clasificacion d,2001-09-01,2,44,2,44,46
60301,YACUIBA,estado nutricional en menores de 5 anos,clasificacion d,2001-09-01,36,20,36,20,56
10602,YAMPARAEZ,estado nutricional en menores de 5 anos,clasificacion d,2001-09-01,6,391,6,391,397
21103,YANACACHI,estado nutricional en menores de 5 anos,clasificacion d,2001-09-01,2,5,2,5,7
70403,YAPACANI,estado nutricional en menores de 5 anos,clasificacion d,2001-09-01,53,113,53,113,166
50103,YOCALLA,estado nutricional en menores de 5 anos,clasificacion d,2001-09-01,0,100,0,100,100
10102,YOTALA,estado nutricional en menores de 5 anos,clasificacion d,2001-09-01,2,298,2,298,300
60402,YUNCHARA,estado nutricional en menores de 5 anos,clasificacion d,2001-09-01,9,9,9,9,18
10301,ZUDAÃ‘EZ,estado nutricional en menores de 5 anos,clasificacion d,2001-09-01,2,254,2,254,256
51302,ACACIO,estado nutricional en menores de 5 anos,clasificacion d,2001-10-01,1,114,1,114,115
20201,ACHACACHI,estado nutricional en menores de 5 anos,clasificacion d,2001-10-01,16,132,16,132,148
20104,ACHOCALLA,estado nutricional en menores de 5 anos,clasificacion d,2001-10-01,4,12,4,12,16
30201,AIQUILE,estado nutricional en menores de 5 anos,clasificacion d,2001-10-01,31,29,31,29,60
31303,ALALAY,estado nutricional en menores de 5 anos,clasificacion d,2001-10-01,12,10,12,10,22
10404,ALCALA,estado nutricional en menores de 5 anos,clasificacion d,2001-10-01,0,104,0,104,104
20202,ANCORAIMES,estado nutricional en menores de 5 anos,clasificacion d,2001-10-01,1,201,1,201,202
41201,ANDAMARCA,estado nutricional en menores de 5 anos,clasificacion d,2001-10-01,5,9,5,9,14
30402,ANZALDO,estado nutricional en menores de 5 anos,clasificacion d,2001-10-01,6,76,6,76,82
20701,APOLO,estado nutricional en menores de 5 anos,clasificacion d,2001-10-01,14,18,14,18,32
51301,ARAMPAMPA,estado nutricional en menores de 5 anos,clasificacion d,2001-10-01,1,51,1,51,52
30501,ARANI,estado nutricional en menores de 5 anos,clasificacion d,2001-10-01,37,100,37,100,137
30403,ARBIETO,estado nutricional en menores de 5 anos,clasificacion d,2001-10-01,0,18,0,18,18
30601,ARQUE,estado nutricional en menores de 5 anos,clasificacion d,2001-10-01,29,39,29,39,68
71501,ASCENCION DE GUARAYOS,estado nutricional en menores de 5 anos,clasificacion d,2001-10-01,163,259,163,259,422
50802,ATOCHA,estado nutricional en menores de 5 anos,clasificacion d,2001-10-01,2,74,2,74,76
20503,AUCAPATA,estado nutricional en menores de 5 anos,clasificacion d,2001-10-01,0,6,0,6,6
20502,AYATA,estado nutricional en menores de 5 anos,clasificacion d,2001-10-01,18,1,18,1,19
21303,AYO AYO,estado nutricional en menores de 5 anos,clasificacion d,2001-10-01,25,19,25,19,44
30301,AYOPAYA (V. DE INDEPENDENCIA),estado nutricional en menores de 5 anos,clasificacion d,2001-10-01,123,175,123,175,298
10201,AZURDUY,estado nutricional en menores de 5 anos,clasificacion d,2001-10-01,2,192,2,192,194
21203,BATALLAS,estado nutricional en menores de 5 anos,clasificacion d,2001-10-01,3,89,3,89,92
80802,BAURES,estado nutricional en menores de 5 anos,clasificacion d,2001-10-01,29,34,29,34,63
41202,BELEN DE ANDAMARCA,estado nutricional en menores de 5 anos,clasificacion d,2001-10-01,0,2,0,2,2
50104,BELEN DE URMIRI,estado nutricional en menores de 5 anos,clasificacion d,2001-10-01,0,36,0,36,36
90104,BELLA FLOR,estado nutricional en menores de 5 anos,clasificacion d,2001-10-01,4,7,4,7,11
60202,BERMEJO,estado nutricional en menores de 5 anos,clasificacion d,2001-10-01,0,26,0,26,26
50301,BETANZOS,estado nutricional en menores de 5 anos,clasificacion d,2001-10-01,5,232,5,232,237
31501,BOLIVAR,estado nutricional en menores de 5 anos,clasificacion d,2001-10-01,72,90,72,90,162
90103,BOLPEBRA,estado nutricional en menores de 5 anos,clasificacion d,2001-10-01,1,9,1,9,10
70707,BOYUIBE,estado nutricional en menores de 5 anos,clasificacion d,2001-10-01,4,46,4,46,50
70401,BUENA VISTA,estado nutricional en menores de 5 anos,clasificacion d,2001-10-01,50,59,50,59,109
70703,CABEZAS,estado nutricional en menores de 5 anos,clasificacion d,2001-10-01,1,82,1,82,83
20905,CAIROMA,estado nutricional en menores de 5 anos,clasificacion d,2001-10-01,0,5,0,5,5
51102,"CAIZA ""D""",estado nutricional en menores de 5 anos,clasificacion d,2001-10-01,8,161,8,161,169
21003,CAJUATA,estado nutricional en menores de 5 anos,clasificacion d,2001-10-01,7,4,7,4,11
20303,CALACOTO,estado nutricional en menores de 5 anos,clasificacion d,2001-10-01,2,1,2,1,3
21304,CALAMARCA,estado nutricional en menores de 5 anos,clasificacion d,2001-10-01,11,52,11,52,63
10701,CAMARGO,estado nutricional en menores de 5 anos,clasificacion d,2001-10-01,9,123,9,123,132
10901,CAMATAQUI (C. VILLA ABECIA),estado nutricional en menores de 5 anos,clasificacion d,2001-10-01,1,31,1,31,32
70706,CAMIRI,estado nutricional en menores de 5 anos,clasificacion d,2001-10-01,68,97,68,97,165
30701,CAPINOTA,estado nutricional en menores de 5 anos,clasificacion d,2001-10-01,49,59,49,59,108
20302,CAQUIAVIRI,estado nutricional en menores de 5 anos,clasificacion d,2001-10-01,26,22,26,22,48
40102,CARACOLLO,estado nutricional en menores de 5 anos,clasificacion d,2001-10-01,18,35,18,35,53
22001,CARANAVI,estado nutricional en menores de 5 anos,clasificacion d,2001-10-01,87,141,87,141,228
60302,CARAPARI,estado nutricional en menores de 5 anos,clasificacion d,2001-10-01,15,34,15,34,49
50702,CARIPUYO,estado nutricional en menores de 5 anos,clasificacion d,2001-10-01,4,162,4,162,166
21902,CATACORA,estado nutricional en menores de 5 anos,clasificacion d,2001-10-01,0,2,0,2,2
40201,CHALLAPATA,estado nutricional en menores de 5 anos,clasificacion d,2001-10-01,34,33,34,33,67
50302,CHAQUI,estado nutricional en menores de 5 anos,clasificacion d,2001-10-01,0,68,0,68,68
70702,CHARAGUA,estado nutricional en menores de 5 anos,clasificacion d,2001-10-01,8,273,8,273,281
20305,CHARAÃ‘A,estado nutricional en menores de 5 anos,clasificacion d,2001-10-01,0,26,0,26,26
50202,CHAYANTA,estado nutricional en menores de 5 anos,clasificacion d,2001-10-01,1,64,1,64,65
31204,CHIMORE,estado nutricional en menores de 5 anos,clasificacion d,2001-10-01,32,79,32,79,111
40302,CHOQUE COTA,estado nutricional en menores de 5 anos,clasificacion d,2001-10-01,0,10,0,10,10
21101,CHULUMANI (V. DE LA LIBERTAD),estado nutricional en menores de 5 anos,clasificacion d,2001-10-01,10,17,10,17,27
20501,CHUMA,estado nutricional en menores de 5 anos,clasificacion d,2001-10-01,19,35,19,35,54
30801,CLIZA,estado nutricional en menores de 5 anos,clasificacion d,2001-10-01,4,50,4,50,54
90101,COBIJA,estado nutricional en menores de 5 anos,clasificacion d,2001-10-01,87,74,87,74,161
30101,COCHABAMBA,estado nutricional en menores de 5 anos,clasificacion d,2001-10-01,291,426,291,426,717
40902,COIPASA,estado nutricional en menores de 5 anos,clasificacion d,2001-10-01,0,1,0,1,1
30905,COLCAPIRHUA,estado nutricional en menores de 5 anos,clasificacion d,2001-10-01,96,71,96,71,167
50901,"COLCHA ""K""",estado nutricional en menores de 5 anos,clasificacion d,2001-10-01,0,102,0,102,102
21307,COLLANA,estado nutricional en menores de 5 anos,clasificacion d,2001-10-01,2,0,2,0,2
31002,COLOMI,estado nutricional en menores de 5 anos,clasificacion d,2001-10-01,28,54,28,54,82
70603,COLPA BELGICA,estado nutricional en menores de 5 anos,clasificacion d,2001-10-01,7,6,7,6,13
50401,COLQUECHACA,estado nutricional en menores de 5 anos,clasificacion d,2001-10-01,4,184,4,184,188
21306,COLQUENCHA,estado nutricional en menores de 5 anos,clasificacion d,2001-10-01,13,36,13,36,49
21004,COLQUIRI,estado nutricional en menores de 5 anos,clasificacion d,2001-10-01,71,30,71,30,101
20304,COMANCHE,estado nutricional en menores de 5 anos,clasificacion d,2001-10-01,3,25,3,25,28
71301,COMARAPA,estado nutricional en menores de 5 anos,clasificacion d,2001-10-01,19,34,19,34,53
20605,COMBAYA,estado nutricional en menores de 5 anos,clasificacion d,2001-10-01,0,21,0,21,21
71101,CONCEPCION,estado nutricional en menores de 5 anos,clasificacion d,2001-10-01,48,28,48,28,76
21701,COPACABANA,estado nutricional en menores de 5 anos,clasificacion d,2001-10-01,1,49,1,49,50
21402,CORIPATA,estado nutricional en menores de 5 anos,clasificacion d,2001-10-01,1,2,1,2,3
20301,CORO CORO,estado nutricional en menores de 5 anos,clasificacion d,2001-10-01,35,33,35,33,68
21401,COROICO,estado nutricional en menores de 5 anos,clasificacion d,2001-10-01,14,14,14,14,28
40301,CORQUE,estado nutricional en menores de 5 anos,clasificacion d,2001-10-01,12,55,12,55,67
50601,COTAGAITA,estado nutricional en menores de 5 anos,clasificacion d,2001-10-01,8,159,8,159,167
70102,COTOCA,estado nutricional en menores de 5 anos,clasificacion d,2001-10-01,1,51,1,51,52
70704,CUEVO,estado nutricional en menores de 5 anos,clasificacion d,2001-10-01,18,44,18,44,62
10902,CULPINA,estado nutricional en menores de 5 anos,clasificacion d,2001-10-01,14,369,14,369,383
40401,CURAHUARA DE CARANGAS,estado nutricional en menores de 5 anos,clasificacion d,2001-10-01,9,3,9,3,12
21602,CURVA,estado nutricional en menores de 5 anos,clasificacion d,2001-10-01,5,2,5,2,7
20804,DESAGUADERO,estado nutricional en menores de 5 anos,clasificacion d,2001-10-01,2,28,2,28,30
20105,EL ALTO,estado nutricional en menores de 5 anos,clasificacion d,2001-10-01,1341,1582,1341,1582,2923
71503,EL PUENTE(STC),estado nutricional en menores de 5 anos,clasificacion d,2001-10-01,6,80,6,80,86
60502,EL PUENTE(TJA),estado nutricional en menores de 5 anos,clasificacion d,2001-10-01,17,50,17,50,67
70105,EL TORNO,estado nutricional en menores de 5 anos,clasificacion d,2001-10-01,4,155,4,155,159
10405,EL VILLAR,estado nutricional en menores de 5 anos,clasificacion d,2001-10-01,3,175,3,175,178
60601,ENTRE RIOS,estado nutricional en menores de 5 anos,clasificacion d,2001-10-01,14,58,14,58,72
41101,EUCALIPTUS,estado nutricional en menores de 5 anos,clasificacion d,2001-10-01,0,18,0,18,18
80402,EXALTACION,estado nutricional en menores de 5 anos,clasificacion d,2001-10-01,0,75,0,75,75
90203,FILADELFIA,estado nutricional en menores de 5 anos,clasificacion d,2001-10-01,0,11,0,11,11
71002,GENERAL SAAVEDRA,estado nutricional en menores de 5 anos,clasificacion d,2001-10-01,9,126,9,126,135
21601,GRAL. J.J. PEREZ (CHARAZANI),estado nutricional en menores de 5 anos,clasificacion d,2001-10-01,16,1,16,1,17
20602,GUANAY,estado nutricional en menores de 5 anos,clasificacion d,2001-10-01,22,201,22,201,223
20802,GUAQUI,estado nutricional en menores de 5 anos,clasificacion d,2001-10-01,3,10,3,10,13
80202,GUAYARAMERIN,estado nutricional en menores de 5 anos,clasificacion d,2001-10-01,106,121,106,121,227
70705,GUTIERREZ,estado nutricional en menores de 5 anos,clasificacion d,2001-10-01,40,136,40,136,176
10502,HUACARETA,estado nutricional en menores de 5 anos,clasificacion d,2001-10-01,4,194,4,194,198
40701,HUANUNI,estado nutricional en menores de 5 anos,clasificacion d,2001-10-01,1,11,1,11,12
80803,HUARACAJE,estado nutricional en menores de 5 anos,clasificacion d,2001-10-01,2,1,2,1,3
41601,HUAYLLAMARCA,estado nutricional en menores de 5 anos,clasificacion d,2001-10-01,0,17,0,17,17
21005,ICHOCA,estado nutricional en menores de 5 anos,clasificacion d,2001-10-01,0,3,0,3,3
10304,ICLA,estado nutricional en menores de 5 anos,clasificacion d,2001-10-01,60,219,60,219,279
10703,INCAHUASI,estado nutricional en menores de 5 anos,clasificacion d,2001-10-01,7,219,7,219,226
21001,INQUISIVI,estado nutricional en menores de 5 anos,clasificacion d,2001-10-01,3,82,3,82,85
21102,IRUPANA (VILLA DE LANZA),estado nutricional en menores de 5 anos,clasificacion d,2001-10-01,11,41,11,41,52
21501,IXIAMAS,estado nutricional en menores de 5 anos,clasificacion d,2001-10-01,25,46,25,46,71
21105,LA ASUNTA,estado nutricional en menores de 5 anos,clasificacion d,2001-10-01,21,82,21,82,103
70104,LA GUARDIA,estado nutricional en menores de 5 anos,clasificacion d,2001-10-01,4,130,4,130,134
20101,LA PAZ,estado nutricional en menores de 5 anos,clasificacion d,2001-10-01,869,1181,869,1181,2050
70701,LAGUNILLAS,estado nutricional en menores de 5 anos,clasificacion d,2001-10-01,12,46,12,46,58
21202,LAJA,estado nutricional en menores de 5 anos,clasificacion d,2001-10-01,2,98,2,98,100
10903,LAS CARRERAS,estado nutricional en menores de 5 anos,clasificacion d,2001-10-01,1,49,1,49,50
50203,LLALLAGUA,estado nutricional en menores de 5 anos,clasificacion d,2001-10-01,8,104,8,104,112
51401,LLICA,estado nutricional en menores de 5 anos,clasificacion d,2001-10-01,0,25,0,25,25
80601,LORETO,estado nutricional en menores de 5 anos,clasificacion d,2001-10-01,0,18,0,18,18
20901,LURIBAY,estado nutricional en menores de 5 anos,clasificacion d,2001-10-01,1,50,1,50,51
40702,MACHACAMARCA,estado nutricional en menores de 5 anos,clasificacion d,2001-10-01,5,13,5,13,18
11003,MACHARETI,estado nutricional en menores de 5 anos,clasificacion d,2001-10-01,2,131,2,131,133
80801,MAGDALENA,estado nutricional en menores de 5 anos,clasificacion d,2001-10-01,20,33,20,33,53
70903,MAIRANA,estado nutricional en menores de 5 anos,clasificacion d,2001-10-01,21,36,21,36,57
20103,MECAPACA,estado nutricional en menores de 5 anos,clasificacion d,2001-10-01,10,50,10,50,60
71003,MINEROS,estado nutricional en menores de 5 anos,clasificacion d,2001-10-01,4,165,4,165,169
31301,MIZQUE,estado nutricional en menores de 5 anos,clasificacion d,2001-10-01,57,78,57,78,135
20402,MOCOMOCO,estado nutricional en menores de 5 anos,clasificacion d,2001-10-01,33,41,33,41,74
51002,MOJINETE,estado nutricional en menores de 5 anos,clasificacion d,2001-10-01,0,4,0,4,4
10303,MOJOCOYA,estado nutricional en menores de 5 anos,clasificacion d,2001-10-01,3,218,3,218,221
10501,MONTEAGUDO,estado nutricional en menores de 5 anos,clasificacion d,2001-10-01,3,287,3,287,290
71001,MONTERO,estado nutricional en menores de 5 anos,clasificacion d,2001-10-01,35,523,35,523,558
70803,MORO MORO,estado nutricional en menores de 5 anos,clasificacion d,2001-10-01,9,6,9,6,15
30302,MOROCHATA,estado nutricional en menores de 5 anos,clasificacion d,2001-10-01,65,73,65,73,138
90401,NACEBE (SANTA ROSA DEL ABUNA),estado nutricional en menores de 5 anos,clasificacion d,2001-10-01,3,5,3,5,8
20307,NAZACARA DE PACAJES,estado nutricional en menores de 5 anos,clasificacion d,2001-10-01,1,3,1,3,4
90501,NUEVO MANOA (NUEVA ESPERANZA),estado nutricional en menores de 5 anos,clasificacion d,2001-10-01,0,3,0,3,3
50404,OCURI,estado nutricional en menores de 5 anos,clasificacion d,2001-10-01,34,118,34,118,152
70202,OKINAWA,estado nutricional en menores de 5 anos,clasificacion d,2001-10-01,2,32,2,32,34
30203,OMEREQUE,estado nutricional en menores de 5 anos,clasificacion d,2001-10-01,1,27,1,27,28
40101,ORURO,estado nutricional en menores de 5 anos,clasificacion d,2001-10-01,34,930,34,930,964
60201,PADCAYA,estado nutricional en menores de 5 anos,clasificacion d,2001-10-01,17,60,17,60,77
10401,PADILLA,estado nutricional en menores de 5 anos,clasificacion d,2001-10-01,5,393,5,393,398
70502,PAILON,estado nutricional en menores de 5 anos,clasificacion d,2001-10-01,5,52,5,52,57
20102,PALCA,estado nutricional en menores de 5 anos,clasificacion d,2001-10-01,44,29,44,29,73
21104,PALOS BLANCOS,estado nutricional en menores de 5 anos,clasificacion d,2001-10-01,41,66,41,66,107
40802,PAMPA AULLAGAS,estado nutricional en menores de 5 anos,clasificacion d,2001-10-01,13,25,13,25,38
70902,PAMPA GRANDE,estado nutricional en menores de 5 anos,clasificacion d,2001-10-01,11,14,11,14,25
21802,PAPEL PAMPA,estado nutricional en menores de 5 anos,clasificacion d,2001-10-01,0,4,0,4,4
30202,PASORAPA,estado nutricional en menores de 5 anos,clasificacion d,2001-10-01,1,35,1,35,36
21305,PATACAMAYA,estado nutricional en menores de 5 anos,clasificacion d,2001-10-01,29,18,29,18,47
40602,PAZÃ‘A,estado nutricional en menores de 5 anos,clasificacion d,2001-10-01,4,33,4,33,37
20702,PELECHUCO,estado nutricional en menores de 5 anos,clasificacion d,2001-10-01,0,22,0,22,22
50403,POCOATA,estado nutricional en menores de 5 anos,clasificacion d,2001-10-01,56,121,56,121,177
31203,POCONA,estado nutricional en menores de 5 anos,clasificacion d,2001-10-01,7,52,7,52,59
31202,POJO (CBBA),estado nutricional en menores de 5 anos,clasificacion d,2001-10-01,59,134,59,134,193
40601,POOPO,estado nutricional en menores de 5 anos,clasificacion d,2001-10-01,0,37,0,37,37
51203,PORCO,estado nutricional en menores de 5 anos,clasificacion d,2001-10-01,6,115,6,115,121
10103,POROMA,estado nutricional en menores de 5 anos,clasificacion d,2001-10-01,3,322,3,322,325
70103,PORONGO,estado nutricional en menores de 5 anos,clasificacion d,2001-10-01,1,49,1,49,50
70601,PORTACHUELO,estado nutricional en menores de 5 anos,clasificacion d,2001-10-01,34,64,34,64,98
90102,PORVENIR,estado nutricional en menores de 5 anos,clasificacion d,2001-10-01,2,37,2,37,39
70804,POSTRER VALLE,estado nutricional en menores de 5 anos,clasificacion d,2001-10-01,4,11,4,11,15
50101,POTOSI,estado nutricional en menores de 5 anos,clasificacion d,2001-10-01,38,788,38,788,826
10302,PRESTO,estado nutricional en menores de 5 anos,clasificacion d,2001-10-01,3,174,3,174,177
21201,PUCARANI,estado nutricional en menores de 5 anos,clasificacion d,2001-10-01,16,38,16,38,54
20401,PUERTO ACOSTA,estado nutricional en menores de 5 anos,clasificacion d,2001-10-01,81,124,81,124,205
20403,PUERTO CARABUCO,estado nutricional en menores de 5 anos,clasificacion d,2001-10-01,66,74,66,74,140
90301,PUERTO GONZALO MORENO,estado nutricional en menores de 5 anos,clasificacion d,2001-10-01,0,27,0,27,27
21204,PUERTO PEREZ,estado nutricional en menores de 5 anos,clasificacion d,2001-10-01,2,13,2,13,15
71402,PUERTO QUIJARRO,estado nutricional en menores de 5 anos,clasificacion d,2001-10-01,26,6,26,6,32
90201,PUERTO RICO,estado nutricional en menores de 5 anos,clasificacion d,2001-10-01,1,22,1,22,23
80703,PUERTO SILES,estado nutricional en menores de 5 anos,clasificacion d,2001-10-01,0,5,0,5,5
71401,PUERTO SUAREZ,estado nutricional en menores de 5 anos,clasificacion d,2001-10-01,69,21,69,21,90
31205,PUERTO VILLARROEL,estado nutricional en menores de 5 anos,clasificacion d,2001-10-01,116,96,116,96,212
51101,PUNA,estado nutricional en menores de 5 anos,clasificacion d,2001-10-01,8,239,8,239,247
31401,PUNATA,estado nutricional en menores de 5 anos,clasificacion d,2001-10-01,26,27,26,27,53
20604,QUIABAYA,estado nutricional en menores de 5 anos,clasificacion d,2001-10-01,0,44,0,44,44
30901,QUILLACOLLO,estado nutricional en menores de 5 anos,clasificacion d,2001-10-01,19,26,19,26,45
21002,QUIME,estado nutricional en menores de 5 anos,clasificacion d,2001-10-01,30,45,30,45,75
70904,QUIRUSILLAS,estado nutricional en menores de 5 anos,clasificacion d,2001-10-01,2,2,2,2,4
50402,RAVELO,estado nutricional en menores de 5 anos,clasificacion d,2001-10-01,25,289,25,289,314
80301,REYES,estado nutricional en menores de 5 anos,clasificacion d,2001-10-01,13,28,13,28,41
80201,RIBERALTA,estado nutricional en menores de 5 anos,clasificacion d,2001-10-01,187,431,187,431,618
70503,ROBORE,estado nutricional en menores de 5 anos,clasificacion d,2001-10-01,0,63,0,63,63
80304,RURRENABAQUE,estado nutricional en menores de 5 anos,clasificacion d,2001-10-01,19,14,19,14,33
40901,SABAYA,estado nutricional en menores de 5 anos,clasificacion d,2001-10-01,1,7,1,7,8
31001,SACABA,estado nutricional en menores de 5 anos,clasificacion d,2001-10-01,86,65,86,65,151
30404,SACABAMBA,estado nutricional en menores de 5 anos,clasificacion d,2001-10-01,8,78,8,78,86
50701,SACACA,estado nutricional en menores de 5 anos,clasificacion d,2001-10-01,2,226,2,226,228
71302,SAIPINA,estado nutricional en menores de 5 anos,clasificacion d,2001-10-01,13,17,13,17,30
40801,SALINAS DE GARCI MENDOZA,estado nutricional en menores de 5 anos,clasificacion d,2001-10-01,6,9,6,9,15
70901,SAMAIPATA,estado nutricional en menores de 5 anos,clasificacion d,2001-10-01,31,18,31,18,49
51601,SAN AGUSTIN,estado nutricional en menores de 5 anos,clasificacion d,2001-10-01,0,19,0,19,19
80602,SAN ANDRES,estado nutricional en menores de 5 anos,clasificacion d,2001-10-01,0,27,0,27,27
51003,SAN ANTONIO DE ESMORUCO,estado nutricional en menores de 5 anos,clasificacion d,2001-10-01,0,3,0,3,3
71105,SAN ANTONIO DE LOMERIO,estado nutricional en menores de 5 anos,clasificacion d,2001-10-01,97,143,97,143,240
31403,SAN BENITO,estado nutricional en menores de 5 anos,clasificacion d,2001-10-01,0,22,0,22,22
80302,SAN BORJA,estado nutricional en menores de 5 anos,clasificacion d,2001-10-01,80,56,80,56,136
21502,SAN BUENA VENTURA,estado nutricional en menores de 5 anos,clasificacion d,2001-10-01,35,49,35,49,84
70402,SAN CARLOS,estado nutricional en menores de 5 anos,clasificacion d,2001-10-01,0,52,0,52,52
80501,SAN IGNACIO,estado nutricional en menores de 5 anos,clasificacion d,2001-10-01,30,130,30,130,160
70301,SAN IGNACIO DE VELASCO,estado nutricional en menores de 5 anos,clasificacion d,2001-10-01,199,254,199,254,453
80102,SAN JAVIER(BNI),estado nutricional en menores de 5 anos,clasificacion d,2001-10-01,0,37,0,37,37
71102,SAN JAVIER(STC),estado nutricional en menores de 5 anos,clasificacion d,2001-10-01,70,62,70,62,132
80701,SAN JOAQUIN,estado nutricional en menores de 5 anos,clasificacion d,2001-10-01,2,17,2,17,19
70501,SAN JOSE DE CHIQUITOS,estado nutricional en menores de 5 anos,clasificacion d,2001-10-01,62,14,62,14,76
71104,SAN JULIAN,estado nutricional en menores de 5 anos,clasificacion d,2001-10-01,64,187,64,187,251
90302,SAN LORENZO(PND),estado nutricional en menores de 5 anos,clasificacion d,2001-10-01,1,12,1,12,13
60501,SAN LORENZO(TJA),estado nutricional en menores de 5 anos,clasificacion d,2001-10-01,5,58,5,58,63
10702,SAN LUCAS,estado nutricional en menores de 5 anos,clasificacion d,2001-10-01,10,602,10,602,612
71201,SAN MATIAS,estado nutricional en menores de 5 anos,clasificacion d,2001-10-01,58,53,58,53,111
70302,SAN MIGUEL DE VELASCO,estado nutricional en menores de 5 anos,clasificacion d,2001-10-01,39,69,39,69,108
51001,SAN PABLO DE LIPEZ,estado nutricional en menores de 5 anos,clasificacion d,2001-10-01,2,19,2,19,21
50501,SAN PEDRO DE BUENA VISTA,estado nutricional en menores de 5 anos,clasificacion d,2001-10-01,1,187,1,187,188
21801,SAN PEDRO DE CURAHUARA,estado nutricional en menores de 5 anos,clasificacion d,2001-10-01,3,23,3,23,26
50902,SAN PEDRO DE QUEMES,estado nutricional en menores de 5 anos,clasificacion d,2001-10-01,0,11,0,11,11
21702,SAN PEDRO DE TIQUINA,estado nutricional en menores de 5 anos,clasificacion d,2001-10-01,0,16,0,16,16
90202,SAN PEDRO(PND),estado nutricional en menores de 5 anos,clasificacion d,2001-10-01,3,7,3,7,10
70303,SAN RAFAEL,estado nutricional en menores de 5 anos,clasificacion d,2001-10-01,30,28,30,28,58
80702,SAN RAMON,estado nutricional en menores de 5 anos,clasificacion d,2001-10-01,0,33,0,33,33
80401,SANTA ANA,estado nutricional en menores de 5 anos,clasificacion d,2001-10-01,17,38,17,38,55
70101,SANTA CRUZ DE LA SIERRA,estado nutricional en menores de 5 anos,clasificacion d,2001-10-01,214,330,214,330,544
80303,SANTA ROSA,estado nutricional en menores de 5 anos,clasificacion d,2001-10-01,13,16,13,16,29
70602,SANTA ROSA DEL SARA,estado nutricional en menores de 5 anos,clasificacion d,2001-10-01,11,11,11,11,22
20308,SANTIAGO DE CALLAPA,estado nutricional en menores de 5 anos,clasificacion d,2001-10-01,0,19,0,19,19
41401,SANTIAGO DE HUARI,estado nutricional en menores de 5 anos,clasificacion d,2001-10-01,21,28,21,28,49
21901,SANTIAGO DE MACHACA,estado nutricional en menores de 5 anos,clasificacion d,2001-10-01,10,20,10,20,30
30702,SANTIVAÃ‘ES,estado nutricional en menores de 5 anos,clasificacion d,2001-10-01,27,40,27,40,67
40202,SANTUARIO DE QUILLACAS,estado nutricional en menores de 5 anos,clasificacion d,2001-10-01,4,25,4,25,29
20902,SAPAHAQUI,estado nutricional en menores de 5 anos,clasificacion d,2001-10-01,4,37,4,37,41
90303,SENA,estado nutricional en menores de 5 anos,clasificacion d,2001-10-01,1,7,1,7,8
21301,SICA SICA (VILLA AROMA),estado nutricional en menores de 5 anos,clasificacion d,2001-10-01,9,33,9,33,42
30703,SICAYA,estado nutricional en menores de 5 anos,clasificacion d,2001-10-01,2,22,2,22,24
30902,SIPE SIPE,estado nutricional en menores de 5 anos,clasificacion d,2001-10-01,131,95,131,95,226
10403,SOPACHUY,estado nutricional en menores de 5 anos,clasificacion d,2001-10-01,6,112,6,112,118
20601,SORATA,estado nutricional en menores de 5 anos,clasificacion d,2001-10-01,3,85,3,85,88
10101,SUCRE,estado nutricional en menores de 5 anos,clasificacion d,2001-10-01,56,1253,56,1253,1309
31404,TACACHI,estado nutricional en menores de 5 anos,clasificacion d,2001-10-01,0,16,0,16,16
20603,TACACOMA,estado nutricional en menores de 5 anos,clasificacion d,2001-10-01,17,70,17,70,87
50303,TACOBAMBA,estado nutricional en menores de 5 anos,clasificacion d,2001-10-01,3,143,3,143,146
30602,TACOPAYA,estado nutricional en menores de 5 anos,clasificacion d,2001-10-01,9,88,9,88,97
51402,TAHUA,estado nutricional en menores de 5 anos,clasificacion d,2001-10-01,1,4,1,4,5
31101,TAPACARI,estado nutricional en menores de 5 anos,clasificacion d,2001-10-01,6,145,6,145,151
10601,TARABUCO,estado nutricional en menores de 5 anos,clasificacion d,2001-10-01,14,869,14,869,883
30401,TARATA,estado nutricional en menores de 5 anos,clasificacion d,2001-10-01,6,42,6,42,48
60101,TARIJA,estado nutricional en menores de 5 anos,clasificacion d,2001-10-01,65,299,65,299,364
10202,TARVITA,estado nutricional en menores de 5 anos,clasificacion d,2001-10-01,5,176,5,176,181
20803,TIAWANACU,estado nutricional en menores de 5 anos,clasificacion d,2001-10-01,26,18,26,18,44
50102,TINGUIPAYA,estado nutricional en menores de 5 anos,clasificacion d,2001-10-01,25,121,25,121,146
20606,TIPUANI,estado nutricional en menores de 5 anos,clasificacion d,2001-10-01,19,11,19,11,30
30903,TIQUIPAYA,estado nutricional en menores de 5 anos,clasificacion d,2001-10-01,0,18,0,18,18
31601,TIRAQUE (CBBA),estado nutricional en menores de 5 anos,clasificacion d,2001-10-01,50,79,50,79,129
21703,TITO YUPANQUI (PARQUIPUJIO),estado nutricional en menores de 5 anos,clasificacion d,2001-10-01,6,13,6,13,19
30802,TOCO,estado nutricional en menores de 5 anos,clasificacion d,2001-10-01,1,20,1,20,21
41502,TODOS SANTOS,estado nutricional en menores de 5 anos,clasificacion d,2001-10-01,0,2,0,2,2
30803,TOLATA,estado nutricional en menores de 5 anos,clasificacion d,2001-10-01,0,2,0,2,2
41001,TOLEDO,estado nutricional en menores de 5 anos,clasificacion d,2001-10-01,9,13,9,13,22
51202,TOMAVE,estado nutricional en menores de 5 anos,clasificacion d,2001-10-01,10,150,10,150,160
10402,TOMINA,estado nutricional en menores de 5 anos,clasificacion d,2001-10-01,6,303,6,303,309
50502,TORO TORO,estado nutricional en menores de 5 anos,clasificacion d,2001-10-01,1,37,1,37,38
31201,TOTORA(CBBA),estado nutricional en menores de 5 anos,clasificacion d,2001-10-01,57,45,57,45,102
41301,TOTORA(ORR),estado nutricional en menores de 5 anos,clasificacion d,2001-10-01,0,31,0,31,31
70802,TRIGAL,estado nutricional en menores de 5 anos,clasificacion d,2001-10-01,6,4,6,4,10
80101,TRINIDAD,estado nutricional en menores de 5 anos,clasificacion d,2001-10-01,28,209,28,209,237
50801,TUPIZA,estado nutricional en menores de 5 anos,clasificacion d,2001-10-01,12,345,12,345,357
40402,TURCO,estado nutricional en menores de 5 anos,clasificacion d,2001-10-01,11,21,11,21,32
21302,UMALA,estado nutricional en menores de 5 anos,clasificacion d,2001-10-01,1,77,1,77,78
50201,UNCIA,estado nutricional en menores de 5 anos,clasificacion d,2001-10-01,0,56,0,56,56
60401,URIONDO (A. CONCEPCION),estado nutricional en menores de 5 anos,clasificacion d,2001-10-01,0,30,0,30,30
71502,URUBICHA,estado nutricional en menores de 5 anos,clasificacion d,2001-10-01,77,125,77,125,202
51201,UYUNI,estado nutricional en menores de 5 anos,clasificacion d,2001-10-01,6,132,6,132,138
30502,VACAS,estado nutricional en menores de 5 anos,clasificacion d,2001-10-01,5,29,5,29,34
70801,VALLEGRANDE,estado nutricional en menores de 5 anos,clasificacion d,2001-10-01,36,91,36,91,127
20801,VIACHA,estado nutricional en menores de 5 anos,clasificacion d,2001-10-01,8,169,8,169,177
31302,VILA VILA,estado nutricional en menores de 5 anos,clasificacion d,2001-10-01,0,39,0,39,39
60303,VILLA MONTES,estado nutricional en menores de 5 anos,clasificacion d,2001-10-01,43,55,43,55,98
90502,VILLA NUEVA (LOMA ALTA),estado nutricional en menores de 5 anos,clasificacion d,2001-10-01,0,1,0,1,1
31402,VILLA RIVERO,estado nutricional en menores de 5 anos,clasificacion d,2001-10-01,2,30,2,30,32
10801,VILLA SERRANO,estado nutricional en menores de 5 anos,clasificacion d,2001-10-01,2,326,2,326,328
31003,VILLA TUNARI,estado nutricional en menores de 5 anos,clasificacion d,2001-10-01,73,123,73,123,196
11001,VILLA VACA GUZMAN (MUYUPAMPA),estado nutricional en menores de 5 anos,clasificacion d,2001-10-01,2,230,2,230,232
51501,VILLAZON,estado nutricional en menores de 5 anos,clasificacion d,2001-10-01,5,229,5,229,234
30904,VINTO,estado nutricional en menores de 5 anos,clasificacion d,2001-10-01,58,24,58,24,82
50602,VITICHI,estado nutricional en menores de 5 anos,clasificacion d,2001-10-01,8,152,8,152,160
70201,WARNES,estado nutricional en menores de 5 anos,clasificacion d,2001-10-01,96,154,96,154,250
20903,YACO,estado nutricional en menores de 5 anos,clasificacion d,2001-10-01,3,25,3,25,28
60301,YACUIBA,estado nutricional en menores de 5 anos,clasificacion d,2001-10-01,50,20,50,20,70
10602,YAMPARAEZ,estado nutricional en menores de 5 anos,clasificacion d,2001-10-01,3,408,3,408,411
21103,YANACACHI,estado nutricional en menores de 5 anos,clasificacion d,2001-10-01,1,3,1,3,4
70403,YAPACANI,estado nutricional en menores de 5 anos,clasificacion d,2001-10-01,47,144,47,144,191
50103,YOCALLA,estado nutricional en menores de 5 anos,clasificacion d,2001-10-01,2,107,2,107,109
10102,YOTALA,estado nutricional en menores de 5 anos,clasificacion d,2001-10-01,4,293,4,293,297
60402,YUNCHARA,estado nutricional en menores de 5 anos,clasificacion d,2001-10-01,11,18,11,18,29
10301,ZUDAÃ‘EZ,estado nutricional en menores de 5 anos,clasificacion d,2001-10-01,5,223,5,223,228
51302,ACACIO,estado nutricional en menores de 5 anos,clasificacion d,2001-11-01,7,196,7,196,203
20201,ACHACACHI,estado nutricional en menores de 5 anos,clasificacion d,2001-11-01,23,251,23,251,274
20104,ACHOCALLA,estado nutricional en menores de 5 anos,clasificacion d,2001-11-01,24,21,24,21,45
30201,AIQUILE,estado nutricional en menores de 5 anos,clasificacion d,2001-11-01,3,1,3,1,4
31303,ALALAY,estado nutricional en menores de 5 anos,clasificacion d,2001-11-01,6,14,6,14,20
10404,ALCALA,estado nutricional en menores de 5 anos,clasificacion d,2001-11-01,1,105,1,105,106
20202,ANCORAIMES,estado nutricional en menores de 5 anos,clasificacion d,2001-11-01,2,163,2,163,165
41201,ANDAMARCA,estado nutricional en menores de 5 anos,clasificacion d,2001-11-01,7,4,7,4,11
30402,ANZALDO,estado nutricional en menores de 5 anos,clasificacion d,2001-11-01,7,77,7,77,84
20701,APOLO,estado nutricional en menores de 5 anos,clasificacion d,2001-11-01,25,13,25,13,38
51301,ARAMPAMPA,estado nutricional en menores de 5 anos,clasificacion d,2001-11-01,1,135,1,135,136
30501,ARANI,estado nutricional en menores de 5 anos,clasificacion d,2001-11-01,24,75,24,75,99
30403,ARBIETO,estado nutricional en menores de 5 anos,clasificacion d,2001-11-01,0,12,0,12,12
30601,ARQUE,estado nutricional en menores de 5 anos,clasificacion d,2001-11-01,67,100,67,100,167
71501,ASCENCION DE GUARAYOS,estado nutricional en menores de 5 anos,clasificacion d,2001-11-01,0,26,0,26,26
50802,ATOCHA,estado nutricional en menores de 5 anos,clasificacion d,2001-11-01,5,72,5,72,77
20503,AUCAPATA,estado nutricional en menores de 5 anos,clasificacion d,2001-11-01,2,3,2,3,5
20502,AYATA,estado nutricional en menores de 5 anos,clasificacion d,2001-11-01,1,5,1,5,6
21303,AYO AYO,estado nutricional en menores de 5 anos,clasificacion d,2001-11-01,30,8,30,8,38
30301,AYOPAYA (V. DE INDEPENDENCIA),estado nutricional en menores de 5 anos,clasificacion d,2001-11-01,99,167,99,167,266
10201,AZURDUY,estado nutricional en menores de 5 anos,clasificacion d,2001-11-01,2,176,2,176,178
21203,BATALLAS,estado nutricional en menores de 5 anos,clasificacion d,2001-11-01,3,95,3,95,98
80802,BAURES,estado nutricional en menores de 5 anos,clasificacion d,2001-11-01,16,5,16,5,21
41202,BELEN DE ANDAMARCA,estado nutricional en menores de 5 anos,clasificacion d,2001-11-01,0,2,0,2,2
50104,BELEN DE URMIRI,estado nutricional en menores de 5 anos,clasificacion d,2001-11-01,0,62,0,62,62
90104,BELLA FLOR,estado nutricional en menores de 5 anos,clasificacion d,2001-11-01,1,8,1,8,9
60202,BERMEJO,estado nutricional en menores de 5 anos,clasificacion d,2001-11-01,1,16,1,16,17
50301,BETANZOS,estado nutricional en menores de 5 anos,clasificacion d,2001-11-01,16,690,16,690,706
31501,BOLIVAR,estado nutricional en menores de 5 anos,clasificacion d,2001-11-01,52,69,52,69,121
90103,BOLPEBRA,estado nutricional en menores de 5 anos,clasificacion d,2001-11-01,1,13,1,13,14
70707,BOYUIBE,estado nutricional en menores de 5 anos,clasificacion d,2001-11-01,1,47,1,47,48
70401,BUENA VISTA,estado nutricional en menores de 5 anos,clasificacion d,2001-11-01,47,63,47,63,110
70703,CABEZAS,estado nutricional en menores de 5 anos,clasificacion d,2001-11-01,2,93,2,93,95
20905,CAIROMA,estado nutricional en menores de 5 anos,clasificacion d,2001-11-01,0,19,0,19,19
51102,"CAIZA ""D""",estado nutricional en menores de 5 anos,clasificacion d,2001-11-01,10,17,10,17,27
21003,CAJUATA,estado nutricional en menores de 5 anos,clasificacion d,2001-11-01,20,11,20,11,31
20303,CALACOTO,estado nutricional en menores de 5 anos,clasificacion d,2001-11-01,3,0,3,0,3
21304,CALAMARCA,estado nutricional en menores de 5 anos,clasificacion d,2001-11-01,1,51,1,51,52
10701,CAMARGO,estado nutricional en menores de 5 anos,clasificacion d,2001-11-01,12,100,12,100,112
10901,CAMATAQUI (C. VILLA ABECIA),estado nutricional en menores de 5 anos,clasificacion d,2001-11-01,0,56,0,56,56
70706,CAMIRI,estado nutricional en menores de 5 anos,clasificacion d,2001-11-01,56,78,56,78,134
30701,CAPINOTA,estado nutricional en menores de 5 anos,clasificacion d,2001-11-01,50,42,50,42,92
20302,CAQUIAVIRI,estado nutricional en menores de 5 anos,clasificacion d,2001-11-01,19,23,19,23,42
40102,CARACOLLO,estado nutricional en menores de 5 anos,clasificacion d,2001-11-01,20,36,20,36,56
22001,CARANAVI,estado nutricional en menores de 5 anos,clasificacion d,2001-11-01,78,148,78,148,226
41503,CARANGAS,estado nutricional en menores de 5 anos,clasificacion d,2001-11-01,0,3,0,3,3
60302,CARAPARI,estado nutricional en menores de 5 anos,clasificacion d,2001-11-01,17,53,17,53,70
50702,CARIPUYO,estado nutricional en menores de 5 anos,clasificacion d,2001-11-01,5,198,5,198,203
21902,CATACORA,estado nutricional en menores de 5 anos,clasificacion d,2001-11-01,0,5,0,5,5
21803,CHACARILLA,estado nutricional en menores de 5 anos,clasificacion d,2001-11-01,0,3,0,3,3
40201,CHALLAPATA,estado nutricional en menores de 5 anos,clasificacion d,2001-11-01,46,38,46,38,84
50302,CHAQUI,estado nutricional en menores de 5 anos,clasificacion d,2001-11-01,0,87,0,87,87
70702,CHARAGUA,estado nutricional en menores de 5 anos,clasificacion d,2001-11-01,4,250,4,250,254
20305,CHARAÃ‘A,estado nutricional en menores de 5 anos,clasificacion d,2001-11-01,0,16,0,16,16
50202,CHAYANTA,estado nutricional en menores de 5 anos,clasificacion d,2001-11-01,0,181,0,181,181
31204,CHIMORE,estado nutricional en menores de 5 anos,clasificacion d,2001-11-01,22,51,22,51,73
40903,CHIPAYA,estado nutricional en menores de 5 anos,clasificacion d,2001-11-01,0,3,0,3,3
40302,CHOQUE COTA,estado nutricional en menores de 5 anos,clasificacion d,2001-11-01,0,4,0,4,4
21101,CHULUMANI (V. DE LA LIBERTAD),estado nutricional en menores de 5 anos,clasificacion d,2001-11-01,1,20,1,20,21
20501,CHUMA,estado nutricional en menores de 5 anos,clasificacion d,2001-11-01,34,22,34,22,56
30801,CLIZA,estado nutricional en menores de 5 anos,clasificacion d,2001-11-01,2,27,2,27,29
90101,COBIJA,estado nutricional en menores de 5 anos,clasificacion d,2001-11-01,93,69,93,69,162
30101,COCHABAMBA,estado nutricional en menores de 5 anos,clasificacion d,2001-11-01,345,342,345,342,687
30905,COLCAPIRHUA,estado nutricional en menores de 5 anos,clasificacion d,2001-11-01,72,76,72,76,148
50901,"COLCHA ""K""",estado nutricional en menores de 5 anos,clasificacion d,2001-11-01,1,159,1,159,160
21307,COLLANA,estado nutricional en menores de 5 anos,clasificacion d,2001-11-01,2,0,2,0,2
31002,COLOMI,estado nutricional en menores de 5 anos,clasificacion d,2001-11-01,48,130,48,130,178
70603,COLPA BELGICA,estado nutricional en menores de 5 anos,clasificacion d,2001-11-01,8,4,8,4,12
50401,COLQUECHACA,estado nutricional en menores de 5 anos,clasificacion d,2001-11-01,27,116,27,116,143
21306,COLQUENCHA,estado nutricional en menores de 5 anos,clasificacion d,2001-11-01,25,26,25,26,51
21004,COLQUIRI,estado nutricional en menores de 5 anos,clasificacion d,2001-11-01,47,57,47,57,104
20304,COMANCHE,estado nutricional en menores de 5 anos,clasificacion d,2001-11-01,6,22,6,22,28
71301,COMARAPA,estado nutricional en menores de 5 anos,clasificacion d,2001-11-01,40,28,40,28,68
20605,COMBAYA,estado nutricional en menores de 5 anos,clasificacion d,2001-11-01,0,19,0,19,19
71101,CONCEPCION,estado nutricional en menores de 5 anos,clasificacion d,2001-11-01,7,16,7,16,23
21701,COPACABANA,estado nutricional en menores de 5 anos,clasificacion d,2001-11-01,12,53,12,53,65
21402,CORIPATA,estado nutricional en menores de 5 anos,clasificacion d,2001-11-01,1,15,1,15,16
21401,COROICO,estado nutricional en menores de 5 anos,clasificacion d,2001-11-01,35,20,35,20,55
40301,CORQUE,estado nutricional en menores de 5 anos,clasificacion d,2001-11-01,21,14,21,14,35
50601,COTAGAITA,estado nutricional en menores de 5 anos,clasificacion d,2001-11-01,1,191,1,191,192
70102,COTOCA,estado nutricional en menores de 5 anos,clasificacion d,2001-11-01,3,34,3,34,37
70704,CUEVO,estado nutricional en menores de 5 anos,clasificacion d,2001-11-01,16,37,16,37,53
10902,CULPINA,estado nutricional en menores de 5 anos,clasificacion d,2001-11-01,2,425,2,425,427
40401,CURAHUARA DE CARANGAS,estado nutricional en menores de 5 anos,clasificacion d,2001-11-01,20,10,20,10,30
20804,DESAGUADERO,estado nutricional en menores de 5 anos,clasificacion d,2001-11-01,4,18,4,18,22
20105,EL ALTO,estado nutricional en menores de 5 anos,clasificacion d,2001-11-01,1407,1654,1407,1654,3061
40103,EL CHORO,estado nutricional en menores de 5 anos,clasificacion d,2001-11-01,2,1,2,1,3
71503,EL PUENTE(STC),estado nutricional en menores de 5 anos,clasificacion d,2001-11-01,12,90,12,90,102
60502,EL PUENTE(TJA),estado nutricional en menores de 5 anos,clasificacion d,2001-11-01,15,53,15,53,68
70105,EL TORNO,estado nutricional en menores de 5 anos,clasificacion d,2001-11-01,4,139,4,139,143
10405,EL VILLAR,estado nutricional en menores de 5 anos,clasificacion d,2001-11-01,0,181,0,181,181
60601,ENTRE RIOS,estado nutricional en menores de 5 anos,clasificacion d,2001-11-01,24,93,24,93,117
41101,EUCALIPTUS,estado nutricional en menores de 5 anos,clasificacion d,2001-11-01,3,39,3,39,42
90503,EUREKA (SANTOS MERCADO),estado nutricional en menores de 5 anos,clasificacion d,2001-11-01,0,1,0,1,1
80402,EXALTACION,estado nutricional en menores de 5 anos,clasificacion d,2001-11-01,0,27,0,27,27
90203,FILADELFIA,estado nutricional en menores de 5 anos,clasificacion d,2001-11-01,0,8,0,8,8
71002,GENERAL SAAVEDRA,estado nutricional en menores de 5 anos,clasificacion d,2001-11-01,1,183,1,183,184
21601,GRAL. J.J. PEREZ (CHARAZANI),estado nutricional en menores de 5 anos,clasificacion d,2001-11-01,6,27,6,27,33
20602,GUANAY,estado nutricional en menores de 5 anos,clasificacion d,2001-11-01,18,65,18,65,83
20802,GUAQUI,estado nutricional en menores de 5 anos,clasificacion d,2001-11-01,2,18,2,18,20
80202,GUAYARAMERIN,estado nutricional en menores de 5 anos,clasificacion d,2001-11-01,124,106,124,106,230
70705,GUTIERREZ,estado nutricional en menores de 5 anos,clasificacion d,2001-11-01,13,112,13,112,125
10502,HUACARETA,estado nutricional en menores de 5 anos,clasificacion d,2001-11-01,2,215,2,215,217
11002,HUACAYA (VILLA DE HUACAYA),estado nutricional en menores de 5 anos,clasificacion d,2001-11-01,0,13,0,13,13
40501,HUACHACALLA,estado nutricional en menores de 5 anos,clasificacion d,2001-11-01,1,10,1,10,11
40701,HUANUNI,estado nutricional en menores de 5 anos,clasificacion d,2001-11-01,1,1,1,1,2
80803,HUARACAJE,estado nutricional en menores de 5 anos,clasificacion d,2001-11-01,3,4,3,4,7
41601,HUAYLLAMARCA,estado nutricional en menores de 5 anos,clasificacion d,2001-11-01,9,36,9,36,45
21005,ICHOCA,estado nutricional en menores de 5 anos,clasificacion d,2001-11-01,1,23,1,23,24
10304,ICLA,estado nutricional en menores de 5 anos,clasificacion d,2001-11-01,130,259,130,259,389
10703,INCAHUASI,estado nutricional en menores de 5 anos,clasificacion d,2001-11-01,4,190,4,190,194
21001,INQUISIVI,estado nutricional en menores de 5 anos,clasificacion d,2001-11-01,1,71,1,71,72
21102,IRUPANA (VILLA DE LANZA),estado nutricional en menores de 5 anos,clasificacion d,2001-11-01,5,47,5,47,52
21501,IXIAMAS,estado nutricional en menores de 5 anos,clasificacion d,2001-11-01,29,48,29,48,77
21105,LA ASUNTA,estado nutricional en menores de 5 anos,clasificacion d,2001-11-01,41,69,41,69,110
70104,LA GUARDIA,estado nutricional en menores de 5 anos,clasificacion d,2001-11-01,2,109,2,109,111
20101,LA PAZ,estado nutricional en menores de 5 anos,clasificacion d,2001-11-01,828,1113,828,1113,1941
70701,LAGUNILLAS,estado nutricional en menores de 5 anos,clasificacion d,2001-11-01,35,73,35,73,108
21202,LAJA,estado nutricional en menores de 5 anos,clasificacion d,2001-11-01,3,93,3,93,96
10903,LAS CARRERAS,estado nutricional en menores de 5 anos,clasificacion d,2001-11-01,2,68,2,68,70
50203,LLALLAGUA,estado nutricional en menores de 5 anos,clasificacion d,2001-11-01,7,206,7,206,213
51401,LLICA,estado nutricional en menores de 5 anos,clasificacion d,2001-11-01,1,37,1,37,38
80601,LORETO,estado nutricional en menores de 5 anos,clasificacion d,2001-11-01,0,7,0,7,7
20901,LURIBAY,estado nutricional en menores de 5 anos,clasificacion d,2001-11-01,3,42,3,42,45
40702,MACHACAMARCA,estado nutricional en menores de 5 anos,clasificacion d,2001-11-01,5,5,5,5,10
11003,MACHARETI,estado nutricional en menores de 5 anos,clasificacion d,2001-11-01,8,154,8,154,162
80801,MAGDALENA,estado nutricional en menores de 5 anos,clasificacion d,2001-11-01,10,15,10,15,25
70903,MAIRANA,estado nutricional en menores de 5 anos,clasificacion d,2001-11-01,22,35,22,35,57
20103,MECAPACA,estado nutricional en menores de 5 anos,clasificacion d,2001-11-01,2,49,2,49,51
71003,MINEROS,estado nutricional en menores de 5 anos,clasificacion d,2001-11-01,5,153,5,153,158
31301,MIZQUE,estado nutricional en menores de 5 anos,clasificacion d,2001-11-01,14,40,14,40,54
20402,MOCOMOCO,estado nutricional en menores de 5 anos,clasificacion d,2001-11-01,34,54,34,54,88
51002,MOJINETE,estado nutricional en menores de 5 anos,clasificacion d,2001-11-01,0,16,0,16,16
10303,MOJOCOYA,estado nutricional en menores de 5 anos,clasificacion d,2001-11-01,0,85,0,85,85
10501,MONTEAGUDO,estado nutricional en menores de 5 anos,clasificacion d,2001-11-01,6,323,6,323,329
71001,MONTERO,estado nutricional en menores de 5 anos,clasificacion d,2001-11-01,28,475,28,475,503
70803,MORO MORO,estado nutricional en menores de 5 anos,clasificacion d,2001-11-01,21,22,21,22,43
30302,MOROCHATA,estado nutricional en menores de 5 anos,clasificacion d,2001-11-01,21,53,21,53,74
90401,NACEBE (SANTA ROSA DEL ABUNA),estado nutricional en menores de 5 anos,clasificacion d,2001-11-01,0,15,0,15,15
20307,NAZACARA DE PACAJES,estado nutricional en menores de 5 anos,clasificacion d,2001-11-01,0,5,0,5,5
50404,OCURI,estado nutricional en menores de 5 anos,clasificacion d,2001-11-01,46,139,46,139,185
70202,OKINAWA,estado nutricional en menores de 5 anos,clasificacion d,2001-11-01,6,25,6,25,31
30203,OMEREQUE,estado nutricional en menores de 5 anos,clasificacion d,2001-11-01,8,6,8,6,14
40101,ORURO,estado nutricional en menores de 5 anos,clasificacion d,2001-11-01,29,909,29,909,938
60201,PADCAYA,estado nutricional en menores de 5 anos,clasificacion d,2001-11-01,15,38,15,38,53
10401,PADILLA,estado nutricional en menores de 5 anos,clasificacion d,2001-11-01,10,331,10,331,341
70502,PAILON,estado nutricional en menores de 5 anos,clasificacion d,2001-11-01,3,47,3,47,50
20102,PALCA,estado nutricional en menores de 5 anos,clasificacion d,2001-11-01,45,45,45,45,90
21104,PALOS BLANCOS,estado nutricional en menores de 5 anos,clasificacion d,2001-11-01,45,114,45,114,159
40802,PAMPA AULLAGAS,estado nutricional en menores de 5 anos,clasificacion d,2001-11-01,8,18,8,18,26
70902,PAMPA GRANDE,estado nutricional en menores de 5 anos,clasificacion d,2001-11-01,11,19,11,19,30
21802,PAPEL PAMPA,estado nutricional en menores de 5 anos,clasificacion d,2001-11-01,3,1,3,1,4
30202,PASORAPA,estado nutricional en menores de 5 anos,clasificacion d,2001-11-01,4,15,4,15,19
21305,PATACAMAYA,estado nutricional en menores de 5 anos,clasificacion d,2001-11-01,27,27,27,27,54
40602,PAZÃ‘A,estado nutricional en menores de 5 anos,clasificacion d,2001-11-01,2,34,2,34,36
20702,PELECHUCO,estado nutricional en menores de 5 anos,clasificacion d,2001-11-01,7,17,7,17,24
50403,POCOATA,estado nutricional en menores de 5 anos,clasificacion d,2001-11-01,51,223,51,223,274
31203,POCONA,estado nutricional en menores de 5 anos,clasificacion d,2001-11-01,5,30,5,30,35
31202,POJO (CBBA),estado nutricional en menores de 5 anos,clasificacion d,2001-11-01,38,121,38,121,159
40601,POOPO,estado nutricional en menores de 5 anos,clasificacion d,2001-11-01,2,28,2,28,30
51203,PORCO,estado nutricional en menores de 5 anos,clasificacion d,2001-11-01,14,23,14,23,37
10103,POROMA,estado nutricional en menores de 5 anos,clasificacion d,2001-11-01,3,386,3,386,389
70103,PORONGO,estado nutricional en menores de 5 anos,clasificacion d,2001-11-01,1,52,1,52,53
70601,PORTACHUELO,estado nutricional en menores de 5 anos,clasificacion d,2001-11-01,26,27,26,27,53
90102,PORVENIR,estado nutricional en menores de 5 anos,clasificacion d,2001-11-01,0,34,0,34,34
50101,POTOSI,estado nutricional en menores de 5 anos,clasificacion d,2001-11-01,41,530,41,530,571
70805,PUCARA,estado nutricional en menores de 5 anos,clasificacion d,2001-11-01,0,23,0,23,23
21201,PUCARANI,estado nutricional en menores de 5 anos,clasificacion d,2001-11-01,6,76,6,76,82
20401,PUERTO ACOSTA,estado nutricional en menores de 5 anos,clasificacion d,2001-11-01,96,89,96,89,185
20403,PUERTO CARABUCO,estado nutricional en menores de 5 anos,clasificacion d,2001-11-01,47,68,47,68,115
90301,PUERTO GONZALO MORENO,estado nutricional en menores de 5 anos,clasificacion d,2001-11-01,0,26,0,26,26
21204,PUERTO PEREZ,estado nutricional en menores de 5 anos,clasificacion d,2001-11-01,8,23,8,23,31
71402,PUERTO QUIJARRO,estado nutricional en menores de 5 anos,clasificacion d,2001-11-01,40,10,40,10,50
90201,PUERTO RICO,estado nutricional en menores de 5 anos,clasificacion d,2001-11-01,6,17,6,17,23
80703,PUERTO SILES,estado nutricional en menores de 5 anos,clasificacion d,2001-11-01,2,2,2,2,4
71401,PUERTO SUAREZ,estado nutricional en menores de 5 anos,clasificacion d,2001-11-01,59,22,59,22,81
31205,PUERTO VILLARROEL,estado nutricional en menores de 5 anos,clasificacion d,2001-11-01,108,70,108,70,178
51101,PUNA,estado nutricional en menores de 5 anos,clasificacion d,2001-11-01,4,144,4,144,148
31401,PUNATA,estado nutricional en menores de 5 anos,clasificacion d,2001-11-01,11,57,11,57,68
20604,QUIABAYA,estado nutricional en menores de 5 anos,clasificacion d,2001-11-01,0,63,0,63,63
30901,QUILLACOLLO,estado nutricional en menores de 5 anos,clasificacion d,2001-11-01,12,12,12,12,24
21002,QUIME,estado nutricional en menores de 5 anos,clasificacion d,2001-11-01,28,64,28,64,92
70904,QUIRUSILLAS,estado nutricional en menores de 5 anos,clasificacion d,2001-11-01,4,0,4,0,4
50402,RAVELO,estado nutricional en menores de 5 anos,clasificacion d,2001-11-01,15,315,15,315,330
80301,REYES,estado nutricional en menores de 5 anos,clasificacion d,2001-11-01,10,51,10,51,61
80201,RIBERALTA,estado nutricional en menores de 5 anos,clasificacion d,2001-11-01,280,194,280,194,474
70503,ROBORE,estado nutricional en menores de 5 anos,clasificacion d,2001-11-01,1,71,1,71,72
80304,RURRENABAQUE,estado nutricional en menores de 5 anos,clasificacion d,2001-11-01,16,13,16,13,29
40901,SABAYA,estado nutricional en menores de 5 anos,clasificacion d,2001-11-01,0,8,0,8,8
31001,SACABA,estado nutricional en menores de 5 anos,clasificacion d,2001-11-01,31,153,31,153,184
30404,SACABAMBA,estado nutricional en menores de 5 anos,clasificacion d,2001-11-01,1,85,1,85,86
50701,SACACA,estado nutricional en menores de 5 anos,clasificacion d,2001-11-01,1,327,1,327,328
71302,SAIPINA,estado nutricional en menores de 5 anos,clasificacion d,2001-11-01,26,29,26,29,55
40801,SALINAS DE GARCI MENDOZA,estado nutricional en menores de 5 anos,clasificacion d,2001-11-01,6,16,6,16,22
70901,SAMAIPATA,estado nutricional en menores de 5 anos,clasificacion d,2001-11-01,16,9,16,9,25
51601,SAN AGUSTIN,estado nutricional en menores de 5 anos,clasificacion d,2001-11-01,0,10,0,10,10
80602,SAN ANDRES,estado nutricional en menores de 5 anos,clasificacion d,2001-11-01,0,37,0,37,37
51003,SAN ANTONIO DE ESMORUCO,estado nutricional en menores de 5 anos,clasificacion d,2001-11-01,0,31,0,31,31
71105,SAN ANTONIO DE LOMERIO,estado nutricional en menores de 5 anos,clasificacion d,2001-11-01,66,87,66,87,153
31403,SAN BENITO,estado nutricional en menores de 5 anos,clasificacion d,2001-11-01,1,59,1,59,60
80302,SAN BORJA,estado nutricional en menores de 5 anos,clasificacion d,2001-11-01,98,72,98,72,170
21502,SAN BUENA VENTURA,estado nutricional en menores de 5 anos,clasificacion d,2001-11-01,44,57,44,57,101
70402,SAN CARLOS,estado nutricional en menores de 5 anos,clasificacion d,2001-11-01,0,44,0,44,44
80501,SAN IGNACIO,estado nutricional en menores de 5 anos,clasificacion d,2001-11-01,23,128,23,128,151
70301,SAN IGNACIO DE VELASCO,estado nutricional en menores de 5 anos,clasificacion d,2001-11-01,200,143,200,143,343
80102,SAN JAVIER(BNI),estado nutricional en menores de 5 anos,clasificacion d,2001-11-01,0,40,0,40,40
71102,SAN JAVIER(STC),estado nutricional en menores de 5 anos,clasificacion d,2001-11-01,16,12,16,12,28
80701,SAN JOAQUIN,estado nutricional en menores de 5 anos,clasificacion d,2001-11-01,0,16,0,16,16
70501,SAN JOSE DE CHIQUITOS,estado nutricional en menores de 5 anos,clasificacion d,2001-11-01,47,13,47,13,60
71104,SAN JULIAN,estado nutricional en menores de 5 anos,clasificacion d,2001-11-01,84,195,84,195,279
90302,SAN LORENZO(PND),estado nutricional en menores de 5 anos,clasificacion d,2001-11-01,7,2,7,2,9
60501,SAN LORENZO(TJA),estado nutricional en menores de 5 anos,clasificacion d,2001-11-01,27,72,27,72,99
10702,SAN LUCAS,estado nutricional en menores de 5 anos,clasificacion d,2001-11-01,7,750,7,750,757
71201,SAN MATIAS,estado nutricional en menores de 5 anos,clasificacion d,2001-11-01,38,30,38,30,68
70302,SAN MIGUEL DE VELASCO,estado nutricional en menores de 5 anos,clasificacion d,2001-11-01,36,73,36,73,109
51001,SAN PABLO DE LIPEZ,estado nutricional en menores de 5 anos,clasificacion d,2001-11-01,4,47,4,47,51
50501,SAN PEDRO DE BUENA VISTA,estado nutricional en menores de 5 anos,clasificacion d,2001-11-01,4,465,4,465,469
21801,SAN PEDRO DE CURAHUARA,estado nutricional en menores de 5 anos,clasificacion d,2001-11-01,1,29,1,29,30
50902,SAN PEDRO DE QUEMES,estado nutricional en menores de 5 anos,clasificacion d,2001-11-01,1,21,1,21,22
21702,SAN PEDRO DE TIQUINA,estado nutricional en menores de 5 anos,clasificacion d,2001-11-01,0,20,0,20,20
70303,SAN RAFAEL,estado nutricional en menores de 5 anos,clasificacion d,2001-11-01,39,36,39,36,75
80702,SAN RAMON,estado nutricional en menores de 5 anos,clasificacion d,2001-11-01,4,1,4,1,5
80702,SAN RAMON,estado nutricional en menores de 5 anos,clasificacion d,2001-11-01,0,14,0,14,14
80401,SANTA ANA,estado nutricional en menores de 5 anos,clasificacion d,2001-11-01,26,34,26,34,60
70101,SANTA CRUZ DE LA SIERRA,estado nutricional en menores de 5 anos,clasificacion d,2001-11-01,322,441,322,441,763
80303,SANTA ROSA,estado nutricional en menores de 5 anos,clasificacion d,2001-11-01,11,5,11,5,16
70602,SANTA ROSA DEL SARA,estado nutricional en menores de 5 anos,clasificacion d,2001-11-01,11,36,11,36,47
20308,SANTIAGO DE CALLAPA,estado nutricional en menores de 5 anos,clasificacion d,2001-11-01,0,15,0,15,15
41401,SANTIAGO DE HUARI,estado nutricional en menores de 5 anos,clasificacion d,2001-11-01,12,19,12,19,31
21901,SANTIAGO DE MACHACA,estado nutricional en menores de 5 anos,clasificacion d,2001-11-01,6,9,6,9,15
30702,SANTIVAÃ‘ES,estado nutricional en menores de 5 anos,clasificacion d,2001-11-01,26,22,26,22,48
40202,SANTUARIO DE QUILLACAS,estado nutricional en menores de 5 anos,clasificacion d,2001-11-01,4,22,4,22,26
20902,SAPAHAQUI,estado nutricional en menores de 5 anos,clasificacion d,2001-11-01,2,39,2,39,41
90303,SENA,estado nutricional en menores de 5 anos,clasificacion d,2001-11-01,0,6,0,6,6
21301,SICA SICA (VILLA AROMA),estado nutricional en menores de 5 anos,clasificacion d,2001-11-01,21,30,21,30,51
30703,SICAYA,estado nutricional en menores de 5 anos,clasificacion d,2001-11-01,2,21,2,21,23
30902,SIPE SIPE,estado nutricional en menores de 5 anos,clasificacion d,2001-11-01,124,88,124,88,212
10403,SOPACHUY,estado nutricional en menores de 5 anos,clasificacion d,2001-11-01,7,108,7,108,115
20601,SORATA,estado nutricional en menores de 5 anos,clasificacion d,2001-11-01,8,116,8,116,124
10101,SUCRE,estado nutricional en menores de 5 anos,clasificacion d,2001-11-01,35,1230,35,1230,1265
31404,TACACHI,estado nutricional en menores de 5 anos,clasificacion d,2001-11-01,1,5,1,5,6
20603,TACACOMA,estado nutricional en menores de 5 anos,clasificacion d,2001-11-01,20,39,20,39,59
50303,TACOBAMBA,estado nutricional en menores de 5 anos,clasificacion d,2001-11-01,6,225,6,225,231
30602,TACOPAYA,estado nutricional en menores de 5 anos,clasificacion d,2001-11-01,5,62,5,62,67
51402,TAHUA,estado nutricional en menores de 5 anos,clasificacion d,2001-11-01,0,6,0,6,6
31101,TAPACARI,estado nutricional en menores de 5 anos,clasificacion d,2001-11-01,6,148,6,148,154
10601,TARABUCO,estado nutricional en menores de 5 anos,clasificacion d,2001-11-01,17,723,17,723,740
30401,TARATA,estado nutricional en menores de 5 anos,clasificacion d,2001-11-01,2,52,2,52,54
60101,TARIJA,estado nutricional en menores de 5 anos,clasificacion d,2001-11-01,83,460,83,460,543
10202,TARVITA,estado nutricional en menores de 5 anos,clasificacion d,2001-11-01,1,155,1,155,156
20803,TIAWANACU,estado nutricional en menores de 5 anos,clasificacion d,2001-11-01,16,25,16,25,41
50102,TINGUIPAYA,estado nutricional en menores de 5 anos,clasificacion d,2001-11-01,13,183,13,183,196
20606,TIPUANI,estado nutricional en menores de 5 anos,clasificacion d,2001-11-01,15,12,15,12,27
30903,TIQUIPAYA,estado nutricional en menores de 5 anos,clasificacion d,2001-11-01,1,65,1,65,66
31601,TIRAQUE (CBBA),estado nutricional en menores de 5 anos,clasificacion d,2001-11-01,53,145,53,145,198
21703,TITO YUPANQUI (PARQUIPUJIO),estado nutricional en menores de 5 anos,clasificacion d,2001-11-01,0,26,0,26,26
30802,TOCO,estado nutricional en menores de 5 anos,clasificacion d,2001-11-01,0,12,0,12,12
30803,TOLATA,estado nutricional en menores de 5 anos,clasificacion d,2001-11-01,1,4,1,4,5
41001,TOLEDO,estado nutricional en menores de 5 anos,clasificacion d,2001-11-01,15,2,15,2,17
51202,TOMAVE,estado nutricional en menores de 5 anos,clasificacion d,2001-11-01,3,141,3,141,144
10402,TOMINA,estado nutricional en menores de 5 anos,clasificacion d,2001-11-01,4,320,4,320,324
50502,TORO TORO,estado nutricional en menores de 5 anos,clasificacion d,2001-11-01,5,93,5,93,98
31201,TOTORA(CBBA),estado nutricional en menores de 5 anos,clasificacion d,2001-11-01,30,31,30,31,61
41301,TOTORA(ORR),estado nutricional en menores de 5 anos,clasificacion d,2001-11-01,0,24,0,24,24
70802,TRIGAL,estado nutricional en menores de 5 anos,clasificacion d,2001-11-01,2,5,2,5,7
80101,TRINIDAD,estado nutricional en menores de 5 anos,clasificacion d,2001-11-01,9,250,9,250,259
50801,TUPIZA,estado nutricional en menores de 5 anos,clasificacion d,2001-11-01,10,340,10,340,350
40402,TURCO,estado nutricional en menores de 5 anos,clasificacion d,2001-11-01,11,5,11,5,16
21302,UMALA,estado nutricional en menores de 5 anos,clasificacion d,2001-11-01,14,19,14,19,33
50201,UNCIA,estado nutricional en menores de 5 anos,clasificacion d,2001-11-01,7,90,7,90,97
60401,URIONDO (A. CONCEPCION),estado nutricional en menores de 5 anos,clasificacion d,2001-11-01,0,47,0,47,47
71502,URUBICHA,estado nutricional en menores de 5 anos,clasificacion d,2001-11-01,0,56,0,56,56
51201,UYUNI,estado nutricional en menores de 5 anos,clasificacion d,2001-11-01,3,219,3,219,222
30502,VACAS,estado nutricional en menores de 5 anos,clasificacion d,2001-11-01,2,20,2,20,22
70801,VALLEGRANDE,estado nutricional en menores de 5 anos,clasificacion d,2001-11-01,35,49,35,49,84
20801,VIACHA,estado nutricional en menores de 5 anos,clasificacion d,2001-11-01,15,179,15,179,194
31302,VILA VILA,estado nutricional en menores de 5 anos,clasificacion d,2001-11-01,3,43,3,43,46
60303,VILLA MONTES,estado nutricional en menores de 5 anos,clasificacion d,2001-11-01,46,54,46,54,100
90502,VILLA NUEVA (LOMA ALTA),estado nutricional en menores de 5 anos,clasificacion d,2001-11-01,1,0,1,0,1
31402,VILLA RIVERO,estado nutricional en menores de 5 anos,clasificacion d,2001-11-01,0,16,0,16,16
10801,VILLA SERRANO,estado nutricional en menores de 5 anos,clasificacion d,2001-11-01,6,298,6,298,304
31003,VILLA TUNARI,estado nutricional en menores de 5 anos,clasificacion d,2001-11-01,56,73,56,73,129
11001,VILLA VACA GUZMAN (MUYUPAMPA),estado nutricional en menores de 5 anos,clasificacion d,2001-11-01,10,167,10,167,177
51501,VILLAZON,estado nutricional en menores de 5 anos,clasificacion d,2001-11-01,13,271,13,271,284
30904,VINTO,estado nutricional en menores de 5 anos,clasificacion d,2001-11-01,47,22,47,22,69
50602,VITICHI,estado nutricional en menores de 5 anos,clasificacion d,2001-11-01,1,81,1,81,82
70201,WARNES,estado nutricional en menores de 5 anos,clasificacion d,2001-11-01,72,114,72,114,186
20903,YACO,estado nutricional en menores de 5 anos,clasificacion d,2001-11-01,1,35,1,35,36
60301,YACUIBA,estado nutricional en menores de 5 anos,clasificacion d,2001-11-01,37,32,37,32,69
10602,YAMPARAEZ,estado nutricional en menores de 5 anos,clasificacion d,2001-11-01,2,436,2,436,438
21103,YANACACHI,estado nutricional en menores de 5 anos,clasificacion d,2001-11-01,0,6,0,6,6
70403,YAPACANI,estado nutricional en menores de 5 anos,clasificacion d,2001-11-01,89,116,89,116,205
50103,YOCALLA,estado nutricional en menores de 5 anos,clasificacion d,2001-11-01,0,62,0,62,62
10102,YOTALA,estado nutricional en menores de 5 anos,clasificacion d,2001-11-01,2,318,2,318,320
60402,YUNCHARA,estado nutricional en menores de 5 anos,clasificacion d,2001-11-01,2,28,2,28,30
10301,ZUDAÃ‘EZ,estado nutricional en menores de 5 anos,clasificacion d,2001-11-01,7,269,7,269,276
51302,ACACIO,estado nutricional en menores de 5 anos,clasificacion d,2001-12-01,0,101,0,101,101
20201,ACHACACHI,estado nutricional en menores de 5 anos,clasificacion d,2001-12-01,13,110,13,110,123
20104,ACHOCALLA,estado nutricional en menores de 5 anos,clasificacion d,2001-12-01,15,17,15,17,32
30201,AIQUILE,estado nutricional en menores de 5 anos,clasificacion d,2001-12-01,4,4,4,4,8
31303,ALALAY,estado nutricional en menores de 5 anos,clasificacion d,2001-12-01,5,16,5,16,21
10404,ALCALA,estado nutricional en menores de 5 anos,clasificacion d,2001-12-01,2,108,2,108,110
20202,ANCORAIMES,estado nutricional en menores de 5 anos,clasificacion d,2001-12-01,0,102,0,102,102
41201,ANDAMARCA,estado nutricional en menores de 5 anos,clasificacion d,2001-12-01,5,14,5,14,19
30402,ANZALDO,estado nutricional en menores de 5 anos,clasificacion d,2001-12-01,4,51,4,51,55
20701,APOLO,estado nutricional en menores de 5 anos,clasificacion d,2001-12-01,22,6,22,6,28
51301,ARAMPAMPA,estado nutricional en menores de 5 anos,clasificacion d,2001-12-01,2,63,2,63,65
30501,ARANI,estado nutricional en menores de 5 anos,clasificacion d,2001-12-01,1,16,1,16,17
30403,ARBIETO,estado nutricional en menores de 5 anos,clasificacion d,2001-12-01,0,5,0,5,5
30601,ARQUE,estado nutricional en menores de 5 anos,clasificacion d,2001-12-01,25,33,25,33,58
71501,ASCENCION DE GUARAYOS,estado nutricional en menores de 5 anos,clasificacion d,2001-12-01,183,256,183,256,439
50802,ATOCHA,estado nutricional en menores de 5 anos,clasificacion d,2001-12-01,1,70,1,70,71
20503,AUCAPATA,estado nutricional en menores de 5 anos,clasificacion d,2001-12-01,3,3,3,3,6
20502,AYATA,estado nutricional en menores de 5 anos,clasificacion d,2001-12-01,1,5,1,5,6
21303,AYO AYO,estado nutricional en menores de 5 anos,clasificacion d,2001-12-01,37,10,37,10,47
30301,AYOPAYA (V. DE INDEPENDENCIA),estado nutricional en menores de 5 anos,clasificacion d,2001-12-01,75,90,75,90,165
10201,AZURDUY,estado nutricional en menores de 5 anos,clasificacion d,2001-12-01,0,153,0,153,153
21203,BATALLAS,estado nutricional en menores de 5 anos,clasificacion d,2001-12-01,3,73,3,73,76
80802,BAURES,estado nutricional en menores de 5 anos,clasificacion d,2001-12-01,11,19,11,19,30
41202,BELEN DE ANDAMARCA,estado nutricional en menores de 5 anos,clasificacion d,2001-12-01,0,2,0,2,2
50104,BELEN DE URMIRI,estado nutricional en menores de 5 anos,clasificacion d,2001-12-01,0,19,0,19,19
90104,BELLA FLOR,estado nutricional en menores de 5 anos,clasificacion d,2001-12-01,0,3,0,3,3
60202,BERMEJO,estado nutricional en menores de 5 anos,clasificacion d,2001-12-01,1,14,1,14,15
50301,BETANZOS,estado nutricional en menores de 5 anos,clasificacion d,2001-12-01,3,244,3,244,247
31501,BOLIVAR,estado nutricional en menores de 5 anos,clasificacion d,2001-12-01,41,65,41,65,106
90103,BOLPEBRA,estado nutricional en menores de 5 anos,clasificacion d,2001-12-01,0,4,0,4,4
70707,BOYUIBE,estado nutricional en menores de 5 anos,clasificacion d,2001-12-01,4,23,4,23,27
70401,BUENA VISTA,estado nutricional en menores de 5 anos,clasificacion d,2001-12-01,43,67,43,67,110
70703,CABEZAS,estado nutricional en menores de 5 anos,clasificacion d,2001-12-01,2,63,2,63,65
20905,CAIROMA,estado nutricional en menores de 5 anos,clasificacion d,2001-12-01,3,38,3,38,41
51102,"CAIZA ""D""",estado nutricional en menores de 5 anos,clasificacion d,2001-12-01,4,154,4,154,158
21003,CAJUATA,estado nutricional en menores de 5 anos,clasificacion d,2001-12-01,3,0,3,0,3
20303,CALACOTO,estado nutricional en menores de 5 anos,clasificacion d,2001-12-01,1,6,1,6,7
21304,CALAMARCA,estado nutricional en menores de 5 anos,clasificacion d,2001-12-01,2,48,2,48,50
10701,CAMARGO,estado nutricional en menores de 5 anos,clasificacion d,2001-12-01,8,50,8,50,58
10901,CAMATAQUI (C. VILLA ABECIA),estado nutricional en menores de 5 anos,clasificacion d,2001-12-01,0,39,0,39,39
70706,CAMIRI,estado nutricional en menores de 5 anos,clasificacion d,2001-12-01,42,56,42,56,98
30701,CAPINOTA,estado nutricional en menores de 5 anos,clasificacion d,2001-12-01,49,40,49,40,89
20302,CAQUIAVIRI,estado nutricional en menores de 5 anos,clasificacion d,2001-12-01,8,21,8,21,29
40102,CARACOLLO,estado nutricional en menores de 5 anos,clasificacion d,2001-12-01,9,12,9,12,21
22001,CARANAVI,estado nutricional en menores de 5 anos,clasificacion d,2001-12-01,73,87,73,87,160
41503,CARANGAS,estado nutricional en menores de 5 anos,clasificacion d,2001-12-01,0,1,0,1,1
60302,CARAPARI,estado nutricional en menores de 5 anos,clasificacion d,2001-12-01,5,36,5,36,41
50702,CARIPUYO,estado nutricional en menores de 5 anos,clasificacion d,2001-12-01,2,89,2,89,91
40201,CHALLAPATA,estado nutricional en menores de 5 anos,clasificacion d,2001-12-01,27,43,27,43,70
50302,CHAQUI,estado nutricional en menores de 5 anos,clasificacion d,2001-12-01,0,85,0,85,85
70702,CHARAGUA,estado nutricional en menores de 5 anos,clasificacion d,2001-12-01,16,208,16,208,224
20305,CHARAÃ‘A,estado nutricional en menores de 5 anos,clasificacion d,2001-12-01,0,14,0,14,14
50202,CHAYANTA,estado nutricional en menores de 5 anos,clasificacion d,2001-12-01,1,40,1,40,41
31204,CHIMORE,estado nutricional en menores de 5 anos,clasificacion d,2001-12-01,17,72,17,72,89
40903,CHIPAYA,estado nutricional en menores de 5 anos,clasificacion d,2001-12-01,0,2,0,2,2
40302,CHOQUE COTA,estado nutricional en menores de 5 anos,clasificacion d,2001-12-01,1,8,1,8,9
21101,CHULUMANI (V. DE LA LIBERTAD),estado nutricional en menores de 5 anos,clasificacion d,2001-12-01,2,34,2,34,36
20501,CHUMA,estado nutricional en menores de 5 anos,clasificacion d,2001-12-01,10,17,10,17,27
30801,CLIZA,estado nutricional en menores de 5 anos,clasificacion d,2001-12-01,14,30,14,30,44
90101,COBIJA,estado nutricional en menores de 5 anos,clasificacion d,2001-12-01,30,33,30,33,63
30101,COCHABAMBA,estado nutricional en menores de 5 anos,clasificacion d,2001-12-01,202,324,202,324,526
30905,COLCAPIRHUA,estado nutricional en menores de 5 anos,clasificacion d,2001-12-01,86,45,86,45,131
50901,"COLCHA ""K""",estado nutricional en menores de 5 anos,clasificacion d,2001-12-01,2,35,2,35,37
21307,COLLANA,estado nutricional en menores de 5 anos,clasificacion d,2001-12-01,0,3,0,3,3
31002,COLOMI,estado nutricional en menores de 5 anos,clasificacion d,2001-12-01,35,78,35,78,113
70603,COLPA BELGICA,estado nutricional en menores de 5 anos,clasificacion d,2001-12-01,7,4,7,4,11
50401,COLQUECHACA,estado nutricional en menores de 5 anos,clasificacion d,2001-12-01,7,91,7,91,98
21306,COLQUENCHA,estado nutricional en menores de 5 anos,clasificacion d,2001-12-01,15,12,15,12,27
21004,COLQUIRI,estado nutricional en menores de 5 anos,clasificacion d,2001-12-01,17,50,17,50,67
20304,COMANCHE,estado nutricional en menores de 5 anos,clasificacion d,2001-12-01,2,26,2,26,28
71301,COMARAPA,estado nutricional en menores de 5 anos,clasificacion d,2001-12-01,16,27,16,27,43
20605,COMBAYA,estado nutricional en menores de 5 anos,clasificacion d,2001-12-01,0,16,0,16,16
71101,CONCEPCION,estado nutricional en menores de 5 anos,clasificacion d,2001-12-01,5,13,5,13,18
21701,COPACABANA,estado nutricional en menores de 5 anos,clasificacion d,2001-12-01,3,79,3,79,82
21402,CORIPATA,estado nutricional en menores de 5 anos,clasificacion d,2001-12-01,4,10,4,10,14
20301,CORO CORO,estado nutricional en menores de 5 anos,clasificacion d,2001-12-01,12,8,12,8,20
21401,COROICO,estado nutricional en menores de 5 anos,clasificacion d,2001-12-01,17,31,17,31,48
40301,CORQUE,estado nutricional en menores de 5 anos,clasificacion d,2001-12-01,19,23,19,23,42
50601,COTAGAITA,estado nutricional en menores de 5 anos,clasificacion d,2001-12-01,16,198,16,198,214
70102,COTOCA,estado nutricional en menores de 5 anos,clasificacion d,2001-12-01,7,46,7,46,53
70704,CUEVO,estado nutricional en menores de 5 anos,clasificacion d,2001-12-01,11,26,11,26,37
10902,CULPINA,estado nutricional en menores de 5 anos,clasificacion d,2001-12-01,20,247,20,247,267
40401,CURAHUARA DE CARANGAS,estado nutricional en menores de 5 anos,clasificacion d,2001-12-01,9,5,9,5,14
21602,CURVA,estado nutricional en menores de 5 anos,clasificacion d,2001-12-01,6,7,6,7,13
20804,DESAGUADERO,estado nutricional en menores de 5 anos,clasificacion d,2001-12-01,1,14,1,14,15
20105,EL ALTO,estado nutricional en menores de 5 anos,clasificacion d,2001-12-01,1084,1099,1084,1099,2183
40103,EL CHORO,estado nutricional en menores de 5 anos,clasificacion d,2001-12-01,2,4,2,4,6
71503,EL PUENTE(STC),estado nutricional en menores de 5 anos,clasificacion d,2001-12-01,10,106,10,106,116
60502,EL PUENTE(TJA),estado nutricional en menores de 5 anos,clasificacion d,2001-12-01,27,46,27,46,73
70105,EL TORNO,estado nutricional en menores de 5 anos,clasificacion d,2001-12-01,0,132,0,132,132
10405,EL VILLAR,estado nutricional en menores de 5 anos,clasificacion d,2001-12-01,2,197,2,197,199
60601,ENTRE RIOS,estado nutricional en menores de 5 anos,clasificacion d,2001-12-01,24,76,24,76,100
41101,EUCALIPTUS,estado nutricional en menores de 5 anos,clasificacion d,2001-12-01,0,18,0,18,18
80402,EXALTACION,estado nutricional en menores de 5 anos,clasificacion d,2001-12-01,5,13,5,13,18
90203,FILADELFIA,estado nutricional en menores de 5 anos,clasificacion d,2001-12-01,9,16,9,16,25
71002,GENERAL SAAVEDRA,estado nutricional en menores de 5 anos,clasificacion d,2001-12-01,22,115,22,115,137
21601,GRAL. J.J. PEREZ (CHARAZANI),estado nutricional en menores de 5 anos,clasificacion d,2001-12-01,3,3,3,3,6
20602,GUANAY,estado nutricional en menores de 5 anos,clasificacion d,2001-12-01,14,78,14,78,92
20802,GUAQUI,estado nutricional en menores de 5 anos,clasificacion d,2001-12-01,0,8,0,8,8
80202,GUAYARAMERIN,estado nutricional en menores de 5 anos,clasificacion d,2001-12-01,58,57,58,57,115
70705,GUTIERREZ,estado nutricional en menores de 5 anos,clasificacion d,2001-12-01,20,187,20,187,207
10502,HUACARETA,estado nutricional en menores de 5 anos,clasificacion d,2001-12-01,1,148,1,148,149
40501,HUACHACALLA,estado nutricional en menores de 5 anos,clasificacion d,2001-12-01,1,9,1,9,10
40701,HUANUNI,estado nutricional en menores de 5 anos,clasificacion d,2001-12-01,1,7,1,7,8
80803,HUARACAJE,estado nutricional en menores de 5 anos,clasificacion d,2001-12-01,1,4,1,4,5
41601,HUAYLLAMARCA,estado nutricional en menores de 5 anos,clasificacion d,2001-12-01,4,25,4,25,29
21005,ICHOCA,estado nutricional en menores de 5 anos,clasificacion d,2001-12-01,1,8,1,8,9
10304,ICLA,estado nutricional en menores de 5 anos,clasificacion d,2001-12-01,124,181,124,181,305
10703,INCAHUASI,estado nutricional en menores de 5 anos,clasificacion d,2001-12-01,4,134,4,134,138
21001,INQUISIVI,estado nutricional en menores de 5 anos,clasificacion d,2001-12-01,0,52,0,52,52
21102,IRUPANA (VILLA DE LANZA),estado nutricional en menores de 5 anos,clasificacion d,2001-12-01,4,41,4,41,45
21501,IXIAMAS,estado nutricional en menores de 5 anos,clasificacion d,2001-12-01,18,6,18,6,24
21105,LA ASUNTA,estado nutricional en menores de 5 anos,clasificacion d,2001-12-01,24,68,24,68,92
70104,LA GUARDIA,estado nutricional en menores de 5 anos,clasificacion d,2001-12-01,1,108,1,108,109
20101,LA PAZ,estado nutricional en menores de 5 anos,clasificacion d,2001-12-01,731,903,731,903,1634
41501,LA RIVERA,estado nutricional en menores de 5 anos,clasificacion d,2001-12-01,0,1,0,1,1
70701,LAGUNILLAS,estado nutricional en menores de 5 anos,clasificacion d,2001-12-01,21,33,21,33,54
21202,LAJA,estado nutricional en menores de 5 anos,clasificacion d,2001-12-01,1,54,1,54,55
10903,LAS CARRERAS,estado nutricional en menores de 5 anos,clasificacion d,2001-12-01,0,90,0,90,90
50203,LLALLAGUA,estado nutricional en menores de 5 anos,clasificacion d,2001-12-01,6,111,6,111,117
51401,LLICA,estado nutricional en menores de 5 anos,clasificacion d,2001-12-01,1,13,1,13,14
80601,LORETO,estado nutricional en menores de 5 anos,clasificacion d,2001-12-01,0,6,0,6,6
20901,LURIBAY,estado nutricional en menores de 5 anos,clasificacion d,2001-12-01,0,42,0,42,42
40702,MACHACAMARCA,estado nutricional en menores de 5 anos,clasificacion d,2001-12-01,15,15,15,15,30
11003,MACHARETI,estado nutricional en menores de 5 anos,clasificacion d,2001-12-01,2,105,2,105,107
80801,MAGDALENA,estado nutricional en menores de 5 anos,clasificacion d,2001-12-01,3,8,3,8,11
70903,MAIRANA,estado nutricional en menores de 5 anos,clasificacion d,2001-12-01,17,20,17,20,37
20103,MECAPACA,estado nutricional en menores de 5 anos,clasificacion d,2001-12-01,0,26,0,26,26
71003,MINEROS,estado nutricional en menores de 5 anos,clasificacion d,2001-12-01,2,173,2,173,175
31301,MIZQUE,estado nutricional en menores de 5 anos,clasificacion d,2001-12-01,14,48,14,48,62
20402,MOCOMOCO,estado nutricional en menores de 5 anos,clasificacion d,2001-12-01,17,14,17,14,31
51002,MOJINETE,estado nutricional en menores de 5 anos,clasificacion d,2001-12-01,0,5,0,5,5
10303,MOJOCOYA,estado nutricional en menores de 5 anos,clasificacion d,2001-12-01,3,204,3,204,207
10501,MONTEAGUDO,estado nutricional en menores de 5 anos,clasificacion d,2001-12-01,5,301,5,301,306
71001,MONTERO,estado nutricional en menores de 5 anos,clasificacion d,2001-12-01,10,462,10,462,472
70803,MORO MORO,estado nutricional en menores de 5 anos,clasificacion d,2001-12-01,10,7,10,7,17
30302,MOROCHATA,estado nutricional en menores de 5 anos,clasificacion d,2001-12-01,4,50,4,50,54
90401,NACEBE (SANTA ROSA DEL ABUNA),estado nutricional en menores de 5 anos,clasificacion d,2001-12-01,4,0,4,0,4
90501,NUEVO MANOA (NUEVA ESPERANZA),estado nutricional en menores de 5 anos,clasificacion d,2001-12-01,0,2,0,2,2
50404,OCURI,estado nutricional en menores de 5 anos,clasificacion d,2001-12-01,43,127,43,127,170
70202,OKINAWA,estado nutricional en menores de 5 anos,clasificacion d,2001-12-01,10,18,10,18,28
30203,OMEREQUE,estado nutricional en menores de 5 anos,clasificacion d,2001-12-01,1,20,1,20,21
40101,ORURO,estado nutricional en menores de 5 anos,clasificacion d,2001-12-01,61,778,61,778,839
60201,PADCAYA,estado nutricional en menores de 5 anos,clasificacion d,2001-12-01,17,60,17,60,77
10401,PADILLA,estado nutricional en menores de 5 anos,clasificacion d,2001-12-01,2,443,2,443,445
70502,PAILON,estado nutricional en menores de 5 anos,clasificacion d,2001-12-01,0,10,0,10,10
20102,PALCA,estado nutricional en menores de 5 anos,clasificacion d,2001-12-01,37,23,37,23,60
21104,PALOS BLANCOS,estado nutricional en menores de 5 anos,clasificacion d,2001-12-01,25,69,25,69,94
40802,PAMPA AULLAGAS,estado nutricional en menores de 5 anos,clasificacion d,2001-12-01,1,15,1,15,16
70902,PAMPA GRANDE,estado nutricional en menores de 5 anos,clasificacion d,2001-12-01,8,12,8,12,20
21802,PAPEL PAMPA,estado nutricional en menores de 5 anos,clasificacion d,2001-12-01,2,11,2,11,13
30202,PASORAPA,estado nutricional en menores de 5 anos,clasificacion d,2001-12-01,0,26,0,26,26
21305,PATACAMAYA,estado nutricional en menores de 5 anos,clasificacion d,2001-12-01,18,26,18,26,44
40602,PAZÃ‘A,estado nutricional en menores de 5 anos,clasificacion d,2001-12-01,2,37,2,37,39
20702,PELECHUCO,estado nutricional en menores de 5 anos,clasificacion d,2001-12-01,8,30,8,30,38
50403,POCOATA,estado nutricional en menores de 5 anos,clasificacion d,2001-12-01,66,236,66,236,302
31203,POCONA,estado nutricional en menores de 5 anos,clasificacion d,2001-12-01,2,25,2,25,27
31202,POJO (CBBA),estado nutricional en menores de 5 anos,clasificacion d,2001-12-01,26,109,26,109,135
40601,POOPO,estado nutricional en menores de 5 anos,clasificacion d,2001-12-01,5,36,5,36,41
51203,PORCO,estado nutricional en menores de 5 anos,clasificacion d,2001-12-01,9,15,9,15,24
10103,POROMA,estado nutricional en menores de 5 anos,clasificacion d,2001-12-01,0,252,0,252,252
70103,PORONGO,estado nutricional en menores de 5 anos,clasificacion d,2001-12-01,2,24,2,24,26
70601,PORTACHUELO,estado nutricional en menores de 5 anos,clasificacion d,2001-12-01,49,15,49,15,64
90102,PORVENIR,estado nutricional en menores de 5 anos,clasificacion d,2001-12-01,0,25,0,25,25
70804,POSTRER VALLE,estado nutricional en menores de 5 anos,clasificacion d,2001-12-01,0,4,0,4,4
50101,POTOSI,estado nutricional en menores de 5 anos,clasificacion d,2001-12-01,59,520,59,520,579
10302,PRESTO,estado nutricional en menores de 5 anos,clasificacion d,2001-12-01,2,162,2,162,164
21201,PUCARANI,estado nutricional en menores de 5 anos,clasificacion d,2001-12-01,3,44,3,44,47
20401,PUERTO ACOSTA,estado nutricional en menores de 5 anos,clasificacion d,2001-12-01,62,88,62,88,150
20403,PUERTO CARABUCO,estado nutricional en menores de 5 anos,clasificacion d,2001-12-01,27,55,27,55,82
90301,PUERTO GONZALO MORENO,estado nutricional en menores de 5 anos,clasificacion d,2001-12-01,3,17,3,17,20
21204,PUERTO PEREZ,estado nutricional en menores de 5 anos,clasificacion d,2001-12-01,0,14,0,14,14
71402,PUERTO QUIJARRO,estado nutricional en menores de 5 anos,clasificacion d,2001-12-01,27,5,27,5,32
90201,PUERTO RICO,estado nutricional en menores de 5 anos,clasificacion d,2001-12-01,0,36,0,36,36
80703,PUERTO SILES,estado nutricional en menores de 5 anos,clasificacion d,2001-12-01,3,60,3,60,63
71401,PUERTO SUAREZ,estado nutricional en menores de 5 anos,clasificacion d,2001-12-01,69,20,69,20,89
31205,PUERTO VILLARROEL,estado nutricional en menores de 5 anos,clasificacion d,2001-12-01,94,77,94,77,171
51101,PUNA,estado nutricional en menores de 5 anos,clasificacion d,2001-12-01,6,229,6,229,235
31401,PUNATA,estado nutricional en menores de 5 anos,clasificacion d,2001-12-01,12,47,12,47,59
20604,QUIABAYA,estado nutricional en menores de 5 anos,clasificacion d,2001-12-01,0,14,0,14,14
30901,QUILLACOLLO,estado nutricional en menores de 5 anos,clasificacion d,2001-12-01,16,14,16,14,30
21002,QUIME,estado nutricional en menores de 5 anos,clasificacion d,2001-12-01,11,35,11,35,46
50402,RAVELO,estado nutricional en menores de 5 anos,clasificacion d,2001-12-01,13,363,13,363,376
80201,RIBERALTA,estado nutricional en menores de 5 anos,clasificacion d,2001-12-01,241,215,241,215,456
70503,ROBORE,estado nutricional en menores de 5 anos,clasificacion d,2001-12-01,3,48,3,48,51
80304,RURRENABAQUE,estado nutricional en menores de 5 anos,clasificacion d,2001-12-01,10,13,10,13,23
40901,SABAYA,estado nutricional en menores de 5 anos,clasificacion d,2001-12-01,2,4,2,4,6
31001,SACABA,estado nutricional en menores de 5 anos,clasificacion d,2001-12-01,64,26,64,26,90
30404,SACABAMBA,estado nutricional en menores de 5 anos,clasificacion d,2001-12-01,0,64,0,64,64
50701,SACACA,estado nutricional en menores de 5 anos,clasificacion d,2001-12-01,1,244,1,244,245
71302,SAIPINA,estado nutricional en menores de 5 anos,clasificacion d,2001-12-01,15,36,15,36,51
40801,SALINAS DE GARCI MENDOZA,estado nutricional en menores de 5 anos,clasificacion d,2001-12-01,9,13,9,13,22
70901,SAMAIPATA,estado nutricional en menores de 5 anos,clasificacion d,2001-12-01,31,12,31,12,43
51601,SAN AGUSTIN,estado nutricional en menores de 5 anos,clasificacion d,2001-12-01,0,9,0,9,9
80602,SAN ANDRES,estado nutricional en menores de 5 anos,clasificacion d,2001-12-01,18,21,18,21,39
51003,SAN ANTONIO DE ESMORUCO,estado nutricional en menores de 5 anos,clasificacion d,2001-12-01,0,16,0,16,16
71105,SAN ANTONIO DE LOMERIO,estado nutricional en menores de 5 anos,clasificacion d,2001-12-01,38,83,38,83,121
31403,SAN BENITO,estado nutricional en menores de 5 anos,clasificacion d,2001-12-01,2,18,2,18,20
80302,SAN BORJA,estado nutricional en menores de 5 anos,clasificacion d,2001-12-01,43,71,43,71,114
21502,SAN BUENA VENTURA,estado nutricional en menores de 5 anos,clasificacion d,2001-12-01,14,71,14,71,85
70402,SAN CARLOS,estado nutricional en menores de 5 anos,clasificacion d,2001-12-01,1,8,1,8,9
80501,SAN IGNACIO,estado nutricional en menores de 5 anos,clasificacion d,2001-12-01,26,100,26,100,126
70301,SAN IGNACIO DE VELASCO,estado nutricional en menores de 5 anos,clasificacion d,2001-12-01,178,173,178,173,351
80102,SAN JAVIER(BNI),estado nutricional en menores de 5 anos,clasificacion d,2001-12-01,0,15,0,15,15
71102,SAN JAVIER(STC),estado nutricional en menores de 5 anos,clasificacion d,2001-12-01,55,44,55,44,99
80701,SAN JOAQUIN,estado nutricional en menores de 5 anos,clasificacion d,2001-12-01,0,17,0,17,17
70501,SAN JOSE DE CHIQUITOS,estado nutricional en menores de 5 anos,clasificacion d,2001-12-01,53,12,53,12,65
71104,SAN JULIAN,estado nutricional en menores de 5 anos,clasificacion d,2001-12-01,58,240,58,240,298
60501,SAN LORENZO(TJA),estado nutricional en menores de 5 anos,clasificacion d,2001-12-01,2,42,2,42,44
10702,SAN LUCAS,estado nutricional en menores de 5 anos,clasificacion d,2001-12-01,9,607,9,607,616
71201,SAN MATIAS,estado nutricional en menores de 5 anos,clasificacion d,2001-12-01,57,34,57,34,91
70302,SAN MIGUEL DE VELASCO,estado nutricional en menores de 5 anos,clasificacion d,2001-12-01,32,24,32,24,56
51001,SAN PABLO DE LIPEZ,estado nutricional en menores de 5 anos,clasificacion d,2001-12-01,0,35,0,35,35
50501,SAN PEDRO DE BUENA VISTA,estado nutricional en menores de 5 anos,clasificacion d,2001-12-01,4,155,4,155,159
21801,SAN PEDRO DE CURAHUARA,estado nutricional en menores de 5 anos,clasificacion d,2001-12-01,3,15,3,15,18
50902,SAN PEDRO DE QUEMES,estado nutricional en menores de 5 anos,clasificacion d,2001-12-01,0,6,0,6,6
21702,SAN PEDRO DE TIQUINA,estado nutricional en menores de 5 anos,clasificacion d,2001-12-01,0,7,0,7,7
70303,SAN RAFAEL,estado nutricional en menores de 5 anos,clasificacion d,2001-12-01,35,40,35,40,75
80702,SAN RAMON,estado nutricional en menores de 5 anos,clasificacion d,2001-12-01,2,6,2,6,8
80702,SAN RAMON,estado nutricional en menores de 5 anos,clasificacion d,2001-12-01,1,18,1,18,19
80401,SANTA ANA,estado nutricional en menores de 5 anos,clasificacion d,2001-12-01,19,11,19,11,30
70101,SANTA CRUZ DE LA SIERRA,estado nutricional en menores de 5 anos,clasificacion d,2001-12-01,139,438,139,438,577
80303,SANTA ROSA,estado nutricional en menores de 5 anos,clasificacion d,2001-12-01,29,34,29,34,63
70602,SANTA ROSA DEL SARA,estado nutricional en menores de 5 anos,clasificacion d,2001-12-01,3,24,3,24,27
41401,SANTIAGO DE HUARI,estado nutricional en menores de 5 anos,clasificacion d,2001-12-01,18,10,18,10,28
30702,SANTIVAÃ‘ES,estado nutricional en menores de 5 anos,clasificacion d,2001-12-01,5,3,5,3,8
40202,SANTUARIO DE QUILLACAS,estado nutricional en menores de 5 anos,clasificacion d,2001-12-01,4,8,4,8,12
20902,SAPAHAQUI,estado nutricional en menores de 5 anos,clasificacion d,2001-12-01,0,22,0,22,22
21301,SICA SICA (VILLA AROMA),estado nutricional en menores de 5 anos,clasificacion d,2001-12-01,13,26,13,26,39
30703,SICAYA,estado nutricional en menores de 5 anos,clasificacion d,2001-12-01,0,11,0,11,11
30902,SIPE SIPE,estado nutricional en menores de 5 anos,clasificacion d,2001-12-01,121,68,121,68,189
10403,SOPACHUY,estado nutricional en menores de 5 anos,clasificacion d,2001-12-01,4,103,4,103,107
20601,SORATA,estado nutricional en menores de 5 anos,clasificacion d,2001-12-01,2,96,2,96,98
10101,SUCRE,estado nutricional en menores de 5 anos,clasificacion d,2001-12-01,49,777,49,777,826
31404,TACACHI,estado nutricional en menores de 5 anos,clasificacion d,2001-12-01,1,8,1,8,9
20603,TACACOMA,estado nutricional en menores de 5 anos,clasificacion d,2001-12-01,0,11,0,11,11
50303,TACOBAMBA,estado nutricional en menores de 5 anos,clasificacion d,2001-12-01,2,180,2,180,182
51402,TAHUA,estado nutricional en menores de 5 anos,clasificacion d,2001-12-01,0,5,0,5,5
31101,TAPACARI,estado nutricional en menores de 5 anos,clasificacion d,2001-12-01,11,56,11,56,67
10601,TARABUCO,estado nutricional en menores de 5 anos,clasificacion d,2001-12-01,15,759,15,759,774
30401,TARATA,estado nutricional en menores de 5 anos,clasificacion d,2001-12-01,4,50,4,50,54
60101,TARIJA,estado nutricional en menores de 5 anos,clasificacion d,2001-12-01,39,223,39,223,262
10202,TARVITA,estado nutricional en menores de 5 anos,clasificacion d,2001-12-01,3,185,3,185,188
20803,TIAWANACU,estado nutricional en menores de 5 anos,clasificacion d,2001-12-01,7,8,7,8,15
50102,TINGUIPAYA,estado nutricional en menores de 5 anos,clasificacion d,2001-12-01,14,94,14,94,108
20606,TIPUANI,estado nutricional en menores de 5 anos,clasificacion d,2001-12-01,4,5,4,5,9
30903,TIQUIPAYA,estado nutricional en menores de 5 anos,clasificacion d,2001-12-01,0,28,0,28,28
31601,TIRAQUE (CBBA),estado nutricional en menores de 5 anos,clasificacion d,2001-12-01,71,76,71,76,147
21703,TITO YUPANQUI (PARQUIPUJIO),estado nutricional en menores de 5 anos,clasificacion d,2001-12-01,0,16,0,16,16
30802,TOCO,estado nutricional en menores de 5 anos,clasificacion d,2001-12-01,0,9,0,9,9
41001,TOLEDO,estado nutricional en menores de 5 anos,clasificacion d,2001-12-01,11,4,11,4,15
51202,TOMAVE,estado nutricional en menores de 5 anos,clasificacion d,2001-12-01,5,144,5,144,149
10402,TOMINA,estado nutricional en menores de 5 anos,clasificacion d,2001-12-01,4,301,4,301,305
50502,TORO TORO,estado nutricional en menores de 5 anos,clasificacion d,2001-12-01,2,65,2,65,67
31201,TOTORA(CBBA),estado nutricional en menores de 5 anos,clasificacion d,2001-12-01,40,68,40,68,108
41301,TOTORA(ORR),estado nutricional en menores de 5 anos,clasificacion d,2001-12-01,0,22,0,22,22
70802,TRIGAL,estado nutricional en menores de 5 anos,clasificacion d,2001-12-01,3,1,3,1,4
80101,TRINIDAD,estado nutricional en menores de 5 anos,clasificacion d,2001-12-01,9,170,9,170,179
50801,TUPIZA,estado nutricional en menores de 5 anos,clasificacion d,2001-12-01,4,373,4,373,377
40402,TURCO,estado nutricional en menores de 5 anos,clasificacion d,2001-12-01,8,4,8,4,12
21302,UMALA,estado nutricional en menores de 5 anos,clasificacion d,2001-12-01,4,19,4,19,23
50201,UNCIA,estado nutricional en menores de 5 anos,clasificacion d,2001-12-01,0,64,0,64,64
60401,URIONDO (A. CONCEPCION),estado nutricional en menores de 5 anos,clasificacion d,2001-12-01,4,26,4,26,30
71502,URUBICHA,estado nutricional en menores de 5 anos,clasificacion d,2001-12-01,65,233,65,233,298
51201,UYUNI,estado nutricional en menores de 5 anos,clasificacion d,2001-12-01,3,76,3,76,79
30502,VACAS,estado nutricional en menores de 5 anos,clasificacion d,2001-12-01,2,20,2,20,22
70801,VALLEGRANDE,estado nutricional en menores de 5 anos,clasificacion d,2001-12-01,25,69,25,69,94
20801,VIACHA,estado nutricional en menores de 5 anos,clasificacion d,2001-12-01,10,148,10,148,158
31302,VILA VILA,estado nutricional en menores de 5 anos,clasificacion d,2001-12-01,0,80,0,80,80
60303,VILLA MONTES,estado nutricional en menores de 5 anos,clasificacion d,2001-12-01,43,59,43,59,102
90502,VILLA NUEVA (LOMA ALTA),estado nutricional en menores de 5 anos,clasificacion d,2001-12-01,2,0,2,0,2
31402,VILLA RIVERO,estado nutricional en menores de 5 anos,clasificacion d,2001-12-01,1,22,1,22,23
10801,VILLA SERRANO,estado nutricional en menores de 5 anos,clasificacion d,2001-12-01,2,259,2,259,261
31003,VILLA TUNARI,estado nutricional en menores de 5 anos,clasificacion d,2001-12-01,79,111,79,111,190
11001,VILLA VACA GUZMAN (MUYUPAMPA),estado nutricional en menores de 5 anos,clasificacion d,2001-12-01,2,147,2,147,149
51501,VILLAZON,estado nutricional en menores de 5 anos,clasificacion d,2001-12-01,3,280,3,280,283
30904,VINTO,estado nutricional en menores de 5 anos,clasificacion d,2001-12-01,34,12,34,12,46
50602,VITICHI,estado nutricional en menores de 5 anos,clasificacion d,2001-12-01,2,110,2,110,112
70201,WARNES,estado nutricional en menores de 5 anos,clasificacion d,2001-12-01,54,91,54,91,145
20903,YACO,estado nutricional en menores de 5 anos,clasificacion d,2001-12-01,0,13,0,13,13
60301,YACUIBA,estado nutricional en menores de 5 anos,clasificacion d,2001-12-01,64,40,64,40,104
10602,YAMPARAEZ,estado nutricional en menores de 5 anos,clasificacion d,2001-12-01,5,403,5,403,408
21103,YANACACHI,estado nutricional en menores de 5 anos,clasificacion d,2001-12-01,2,12,2,12,14
70403,YAPACANI,estado nutricional en menores de 5 anos,clasificacion d,2001-12-01,67,80,67,80,147
50103,YOCALLA,estado nutricional en menores de 5 anos,clasificacion d,2001-12-01,0,68,0,68,68
10102,YOTALA,estado nutricional en menores de 5 anos,clasificacion d,2001-12-01,2,304,2,304,306
60402,YUNCHARA,estado nutricional en menores de 5 anos,clasificacion d,2001-12-01,5,28,5,28,33
10301,ZUDAÃ‘EZ,estado nutricional en menores de 5 anos,clasificacion d,2001-12-01,6,206,6,206,212
51302,ACACIO,estado nutricional en menores de 5 anos,clasificacion d,2002-01-01,3,155,3,155,158
20201,ACHACACHI,estado nutricional en menores de 5 anos,clasificacion d,2002-01-01,11,128,11,128,139
20104,ACHOCALLA,estado nutricional en menores de 5 anos,clasificacion d,2002-01-01,7,26,7,26,33
30201,AIQUILE,estado nutricional en menores de 5 anos,clasificacion d,2002-01-01,5,11,5,11,16
31303,ALALAY,estado nutricional en menores de 5 anos,clasificacion d,2002-01-01,8,6,8,6,14
10404,ALCALA,estado nutricional en menores de 5 anos,clasificacion d,2002-01-01,4,114,4,114,118
20202,ANCORAIMES,estado nutricional en menores de 5 anos,clasificacion d,2002-01-01,3,222,3,222,225
41201,ANDAMARCA,estado nutricional en menores de 5 anos,clasificacion d,2002-01-01,3,1,3,1,4
40603,ANTEQUERA,estado nutricional en menores de 5 anos,clasificacion d,2002-01-01,4,11,4,11,15
30402,ANZALDO,estado nutricional en menores de 5 anos,clasificacion d,2002-01-01,2,40,2,40,42
20701,APOLO,estado nutricional en menores de 5 anos,clasificacion d,2002-01-01,16,3,16,3,19
51301,ARAMPAMPA,estado nutricional en menores de 5 anos,clasificacion d,2002-01-01,2,80,2,80,82
30501,ARANI,estado nutricional en menores de 5 anos,clasificacion d,2002-01-01,2,29,2,29,31
30403,ARBIETO,estado nutricional en menores de 5 anos,clasificacion d,2002-01-01,0,17,0,17,17
30601,ARQUE,estado nutricional en menores de 5 anos,clasificacion d,2002-01-01,13,2,13,2,15
50802,ATOCHA,estado nutricional en menores de 5 anos,clasificacion d,2002-01-01,0,44,0,44,44
20503,AUCAPATA,estado nutricional en menores de 5 anos,clasificacion d,2002-01-01,1,9,1,9,10
20502,AYATA,estado nutricional en menores de 5 anos,clasificacion d,2002-01-01,5,0,5,0,5
21303,AYO AYO,estado nutricional en menores de 5 anos,clasificacion d,2002-01-01,20,5,20,5,25
30301,AYOPAYA (V. DE INDEPENDENCIA),estado nutricional en menores de 5 anos,clasificacion d,2002-01-01,83,114,83,114,197
10201,AZURDUY,estado nutricional en menores de 5 anos,clasificacion d,2002-01-01,2,94,2,94,96
21203,BATALLAS,estado nutricional en menores de 5 anos,clasificacion d,2002-01-01,0,23,0,23,23
80802,BAURES,estado nutricional en menores de 5 anos,clasificacion d,2002-01-01,31,27,31,27,58
41202,BELEN DE ANDAMARCA,estado nutricional en menores de 5 anos,clasificacion d,2002-01-01,0,2,0,2,2
50104,BELEN DE URMIRI,estado nutricional en menores de 5 anos,clasificacion d,2002-01-01,0,16,0,16,16
90104,BELLA FLOR,estado nutricional en menores de 5 anos,clasificacion d,2002-01-01,1,0,1,0,1
60202,BERMEJO,estado nutricional en menores de 5 anos,clasificacion d,2002-01-01,0,19,0,19,19
50301,BETANZOS,estado nutricional en menores de 5 anos,clasificacion d,2002-01-01,38,424,38,424,462
31501,BOLIVAR,estado nutricional en menores de 5 anos,clasificacion d,2002-01-01,89,148,89,148,237
90103,BOLPEBRA,estado nutricional en menores de 5 anos,clasificacion d,2002-01-01,0,12,0,12,12
70707,BOYUIBE,estado nutricional en menores de 5 anos,clasificacion d,2002-01-01,1,34,1,34,35
70401,BUENA VISTA,estado nutricional en menores de 5 anos,clasificacion d,2002-01-01,41,54,41,54,95
70703,CABEZAS,estado nutricional en menores de 5 anos,clasificacion d,2002-01-01,3,60,3,60,63
20905,CAIROMA,estado nutricional en menores de 5 anos,clasificacion d,2002-01-01,0,36,0,36,36
51102,"CAIZA ""D""",estado nutricional en menores de 5 anos,clasificacion d,2002-01-01,12,92,12,92,104
21003,CAJUATA,estado nutricional en menores de 5 anos,clasificacion d,2002-01-01,13,23,13,23,36
20303,CALACOTO,estado nutricional en menores de 5 anos,clasificacion d,2002-01-01,4,1,4,1,5
21304,CALAMARCA,estado nutricional en menores de 5 anos,clasificacion d,2002-01-01,22,16,22,16,38
10701,CAMARGO,estado nutricional en menores de 5 anos,clasificacion d,2002-01-01,4,126,4,126,130
10901,CAMATAQUI (C. VILLA ABECIA),estado nutricional en menores de 5 anos,clasificacion d,2002-01-01,1,59,1,59,60
70706,CAMIRI,estado nutricional en menores de 5 anos,clasificacion d,2002-01-01,57,96,57,96,153
30701,CAPINOTA,estado nutricional en menores de 5 anos,clasificacion d,2002-01-01,40,34,40,34,74
20302,CAQUIAVIRI,estado nutricional en menores de 5 anos,clasificacion d,2002-01-01,19,26,19,26,45
40102,CARACOLLO,estado nutricional en menores de 5 anos,clasificacion d,2002-01-01,26,49,26,49,75
22001,CARANAVI,estado nutricional en menores de 5 anos,clasificacion d,2002-01-01,63,90,63,90,153
41503,CARANGAS,estado nutricional en menores de 5 anos,clasificacion d,2002-01-01,0,2,0,2,2
60302,CARAPARI,estado nutricional en menores de 5 anos,clasificacion d,2002-01-01,24,46,24,46,70
50702,CARIPUYO,estado nutricional en menores de 5 anos,clasificacion d,2002-01-01,3,158,3,158,161
21902,CATACORA,estado nutricional en menores de 5 anos,clasificacion d,2002-01-01,1,7,1,7,8
40201,CHALLAPATA,estado nutricional en menores de 5 anos,clasificacion d,2002-01-01,27,68,27,68,95
50302,CHAQUI,estado nutricional en menores de 5 anos,clasificacion d,2002-01-01,0,113,0,113,113
70702,CHARAGUA,estado nutricional en menores de 5 anos,clasificacion d,2002-01-01,4,299,4,299,303
20305,CHARAÃ‘A,estado nutricional en menores de 5 anos,clasificacion d,2002-01-01,0,5,0,5,5
31204,CHIMORE,estado nutricional en menores de 5 anos,clasificacion d,2002-01-01,18,49,18,49,67
21101,CHULUMANI (V. DE LA LIBERTAD),estado nutricional en menores de 5 anos,clasificacion d,2002-01-01,2,22,2,22,24
20501,CHUMA,estado nutricional en menores de 5 anos,clasificacion d,2002-01-01,1,1,1,1,2
30801,CLIZA,estado nutricional en menores de 5 anos,clasificacion d,2002-01-01,4,27,4,27,31
90101,COBIJA,estado nutricional en menores de 5 anos,clasificacion d,2002-01-01,89,46,89,46,135
30101,COCHABAMBA,estado nutricional en menores de 5 anos,clasificacion d,2002-01-01,389,328,389,328,717
30905,COLCAPIRHUA,estado nutricional en menores de 5 anos,clasificacion d,2002-01-01,53,69,53,69,122
50901,"COLCHA ""K""",estado nutricional en menores de 5 anos,clasificacion d,2002-01-01,4,66,4,66,70
21307,COLLANA,estado nutricional en menores de 5 anos,clasificacion d,2002-01-01,1,0,1,0,1
31002,COLOMI,estado nutricional en menores de 5 anos,clasificacion d,2002-01-01,19,35,19,35,54
50401,COLQUECHACA,estado nutricional en menores de 5 anos,clasificacion d,2002-01-01,38,141,38,141,179
21306,COLQUENCHA,estado nutricional en menores de 5 anos,clasificacion d,2002-01-01,18,5,18,5,23
21004,COLQUIRI,estado nutricional en menores de 5 anos,clasificacion d,2002-01-01,36,46,36,46,82
20304,COMANCHE,estado nutricional en menores de 5 anos,clasificacion d,2002-01-01,6,16,6,16,22
71301,COMARAPA,estado nutricional en menores de 5 anos,clasificacion d,2002-01-01,20,39,20,39,59
20605,COMBAYA,estado nutricional en menores de 5 anos,clasificacion d,2002-01-01,0,28,0,28,28
71101,CONCEPCION,estado nutricional en menores de 5 anos,clasificacion d,2002-01-01,3,24,3,24,27
21701,COPACABANA,estado nutricional en menores de 5 anos,clasificacion d,2002-01-01,5,55,5,55,60
21402,CORIPATA,estado nutricional en menores de 5 anos,clasificacion d,2002-01-01,5,6,5,6,11
20301,CORO CORO,estado nutricional en menores de 5 anos,clasificacion d,2002-01-01,22,26,22,26,48
21401,COROICO,estado nutricional en menores de 5 anos,clasificacion d,2002-01-01,16,28,16,28,44
40301,CORQUE,estado nutricional en menores de 5 anos,clasificacion d,2002-01-01,8,14,8,14,22
50601,COTAGAITA,estado nutricional en menores de 5 anos,clasificacion d,2002-01-01,13,154,13,154,167
70102,COTOCA,estado nutricional en menores de 5 anos,clasificacion d,2002-01-01,37,57,37,57,94
31405,CUCHUMUELA (V. G. VILLARROEL),estado nutricional en menores de 5 anos,clasificacion d,2002-01-01,0,4,0,4,4
70704,CUEVO,estado nutricional en menores de 5 anos,clasificacion d,2002-01-01,31,33,31,33,64
10902,CULPINA,estado nutricional en menores de 5 anos,clasificacion d,2002-01-01,6,237,6,237,243
40401,CURAHUARA DE CARANGAS,estado nutricional en menores de 5 anos,clasificacion d,2002-01-01,16,10,16,10,26
21602,CURVA,estado nutricional en menores de 5 anos,clasificacion d,2002-01-01,5,2,5,2,7
20804,DESAGUADERO,estado nutricional en menores de 5 anos,clasificacion d,2002-01-01,1,12,1,12,13
20105,EL ALTO,estado nutricional en menores de 5 anos,clasificacion d,2002-01-01,1290,1245,1290,1245,2535
40103,EL CHORO,estado nutricional en menores de 5 anos,clasificacion d,2002-01-01,0,1,0,1,1
71503,EL PUENTE(STC),estado nutricional en menores de 5 anos,clasificacion d,2002-01-01,7,72,7,72,79
60502,EL PUENTE(TJA),estado nutricional en menores de 5 anos,clasificacion d,2002-01-01,6,32,6,32,38
70105,EL TORNO,estado nutricional en menores de 5 anos,clasificacion d,2002-01-01,52,94,52,94,146
10405,EL VILLAR,estado nutricional en menores de 5 anos,clasificacion d,2002-01-01,1,147,1,147,148
60601,ENTRE RIOS,estado nutricional en menores de 5 anos,clasificacion d,2002-01-01,28,85,28,85,113
41101,EUCALIPTUS,estado nutricional en menores de 5 anos,clasificacion d,2002-01-01,0,6,0,6,6
80402,EXALTACION,estado nutricional en menores de 5 anos,clasificacion d,2002-01-01,12,25,12,25,37
90203,FILADELFIA,estado nutricional en menores de 5 anos,clasificacion d,2002-01-01,6,10,6,10,16
71002,GENERAL SAAVEDRA,estado nutricional en menores de 5 anos,clasificacion d,2002-01-01,40,165,40,165,205
21601,GRAL. J.J. PEREZ (CHARAZANI),estado nutricional en menores de 5 anos,clasificacion d,2002-01-01,8,19,8,19,27
20602,GUANAY,estado nutricional en menores de 5 anos,clasificacion d,2002-01-01,10,153,10,153,163
20802,GUAQUI,estado nutricional en menores de 5 anos,clasificacion d,2002-01-01,2,7,2,7,9
80202,GUAYARAMERIN,estado nutricional en menores de 5 anos,clasificacion d,2002-01-01,62,91,62,91,153
70705,GUTIERREZ,estado nutricional en menores de 5 anos,clasificacion d,2002-01-01,22,250,22,250,272
10502,HUACARETA,estado nutricional en menores de 5 anos,clasificacion d,2002-01-01,7,169,7,169,176
11002,HUACAYA (VILLA DE HUACAYA),estado nutricional en menores de 5 anos,clasificacion d,2002-01-01,0,22,0,22,22
40501,HUACHACALLA,estado nutricional en menores de 5 anos,clasificacion d,2002-01-01,0,12,0,12,12
40701,HUANUNI,estado nutricional en menores de 5 anos,clasificacion d,2002-01-01,3,10,3,10,13
80803,HUARACAJE,estado nutricional en menores de 5 anos,clasificacion d,2002-01-01,5,7,5,7,12
41601,HUAYLLAMARCA,estado nutricional en menores de 5 anos,clasificacion d,2002-01-01,13,38,13,38,51
21005,ICHOCA,estado nutricional en menores de 5 anos,clasificacion d,2002-01-01,5,17,5,17,22
10304,ICLA,estado nutricional en menores de 5 anos,clasificacion d,2002-01-01,167,261,167,261,428
10703,INCAHUASI,estado nutricional en menores de 5 anos,clasificacion d,2002-01-01,2,102,2,102,104
21001,INQUISIVI,estado nutricional en menores de 5 anos,clasificacion d,2002-01-01,10,53,10,53,63
21102,IRUPANA (VILLA DE LANZA),estado nutricional en menores de 5 anos,clasificacion d,2002-01-01,3,43,3,43,46
21501,IXIAMAS,estado nutricional en menores de 5 anos,clasificacion d,2002-01-01,14,17,14,17,31
21105,LA ASUNTA,estado nutricional en menores de 5 anos,clasificacion d,2002-01-01,26,59,26,59,85
70104,LA GUARDIA,estado nutricional en menores de 5 anos,clasificacion d,2002-01-01,66,116,66,116,182
20101,LA PAZ,estado nutricional en menores de 5 anos,clasificacion d,2002-01-01,853,946,853,946,1799
41501,LA RIVERA,estado nutricional en menores de 5 anos,clasificacion d,2002-01-01,1,0,1,0,1
70701,LAGUNILLAS,estado nutricional en menores de 5 anos,clasificacion d,2002-01-01,35,51,35,51,86
21202,LAJA,estado nutricional en menores de 5 anos,clasificacion d,2002-01-01,0,32,0,32,32
10903,LAS CARRERAS,estado nutricional en menores de 5 anos,clasificacion d,2002-01-01,0,37,0,37,37
51401,LLICA,estado nutricional en menores de 5 anos,clasificacion d,2002-01-01,0,20,0,20,20
80601,LORETO,estado nutricional en menores de 5 anos,clasificacion d,2002-01-01,0,12,0,12,12
20901,LURIBAY,estado nutricional en menores de 5 anos,clasificacion d,2002-01-01,0,17,0,17,17
40702,MACHACAMARCA,estado nutricional en menores de 5 anos,clasificacion d,2002-01-01,11,13,11,13,24
11003,MACHARETI,estado nutricional en menores de 5 anos,clasificacion d,2002-01-01,1,142,1,142,143
80801,MAGDALENA,estado nutricional en menores de 5 anos,clasificacion d,2002-01-01,20,57,20,57,77
70903,MAIRANA,estado nutricional en menores de 5 anos,clasificacion d,2002-01-01,28,24,28,24,52
20103,MECAPACA,estado nutricional en menores de 5 anos,clasificacion d,2002-01-01,0,22,0,22,22
71003,MINEROS,estado nutricional en menores de 5 anos,clasificacion d,2002-01-01,14,191,14,191,205
31301,MIZQUE,estado nutricional en menores de 5 anos,clasificacion d,2002-01-01,9,20,9,20,29
20402,MOCOMOCO,estado nutricional en menores de 5 anos,clasificacion d,2002-01-01,13,17,13,17,30
51002,MOJINETE,estado nutricional en menores de 5 anos,clasificacion d,2002-01-01,2,15,2,15,17
10303,MOJOCOYA,estado nutricional en menores de 5 anos,clasificacion d,2002-01-01,73,114,73,114,187
10501,MONTEAGUDO,estado nutricional en menores de 5 anos,clasificacion d,2002-01-01,29,194,29,194,223
71001,MONTERO,estado nutricional en menores de 5 anos,clasificacion d,2002-01-01,13,560,13,560,573
70803,MORO MORO,estado nutricional en menores de 5 anos,clasificacion d,2002-01-01,13,12,13,12,25
30302,MOROCHATA,estado nutricional en menores de 5 anos,clasificacion d,2002-01-01,7,15,7,15,22
90401,NACEBE (SANTA ROSA DEL ABUNA),estado nutricional en menores de 5 anos,clasificacion d,2002-01-01,0,1,0,1,1
20307,NAZACARA DE PACAJES,estado nutricional en menores de 5 anos,clasificacion d,2002-01-01,4,0,4,0,4
50404,OCURI,estado nutricional en menores de 5 anos,clasificacion d,2002-01-01,43,70,43,70,113
70202,OKINAWA,estado nutricional en menores de 5 anos,clasificacion d,2002-01-01,2,7,2,7,9
30203,OMEREQUE,estado nutricional en menores de 5 anos,clasificacion d,2002-01-01,1,0,1,0,1
40101,ORURO,estado nutricional en menores de 5 anos,clasificacion d,2002-01-01,80,789,80,789,869
60201,PADCAYA,estado nutricional en menores de 5 anos,clasificacion d,2002-01-01,11,46,11,46,57
10401,PADILLA,estado nutricional en menores de 5 anos,clasificacion d,2002-01-01,8,414,8,414,422
70502,PAILON,estado nutricional en menores de 5 anos,clasificacion d,2002-01-01,4,71,4,71,75
20102,PALCA,estado nutricional en menores de 5 anos,clasificacion d,2002-01-01,22,22,22,22,44
21104,PALOS BLANCOS,estado nutricional en menores de 5 anos,clasificacion d,2002-01-01,43,84,43,84,127
40802,PAMPA AULLAGAS,estado nutricional en menores de 5 anos,clasificacion d,2002-01-01,12,19,12,19,31
70902,PAMPA GRANDE,estado nutricional en menores de 5 anos,clasificacion d,2002-01-01,10,15,10,15,25
21802,PAPEL PAMPA,estado nutricional en menores de 5 anos,clasificacion d,2002-01-01,3,2,3,2,5
30202,PASORAPA,estado nutricional en menores de 5 anos,clasificacion d,2002-01-01,6,6,6,6,12
21305,PATACAMAYA,estado nutricional en menores de 5 anos,clasificacion d,2002-01-01,21,23,21,23,44
40602,PAZÃ‘A,estado nutricional en menores de 5 anos,clasificacion d,2002-01-01,4,42,4,42,46
20702,PELECHUCO,estado nutricional en menores de 5 anos,clasificacion d,2002-01-01,8,49,8,49,57
50403,POCOATA,estado nutricional en menores de 5 anos,clasificacion d,2002-01-01,68,185,68,185,253
31203,POCONA,estado nutricional en menores de 5 anos,clasificacion d,2002-01-01,1,46,1,46,47
31202,POJO (CBBA),estado nutricional en menores de 5 anos,clasificacion d,2002-01-01,48,128,48,128,176
40601,POOPO,estado nutricional en menores de 5 anos,clasificacion d,2002-01-01,1,45,1,45,46
51203,PORCO,estado nutricional en menores de 5 anos,clasificacion d,2002-01-01,12,14,12,14,26
10103,POROMA,estado nutricional en menores de 5 anos,clasificacion d,2002-01-01,46,142,46,142,188
70103,PORONGO,estado nutricional en menores de 5 anos,clasificacion d,2002-01-01,1,43,1,43,44
70601,PORTACHUELO,estado nutricional en menores de 5 anos,clasificacion d,2002-01-01,55,28,55,28,83
90102,PORVENIR,estado nutricional en menores de 5 anos,clasificacion d,2002-01-01,1,30,1,30,31
70804,POSTRER VALLE,estado nutricional en menores de 5 anos,clasificacion d,2002-01-01,0,4,0,4,4
50101,POTOSI,estado nutricional en menores de 5 anos,clasificacion d,2002-01-01,102,484,102,484,586
10302,PRESTO,estado nutricional en menores de 5 anos,clasificacion d,2002-01-01,66,76,66,76,142
21201,PUCARANI,estado nutricional en menores de 5 anos,clasificacion d,2002-01-01,1,24,1,24,25
20401,PUERTO ACOSTA,estado nutricional en menores de 5 anos,clasificacion d,2002-01-01,42,61,42,61,103
20403,PUERTO CARABUCO,estado nutricional en menores de 5 anos,clasificacion d,2002-01-01,39,60,39,60,99
90301,PUERTO GONZALO MORENO,estado nutricional en menores de 5 anos,clasificacion d,2002-01-01,1,7,1,7,8
21204,PUERTO PEREZ,estado nutricional en menores de 5 anos,clasificacion d,2002-01-01,5,12,5,12,17
71402,PUERTO QUIJARRO,estado nutricional en menores de 5 anos,clasificacion d,2002-01-01,47,13,47,13,60
90201,PUERTO RICO,estado nutricional en menores de 5 anos,clasificacion d,2002-01-01,2,26,2,26,28
80703,PUERTO SILES,estado nutricional en menores de 5 anos,clasificacion d,2002-01-01,0,2,0,2,2
71401,PUERTO SUAREZ,estado nutricional en menores de 5 anos,clasificacion d,2002-01-01,89,30,89,30,119
31205,PUERTO VILLARROEL,estado nutricional en menores de 5 anos,clasificacion d,2002-01-01,168,173,168,173,341
51101,PUNA,estado nutricional en menores de 5 anos,clasificacion d,2002-01-01,4,244,4,244,248
31401,PUNATA,estado nutricional en menores de 5 anos,clasificacion d,2002-01-01,0,13,0,13,13
20604,QUIABAYA,estado nutricional en menores de 5 anos,clasificacion d,2002-01-01,0,17,0,17,17
30901,QUILLACOLLO,estado nutricional en menores de 5 anos,clasificacion d,2002-01-01,17,14,17,14,31
21002,QUIME,estado nutricional en menores de 5 anos,clasificacion d,2002-01-01,15,43,15,43,58
50402,RAVELO,estado nutricional en menores de 5 anos,clasificacion d,2002-01-01,29,245,29,245,274
80301,REYES,estado nutricional en menores de 5 anos,clasificacion d,2002-01-01,21,38,21,38,59
80201,RIBERALTA,estado nutricional en menores de 5 anos,clasificacion d,2002-01-01,301,264,301,264,565
70503,ROBORE,estado nutricional en menores de 5 anos,clasificacion d,2002-01-01,3,60,3,60,63
80304,RURRENABAQUE,estado nutricional en menores de 5 anos,clasificacion d,2002-01-01,27,18,27,18,45
40901,SABAYA,estado nutricional en menores de 5 anos,clasificacion d,2002-01-01,0,6,0,6,6
31001,SACABA,estado nutricional en menores de 5 anos,clasificacion d,2002-01-01,42,85,42,85,127
30404,SACABAMBA,estado nutricional en menores de 5 anos,clasificacion d,2002-01-01,0,31,0,31,31
50701,SACACA,estado nutricional en menores de 5 anos,clasificacion d,2002-01-01,42,249,42,249,291
71302,SAIPINA,estado nutricional en menores de 5 anos,clasificacion d,2002-01-01,29,9,29,9,38
40801,SALINAS DE GARCI MENDOZA,estado nutricional en menores de 5 anos,clasificacion d,2002-01-01,9,5,9,5,14
70901,SAMAIPATA,estado nutricional en menores de 5 anos,clasificacion d,2002-01-01,28,17,28,17,45
51601,SAN AGUSTIN,estado nutricional en menores de 5 anos,clasificacion d,2002-01-01,0,7,0,7,7
71105,SAN ANTONIO DE LOMERIO,estado nutricional en menores de 5 anos,clasificacion d,2002-01-01,59,133,59,133,192
31403,SAN BENITO,estado nutricional en menores de 5 anos,clasificacion d,2002-01-01,1,12,1,12,13
80302,SAN BORJA,estado nutricional en menores de 5 anos,clasificacion d,2002-01-01,66,82,66,82,148
21502,SAN BUENA VENTURA,estado nutricional en menores de 5 anos,clasificacion d,2002-01-01,34,39,34,39,73
70402,SAN CARLOS,estado nutricional en menores de 5 anos,clasificacion d,2002-01-01,0,5,0,5,5
80501,SAN IGNACIO,estado nutricional en menores de 5 anos,clasificacion d,2002-01-01,20,127,20,127,147
70301,SAN IGNACIO DE VELASCO,estado nutricional en menores de 5 anos,clasificacion d,2002-01-01,191,178,191,178,369
80102,SAN JAVIER(BNI),estado nutricional en menores de 5 anos,clasificacion d,2002-01-01,0,14,0,14,14
71102,SAN JAVIER(STC),estado nutricional en menores de 5 anos,clasificacion d,2002-01-01,26,15,26,15,41
80701,SAN JOAQUIN,estado nutricional en menores de 5 anos,clasificacion d,2002-01-01,0,9,0,9,9
70501,SAN JOSE DE CHIQUITOS,estado nutricional en menores de 5 anos,clasificacion d,2002-01-01,57,19,57,19,76
71104,SAN JULIAN,estado nutricional en menores de 5 anos,clasificacion d,2002-01-01,69,192,69,192,261
90302,SAN LORENZO(PND),estado nutricional en menores de 5 anos,clasificacion d,2002-01-01,0,4,0,4,4
60501,SAN LORENZO(TJA),estado nutricional en menores de 5 anos,clasificacion d,2002-01-01,31,25,31,25,56
10702,SAN LUCAS,estado nutricional en menores de 5 anos,clasificacion d,2002-01-01,10,540,10,540,550
71201,SAN MATIAS,estado nutricional en menores de 5 anos,clasificacion d,2002-01-01,61,55,61,55,116
70302,SAN MIGUEL DE VELASCO,estado nutricional en menores de 5 anos,clasificacion d,2002-01-01,46,139,46,139,185
51001,SAN PABLO DE LIPEZ,estado nutricional en menores de 5 anos,clasificacion d,2002-01-01,1,19,1,19,20
50501,SAN PEDRO DE BUENA VISTA,estado nutricional en menores de 5 anos,clasificacion d,2002-01-01,0,76,0,76,76
21801,SAN PEDRO DE CURAHUARA,estado nutricional en menores de 5 anos,clasificacion d,2002-01-01,0,27,0,27,27
50902,SAN PEDRO DE QUEMES,estado nutricional en menores de 5 anos,clasificacion d,2002-01-01,0,5,0,5,5
21702,SAN PEDRO DE TIQUINA,estado nutricional en menores de 5 anos,clasificacion d,2002-01-01,0,13,0,13,13
90202,SAN PEDRO(PND),estado nutricional en menores de 5 anos,clasificacion d,2002-01-01,2,1,2,1,3
70303,SAN RAFAEL,estado nutricional en menores de 5 anos,clasificacion d,2002-01-01,29,17,29,17,46
80702,SAN RAMON,estado nutricional en menores de 5 anos,clasificacion d,2002-01-01,1,2,1,2,3
80702,SAN RAMON,estado nutricional en menores de 5 anos,clasificacion d,2002-01-01,0,16,0,16,16
80401,SANTA ANA,estado nutricional en menores de 5 anos,clasificacion d,2002-01-01,19,13,19,13,32
70101,SANTA CRUZ DE LA SIERRA,estado nutricional en menores de 5 anos,clasificacion d,2002-01-01,291,363,291,363,654
80303,SANTA ROSA,estado nutricional en menores de 5 anos,clasificacion d,2002-01-01,13,4,13,4,17
70602,SANTA ROSA DEL SARA,estado nutricional en menores de 5 anos,clasificacion d,2002-01-01,7,29,7,29,36
20308,SANTIAGO DE CALLAPA,estado nutricional en menores de 5 anos,clasificacion d,2002-01-01,0,4,0,4,4
41401,SANTIAGO DE HUARI,estado nutricional en menores de 5 anos,clasificacion d,2002-01-01,10,26,10,26,36
21901,SANTIAGO DE MACHACA,estado nutricional en menores de 5 anos,clasificacion d,2002-01-01,3,9,3,9,12
30702,SANTIVAÃ‘ES,estado nutricional en menores de 5 anos,clasificacion d,2002-01-01,24,21,24,21,45
40202,SANTUARIO DE QUILLACAS,estado nutricional en menores de 5 anos,clasificacion d,2002-01-01,3,16,3,16,19
20902,SAPAHAQUI,estado nutricional en menores de 5 anos,clasificacion d,2002-01-01,2,21,2,21,23
90303,SENA,estado nutricional en menores de 5 anos,clasificacion d,2002-01-01,0,10,0,10,10
21301,SICA SICA (VILLA AROMA),estado nutricional en menores de 5 anos,clasificacion d,2002-01-01,24,20,24,20,44
30703,SICAYA,estado nutricional en menores de 5 anos,clasificacion d,2002-01-01,1,29,1,29,30
30902,SIPE SIPE,estado nutricional en menores de 5 anos,clasificacion d,2002-01-01,122,128,122,128,250
10403,SOPACHUY,estado nutricional en menores de 5 anos,clasificacion d,2002-01-01,2,114,2,114,116
20601,SORATA,estado nutricional en menores de 5 anos,clasificacion d,2002-01-01,4,55,4,55,59
10101,SUCRE,estado nutricional en menores de 5 anos,clasificacion d,2002-01-01,69,1053,69,1053,1122
31404,TACACHI,estado nutricional en menores de 5 anos,clasificacion d,2002-01-01,1,10,1,10,11
20603,TACACOMA,estado nutricional en menores de 5 anos,clasificacion d,2002-01-01,1,36,1,36,37
50303,TACOBAMBA,estado nutricional en menores de 5 anos,clasificacion d,2002-01-01,8,94,8,94,102
30602,TACOPAYA,estado nutricional en menores de 5 anos,clasificacion d,2002-01-01,41,73,41,73,114
51402,TAHUA,estado nutricional en menores de 5 anos,clasificacion d,2002-01-01,1,5,1,5,6
31101,TAPACARI,estado nutricional en menores de 5 anos,clasificacion d,2002-01-01,2,52,2,52,54
10601,TARABUCO,estado nutricional en menores de 5 anos,clasificacion d,2002-01-01,7,723,7,723,730
30401,TARATA,estado nutricional en menores de 5 anos,clasificacion d,2002-01-01,6,41,6,41,47
60101,TARIJA,estado nutricional en menores de 5 anos,clasificacion d,2002-01-01,58,222,58,222,280
10202,TARVITA,estado nutricional en menores de 5 anos,clasificacion d,2002-01-01,62,72,62,72,134
20803,TIAWANACU,estado nutricional en menores de 5 anos,clasificacion d,2002-01-01,12,11,12,11,23
50102,TINGUIPAYA,estado nutricional en menores de 5 anos,clasificacion d,2002-01-01,14,56,14,56,70
20606,TIPUANI,estado nutricional en menores de 5 anos,clasificacion d,2002-01-01,7,5,7,5,12
30903,TIQUIPAYA,estado nutricional en menores de 5 anos,clasificacion d,2002-01-01,1,40,1,40,41
31601,TIRAQUE (CBBA),estado nutricional en menores de 5 anos,clasificacion d,2002-01-01,63,176,63,176,239
21703,TITO YUPANQUI (PARQUIPUJIO),estado nutricional en menores de 5 anos,clasificacion d,2002-01-01,0,23,0,23,23
30802,TOCO,estado nutricional en menores de 5 anos,clasificacion d,2002-01-01,0,1,0,1,1
30803,TOLATA,estado nutricional en menores de 5 anos,clasificacion d,2002-01-01,0,4,0,4,4
41001,TOLEDO,estado nutricional en menores de 5 anos,clasificacion d,2002-01-01,13,1,13,1,14
51202,TOMAVE,estado nutricional en menores de 5 anos,clasificacion d,2002-01-01,3,143,3,143,146
10402,TOMINA,estado nutricional en menores de 5 anos,clasificacion d,2002-01-01,43,243,43,243,286
50502,TORO TORO,estado nutricional en menores de 5 anos,clasificacion d,2002-01-01,1,24,1,24,25
31201,TOTORA(CBBA),estado nutricional en menores de 5 anos,clasificacion d,2002-01-01,21,30,21,30,51
41301,TOTORA(ORR),estado nutricional en menores de 5 anos,clasificacion d,2002-01-01,0,13,0,13,13
70802,TRIGAL,estado nutricional en menores de 5 anos,clasificacion d,2002-01-01,3,7,3,7,10
80101,TRINIDAD,estado nutricional en menores de 5 anos,clasificacion d,2002-01-01,25,187,25,187,212
50801,TUPIZA,estado nutricional en menores de 5 anos,clasificacion d,2002-01-01,5,389,5,389,394
40402,TURCO,estado nutricional en menores de 5 anos,clasificacion d,2002-01-01,14,11,14,11,25
21302,UMALA,estado nutricional en menores de 5 anos,clasificacion d,2002-01-01,0,8,0,8,8
50201,UNCIA,estado nutricional en menores de 5 anos,clasificacion d,2002-01-01,0,24,0,24,24
60401,URIONDO (A. CONCEPCION),estado nutricional en menores de 5 anos,clasificacion d,2002-01-01,14,19,14,19,33
71502,URUBICHA,estado nutricional en menores de 5 anos,clasificacion d,2002-01-01,0,20,0,20,20
51201,UYUNI,estado nutricional en menores de 5 anos,clasificacion d,2002-01-01,5,74,5,74,79
30502,VACAS,estado nutricional en menores de 5 anos,clasificacion d,2002-01-01,3,22,3,22,25
70801,VALLEGRANDE,estado nutricional en menores de 5 anos,clasificacion d,2002-01-01,37,112,37,112,149
20801,VIACHA,estado nutricional en menores de 5 anos,clasificacion d,2002-01-01,17,135,17,135,152
31302,VILA VILA,estado nutricional en menores de 5 anos,clasificacion d,2002-01-01,3,8,3,8,11
60303,VILLA MONTES,estado nutricional en menores de 5 anos,clasificacion d,2002-01-01,67,62,67,62,129
31402,VILLA RIVERO,estado nutricional en menores de 5 anos,clasificacion d,2002-01-01,1,5,1,5,6
10801,VILLA SERRANO,estado nutricional en menores de 5 anos,clasificacion d,2002-01-01,1,266,1,266,267
31003,VILLA TUNARI,estado nutricional en menores de 5 anos,clasificacion d,2002-01-01,72,112,72,112,184
11001,VILLA VACA GUZMAN (MUYUPAMPA),estado nutricional en menores de 5 anos,clasificacion d,2002-01-01,0,133,0,133,133
51501,VILLAZON,estado nutricional en menores de 5 anos,clasificacion d,2002-01-01,2,209,2,209,211
30904,VINTO,estado nutricional en menores de 5 anos,clasificacion d,2002-01-01,17,98,17,98,115
50602,VITICHI,estado nutricional en menores de 5 anos,clasificacion d,2002-01-01,15,66,15,66,81
20306,WALDO BALLIVIAN,estado nutricional en menores de 5 anos,clasificacion d,2002-01-01,0,4,0,4,4
70201,WARNES,estado nutricional en menores de 5 anos,clasificacion d,2002-01-01,101,157,101,157,258
20903,YACO,estado nutricional en menores de 5 anos,clasificacion d,2002-01-01,1,31,1,31,32
60301,YACUIBA,estado nutricional en menores de 5 anos,clasificacion d,2002-01-01,43,33,43,33,76
10602,YAMPARAEZ,estado nutricional en menores de 5 anos,clasificacion d,2002-01-01,138,293,138,293,431
21103,YANACACHI,estado nutricional en menores de 5 anos,clasificacion d,2002-01-01,14,9,14,9,23
70403,YAPACANI,estado nutricional en menores de 5 anos,clasificacion d,2002-01-01,101,103,101,103,204
50103,YOCALLA,estado nutricional en menores de 5 anos,clasificacion d,2002-01-01,3,50,3,50,53
10102,YOTALA,estado nutricional en menores de 5 anos,clasificacion d,2002-01-01,73,169,73,169,242
60402,YUNCHARA,estado nutricional en menores de 5 anos,clasificacion d,2002-01-01,8,32,8,32,40
10301,ZUDAÃ‘EZ,estado nutricional en menores de 5 anos,clasificacion d,2002-01-01,71,130,71,130,201
51302,ACACIO,estado nutricional en menores de 5 anos,clasificacion d,2002-02-01,2,110,2,110,112
20201,ACHACACHI,estado nutricional en menores de 5 anos,clasificacion d,2002-02-01,65,130,65,130,195
20104,ACHOCALLA,estado nutricional en menores de 5 anos,clasificacion d,2002-02-01,1,9,1,9,10
30201,AIQUILE,estado nutricional en menores de 5 anos,clasificacion d,2002-02-01,8,15,8,15,23
31303,ALALAY,estado nutricional en menores de 5 anos,clasificacion d,2002-02-01,0,9,0,9,9
10404,ALCALA,estado nutricional en menores de 5 anos,clasificacion d,2002-02-01,30,47,30,47,77
20202,ANCORAIMES,estado nutricional en menores de 5 anos,clasificacion d,2002-02-01,44,67,44,67,111
41201,ANDAMARCA,estado nutricional en menores de 5 anos,clasificacion d,2002-02-01,9,4,9,4,13
40603,ANTEQUERA,estado nutricional en menores de 5 anos,clasificacion d,2002-02-01,0,1,0,1,1
30402,ANZALDO,estado nutricional en menores de 5 anos,clasificacion d,2002-02-01,1,28,1,28,29
20701,APOLO,estado nutricional en menores de 5 anos,clasificacion d,2002-02-01,12,4,12,4,16
51301,ARAMPAMPA,estado nutricional en menores de 5 anos,clasificacion d,2002-02-01,14,76,14,76,90
30501,ARANI,estado nutricional en menores de 5 anos,clasificacion d,2002-02-01,0,13,0,13,13
30403,ARBIETO,estado nutricional en menores de 5 anos,clasificacion d,2002-02-01,0,12,0,12,12
30601,ARQUE,estado nutricional en menores de 5 anos,clasificacion d,2002-02-01,3,20,3,20,23
71501,ASCENCION DE GUARAYOS,estado nutricional en menores de 5 anos,clasificacion d,2002-02-01,169,277,169,277,446
50802,ATOCHA,estado nutricional en menores de 5 anos,clasificacion d,2002-02-01,5,67,5,67,72
20503,AUCAPATA,estado nutricional en menores de 5 anos,clasificacion d,2002-02-01,0,1,0,1,1
20502,AYATA,estado nutricional en menores de 5 anos,clasificacion d,2002-02-01,1,1,1,1,2
21303,AYO AYO,estado nutricional en menores de 5 anos,clasificacion d,2002-02-01,18,7,18,7,25
30301,AYOPAYA (V. DE INDEPENDENCIA),estado nutricional en menores de 5 anos,clasificacion d,2002-02-01,68,86,68,86,154
10201,AZURDUY,estado nutricional en menores de 5 anos,clasificacion d,2002-02-01,29,119,29,119,148
21203,BATALLAS,estado nutricional en menores de 5 anos,clasificacion d,2002-02-01,1,39,1,39,40
80802,BAURES,estado nutricional en menores de 5 anos,clasificacion d,2002-02-01,21,24,21,24,45
41202,BELEN DE ANDAMARCA,estado nutricional en menores de 5 anos,clasificacion d,2002-02-01,0,1,0,1,1
50104,BELEN DE URMIRI,estado nutricional en menores de 5 anos,clasificacion d,2002-02-01,1,10,1,10,11
90104,BELLA FLOR,estado nutricional en menores de 5 anos,clasificacion d,2002-02-01,1,0,1,0,1
60202,BERMEJO,estado nutricional en menores de 5 anos,clasificacion d,2002-02-01,0,11,0,11,11
50301,BETANZOS,estado nutricional en menores de 5 anos,clasificacion d,2002-02-01,29,181,29,181,210
31501,BOLIVAR,estado nutricional en menores de 5 anos,clasificacion d,2002-02-01,19,31,19,31,50
90103,BOLPEBRA,estado nutricional en menores de 5 anos,clasificacion d,2002-02-01,0,3,0,3,3
70707,BOYUIBE,estado nutricional en menores de 5 anos,clasificacion d,2002-02-01,0,22,0,22,22
70401,BUENA VISTA,estado nutricional en menores de 5 anos,clasificacion d,2002-02-01,55,75,55,75,130
70703,CABEZAS,estado nutricional en menores de 5 anos,clasificacion d,2002-02-01,2,70,2,70,72
20905,CAIROMA,estado nutricional en menores de 5 anos,clasificacion d,2002-02-01,0,4,0,4,4
51102,"CAIZA ""D""",estado nutricional en menores de 5 anos,clasificacion d,2002-02-01,10,139,10,139,149
21003,CAJUATA,estado nutricional en menores de 5 anos,clasificacion d,2002-02-01,7,21,7,21,28
20303,CALACOTO,estado nutricional en menores de 5 anos,clasificacion d,2002-02-01,1,12,1,12,13
21304,CALAMARCA,estado nutricional en menores de 5 anos,clasificacion d,2002-02-01,12,8,12,8,20
10701,CAMARGO,estado nutricional en menores de 5 anos,clasificacion d,2002-02-01,4,67,4,67,71
10901,CAMATAQUI (C. VILLA ABECIA),estado nutricional en menores de 5 anos,clasificacion d,2002-02-01,1,10,1,10,11
70706,CAMIRI,estado nutricional en menores de 5 anos,clasificacion d,2002-02-01,47,126,47,126,173
30701,CAPINOTA,estado nutricional en menores de 5 anos,clasificacion d,2002-02-01,28,14,28,14,42
20302,CAQUIAVIRI,estado nutricional en menores de 5 anos,clasificacion d,2002-02-01,12,23,12,23,35
40102,CARACOLLO,estado nutricional en menores de 5 anos,clasificacion d,2002-02-01,41,38,41,38,79
22001,CARANAVI,estado nutricional en menores de 5 anos,clasificacion d,2002-02-01,109,80,109,80,189
60302,CARAPARI,estado nutricional en menores de 5 anos,clasificacion d,2002-02-01,15,40,15,40,55
50702,CARIPUYO,estado nutricional en menores de 5 anos,clasificacion d,2002-02-01,1,54,1,54,55
21902,CATACORA,estado nutricional en menores de 5 anos,clasificacion d,2002-02-01,2,3,2,3,5
40201,CHALLAPATA,estado nutricional en menores de 5 anos,clasificacion d,2002-02-01,24,29,24,29,53
50302,CHAQUI,estado nutricional en menores de 5 anos,clasificacion d,2002-02-01,27,82,27,82,109
70702,CHARAGUA,estado nutricional en menores de 5 anos,clasificacion d,2002-02-01,9,264,9,264,273
20305,CHARAÃ‘A,estado nutricional en menores de 5 anos,clasificacion d,2002-02-01,8,7,8,7,15
31204,CHIMORE,estado nutricional en menores de 5 anos,clasificacion d,2002-02-01,10,5,10,5,15
40903,CHIPAYA,estado nutricional en menores de 5 anos,clasificacion d,2002-02-01,1,1,1,1,2
40302,CHOQUE COTA,estado nutricional en menores de 5 anos,clasificacion d,2002-02-01,1,3,1,3,4
21101,CHULUMANI (V. DE LA LIBERTAD),estado nutricional en menores de 5 anos,clasificacion d,2002-02-01,4,6,4,6,10
20501,CHUMA,estado nutricional en menores de 5 anos,clasificacion d,2002-02-01,2,1,2,1,3
30801,CLIZA,estado nutricional en menores de 5 anos,clasificacion d,2002-02-01,1,41,1,41,42
90101,COBIJA,estado nutricional en menores de 5 anos,clasificacion d,2002-02-01,35,30,35,30,65
30101,COCHABAMBA,estado nutricional en menores de 5 anos,clasificacion d,2002-02-01,151,282,151,282,433
40902,COIPASA,estado nutricional en menores de 5 anos,clasificacion d,2002-02-01,0,1,0,1,1
30905,COLCAPIRHUA,estado nutricional en menores de 5 anos,clasificacion d,2002-02-01,25,32,25,32,57
50901,"COLCHA ""K""",estado nutricional en menores de 5 anos,clasificacion d,2002-02-01,0,27,0,27,27
21307,COLLANA,estado nutricional en menores de 5 anos,clasificacion d,2002-02-01,3,0,3,0,3
31002,COLOMI,estado nutricional en menores de 5 anos,clasificacion d,2002-02-01,45,40,45,40,85
50401,COLQUECHACA,estado nutricional en menores de 5 anos,clasificacion d,2002-02-01,26,90,26,90,116
21306,COLQUENCHA,estado nutricional en menores de 5 anos,clasificacion d,2002-02-01,7,8,7,8,15
21004,COLQUIRI,estado nutricional en menores de 5 anos,clasificacion d,2002-02-01,41,27,41,27,68
20304,COMANCHE,estado nutricional en menores de 5 anos,clasificacion d,2002-02-01,8,14,8,14,22
71301,COMARAPA,estado nutricional en menores de 5 anos,clasificacion d,2002-02-01,14,32,14,32,46
20605,COMBAYA,estado nutricional en menores de 5 anos,clasificacion d,2002-02-01,0,28,0,28,28
71101,CONCEPCION,estado nutricional en menores de 5 anos,clasificacion d,2002-02-01,4,41,4,41,45
21701,COPACABANA,estado nutricional en menores de 5 anos,clasificacion d,2002-02-01,4,45,4,45,49
21402,CORIPATA,estado nutricional en menores de 5 anos,clasificacion d,2002-02-01,4,6,4,6,10
20301,CORO CORO,estado nutricional en menores de 5 anos,clasificacion d,2002-02-01,15,20,15,20,35
21401,COROICO,estado nutricional en menores de 5 anos,clasificacion d,2002-02-01,12,9,12,9,21
40301,CORQUE,estado nutricional en menores de 5 anos,clasificacion d,2002-02-01,16,8,16,8,24
50601,COTAGAITA,estado nutricional en menores de 5 anos,clasificacion d,2002-02-01,14,107,14,107,121
70102,COTOCA,estado nutricional en menores de 5 anos,clasificacion d,2002-02-01,32,44,32,44,76
31405,CUCHUMUELA (V. G. VILLARROEL),estado nutricional en menores de 5 anos,clasificacion d,2002-02-01,1,6,1,6,7
70704,CUEVO,estado nutricional en menores de 5 anos,clasificacion d,2002-02-01,19,18,19,18,37
10902,CULPINA,estado nutricional en menores de 5 anos,clasificacion d,2002-02-01,8,242,8,242,250
40401,CURAHUARA DE CARANGAS,estado nutricional en menores de 5 anos,clasificacion d,2002-02-01,17,10,17,10,27
21602,CURVA,estado nutricional en menores de 5 anos,clasificacion d,2002-02-01,12,4,12,4,16
20804,DESAGUADERO,estado nutricional en menores de 5 anos,clasificacion d,2002-02-01,4,23,4,23,27
20105,EL ALTO,estado nutricional en menores de 5 anos,clasificacion d,2002-02-01,896,761,896,761,1657
40103,EL CHORO,estado nutricional en menores de 5 anos,clasificacion d,2002-02-01,1,2,1,2,3
71503,EL PUENTE(STC),estado nutricional en menores de 5 anos,clasificacion d,2002-02-01,12,107,12,107,119
60502,EL PUENTE(TJA),estado nutricional en menores de 5 anos,clasificacion d,2002-02-01,22,52,22,52,74
70105,EL TORNO,estado nutricional en menores de 5 anos,clasificacion d,2002-02-01,61,42,61,42,103
10405,EL VILLAR,estado nutricional en menores de 5 anos,clasificacion d,2002-02-01,38,98,38,98,136
60601,ENTRE RIOS,estado nutricional en menores de 5 anos,clasificacion d,2002-02-01,15,41,15,41,56
41101,EUCALIPTUS,estado nutricional en menores de 5 anos,clasificacion d,2002-02-01,0,32,0,32,32
90503,EUREKA (SANTOS MERCADO),estado nutricional en menores de 5 anos,clasificacion d,2002-02-01,0,2,0,2,2
80402,EXALTACION,estado nutricional en menores de 5 anos,clasificacion d,2002-02-01,6,27,6,27,33
90203,FILADELFIA,estado nutricional en menores de 5 anos,clasificacion d,2002-02-01,4,4,4,4,8
71002,GENERAL SAAVEDRA,estado nutricional en menores de 5 anos,clasificacion d,2002-02-01,33,111,33,111,144
21601,GRAL. J.J. PEREZ (CHARAZANI),estado nutricional en menores de 5 anos,clasificacion d,2002-02-01,12,7,12,7,19
20602,GUANAY,estado nutricional en menores de 5 anos,clasificacion d,2002-02-01,17,104,17,104,121
20802,GUAQUI,estado nutricional en menores de 5 anos,clasificacion d,2002-02-01,0,9,0,9,9
80202,GUAYARAMERIN,estado nutricional en menores de 5 anos,clasificacion d,2002-02-01,33,48,33,48,81
70705,GUTIERREZ,estado nutricional en menores de 5 anos,clasificacion d,2002-02-01,10,192,10,192,202
10502,HUACARETA,estado nutricional en menores de 5 anos,clasificacion d,2002-02-01,67,100,67,100,167
11002,HUACAYA (VILLA DE HUACAYA),estado nutricional en menores de 5 anos,clasificacion d,2002-02-01,9,17,9,17,26
40501,HUACHACALLA,estado nutricional en menores de 5 anos,clasificacion d,2002-02-01,1,1,1,1,2
80803,HUARACAJE,estado nutricional en menores de 5 anos,clasificacion d,2002-02-01,2,9,2,9,11
41601,HUAYLLAMARCA,estado nutricional en menores de 5 anos,clasificacion d,2002-02-01,11,6,11,6,17
21005,ICHOCA,estado nutricional en menores de 5 anos,clasificacion d,2002-02-01,17,27,17,27,44
10304,ICLA,estado nutricional en menores de 5 anos,clasificacion d,2002-02-01,54,124,54,124,178
10703,INCAHUASI,estado nutricional en menores de 5 anos,clasificacion d,2002-02-01,3,186,3,186,189
21001,INQUISIVI,estado nutricional en menores de 5 anos,clasificacion d,2002-02-01,4,49,4,49,53
21102,IRUPANA (VILLA DE LANZA),estado nutricional en menores de 5 anos,clasificacion d,2002-02-01,4,51,4,51,55
21501,IXIAMAS,estado nutricional en menores de 5 anos,clasificacion d,2002-02-01,9,10,9,10,19
21105,LA ASUNTA,estado nutricional en menores de 5 anos,clasificacion d,2002-02-01,19,50,19,50,69
70104,LA GUARDIA,estado nutricional en menores de 5 anos,clasificacion d,2002-02-01,68,46,68,46,114
20101,LA PAZ,estado nutricional en menores de 5 anos,clasificacion d,2002-02-01,776,755,776,755,1531
70701,LAGUNILLAS,estado nutricional en menores de 5 anos,clasificacion d,2002-02-01,6,20,6,20,26
21202,LAJA,estado nutricional en menores de 5 anos,clasificacion d,2002-02-01,0,22,0,22,22
10903,LAS CARRERAS,estado nutricional en menores de 5 anos,clasificacion d,2002-02-01,2,35,2,35,37
51401,LLICA,estado nutricional en menores de 5 anos,clasificacion d,2002-02-01,0,14,0,14,14
80601,LORETO,estado nutricional en menores de 5 anos,clasificacion d,2002-02-01,0,8,0,8,8
20901,LURIBAY,estado nutricional en menores de 5 anos,clasificacion d,2002-02-01,0,23,0,23,23
40702,MACHACAMARCA,estado nutricional en menores de 5 anos,clasificacion d,2002-02-01,7,5,7,5,12
11003,MACHARETI,estado nutricional en menores de 5 anos,clasificacion d,2002-02-01,30,65,30,65,95
80801,MAGDALENA,estado nutricional en menores de 5 anos,clasificacion d,2002-02-01,10,22,10,22,32
70903,MAIRANA,estado nutricional en menores de 5 anos,clasificacion d,2002-02-01,24,21,24,21,45
20103,MECAPACA,estado nutricional en menores de 5 anos,clasificacion d,2002-02-01,5,9,5,9,14
71003,MINEROS,estado nutricional en menores de 5 anos,clasificacion d,2002-02-01,51,109,51,109,160
31301,MIZQUE,estado nutricional en menores de 5 anos,clasificacion d,2002-02-01,39,88,39,88,127
20402,MOCOMOCO,estado nutricional en menores de 5 anos,clasificacion d,2002-02-01,32,36,32,36,68
51002,MOJINETE,estado nutricional en menores de 5 anos,clasificacion d,2002-02-01,0,7,0,7,7
10303,MOJOCOYA,estado nutricional en menores de 5 anos,clasificacion d,2002-02-01,67,122,67,122,189
10501,MONTEAGUDO,estado nutricional en menores de 5 anos,clasificacion d,2002-02-01,112,172,112,172,284
71001,MONTERO,estado nutricional en menores de 5 anos,clasificacion d,2002-02-01,11,341,11,341,352
70803,MORO MORO,estado nutricional en menores de 5 anos,clasificacion d,2002-02-01,4,9,4,9,13
30302,MOROCHATA,estado nutricional en menores de 5 anos,clasificacion d,2002-02-01,22,23,22,23,45
90401,NACEBE (SANTA ROSA DEL ABUNA),estado nutricional en menores de 5 anos,clasificacion d,2002-02-01,0,3,0,3,3
20307,NAZACARA DE PACAJES,estado nutricional en menores de 5 anos,clasificacion d,2002-02-01,4,0,4,0,4
50404,OCURI,estado nutricional en menores de 5 anos,clasificacion d,2002-02-01,42,66,42,66,108
70202,OKINAWA,estado nutricional en menores de 5 anos,clasificacion d,2002-02-01,5,5,5,5,10
30203,OMEREQUE,estado nutricional en menores de 5 anos,clasificacion d,2002-02-01,2,11,2,11,13
40101,ORURO,estado nutricional en menores de 5 anos,clasificacion d,2002-02-01,63,597,63,597,660
60201,PADCAYA,estado nutricional en menores de 5 anos,clasificacion d,2002-02-01,14,38,14,38,52
10401,PADILLA,estado nutricional en menores de 5 anos,clasificacion d,2002-02-01,132,212,132,212,344
70502,PAILON,estado nutricional en menores de 5 anos,clasificacion d,2002-02-01,1,56,1,56,57
20102,PALCA,estado nutricional en menores de 5 anos,clasificacion d,2002-02-01,39,27,39,27,66
21104,PALOS BLANCOS,estado nutricional en menores de 5 anos,clasificacion d,2002-02-01,52,48,52,48,100
40802,PAMPA AULLAGAS,estado nutricional en menores de 5 anos,clasificacion d,2002-02-01,12,12,12,12,24
70902,PAMPA GRANDE,estado nutricional en menores de 5 anos,clasificacion d,2002-02-01,6,9,6,9,15
21802,PAPEL PAMPA,estado nutricional en menores de 5 anos,clasificacion d,2002-02-01,1,2,1,2,3
30202,PASORAPA,estado nutricional en menores de 5 anos,clasificacion d,2002-02-01,5,23,5,23,28
21305,PATACAMAYA,estado nutricional en menores de 5 anos,clasificacion d,2002-02-01,16,14,16,14,30
40602,PAZÃ‘A,estado nutricional en menores de 5 anos,clasificacion d,2002-02-01,2,30,2,30,32
20702,PELECHUCO,estado nutricional en menores de 5 anos,clasificacion d,2002-02-01,17,7,17,7,24
50403,POCOATA,estado nutricional en menores de 5 anos,clasificacion d,2002-02-01,69,164,69,164,233
31203,POCONA,estado nutricional en menores de 5 anos,clasificacion d,2002-02-01,10,35,10,35,45
31202,POJO (CBBA),estado nutricional en menores de 5 anos,clasificacion d,2002-02-01,27,93,27,93,120
40601,POOPO,estado nutricional en menores de 5 anos,clasificacion d,2002-02-01,0,22,0,22,22
51203,PORCO,estado nutricional en menores de 5 anos,clasificacion d,2002-02-01,32,33,32,33,65
10103,POROMA,estado nutricional en menores de 5 anos,clasificacion d,2002-02-01,80,129,80,129,209
70103,PORONGO,estado nutricional en menores de 5 anos,clasificacion d,2002-02-01,14,13,14,13,27
70601,PORTACHUELO,estado nutricional en menores de 5 anos,clasificacion d,2002-02-01,41,30,41,30,71
90102,PORVENIR,estado nutricional en menores de 5 anos,clasificacion d,2002-02-01,0,5,0,5,5
50101,POTOSI,estado nutricional en menores de 5 anos,clasificacion d,2002-02-01,131,257,131,257,388
10302,PRESTO,estado nutricional en menores de 5 anos,clasificacion d,2002-02-01,62,50,62,50,112
21201,PUCARANI,estado nutricional en menores de 5 anos,clasificacion d,2002-02-01,5,45,5,45,50
20401,PUERTO ACOSTA,estado nutricional en menores de 5 anos,clasificacion d,2002-02-01,34,44,34,44,78
20403,PUERTO CARABUCO,estado nutricional en menores de 5 anos,clasificacion d,2002-02-01,34,70,34,70,104
90301,PUERTO GONZALO MORENO,estado nutricional en menores de 5 anos,clasificacion d,2002-02-01,1,15,1,15,16
21204,PUERTO PEREZ,estado nutricional en menores de 5 anos,clasificacion d,2002-02-01,2,3,2,3,5
71402,PUERTO QUIJARRO,estado nutricional en menores de 5 anos,clasificacion d,2002-02-01,40,8,40,8,48
90201,PUERTO RICO,estado nutricional en menores de 5 anos,clasificacion d,2002-02-01,0,6,0,6,6
80703,PUERTO SILES,estado nutricional en menores de 5 anos,clasificacion d,2002-02-01,0,2,0,2,2
71401,PUERTO SUAREZ,estado nutricional en menores de 5 anos,clasificacion d,2002-02-01,27,15,27,15,42
31205,PUERTO VILLARROEL,estado nutricional en menores de 5 anos,clasificacion d,2002-02-01,54,37,54,37,91
51101,PUNA,estado nutricional en menores de 5 anos,clasificacion d,2002-02-01,2,154,2,154,156
31401,PUNATA,estado nutricional en menores de 5 anos,clasificacion d,2002-02-01,0,8,0,8,8
20604,QUIABAYA,estado nutricional en menores de 5 anos,clasificacion d,2002-02-01,0,36,0,36,36
21002,QUIME,estado nutricional en menores de 5 anos,clasificacion d,2002-02-01,17,42,17,42,59
50402,RAVELO,estado nutricional en menores de 5 anos,clasificacion d,2002-02-01,77,150,77,150,227
80301,REYES,estado nutricional en menores de 5 anos,clasificacion d,2002-02-01,15,10,15,10,25
80201,RIBERALTA,estado nutricional en menores de 5 anos,clasificacion d,2002-02-01,107,91,107,91,198
70503,ROBORE,estado nutricional en menores de 5 anos,clasificacion d,2002-02-01,1,51,1,51,52
80304,RURRENABAQUE,estado nutricional en menores de 5 anos,clasificacion d,2002-02-01,19,15,19,15,34
40901,SABAYA,estado nutricional en menores de 5 anos,clasificacion d,2002-02-01,0,7,0,7,7
31001,SACABA,estado nutricional en menores de 5 anos,clasificacion d,2002-02-01,28,5,28,5,33
30404,SACABAMBA,estado nutricional en menores de 5 anos,clasificacion d,2002-02-01,0,36,0,36,36
50701,SACACA,estado nutricional en menores de 5 anos,clasificacion d,2002-02-01,53,289,53,289,342
71302,SAIPINA,estado nutricional en menores de 5 anos,clasificacion d,2002-02-01,11,13,11,13,24
40801,SALINAS DE GARCI MENDOZA,estado nutricional en menores de 5 anos,clasificacion d,2002-02-01,10,13,10,13,23
70901,SAMAIPATA,estado nutricional en menores de 5 anos,clasificacion d,2002-02-01,30,9,30,9,39
51601,SAN AGUSTIN,estado nutricional en menores de 5 anos,clasificacion d,2002-02-01,1,4,1,4,5
51003,SAN ANTONIO DE ESMORUCO,estado nutricional en menores de 5 anos,clasificacion d,2002-02-01,0,21,0,21,21
71105,SAN ANTONIO DE LOMERIO,estado nutricional en menores de 5 anos,clasificacion d,2002-02-01,70,154,70,154,224
31403,SAN BENITO,estado nutricional en menores de 5 anos,clasificacion d,2002-02-01,1,41,1,41,42
80302,SAN BORJA,estado nutricional en menores de 5 anos,clasificacion d,2002-02-01,40,36,40,36,76
21502,SAN BUENA VENTURA,estado nutricional en menores de 5 anos,clasificacion d,2002-02-01,30,50,30,50,80
70402,SAN CARLOS,estado nutricional en menores de 5 anos,clasificacion d,2002-02-01,0,7,0,7,7
80501,SAN IGNACIO,estado nutricional en menores de 5 anos,clasificacion d,2002-02-01,13,104,13,104,117
70301,SAN IGNACIO DE VELASCO,estado nutricional en menores de 5 anos,clasificacion d,2002-02-01,194,247,194,247,441
80102,SAN JAVIER(BNI),estado nutricional en menores de 5 anos,clasificacion d,2002-02-01,14,15,14,15,29
71102,SAN JAVIER(STC),estado nutricional en menores de 5 anos,clasificacion d,2002-02-01,4,106,4,106,110
80701,SAN JOAQUIN,estado nutricional en menores de 5 anos,clasificacion d,2002-02-01,1,7,1,7,8
70501,SAN JOSE DE CHIQUITOS,estado nutricional en menores de 5 anos,clasificacion d,2002-02-01,31,27,31,27,58
71104,SAN JULIAN,estado nutricional en menores de 5 anos,clasificacion d,2002-02-01,139,212,139,212,351
90302,SAN LORENZO(PND),estado nutricional en menores de 5 anos,clasificacion d,2002-02-01,0,2,0,2,2
60501,SAN LORENZO(TJA),estado nutricional en menores de 5 anos,clasificacion d,2002-02-01,5,18,5,18,23
10702,SAN LUCAS,estado nutricional en menores de 5 anos,clasificacion d,2002-02-01,7,458,7,458,465
71201,SAN MATIAS,estado nutricional en menores de 5 anos,clasificacion d,2002-02-01,59,61,59,61,120
70302,SAN MIGUEL DE VELASCO,estado nutricional en menores de 5 anos,clasificacion d,2002-02-01,48,124,48,124,172
51001,SAN PABLO DE LIPEZ,estado nutricional en menores de 5 anos,clasificacion d,2002-02-01,2,17,2,17,19
50501,SAN PEDRO DE BUENA VISTA,estado nutricional en menores de 5 anos,clasificacion d,2002-02-01,7,213,7,213,220
21801,SAN PEDRO DE CURAHUARA,estado nutricional en menores de 5 anos,clasificacion d,2002-02-01,2,10,2,10,12
50902,SAN PEDRO DE QUEMES,estado nutricional en menores de 5 anos,clasificacion d,2002-02-01,0,7,0,7,7
21702,SAN PEDRO DE TIQUINA,estado nutricional en menores de 5 anos,clasificacion d,2002-02-01,0,3,0,3,3
90202,SAN PEDRO(PND),estado nutricional en menores de 5 anos,clasificacion d,2002-02-01,1,7,1,7,8
70303,SAN RAFAEL,estado nutricional en menores de 5 anos,clasificacion d,2002-02-01,36,40,36,40,76
80702,SAN RAMON,estado nutricional en menores de 5 anos,clasificacion d,2002-02-01,4,4,4,4,8
80702,SAN RAMON,estado nutricional en menores de 5 anos,clasificacion d,2002-02-01,14,2,14,2,16
80401,SANTA ANA,estado nutricional en menores de 5 anos,clasificacion d,2002-02-01,27,20,27,20,47
70101,SANTA CRUZ DE LA SIERRA,estado nutricional en menores de 5 anos,clasificacion d,2002-02-01,296,337,296,337,633
80303,SANTA ROSA,estado nutricional en menores de 5 anos,clasificacion d,2002-02-01,8,7,8,7,15
70602,SANTA ROSA DEL SARA,estado nutricional en menores de 5 anos,clasificacion d,2002-02-01,8,26,8,26,34
20308,SANTIAGO DE CALLAPA,estado nutricional en menores de 5 anos,clasificacion d,2002-02-01,0,7,0,7,7
41401,SANTIAGO DE HUARI,estado nutricional en menores de 5 anos,clasificacion d,2002-02-01,16,7,16,7,23
21901,SANTIAGO DE MACHACA,estado nutricional en menores de 5 anos,clasificacion d,2002-02-01,3,6,3,6,9
30702,SANTIVAÃ‘ES,estado nutricional en menores de 5 anos,clasificacion d,2002-02-01,14,50,14,50,64
40202,SANTUARIO DE QUILLACAS,estado nutricional en menores de 5 anos,clasificacion d,2002-02-01,6,22,6,22,28
20902,SAPAHAQUI,estado nutricional en menores de 5 anos,clasificacion d,2002-02-01,1,16,1,16,17
21301,SICA SICA (VILLA AROMA),estado nutricional en menores de 5 anos,clasificacion d,2002-02-01,26,4,26,4,30
30703,SICAYA,estado nutricional en menores de 5 anos,clasificacion d,2002-02-01,0,17,0,17,17
30902,SIPE SIPE,estado nutricional en menores de 5 anos,clasificacion d,2002-02-01,79,70,79,70,149
10403,SOPACHUY,estado nutricional en menores de 5 anos,clasificacion d,2002-02-01,29,30,29,30,59
20601,SORATA,estado nutricional en menores de 5 anos,clasificacion d,2002-02-01,11,39,11,39,50
10101,SUCRE,estado nutricional en menores de 5 anos,clasificacion d,2002-02-01,59,777,59,777,836
31404,TACACHI,estado nutricional en menores de 5 anos,clasificacion d,2002-02-01,1,11,1,11,12
20603,TACACOMA,estado nutricional en menores de 5 anos,clasificacion d,2002-02-01,20,23,20,23,43
50303,TACOBAMBA,estado nutricional en menores de 5 anos,clasificacion d,2002-02-01,17,71,17,71,88
30602,TACOPAYA,estado nutricional en menores de 5 anos,clasificacion d,2002-02-01,2,7,2,7,9
51402,TAHUA,estado nutricional en menores de 5 anos,clasificacion d,2002-02-01,0,6,0,6,6
31101,TAPACARI,estado nutricional en menores de 5 anos,clasificacion d,2002-02-01,5,66,5,66,71
10601,TARABUCO,estado nutricional en menores de 5 anos,clasificacion d,2002-02-01,12,615,12,615,627
30401,TARATA,estado nutricional en menores de 5 anos,clasificacion d,2002-02-01,1,22,1,22,23
60101,TARIJA,estado nutricional en menores de 5 anos,clasificacion d,2002-02-01,37,167,37,167,204
10202,TARVITA,estado nutricional en menores de 5 anos,clasificacion d,2002-02-01,79,97,79,97,176
20803,TIAWANACU,estado nutricional en menores de 5 anos,clasificacion d,2002-02-01,13,9,13,9,22
50102,TINGUIPAYA,estado nutricional en menores de 5 anos,clasificacion d,2002-02-01,2,59,2,59,61
20606,TIPUANI,estado nutricional en menores de 5 anos,clasificacion d,2002-02-01,7,1,7,1,8
30903,TIQUIPAYA,estado nutricional en menores de 5 anos,clasificacion d,2002-02-01,1,15,1,15,16
31601,TIRAQUE (CBBA),estado nutricional en menores de 5 anos,clasificacion d,2002-02-01,55,85,55,85,140
21703,TITO YUPANQUI (PARQUIPUJIO),estado nutricional en menores de 5 anos,clasificacion d,2002-02-01,0,9,0,9,9
30802,TOCO,estado nutricional en menores de 5 anos,clasificacion d,2002-02-01,1,9,1,9,10
30803,TOLATA,estado nutricional en menores de 5 anos,clasificacion d,2002-02-01,0,6,0,6,6
41001,TOLEDO,estado nutricional en menores de 5 anos,clasificacion d,2002-02-01,6,9,6,9,15
51202,TOMAVE,estado nutricional en menores de 5 anos,clasificacion d,2002-02-01,0,104,0,104,104
10402,TOMINA,estado nutricional en menores de 5 anos,clasificacion d,2002-02-01,71,163,71,163,234
50502,TORO TORO,estado nutricional en menores de 5 anos,clasificacion d,2002-02-01,8,20,8,20,28
31201,TOTORA(CBBA),estado nutricional en menores de 5 anos,clasificacion d,2002-02-01,37,28,37,28,65
41301,TOTORA(ORR),estado nutricional en menores de 5 anos,clasificacion d,2002-02-01,0,13,0,13,13
70802,TRIGAL,estado nutricional en menores de 5 anos,clasificacion d,2002-02-01,2,1,2,1,3
80101,TRINIDAD,estado nutricional en menores de 5 anos,clasificacion d,2002-02-01,1,0,1,0,1
50801,TUPIZA,estado nutricional en menores de 5 anos,clasificacion d,2002-02-01,9,165,9,165,174
40402,TURCO,estado nutricional en menores de 5 anos,clasificacion d,2002-02-01,4,5,4,5,9
21302,UMALA,estado nutricional en menores de 5 anos,clasificacion d,2002-02-01,11,3,11,3,14
60401,URIONDO (A. CONCEPCION),estado nutricional en menores de 5 anos,clasificacion d,2002-02-01,4,20,4,20,24
71502,URUBICHA,estado nutricional en menores de 5 anos,clasificacion d,2002-02-01,59,298,59,298,357
51201,UYUNI,estado nutricional en menores de 5 anos,clasificacion d,2002-02-01,1,79,1,79,80
30502,VACAS,estado nutricional en menores de 5 anos,clasificacion d,2002-02-01,3,43,3,43,46
70801,VALLEGRANDE,estado nutricional en menores de 5 anos,clasificacion d,2002-02-01,26,56,26,56,82
20801,VIACHA,estado nutricional en menores de 5 anos,clasificacion d,2002-02-01,7,97,7,97,104
31302,VILA VILA,estado nutricional en menores de 5 anos,clasificacion d,2002-02-01,0,24,0,24,24
60303,VILLA MONTES,estado nutricional en menores de 5 anos,clasificacion d,2002-02-01,37,42,37,42,79
90502,VILLA NUEVA (LOMA ALTA),estado nutricional en menores de 5 anos,clasificacion d,2002-02-01,2,0,2,0,2
31402,VILLA RIVERO,estado nutricional en menores de 5 anos,clasificacion d,2002-02-01,0,5,0,5,5
10801,VILLA SERRANO,estado nutricional en menores de 5 anos,clasificacion d,2002-02-01,78,195,78,195,273
31003,VILLA TUNARI,estado nutricional en menores de 5 anos,clasificacion d,2002-02-01,49,74,49,74,123
11001,VILLA VACA GUZMAN (MUYUPAMPA),estado nutricional en menores de 5 anos,clasificacion d,2002-02-01,52,113,52,113,165
51501,VILLAZON,estado nutricional en menores de 5 anos,clasificacion d,2002-02-01,3,139,3,139,142
30904,VINTO,estado nutricional en menores de 5 anos,clasificacion d,2002-02-01,30,18,30,18,48
50602,VITICHI,estado nutricional en menores de 5 anos,clasificacion d,2002-02-01,36,106,36,106,142
20306,WALDO BALLIVIAN,estado nutricional en menores de 5 anos,clasificacion d,2002-02-01,0,3,0,3,3
70201,WARNES,estado nutricional en menores de 5 anos,clasificacion d,2002-02-01,57,114,57,114,171
20903,YACO,estado nutricional en menores de 5 anos,clasificacion d,2002-02-01,3,18,3,18,21
60301,YACUIBA,estado nutricional en menores de 5 anos,clasificacion d,2002-02-01,37,23,37,23,60
10602,YAMPARAEZ,estado nutricional en menores de 5 anos,clasificacion d,2002-02-01,128,259,128,259,387
21103,YANACACHI,estado nutricional en menores de 5 anos,clasificacion d,2002-02-01,2,4,2,4,6
70403,YAPACANI,estado nutricional en menores de 5 anos,clasificacion d,2002-02-01,67,124,67,124,191
50103,YOCALLA,estado nutricional en menores de 5 anos,clasificacion d,2002-02-01,5,88,5,88,93
10102,YOTALA,estado nutricional en menores de 5 anos,clasificacion d,2002-02-01,77,179,77,179,256
60402,YUNCHARA,estado nutricional en menores de 5 anos,clasificacion d,2002-02-01,8,29,8,29,37
10301,ZUDAÃ‘EZ,estado nutricional en menores de 5 anos,clasificacion d,2002-02-01,68,135,68,135,203
51302,ACACIO,estado nutricional en menores de 5 anos,clasificacion d,2002-03-01,27,127,27,127,154
20201,ACHACACHI,estado nutricional en menores de 5 anos,clasificacion d,2002-03-01,55,170,55,170,225
20104,ACHOCALLA,estado nutricional en menores de 5 anos,clasificacion d,2002-03-01,22,8,22,8,30
30201,AIQUILE,estado nutricional en menores de 5 anos,clasificacion d,2002-03-01,9,27,9,27,36
31303,ALALAY,estado nutricional en menores de 5 anos,clasificacion d,2002-03-01,14,13,14,13,27
10404,ALCALA,estado nutricional en menores de 5 anos,clasificacion d,2002-03-01,40,68,40,68,108
20202,ANCORAIMES,estado nutricional en menores de 5 anos,clasificacion d,2002-03-01,98,108,98,108,206
41201,ANDAMARCA,estado nutricional en menores de 5 anos,clasificacion d,2002-03-01,12,29,12,29,41
40603,ANTEQUERA,estado nutricional en menores de 5 anos,clasificacion d,2002-03-01,0,10,0,10,10
30402,ANZALDO,estado nutricional en menores de 5 anos,clasificacion d,2002-03-01,2,63,2,63,65
20701,APOLO,estado nutricional en menores de 5 anos,clasificacion d,2002-03-01,13,18,13,18,31
51301,ARAMPAMPA,estado nutricional en menores de 5 anos,clasificacion d,2002-03-01,10,43,10,43,53
30501,ARANI,estado nutricional en menores de 5 anos,clasificacion d,2002-03-01,9,65,9,65,74
30403,ARBIETO,estado nutricional en menores de 5 anos,clasificacion d,2002-03-01,3,16,3,16,19
30601,ARQUE,estado nutricional en menores de 5 anos,clasificacion d,2002-03-01,50,111,50,111,161
71501,ASCENCION DE GUARAYOS,estado nutricional en menores de 5 anos,clasificacion d,2002-03-01,0,2,0,2,2
50802,ATOCHA,estado nutricional en menores de 5 anos,clasificacion d,2002-03-01,5,67,5,67,72
20503,AUCAPATA,estado nutricional en menores de 5 anos,clasificacion d,2002-03-01,0,2,0,2,2
21303,AYO AYO,estado nutricional en menores de 5 anos,clasificacion d,2002-03-01,19,2,19,2,21
30301,AYOPAYA (V. DE INDEPENDENCIA),estado nutricional en menores de 5 anos,clasificacion d,2002-03-01,79,97,79,97,176
10201,AZURDUY,estado nutricional en menores de 5 anos,clasificacion d,2002-03-01,102,175,102,175,277
21203,BATALLAS,estado nutricional en menores de 5 anos,clasificacion d,2002-03-01,1,37,1,37,38
80802,BAURES,estado nutricional en menores de 5 anos,clasificacion d,2002-03-01,15,21,15,21,36
41202,BELEN DE ANDAMARCA,estado nutricional en menores de 5 anos,clasificacion d,2002-03-01,0,5,0,5,5
50104,BELEN DE URMIRI,estado nutricional en menores de 5 anos,clasificacion d,2002-03-01,0,15,0,15,15
90104,BELLA FLOR,estado nutricional en menores de 5 anos,clasificacion d,2002-03-01,0,1,0,1,1
60202,BERMEJO,estado nutricional en menores de 5 anos,clasificacion d,2002-03-01,5,12,5,12,17
50301,BETANZOS,estado nutricional en menores de 5 anos,clasificacion d,2002-03-01,124,485,124,485,609
31501,BOLIVAR,estado nutricional en menores de 5 anos,clasificacion d,2002-03-01,50,111,50,111,161
90103,BOLPEBRA,estado nutricional en menores de 5 anos,clasificacion d,2002-03-01,0,12,0,12,12
70707,BOYUIBE,estado nutricional en menores de 5 anos,clasificacion d,2002-03-01,0,29,0,29,29
70401,BUENA VISTA,estado nutricional en menores de 5 anos,clasificacion d,2002-03-01,33,48,33,48,81
70703,CABEZAS,estado nutricional en menores de 5 anos,clasificacion d,2002-03-01,3,58,3,58,61
20905,CAIROMA,estado nutricional en menores de 5 anos,clasificacion d,2002-03-01,0,39,0,39,39
51102,"CAIZA ""D""",estado nutricional en menores de 5 anos,clasificacion d,2002-03-01,37,152,37,152,189
21003,CAJUATA,estado nutricional en menores de 5 anos,clasificacion d,2002-03-01,18,20,18,20,38
20303,CALACOTO,estado nutricional en menores de 5 anos,clasificacion d,2002-03-01,8,7,8,7,15
21304,CALAMARCA,estado nutricional en menores de 5 anos,clasificacion d,2002-03-01,14,16,14,16,30
10701,CAMARGO,estado nutricional en menores de 5 anos,clasificacion d,2002-03-01,4,73,4,73,77
10901,CAMATAQUI (C. VILLA ABECIA),estado nutricional en menores de 5 anos,clasificacion d,2002-03-01,0,64,0,64,64
70706,CAMIRI,estado nutricional en menores de 5 anos,clasificacion d,2002-03-01,52,97,52,97,149
30701,CAPINOTA,estado nutricional en menores de 5 anos,clasificacion d,2002-03-01,58,137,58,137,195
20302,CAQUIAVIRI,estado nutricional en menores de 5 anos,clasificacion d,2002-03-01,21,44,21,44,65
40102,CARACOLLO,estado nutricional en menores de 5 anos,clasificacion d,2002-03-01,22,48,22,48,70
22001,CARANAVI,estado nutricional en menores de 5 anos,clasificacion d,2002-03-01,86,143,86,143,229
41503,CARANGAS,estado nutricional en menores de 5 anos,clasificacion d,2002-03-01,0,2,0,2,2
60302,CARAPARI,estado nutricional en menores de 5 anos,clasificacion d,2002-03-01,19,64,19,64,83
50702,CARIPUYO,estado nutricional en menores de 5 anos,clasificacion d,2002-03-01,18,131,18,131,149
21902,CATACORA,estado nutricional en menores de 5 anos,clasificacion d,2002-03-01,3,1,3,1,4
40201,CHALLAPATA,estado nutricional en menores de 5 anos,clasificacion d,2002-03-01,45,43,45,43,88
50302,CHAQUI,estado nutricional en menores de 5 anos,clasificacion d,2002-03-01,1,98,1,98,99
70702,CHARAGUA,estado nutricional en menores de 5 anos,clasificacion d,2002-03-01,5,197,5,197,202
20305,CHARAÃ‘A,estado nutricional en menores de 5 anos,clasificacion d,2002-03-01,0,13,0,13,13
31204,CHIMORE,estado nutricional en menores de 5 anos,clasificacion d,2002-03-01,12,42,12,42,54
40903,CHIPAYA,estado nutricional en menores de 5 anos,clasificacion d,2002-03-01,0,6,0,6,6
21101,CHULUMANI (V. DE LA LIBERTAD),estado nutricional en menores de 5 anos,clasificacion d,2002-03-01,20,13,20,13,33
20501,CHUMA,estado nutricional en menores de 5 anos,clasificacion d,2002-03-01,8,14,8,14,22
30801,CLIZA,estado nutricional en menores de 5 anos,clasificacion d,2002-03-01,3,28,3,28,31
90101,COBIJA,estado nutricional en menores de 5 anos,clasificacion d,2002-03-01,55,43,55,43,98
30101,COCHABAMBA,estado nutricional en menores de 5 anos,clasificacion d,2002-03-01,185,306,185,306,491
40902,COIPASA,estado nutricional en menores de 5 anos,clasificacion d,2002-03-01,0,3,0,3,3
30905,COLCAPIRHUA,estado nutricional en menores de 5 anos,clasificacion d,2002-03-01,61,41,61,41,102
50901,"COLCHA ""K""",estado nutricional en menores de 5 anos,clasificacion d,2002-03-01,1,88,1,88,89
21307,COLLANA,estado nutricional en menores de 5 anos,clasificacion d,2002-03-01,2,0,2,0,2
31002,COLOMI,estado nutricional en menores de 5 anos,clasificacion d,2002-03-01,39,54,39,54,93
50401,COLQUECHACA,estado nutricional en menores de 5 anos,clasificacion d,2002-03-01,67,120,67,120,187
21306,COLQUENCHA,estado nutricional en menores de 5 anos,clasificacion d,2002-03-01,13,23,13,23,36
21004,COLQUIRI,estado nutricional en menores de 5 anos,clasificacion d,2002-03-01,48,37,48,37,85
20304,COMANCHE,estado nutricional en menores de 5 anos,clasificacion d,2002-03-01,5,14,5,14,19
71301,COMARAPA,estado nutricional en menores de 5 anos,clasificacion d,2002-03-01,26,53,26,53,79
20605,COMBAYA,estado nutricional en menores de 5 anos,clasificacion d,2002-03-01,14,15,14,15,29
71101,CONCEPCION,estado nutricional en menores de 5 anos,clasificacion d,2002-03-01,3,33,3,33,36
21701,COPACABANA,estado nutricional en menores de 5 anos,clasificacion d,2002-03-01,4,67,4,67,71
21402,CORIPATA,estado nutricional en menores de 5 anos,clasificacion d,2002-03-01,9,6,9,6,15
20301,CORO CORO,estado nutricional en menores de 5 anos,clasificacion d,2002-03-01,10,29,10,29,39
21401,COROICO,estado nutricional en menores de 5 anos,clasificacion d,2002-03-01,22,9,22,9,31
40301,CORQUE,estado nutricional en menores de 5 anos,clasificacion d,2002-03-01,21,40,21,40,61
50601,COTAGAITA,estado nutricional en menores de 5 anos,clasificacion d,2002-03-01,56,211,56,211,267
70102,COTOCA,estado nutricional en menores de 5 anos,clasificacion d,2002-03-01,61,26,61,26,87
31405,CUCHUMUELA (V. G. VILLARROEL),estado nutricional en menores de 5 anos,clasificacion d,2002-03-01,0,23,0,23,23
70704,CUEVO,estado nutricional en menores de 5 anos,clasificacion d,2002-03-01,26,13,26,13,39
10902,CULPINA,estado nutricional en menores de 5 anos,clasificacion d,2002-03-01,43,259,43,259,302
40401,CURAHUARA DE CARANGAS,estado nutricional en menores de 5 anos,clasificacion d,2002-03-01,21,6,21,6,27
21602,CURVA,estado nutricional en menores de 5 anos,clasificacion d,2002-03-01,8,9,8,9,17
20804,DESAGUADERO,estado nutricional en menores de 5 anos,clasificacion d,2002-03-01,1,26,1,26,27
20105,EL ALTO,estado nutricional en menores de 5 anos,clasificacion d,2002-03-01,1148,925,1148,925,2073
40103,EL CHORO,estado nutricional en menores de 5 anos,clasificacion d,2002-03-01,1,0,1,0,1
71503,EL PUENTE(STC),estado nutricional en menores de 5 anos,clasificacion d,2002-03-01,10,90,10,90,100
60502,EL PUENTE(TJA),estado nutricional en menores de 5 anos,clasificacion d,2002-03-01,13,27,13,27,40
70105,EL TORNO,estado nutricional en menores de 5 anos,clasificacion d,2002-03-01,84,67,84,67,151
10405,EL VILLAR,estado nutricional en menores de 5 anos,clasificacion d,2002-03-01,47,132,47,132,179
60601,ENTRE RIOS,estado nutricional en menores de 5 anos,clasificacion d,2002-03-01,22,67,22,67,89
40502,ESCARA,estado nutricional en menores de 5 anos,clasificacion d,2002-03-01,0,1,0,1,1
41101,EUCALIPTUS,estado nutricional en menores de 5 anos,clasificacion d,2002-03-01,0,14,0,14,14
80402,EXALTACION,estado nutricional en menores de 5 anos,clasificacion d,2002-03-01,12,15,12,15,27
90203,FILADELFIA,estado nutricional en menores de 5 anos,clasificacion d,2002-03-01,5,10,5,10,15
71002,GENERAL SAAVEDRA,estado nutricional en menores de 5 anos,clasificacion d,2002-03-01,53,163,53,163,216
21601,GRAL. J.J. PEREZ (CHARAZANI),estado nutricional en menores de 5 anos,clasificacion d,2002-03-01,27,24,27,24,51
20602,GUANAY,estado nutricional en menores de 5 anos,clasificacion d,2002-03-01,10,129,10,129,139
20802,GUAQUI,estado nutricional en menores de 5 anos,clasificacion d,2002-03-01,0,9,0,9,9
80202,GUAYARAMERIN,estado nutricional en menores de 5 anos,clasificacion d,2002-03-01,69,52,69,52,121
70705,GUTIERREZ,estado nutricional en menores de 5 anos,clasificacion d,2002-03-01,26,194,26,194,220
10502,HUACARETA,estado nutricional en menores de 5 anos,clasificacion d,2002-03-01,77,122,77,122,199
11002,HUACAYA (VILLA DE HUACAYA),estado nutricional en menores de 5 anos,clasificacion d,2002-03-01,9,33,9,33,42
40501,HUACHACALLA,estado nutricional en menores de 5 anos,clasificacion d,2002-03-01,0,7,0,7,7
40701,HUANUNI,estado nutricional en menores de 5 anos,clasificacion d,2002-03-01,1,3,1,3,4
80803,HUARACAJE,estado nutricional en menores de 5 anos,clasificacion d,2002-03-01,3,4,3,4,7
41601,HUAYLLAMARCA,estado nutricional en menores de 5 anos,clasificacion d,2002-03-01,8,4,8,4,12
21005,ICHOCA,estado nutricional en menores de 5 anos,clasificacion d,2002-03-01,3,8,3,8,11
10304,ICLA,estado nutricional en menores de 5 anos,clasificacion d,2002-03-01,102,274,102,274,376
10703,INCAHUASI,estado nutricional en menores de 5 anos,clasificacion d,2002-03-01,5,284,5,284,289
21001,INQUISIVI,estado nutricional en menores de 5 anos,clasificacion d,2002-03-01,5,46,5,46,51
21102,IRUPANA (VILLA DE LANZA),estado nutricional en menores de 5 anos,clasificacion d,2002-03-01,11,29,11,29,40
21501,IXIAMAS,estado nutricional en menores de 5 anos,clasificacion d,2002-03-01,25,35,25,35,60
21105,LA ASUNTA,estado nutricional en menores de 5 anos,clasificacion d,2002-03-01,29,38,29,38,67
70104,LA GUARDIA,estado nutricional en menores de 5 anos,clasificacion d,2002-03-01,98,40,98,40,138
20101,LA PAZ,estado nutricional en menores de 5 anos,clasificacion d,2002-03-01,846,901,846,901,1747
41501,LA RIVERA,estado nutricional en menores de 5 anos,clasificacion d,2002-03-01,0,2,0,2,2
70701,LAGUNILLAS,estado nutricional en menores de 5 anos,clasificacion d,2002-03-01,5,71,5,71,76
21202,LAJA,estado nutricional en menores de 5 anos,clasificacion d,2002-03-01,0,33,0,33,33
10903,LAS CARRERAS,estado nutricional en menores de 5 anos,clasificacion d,2002-03-01,15,54,15,54,69
21006,LICOMA PAMPA,estado nutricional en menores de 5 anos,clasificacion d,2002-03-01,1,19,1,19,20
51401,LLICA,estado nutricional en menores de 5 anos,clasificacion d,2002-03-01,1,22,1,22,23
80601,LORETO,estado nutricional en menores de 5 anos,clasificacion d,2002-03-01,0,6,0,6,6
20901,LURIBAY,estado nutricional en menores de 5 anos,clasificacion d,2002-03-01,0,44,0,44,44
40702,MACHACAMARCA,estado nutricional en menores de 5 anos,clasificacion d,2002-03-01,9,12,9,12,21
11003,MACHARETI,estado nutricional en menores de 5 anos,clasificacion d,2002-03-01,38,102,38,102,140
80801,MAGDALENA,estado nutricional en menores de 5 anos,clasificacion d,2002-03-01,5,9,5,9,14
70903,MAIRANA,estado nutricional en menores de 5 anos,clasificacion d,2002-03-01,17,17,17,17,34
20103,MECAPACA,estado nutricional en menores de 5 anos,clasificacion d,2002-03-01,10,12,10,12,22
71003,MINEROS,estado nutricional en menores de 5 anos,clasificacion d,2002-03-01,57,114,57,114,171
31301,MIZQUE,estado nutricional en menores de 5 anos,clasificacion d,2002-03-01,0,70,0,70,70
20402,MOCOMOCO,estado nutricional en menores de 5 anos,clasificacion d,2002-03-01,19,28,19,28,47
51002,MOJINETE,estado nutricional en menores de 5 anos,clasificacion d,2002-03-01,0,20,0,20,20
10303,MOJOCOYA,estado nutricional en menores de 5 anos,clasificacion d,2002-03-01,85,131,85,131,216
10501,MONTEAGUDO,estado nutricional en menores de 5 anos,clasificacion d,2002-03-01,137,240,137,240,377
71001,MONTERO,estado nutricional en menores de 5 anos,clasificacion d,2002-03-01,12,476,12,476,488
70803,MORO MORO,estado nutricional en menores de 5 anos,clasificacion d,2002-03-01,9,22,9,22,31
30302,MOROCHATA,estado nutricional en menores de 5 anos,clasificacion d,2002-03-01,38,95,38,95,133
90401,NACEBE (SANTA ROSA DEL ABUNA),estado nutricional en menores de 5 anos,clasificacion d,2002-03-01,0,7,0,7,7
50404,OCURI,estado nutricional en menores de 5 anos,clasificacion d,2002-03-01,75,66,75,66,141
70202,OKINAWA,estado nutricional en menores de 5 anos,clasificacion d,2002-03-01,8,35,8,35,43
30203,OMEREQUE,estado nutricional en menores de 5 anos,clasificacion d,2002-03-01,0,11,0,11,11
40101,ORURO,estado nutricional en menores de 5 anos,clasificacion d,2002-03-01,331,417,331,417,748
60201,PADCAYA,estado nutricional en menores de 5 anos,clasificacion d,2002-03-01,26,56,26,56,82
10401,PADILLA,estado nutricional en menores de 5 anos,clasificacion d,2002-03-01,132,258,132,258,390
70502,PAILON,estado nutricional en menores de 5 anos,clasificacion d,2002-03-01,4,69,4,69,73
20102,PALCA,estado nutricional en menores de 5 anos,clasificacion d,2002-03-01,37,34,37,34,71
21104,PALOS BLANCOS,estado nutricional en menores de 5 anos,clasificacion d,2002-03-01,52,121,52,121,173
40802,PAMPA AULLAGAS,estado nutricional en menores de 5 anos,clasificacion d,2002-03-01,9,24,9,24,33
70902,PAMPA GRANDE,estado nutricional en menores de 5 anos,clasificacion d,2002-03-01,15,18,15,18,33
21802,PAPEL PAMPA,estado nutricional en menores de 5 anos,clasificacion d,2002-03-01,2,12,2,12,14
30202,PASORAPA,estado nutricional en menores de 5 anos,clasificacion d,2002-03-01,10,40,10,40,50
21305,PATACAMAYA,estado nutricional en menores de 5 anos,clasificacion d,2002-03-01,27,7,27,7,34
40602,PAZÃ‘A,estado nutricional en menores de 5 anos,clasificacion d,2002-03-01,1,28,1,28,29
20702,PELECHUCO,estado nutricional en menores de 5 anos,clasificacion d,2002-03-01,9,25,9,25,34
50403,POCOATA,estado nutricional en menores de 5 anos,clasificacion d,2002-03-01,104,208,104,208,312
31203,POCONA,estado nutricional en menores de 5 anos,clasificacion d,2002-03-01,49,51,49,51,100
31202,POJO (CBBA),estado nutricional en menores de 5 anos,clasificacion d,2002-03-01,40,120,40,120,160
40601,POOPO,estado nutricional en menores de 5 anos,clasificacion d,2002-03-01,0,38,0,38,38
51203,PORCO,estado nutricional en menores de 5 anos,clasificacion d,2002-03-01,24,25,24,25,49
10103,POROMA,estado nutricional en menores de 5 anos,clasificacion d,2002-03-01,123,132,123,132,255
70103,PORONGO,estado nutricional en menores de 5 anos,clasificacion d,2002-03-01,23,18,23,18,41
70601,PORTACHUELO,estado nutricional en menores de 5 anos,clasificacion d,2002-03-01,59,33,59,33,92
90102,PORVENIR,estado nutricional en menores de 5 anos,clasificacion d,2002-03-01,0,4,0,4,4
70804,POSTRER VALLE,estado nutricional en menores de 5 anos,clasificacion d,2002-03-01,3,7,3,7,10
50101,POTOSI,estado nutricional en menores de 5 anos,clasificacion d,2002-03-01,213,330,213,330,543
10302,PRESTO,estado nutricional en menores de 5 anos,clasificacion d,2002-03-01,80,73,80,73,153
70805,PUCARA,estado nutricional en menores de 5 anos,clasificacion d,2002-03-01,0,2,0,2,2
21201,PUCARANI,estado nutricional en menores de 5 anos,clasificacion d,2002-03-01,8,84,8,84,92
20401,PUERTO ACOSTA,estado nutricional en menores de 5 anos,clasificacion d,2002-03-01,29,56,29,56,85
20403,PUERTO CARABUCO,estado nutricional en menores de 5 anos,clasificacion d,2002-03-01,33,47,33,47,80
90301,PUERTO GONZALO MORENO,estado nutricional en menores de 5 anos,clasificacion d,2002-03-01,20,18,20,18,38
21204,PUERTO PEREZ,estado nutricional en menores de 5 anos,clasificacion d,2002-03-01,5,14,5,14,19
71402,PUERTO QUIJARRO,estado nutricional en menores de 5 anos,clasificacion d,2002-03-01,18,5,18,5,23
90201,PUERTO RICO,estado nutricional en menores de 5 anos,clasificacion d,2002-03-01,1,12,1,12,13
80703,PUERTO SILES,estado nutricional en menores de 5 anos,clasificacion d,2002-03-01,0,4,0,4,4
71401,PUERTO SUAREZ,estado nutricional en menores de 5 anos,clasificacion d,2002-03-01,66,27,66,27,93
31205,PUERTO VILLARROEL,estado nutricional en menores de 5 anos,clasificacion d,2002-03-01,94,104,94,104,198
51101,PUNA,estado nutricional en menores de 5 anos,clasificacion d,2002-03-01,44,363,44,363,407
31401,PUNATA,estado nutricional en menores de 5 anos,clasificacion d,2002-03-01,73,164,73,164,237
20604,QUIABAYA,estado nutricional en menores de 5 anos,clasificacion d,2002-03-01,1,34,1,34,35
30901,QUILLACOLLO,estado nutricional en menores de 5 anos,clasificacion d,2002-03-01,20,3,20,3,23
21002,QUIME,estado nutricional en menores de 5 anos,clasificacion d,2002-03-01,16,24,16,24,40
70904,QUIRUSILLAS,estado nutricional en menores de 5 anos,clasificacion d,2002-03-01,2,2,2,2,4
50402,RAVELO,estado nutricional en menores de 5 anos,clasificacion d,2002-03-01,121,223,121,223,344
80301,REYES,estado nutricional en menores de 5 anos,clasificacion d,2002-03-01,32,26,32,26,58
80201,RIBERALTA,estado nutricional en menores de 5 anos,clasificacion d,2002-03-01,285,215,285,215,500
70503,ROBORE,estado nutricional en menores de 5 anos,clasificacion d,2002-03-01,0,70,0,70,70
80304,RURRENABAQUE,estado nutricional en menores de 5 anos,clasificacion d,2002-03-01,25,32,25,32,57
40901,SABAYA,estado nutricional en menores de 5 anos,clasificacion d,2002-03-01,0,7,0,7,7
31001,SACABA,estado nutricional en menores de 5 anos,clasificacion d,2002-03-01,90,123,90,123,213
30404,SACABAMBA,estado nutricional en menores de 5 anos,clasificacion d,2002-03-01,1,62,1,62,63
50701,SACACA,estado nutricional en menores de 5 anos,clasificacion d,2002-03-01,95,341,95,341,436
71302,SAIPINA,estado nutricional en menores de 5 anos,clasificacion d,2002-03-01,16,17,16,17,33
40801,SALINAS DE GARCI MENDOZA,estado nutricional en menores de 5 anos,clasificacion d,2002-03-01,9,9,9,9,18
70901,SAMAIPATA,estado nutricional en menores de 5 anos,clasificacion d,2002-03-01,19,9,19,9,28
51601,SAN AGUSTIN,estado nutricional en menores de 5 anos,clasificacion d,2002-03-01,0,11,0,11,11
80602,SAN ANDRES,estado nutricional en menores de 5 anos,clasificacion d,2002-03-01,6,9,6,9,15
51003,SAN ANTONIO DE ESMORUCO,estado nutricional en menores de 5 anos,clasificacion d,2002-03-01,0,22,0,22,22
71105,SAN ANTONIO DE LOMERIO,estado nutricional en menores de 5 anos,clasificacion d,2002-03-01,67,148,67,148,215
31403,SAN BENITO,estado nutricional en menores de 5 anos,clasificacion d,2002-03-01,3,31,3,31,34
80302,SAN BORJA,estado nutricional en menores de 5 anos,clasificacion d,2002-03-01,104,81,104,81,185
21502,SAN BUENA VENTURA,estado nutricional en menores de 5 anos,clasificacion d,2002-03-01,44,76,44,76,120
70402,SAN CARLOS,estado nutricional en menores de 5 anos,clasificacion d,2002-03-01,0,7,0,7,7
80501,SAN IGNACIO,estado nutricional en menores de 5 anos,clasificacion d,2002-03-01,36,79,36,79,115
70301,SAN IGNACIO DE VELASCO,estado nutricional en menores de 5 anos,clasificacion d,2002-03-01,147,257,147,257,404
80102,SAN JAVIER(BNI),estado nutricional en menores de 5 anos,clasificacion d,2002-03-01,6,9,6,9,15
71102,SAN JAVIER(STC),estado nutricional en menores de 5 anos,clasificacion d,2002-03-01,2,46,2,46,48
80701,SAN JOAQUIN,estado nutricional en menores de 5 anos,clasificacion d,2002-03-01,3,15,3,15,18
70501,SAN JOSE DE CHIQUITOS,estado nutricional en menores de 5 anos,clasificacion d,2002-03-01,64,29,64,29,93
71104,SAN JULIAN,estado nutricional en menores de 5 anos,clasificacion d,2002-03-01,103,198,103,198,301
60501,SAN LORENZO(TJA),estado nutricional en menores de 5 anos,clasificacion d,2002-03-01,34,72,34,72,106
10702,SAN LUCAS,estado nutricional en menores de 5 anos,clasificacion d,2002-03-01,37,683,37,683,720
71201,SAN MATIAS,estado nutricional en menores de 5 anos,clasificacion d,2002-03-01,70,38,70,38,108
70302,SAN MIGUEL DE VELASCO,estado nutricional en menores de 5 anos,clasificacion d,2002-03-01,65,92,65,92,157
51001,SAN PABLO DE LIPEZ,estado nutricional en menores de 5 anos,clasificacion d,2002-03-01,7,75,7,75,82
50501,SAN PEDRO DE BUENA VISTA,estado nutricional en menores de 5 anos,clasificacion d,2002-03-01,0,258,0,258,258
21801,SAN PEDRO DE CURAHUARA,estado nutricional en menores de 5 anos,clasificacion d,2002-03-01,16,29,16,29,45
50902,SAN PEDRO DE QUEMES,estado nutricional en menores de 5 anos,clasificacion d,2002-03-01,0,3,0,3,3
21702,SAN PEDRO DE TIQUINA,estado nutricional en menores de 5 anos,clasificacion d,2002-03-01,3,9,3,9,12
90202,SAN PEDRO(PND),estado nutricional en menores de 5 anos,clasificacion d,2002-03-01,2,2,2,2,4
70303,SAN RAFAEL,estado nutricional en menores de 5 anos,clasificacion d,2002-03-01,38,47,38,47,85
80702,SAN RAMON,estado nutricional en menores de 5 anos,clasificacion d,2002-03-01,0,37,0,37,37
80702,SAN RAMON,estado nutricional en menores de 5 anos,clasificacion d,2002-03-01,2,34,2,34,36
80401,SANTA ANA,estado nutricional en menores de 5 anos,clasificacion d,2002-03-01,20,16,20,16,36
70101,SANTA CRUZ DE LA SIERRA,estado nutricional en menores de 5 anos,clasificacion d,2002-03-01,315,385,315,385,700
80303,SANTA ROSA,estado nutricional en menores de 5 anos,clasificacion d,2002-03-01,12,15,12,15,27
70602,SANTA ROSA DEL SARA,estado nutricional en menores de 5 anos,clasificacion d,2002-03-01,11,11,11,11,22
20308,SANTIAGO DE CALLAPA,estado nutricional en menores de 5 anos,clasificacion d,2002-03-01,0,2,0,2,2
41401,SANTIAGO DE HUARI,estado nutricional en menores de 5 anos,clasificacion d,2002-03-01,17,22,17,22,39
21901,SANTIAGO DE MACHACA,estado nutricional en menores de 5 anos,clasificacion d,2002-03-01,8,5,8,5,13
30702,SANTIVAÃ‘ES,estado nutricional en menores de 5 anos,clasificacion d,2002-03-01,36,40,36,40,76
40202,SANTUARIO DE QUILLACAS,estado nutricional en menores de 5 anos,clasificacion d,2002-03-01,6,18,6,18,24
20902,SAPAHAQUI,estado nutricional en menores de 5 anos,clasificacion d,2002-03-01,0,29,0,29,29
21301,SICA SICA (VILLA AROMA),estado nutricional en menores de 5 anos,clasificacion d,2002-03-01,31,15,31,15,46
30703,SICAYA,estado nutricional en menores de 5 anos,clasificacion d,2002-03-01,0,27,0,27,27
30902,SIPE SIPE,estado nutricional en menores de 5 anos,clasificacion d,2002-03-01,122,93,122,93,215
10403,SOPACHUY,estado nutricional en menores de 5 anos,clasificacion d,2002-03-01,60,74,60,74,134
20601,SORATA,estado nutricional en menores de 5 anos,clasificacion d,2002-03-01,10,46,10,46,56
10101,SUCRE,estado nutricional en menores de 5 anos,clasificacion d,2002-03-01,242,1154,242,1154,1396
31404,TACACHI,estado nutricional en menores de 5 anos,clasificacion d,2002-03-01,0,12,0,12,12
20603,TACACOMA,estado nutricional en menores de 5 anos,clasificacion d,2002-03-01,10,15,10,15,25
50303,TACOBAMBA,estado nutricional en menores de 5 anos,clasificacion d,2002-03-01,27,58,27,58,85
30602,TACOPAYA,estado nutricional en menores de 5 anos,clasificacion d,2002-03-01,0,82,0,82,82
51402,TAHUA,estado nutricional en menores de 5 anos,clasificacion d,2002-03-01,0,11,0,11,11
31101,TAPACARI,estado nutricional en menores de 5 anos,clasificacion d,2002-03-01,5,106,5,106,111
10601,TARABUCO,estado nutricional en menores de 5 anos,clasificacion d,2002-03-01,70,666,70,666,736
30401,TARATA,estado nutricional en menores de 5 anos,clasificacion d,2002-03-01,2,41,2,41,43
60101,TARIJA,estado nutricional en menores de 5 anos,clasificacion d,2002-03-01,74,199,74,199,273
10202,TARVITA,estado nutricional en menores de 5 anos,clasificacion d,2002-03-01,52,90,52,90,142
20803,TIAWANACU,estado nutricional en menores de 5 anos,clasificacion d,2002-03-01,15,15,15,15,30
50102,TINGUIPAYA,estado nutricional en menores de 5 anos,clasificacion d,2002-03-01,19,78,19,78,97
20606,TIPUANI,estado nutricional en menores de 5 anos,clasificacion d,2002-03-01,10,5,10,5,15
30903,TIQUIPAYA,estado nutricional en menores de 5 anos,clasificacion d,2002-03-01,0,33,0,33,33
31601,TIRAQUE (CBBA),estado nutricional en menores de 5 anos,clasificacion d,2002-03-01,44,117,44,117,161
21703,TITO YUPANQUI (PARQUIPUJIO),estado nutricional en menores de 5 anos,clasificacion d,2002-03-01,0,21,0,21,21
30802,TOCO,estado nutricional en menores de 5 anos,clasificacion d,2002-03-01,0,9,0,9,9
30803,TOLATA,estado nutricional en menores de 5 anos,clasificacion d,2002-03-01,0,2,0,2,2
41001,TOLEDO,estado nutricional en menores de 5 anos,clasificacion d,2002-03-01,8,2,8,2,10
51202,TOMAVE,estado nutricional en menores de 5 anos,clasificacion d,2002-03-01,3,179,3,179,182
10402,TOMINA,estado nutricional en menores de 5 anos,clasificacion d,2002-03-01,108,185,108,185,293
50502,TORO TORO,estado nutricional en menores de 5 anos,clasificacion d,2002-03-01,7,72,7,72,79
31201,TOTORA(CBBA),estado nutricional en menores de 5 anos,clasificacion d,2002-03-01,38,47,38,47,85
41301,TOTORA(ORR),estado nutricional en menores de 5 anos,clasificacion d,2002-03-01,1,31,1,31,32
70802,TRIGAL,estado nutricional en menores de 5 anos,clasificacion d,2002-03-01,4,4,4,4,8
80101,TRINIDAD,estado nutricional en menores de 5 anos,clasificacion d,2002-03-01,80,147,80,147,227
50801,TUPIZA,estado nutricional en menores de 5 anos,clasificacion d,2002-03-01,8,437,8,437,445
40402,TURCO,estado nutricional en menores de 5 anos,clasificacion d,2002-03-01,10,12,10,12,22
21302,UMALA,estado nutricional en menores de 5 anos,clasificacion d,2002-03-01,4,15,4,15,19
60401,URIONDO (A. CONCEPCION),estado nutricional en menores de 5 anos,clasificacion d,2002-03-01,12,40,12,40,52
71502,URUBICHA,estado nutricional en menores de 5 anos,clasificacion d,2002-03-01,0,19,0,19,19
51201,UYUNI,estado nutricional en menores de 5 anos,clasificacion d,2002-03-01,5,139,5,139,144
30502,VACAS,estado nutricional en menores de 5 anos,clasificacion d,2002-03-01,3,34,3,34,37
70801,VALLEGRANDE,estado nutricional en menores de 5 anos,clasificacion d,2002-03-01,34,108,34,108,142
20801,VIACHA,estado nutricional en menores de 5 anos,clasificacion d,2002-03-01,7,129,7,129,136
31302,VILA VILA,estado nutricional en menores de 5 anos,clasificacion d,2002-03-01,0,64,0,64,64
60303,VILLA MONTES,estado nutricional en menores de 5 anos,clasificacion d,2002-03-01,57,73,57,73,130
90502,VILLA NUEVA (LOMA ALTA),estado nutricional en menores de 5 anos,clasificacion d,2002-03-01,1,0,1,0,1
31402,VILLA RIVERO,estado nutricional en menores de 5 anos,clasificacion d,2002-03-01,2,16,2,16,18
10801,VILLA SERRANO,estado nutricional en menores de 5 anos,clasificacion d,2002-03-01,113,176,113,176,289
31003,VILLA TUNARI,estado nutricional en menores de 5 anos,clasificacion d,2002-03-01,60,141,60,141,201
11001,VILLA VACA GUZMAN (MUYUPAMPA),estado nutricional en menores de 5 anos,clasificacion d,2002-03-01,60,95,60,95,155
51501,VILLAZON,estado nutricional en menores de 5 anos,clasificacion d,2002-03-01,4,236,4,236,240
30904,VINTO,estado nutricional en menores de 5 anos,clasificacion d,2002-03-01,24,21,24,21,45
50602,VITICHI,estado nutricional en menores de 5 anos,clasificacion d,2002-03-01,18,114,18,114,132
20306,WALDO BALLIVIAN,estado nutricional en menores de 5 anos,clasificacion d,2002-03-01,1,3,1,3,4
70201,WARNES,estado nutricional en menores de 5 anos,clasificacion d,2002-03-01,95,115,95,115,210
20903,YACO,estado nutricional en menores de 5 anos,clasificacion d,2002-03-01,2,38,2,38,40
60301,YACUIBA,estado nutricional en menores de 5 anos,clasificacion d,2002-03-01,69,109,69,109,178
10602,YAMPARAEZ,estado nutricional en menores de 5 anos,clasificacion d,2002-03-01,147,298,147,298,445
21103,YANACACHI,estado nutricional en menores de 5 anos,clasificacion d,2002-03-01,8,3,8,3,11
70403,YAPACANI,estado nutricional en menores de 5 anos,clasificacion d,2002-03-01,80,100,80,100,180
50103,YOCALLA,estado nutricional en menores de 5 anos,clasificacion d,2002-03-01,0,84,0,84,84
10102,YOTALA,estado nutricional en menores de 5 anos,clasificacion d,2002-03-01,96,213,96,213,309
60402,YUNCHARA,estado nutricional en menores de 5 anos,clasificacion d,2002-03-01,7,37,7,37,44
10301,ZUDAÃ‘EZ,estado nutricional en menores de 5 anos,clasificacion d,2002-03-01,76,147,76,147,223
51302,ACACIO,estado nutricional en menores de 5 anos,clasificacion d,2002-04-01,22,112,22,112,134
20201,ACHACACHI,estado nutricional en menores de 5 anos,clasificacion d,2002-04-01,121,154,121,154,275
20104,ACHOCALLA,estado nutricional en menores de 5 anos,clasificacion d,2002-04-01,13,11,13,11,24
30201,AIQUILE,estado nutricional en menores de 5 anos,clasificacion d,2002-04-01,8,26,8,26,34
31303,ALALAY,estado nutricional en menores de 5 anos,clasificacion d,2002-04-01,7,15,7,15,22
10404,ALCALA,estado nutricional en menores de 5 anos,clasificacion d,2002-04-01,42,62,42,62,104
20202,ANCORAIMES,estado nutricional en menores de 5 anos,clasificacion d,2002-04-01,80,114,80,114,194
41201,ANDAMARCA,estado nutricional en menores de 5 anos,clasificacion d,2002-04-01,4,0,4,0,4
40603,ANTEQUERA,estado nutricional en menores de 5 anos,clasificacion d,2002-04-01,0,2,0,2,2
30402,ANZALDO,estado nutricional en menores de 5 anos,clasificacion d,2002-04-01,3,82,3,82,85
20701,APOLO,estado nutricional en menores de 5 anos,clasificacion d,2002-04-01,20,8,20,8,28
51301,ARAMPAMPA,estado nutricional en menores de 5 anos,clasificacion d,2002-04-01,19,94,19,94,113
30501,ARANI,estado nutricional en menores de 5 anos,clasificacion d,2002-04-01,7,33,7,33,40
30403,ARBIETO,estado nutricional en menores de 5 anos,clasificacion d,2002-04-01,7,29,7,29,36
30601,ARQUE,estado nutricional en menores de 5 anos,clasificacion d,2002-04-01,17,32,17,32,49
71501,ASCENCION DE GUARAYOS,estado nutricional en menores de 5 anos,clasificacion d,2002-04-01,167,243,167,243,410
50802,ATOCHA,estado nutricional en menores de 5 anos,clasificacion d,2002-04-01,1,71,1,71,72
20503,AUCAPATA,estado nutricional en menores de 5 anos,clasificacion d,2002-04-01,19,6,19,6,25
20502,AYATA,estado nutricional en menores de 5 anos,clasificacion d,2002-04-01,6,13,6,13,19
21303,AYO AYO,estado nutricional en menores de 5 anos,clasificacion d,2002-04-01,23,3,23,3,26
30301,AYOPAYA (V. DE INDEPENDENCIA),estado nutricional en menores de 5 anos,clasificacion d,2002-04-01,109,92,109,92,201
10201,AZURDUY,estado nutricional en menores de 5 anos,clasificacion d,2002-04-01,98,114,98,114,212
21203,BATALLAS,estado nutricional en menores de 5 anos,clasificacion d,2002-04-01,1,45,1,45,46
80802,BAURES,estado nutricional en menores de 5 anos,clasificacion d,2002-04-01,22,32,22,32,54
41202,BELEN DE ANDAMARCA,estado nutricional en menores de 5 anos,clasificacion d,2002-04-01,0,3,0,3,3
50104,BELEN DE URMIRI,estado nutricional en menores de 5 anos,clasificacion d,2002-04-01,7,27,7,27,34
90104,BELLA FLOR,estado nutricional en menores de 5 anos,clasificacion d,2002-04-01,10,11,10,11,21
60202,BERMEJO,estado nutricional en menores de 5 anos,clasificacion d,2002-04-01,4,7,4,7,11
50301,BETANZOS,estado nutricional en menores de 5 anos,clasificacion d,2002-04-01,78,325,78,325,403
31501,BOLIVAR,estado nutricional en menores de 5 anos,clasificacion d,2002-04-01,53,97,53,97,150
90103,BOLPEBRA,estado nutricional en menores de 5 anos,clasificacion d,2002-04-01,0,2,0,2,2
70707,BOYUIBE,estado nutricional en menores de 5 anos,clasificacion d,2002-04-01,2,31,2,31,33
70401,BUENA VISTA,estado nutricional en menores de 5 anos,clasificacion d,2002-04-01,51,39,51,39,90
70703,CABEZAS,estado nutricional en menores de 5 anos,clasificacion d,2002-04-01,1,50,1,50,51
20905,CAIROMA,estado nutricional en menores de 5 anos,clasificacion d,2002-04-01,0,22,0,22,22
51102,"CAIZA ""D""",estado nutricional en menores de 5 anos,clasificacion d,2002-04-01,27,60,27,60,87
21003,CAJUATA,estado nutricional en menores de 5 anos,clasificacion d,2002-04-01,15,9,15,9,24
20303,CALACOTO,estado nutricional en menores de 5 anos,clasificacion d,2002-04-01,8,26,8,26,34
21304,CALAMARCA,estado nutricional en menores de 5 anos,clasificacion d,2002-04-01,23,13,23,13,36
10701,CAMARGO,estado nutricional en menores de 5 anos,clasificacion d,2002-04-01,2,89,2,89,91
10901,CAMATAQUI (C. VILLA ABECIA),estado nutricional en menores de 5 anos,clasificacion d,2002-04-01,1,51,1,51,52
70706,CAMIRI,estado nutricional en menores de 5 anos,clasificacion d,2002-04-01,57,121,57,121,178
30701,CAPINOTA,estado nutricional en menores de 5 anos,clasificacion d,2002-04-01,22,20,22,20,42
20302,CAQUIAVIRI,estado nutricional en menores de 5 anos,clasificacion d,2002-04-01,32,43,32,43,75
40102,CARACOLLO,estado nutricional en menores de 5 anos,clasificacion d,2002-04-01,27,42,27,42,69
22001,CARANAVI,estado nutricional en menores de 5 anos,clasificacion d,2002-04-01,158,205,158,205,363
41503,CARANGAS,estado nutricional en menores de 5 anos,clasificacion d,2002-04-01,0,1,0,1,1
60302,CARAPARI,estado nutricional en menores de 5 anos,clasificacion d,2002-04-01,22,44,22,44,66
50702,CARIPUYO,estado nutricional en menores de 5 anos,clasificacion d,2002-04-01,8,83,8,83,91
21902,CATACORA,estado nutricional en menores de 5 anos,clasificacion d,2002-04-01,4,9,4,9,13
40201,CHALLAPATA,estado nutricional en menores de 5 anos,clasificacion d,2002-04-01,52,91,52,91,143
50302,CHAQUI,estado nutricional en menores de 5 anos,clasificacion d,2002-04-01,0,105,0,105,105
70702,CHARAGUA,estado nutricional en menores de 5 anos,clasificacion d,2002-04-01,6,247,6,247,253
20305,CHARAÃ‘A,estado nutricional en menores de 5 anos,clasificacion d,2002-04-01,0,19,0,19,19
31204,CHIMORE,estado nutricional en menores de 5 anos,clasificacion d,2002-04-01,27,10,27,10,37
40302,CHOQUE COTA,estado nutricional en menores de 5 anos,clasificacion d,2002-04-01,0,20,0,20,20
21101,CHULUMANI (V. DE LA LIBERTAD),estado nutricional en menores de 5 anos,clasificacion d,2002-04-01,3,27,3,27,30
20501,CHUMA,estado nutricional en menores de 5 anos,clasificacion d,2002-04-01,16,25,16,25,41
30801,CLIZA,estado nutricional en menores de 5 anos,clasificacion d,2002-04-01,4,20,4,20,24
90101,COBIJA,estado nutricional en menores de 5 anos,clasificacion d,2002-04-01,103,73,103,73,176
30101,COCHABAMBA,estado nutricional en menores de 5 anos,clasificacion d,2002-04-01,379,373,379,373,752
40902,COIPASA,estado nutricional en menores de 5 anos,clasificacion d,2002-04-01,0,1,0,1,1
30905,COLCAPIRHUA,estado nutricional en menores de 5 anos,clasificacion d,2002-04-01,38,52,38,52,90
50901,"COLCHA ""K""",estado nutricional en menores de 5 anos,clasificacion d,2002-04-01,1,68,1,68,69
21307,COLLANA,estado nutricional en menores de 5 anos,clasificacion d,2002-04-01,3,0,3,0,3
31002,COLOMI,estado nutricional en menores de 5 anos,clasificacion d,2002-04-01,36,57,36,57,93
50401,COLQUECHACA,estado nutricional en menores de 5 anos,clasificacion d,2002-04-01,72,117,72,117,189
21306,COLQUENCHA,estado nutricional en menores de 5 anos,clasificacion d,2002-04-01,20,7,20,7,27
21004,COLQUIRI,estado nutricional en menores de 5 anos,clasificacion d,2002-04-01,60,52,60,52,112
20304,COMANCHE,estado nutricional en menores de 5 anos,clasificacion d,2002-04-01,3,8,3,8,11
71301,COMARAPA,estado nutricional en menores de 5 anos,clasificacion d,2002-04-01,16,19,16,19,35
20605,COMBAYA,estado nutricional en menores de 5 anos,clasificacion d,2002-04-01,10,12,10,12,22
71101,CONCEPCION,estado nutricional en menores de 5 anos,clasificacion d,2002-04-01,2,10,2,10,12
21701,COPACABANA,estado nutricional en menores de 5 anos,clasificacion d,2002-04-01,4,34,4,34,38
21402,CORIPATA,estado nutricional en menores de 5 anos,clasificacion d,2002-04-01,6,17,6,17,23
20301,CORO CORO,estado nutricional en menores de 5 anos,clasificacion d,2002-04-01,27,46,27,46,73
21401,COROICO,estado nutricional en menores de 5 anos,clasificacion d,2002-04-01,8,8,8,8,16
40301,CORQUE,estado nutricional en menores de 5 anos,clasificacion d,2002-04-01,14,14,14,14,28
50601,COTAGAITA,estado nutricional en menores de 5 anos,clasificacion d,2002-04-01,11,199,11,199,210
70102,COTOCA,estado nutricional en menores de 5 anos,clasificacion d,2002-04-01,35,42,35,42,77
31405,CUCHUMUELA (V. G. VILLARROEL),estado nutricional en menores de 5 anos,clasificacion d,2002-04-01,0,23,0,23,23
70704,CUEVO,estado nutricional en menores de 5 anos,clasificacion d,2002-04-01,16,10,16,10,26
10902,CULPINA,estado nutricional en menores de 5 anos,clasificacion d,2002-04-01,101,108,101,108,209
40401,CURAHUARA DE CARANGAS,estado nutricional en menores de 5 anos,clasificacion d,2002-04-01,17,12,17,12,29
20804,DESAGUADERO,estado nutricional en menores de 5 anos,clasificacion d,2002-04-01,2,16,2,16,18
20105,EL ALTO,estado nutricional en menores de 5 anos,clasificacion d,2002-04-01,1344,1270,1344,1270,2614
40103,EL CHORO,estado nutricional en menores de 5 anos,clasificacion d,2002-04-01,1,0,1,0,1
71503,EL PUENTE(STC),estado nutricional en menores de 5 anos,clasificacion d,2002-04-01,18,143,18,143,161
60502,EL PUENTE(TJA),estado nutricional en menores de 5 anos,clasificacion d,2002-04-01,24,50,24,50,74
70105,EL TORNO,estado nutricional en menores de 5 anos,clasificacion d,2002-04-01,63,41,63,41,104
10405,EL VILLAR,estado nutricional en menores de 5 anos,clasificacion d,2002-04-01,50,113,50,113,163
60601,ENTRE RIOS,estado nutricional en menores de 5 anos,clasificacion d,2002-04-01,50,65,50,65,115
41101,EUCALIPTUS,estado nutricional en menores de 5 anos,clasificacion d,2002-04-01,1,26,1,26,27
80402,EXALTACION,estado nutricional en menores de 5 anos,clasificacion d,2002-04-01,11,20,11,20,31
90203,FILADELFIA,estado nutricional en menores de 5 anos,clasificacion d,2002-04-01,0,11,0,11,11
21601,GRAL. J.J. PEREZ (CHARAZANI),estado nutricional en menores de 5 anos,clasificacion d,2002-04-01,12,5,12,5,17
20602,GUANAY,estado nutricional en menores de 5 anos,clasificacion d,2002-04-01,11,121,11,121,132
20802,GUAQUI,estado nutricional en menores de 5 anos,clasificacion d,2002-04-01,0,6,0,6,6
80202,GUAYARAMERIN,estado nutricional en menores de 5 anos,clasificacion d,2002-04-01,109,83,109,83,192
70705,GUTIERREZ,estado nutricional en menores de 5 anos,clasificacion d,2002-04-01,9,154,9,154,163
10502,HUACARETA,estado nutricional en menores de 5 anos,clasificacion d,2002-04-01,81,104,81,104,185
11002,HUACAYA (VILLA DE HUACAYA),estado nutricional en menores de 5 anos,clasificacion d,2002-04-01,11,24,11,24,35
40501,HUACHACALLA,estado nutricional en menores de 5 anos,clasificacion d,2002-04-01,1,10,1,10,11
40701,HUANUNI,estado nutricional en menores de 5 anos,clasificacion d,2002-04-01,4,1,4,1,5
80803,HUARACAJE,estado nutricional en menores de 5 anos,clasificacion d,2002-04-01,6,4,6,4,10
41601,HUAYLLAMARCA,estado nutricional en menores de 5 anos,clasificacion d,2002-04-01,11,17,11,17,28
21005,ICHOCA,estado nutricional en menores de 5 anos,clasificacion d,2002-04-01,12,21,12,21,33
10304,ICLA,estado nutricional en menores de 5 anos,clasificacion d,2002-04-01,83,139,83,139,222
10703,INCAHUASI,estado nutricional en menores de 5 anos,clasificacion d,2002-04-01,17,181,17,181,198
21001,INQUISIVI,estado nutricional en menores de 5 anos,clasificacion d,2002-04-01,4,42,4,42,46
21102,IRUPANA (VILLA DE LANZA),estado nutricional en menores de 5 anos,clasificacion d,2002-04-01,9,23,9,23,32
21501,IXIAMAS,estado nutricional en menores de 5 anos,clasificacion d,2002-04-01,29,38,29,38,67
21105,LA ASUNTA,estado nutricional en menores de 5 anos,clasificacion d,2002-04-01,19,50,19,50,69
70104,LA GUARDIA,estado nutricional en menores de 5 anos,clasificacion d,2002-04-01,90,45,90,45,135
20101,LA PAZ,estado nutricional en menores de 5 anos,clasificacion d,2002-04-01,1000,955,1000,955,1955
70701,LAGUNILLAS,estado nutricional en menores de 5 anos,clasificacion d,2002-04-01,21,58,21,58,79
21202,LAJA,estado nutricional en menores de 5 anos,clasificacion d,2002-04-01,0,47,0,47,47
10903,LAS CARRERAS,estado nutricional en menores de 5 anos,clasificacion d,2002-04-01,14,41,14,41,55
21006,LICOMA PAMPA,estado nutricional en menores de 5 anos,clasificacion d,2002-04-01,0,5,0,5,5
51401,LLICA,estado nutricional en menores de 5 anos,clasificacion d,2002-04-01,0,11,0,11,11
80601,LORETO,estado nutricional en menores de 5 anos,clasificacion d,2002-04-01,3,7,3,7,10
20901,LURIBAY,estado nutricional en menores de 5 anos,clasificacion d,2002-04-01,8,17,8,17,25
40702,MACHACAMARCA,estado nutricional en menores de 5 anos,clasificacion d,2002-04-01,6,10,6,10,16
11003,MACHARETI,estado nutricional en menores de 5 anos,clasificacion d,2002-04-01,26,100,26,100,126
80801,MAGDALENA,estado nutricional en menores de 5 anos,clasificacion d,2002-04-01,12,17,12,17,29
70903,MAIRANA,estado nutricional en menores de 5 anos,clasificacion d,2002-04-01,15,16,15,16,31
20904,MALLA,estado nutricional en menores de 5 anos,clasificacion d,2002-04-01,0,10,0,10,10
20103,MECAPACA,estado nutricional en menores de 5 anos,clasificacion d,2002-04-01,5,24,5,24,29
71003,MINEROS,estado nutricional en menores de 5 anos,clasificacion d,2002-04-01,29,20,29,20,49
31301,MIZQUE,estado nutricional en menores de 5 anos,clasificacion d,2002-04-01,11,26,11,26,37
20402,MOCOMOCO,estado nutricional en menores de 5 anos,clasificacion d,2002-04-01,27,19,27,19,46
51002,MOJINETE,estado nutricional en menores de 5 anos,clasificacion d,2002-04-01,0,15,0,15,15
10303,MOJOCOYA,estado nutricional en menores de 5 anos,clasificacion d,2002-04-01,77,124,77,124,201
10501,MONTEAGUDO,estado nutricional en menores de 5 anos,clasificacion d,2002-04-01,120,194,120,194,314
71001,MONTERO,estado nutricional en menores de 5 anos,clasificacion d,2002-04-01,0,33,0,33,33
70803,MORO MORO,estado nutricional en menores de 5 anos,clasificacion d,2002-04-01,17,15,17,15,32
30302,MOROCHATA,estado nutricional en menores de 5 anos,clasificacion d,2002-04-01,23,52,23,52,75
90401,NACEBE (SANTA ROSA DEL ABUNA),estado nutricional en menores de 5 anos,clasificacion d,2002-04-01,0,11,0,11,11
20307,NAZACARA DE PACAJES,estado nutricional en menores de 5 anos,clasificacion d,2002-04-01,1,7,1,7,8
90501,NUEVO MANOA (NUEVA ESPERANZA),estado nutricional en menores de 5 anos,clasificacion d,2002-04-01,11,1,11,1,12
50404,OCURI,estado nutricional en menores de 5 anos,clasificacion d,2002-04-01,38,46,38,46,84
70202,OKINAWA,estado nutricional en menores de 5 anos,clasificacion d,2002-04-01,11,32,11,32,43
30203,OMEREQUE,estado nutricional en menores de 5 anos,clasificacion d,2002-04-01,0,26,0,26,26
40101,ORURO,estado nutricional en menores de 5 anos,clasificacion d,2002-04-01,389,420,389,420,809
60201,PADCAYA,estado nutricional en menores de 5 anos,clasificacion d,2002-04-01,56,77,56,77,133
10401,PADILLA,estado nutricional en menores de 5 anos,clasificacion d,2002-04-01,152,245,152,245,397
70502,PAILON,estado nutricional en menores de 5 anos,clasificacion d,2002-04-01,0,56,0,56,56
20102,PALCA,estado nutricional en menores de 5 anos,clasificacion d,2002-04-01,33,41,33,41,74
21104,PALOS BLANCOS,estado nutricional en menores de 5 anos,clasificacion d,2002-04-01,66,165,66,165,231
40802,PAMPA AULLAGAS,estado nutricional en menores de 5 anos,clasificacion d,2002-04-01,0,37,0,37,37
70902,PAMPA GRANDE,estado nutricional en menores de 5 anos,clasificacion d,2002-04-01,26,15,26,15,41
21802,PAPEL PAMPA,estado nutricional en menores de 5 anos,clasificacion d,2002-04-01,10,6,10,6,16
30202,PASORAPA,estado nutricional en menores de 5 anos,clasificacion d,2002-04-01,6,38,6,38,44
21305,PATACAMAYA,estado nutricional en menores de 5 anos,clasificacion d,2002-04-01,30,7,30,7,37
40602,PAZÃ‘A,estado nutricional en menores de 5 anos,clasificacion d,2002-04-01,0,13,0,13,13
20702,PELECHUCO,estado nutricional en menores de 5 anos,clasificacion d,2002-04-01,14,14,14,14,28
50403,POCOATA,estado nutricional en menores de 5 anos,clasificacion d,2002-04-01,88,158,88,158,246
31203,POCONA,estado nutricional en menores de 5 anos,clasificacion d,2002-04-01,42,67,42,67,109
31202,POJO (CBBA),estado nutricional en menores de 5 anos,clasificacion d,2002-04-01,115,110,115,110,225
40601,POOPO,estado nutricional en menores de 5 anos,clasificacion d,2002-04-01,3,19,3,19,22
51203,PORCO,estado nutricional en menores de 5 anos,clasificacion d,2002-04-01,23,50,23,50,73
10103,POROMA,estado nutricional en menores de 5 anos,clasificacion d,2002-04-01,78,92,78,92,170
70103,PORONGO,estado nutricional en menores de 5 anos,clasificacion d,2002-04-01,14,17,14,17,31
70601,PORTACHUELO,estado nutricional en menores de 5 anos,clasificacion d,2002-04-01,58,63,58,63,121
50101,POTOSI,estado nutricional en menores de 5 anos,clasificacion d,2002-04-01,500,410,500,410,910
10302,PRESTO,estado nutricional en menores de 5 anos,clasificacion d,2002-04-01,74,71,74,71,145
70805,PUCARA,estado nutricional en menores de 5 anos,clasificacion d,2002-04-01,2,7,2,7,9
21201,PUCARANI,estado nutricional en menores de 5 anos,clasificacion d,2002-04-01,4,51,4,51,55
20401,PUERTO ACOSTA,estado nutricional en menores de 5 anos,clasificacion d,2002-04-01,75,123,75,123,198
20403,PUERTO CARABUCO,estado nutricional en menores de 5 anos,clasificacion d,2002-04-01,62,57,62,57,119
90301,PUERTO GONZALO MORENO,estado nutricional en menores de 5 anos,clasificacion d,2002-04-01,9,17,9,17,26
21204,PUERTO PEREZ,estado nutricional en menores de 5 anos,clasificacion d,2002-04-01,0,10,0,10,10
71402,PUERTO QUIJARRO,estado nutricional en menores de 5 anos,clasificacion d,2002-04-01,33,19,33,19,52
90201,PUERTO RICO,estado nutricional en menores de 5 anos,clasificacion d,2002-04-01,4,16,4,16,20
80703,PUERTO SILES,estado nutricional en menores de 5 anos,clasificacion d,2002-04-01,0,5,0,5,5
71401,PUERTO SUAREZ,estado nutricional en menores de 5 anos,clasificacion d,2002-04-01,38,11,38,11,49
31205,PUERTO VILLARROEL,estado nutricional en menores de 5 anos,clasificacion d,2002-04-01,103,92,103,92,195
51101,PUNA,estado nutricional en menores de 5 anos,clasificacion d,2002-04-01,48,253,48,253,301
31401,PUNATA,estado nutricional en menores de 5 anos,clasificacion d,2002-04-01,32,133,32,133,165
20604,QUIABAYA,estado nutricional en menores de 5 anos,clasificacion d,2002-04-01,11,24,11,24,35
30901,QUILLACOLLO,estado nutricional en menores de 5 anos,clasificacion d,2002-04-01,33,21,33,21,54
21002,QUIME,estado nutricional en menores de 5 anos,clasificacion d,2002-04-01,18,33,18,33,51
50402,RAVELO,estado nutricional en menores de 5 anos,clasificacion d,2002-04-01,71,128,71,128,199
80301,REYES,estado nutricional en menores de 5 anos,clasificacion d,2002-04-01,31,41,31,41,72
80201,RIBERALTA,estado nutricional en menores de 5 anos,clasificacion d,2002-04-01,381,316,381,316,697
70503,ROBORE,estado nutricional en menores de 5 anos,clasificacion d,2002-04-01,0,69,0,69,69
80304,RURRENABAQUE,estado nutricional en menores de 5 anos,clasificacion d,2002-04-01,21,28,21,28,49
40901,SABAYA,estado nutricional en menores de 5 anos,clasificacion d,2002-04-01,0,3,0,3,3
31001,SACABA,estado nutricional en menores de 5 anos,clasificacion d,2002-04-01,49,24,49,24,73
30404,SACABAMBA,estado nutricional en menores de 5 anos,clasificacion d,2002-04-01,1,25,1,25,26
50701,SACACA,estado nutricional en menores de 5 anos,clasificacion d,2002-04-01,79,196,79,196,275
71302,SAIPINA,estado nutricional en menores de 5 anos,clasificacion d,2002-04-01,27,19,27,19,46
40801,SALINAS DE GARCI MENDOZA,estado nutricional en menores de 5 anos,clasificacion d,2002-04-01,19,21,19,21,40
70901,SAMAIPATA,estado nutricional en menores de 5 anos,clasificacion d,2002-04-01,8,14,8,14,22
51601,SAN AGUSTIN,estado nutricional en menores de 5 anos,clasificacion d,2002-04-01,0,17,0,17,17
80602,SAN ANDRES,estado nutricional en menores de 5 anos,clasificacion d,2002-04-01,20,55,20,55,75
51003,SAN ANTONIO DE ESMORUCO,estado nutricional en menores de 5 anos,clasificacion d,2002-04-01,0,13,0,13,13
71105,SAN ANTONIO DE LOMERIO,estado nutricional en menores de 5 anos,clasificacion d,2002-04-01,74,137,74,137,211
31403,SAN BENITO,estado nutricional en menores de 5 anos,clasificacion d,2002-04-01,0,41,0,41,41
80302,SAN BORJA,estado nutricional en menores de 5 anos,clasificacion d,2002-04-01,117,112,117,112,229
21502,SAN BUENA VENTURA,estado nutricional en menores de 5 anos,clasificacion d,2002-04-01,51,90,51,90,141
70402,SAN CARLOS,estado nutricional en menores de 5 anos,clasificacion d,2002-04-01,2,27,2,27,29
80501,SAN IGNACIO,estado nutricional en menores de 5 anos,clasificacion d,2002-04-01,28,146,28,146,174
70301,SAN IGNACIO DE VELASCO,estado nutricional en menores de 5 anos,clasificacion d,2002-04-01,224,175,224,175,399
80102,SAN JAVIER(BNI),estado nutricional en menores de 5 anos,clasificacion d,2002-04-01,6,32,6,32,38
71102,SAN JAVIER(STC),estado nutricional en menores de 5 anos,clasificacion d,2002-04-01,14,7,14,7,21
80701,SAN JOAQUIN,estado nutricional en menores de 5 anos,clasificacion d,2002-04-01,3,22,3,22,25
70501,SAN JOSE DE CHIQUITOS,estado nutricional en menores de 5 anos,clasificacion d,2002-04-01,58,44,58,44,102
71104,SAN JULIAN,estado nutricional en menores de 5 anos,clasificacion d,2002-04-01,103,282,103,282,385
60501,SAN LORENZO(TJA),estado nutricional en menores de 5 anos,clasificacion d,2002-04-01,19,23,19,23,42
10702,SAN LUCAS,estado nutricional en menores de 5 anos,clasificacion d,2002-04-01,306,424,306,424,730
71201,SAN MATIAS,estado nutricional en menores de 5 anos,clasificacion d,2002-04-01,55,33,55,33,88
70302,SAN MIGUEL DE VELASCO,estado nutricional en menores de 5 anos,clasificacion d,2002-04-01,87,78,87,78,165
51001,SAN PABLO DE LIPEZ,estado nutricional en menores de 5 anos,clasificacion d,2002-04-01,1,16,1,16,17
50501,SAN PEDRO DE BUENA VISTA,estado nutricional en menores de 5 anos,clasificacion d,2002-04-01,7,137,7,137,144
21801,SAN PEDRO DE CURAHUARA,estado nutricional en menores de 5 anos,clasificacion d,2002-04-01,2,15,2,15,17
50902,SAN PEDRO DE QUEMES,estado nutricional en menores de 5 anos,clasificacion d,2002-04-01,0,4,0,4,4
21702,SAN PEDRO DE TIQUINA,estado nutricional en menores de 5 anos,clasificacion d,2002-04-01,0,7,0,7,7
90202,SAN PEDRO(PND),estado nutricional en menores de 5 anos,clasificacion d,2002-04-01,1,0,1,0,1
70303,SAN RAFAEL,estado nutricional en menores de 5 anos,clasificacion d,2002-04-01,37,23,37,23,60
80702,SAN RAMON,estado nutricional en menores de 5 anos,clasificacion d,2002-04-01,2,2,2,2,4
80702,SAN RAMON,estado nutricional en menores de 5 anos,clasificacion d,2002-04-01,10,32,10,32,42
80401,SANTA ANA,estado nutricional en menores de 5 anos,clasificacion d,2002-04-01,42,18,42,18,60
70101,SANTA CRUZ DE LA SIERRA,estado nutricional en menores de 5 anos,clasificacion d,2002-04-01,286,427,286,427,713
80303,SANTA ROSA,estado nutricional en menores de 5 anos,clasificacion d,2002-04-01,23,4,23,4,27
70602,SANTA ROSA DEL SARA,estado nutricional en menores de 5 anos,clasificacion d,2002-04-01,15,14,15,14,29
20308,SANTIAGO DE CALLAPA,estado nutricional en menores de 5 anos,clasificacion d,2002-04-01,8,39,8,39,47
41401,SANTIAGO DE HUARI,estado nutricional en menores de 5 anos,clasificacion d,2002-04-01,15,18,15,18,33
21901,SANTIAGO DE MACHACA,estado nutricional en menores de 5 anos,clasificacion d,2002-04-01,14,20,14,20,34
30702,SANTIVAÃ‘ES,estado nutricional en menores de 5 anos,clasificacion d,2002-04-01,23,15,23,15,38
40202,SANTUARIO DE QUILLACAS,estado nutricional en menores de 5 anos,clasificacion d,2002-04-01,3,26,3,26,29
20902,SAPAHAQUI,estado nutricional en menores de 5 anos,clasificacion d,2002-04-01,0,6,0,6,6
21301,SICA SICA (VILLA AROMA),estado nutricional en menores de 5 anos,clasificacion d,2002-04-01,28,18,28,18,46
30703,SICAYA,estado nutricional en menores de 5 anos,clasificacion d,2002-04-01,1,27,1,27,28
30902,SIPE SIPE,estado nutricional en menores de 5 anos,clasificacion d,2002-04-01,132,122,132,122,254
10403,SOPACHUY,estado nutricional en menores de 5 anos,clasificacion d,2002-04-01,44,72,44,72,116
20601,SORATA,estado nutricional en menores de 5 anos,clasificacion d,2002-04-01,11,30,11,30,41
10101,SUCRE,estado nutricional en menores de 5 anos,clasificacion d,2002-04-01,778,757,778,757,1535
31404,TACACHI,estado nutricional en menores de 5 anos,clasificacion d,2002-04-01,1,15,1,15,16
20603,TACACOMA,estado nutricional en menores de 5 anos,clasificacion d,2002-04-01,1,25,1,25,26
50303,TACOBAMBA,estado nutricional en menores de 5 anos,clasificacion d,2002-04-01,48,57,48,57,105
30602,TACOPAYA,estado nutricional en menores de 5 anos,clasificacion d,2002-04-01,26,67,26,67,93
51402,TAHUA,estado nutricional en menores de 5 anos,clasificacion d,2002-04-01,0,9,0,9,9
31101,TAPACARI,estado nutricional en menores de 5 anos,clasificacion d,2002-04-01,7,100,7,100,107
10601,TARABUCO,estado nutricional en menores de 5 anos,clasificacion d,2002-04-01,151,584,151,584,735
30401,TARATA,estado nutricional en menores de 5 anos,clasificacion d,2002-04-01,2,54,2,54,56
60101,TARIJA,estado nutricional en menores de 5 anos,clasificacion d,2002-04-01,134,285,134,285,419
10202,TARVITA,estado nutricional en menores de 5 anos,clasificacion d,2002-04-01,80,130,80,130,210
20803,TIAWANACU,estado nutricional en menores de 5 anos,clasificacion d,2002-04-01,24,12,24,12,36
50102,TINGUIPAYA,estado nutricional en menores de 5 anos,clasificacion d,2002-04-01,1,105,1,105,106
20606,TIPUANI,estado nutricional en menores de 5 anos,clasificacion d,2002-04-01,15,10,15,10,25
30903,TIQUIPAYA,estado nutricional en menores de 5 anos,clasificacion d,2002-04-01,0,25,0,25,25
31601,TIRAQUE (CBBA),estado nutricional en menores de 5 anos,clasificacion d,2002-04-01,70,149,70,149,219
21703,TITO YUPANQUI (PARQUIPUJIO),estado nutricional en menores de 5 anos,clasificacion d,2002-04-01,0,18,0,18,18
30802,TOCO,estado nutricional en menores de 5 anos,clasificacion d,2002-04-01,1,6,1,6,7
41001,TOLEDO,estado nutricional en menores de 5 anos,clasificacion d,2002-04-01,8,8,8,8,16
51202,TOMAVE,estado nutricional en menores de 5 anos,clasificacion d,2002-04-01,2,132,2,132,134
10402,TOMINA,estado nutricional en menores de 5 anos,clasificacion d,2002-04-01,106,178,106,178,284
50502,TORO TORO,estado nutricional en menores de 5 anos,clasificacion d,2002-04-01,5,28,5,28,33
31201,TOTORA(CBBA),estado nutricional en menores de 5 anos,clasificacion d,2002-04-01,66,61,66,61,127
41301,TOTORA(ORR),estado nutricional en menores de 5 anos,clasificacion d,2002-04-01,0,26,0,26,26
70802,TRIGAL,estado nutricional en menores de 5 anos,clasificacion d,2002-04-01,6,5,6,5,11
80101,TRINIDAD,estado nutricional en menores de 5 anos,clasificacion d,2002-04-01,140,177,140,177,317
50801,TUPIZA,estado nutricional en menores de 5 anos,clasificacion d,2002-04-01,7,327,7,327,334
40402,TURCO,estado nutricional en menores de 5 anos,clasificacion d,2002-04-01,5,11,5,11,16
21302,UMALA,estado nutricional en menores de 5 anos,clasificacion d,2002-04-01,6,2,6,2,8
60401,URIONDO (A. CONCEPCION),estado nutricional en menores de 5 anos,clasificacion d,2002-04-01,19,40,19,40,59
71502,URUBICHA,estado nutricional en menores de 5 anos,clasificacion d,2002-04-01,79,198,79,198,277
51201,UYUNI,estado nutricional en menores de 5 anos,clasificacion d,2002-04-01,6,190,6,190,196
30502,VACAS,estado nutricional en menores de 5 anos,clasificacion d,2002-04-01,4,33,4,33,37
70801,VALLEGRANDE,estado nutricional en menores de 5 anos,clasificacion d,2002-04-01,40,56,40,56,96
20801,VIACHA,estado nutricional en menores de 5 anos,clasificacion d,2002-04-01,12,134,12,134,146
31302,VILA VILA,estado nutricional en menores de 5 anos,clasificacion d,2002-04-01,6,35,6,35,41
60303,VILLA MONTES,estado nutricional en menores de 5 anos,clasificacion d,2002-04-01,43,78,43,78,121
90502,VILLA NUEVA (LOMA ALTA),estado nutricional en menores de 5 anos,clasificacion d,2002-04-01,2,0,2,0,2
31402,VILLA RIVERO,estado nutricional en menores de 5 anos,clasificacion d,2002-04-01,2,72,2,72,74
10801,VILLA SERRANO,estado nutricional en menores de 5 anos,clasificacion d,2002-04-01,64,224,64,224,288
31003,VILLA TUNARI,estado nutricional en menores de 5 anos,clasificacion d,2002-04-01,104,78,104,78,182
11001,VILLA VACA GUZMAN (MUYUPAMPA),estado nutricional en menores de 5 anos,clasificacion d,2002-04-01,56,98,56,98,154
51501,VILLAZON,estado nutricional en menores de 5 anos,clasificacion d,2002-04-01,8,260,8,260,268
30904,VINTO,estado nutricional en menores de 5 anos,clasificacion d,2002-04-01,66,35,66,35,101
50602,VITICHI,estado nutricional en menores de 5 anos,clasificacion d,2002-04-01,49,174,49,174,223
20306,WALDO BALLIVIAN,estado nutricional en menores de 5 anos,clasificacion d,2002-04-01,7,1,7,1,8
70201,WARNES,estado nutricional en menores de 5 anos,clasificacion d,2002-04-01,88,122,88,122,210
20903,YACO,estado nutricional en menores de 5 anos,clasificacion d,2002-04-01,0,14,0,14,14
60301,YACUIBA,estado nutricional en menores de 5 anos,clasificacion d,2002-04-01,76,96,76,96,172
10602,YAMPARAEZ,estado nutricional en menores de 5 anos,clasificacion d,2002-04-01,141,283,141,283,424
21103,YANACACHI,estado nutricional en menores de 5 anos,clasificacion d,2002-04-01,6,7,6,7,13
70403,YAPACANI,estado nutricional en menores de 5 anos,clasificacion d,2002-04-01,69,144,69,144,213
50103,YOCALLA,estado nutricional en menores de 5 anos,clasificacion d,2002-04-01,2,59,2,59,61
10102,YOTALA,estado nutricional en menores de 5 anos,clasificacion d,2002-04-01,100,218,100,218,318
60402,YUNCHARA,estado nutricional en menores de 5 anos,clasificacion d,2002-04-01,3,36,3,36,39
10301,ZUDAÃ‘EZ,estado nutricional en menores de 5 anos,clasificacion d,2002-04-01,70,129,70,129,199
51302,ACACIO,estado nutricional en menores de 5 anos,clasificacion d,2002-05-01,23,93,23,93,116
20201,ACHACACHI,estado nutricional en menores de 5 anos,clasificacion d,2002-05-01,99,105,99,105,204
20104,ACHOCALLA,estado nutricional en menores de 5 anos,clasificacion d,2002-05-01,13,12,13,12,25
30201,AIQUILE,estado nutricional en menores de 5 anos,clasificacion d,2002-05-01,31,42,31,42,73
31303,ALALAY,estado nutricional en menores de 5 anos,clasificacion d,2002-05-01,13,17,13,17,30
10404,ALCALA,estado nutricional en menores de 5 anos,clasificacion d,2002-05-01,35,71,35,71,106
20202,ANCORAIMES,estado nutricional en menores de 5 anos,clasificacion d,2002-05-01,86,139,86,139,225
41201,ANDAMARCA,estado nutricional en menores de 5 anos,clasificacion d,2002-05-01,5,3,5,3,8
40603,ANTEQUERA,estado nutricional en menores de 5 anos,clasificacion d,2002-05-01,1,2,1,2,3
30402,ANZALDO,estado nutricional en menores de 5 anos,clasificacion d,2002-05-01,2,60,2,60,62
20701,APOLO,estado nutricional en menores de 5 anos,clasificacion d,2002-05-01,36,20,36,20,56
51301,ARAMPAMPA,estado nutricional en menores de 5 anos,clasificacion d,2002-05-01,50,53,50,53,103
30501,ARANI,estado nutricional en menores de 5 anos,clasificacion d,2002-05-01,11,27,11,27,38
30403,ARBIETO,estado nutricional en menores de 5 anos,clasificacion d,2002-05-01,0,31,0,31,31
30601,ARQUE,estado nutricional en menores de 5 anos,clasificacion d,2002-05-01,51,51,51,51,102
71501,ASCENCION DE GUARAYOS,estado nutricional en menores de 5 anos,clasificacion d,2002-05-01,0,1,0,1,1
50802,ATOCHA,estado nutricional en menores de 5 anos,clasificacion d,2002-05-01,3,128,3,128,131
20502,AYATA,estado nutricional en menores de 5 anos,clasificacion d,2002-05-01,1,29,1,29,30
21303,AYO AYO,estado nutricional en menores de 5 anos,clasificacion d,2002-05-01,33,9,33,9,42
30301,AYOPAYA (V. DE INDEPENDENCIA),estado nutricional en menores de 5 anos,clasificacion d,2002-05-01,92,88,92,88,180
10201,AZURDUY,estado nutricional en menores de 5 anos,clasificacion d,2002-05-01,133,117,133,117,250
21203,BATALLAS,estado nutricional en menores de 5 anos,clasificacion d,2002-05-01,7,54,7,54,61
80802,BAURES,estado nutricional en menores de 5 anos,clasificacion d,2002-05-01,8,18,8,18,26
41202,BELEN DE ANDAMARCA,estado nutricional en menores de 5 anos,clasificacion d,2002-05-01,0,2,0,2,2
50104,BELEN DE URMIRI,estado nutricional en menores de 5 anos,clasificacion d,2002-05-01,1,32,1,32,33
90104,BELLA FLOR,estado nutricional en menores de 5 anos,clasificacion d,2002-05-01,8,8,8,8,16
60202,BERMEJO,estado nutricional en menores de 5 anos,clasificacion d,2002-05-01,2,14,2,14,16
50301,BETANZOS,estado nutricional en menores de 5 anos,clasificacion d,2002-05-01,200,421,200,421,621
31501,BOLIVAR,estado nutricional en menores de 5 anos,clasificacion d,2002-05-01,11,80,11,80,91
90103,BOLPEBRA,estado nutricional en menores de 5 anos,clasificacion d,2002-05-01,0,2,0,2,2
70707,BOYUIBE,estado nutricional en menores de 5 anos,clasificacion d,2002-05-01,1,32,1,32,33
70401,BUENA VISTA,estado nutricional en menores de 5 anos,clasificacion d,2002-05-01,44,59,44,59,103
70703,CABEZAS,estado nutricional en menores de 5 anos,clasificacion d,2002-05-01,0,9,0,9,9
20905,CAIROMA,estado nutricional en menores de 5 anos,clasificacion d,2002-05-01,1,8,1,8,9
51102,"CAIZA ""D""",estado nutricional en menores de 5 anos,clasificacion d,2002-05-01,34,144,34,144,178
21003,CAJUATA,estado nutricional en menores de 5 anos,clasificacion d,2002-05-01,17,18,17,18,35
20303,CALACOTO,estado nutricional en menores de 5 anos,clasificacion d,2002-05-01,5,5,5,5,10
21304,CALAMARCA,estado nutricional en menores de 5 anos,clasificacion d,2002-05-01,35,39,35,39,74
10701,CAMARGO,estado nutricional en menores de 5 anos,clasificacion d,2002-05-01,56,114,56,114,170
10901,CAMATAQUI (C. VILLA ABECIA),estado nutricional en menores de 5 anos,clasificacion d,2002-05-01,18,38,18,38,56
70706,CAMIRI,estado nutricional en menores de 5 anos,clasificacion d,2002-05-01,19,81,19,81,100
30701,CAPINOTA,estado nutricional en menores de 5 anos,clasificacion d,2002-05-01,10,29,10,29,39
20302,CAQUIAVIRI,estado nutricional en menores de 5 anos,clasificacion d,2002-05-01,29,23,29,23,52
40102,CARACOLLO,estado nutricional en menores de 5 anos,clasificacion d,2002-05-01,27,96,27,96,123
22001,CARANAVI,estado nutricional en menores de 5 anos,clasificacion d,2002-05-01,86,126,86,126,212
41503,CARANGAS,estado nutricional en menores de 5 anos,clasificacion d,2002-05-01,0,2,0,2,2
60302,CARAPARI,estado nutricional en menores de 5 anos,clasificacion d,2002-05-01,19,43,19,43,62
50702,CARIPUYO,estado nutricional en menores de 5 anos,clasificacion d,2002-05-01,24,208,24,208,232
21803,CHACARILLA,estado nutricional en menores de 5 anos,clasificacion d,2002-05-01,1,1,1,1,2
40201,CHALLAPATA,estado nutricional en menores de 5 anos,clasificacion d,2002-05-01,63,93,63,93,156
50302,CHAQUI,estado nutricional en menores de 5 anos,clasificacion d,2002-05-01,66,112,66,112,178
70702,CHARAGUA,estado nutricional en menores de 5 anos,clasificacion d,2002-05-01,14,220,14,220,234
20305,CHARAÃ‘A,estado nutricional en menores de 5 anos,clasificacion d,2002-05-01,0,11,0,11,11
31204,CHIMORE,estado nutricional en menores de 5 anos,clasificacion d,2002-05-01,23,28,23,28,51
40903,CHIPAYA,estado nutricional en menores de 5 anos,clasificacion d,2002-05-01,0,8,0,8,8
40302,CHOQUE COTA,estado nutricional en menores de 5 anos,clasificacion d,2002-05-01,1,16,1,16,17
21101,CHULUMANI (V. DE LA LIBERTAD),estado nutricional en menores de 5 anos,clasificacion d,2002-05-01,2,23,2,23,25
20501,CHUMA,estado nutricional en menores de 5 anos,clasificacion d,2002-05-01,8,12,8,12,20
30801,CLIZA,estado nutricional en menores de 5 anos,clasificacion d,2002-05-01,2,32,2,32,34
90101,COBIJA,estado nutricional en menores de 5 anos,clasificacion d,2002-05-01,77,66,77,66,143
30101,COCHABAMBA,estado nutricional en menores de 5 anos,clasificacion d,2002-05-01,422,402,422,402,824
40902,COIPASA,estado nutricional en menores de 5 anos,clasificacion d,2002-05-01,0,1,0,1,1
30905,COLCAPIRHUA,estado nutricional en menores de 5 anos,clasificacion d,2002-05-01,74,62,74,62,136
50901,"COLCHA ""K""",estado nutricional en menores de 5 anos,clasificacion d,2002-05-01,2,141,2,141,143
21307,COLLANA,estado nutricional en menores de 5 anos,clasificacion d,2002-05-01,5,0,5,0,5
31002,COLOMI,estado nutricional en menores de 5 anos,clasificacion d,2002-05-01,32,46,32,46,78
50401,COLQUECHACA,estado nutricional en menores de 5 anos,clasificacion d,2002-05-01,107,131,107,131,238
21306,COLQUENCHA,estado nutricional en menores de 5 anos,clasificacion d,2002-05-01,32,25,32,25,57
21004,COLQUIRI,estado nutricional en menores de 5 anos,clasificacion d,2002-05-01,26,25,26,25,51
20304,COMANCHE,estado nutricional en menores de 5 anos,clasificacion d,2002-05-01,1,12,1,12,13
71301,COMARAPA,estado nutricional en menores de 5 anos,clasificacion d,2002-05-01,17,55,17,55,72
20605,COMBAYA,estado nutricional en menores de 5 anos,clasificacion d,2002-05-01,11,30,11,30,41
71101,CONCEPCION,estado nutricional en menores de 5 anos,clasificacion d,2002-05-01,2,4,2,4,6
21701,COPACABANA,estado nutricional en menores de 5 anos,clasificacion d,2002-05-01,3,56,3,56,59
21402,CORIPATA,estado nutricional en menores de 5 anos,clasificacion d,2002-05-01,4,17,4,17,21
20301,CORO CORO,estado nutricional en menores de 5 anos,clasificacion d,2002-05-01,30,22,30,22,52
21401,COROICO,estado nutricional en menores de 5 anos,clasificacion d,2002-05-01,32,12,32,12,44
40301,CORQUE,estado nutricional en menores de 5 anos,clasificacion d,2002-05-01,23,16,23,16,39
50601,COTAGAITA,estado nutricional en menores de 5 anos,clasificacion d,2002-05-01,22,198,22,198,220
70102,COTOCA,estado nutricional en menores de 5 anos,clasificacion d,2002-05-01,28,27,28,27,55
31405,CUCHUMUELA (V. G. VILLARROEL),estado nutricional en menores de 5 anos,clasificacion d,2002-05-01,0,40,0,40,40
70704,CUEVO,estado nutricional en menores de 5 anos,clasificacion d,2002-05-01,25,28,25,28,53
10902,CULPINA,estado nutricional en menores de 5 anos,clasificacion d,2002-05-01,184,193,184,193,377
40401,CURAHUARA DE CARANGAS,estado nutricional en menores de 5 anos,clasificacion d,2002-05-01,22,8,22,8,30
21602,CURVA,estado nutricional en menores de 5 anos,clasificacion d,2002-05-01,15,8,15,8,23
20804,DESAGUADERO,estado nutricional en menores de 5 anos,clasificacion d,2002-05-01,1,37,1,37,38
20105,EL ALTO,estado nutricional en menores de 5 anos,clasificacion d,2002-05-01,1728,1503,1728,1503,3231
40103,EL CHORO,estado nutricional en menores de 5 anos,clasificacion d,2002-05-01,5,7,5,7,12
71503,EL PUENTE(STC),estado nutricional en menores de 5 anos,clasificacion d,2002-05-01,2,71,2,71,73
60502,EL PUENTE(TJA),estado nutricional en menores de 5 anos,clasificacion d,2002-05-01,31,104,31,104,135
70105,EL TORNO,estado nutricional en menores de 5 anos,clasificacion d,2002-05-01,82,100,82,100,182
10405,EL VILLAR,estado nutricional en menores de 5 anos,clasificacion d,2002-05-01,54,133,54,133,187
60601,ENTRE RIOS,estado nutricional en menores de 5 anos,clasificacion d,2002-05-01,38,86,38,86,124
41101,EUCALIPTUS,estado nutricional en menores de 5 anos,clasificacion d,2002-05-01,0,3,0,3,3
80402,EXALTACION,estado nutricional en menores de 5 anos,clasificacion d,2002-05-01,32,62,32,62,94
90203,FILADELFIA,estado nutricional en menores de 5 anos,clasificacion d,2002-05-01,0,5,0,5,5
71002,GENERAL SAAVEDRA,estado nutricional en menores de 5 anos,clasificacion d,2002-05-01,88,93,88,93,181
21601,GRAL. J.J. PEREZ (CHARAZANI),estado nutricional en menores de 5 anos,clasificacion d,2002-05-01,1,3,1,3,4
20602,GUANAY,estado nutricional en menores de 5 anos,clasificacion d,2002-05-01,51,122,51,122,173
20802,GUAQUI,estado nutricional en menores de 5 anos,clasificacion d,2002-05-01,10,20,10,20,30
80202,GUAYARAMERIN,estado nutricional en menores de 5 anos,clasificacion d,2002-05-01,84,82,84,82,166
70705,GUTIERREZ,estado nutricional en menores de 5 anos,clasificacion d,2002-05-01,32,144,32,144,176
10502,HUACARETA,estado nutricional en menores de 5 anos,clasificacion d,2002-05-01,90,111,90,111,201
11002,HUACAYA (VILLA DE HUACAYA),estado nutricional en menores de 5 anos,clasificacion d,2002-05-01,13,20,13,20,33
40501,HUACHACALLA,estado nutricional en menores de 5 anos,clasificacion d,2002-05-01,2,10,2,10,12
40701,HUANUNI,estado nutricional en menores de 5 anos,clasificacion d,2002-05-01,6,2,6,2,8
80803,HUARACAJE,estado nutricional en menores de 5 anos,clasificacion d,2002-05-01,11,4,11,4,15
41601,HUAYLLAMARCA,estado nutricional en menores de 5 anos,clasificacion d,2002-05-01,22,10,22,10,32
21005,ICHOCA,estado nutricional en menores de 5 anos,clasificacion d,2002-05-01,5,3,5,3,8
10304,ICLA,estado nutricional en menores de 5 anos,clasificacion d,2002-05-01,117,205,117,205,322
10703,INCAHUASI,estado nutricional en menores de 5 anos,clasificacion d,2002-05-01,98,148,98,148,246
90402,INGAVI (HUMAITA),estado nutricional en menores de 5 anos,clasificacion d,2002-05-01,0,3,0,3,3
21001,INQUISIVI,estado nutricional en menores de 5 anos,clasificacion d,2002-05-01,29,87,29,87,116
21102,IRUPANA (VILLA DE LANZA),estado nutricional en menores de 5 anos,clasificacion d,2002-05-01,8,34,8,34,42
21501,IXIAMAS,estado nutricional en menores de 5 anos,clasificacion d,2002-05-01,20,36,20,36,56
21105,LA ASUNTA,estado nutricional en menores de 5 anos,clasificacion d,2002-05-01,17,57,17,57,74
70104,LA GUARDIA,estado nutricional en menores de 5 anos,clasificacion d,2002-05-01,82,56,82,56,138
20101,LA PAZ,estado nutricional en menores de 5 anos,clasificacion d,2002-05-01,1204,1011,1204,1011,2215
41501,LA RIVERA,estado nutricional en menores de 5 anos,clasificacion d,2002-05-01,0,1,0,1,1
70701,LAGUNILLAS,estado nutricional en menores de 5 anos,clasificacion d,2002-05-01,40,42,40,42,82
21202,LAJA,estado nutricional en menores de 5 anos,clasificacion d,2002-05-01,3,47,3,47,50
10903,LAS CARRERAS,estado nutricional en menores de 5 anos,clasificacion d,2002-05-01,40,50,40,50,90
51401,LLICA,estado nutricional en menores de 5 anos,clasificacion d,2002-05-01,15,16,15,16,31
80601,LORETO,estado nutricional en menores de 5 anos,clasificacion d,2002-05-01,5,19,5,19,24
20901,LURIBAY,estado nutricional en menores de 5 anos,clasificacion d,2002-05-01,9,16,9,16,25
40702,MACHACAMARCA,estado nutricional en menores de 5 anos,clasificacion d,2002-05-01,12,12,12,12,24
11003,MACHARETI,estado nutricional en menores de 5 anos,clasificacion d,2002-05-01,33,125,33,125,158
80801,MAGDALENA,estado nutricional en menores de 5 anos,clasificacion d,2002-05-01,18,46,18,46,64
70903,MAIRANA,estado nutricional en menores de 5 anos,clasificacion d,2002-05-01,14,31,14,31,45
20904,MALLA,estado nutricional en menores de 5 anos,clasificacion d,2002-05-01,3,2,3,2,5
20103,MECAPACA,estado nutricional en menores de 5 anos,clasificacion d,2002-05-01,7,24,7,24,31
71003,MINEROS,estado nutricional en menores de 5 anos,clasificacion d,2002-05-01,114,93,114,93,207
31301,MIZQUE,estado nutricional en menores de 5 anos,clasificacion d,2002-05-01,55,74,55,74,129
20402,MOCOMOCO,estado nutricional en menores de 5 anos,clasificacion d,2002-05-01,37,46,37,46,83
51002,MOJINETE,estado nutricional en menores de 5 anos,clasificacion d,2002-05-01,0,11,0,11,11
10303,MOJOCOYA,estado nutricional en menores de 5 anos,clasificacion d,2002-05-01,79,139,79,139,218
10501,MONTEAGUDO,estado nutricional en menores de 5 anos,clasificacion d,2002-05-01,194,289,194,289,483
71001,MONTERO,estado nutricional en menores de 5 anos,clasificacion d,2002-05-01,91,359,91,359,450
70803,MORO MORO,estado nutricional en menores de 5 anos,clasificacion d,2002-05-01,17,7,17,7,24
30302,MOROCHATA,estado nutricional en menores de 5 anos,clasificacion d,2002-05-01,26,52,26,52,78
20307,NAZACARA DE PACAJES,estado nutricional en menores de 5 anos,clasificacion d,2002-05-01,0,4,0,4,4
90501,NUEVO MANOA (NUEVA ESPERANZA),estado nutricional en menores de 5 anos,clasificacion d,2002-05-01,3,5,3,5,8
50404,OCURI,estado nutricional en menores de 5 anos,clasificacion d,2002-05-01,70,68,70,68,138
70202,OKINAWA,estado nutricional en menores de 5 anos,clasificacion d,2002-05-01,5,12,5,12,17
30203,OMEREQUE,estado nutricional en menores de 5 anos,clasificacion d,2002-05-01,1,6,1,6,7
40101,ORURO,estado nutricional en menores de 5 anos,clasificacion d,2002-05-01,507,497,507,497,1004
60201,PADCAYA,estado nutricional en menores de 5 anos,clasificacion d,2002-05-01,51,78,51,78,129
10401,PADILLA,estado nutricional en menores de 5 anos,clasificacion d,2002-05-01,157,258,157,258,415
70502,PAILON,estado nutricional en menores de 5 anos,clasificacion d,2002-05-01,3,51,3,51,54
20102,PALCA,estado nutricional en menores de 5 anos,clasificacion d,2002-05-01,34,44,34,44,78
21104,PALOS BLANCOS,estado nutricional en menores de 5 anos,clasificacion d,2002-05-01,42,97,42,97,139
40802,PAMPA AULLAGAS,estado nutricional en menores de 5 anos,clasificacion d,2002-05-01,12,19,12,19,31
70902,PAMPA GRANDE,estado nutricional en menores de 5 anos,clasificacion d,2002-05-01,13,13,13,13,26
21802,PAPEL PAMPA,estado nutricional en menores de 5 anos,clasificacion d,2002-05-01,5,3,5,3,8
30202,PASORAPA,estado nutricional en menores de 5 anos,clasificacion d,2002-05-01,29,41,29,41,70
21305,PATACAMAYA,estado nutricional en menores de 5 anos,clasificacion d,2002-05-01,44,31,44,31,75
40602,PAZÃ‘A,estado nutricional en menores de 5 anos,clasificacion d,2002-05-01,1,45,1,45,46
20702,PELECHUCO,estado nutricional en menores de 5 anos,clasificacion d,2002-05-01,10,32,10,32,42
50403,POCOATA,estado nutricional en menores de 5 anos,clasificacion d,2002-05-01,141,260,141,260,401
31203,POCONA,estado nutricional en menores de 5 anos,clasificacion d,2002-05-01,88,68,88,68,156
31202,POJO (CBBA),estado nutricional en menores de 5 anos,clasificacion d,2002-05-01,113,90,113,90,203
40601,POOPO,estado nutricional en menores de 5 anos,clasificacion d,2002-05-01,1,31,1,31,32
51203,PORCO,estado nutricional en menores de 5 anos,clasificacion d,2002-05-01,21,37,21,37,58
10103,POROMA,estado nutricional en menores de 5 anos,clasificacion d,2002-05-01,147,193,147,193,340
70103,PORONGO,estado nutricional en menores de 5 anos,clasificacion d,2002-05-01,18,18,18,18,36
70601,PORTACHUELO,estado nutricional en menores de 5 anos,clasificacion d,2002-05-01,43,38,43,38,81
90102,PORVENIR,estado nutricional en menores de 5 anos,clasificacion d,2002-05-01,1,0,1,0,1
50101,POTOSI,estado nutricional en menores de 5 anos,clasificacion d,2002-05-01,456,425,456,425,881
10302,PRESTO,estado nutricional en menores de 5 anos,clasificacion d,2002-05-01,69,77,69,77,146
70805,PUCARA,estado nutricional en menores de 5 anos,clasificacion d,2002-05-01,5,8,5,8,13
21201,PUCARANI,estado nutricional en menores de 5 anos,clasificacion d,2002-05-01,3,92,3,92,95
20401,PUERTO ACOSTA,estado nutricional en menores de 5 anos,clasificacion d,2002-05-01,58,66,58,66,124
20403,PUERTO CARABUCO,estado nutricional en menores de 5 anos,clasificacion d,2002-05-01,42,59,42,59,101
90301,PUERTO GONZALO MORENO,estado nutricional en menores de 5 anos,clasificacion d,2002-05-01,14,15,14,15,29
21204,PUERTO PEREZ,estado nutricional en menores de 5 anos,clasificacion d,2002-05-01,5,13,5,13,18
71402,PUERTO QUIJARRO,estado nutricional en menores de 5 anos,clasificacion d,2002-05-01,24,6,24,6,30
90201,PUERTO RICO,estado nutricional en menores de 5 anos,clasificacion d,2002-05-01,0,26,0,26,26
80703,PUERTO SILES,estado nutricional en menores de 5 anos,clasificacion d,2002-05-01,1,3,1,3,4
71401,PUERTO SUAREZ,estado nutricional en menores de 5 anos,clasificacion d,2002-05-01,63,21,63,21,84
31205,PUERTO VILLARROEL,estado nutricional en menores de 5 anos,clasificacion d,2002-05-01,155,141,155,141,296
51101,PUNA,estado nutricional en menores de 5 anos,clasificacion d,2002-05-01,131,360,131,360,491
31401,PUNATA,estado nutricional en menores de 5 anos,clasificacion d,2002-05-01,1,23,1,23,24
20604,QUIABAYA,estado nutricional en menores de 5 anos,clasificacion d,2002-05-01,12,26,12,26,38
30901,QUILLACOLLO,estado nutricional en menores de 5 anos,clasificacion d,2002-05-01,62,44,62,44,106
21002,QUIME,estado nutricional en menores de 5 anos,clasificacion d,2002-05-01,24,13,24,13,37
50402,RAVELO,estado nutricional en menores de 5 anos,clasificacion d,2002-05-01,140,234,140,234,374
80301,REYES,estado nutricional en menores de 5 anos,clasificacion d,2002-05-01,25,32,25,32,57
80201,RIBERALTA,estado nutricional en menores de 5 anos,clasificacion d,2002-05-01,382,242,382,242,624
70503,ROBORE,estado nutricional en menores de 5 anos,clasificacion d,2002-05-01,26,45,26,45,71
80304,RURRENABAQUE,estado nutricional en menores de 5 anos,clasificacion d,2002-05-01,13,9,13,9,22
40901,SABAYA,estado nutricional en menores de 5 anos,clasificacion d,2002-05-01,0,3,0,3,3
31001,SACABA,estado nutricional en menores de 5 anos,clasificacion d,2002-05-01,16,144,16,144,160
30404,SACABAMBA,estado nutricional en menores de 5 anos,clasificacion d,2002-05-01,0,61,0,61,61
50701,SACACA,estado nutricional en menores de 5 anos,clasificacion d,2002-05-01,171,301,171,301,472
71302,SAIPINA,estado nutricional en menores de 5 anos,clasificacion d,2002-05-01,9,23,9,23,32
40801,SALINAS DE GARCI MENDOZA,estado nutricional en menores de 5 anos,clasificacion d,2002-05-01,9,13,9,13,22
70901,SAMAIPATA,estado nutricional en menores de 5 anos,clasificacion d,2002-05-01,21,20,21,20,41
51601,SAN AGUSTIN,estado nutricional en menores de 5 anos,clasificacion d,2002-05-01,1,9,1,9,10
80602,SAN ANDRES,estado nutricional en menores de 5 anos,clasificacion d,2002-05-01,4,6,4,6,10
51003,SAN ANTONIO DE ESMORUCO,estado nutricional en menores de 5 anos,clasificacion d,2002-05-01,1,14,1,14,15
71105,SAN ANTONIO DE LOMERIO,estado nutricional en menores de 5 anos,clasificacion d,2002-05-01,67,122,67,122,189
31403,SAN BENITO,estado nutricional en menores de 5 anos,clasificacion d,2002-05-01,18,21,18,21,39
80302,SAN BORJA,estado nutricional en menores de 5 anos,clasificacion d,2002-05-01,91,71,91,71,162
21502,SAN BUENA VENTURA,estado nutricional en menores de 5 anos,clasificacion d,2002-05-01,12,23,12,23,35
70402,SAN CARLOS,estado nutricional en menores de 5 anos,clasificacion d,2002-05-01,0,21,0,21,21
80501,SAN IGNACIO,estado nutricional en menores de 5 anos,clasificacion d,2002-05-01,51,155,51,155,206
70301,SAN IGNACIO DE VELASCO,estado nutricional en menores de 5 anos,clasificacion d,2002-05-01,153,123,153,123,276
80102,SAN JAVIER(BNI),estado nutricional en menores de 5 anos,clasificacion d,2002-05-01,9,16,9,16,25
71102,SAN JAVIER(STC),estado nutricional en menores de 5 anos,clasificacion d,2002-05-01,24,10,24,10,34
80701,SAN JOAQUIN,estado nutricional en menores de 5 anos,clasificacion d,2002-05-01,0,25,0,25,25
70501,SAN JOSE DE CHIQUITOS,estado nutricional en menores de 5 anos,clasificacion d,2002-05-01,39,21,39,21,60
71104,SAN JULIAN,estado nutricional en menores de 5 anos,clasificacion d,2002-05-01,153,327,153,327,480
90302,SAN LORENZO(PND),estado nutricional en menores de 5 anos,clasificacion d,2002-05-01,2,3,2,3,5
60501,SAN LORENZO(TJA),estado nutricional en menores de 5 anos,clasificacion d,2002-05-01,9,45,9,45,54
10702,SAN LUCAS,estado nutricional en menores de 5 anos,clasificacion d,2002-05-01,342,338,342,338,680
71201,SAN MATIAS,estado nutricional en menores de 5 anos,clasificacion d,2002-05-01,41,26,41,26,67
70302,SAN MIGUEL DE VELASCO,estado nutricional en menores de 5 anos,clasificacion d,2002-05-01,50,64,50,64,114
51001,SAN PABLO DE LIPEZ,estado nutricional en menores de 5 anos,clasificacion d,2002-05-01,2,68,2,68,70
50501,SAN PEDRO DE BUENA VISTA,estado nutricional en menores de 5 anos,clasificacion d,2002-05-01,11,304,11,304,315
21801,SAN PEDRO DE CURAHUARA,estado nutricional en menores de 5 anos,clasificacion d,2002-05-01,9,18,9,18,27
50902,SAN PEDRO DE QUEMES,estado nutricional en menores de 5 anos,clasificacion d,2002-05-01,0,3,0,3,3
21702,SAN PEDRO DE TIQUINA,estado nutricional en menores de 5 anos,clasificacion d,2002-05-01,1,6,1,6,7
90202,SAN PEDRO(PND),estado nutricional en menores de 5 anos,clasificacion d,2002-05-01,1,5,1,5,6
70303,SAN RAFAEL,estado nutricional en menores de 5 anos,clasificacion d,2002-05-01,25,16,25,16,41
80702,SAN RAMON,estado nutricional en menores de 5 anos,clasificacion d,2002-05-01,18,48,18,48,66
80401,SANTA ANA,estado nutricional en menores de 5 anos,clasificacion d,2002-05-01,20,26,20,26,46
70101,SANTA CRUZ DE LA SIERRA,estado nutricional en menores de 5 anos,clasificacion d,2002-05-01,398,298,398,298,696
80303,SANTA ROSA,estado nutricional en menores de 5 anos,clasificacion d,2002-05-01,44,25,44,25,69
70602,SANTA ROSA DEL SARA,estado nutricional en menores de 5 anos,clasificacion d,2002-05-01,12,17,12,17,29
20308,SANTIAGO DE CALLAPA,estado nutricional en menores de 5 anos,clasificacion d,2002-05-01,2,12,2,12,14
41401,SANTIAGO DE HUARI,estado nutricional en menores de 5 anos,clasificacion d,2002-05-01,23,30,23,30,53
21901,SANTIAGO DE MACHACA,estado nutricional en menores de 5 anos,clasificacion d,2002-05-01,4,7,4,7,11
30702,SANTIVAÃ‘ES,estado nutricional en menores de 5 anos,clasificacion d,2002-05-01,15,10,15,10,25
40202,SANTUARIO DE QUILLACAS,estado nutricional en menores de 5 anos,clasificacion d,2002-05-01,3,10,3,10,13
20902,SAPAHAQUI,estado nutricional en menores de 5 anos,clasificacion d,2002-05-01,0,22,0,22,22
21301,SICA SICA (VILLA AROMA),estado nutricional en menores de 5 anos,clasificacion d,2002-05-01,44,13,44,13,57
30703,SICAYA,estado nutricional en menores de 5 anos,clasificacion d,2002-05-01,2,32,2,32,34
30902,SIPE SIPE,estado nutricional en menores de 5 anos,clasificacion d,2002-05-01,143,169,143,169,312
10403,SOPACHUY,estado nutricional en menores de 5 anos,clasificacion d,2002-05-01,46,49,46,49,95
20601,SORATA,estado nutricional en menores de 5 anos,clasificacion d,2002-05-01,38,84,38,84,122
10101,SUCRE,estado nutricional en menores de 5 anos,clasificacion d,2002-05-01,641,776,641,776,1417
31404,TACACHI,estado nutricional en menores de 5 anos,clasificacion d,2002-05-01,0,3,0,3,3
20603,TACACOMA,estado nutricional en menores de 5 anos,clasificacion d,2002-05-01,12,51,12,51,63
50303,TACOBAMBA,estado nutricional en menores de 5 anos,clasificacion d,2002-05-01,46,52,46,52,98
30602,TACOPAYA,estado nutricional en menores de 5 anos,clasificacion d,2002-05-01,49,96,49,96,145
51402,TAHUA,estado nutricional en menores de 5 anos,clasificacion d,2002-05-01,0,16,0,16,16
31101,TAPACARI,estado nutricional en menores de 5 anos,clasificacion d,2002-05-01,5,149,5,149,154
10601,TARABUCO,estado nutricional en menores de 5 anos,clasificacion d,2002-05-01,120,625,120,625,745
30401,TARATA,estado nutricional en menores de 5 anos,clasificacion d,2002-05-01,52,55,52,55,107
60101,TARIJA,estado nutricional en menores de 5 anos,clasificacion d,2002-05-01,183,189,183,189,372
10202,TARVITA,estado nutricional en menores de 5 anos,clasificacion d,2002-05-01,86,121,86,121,207
20803,TIAWANACU,estado nutricional en menores de 5 anos,clasificacion d,2002-05-01,29,10,29,10,39
50102,TINGUIPAYA,estado nutricional en menores de 5 anos,clasificacion d,2002-05-01,8,114,8,114,122
20606,TIPUANI,estado nutricional en menores de 5 anos,clasificacion d,2002-05-01,12,16,12,16,28
30903,TIQUIPAYA,estado nutricional en menores de 5 anos,clasificacion d,2002-05-01,1,76,1,76,77
31601,TIRAQUE (CBBA),estado nutricional en menores de 5 anos,clasificacion d,2002-05-01,51,126,51,126,177
21703,TITO YUPANQUI (PARQUIPUJIO),estado nutricional en menores de 5 anos,clasificacion d,2002-05-01,0,22,0,22,22
30802,TOCO,estado nutricional en menores de 5 anos,clasificacion d,2002-05-01,6,9,6,9,15
30803,TOLATA,estado nutricional en menores de 5 anos,clasificacion d,2002-05-01,0,18,0,18,18
41001,TOLEDO,estado nutricional en menores de 5 anos,clasificacion d,2002-05-01,9,7,9,7,16
51202,TOMAVE,estado nutricional en menores de 5 anos,clasificacion d,2002-05-01,5,137,5,137,142
10402,TOMINA,estado nutricional en menores de 5 anos,clasificacion d,2002-05-01,102,161,102,161,263
50502,TORO TORO,estado nutricional en menores de 5 anos,clasificacion d,2002-05-01,0,54,0,54,54
31201,TOTORA(CBBA),estado nutricional en menores de 5 anos,clasificacion d,2002-05-01,72,81,72,81,153
41301,TOTORA(ORR),estado nutricional en menores de 5 anos,clasificacion d,2002-05-01,7,12,7,12,19
70802,TRIGAL,estado nutricional en menores de 5 anos,clasificacion d,2002-05-01,1,3,1,3,4
80101,TRINIDAD,estado nutricional en menores de 5 anos,clasificacion d,2002-05-01,143,192,143,192,335
50801,TUPIZA,estado nutricional en menores de 5 anos,clasificacion d,2002-05-01,8,387,8,387,395
40402,TURCO,estado nutricional en menores de 5 anos,clasificacion d,2002-05-01,12,2,12,2,14
21302,UMALA,estado nutricional en menores de 5 anos,clasificacion d,2002-05-01,2,10,2,10,12
60401,URIONDO (A. CONCEPCION),estado nutricional en menores de 5 anos,clasificacion d,2002-05-01,27,47,27,47,74
71502,URUBICHA,estado nutricional en menores de 5 anos,clasificacion d,2002-05-01,0,29,0,29,29
51201,UYUNI,estado nutricional en menores de 5 anos,clasificacion d,2002-05-01,13,340,13,340,353
30502,VACAS,estado nutricional en menores de 5 anos,clasificacion d,2002-05-01,1,47,1,47,48
70801,VALLEGRANDE,estado nutricional en menores de 5 anos,clasificacion d,2002-05-01,46,70,46,70,116
20801,VIACHA,estado nutricional en menores de 5 anos,clasificacion d,2002-05-01,8,171,8,171,179
31302,VILA VILA,estado nutricional en menores de 5 anos,clasificacion d,2002-05-01,24,33,24,33,57
60303,VILLA MONTES,estado nutricional en menores de 5 anos,clasificacion d,2002-05-01,42,60,42,60,102
31402,VILLA RIVERO,estado nutricional en menores de 5 anos,clasificacion d,2002-05-01,0,25,0,25,25
10801,VILLA SERRANO,estado nutricional en menores de 5 anos,clasificacion d,2002-05-01,99,252,99,252,351
31003,VILLA TUNARI,estado nutricional en menores de 5 anos,clasificacion d,2002-05-01,132,104,132,104,236
11001,VILLA VACA GUZMAN (MUYUPAMPA),estado nutricional en menores de 5 anos,clasificacion d,2002-05-01,91,125,91,125,216
51501,VILLAZON,estado nutricional en menores de 5 anos,clasificacion d,2002-05-01,26,259,26,259,285
30904,VINTO,estado nutricional en menores de 5 anos,clasificacion d,2002-05-01,104,48,104,48,152
50602,VITICHI,estado nutricional en menores de 5 anos,clasificacion d,2002-05-01,11,160,11,160,171
20306,WALDO BALLIVIAN,estado nutricional en menores de 5 anos,clasificacion d,2002-05-01,3,2,3,2,5
70201,WARNES,estado nutricional en menores de 5 anos,clasificacion d,2002-05-01,114,94,114,94,208
20903,YACO,estado nutricional en menores de 5 anos,clasificacion d,2002-05-01,2,23,2,23,25
60301,YACUIBA,estado nutricional en menores de 5 anos,clasificacion d,2002-05-01,70,58,70,58,128
10602,YAMPARAEZ,estado nutricional en menores de 5 anos,clasificacion d,2002-05-01,155,302,155,302,457
21103,YANACACHI,estado nutricional en menores de 5 anos,clasificacion d,2002-05-01,16,17,16,17,33
70403,YAPACANI,estado nutricional en menores de 5 anos,clasificacion d,2002-05-01,13,130,13,130,143
50103,YOCALLA,estado nutricional en menores de 5 anos,clasificacion d,2002-05-01,1,72,1,72,73
10102,YOTALA,estado nutricional en menores de 5 anos,clasificacion d,2002-05-01,122,214,122,214,336
60402,YUNCHARA,estado nutricional en menores de 5 anos,clasificacion d,2002-05-01,15,29,15,29,44
10301,ZUDAÃ‘EZ,estado nutricional en menores de 5 anos,clasificacion d,2002-05-01,49,127,49,127,176
51302,ACACIO,estado nutricional en menores de 5 anos,clasificacion d,2002-06-01,29,171,29,171,200
20201,ACHACACHI,estado nutricional en menores de 5 anos,clasificacion d,2002-06-01,142,122,142,122,264
20104,ACHOCALLA,estado nutricional en menores de 5 anos,clasificacion d,2002-06-01,16,8,16,8,24
30201,AIQUILE,estado nutricional en menores de 5 anos,clasificacion d,2002-06-01,17,68,17,68,85
31303,ALALAY,estado nutricional en menores de 5 anos,clasificacion d,2002-06-01,10,11,10,11,21
10404,ALCALA,estado nutricional en menores de 5 anos,clasificacion d,2002-06-01,36,63,36,63,99
20202,ANCORAIMES,estado nutricional en menores de 5 anos,clasificacion d,2002-06-01,70,116,70,116,186
41201,ANDAMARCA,estado nutricional en menores de 5 anos,clasificacion d,2002-06-01,11,10,11,10,21
40603,ANTEQUERA,estado nutricional en menores de 5 anos,clasificacion d,2002-06-01,0,10,0,10,10
30402,ANZALDO,estado nutricional en menores de 5 anos,clasificacion d,2002-06-01,2,112,2,112,114
20701,APOLO,estado nutricional en menores de 5 anos,clasificacion d,2002-06-01,26,16,26,16,42
51301,ARAMPAMPA,estado nutricional en menores de 5 anos,clasificacion d,2002-06-01,25,29,25,29,54
30501,ARANI,estado nutricional en menores de 5 anos,clasificacion d,2002-06-01,1,26,1,26,27
30403,ARBIETO,estado nutricional en menores de 5 anos,clasificacion d,2002-06-01,3,17,3,17,20
30601,ARQUE,estado nutricional en menores de 5 anos,clasificacion d,2002-06-01,31,37,31,37,68
71501,ASCENCION DE GUARAYOS,estado nutricional en menores de 5 anos,clasificacion d,2002-06-01,162,227,162,227,389
50802,ATOCHA,estado nutricional en menores de 5 anos,clasificacion d,2002-06-01,4,74,4,74,78
20503,AUCAPATA,estado nutricional en menores de 5 anos,clasificacion d,2002-06-01,15,4,15,4,19
20502,AYATA,estado nutricional en menores de 5 anos,clasificacion d,2002-06-01,9,6,9,6,15
21303,AYO AYO,estado nutricional en menores de 5 anos,clasificacion d,2002-06-01,15,10,15,10,25
30301,AYOPAYA (V. DE INDEPENDENCIA),estado nutricional en menores de 5 anos,clasificacion d,2002-06-01,91,135,91,135,226
10201,AZURDUY,estado nutricional en menores de 5 anos,clasificacion d,2002-06-01,186,223,186,223,409
21203,BATALLAS,estado nutricional en menores de 5 anos,clasificacion d,2002-06-01,1,60,1,60,61
80802,BAURES,estado nutricional en menores de 5 anos,clasificacion d,2002-06-01,17,41,17,41,58
41202,BELEN DE ANDAMARCA,estado nutricional en menores de 5 anos,clasificacion d,2002-06-01,0,1,0,1,1
50104,BELEN DE URMIRI,estado nutricional en menores de 5 anos,clasificacion d,2002-06-01,7,34,7,34,41
90104,BELLA FLOR,estado nutricional en menores de 5 anos,clasificacion d,2002-06-01,12,14,12,14,26
60202,BERMEJO,estado nutricional en menores de 5 anos,clasificacion d,2002-06-01,1,9,1,9,10
50301,BETANZOS,estado nutricional en menores de 5 anos,clasificacion d,2002-06-01,95,204,95,204,299
31501,BOLIVAR,estado nutricional en menores de 5 anos,clasificacion d,2002-06-01,39,67,39,67,106
90103,BOLPEBRA,estado nutricional en menores de 5 anos,clasificacion d,2002-06-01,0,3,0,3,3
70707,BOYUIBE,estado nutricional en menores de 5 anos,clasificacion d,2002-06-01,2,2,2,2,4
70703,CABEZAS,estado nutricional en menores de 5 anos,clasificacion d,2002-06-01,1,63,1,63,64
20905,CAIROMA,estado nutricional en menores de 5 anos,clasificacion d,2002-06-01,14,48,14,48,62
51102,"CAIZA ""D""",estado nutricional en menores de 5 anos,clasificacion d,2002-06-01,27,106,27,106,133
21003,CAJUATA,estado nutricional en menores de 5 anos,clasificacion d,2002-06-01,23,15,23,15,38
20303,CALACOTO,estado nutricional en menores de 5 anos,clasificacion d,2002-06-01,10,17,10,17,27
21304,CALAMARCA,estado nutricional en menores de 5 anos,clasificacion d,2002-06-01,30,56,30,56,86
10701,CAMARGO,estado nutricional en menores de 5 anos,clasificacion d,2002-06-01,20,98,20,98,118
10901,CAMATAQUI (C. VILLA ABECIA),estado nutricional en menores de 5 anos,clasificacion d,2002-06-01,30,47,30,47,77
70706,CAMIRI,estado nutricional en menores de 5 anos,clasificacion d,2002-06-01,29,59,29,59,88
30701,CAPINOTA,estado nutricional en menores de 5 anos,clasificacion d,2002-06-01,17,31,17,31,48
20302,CAQUIAVIRI,estado nutricional en menores de 5 anos,clasificacion d,2002-06-01,24,31,24,31,55
40102,CARACOLLO,estado nutricional en menores de 5 anos,clasificacion d,2002-06-01,14,83,14,83,97
22001,CARANAVI,estado nutricional en menores de 5 anos,clasificacion d,2002-06-01,125,115,125,115,240
41503,CARANGAS,estado nutricional en menores de 5 anos,clasificacion d,2002-06-01,1,0,1,0,1
60302,CARAPARI,estado nutricional en menores de 5 anos,clasificacion d,2002-06-01,25,60,25,60,85
50702,CARIPUYO,estado nutricional en menores de 5 anos,clasificacion d,2002-06-01,9,138,9,138,147
21902,CATACORA,estado nutricional en menores de 5 anos,clasificacion d,2002-06-01,10,11,10,11,21
21803,CHACARILLA,estado nutricional en menores de 5 anos,clasificacion d,2002-06-01,0,8,0,8,8
40201,CHALLAPATA,estado nutricional en menores de 5 anos,clasificacion d,2002-06-01,32,72,32,72,104
50302,CHAQUI,estado nutricional en menores de 5 anos,clasificacion d,2002-06-01,82,57,82,57,139
70702,CHARAGUA,estado nutricional en menores de 5 anos,clasificacion d,2002-06-01,2,170,2,170,172
20305,CHARAÃ‘A,estado nutricional en menores de 5 anos,clasificacion d,2002-06-01,3,2,3,2,5
50202,CHAYANTA,estado nutricional en menores de 5 anos,clasificacion d,2002-06-01,14,99,14,99,113
31204,CHIMORE,estado nutricional en menores de 5 anos,clasificacion d,2002-06-01,9,5,9,5,14
40903,CHIPAYA,estado nutricional en menores de 5 anos,clasificacion d,2002-06-01,5,5,5,5,10
40302,CHOQUE COTA,estado nutricional en menores de 5 anos,clasificacion d,2002-06-01,9,4,9,4,13
21101,CHULUMANI (V. DE LA LIBERTAD),estado nutricional en menores de 5 anos,clasificacion d,2002-06-01,5,20,5,20,25
20501,CHUMA,estado nutricional en menores de 5 anos,clasificacion d,2002-06-01,8,13,8,13,21
30801,CLIZA,estado nutricional en menores de 5 anos,clasificacion d,2002-06-01,2,13,2,13,15
90101,COBIJA,estado nutricional en menores de 5 anos,clasificacion d,2002-06-01,51,49,51,49,100
30101,COCHABAMBA,estado nutricional en menores de 5 anos,clasificacion d,2002-06-01,243,346,243,346,589
40902,COIPASA,estado nutricional en menores de 5 anos,clasificacion d,2002-06-01,0,2,0,2,2
30905,COLCAPIRHUA,estado nutricional en menores de 5 anos,clasificacion d,2002-06-01,60,65,60,65,125
50901,"COLCHA ""K""",estado nutricional en menores de 5 anos,clasificacion d,2002-06-01,10,98,10,98,108
21307,COLLANA,estado nutricional en menores de 5 anos,clasificacion d,2002-06-01,7,0,7,0,7
31002,COLOMI,estado nutricional en menores de 5 anos,clasificacion d,2002-06-01,15,53,15,53,68
50401,COLQUECHACA,estado nutricional en menores de 5 anos,clasificacion d,2002-06-01,123,62,123,62,185
21306,COLQUENCHA,estado nutricional en menores de 5 anos,clasificacion d,2002-06-01,34,26,34,26,60
21004,COLQUIRI,estado nutricional en menores de 5 anos,clasificacion d,2002-06-01,43,31,43,31,74
20304,COMANCHE,estado nutricional en menores de 5 anos,clasificacion d,2002-06-01,10,17,10,17,27
71301,COMARAPA,estado nutricional en menores de 5 anos,clasificacion d,2002-06-01,41,57,41,57,98
20605,COMBAYA,estado nutricional en menores de 5 anos,clasificacion d,2002-06-01,8,22,8,22,30
71101,CONCEPCION,estado nutricional en menores de 5 anos,clasificacion d,2002-06-01,9,8,9,8,17
21701,COPACABANA,estado nutricional en menores de 5 anos,clasificacion d,2002-06-01,12,43,12,43,55
21402,CORIPATA,estado nutricional en menores de 5 anos,clasificacion d,2002-06-01,3,11,3,11,14
20301,CORO CORO,estado nutricional en menores de 5 anos,clasificacion d,2002-06-01,46,21,46,21,67
21401,COROICO,estado nutricional en menores de 5 anos,clasificacion d,2002-06-01,8,5,8,5,13
40301,CORQUE,estado nutricional en menores de 5 anos,clasificacion d,2002-06-01,20,28,20,28,48
50601,COTAGAITA,estado nutricional en menores de 5 anos,clasificacion d,2002-06-01,61,305,61,305,366
70102,COTOCA,estado nutricional en menores de 5 anos,clasificacion d,2002-06-01,26,21,26,21,47
31405,CUCHUMUELA (V. G. VILLARROEL),estado nutricional en menores de 5 anos,clasificacion d,2002-06-01,5,50,5,50,55
70704,CUEVO,estado nutricional en menores de 5 anos,clasificacion d,2002-06-01,12,14,12,14,26
10902,CULPINA,estado nutricional en menores de 5 anos,clasificacion d,2002-06-01,200,206,200,206,406
40401,CURAHUARA DE CARANGAS,estado nutricional en menores de 5 anos,clasificacion d,2002-06-01,19,7,19,7,26
21602,CURVA,estado nutricional en menores de 5 anos,clasificacion d,2002-06-01,27,11,27,11,38
20804,DESAGUADERO,estado nutricional en menores de 5 anos,clasificacion d,2002-06-01,2,21,2,21,23
20105,EL ALTO,estado nutricional en menores de 5 anos,clasificacion d,2002-06-01,1560,1046,1560,1046,2606
40103,EL CHORO,estado nutricional en menores de 5 anos,clasificacion d,2002-06-01,5,1,5,1,6
71503,EL PUENTE(STC),estado nutricional en menores de 5 anos,clasificacion d,2002-06-01,6,105,6,105,111
60502,EL PUENTE(TJA),estado nutricional en menores de 5 anos,clasificacion d,2002-06-01,55,132,55,132,187
70105,EL TORNO,estado nutricional en menores de 5 anos,clasificacion d,2002-06-01,33,57,33,57,90
10405,EL VILLAR,estado nutricional en menores de 5 anos,clasificacion d,2002-06-01,55,133,55,133,188
60601,ENTRE RIOS,estado nutricional en menores de 5 anos,clasificacion d,2002-06-01,51,56,51,56,107
41101,EUCALIPTUS,estado nutricional en menores de 5 anos,clasificacion d,2002-06-01,1,37,1,37,38
80402,EXALTACION,estado nutricional en menores de 5 anos,clasificacion d,2002-06-01,5,6,5,6,11
90203,FILADELFIA,estado nutricional en menores de 5 anos,clasificacion d,2002-06-01,13,20,13,20,33
71002,GENERAL SAAVEDRA,estado nutricional en menores de 5 anos,clasificacion d,2002-06-01,49,61,49,61,110
20602,GUANAY,estado nutricional en menores de 5 anos,clasificacion d,2002-06-01,125,135,125,135,260
20802,GUAQUI,estado nutricional en menores de 5 anos,clasificacion d,2002-06-01,8,10,8,10,18
80202,GUAYARAMERIN,estado nutricional en menores de 5 anos,clasificacion d,2002-06-01,59,58,59,58,117
70705,GUTIERREZ,estado nutricional en menores de 5 anos,clasificacion d,2002-06-01,20,133,20,133,153
10502,HUACARETA,estado nutricional en menores de 5 anos,clasificacion d,2002-06-01,86,106,86,106,192
11002,HUACAYA (VILLA DE HUACAYA),estado nutricional en menores de 5 anos,clasificacion d,2002-06-01,13,18,13,18,31
40501,HUACHACALLA,estado nutricional en menores de 5 anos,clasificacion d,2002-06-01,6,1,6,1,7
40701,HUANUNI,estado nutricional en menores de 5 anos,clasificacion d,2002-06-01,2,0,2,0,2
80803,HUARACAJE,estado nutricional en menores de 5 anos,clasificacion d,2002-06-01,8,0,8,0,8
41601,HUAYLLAMARCA,estado nutricional en menores de 5 anos,clasificacion d,2002-06-01,18,9,18,9,27
21005,ICHOCA,estado nutricional en menores de 5 anos,clasificacion d,2002-06-01,10,14,10,14,24
10304,ICLA,estado nutricional en menores de 5 anos,clasificacion d,2002-06-01,136,187,136,187,323
10703,INCAHUASI,estado nutricional en menores de 5 anos,clasificacion d,2002-06-01,139,181,139,181,320
90402,INGAVI (HUMAITA),estado nutricional en menores de 5 anos,clasificacion d,2002-06-01,1,0,1,0,1
21001,INQUISIVI,estado nutricional en menores de 5 anos,clasificacion d,2002-06-01,33,116,33,116,149
21102,IRUPANA (VILLA DE LANZA),estado nutricional en menores de 5 anos,clasificacion d,2002-06-01,14,34,14,34,48
21501,IXIAMAS,estado nutricional en menores de 5 anos,clasificacion d,2002-06-01,21,29,21,29,50
21105,LA ASUNTA,estado nutricional en menores de 5 anos,clasificacion d,2002-06-01,47,45,47,45,92
70104,LA GUARDIA,estado nutricional en menores de 5 anos,clasificacion d,2002-06-01,56,41,56,41,97
20101,LA PAZ,estado nutricional en menores de 5 anos,clasificacion d,2002-06-01,1225,874,1225,874,2099
70701,LAGUNILLAS,estado nutricional en menores de 5 anos,clasificacion d,2002-06-01,30,17,30,17,47
21202,LAJA,estado nutricional en menores de 5 anos,clasificacion d,2002-06-01,1,39,1,39,40
10903,LAS CARRERAS,estado nutricional en menores de 5 anos,clasificacion d,2002-06-01,23,32,23,32,55
50203,LLALLAGUA,estado nutricional en menores de 5 anos,clasificacion d,2002-06-01,1,42,1,42,43
51401,LLICA,estado nutricional en menores de 5 anos,clasificacion d,2002-06-01,9,15,9,15,24
80601,LORETO,estado nutricional en menores de 5 anos,clasificacion d,2002-06-01,3,14,3,14,17
20901,LURIBAY,estado nutricional en menores de 5 anos,clasificacion d,2002-06-01,2,22,2,22,24
11003,MACHARETI,estado nutricional en menores de 5 anos,clasificacion d,2002-06-01,31,92,31,92,123
80801,MAGDALENA,estado nutricional en menores de 5 anos,clasificacion d,2002-06-01,11,26,11,26,37
70903,MAIRANA,estado nutricional en menores de 5 anos,clasificacion d,2002-06-01,8,10,8,10,18
20103,MECAPACA,estado nutricional en menores de 5 anos,clasificacion d,2002-06-01,15,26,15,26,41
71003,MINEROS,estado nutricional en menores de 5 anos,clasificacion d,2002-06-01,53,24,53,24,77
31301,MIZQUE,estado nutricional en menores de 5 anos,clasificacion d,2002-06-01,15,34,15,34,49
20402,MOCOMOCO,estado nutricional en menores de 5 anos,clasificacion d,2002-06-01,36,35,36,35,71
51002,MOJINETE,estado nutricional en menores de 5 anos,clasificacion d,2002-06-01,0,17,0,17,17
10303,MOJOCOYA,estado nutricional en menores de 5 anos,clasificacion d,2002-06-01,77,129,77,129,206
10501,MONTEAGUDO,estado nutricional en menores de 5 anos,clasificacion d,2002-06-01,136,227,136,227,363
71001,MONTERO,estado nutricional en menores de 5 anos,clasificacion d,2002-06-01,108,276,108,276,384
70803,MORO MORO,estado nutricional en menores de 5 anos,clasificacion d,2002-06-01,18,17,18,17,35
30302,MOROCHATA,estado nutricional en menores de 5 anos,clasificacion d,2002-06-01,29,78,29,78,107
90401,NACEBE (SANTA ROSA DEL ABUNA),estado nutricional en menores de 5 anos,clasificacion d,2002-06-01,2,1,2,1,3
20307,NAZACARA DE PACAJES,estado nutricional en menores de 5 anos,clasificacion d,2002-06-01,2,0,2,0,2
90501,NUEVO MANOA (NUEVA ESPERANZA),estado nutricional en menores de 5 anos,clasificacion d,2002-06-01,0,6,0,6,6
50404,OCURI,estado nutricional en menores de 5 anos,clasificacion d,2002-06-01,48,139,48,139,187
70202,OKINAWA,estado nutricional en menores de 5 anos,clasificacion d,2002-06-01,10,31,10,31,41
40101,ORURO,estado nutricional en menores de 5 anos,clasificacion d,2002-06-01,455,378,455,378,833
60201,PADCAYA,estado nutricional en menores de 5 anos,clasificacion d,2002-06-01,30,67,30,67,97
10401,PADILLA,estado nutricional en menores de 5 anos,clasificacion d,2002-06-01,128,258,128,258,386
70502,PAILON,estado nutricional en menores de 5 anos,clasificacion d,2002-06-01,15,13,15,13,28
20102,PALCA,estado nutricional en menores de 5 anos,clasificacion d,2002-06-01,8,36,8,36,44
21104,PALOS BLANCOS,estado nutricional en menores de 5 anos,clasificacion d,2002-06-01,73,105,73,105,178
40802,PAMPA AULLAGAS,estado nutricional en menores de 5 anos,clasificacion d,2002-06-01,17,24,17,24,41
70902,PAMPA GRANDE,estado nutricional en menores de 5 anos,clasificacion d,2002-06-01,5,9,5,9,14
21802,PAPEL PAMPA,estado nutricional en menores de 5 anos,clasificacion d,2002-06-01,9,13,9,13,22
30202,PASORAPA,estado nutricional en menores de 5 anos,clasificacion d,2002-06-01,16,27,16,27,43
21305,PATACAMAYA,estado nutricional en menores de 5 anos,clasificacion d,2002-06-01,39,16,39,16,55
40602,PAZÃ‘A,estado nutricional en menores de 5 anos,clasificacion d,2002-06-01,5,27,5,27,32
20702,PELECHUCO,estado nutricional en menores de 5 anos,clasificacion d,2002-06-01,11,26,11,26,37
50403,POCOATA,estado nutricional en menores de 5 anos,clasificacion d,2002-06-01,195,236,195,236,431
31203,POCONA,estado nutricional en menores de 5 anos,clasificacion d,2002-06-01,50,46,50,46,96
31202,POJO (CBBA),estado nutricional en menores de 5 anos,clasificacion d,2002-06-01,98,105,98,105,203
40601,POOPO,estado nutricional en menores de 5 anos,clasificacion d,2002-06-01,0,18,0,18,18
51203,PORCO,estado nutricional en menores de 5 anos,clasificacion d,2002-06-01,29,36,29,36,65
10103,POROMA,estado nutricional en menores de 5 anos,clasificacion d,2002-06-01,156,180,156,180,336
70103,PORONGO,estado nutricional en menores de 5 anos,clasificacion d,2002-06-01,16,13,16,13,29
70601,PORTACHUELO,estado nutricional en menores de 5 anos,clasificacion d,2002-06-01,39,19,39,19,58
70804,POSTRER VALLE,estado nutricional en menores de 5 anos,clasificacion d,2002-06-01,2,6,2,6,8
50101,POTOSI,estado nutricional en menores de 5 anos,clasificacion d,2002-06-01,475,371,475,371,846
10302,PRESTO,estado nutricional en menores de 5 anos,clasificacion d,2002-06-01,45,71,45,71,116
21201,PUCARANI,estado nutricional en menores de 5 anos,clasificacion d,2002-06-01,4,77,4,77,81
20401,PUERTO ACOSTA,estado nutricional en menores de 5 anos,clasificacion d,2002-06-01,83,90,83,90,173
20403,PUERTO CARABUCO,estado nutricional en menores de 5 anos,clasificacion d,2002-06-01,50,57,50,57,107
90301,PUERTO GONZALO MORENO,estado nutricional en menores de 5 anos,clasificacion d,2002-06-01,1,4,1,4,5
21204,PUERTO PEREZ,estado nutricional en menores de 5 anos,clasificacion d,2002-06-01,1,23,1,23,24
71402,PUERTO QUIJARRO,estado nutricional en menores de 5 anos,clasificacion d,2002-06-01,26,13,26,13,39
90201,PUERTO RICO,estado nutricional en menores de 5 anos,clasificacion d,2002-06-01,9,13,9,13,22
80703,PUERTO SILES,estado nutricional en menores de 5 anos,clasificacion d,2002-06-01,2,1,2,1,3
71401,PUERTO SUAREZ,estado nutricional en menores de 5 anos,clasificacion d,2002-06-01,29,13,29,13,42
31205,PUERTO VILLARROEL,estado nutricional en menores de 5 anos,clasificacion d,2002-06-01,104,125,104,125,229
51101,PUNA,estado nutricional en menores de 5 anos,clasificacion d,2002-06-01,19,147,19,147,166
31401,PUNATA,estado nutricional en menores de 5 anos,clasificacion d,2002-06-01,75,58,75,58,133
20604,QUIABAYA,estado nutricional en menores de 5 anos,clasificacion d,2002-06-01,9,24,9,24,33
30901,QUILLACOLLO,estado nutricional en menores de 5 anos,clasificacion d,2002-06-01,37,30,37,30,67
21002,QUIME,estado nutricional en menores de 5 anos,clasificacion d,2002-06-01,32,34,32,34,66
70904,QUIRUSILLAS,estado nutricional en menores de 5 anos,clasificacion d,2002-06-01,0,1,0,1,1
50402,RAVELO,estado nutricional en menores de 5 anos,clasificacion d,2002-06-01,240,289,240,289,529
80301,REYES,estado nutricional en menores de 5 anos,clasificacion d,2002-06-01,20,22,20,22,42
80201,RIBERALTA,estado nutricional en menores de 5 anos,clasificacion d,2002-06-01,241,171,241,171,412
70503,ROBORE,estado nutricional en menores de 5 anos,clasificacion d,2002-06-01,21,38,21,38,59
80304,RURRENABAQUE,estado nutricional en menores de 5 anos,clasificacion d,2002-06-01,17,8,17,8,25
40901,SABAYA,estado nutricional en menores de 5 anos,clasificacion d,2002-06-01,2,4,2,4,6
31001,SACABA,estado nutricional en menores de 5 anos,clasificacion d,2002-06-01,69,28,69,28,97
30404,SACABAMBA,estado nutricional en menores de 5 anos,clasificacion d,2002-06-01,0,56,0,56,56
50701,SACACA,estado nutricional en menores de 5 anos,clasificacion d,2002-06-01,120,474,120,474,594
71302,SAIPINA,estado nutricional en menores de 5 anos,clasificacion d,2002-06-01,12,10,12,10,22
40801,SALINAS DE GARCI MENDOZA,estado nutricional en menores de 5 anos,clasificacion d,2002-06-01,21,7,21,7,28
70901,SAMAIPATA,estado nutricional en menores de 5 anos,clasificacion d,2002-06-01,10,19,10,19,29
51601,SAN AGUSTIN,estado nutricional en menores de 5 anos,clasificacion d,2002-06-01,5,15,5,15,20
80602,SAN ANDRES,estado nutricional en menores de 5 anos,clasificacion d,2002-06-01,17,37,17,37,54
51003,SAN ANTONIO DE ESMORUCO,estado nutricional en menores de 5 anos,clasificacion d,2002-06-01,0,1,0,1,1
71105,SAN ANTONIO DE LOMERIO,estado nutricional en menores de 5 anos,clasificacion d,2002-06-01,56,92,56,92,148
31403,SAN BENITO,estado nutricional en menores de 5 anos,clasificacion d,2002-06-01,8,31,8,31,39
80302,SAN BORJA,estado nutricional en menores de 5 anos,clasificacion d,2002-06-01,132,85,132,85,217
21502,SAN BUENA VENTURA,estado nutricional en menores de 5 anos,clasificacion d,2002-06-01,43,31,43,31,74
80501,SAN IGNACIO,estado nutricional en menores de 5 anos,clasificacion d,2002-06-01,19,93,19,93,112
70301,SAN IGNACIO DE VELASCO,estado nutricional en menores de 5 anos,clasificacion d,2002-06-01,194,191,194,191,385
80102,SAN JAVIER(BNI),estado nutricional en menores de 5 anos,clasificacion d,2002-06-01,15,27,15,27,42
71102,SAN JAVIER(STC),estado nutricional en menores de 5 anos,clasificacion d,2002-06-01,35,55,35,55,90
80701,SAN JOAQUIN,estado nutricional en menores de 5 anos,clasificacion d,2002-06-01,0,15,0,15,15
70501,SAN JOSE DE CHIQUITOS,estado nutricional en menores de 5 anos,clasificacion d,2002-06-01,30,5,30,5,35
71104,SAN JULIAN,estado nutricional en menores de 5 anos,clasificacion d,2002-06-01,63,144,63,144,207
90302,SAN LORENZO(PND),estado nutricional en menores de 5 anos,clasificacion d,2002-06-01,2,5,2,5,7
60501,SAN LORENZO(TJA),estado nutricional en menores de 5 anos,clasificacion d,2002-06-01,35,40,35,40,75
10702,SAN LUCAS,estado nutricional en menores de 5 anos,clasificacion d,2002-06-01,340,419,340,419,759
71201,SAN MATIAS,estado nutricional en menores de 5 anos,clasificacion d,2002-06-01,0,2,0,2,2
70302,SAN MIGUEL DE VELASCO,estado nutricional en menores de 5 anos,clasificacion d,2002-06-01,78,69,78,69,147
51001,SAN PABLO DE LIPEZ,estado nutricional en menores de 5 anos,clasificacion d,2002-06-01,1,17,1,17,18
50501,SAN PEDRO DE BUENA VISTA,estado nutricional en menores de 5 anos,clasificacion d,2002-06-01,20,340,20,340,360
21801,SAN PEDRO DE CURAHUARA,estado nutricional en menores de 5 anos,clasificacion d,2002-06-01,20,37,20,37,57
50902,SAN PEDRO DE QUEMES,estado nutricional en menores de 5 anos,clasificacion d,2002-06-01,1,4,1,4,5
21702,SAN PEDRO DE TIQUINA,estado nutricional en menores de 5 anos,clasificacion d,2002-06-01,0,10,0,10,10
90202,SAN PEDRO(PND),estado nutricional en menores de 5 anos,clasificacion d,2002-06-01,10,23,10,23,33
70303,SAN RAFAEL,estado nutricional en menores de 5 anos,clasificacion d,2002-06-01,36,43,36,43,79
80702,SAN RAMON,estado nutricional en menores de 5 anos,clasificacion d,2002-06-01,1,2,1,2,3
80702,SAN RAMON,estado nutricional en menores de 5 anos,clasificacion d,2002-06-01,12,12,12,12,24
80401,SANTA ANA,estado nutricional en menores de 5 anos,clasificacion d,2002-06-01,6,10,6,10,16
70101,SANTA CRUZ DE LA SIERRA,estado nutricional en menores de 5 anos,clasificacion d,2002-06-01,314,203,314,203,517
80303,SANTA ROSA,estado nutricional en menores de 5 anos,clasificacion d,2002-06-01,13,7,13,7,20
70602,SANTA ROSA DEL SARA,estado nutricional en menores de 5 anos,clasificacion d,2002-06-01,18,23,18,23,41
20308,SANTIAGO DE CALLAPA,estado nutricional en menores de 5 anos,clasificacion d,2002-06-01,6,5,6,5,11
41401,SANTIAGO DE HUARI,estado nutricional en menores de 5 anos,clasificacion d,2002-06-01,14,28,14,28,42
21901,SANTIAGO DE MACHACA,estado nutricional en menores de 5 anos,clasificacion d,2002-06-01,13,6,13,6,19
30702,SANTIVAÃ‘ES,estado nutricional en menores de 5 anos,clasificacion d,2002-06-01,28,15,28,15,43
40202,SANTUARIO DE QUILLACAS,estado nutricional en menores de 5 anos,clasificacion d,2002-06-01,9,18,9,18,27
20902,SAPAHAQUI,estado nutricional en menores de 5 anos,clasificacion d,2002-06-01,1,11,1,11,12
90303,SENA,estado nutricional en menores de 5 anos,clasificacion d,2002-06-01,20,11,20,11,31
21301,SICA SICA (VILLA AROMA),estado nutricional en menores de 5 anos,clasificacion d,2002-06-01,54,23,54,23,77
30703,SICAYA,estado nutricional en menores de 5 anos,clasificacion d,2002-06-01,0,28,0,28,28
30902,SIPE SIPE,estado nutricional en menores de 5 anos,clasificacion d,2002-06-01,164,170,164,170,334
10403,SOPACHUY,estado nutricional en menores de 5 anos,clasificacion d,2002-06-01,64,73,64,73,137
20601,SORATA,estado nutricional en menores de 5 anos,clasificacion d,2002-06-01,27,41,27,41,68
10101,SUCRE,estado nutricional en menores de 5 anos,clasificacion d,2002-06-01,595,616,595,616,1211
31404,TACACHI,estado nutricional en menores de 5 anos,clasificacion d,2002-06-01,0,5,0,5,5
20603,TACACOMA,estado nutricional en menores de 5 anos,clasificacion d,2002-06-01,14,15,14,15,29
50303,TACOBAMBA,estado nutricional en menores de 5 anos,clasificacion d,2002-06-01,55,55,55,55,110
30602,TACOPAYA,estado nutricional en menores de 5 anos,clasificacion d,2002-06-01,30,93,30,93,123
51402,TAHUA,estado nutricional en menores de 5 anos,clasificacion d,2002-06-01,1,4,1,4,5
31101,TAPACARI,estado nutricional en menores de 5 anos,clasificacion d,2002-06-01,7,129,7,129,136
10601,TARABUCO,estado nutricional en menores de 5 anos,clasificacion d,2002-06-01,232,516,232,516,748
30401,TARATA,estado nutricional en menores de 5 anos,clasificacion d,2002-06-01,26,19,26,19,45
60101,TARIJA,estado nutricional en menores de 5 anos,clasificacion d,2002-06-01,204,160,204,160,364
10202,TARVITA,estado nutricional en menores de 5 anos,clasificacion d,2002-06-01,107,140,107,140,247
20803,TIAWANACU,estado nutricional en menores de 5 anos,clasificacion d,2002-06-01,20,20,20,20,40
50102,TINGUIPAYA,estado nutricional en menores de 5 anos,clasificacion d,2002-06-01,23,139,23,139,162
20606,TIPUANI,estado nutricional en menores de 5 anos,clasificacion d,2002-06-01,1,8,1,8,9
30903,TIQUIPAYA,estado nutricional en menores de 5 anos,clasificacion d,2002-06-01,40,45,40,45,85
31601,TIRAQUE (CBBA),estado nutricional en menores de 5 anos,clasificacion d,2002-06-01,64,88,64,88,152
21703,TITO YUPANQUI (PARQUIPUJIO),estado nutricional en menores de 5 anos,clasificacion d,2002-06-01,11,7,11,7,18
30802,TOCO,estado nutricional en menores de 5 anos,clasificacion d,2002-06-01,5,9,5,9,14
30803,TOLATA,estado nutricional en menores de 5 anos,clasificacion d,2002-06-01,12,3,12,3,15
41001,TOLEDO,estado nutricional en menores de 5 anos,clasificacion d,2002-06-01,2,9,2,9,11
51202,TOMAVE,estado nutricional en menores de 5 anos,clasificacion d,2002-06-01,2,172,2,172,174
10402,TOMINA,estado nutricional en menores de 5 anos,clasificacion d,2002-06-01,104,230,104,230,334
50502,TORO TORO,estado nutricional en menores de 5 anos,clasificacion d,2002-06-01,5,30,5,30,35
31201,TOTORA(CBBA),estado nutricional en menores de 5 anos,clasificacion d,2002-06-01,45,48,45,48,93
41301,TOTORA(ORR),estado nutricional en menores de 5 anos,clasificacion d,2002-06-01,15,22,15,22,37
70802,TRIGAL,estado nutricional en menores de 5 anos,clasificacion d,2002-06-01,1,2,1,2,3
80101,TRINIDAD,estado nutricional en menores de 5 anos,clasificacion d,2002-06-01,112,152,112,152,264
50801,TUPIZA,estado nutricional en menores de 5 anos,clasificacion d,2002-06-01,7,283,7,283,290
40402,TURCO,estado nutricional en menores de 5 anos,clasificacion d,2002-06-01,3,4,3,4,7
21302,UMALA,estado nutricional en menores de 5 anos,clasificacion d,2002-06-01,9,11,9,11,20
50201,UNCIA,estado nutricional en menores de 5 anos,clasificacion d,2002-06-01,47,141,47,141,188
60401,URIONDO (A. CONCEPCION),estado nutricional en menores de 5 anos,clasificacion d,2002-06-01,12,34,12,34,46
71502,URUBICHA,estado nutricional en menores de 5 anos,clasificacion d,2002-06-01,68,232,68,232,300
51201,UYUNI,estado nutricional en menores de 5 anos,clasificacion d,2002-06-01,41,165,41,165,206
30502,VACAS,estado nutricional en menores de 5 anos,clasificacion d,2002-06-01,0,65,0,65,65
70801,VALLEGRANDE,estado nutricional en menores de 5 anos,clasificacion d,2002-06-01,19,84,19,84,103
20801,VIACHA,estado nutricional en menores de 5 anos,clasificacion d,2002-06-01,22,120,22,120,142
31302,VILA VILA,estado nutricional en menores de 5 anos,clasificacion d,2002-06-01,9,15,9,15,24
60303,VILLA MONTES,estado nutricional en menores de 5 anos,clasificacion d,2002-06-01,33,43,33,43,76
90502,VILLA NUEVA (LOMA ALTA),estado nutricional en menores de 5 anos,clasificacion d,2002-06-01,1,1,1,1,2
31402,VILLA RIVERO,estado nutricional en menores de 5 anos,clasificacion d,2002-06-01,6,23,6,23,29
10801,VILLA SERRANO,estado nutricional en menores de 5 anos,clasificacion d,2002-06-01,122,262,122,262,384
31003,VILLA TUNARI,estado nutricional en menores de 5 anos,clasificacion d,2002-06-01,139,142,139,142,281
11001,VILLA VACA GUZMAN (MUYUPAMPA),estado nutricional en menores de 5 anos,clasificacion d,2002-06-01,52,90,52,90,142
51501,VILLAZON,estado nutricional en menores de 5 anos,clasificacion d,2002-06-01,26,182,26,182,208
30904,VINTO,estado nutricional en menores de 5 anos,clasificacion d,2002-06-01,48,23,48,23,71
50602,VITICHI,estado nutricional en menores de 5 anos,clasificacion d,2002-06-01,49,136,49,136,185
20306,WALDO BALLIVIAN,estado nutricional en menores de 5 anos,clasificacion d,2002-06-01,3,3,3,3,6
70201,WARNES,estado nutricional en menores de 5 anos,clasificacion d,2002-06-01,73,59,73,59,132
20903,YACO,estado nutricional en menores de 5 anos,clasificacion d,2002-06-01,0,19,0,19,19
60301,YACUIBA,estado nutricional en menores de 5 anos,clasificacion d,2002-06-01,72,53,72,53,125
10602,YAMPARAEZ,estado nutricional en menores de 5 anos,clasificacion d,2002-06-01,153,281,153,281,434
21103,YANACACHI,estado nutricional en menores de 5 anos,clasificacion d,2002-06-01,4,6,4,6,10
50103,YOCALLA,estado nutricional en menores de 5 anos,clasificacion d,2002-06-01,4,93,4,93,97
10102,YOTALA,estado nutricional en menores de 5 anos,clasificacion d,2002-06-01,130,209,130,209,339
60402,YUNCHARA,estado nutricional en menores de 5 anos,clasificacion d,2002-06-01,21,20,21,20,41
10301,ZUDAÃ‘EZ,estado nutricional en menores de 5 anos,clasificacion d,2002-06-01,63,146,63,146,209
51302,ACACIO,estado nutricional en menores de 5 anos,clasificacion d,2002-07-01,44,106,44,106,150
20201,ACHACACHI,estado nutricional en menores de 5 anos,clasificacion d,2002-07-01,112,111,112,111,223
20104,ACHOCALLA,estado nutricional en menores de 5 anos,clasificacion d,2002-07-01,17,8,17,8,25
30201,AIQUILE,estado nutricional en menores de 5 anos,clasificacion d,2002-07-01,30,86,30,86,116
31303,ALALAY,estado nutricional en menores de 5 anos,clasificacion d,2002-07-01,11,6,11,6,17
10404,ALCALA,estado nutricional en menores de 5 anos,clasificacion d,2002-07-01,39,66,39,66,105
20202,ANCORAIMES,estado nutricional en menores de 5 anos,clasificacion d,2002-07-01,54,106,54,106,160
41201,ANDAMARCA,estado nutricional en menores de 5 anos,clasificacion d,2002-07-01,5,11,5,11,16
40603,ANTEQUERA,estado nutricional en menores de 5 anos,clasificacion d,2002-07-01,0,36,0,36,36
30402,ANZALDO,estado nutricional en menores de 5 anos,clasificacion d,2002-07-01,3,92,3,92,95
20701,APOLO,estado nutricional en menores de 5 anos,clasificacion d,2002-07-01,40,29,40,29,69
51301,ARAMPAMPA,estado nutricional en menores de 5 anos,clasificacion d,2002-07-01,44,58,44,58,102
30501,ARANI,estado nutricional en menores de 5 anos,clasificacion d,2002-07-01,20,39,20,39,59
30403,ARBIETO,estado nutricional en menores de 5 anos,clasificacion d,2002-07-01,0,36,0,36,36
30601,ARQUE,estado nutricional en menores de 5 anos,clasificacion d,2002-07-01,43,73,43,73,116
71501,ASCENCION DE GUARAYOS,estado nutricional en menores de 5 anos,clasificacion d,2002-07-01,1,1,1,1,2
50802,ATOCHA,estado nutricional en menores de 5 anos,clasificacion d,2002-07-01,1,90,1,90,91
20503,AUCAPATA,estado nutricional en menores de 5 anos,clasificacion d,2002-07-01,4,2,4,2,6
20502,AYATA,estado nutricional en menores de 5 anos,clasificacion d,2002-07-01,16,3,16,3,19
21303,AYO AYO,estado nutricional en menores de 5 anos,clasificacion d,2002-07-01,28,20,28,20,48
30301,AYOPAYA (V. DE INDEPENDENCIA),estado nutricional en menores de 5 anos,clasificacion d,2002-07-01,110,106,110,106,216
10201,AZURDUY,estado nutricional en menores de 5 anos,clasificacion d,2002-07-01,82,101,82,101,183
21203,BATALLAS,estado nutricional en menores de 5 anos,clasificacion d,2002-07-01,21,19,21,19,40
80802,BAURES,estado nutricional en menores de 5 anos,clasificacion d,2002-07-01,17,31,17,31,48
41202,BELEN DE ANDAMARCA,estado nutricional en menores de 5 anos,clasificacion d,2002-07-01,0,2,0,2,2
50104,BELEN DE URMIRI,estado nutricional en menores de 5 anos,clasificacion d,2002-07-01,5,25,5,25,30
90104,BELLA FLOR,estado nutricional en menores de 5 anos,clasificacion d,2002-07-01,3,6,3,6,9
60202,BERMEJO,estado nutricional en menores de 5 anos,clasificacion d,2002-07-01,4,10,4,10,14
50301,BETANZOS,estado nutricional en menores de 5 anos,clasificacion d,2002-07-01,225,351,225,351,576
31501,BOLIVAR,estado nutricional en menores de 5 anos,clasificacion d,2002-07-01,63,70,63,70,133
90103,BOLPEBRA,estado nutricional en menores de 5 anos,clasificacion d,2002-07-01,2,7,2,7,9
70707,BOYUIBE,estado nutricional en menores de 5 anos,clasificacion d,2002-07-01,1,45,1,45,46
70703,CABEZAS,estado nutricional en menores de 5 anos,clasificacion d,2002-07-01,17,13,17,13,30
20905,CAIROMA,estado nutricional en menores de 5 anos,clasificacion d,2002-07-01,24,35,24,35,59
51102,"CAIZA ""D""",estado nutricional en menores de 5 anos,clasificacion d,2002-07-01,63,71,63,71,134
21003,CAJUATA,estado nutricional en menores de 5 anos,clasificacion d,2002-07-01,18,15,18,15,33
20303,CALACOTO,estado nutricional en menores de 5 anos,clasificacion d,2002-07-01,10,12,10,12,22
21304,CALAMARCA,estado nutricional en menores de 5 anos,clasificacion d,2002-07-01,31,24,31,24,55
10701,CAMARGO,estado nutricional en menores de 5 anos,clasificacion d,2002-07-01,40,85,40,85,125
10901,CAMATAQUI (C. VILLA ABECIA),estado nutricional en menores de 5 anos,clasificacion d,2002-07-01,26,34,26,34,60
70706,CAMIRI,estado nutricional en menores de 5 anos,clasificacion d,2002-07-01,24,53,24,53,77
30701,CAPINOTA,estado nutricional en menores de 5 anos,clasificacion d,2002-07-01,23,39,23,39,62
20302,CAQUIAVIRI,estado nutricional en menores de 5 anos,clasificacion d,2002-07-01,22,11,22,11,33
40102,CARACOLLO,estado nutricional en menores de 5 anos,clasificacion d,2002-07-01,30,40,30,40,70
22001,CARANAVI,estado nutricional en menores de 5 anos,clasificacion d,2002-07-01,175,148,175,148,323
41503,CARANGAS,estado nutricional en menores de 5 anos,clasificacion d,2002-07-01,0,3,0,3,3
60302,CARAPARI,estado nutricional en menores de 5 anos,clasificacion d,2002-07-01,27,42,27,42,69
50702,CARIPUYO,estado nutricional en menores de 5 anos,clasificacion d,2002-07-01,62,96,62,96,158
21902,CATACORA,estado nutricional en menores de 5 anos,clasificacion d,2002-07-01,2,2,2,2,4
21803,CHACARILLA,estado nutricional en menores de 5 anos,clasificacion d,2002-07-01,7,0,7,0,7
40201,CHALLAPATA,estado nutricional en menores de 5 anos,clasificacion d,2002-07-01,29,73,29,73,102
50302,CHAQUI,estado nutricional en menores de 5 anos,clasificacion d,2002-07-01,64,58,64,58,122
70702,CHARAGUA,estado nutricional en menores de 5 anos,clasificacion d,2002-07-01,33,171,33,171,204
20305,CHARAÃ‘A,estado nutricional en menores de 5 anos,clasificacion d,2002-07-01,17,16,17,16,33
50202,CHAYANTA,estado nutricional en menores de 5 anos,clasificacion d,2002-07-01,58,59,58,59,117
31204,CHIMORE,estado nutricional en menores de 5 anos,clasificacion d,2002-07-01,20,17,20,17,37
40903,CHIPAYA,estado nutricional en menores de 5 anos,clasificacion d,2002-07-01,0,3,0,3,3
40302,CHOQUE COTA,estado nutricional en menores de 5 anos,clasificacion d,2002-07-01,2,3,2,3,5
21101,CHULUMANI (V. DE LA LIBERTAD),estado nutricional en menores de 5 anos,clasificacion d,2002-07-01,11,28,11,28,39
20501,CHUMA,estado nutricional en menores de 5 anos,clasificacion d,2002-07-01,11,22,11,22,33
30801,CLIZA,estado nutricional en menores de 5 anos,clasificacion d,2002-07-01,4,17,4,17,21
90101,COBIJA,estado nutricional en menores de 5 anos,clasificacion d,2002-07-01,71,70,71,70,141
30101,COCHABAMBA,estado nutricional en menores de 5 anos,clasificacion d,2002-07-01,324,402,324,402,726
40902,COIPASA,estado nutricional en menores de 5 anos,clasificacion d,2002-07-01,0,2,0,2,2
30905,COLCAPIRHUA,estado nutricional en menores de 5 anos,clasificacion d,2002-07-01,28,96,28,96,124
50901,"COLCHA ""K""",estado nutricional en menores de 5 anos,clasificacion d,2002-07-01,39,70,39,70,109
21307,COLLANA,estado nutricional en menores de 5 anos,clasificacion d,2002-07-01,3,0,3,0,3
31002,COLOMI,estado nutricional en menores de 5 anos,clasificacion d,2002-07-01,22,40,22,40,62
50401,COLQUECHACA,estado nutricional en menores de 5 anos,clasificacion d,2002-07-01,124,71,124,71,195
21306,COLQUENCHA,estado nutricional en menores de 5 anos,clasificacion d,2002-07-01,27,22,27,22,49
21004,COLQUIRI,estado nutricional en menores de 5 anos,clasificacion d,2002-07-01,52,28,52,28,80
20304,COMANCHE,estado nutricional en menores de 5 anos,clasificacion d,2002-07-01,2,1,2,1,3
71301,COMARAPA,estado nutricional en menores de 5 anos,clasificacion d,2002-07-01,59,80,59,80,139
20605,COMBAYA,estado nutricional en menores de 5 anos,clasificacion d,2002-07-01,5,12,5,12,17
71101,CONCEPCION,estado nutricional en menores de 5 anos,clasificacion d,2002-07-01,15,12,15,12,27
21701,COPACABANA,estado nutricional en menores de 5 anos,clasificacion d,2002-07-01,14,45,14,45,59
21402,CORIPATA,estado nutricional en menores de 5 anos,clasificacion d,2002-07-01,7,11,7,11,18
20301,CORO CORO,estado nutricional en menores de 5 anos,clasificacion d,2002-07-01,26,18,26,18,44
21401,COROICO,estado nutricional en menores de 5 anos,clasificacion d,2002-07-01,24,25,24,25,49
40301,CORQUE,estado nutricional en menores de 5 anos,clasificacion d,2002-07-01,21,16,21,16,37
50601,COTAGAITA,estado nutricional en menores de 5 anos,clasificacion d,2002-07-01,70,149,70,149,219
70102,COTOCA,estado nutricional en menores de 5 anos,clasificacion d,2002-07-01,36,20,36,20,56
31405,CUCHUMUELA (V. G. VILLARROEL),estado nutricional en menores de 5 anos,clasificacion d,2002-07-01,16,14,16,14,30
70704,CUEVO,estado nutricional en menores de 5 anos,clasificacion d,2002-07-01,19,24,19,24,43
10902,CULPINA,estado nutricional en menores de 5 anos,clasificacion d,2002-07-01,182,183,182,183,365
40401,CURAHUARA DE CARANGAS,estado nutricional en menores de 5 anos,clasificacion d,2002-07-01,23,4,23,4,27
21602,CURVA,estado nutricional en menores de 5 anos,clasificacion d,2002-07-01,18,8,18,8,26
20804,DESAGUADERO,estado nutricional en menores de 5 anos,clasificacion d,2002-07-01,21,11,21,11,32
20105,EL ALTO,estado nutricional en menores de 5 anos,clasificacion d,2002-07-01,1746,1142,1746,1142,2888
40103,EL CHORO,estado nutricional en menores de 5 anos,clasificacion d,2002-07-01,2,5,2,5,7
71503,EL PUENTE(STC),estado nutricional en menores de 5 anos,clasificacion d,2002-07-01,2,91,2,91,93
60502,EL PUENTE(TJA),estado nutricional en menores de 5 anos,clasificacion d,2002-07-01,54,75,54,75,129
70105,EL TORNO,estado nutricional en menores de 5 anos,clasificacion d,2002-07-01,95,104,95,104,199
10405,EL VILLAR,estado nutricional en menores de 5 anos,clasificacion d,2002-07-01,55,119,55,119,174
60601,ENTRE RIOS,estado nutricional en menores de 5 anos,clasificacion d,2002-07-01,36,52,36,52,88
41101,EUCALIPTUS,estado nutricional en menores de 5 anos,clasificacion d,2002-07-01,6,7,6,7,13
90503,EUREKA (SANTOS MERCADO),estado nutricional en menores de 5 anos,clasificacion d,2002-07-01,0,1,0,1,1
80402,EXALTACION,estado nutricional en menores de 5 anos,clasificacion d,2002-07-01,2,16,2,16,18
90203,FILADELFIA,estado nutricional en menores de 5 anos,clasificacion d,2002-07-01,5,9,5,9,14
71002,GENERAL SAAVEDRA,estado nutricional en menores de 5 anos,clasificacion d,2002-07-01,85,88,85,88,173
21601,GRAL. J.J. PEREZ (CHARAZANI),estado nutricional en menores de 5 anos,clasificacion d,2002-07-01,13,26,13,26,39
20602,GUANAY,estado nutricional en menores de 5 anos,clasificacion d,2002-07-01,144,115,144,115,259
20802,GUAQUI,estado nutricional en menores de 5 anos,clasificacion d,2002-07-01,21,26,21,26,47
80202,GUAYARAMERIN,estado nutricional en menores de 5 anos,clasificacion d,2002-07-01,104,112,104,112,216
70705,GUTIERREZ,estado nutricional en menores de 5 anos,clasificacion d,2002-07-01,66,131,66,131,197
10502,HUACARETA,estado nutricional en menores de 5 anos,clasificacion d,2002-07-01,77,130,77,130,207
11002,HUACAYA (VILLA DE HUACAYA),estado nutricional en menores de 5 anos,clasificacion d,2002-07-01,13,18,13,18,31
40501,HUACHACALLA,estado nutricional en menores de 5 anos,clasificacion d,2002-07-01,1,2,1,2,3
40701,HUANUNI,estado nutricional en menores de 5 anos,clasificacion d,2002-07-01,80,74,80,74,154
80803,HUARACAJE,estado nutricional en menores de 5 anos,clasificacion d,2002-07-01,6,3,6,3,9
41601,HUAYLLAMARCA,estado nutricional en menores de 5 anos,clasificacion d,2002-07-01,24,24,24,24,48
21005,ICHOCA,estado nutricional en menores de 5 anos,clasificacion d,2002-07-01,4,8,4,8,12
10304,ICLA,estado nutricional en menores de 5 anos,clasificacion d,2002-07-01,115,177,115,177,292
10703,INCAHUASI,estado nutricional en menores de 5 anos,clasificacion d,2002-07-01,104,192,104,192,296
21001,INQUISIVI,estado nutricional en menores de 5 anos,clasificacion d,2002-07-01,35,78,35,78,113
21102,IRUPANA (VILLA DE LANZA),estado nutricional en menores de 5 anos,clasificacion d,2002-07-01,12,52,12,52,64
21501,IXIAMAS,estado nutricional en menores de 5 anos,clasificacion d,2002-07-01,30,43,30,43,73
21105,LA ASUNTA,estado nutricional en menores de 5 anos,clasificacion d,2002-07-01,53,36,53,36,89
70104,LA GUARDIA,estado nutricional en menores de 5 anos,clasificacion d,2002-07-01,49,33,49,33,82
20101,LA PAZ,estado nutricional en menores de 5 anos,clasificacion d,2002-07-01,1248,881,1248,881,2129
70701,LAGUNILLAS,estado nutricional en menores de 5 anos,clasificacion d,2002-07-01,39,29,39,29,68
21202,LAJA,estado nutricional en menores de 5 anos,clasificacion d,2002-07-01,13,23,13,23,36
10903,LAS CARRERAS,estado nutricional en menores de 5 anos,clasificacion d,2002-07-01,25,44,25,44,69
21006,LICOMA PAMPA,estado nutricional en menores de 5 anos,clasificacion d,2002-07-01,3,9,3,9,12
50203,LLALLAGUA,estado nutricional en menores de 5 anos,clasificacion d,2002-07-01,9,168,9,168,177
51401,LLICA,estado nutricional en menores de 5 anos,clasificacion d,2002-07-01,4,5,4,5,9
80601,LORETO,estado nutricional en menores de 5 anos,clasificacion d,2002-07-01,8,10,8,10,18
20901,LURIBAY,estado nutricional en menores de 5 anos,clasificacion d,2002-07-01,11,33,11,33,44
40702,MACHACAMARCA,estado nutricional en menores de 5 anos,clasificacion d,2002-07-01,6,15,6,15,21
11003,MACHARETI,estado nutricional en menores de 5 anos,clasificacion d,2002-07-01,35,79,35,79,114
80801,MAGDALENA,estado nutricional en menores de 5 anos,clasificacion d,2002-07-01,23,22,23,22,45
70903,MAIRANA,estado nutricional en menores de 5 anos,clasificacion d,2002-07-01,19,15,19,15,34
20103,MECAPACA,estado nutricional en menores de 5 anos,clasificacion d,2002-07-01,9,22,9,22,31
71003,MINEROS,estado nutricional en menores de 5 anos,clasificacion d,2002-07-01,87,59,87,59,146
31301,MIZQUE,estado nutricional en menores de 5 anos,clasificacion d,2002-07-01,29,38,29,38,67
20402,MOCOMOCO,estado nutricional en menores de 5 anos,clasificacion d,2002-07-01,41,34,41,34,75
51002,MOJINETE,estado nutricional en menores de 5 anos,clasificacion d,2002-07-01,0,10,0,10,10
10303,MOJOCOYA,estado nutricional en menores de 5 anos,clasificacion d,2002-07-01,77,113,77,113,190
10501,MONTEAGUDO,estado nutricional en menores de 5 anos,clasificacion d,2002-07-01,152,286,152,286,438
71001,MONTERO,estado nutricional en menores de 5 anos,clasificacion d,2002-07-01,150,211,150,211,361
70803,MORO MORO,estado nutricional en menores de 5 anos,clasificacion d,2002-07-01,9,14,9,14,23
30302,MOROCHATA,estado nutricional en menores de 5 anos,clasificacion d,2002-07-01,70,86,70,86,156
90401,NACEBE (SANTA ROSA DEL ABUNA),estado nutricional en menores de 5 anos,clasificacion d,2002-07-01,2,0,2,0,2
20307,NAZACARA DE PACAJES,estado nutricional en menores de 5 anos,clasificacion d,2002-07-01,6,1,6,1,7
90501,NUEVO MANOA (NUEVA ESPERANZA),estado nutricional en menores de 5 anos,clasificacion d,2002-07-01,3,5,3,5,8
50404,OCURI,estado nutricional en menores de 5 anos,clasificacion d,2002-07-01,87,55,87,55,142
70202,OKINAWA,estado nutricional en menores de 5 anos,clasificacion d,2002-07-01,7,45,7,45,52
30203,OMEREQUE,estado nutricional en menores de 5 anos,clasificacion d,2002-07-01,1,7,1,7,8
40101,ORURO,estado nutricional en menores de 5 anos,clasificacion d,2002-07-01,436,377,436,377,813
60201,PADCAYA,estado nutricional en menores de 5 anos,clasificacion d,2002-07-01,42,47,42,47,89
10401,PADILLA,estado nutricional en menores de 5 anos,clasificacion d,2002-07-01,120,234,120,234,354
70502,PAILON,estado nutricional en menores de 5 anos,clasificacion d,2002-07-01,33,18,33,18,51
20102,PALCA,estado nutricional en menores de 5 anos,clasificacion d,2002-07-01,33,34,33,34,67
21104,PALOS BLANCOS,estado nutricional en menores de 5 anos,clasificacion d,2002-07-01,58,95,58,95,153
40802,PAMPA AULLAGAS,estado nutricional en menores de 5 anos,clasificacion d,2002-07-01,17,16,17,16,33
70902,PAMPA GRANDE,estado nutricional en menores de 5 anos,clasificacion d,2002-07-01,11,7,11,7,18
21802,PAPEL PAMPA,estado nutricional en menores de 5 anos,clasificacion d,2002-07-01,4,11,4,11,15
30202,PASORAPA,estado nutricional en menores de 5 anos,clasificacion d,2002-07-01,12,23,12,23,35
21305,PATACAMAYA,estado nutricional en menores de 5 anos,clasificacion d,2002-07-01,37,22,37,22,59
40602,PAZÃ‘A,estado nutricional en menores de 5 anos,clasificacion d,2002-07-01,17,18,17,18,35
20702,PELECHUCO,estado nutricional en menores de 5 anos,clasificacion d,2002-07-01,14,32,14,32,46
50403,POCOATA,estado nutricional en menores de 5 anos,clasificacion d,2002-07-01,146,151,146,151,297
31203,POCONA,estado nutricional en menores de 5 anos,clasificacion d,2002-07-01,36,38,36,38,74
31202,POJO (CBBA),estado nutricional en menores de 5 anos,clasificacion d,2002-07-01,86,112,86,112,198
40601,POOPO,estado nutricional en menores de 5 anos,clasificacion d,2002-07-01,3,11,3,11,14
51203,PORCO,estado nutricional en menores de 5 anos,clasificacion d,2002-07-01,19,11,19,11,30
10103,POROMA,estado nutricional en menores de 5 anos,clasificacion d,2002-07-01,98,111,98,111,209
70103,PORONGO,estado nutricional en menores de 5 anos,clasificacion d,2002-07-01,13,12,13,12,25
70601,PORTACHUELO,estado nutricional en menores de 5 anos,clasificacion d,2002-07-01,25,24,25,24,49
90102,PORVENIR,estado nutricional en menores de 5 anos,clasificacion d,2002-07-01,0,3,0,3,3
70804,POSTRER VALLE,estado nutricional en menores de 5 anos,clasificacion d,2002-07-01,3,7,3,7,10
50101,POTOSI,estado nutricional en menores de 5 anos,clasificacion d,2002-07-01,552,430,552,430,982
10302,PRESTO,estado nutricional en menores de 5 anos,clasificacion d,2002-07-01,65,80,65,80,145
70805,PUCARA,estado nutricional en menores de 5 anos,clasificacion d,2002-07-01,0,3,0,3,3
21201,PUCARANI,estado nutricional en menores de 5 anos,clasificacion d,2002-07-01,9,53,9,53,62
20401,PUERTO ACOSTA,estado nutricional en menores de 5 anos,clasificacion d,2002-07-01,101,87,101,87,188
20403,PUERTO CARABUCO,estado nutricional en menores de 5 anos,clasificacion d,2002-07-01,42,69,42,69,111
90301,PUERTO GONZALO MORENO,estado nutricional en menores de 5 anos,clasificacion d,2002-07-01,17,12,17,12,29
21204,PUERTO PEREZ,estado nutricional en menores de 5 anos,clasificacion d,2002-07-01,15,7,15,7,22
71402,PUERTO QUIJARRO,estado nutricional en menores de 5 anos,clasificacion d,2002-07-01,29,16,29,16,45
90201,PUERTO RICO,estado nutricional en menores de 5 anos,clasificacion d,2002-07-01,10,9,10,9,19
80703,PUERTO SILES,estado nutricional en menores de 5 anos,clasificacion d,2002-07-01,0,13,0,13,13
71401,PUERTO SUAREZ,estado nutricional en menores de 5 anos,clasificacion d,2002-07-01,27,30,27,30,57
31205,PUERTO VILLARROEL,estado nutricional en menores de 5 anos,clasificacion d,2002-07-01,137,106,137,106,243
51101,PUNA,estado nutricional en menores de 5 anos,clasificacion d,2002-07-01,117,271,117,271,388
31401,PUNATA,estado nutricional en menores de 5 anos,clasificacion d,2002-07-01,57,26,57,26,83
20604,QUIABAYA,estado nutricional en menores de 5 anos,clasificacion d,2002-07-01,8,17,8,17,25
30901,QUILLACOLLO,estado nutricional en menores de 5 anos,clasificacion d,2002-07-01,21,35,21,35,56
21002,QUIME,estado nutricional en menores de 5 anos,clasificacion d,2002-07-01,19,19,19,19,38
70904,QUIRUSILLAS,estado nutricional en menores de 5 anos,clasificacion d,2002-07-01,1,3,1,3,4
50402,RAVELO,estado nutricional en menores de 5 anos,clasificacion d,2002-07-01,123,123,123,123,246
80201,RIBERALTA,estado nutricional en menores de 5 anos,clasificacion d,2002-07-01,361,216,361,216,577
70503,ROBORE,estado nutricional en menores de 5 anos,clasificacion d,2002-07-01,33,30,33,30,63
80304,RURRENABAQUE,estado nutricional en menores de 5 anos,clasificacion d,2002-07-01,24,17,24,17,41
40901,SABAYA,estado nutricional en menores de 5 anos,clasificacion d,2002-07-01,3,3,3,3,6
31001,SACABA,estado nutricional en menores de 5 anos,clasificacion d,2002-07-01,63,168,63,168,231
30404,SACABAMBA,estado nutricional en menores de 5 anos,clasificacion d,2002-07-01,0,72,0,72,72
50701,SACACA,estado nutricional en menores de 5 anos,clasificacion d,2002-07-01,143,224,143,224,367
71302,SAIPINA,estado nutricional en menores de 5 anos,clasificacion d,2002-07-01,8,7,8,7,15
40801,SALINAS DE GARCI MENDOZA,estado nutricional en menores de 5 anos,clasificacion d,2002-07-01,11,23,11,23,34
70901,SAMAIPATA,estado nutricional en menores de 5 anos,clasificacion d,2002-07-01,18,18,18,18,36
51601,SAN AGUSTIN,estado nutricional en menores de 5 anos,clasificacion d,2002-07-01,4,18,4,18,22
80602,SAN ANDRES,estado nutricional en menores de 5 anos,clasificacion d,2002-07-01,22,27,22,27,49
51003,SAN ANTONIO DE ESMORUCO,estado nutricional en menores de 5 anos,clasificacion d,2002-07-01,1,14,1,14,15
71105,SAN ANTONIO DE LOMERIO,estado nutricional en menores de 5 anos,clasificacion d,2002-07-01,91,109,91,109,200
31403,SAN BENITO,estado nutricional en menores de 5 anos,clasificacion d,2002-07-01,24,16,24,16,40
80302,SAN BORJA,estado nutricional en menores de 5 anos,clasificacion d,2002-07-01,75,51,75,51,126
21502,SAN BUENA VENTURA,estado nutricional en menores de 5 anos,clasificacion d,2002-07-01,32,53,32,53,85
80501,SAN IGNACIO,estado nutricional en menores de 5 anos,clasificacion d,2002-07-01,62,76,62,76,138
70301,SAN IGNACIO DE VELASCO,estado nutricional en menores de 5 anos,clasificacion d,2002-07-01,174,112,174,112,286
80102,SAN JAVIER(BNI),estado nutricional en menores de 5 anos,clasificacion d,2002-07-01,22,27,22,27,49
71102,SAN JAVIER(STC),estado nutricional en menores de 5 anos,clasificacion d,2002-07-01,43,51,43,51,94
80701,SAN JOAQUIN,estado nutricional en menores de 5 anos,clasificacion d,2002-07-01,12,14,12,14,26
70501,SAN JOSE DE CHIQUITOS,estado nutricional en menores de 5 anos,clasificacion d,2002-07-01,40,18,40,18,58
71104,SAN JULIAN,estado nutricional en menores de 5 anos,clasificacion d,2002-07-01,129,187,129,187,316
90302,SAN LORENZO(PND),estado nutricional en menores de 5 anos,clasificacion d,2002-07-01,6,33,6,33,39
60501,SAN LORENZO(TJA),estado nutricional en menores de 5 anos,clasificacion d,2002-07-01,66,82,66,82,148
10702,SAN LUCAS,estado nutricional en menores de 5 anos,clasificacion d,2002-07-01,289,346,289,346,635
71201,SAN MATIAS,estado nutricional en menores de 5 anos,clasificacion d,2002-07-01,0,6,0,6,6
70302,SAN MIGUEL DE VELASCO,estado nutricional en menores de 5 anos,clasificacion d,2002-07-01,61,125,61,125,186
51001,SAN PABLO DE LIPEZ,estado nutricional en menores de 5 anos,clasificacion d,2002-07-01,0,16,0,16,16
50501,SAN PEDRO DE BUENA VISTA,estado nutricional en menores de 5 anos,clasificacion d,2002-07-01,14,199,14,199,213
21801,SAN PEDRO DE CURAHUARA,estado nutricional en menores de 5 anos,clasificacion d,2002-07-01,9,18,9,18,27
50902,SAN PEDRO DE QUEMES,estado nutricional en menores de 5 anos,clasificacion d,2002-07-01,2,4,2,4,6
21702,SAN PEDRO DE TIQUINA,estado nutricional en menores de 5 anos,clasificacion d,2002-07-01,2,7,2,7,9
70303,SAN RAFAEL,estado nutricional en menores de 5 anos,clasificacion d,2002-07-01,35,31,35,31,66
80702,SAN RAMON,estado nutricional en menores de 5 anos,clasificacion d,2002-07-01,14,6,14,6,20
80401,SANTA ANA,estado nutricional en menores de 5 anos,clasificacion d,2002-07-01,30,37,30,37,67
70101,SANTA CRUZ DE LA SIERRA,estado nutricional en menores de 5 anos,clasificacion d,2002-07-01,497,251,497,251,748
80303,SANTA ROSA,estado nutricional en menores de 5 anos,clasificacion d,2002-07-01,16,7,16,7,23
70602,SANTA ROSA DEL SARA,estado nutricional en menores de 5 anos,clasificacion d,2002-07-01,10,22,10,22,32
41401,SANTIAGO DE HUARI,estado nutricional en menores de 5 anos,clasificacion d,2002-07-01,3,20,3,20,23
21901,SANTIAGO DE MACHACA,estado nutricional en menores de 5 anos,clasificacion d,2002-07-01,8,10,8,10,18
30702,SANTIVAÃ‘ES,estado nutricional en menores de 5 anos,clasificacion d,2002-07-01,28,10,28,10,38
40202,SANTUARIO DE QUILLACAS,estado nutricional en menores de 5 anos,clasificacion d,2002-07-01,5,18,5,18,23
20902,SAPAHAQUI,estado nutricional en menores de 5 anos,clasificacion d,2002-07-01,0,15,0,15,15
21301,SICA SICA (VILLA AROMA),estado nutricional en menores de 5 anos,clasificacion d,2002-07-01,31,19,31,19,50
30703,SICAYA,estado nutricional en menores de 5 anos,clasificacion d,2002-07-01,21,7,21,7,28
30902,SIPE SIPE,estado nutricional en menores de 5 anos,clasificacion d,2002-07-01,101,85,101,85,186
10403,SOPACHUY,estado nutricional en menores de 5 anos,clasificacion d,2002-07-01,48,59,48,59,107
20601,SORATA,estado nutricional en menores de 5 anos,clasificacion d,2002-07-01,40,62,40,62,102
10101,SUCRE,estado nutricional en menores de 5 anos,clasificacion d,2002-07-01,640,585,640,585,1225
31404,TACACHI,estado nutricional en menores de 5 anos,clasificacion d,2002-07-01,3,1,3,1,4
20603,TACACOMA,estado nutricional en menores de 5 anos,clasificacion d,2002-07-01,13,34,13,34,47
50303,TACOBAMBA,estado nutricional en menores de 5 anos,clasificacion d,2002-07-01,40,33,40,33,73
30602,TACOPAYA,estado nutricional en menores de 5 anos,clasificacion d,2002-07-01,20,38,20,38,58
51402,TAHUA,estado nutricional en menores de 5 anos,clasificacion d,2002-07-01,5,4,5,4,9
31101,TAPACARI,estado nutricional en menores de 5 anos,clasificacion d,2002-07-01,1,77,1,77,78
10601,TARABUCO,estado nutricional en menores de 5 anos,clasificacion d,2002-07-01,275,463,275,463,738
30401,TARATA,estado nutricional en menores de 5 anos,clasificacion d,2002-07-01,13,12,13,12,25
60101,TARIJA,estado nutricional en menores de 5 anos,clasificacion d,2002-07-01,195,143,195,143,338
10202,TARVITA,estado nutricional en menores de 5 anos,clasificacion d,2002-07-01,103,104,103,104,207
20803,TIAWANACU,estado nutricional en menores de 5 anos,clasificacion d,2002-07-01,30,18,30,18,48
50102,TINGUIPAYA,estado nutricional en menores de 5 anos,clasificacion d,2002-07-01,1,107,1,107,108
20606,TIPUANI,estado nutricional en menores de 5 anos,clasificacion d,2002-07-01,17,10,17,10,27
30903,TIQUIPAYA,estado nutricional en menores de 5 anos,clasificacion d,2002-07-01,40,53,40,53,93
31601,TIRAQUE (CBBA),estado nutricional en menores de 5 anos,clasificacion d,2002-07-01,30,184,30,184,214
21703,TITO YUPANQUI (PARQUIPUJIO),estado nutricional en menores de 5 anos,clasificacion d,2002-07-01,0,19,0,19,19
30802,TOCO,estado nutricional en menores de 5 anos,clasificacion d,2002-07-01,2,16,2,16,18
41502,TODOS SANTOS,estado nutricional en menores de 5 anos,clasificacion d,2002-07-01,0,1,0,1,1
30803,TOLATA,estado nutricional en menores de 5 anos,clasificacion d,2002-07-01,9,6,9,6,15
41001,TOLEDO,estado nutricional en menores de 5 anos,clasificacion d,2002-07-01,7,3,7,3,10
51202,TOMAVE,estado nutricional en menores de 5 anos,clasificacion d,2002-07-01,43,94,43,94,137
10402,TOMINA,estado nutricional en menores de 5 anos,clasificacion d,2002-07-01,104,197,104,197,301
50502,TORO TORO,estado nutricional en menores de 5 anos,clasificacion d,2002-07-01,17,45,17,45,62
31201,TOTORA(CBBA),estado nutricional en menores de 5 anos,clasificacion d,2002-07-01,73,63,73,63,136
41301,TOTORA(ORR),estado nutricional en menores de 5 anos,clasificacion d,2002-07-01,6,9,6,9,15
70802,TRIGAL,estado nutricional en menores de 5 anos,clasificacion d,2002-07-01,2,6,2,6,8
80101,TRINIDAD,estado nutricional en menores de 5 anos,clasificacion d,2002-07-01,170,205,170,205,375
50801,TUPIZA,estado nutricional en menores de 5 anos,clasificacion d,2002-07-01,12,387,12,387,399
40402,TURCO,estado nutricional en menores de 5 anos,clasificacion d,2002-07-01,10,8,10,8,18
21302,UMALA,estado nutricional en menores de 5 anos,clasificacion d,2002-07-01,6,22,6,22,28
50201,UNCIA,estado nutricional en menores de 5 anos,clasificacion d,2002-07-01,5,53,5,53,58
60401,URIONDO (A. CONCEPCION),estado nutricional en menores de 5 anos,clasificacion d,2002-07-01,30,25,30,25,55
71502,URUBICHA,estado nutricional en menores de 5 anos,clasificacion d,2002-07-01,0,8,0,8,8
51201,UYUNI,estado nutricional en menores de 5 anos,clasificacion d,2002-07-01,35,124,35,124,159
30502,VACAS,estado nutricional en menores de 5 anos,clasificacion d,2002-07-01,1,42,1,42,43
70801,VALLEGRANDE,estado nutricional en menores de 5 anos,clasificacion d,2002-07-01,16,65,16,65,81
20801,VIACHA,estado nutricional en menores de 5 anos,clasificacion d,2002-07-01,40,98,40,98,138
31302,VILA VILA,estado nutricional en menores de 5 anos,clasificacion d,2002-07-01,11,20,11,20,31
60303,VILLA MONTES,estado nutricional en menores de 5 anos,clasificacion d,2002-07-01,33,56,33,56,89
31402,VILLA RIVERO,estado nutricional en menores de 5 anos,clasificacion d,2002-07-01,17,15,17,15,32
10801,VILLA SERRANO,estado nutricional en menores de 5 anos,clasificacion d,2002-07-01,132,289,132,289,421
31003,VILLA TUNARI,estado nutricional en menores de 5 anos,clasificacion d,2002-07-01,139,118,139,118,257
11001,VILLA VACA GUZMAN (MUYUPAMPA),estado nutricional en menores de 5 anos,clasificacion d,2002-07-01,67,100,67,100,167
51501,VILLAZON,estado nutricional en menores de 5 anos,clasificacion d,2002-07-01,41,162,41,162,203
30904,VINTO,estado nutricional en menores de 5 anos,clasificacion d,2002-07-01,22,18,22,18,40
50602,VITICHI,estado nutricional en menores de 5 anos,clasificacion d,2002-07-01,14,78,14,78,92
20306,WALDO BALLIVIAN,estado nutricional en menores de 5 anos,clasificacion d,2002-07-01,9,3,9,3,12
70201,WARNES,estado nutricional en menores de 5 anos,clasificacion d,2002-07-01,103,75,103,75,178
20903,YACO,estado nutricional en menores de 5 anos,clasificacion d,2002-07-01,0,14,0,14,14
60301,YACUIBA,estado nutricional en menores de 5 anos,clasificacion d,2002-07-01,72,37,72,37,109
10602,YAMPARAEZ,estado nutricional en menores de 5 anos,clasificacion d,2002-07-01,147,248,147,248,395
21103,YANACACHI,estado nutricional en menores de 5 anos,clasificacion d,2002-07-01,3,7,3,7,10
50103,YOCALLA,estado nutricional en menores de 5 anos,clasificacion d,2002-07-01,2,57,2,57,59
10102,YOTALA,estado nutricional en menores de 5 anos,clasificacion d,2002-07-01,114,204,114,204,318
60402,YUNCHARA,estado nutricional en menores de 5 anos,clasificacion d,2002-07-01,7,18,7,18,25
10301,ZUDAÃ‘EZ,estado nutricional en menores de 5 anos,clasificacion d,2002-07-01,70,115,70,115,185
51302,ACACIO,estado nutricional en menores de 5 anos,clasificacion d,2002-08-01,38,97,38,97,135
20201,ACHACACHI,estado nutricional en menores de 5 anos,clasificacion d,2002-08-01,134,104,134,104,238
20104,ACHOCALLA,estado nutricional en menores de 5 anos,clasificacion d,2002-08-01,21,29,21,29,50
30201,AIQUILE,estado nutricional en menores de 5 anos,clasificacion d,2002-08-01,25,77,25,77,102
31303,ALALAY,estado nutricional en menores de 5 anos,clasificacion d,2002-08-01,12,10,12,10,22
10404,ALCALA,estado nutricional en menores de 5 anos,clasificacion d,2002-08-01,30,65,30,65,95
20202,ANCORAIMES,estado nutricional en menores de 5 anos,clasificacion d,2002-08-01,78,121,78,121,199
41201,ANDAMARCA,estado nutricional en menores de 5 anos,clasificacion d,2002-08-01,4,2,4,2,6
30402,ANZALDO,estado nutricional en menores de 5 anos,clasificacion d,2002-08-01,3,69,3,69,72
20701,APOLO,estado nutricional en menores de 5 anos,clasificacion d,2002-08-01,13,38,13,38,51
51301,ARAMPAMPA,estado nutricional en menores de 5 anos,clasificacion d,2002-08-01,36,41,36,41,77
30403,ARBIETO,estado nutricional en menores de 5 anos,clasificacion d,2002-08-01,7,12,7,12,19
30601,ARQUE,estado nutricional en menores de 5 anos,clasificacion d,2002-08-01,42,57,42,57,99
71501,ASCENCION DE GUARAYOS,estado nutricional en menores de 5 anos,clasificacion d,2002-08-01,170,240,170,240,410
50802,ATOCHA,estado nutricional en menores de 5 anos,clasificacion d,2002-08-01,0,14,0,14,14
20503,AUCAPATA,estado nutricional en menores de 5 anos,clasificacion d,2002-08-01,38,8,38,8,46
20502,AYATA,estado nutricional en menores de 5 anos,clasificacion d,2002-08-01,36,30,36,30,66
21303,AYO AYO,estado nutricional en menores de 5 anos,clasificacion d,2002-08-01,15,12,15,12,27
30301,AYOPAYA (V. DE INDEPENDENCIA),estado nutricional en menores de 5 anos,clasificacion d,2002-08-01,117,170,117,170,287
10201,AZURDUY,estado nutricional en menores de 5 anos,clasificacion d,2002-08-01,140,166,140,166,306
21203,BATALLAS,estado nutricional en menores de 5 anos,clasificacion d,2002-08-01,23,38,23,38,61
80802,BAURES,estado nutricional en menores de 5 anos,clasificacion d,2002-08-01,15,28,15,28,43
41202,BELEN DE ANDAMARCA,estado nutricional en menores de 5 anos,clasificacion d,2002-08-01,1,2,1,2,3
50104,BELEN DE URMIRI,estado nutricional en menores de 5 anos,clasificacion d,2002-08-01,2,10,2,10,12
90104,BELLA FLOR,estado nutricional en menores de 5 anos,clasificacion d,2002-08-01,3,0,3,0,3
60202,BERMEJO,estado nutricional en menores de 5 anos,clasificacion d,2002-08-01,1,12,1,12,13
50301,BETANZOS,estado nutricional en menores de 5 anos,clasificacion d,2002-08-01,147,206,147,206,353
31501,BOLIVAR,estado nutricional en menores de 5 anos,clasificacion d,2002-08-01,32,72,32,72,104
90103,BOLPEBRA,estado nutricional en menores de 5 anos,clasificacion d,2002-08-01,3,64,3,64,67
70707,BOYUIBE,estado nutricional en menores de 5 anos,clasificacion d,2002-08-01,0,23,0,23,23
70703,CABEZAS,estado nutricional en menores de 5 anos,clasificacion d,2002-08-01,37,27,37,27,64
20905,CAIROMA,estado nutricional en menores de 5 anos,clasificacion d,2002-08-01,50,31,50,31,81
51102,"CAIZA ""D""",estado nutricional en menores de 5 anos,clasificacion d,2002-08-01,94,83,94,83,177
21003,CAJUATA,estado nutricional en menores de 5 anos,clasificacion d,2002-08-01,29,30,29,30,59
20303,CALACOTO,estado nutricional en menores de 5 anos,clasificacion d,2002-08-01,16,22,16,22,38
21304,CALAMARCA,estado nutricional en menores de 5 anos,clasificacion d,2002-08-01,64,60,64,60,124
10701,CAMARGO,estado nutricional en menores de 5 anos,clasificacion d,2002-08-01,26,125,26,125,151
10901,CAMATAQUI (C. VILLA ABECIA),estado nutricional en menores de 5 anos,clasificacion d,2002-08-01,35,36,35,36,71
70706,CAMIRI,estado nutricional en menores de 5 anos,clasificacion d,2002-08-01,65,65,65,65,130
30701,CAPINOTA,estado nutricional en menores de 5 anos,clasificacion d,2002-08-01,25,63,25,63,88
20302,CAQUIAVIRI,estado nutricional en menores de 5 anos,clasificacion d,2002-08-01,26,31,26,31,57
40102,CARACOLLO,estado nutricional en menores de 5 anos,clasificacion d,2002-08-01,29,56,29,56,85
22001,CARANAVI,estado nutricional en menores de 5 anos,clasificacion d,2002-08-01,160,215,160,215,375
41503,CARANGAS,estado nutricional en menores de 5 anos,clasificacion d,2002-08-01,1,2,1,2,3
60302,CARAPARI,estado nutricional en menores de 5 anos,clasificacion d,2002-08-01,18,57,18,57,75
50702,CARIPUYO,estado nutricional en menores de 5 anos,clasificacion d,2002-08-01,60,118,60,118,178
21902,CATACORA,estado nutricional en menores de 5 anos,clasificacion d,2002-08-01,7,7,7,7,14
40201,CHALLAPATA,estado nutricional en menores de 5 anos,clasificacion d,2002-08-01,59,94,59,94,153
50302,CHAQUI,estado nutricional en menores de 5 anos,clasificacion d,2002-08-01,50,61,50,61,111
70702,CHARAGUA,estado nutricional en menores de 5 anos,clasificacion d,2002-08-01,35,172,35,172,207
20305,CHARAÃ‘A,estado nutricional en menores de 5 anos,clasificacion d,2002-08-01,9,11,9,11,20
31204,CHIMORE,estado nutricional en menores de 5 anos,clasificacion d,2002-08-01,7,10,7,10,17
40302,CHOQUE COTA,estado nutricional en menores de 5 anos,clasificacion d,2002-08-01,5,0,5,0,5
21101,CHULUMANI (V. DE LA LIBERTAD),estado nutricional en menores de 5 anos,clasificacion d,2002-08-01,7,19,7,19,26
20501,CHUMA,estado nutricional en menores de 5 anos,clasificacion d,2002-08-01,33,30,33,30,63
30801,CLIZA,estado nutricional en menores de 5 anos,clasificacion d,2002-08-01,7,13,7,13,20
90101,COBIJA,estado nutricional en menores de 5 anos,clasificacion d,2002-08-01,89,76,89,76,165
30101,COCHABAMBA,estado nutricional en menores de 5 anos,clasificacion d,2002-08-01,334,329,334,329,663
40902,COIPASA,estado nutricional en menores de 5 anos,clasificacion d,2002-08-01,0,2,0,2,2
30905,COLCAPIRHUA,estado nutricional en menores de 5 anos,clasificacion d,2002-08-01,69,32,69,32,101
50901,"COLCHA ""K""",estado nutricional en menores de 5 anos,clasificacion d,2002-08-01,46,49,46,49,95
21307,COLLANA,estado nutricional en menores de 5 anos,clasificacion d,2002-08-01,5,1,5,1,6
31002,COLOMI,estado nutricional en menores de 5 anos,clasificacion d,2002-08-01,9,81,9,81,90
50401,COLQUECHACA,estado nutricional en menores de 5 anos,clasificacion d,2002-08-01,133,108,133,108,241
21306,COLQUENCHA,estado nutricional en menores de 5 anos,clasificacion d,2002-08-01,28,28,28,28,56
21004,COLQUIRI,estado nutricional en menores de 5 anos,clasificacion d,2002-08-01,119,103,119,103,222
20304,COMANCHE,estado nutricional en menores de 5 anos,clasificacion d,2002-08-01,14,21,14,21,35
71301,COMARAPA,estado nutricional en menores de 5 anos,clasificacion d,2002-08-01,54,61,54,61,115
20605,COMBAYA,estado nutricional en menores de 5 anos,clasificacion d,2002-08-01,11,16,11,16,27
71101,CONCEPCION,estado nutricional en menores de 5 anos,clasificacion d,2002-08-01,8,0,8,0,8
21701,COPACABANA,estado nutricional en menores de 5 anos,clasificacion d,2002-08-01,19,13,19,13,32
21402,CORIPATA,estado nutricional en menores de 5 anos,clasificacion d,2002-08-01,10,8,10,8,18
20301,CORO CORO,estado nutricional en menores de 5 anos,clasificacion d,2002-08-01,46,39,46,39,85
21401,COROICO,estado nutricional en menores de 5 anos,clasificacion d,2002-08-01,13,10,13,10,23
40301,CORQUE,estado nutricional en menores de 5 anos,clasificacion d,2002-08-01,21,4,21,4,25
50601,COTAGAITA,estado nutricional en menores de 5 anos,clasificacion d,2002-08-01,87,129,87,129,216
70102,COTOCA,estado nutricional en menores de 5 anos,clasificacion d,2002-08-01,46,19,46,19,65
70704,CUEVO,estado nutricional en menores de 5 anos,clasificacion d,2002-08-01,23,21,23,21,44
10902,CULPINA,estado nutricional en menores de 5 anos,clasificacion d,2002-08-01,179,255,179,255,434
40401,CURAHUARA DE CARANGAS,estado nutricional en menores de 5 anos,clasificacion d,2002-08-01,22,16,22,16,38
21602,CURVA,estado nutricional en menores de 5 anos,clasificacion d,2002-08-01,14,7,14,7,21
20804,DESAGUADERO,estado nutricional en menores de 5 anos,clasificacion d,2002-08-01,20,16,20,16,36
20105,EL ALTO,estado nutricional en menores de 5 anos,clasificacion d,2002-08-01,1438,1179,1438,1179,2617
40103,EL CHORO,estado nutricional en menores de 5 anos,clasificacion d,2002-08-01,4,3,4,3,7
71503,EL PUENTE(STC),estado nutricional en menores de 5 anos,clasificacion d,2002-08-01,2,89,2,89,91
60502,EL PUENTE(TJA),estado nutricional en menores de 5 anos,clasificacion d,2002-08-01,28,56,28,56,84
70105,EL TORNO,estado nutricional en menores de 5 anos,clasificacion d,2002-08-01,53,40,53,40,93
10405,EL VILLAR,estado nutricional en menores de 5 anos,clasificacion d,2002-08-01,47,138,47,138,185
60601,ENTRE RIOS,estado nutricional en menores de 5 anos,clasificacion d,2002-08-01,39,64,39,64,103
40502,ESCARA,estado nutricional en menores de 5 anos,clasificacion d,2002-08-01,0,1,0,1,1
41101,EUCALIPTUS,estado nutricional en menores de 5 anos,clasificacion d,2002-08-01,25,42,25,42,67
90503,EUREKA (SANTOS MERCADO),estado nutricional en menores de 5 anos,clasificacion d,2002-08-01,3,3,3,3,6
80402,EXALTACION,estado nutricional en menores de 5 anos,clasificacion d,2002-08-01,5,29,5,29,34
90203,FILADELFIA,estado nutricional en menores de 5 anos,clasificacion d,2002-08-01,4,4,4,4,8
71002,GENERAL SAAVEDRA,estado nutricional en menores de 5 anos,clasificacion d,2002-08-01,63,64,63,64,127
21601,GRAL. J.J. PEREZ (CHARAZANI),estado nutricional en menores de 5 anos,clasificacion d,2002-08-01,34,48,34,48,82
20602,GUANAY,estado nutricional en menores de 5 anos,clasificacion d,2002-08-01,141,139,141,139,280
20802,GUAQUI,estado nutricional en menores de 5 anos,clasificacion d,2002-08-01,15,18,15,18,33
80202,GUAYARAMERIN,estado nutricional en menores de 5 anos,clasificacion d,2002-08-01,92,145,92,145,237
70705,GUTIERREZ,estado nutricional en menores de 5 anos,clasificacion d,2002-08-01,106,153,106,153,259
10502,HUACARETA,estado nutricional en menores de 5 anos,clasificacion d,2002-08-01,54,114,54,114,168
11002,HUACAYA (VILLA DE HUACAYA),estado nutricional en menores de 5 anos,clasificacion d,2002-08-01,13,31,13,31,44
40501,HUACHACALLA,estado nutricional en menores de 5 anos,clasificacion d,2002-08-01,3,2,3,2,5
40701,HUANUNI,estado nutricional en menores de 5 anos,clasificacion d,2002-08-01,82,37,82,37,119
80803,HUARACAJE,estado nutricional en menores de 5 anos,clasificacion d,2002-08-01,2,1,2,1,3
41601,HUAYLLAMARCA,estado nutricional en menores de 5 anos,clasificacion d,2002-08-01,30,14,30,14,44
21005,ICHOCA,estado nutricional en menores de 5 anos,clasificacion d,2002-08-01,27,36,27,36,63
10304,ICLA,estado nutricional en menores de 5 anos,clasificacion d,2002-08-01,138,219,138,219,357
10703,INCAHUASI,estado nutricional en menores de 5 anos,clasificacion d,2002-08-01,110,164,110,164,274
21001,INQUISIVI,estado nutricional en menores de 5 anos,clasificacion d,2002-08-01,54,116,54,116,170
21102,IRUPANA (VILLA DE LANZA),estado nutricional en menores de 5 anos,clasificacion d,2002-08-01,9,40,9,40,49
21501,IXIAMAS,estado nutricional en menores de 5 anos,clasificacion d,2002-08-01,30,30,30,30,60
21105,LA ASUNTA,estado nutricional en menores de 5 anos,clasificacion d,2002-08-01,21,45,21,45,66
70104,LA GUARDIA,estado nutricional en menores de 5 anos,clasificacion d,2002-08-01,58,45,58,45,103
20101,LA PAZ,estado nutricional en menores de 5 anos,clasificacion d,2002-08-01,989,852,989,852,1841
70701,LAGUNILLAS,estado nutricional en menores de 5 anos,clasificacion d,2002-08-01,25,33,25,33,58
21202,LAJA,estado nutricional en menores de 5 anos,clasificacion d,2002-08-01,19,12,19,12,31
10903,LAS CARRERAS,estado nutricional en menores de 5 anos,clasificacion d,2002-08-01,33,53,33,53,86
21006,LICOMA PAMPA,estado nutricional en menores de 5 anos,clasificacion d,2002-08-01,15,14,15,14,29
50203,LLALLAGUA,estado nutricional en menores de 5 anos,clasificacion d,2002-08-01,0,5,0,5,5
51401,LLICA,estado nutricional en menores de 5 anos,clasificacion d,2002-08-01,14,9,14,9,23
80601,LORETO,estado nutricional en menores de 5 anos,clasificacion d,2002-08-01,1,10,1,10,11
20901,LURIBAY,estado nutricional en menores de 5 anos,clasificacion d,2002-08-01,30,23,30,23,53
40702,MACHACAMARCA,estado nutricional en menores de 5 anos,clasificacion d,2002-08-01,7,20,7,20,27
11003,MACHARETI,estado nutricional en menores de 5 anos,clasificacion d,2002-08-01,61,98,61,98,159
80801,MAGDALENA,estado nutricional en menores de 5 anos,clasificacion d,2002-08-01,14,40,14,40,54
70903,MAIRANA,estado nutricional en menores de 5 anos,clasificacion d,2002-08-01,19,15,19,15,34
20103,MECAPACA,estado nutricional en menores de 5 anos,clasificacion d,2002-08-01,13,18,13,18,31
71003,MINEROS,estado nutricional en menores de 5 anos,clasificacion d,2002-08-01,36,37,36,37,73
31301,MIZQUE,estado nutricional en menores de 5 anos,clasificacion d,2002-08-01,34,24,34,24,58
20402,MOCOMOCO,estado nutricional en menores de 5 anos,clasificacion d,2002-08-01,106,102,106,102,208
10303,MOJOCOYA,estado nutricional en menores de 5 anos,clasificacion d,2002-08-01,87,112,87,112,199
10501,MONTEAGUDO,estado nutricional en menores de 5 anos,clasificacion d,2002-08-01,112,180,112,180,292
71001,MONTERO,estado nutricional en menores de 5 anos,clasificacion d,2002-08-01,126,112,126,112,238
70803,MORO MORO,estado nutricional en menores de 5 anos,clasificacion d,2002-08-01,7,13,7,13,20
30302,MOROCHATA,estado nutricional en menores de 5 anos,clasificacion d,2002-08-01,65,75,65,75,140
90401,NACEBE (SANTA ROSA DEL ABUNA),estado nutricional en menores de 5 anos,clasificacion d,2002-08-01,5,12,5,12,17
20307,NAZACARA DE PACAJES,estado nutricional en menores de 5 anos,clasificacion d,2002-08-01,5,1,5,1,6
90501,NUEVO MANOA (NUEVA ESPERANZA),estado nutricional en menores de 5 anos,clasificacion d,2002-08-01,0,2,0,2,2
50404,OCURI,estado nutricional en menores de 5 anos,clasificacion d,2002-08-01,82,114,82,114,196
70202,OKINAWA,estado nutricional en menores de 5 anos,clasificacion d,2002-08-01,9,25,9,25,34
30203,OMEREQUE,estado nutricional en menores de 5 anos,clasificacion d,2002-08-01,1,33,1,33,34
40101,ORURO,estado nutricional en menores de 5 anos,clasificacion d,2002-08-01,488,346,488,346,834
60201,PADCAYA,estado nutricional en menores de 5 anos,clasificacion d,2002-08-01,25,53,25,53,78
10401,PADILLA,estado nutricional en menores de 5 anos,clasificacion d,2002-08-01,150,264,150,264,414
70502,PAILON,estado nutricional en menores de 5 anos,clasificacion d,2002-08-01,34,36,34,36,70
20102,PALCA,estado nutricional en menores de 5 anos,clasificacion d,2002-08-01,36,34,36,34,70
21104,PALOS BLANCOS,estado nutricional en menores de 5 anos,clasificacion d,2002-08-01,55,166,55,166,221
40802,PAMPA AULLAGAS,estado nutricional en menores de 5 anos,clasificacion d,2002-08-01,14,25,14,25,39
70902,PAMPA GRANDE,estado nutricional en menores de 5 anos,clasificacion d,2002-08-01,12,18,12,18,30
21802,PAPEL PAMPA,estado nutricional en menores de 5 anos,clasificacion d,2002-08-01,6,10,6,10,16
30202,PASORAPA,estado nutricional en menores de 5 anos,clasificacion d,2002-08-01,29,31,29,31,60
21305,PATACAMAYA,estado nutricional en menores de 5 anos,clasificacion d,2002-08-01,29,29,29,29,58
40602,PAZÃ‘A,estado nutricional en menores de 5 anos,clasificacion d,2002-08-01,16,11,16,11,27
20702,PELECHUCO,estado nutricional en menores de 5 anos,clasificacion d,2002-08-01,24,23,24,23,47
50403,POCOATA,estado nutricional en menores de 5 anos,clasificacion d,2002-08-01,138,133,138,133,271
31203,POCONA,estado nutricional en menores de 5 anos,clasificacion d,2002-08-01,43,59,43,59,102
31202,POJO (CBBA),estado nutricional en menores de 5 anos,clasificacion d,2002-08-01,180,155,180,155,335
40601,POOPO,estado nutricional en menores de 5 anos,clasificacion d,2002-08-01,14,24,14,24,38
51203,PORCO,estado nutricional en menores de 5 anos,clasificacion d,2002-08-01,16,16,16,16,32
10103,POROMA,estado nutricional en menores de 5 anos,clasificacion d,2002-08-01,113,132,113,132,245
70103,PORONGO,estado nutricional en menores de 5 anos,clasificacion d,2002-08-01,21,20,21,20,41
70601,PORTACHUELO,estado nutricional en menores de 5 anos,clasificacion d,2002-08-01,42,34,42,34,76
90102,PORVENIR,estado nutricional en menores de 5 anos,clasificacion d,2002-08-01,7,5,7,5,12
70804,POSTRER VALLE,estado nutricional en menores de 5 anos,clasificacion d,2002-08-01,1,7,1,7,8
50101,POTOSI,estado nutricional en menores de 5 anos,clasificacion d,2002-08-01,515,438,515,438,953
10302,PRESTO,estado nutricional en menores de 5 anos,clasificacion d,2002-08-01,73,70,73,70,143
70805,PUCARA,estado nutricional en menores de 5 anos,clasificacion d,2002-08-01,2,10,2,10,12
21201,PUCARANI,estado nutricional en menores de 5 anos,clasificacion d,2002-08-01,22,40,22,40,62
20401,PUERTO ACOSTA,estado nutricional en menores de 5 anos,clasificacion d,2002-08-01,85,86,85,86,171
20403,PUERTO CARABUCO,estado nutricional en menores de 5 anos,clasificacion d,2002-08-01,56,83,56,83,139
90301,PUERTO GONZALO MORENO,estado nutricional en menores de 5 anos,clasificacion d,2002-08-01,13,4,13,4,17
21204,PUERTO PEREZ,estado nutricional en menores de 5 anos,clasificacion d,2002-08-01,8,13,8,13,21
71402,PUERTO QUIJARRO,estado nutricional en menores de 5 anos,clasificacion d,2002-08-01,36,11,36,11,47
90201,PUERTO RICO,estado nutricional en menores de 5 anos,clasificacion d,2002-08-01,8,14,8,14,22
80703,PUERTO SILES,estado nutricional en menores de 5 anos,clasificacion d,2002-08-01,0,2,0,2,2
71401,PUERTO SUAREZ,estado nutricional en menores de 5 anos,clasificacion d,2002-08-01,47,25,47,25,72
31205,PUERTO VILLARROEL,estado nutricional en menores de 5 anos,clasificacion d,2002-08-01,138,83,138,83,221
51101,PUNA,estado nutricional en menores de 5 anos,clasificacion d,2002-08-01,76,108,76,108,184
20604,QUIABAYA,estado nutricional en menores de 5 anos,clasificacion d,2002-08-01,22,33,22,33,55
30901,QUILLACOLLO,estado nutricional en menores de 5 anos,clasificacion d,2002-08-01,54,44,54,44,98
21002,QUIME,estado nutricional en menores de 5 anos,clasificacion d,2002-08-01,56,48,56,48,104
70904,QUIRUSILLAS,estado nutricional en menores de 5 anos,clasificacion d,2002-08-01,2,1,2,1,3
50402,RAVELO,estado nutricional en menores de 5 anos,clasificacion d,2002-08-01,161,155,161,155,316
80301,REYES,estado nutricional en menores de 5 anos,clasificacion d,2002-08-01,30,31,30,31,61
80201,RIBERALTA,estado nutricional en menores de 5 anos,clasificacion d,2002-08-01,391,248,391,248,639
70503,ROBORE,estado nutricional en menores de 5 anos,clasificacion d,2002-08-01,16,22,16,22,38
80304,RURRENABAQUE,estado nutricional en menores de 5 anos,clasificacion d,2002-08-01,17,12,17,12,29
40901,SABAYA,estado nutricional en menores de 5 anos,clasificacion d,2002-08-01,3,1,3,1,4
31001,SACABA,estado nutricional en menores de 5 anos,clasificacion d,2002-08-01,60,48,60,48,108
30404,SACABAMBA,estado nutricional en menores de 5 anos,clasificacion d,2002-08-01,0,98,0,98,98
50701,SACACA,estado nutricional en menores de 5 anos,clasificacion d,2002-08-01,146,231,146,231,377
71302,SAIPINA,estado nutricional en menores de 5 anos,clasificacion d,2002-08-01,11,17,11,17,28
40801,SALINAS DE GARCI MENDOZA,estado nutricional en menores de 5 anos,clasificacion d,2002-08-01,14,16,14,16,30
70901,SAMAIPATA,estado nutricional en menores de 5 anos,clasificacion d,2002-08-01,37,20,37,20,57
51601,SAN AGUSTIN,estado nutricional en menores de 5 anos,clasificacion d,2002-08-01,7,3,7,3,10
80602,SAN ANDRES,estado nutricional en menores de 5 anos,clasificacion d,2002-08-01,22,31,22,31,53
71105,SAN ANTONIO DE LOMERIO,estado nutricional en menores de 5 anos,clasificacion d,2002-08-01,76,129,76,129,205
31403,SAN BENITO,estado nutricional en menores de 5 anos,clasificacion d,2002-08-01,0,5,0,5,5
80302,SAN BORJA,estado nutricional en menores de 5 anos,clasificacion d,2002-08-01,83,92,83,92,175
21502,SAN BUENA VENTURA,estado nutricional en menores de 5 anos,clasificacion d,2002-08-01,26,15,26,15,41
80501,SAN IGNACIO,estado nutricional en menores de 5 anos,clasificacion d,2002-08-01,86,132,86,132,218
70301,SAN IGNACIO DE VELASCO,estado nutricional en menores de 5 anos,clasificacion d,2002-08-01,177,126,177,126,303
80102,SAN JAVIER(BNI),estado nutricional en menores de 5 anos,clasificacion d,2002-08-01,12,30,12,30,42
71102,SAN JAVIER(STC),estado nutricional en menores de 5 anos,clasificacion d,2002-08-01,36,40,36,40,76
80701,SAN JOAQUIN,estado nutricional en menores de 5 anos,clasificacion d,2002-08-01,3,19,3,19,22
70501,SAN JOSE DE CHIQUITOS,estado nutricional en menores de 5 anos,clasificacion d,2002-08-01,36,20,36,20,56
71104,SAN JULIAN,estado nutricional en menores de 5 anos,clasificacion d,2002-08-01,157,194,157,194,351
90302,SAN LORENZO(PND),estado nutricional en menores de 5 anos,clasificacion d,2002-08-01,0,5,0,5,5
60501,SAN LORENZO(TJA),estado nutricional en menores de 5 anos,clasificacion d,2002-08-01,7,24,7,24,31
10702,SAN LUCAS,estado nutricional en menores de 5 anos,clasificacion d,2002-08-01,330,343,330,343,673
71201,SAN MATIAS,estado nutricional en menores de 5 anos,clasificacion d,2002-08-01,59,29,59,29,88
70302,SAN MIGUEL DE VELASCO,estado nutricional en menores de 5 anos,clasificacion d,2002-08-01,44,52,44,52,96
50501,SAN PEDRO DE BUENA VISTA,estado nutricional en menores de 5 anos,clasificacion d,2002-08-01,122,324,122,324,446
21801,SAN PEDRO DE CURAHUARA,estado nutricional en menores de 5 anos,clasificacion d,2002-08-01,10,12,10,12,22
50902,SAN PEDRO DE QUEMES,estado nutricional en menores de 5 anos,clasificacion d,2002-08-01,1,2,1,2,3
21702,SAN PEDRO DE TIQUINA,estado nutricional en menores de 5 anos,clasificacion d,2002-08-01,0,7,0,7,7
70303,SAN RAFAEL,estado nutricional en menores de 5 anos,clasificacion d,2002-08-01,42,42,42,42,84
80702,SAN RAMON,estado nutricional en menores de 5 anos,clasificacion d,2002-08-01,6,14,6,14,20
80401,SANTA ANA,estado nutricional en menores de 5 anos,clasificacion d,2002-08-01,19,9,19,9,28
70101,SANTA CRUZ DE LA SIERRA,estado nutricional en menores de 5 anos,clasificacion d,2002-08-01,637,402,637,402,1039
80303,SANTA ROSA,estado nutricional en menores de 5 anos,clasificacion d,2002-08-01,12,7,12,7,19
70602,SANTA ROSA DEL SARA,estado nutricional en menores de 5 anos,clasificacion d,2002-08-01,9,5,9,5,14
20308,SANTIAGO DE CALLAPA,estado nutricional en menores de 5 anos,clasificacion d,2002-08-01,19,12,19,12,31
41401,SANTIAGO DE HUARI,estado nutricional en menores de 5 anos,clasificacion d,2002-08-01,8,22,8,22,30
21901,SANTIAGO DE MACHACA,estado nutricional en menores de 5 anos,clasificacion d,2002-08-01,22,15,22,15,37
30702,SANTIVAÃ‘ES,estado nutricional en menores de 5 anos,clasificacion d,2002-08-01,18,17,18,17,35
40202,SANTUARIO DE QUILLACAS,estado nutricional en menores de 5 anos,clasificacion d,2002-08-01,4,10,4,10,14
20902,SAPAHAQUI,estado nutricional en menores de 5 anos,clasificacion d,2002-08-01,7,13,7,13,20
21301,SICA SICA (VILLA AROMA),estado nutricional en menores de 5 anos,clasificacion d,2002-08-01,38,25,38,25,63
30703,SICAYA,estado nutricional en menores de 5 anos,clasificacion d,2002-08-01,16,32,16,32,48
30902,SIPE SIPE,estado nutricional en menores de 5 anos,clasificacion d,2002-08-01,111,97,111,97,208
10403,SOPACHUY,estado nutricional en menores de 5 anos,clasificacion d,2002-08-01,49,60,49,60,109
20601,SORATA,estado nutricional en menores de 5 anos,clasificacion d,2002-08-01,35,53,35,53,88
10101,SUCRE,estado nutricional en menores de 5 anos,clasificacion d,2002-08-01,662,777,662,777,1439
20603,TACACOMA,estado nutricional en menores de 5 anos,clasificacion d,2002-08-01,20,24,20,24,44
50303,TACOBAMBA,estado nutricional en menores de 5 anos,clasificacion d,2002-08-01,60,64,60,64,124
30602,TACOPAYA,estado nutricional en menores de 5 anos,clasificacion d,2002-08-01,23,32,23,32,55
51402,TAHUA,estado nutricional en menores de 5 anos,clasificacion d,2002-08-01,7,4,7,4,11
31101,TAPACARI,estado nutricional en menores de 5 anos,clasificacion d,2002-08-01,50,163,50,163,213
10601,TARABUCO,estado nutricional en menores de 5 anos,clasificacion d,2002-08-01,261,461,261,461,722
30401,TARATA,estado nutricional en menores de 5 anos,clasificacion d,2002-08-01,35,25,35,25,60
60101,TARIJA,estado nutricional en menores de 5 anos,clasificacion d,2002-08-01,210,183,210,183,393
10202,TARVITA,estado nutricional en menores de 5 anos,clasificacion d,2002-08-01,105,167,105,167,272
20803,TIAWANACU,estado nutricional en menores de 5 anos,clasificacion d,2002-08-01,24,17,24,17,41
50102,TINGUIPAYA,estado nutricional en menores de 5 anos,clasificacion d,2002-08-01,24,89,24,89,113
20606,TIPUANI,estado nutricional en menores de 5 anos,clasificacion d,2002-08-01,9,9,9,9,18
30903,TIQUIPAYA,estado nutricional en menores de 5 anos,clasificacion d,2002-08-01,34,123,34,123,157
31601,TIRAQUE (CBBA),estado nutricional en menores de 5 anos,clasificacion d,2002-08-01,89,88,89,88,177
21703,TITO YUPANQUI (PARQUIPUJIO),estado nutricional en menores de 5 anos,clasificacion d,2002-08-01,0,18,0,18,18
30802,TOCO,estado nutricional en menores de 5 anos,clasificacion d,2002-08-01,4,13,4,13,17
41001,TOLEDO,estado nutricional en menores de 5 anos,clasificacion d,2002-08-01,6,13,6,13,19
51202,TOMAVE,estado nutricional en menores de 5 anos,clasificacion d,2002-08-01,43,78,43,78,121
10402,TOMINA,estado nutricional en menores de 5 anos,clasificacion d,2002-08-01,87,165,87,165,252
50502,TORO TORO,estado nutricional en menores de 5 anos,clasificacion d,2002-08-01,70,80,70,80,150
31201,TOTORA(CBBA),estado nutricional en menores de 5 anos,clasificacion d,2002-08-01,49,85,49,85,134
41301,TOTORA(ORR),estado nutricional en menores de 5 anos,clasificacion d,2002-08-01,22,44,22,44,66
70802,TRIGAL,estado nutricional en menores de 5 anos,clasificacion d,2002-08-01,5,7,5,7,12
80101,TRINIDAD,estado nutricional en menores de 5 anos,clasificacion d,2002-08-01,170,230,170,230,400
40402,TURCO,estado nutricional en menores de 5 anos,clasificacion d,2002-08-01,14,8,14,8,22
21302,UMALA,estado nutricional en menores de 5 anos,clasificacion d,2002-08-01,16,10,16,10,26
60401,URIONDO (A. CONCEPCION),estado nutricional en menores de 5 anos,clasificacion d,2002-08-01,19,26,19,26,45
71502,URUBICHA,estado nutricional en menores de 5 anos,clasificacion d,2002-08-01,14,145,14,145,159
51201,UYUNI,estado nutricional en menores de 5 anos,clasificacion d,2002-08-01,47,150,47,150,197
70801,VALLEGRANDE,estado nutricional en menores de 5 anos,clasificacion d,2002-08-01,61,64,61,64,125
20801,VIACHA,estado nutricional en menores de 5 anos,clasificacion d,2002-08-01,61,125,61,125,186
31302,VILA VILA,estado nutricional en menores de 5 anos,clasificacion d,2002-08-01,0,48,0,48,48
60303,VILLA MONTES,estado nutricional en menores de 5 anos,clasificacion d,2002-08-01,37,45,37,45,82
90502,VILLA NUEVA (LOMA ALTA),estado nutricional en menores de 5 anos,clasificacion d,2002-08-01,0,1,0,1,1
31402,VILLA RIVERO,estado nutricional en menores de 5 anos,clasificacion d,2002-08-01,4,1,4,1,5
10801,VILLA SERRANO,estado nutricional en menores de 5 anos,clasificacion d,2002-08-01,109,242,109,242,351
31003,VILLA TUNARI,estado nutricional en menores de 5 anos,clasificacion d,2002-08-01,137,114,137,114,251
11001,VILLA VACA GUZMAN (MUYUPAMPA),estado nutricional en menores de 5 anos,clasificacion d,2002-08-01,77,115,77,115,192
51501,VILLAZON,estado nutricional en menores de 5 anos,clasificacion d,2002-08-01,124,166,124,166,290
50602,VITICHI,estado nutricional en menores de 5 anos,clasificacion d,2002-08-01,35,157,35,157,192
20306,WALDO BALLIVIAN,estado nutricional en menores de 5 anos,clasificacion d,2002-08-01,11,5,11,5,16
70201,WARNES,estado nutricional en menores de 5 anos,clasificacion d,2002-08-01,85,100,85,100,185
20903,YACO,estado nutricional en menores de 5 anos,clasificacion d,2002-08-01,10,36,10,36,46
60301,YACUIBA,estado nutricional en menores de 5 anos,clasificacion d,2002-08-01,57,31,57,31,88
10602,YAMPARAEZ,estado nutricional en menores de 5 anos,clasificacion d,2002-08-01,159,274,159,274,433
21103,YANACACHI,estado nutricional en menores de 5 anos,clasificacion d,2002-08-01,5,3,5,3,8
70403,YAPACANI,estado nutricional en menores de 5 anos,clasificacion d,2002-08-01,1,0,1,0,1
50103,YOCALLA,estado nutricional en menores de 5 anos,clasificacion d,2002-08-01,17,59,17,59,76
10102,YOTALA,estado nutricional en menores de 5 anos,clasificacion d,2002-08-01,105,196,105,196,301
60402,YUNCHARA,estado nutricional en menores de 5 anos,clasificacion d,2002-08-01,6,22,6,22,28
10301,ZUDAÃ‘EZ,estado nutricional en menores de 5 anos,clasificacion d,2002-08-01,74,118,74,118,192
51302,ACACIO,estado nutricional en menores de 5 anos,clasificacion d,2002-09-01,19,131,19,131,150
20201,ACHACACHI,estado nutricional en menores de 5 anos,clasificacion d,2002-09-01,106,124,106,124,230
20104,ACHOCALLA,estado nutricional en menores de 5 anos,clasificacion d,2002-09-01,34,29,34,29,63
30201,AIQUILE,estado nutricional en menores de 5 anos,clasificacion d,2002-09-01,19,84,19,84,103
31303,ALALAY,estado nutricional en menores de 5 anos,clasificacion d,2002-09-01,11,15,11,15,26
10404,ALCALA,estado nutricional en menores de 5 anos,clasificacion d,2002-09-01,29,65,29,65,94
20202,ANCORAIMES,estado nutricional en menores de 5 anos,clasificacion d,2002-09-01,59,90,59,90,149
41201,ANDAMARCA,estado nutricional en menores de 5 anos,clasificacion d,2002-09-01,5,9,5,9,14
40603,ANTEQUERA,estado nutricional en menores de 5 anos,clasificacion d,2002-09-01,8,14,8,14,22
30402,ANZALDO,estado nutricional en menores de 5 anos,clasificacion d,2002-09-01,3,112,3,112,115
20701,APOLO,estado nutricional en menores de 5 anos,clasificacion d,2002-09-01,45,42,45,42,87
51301,ARAMPAMPA,estado nutricional en menores de 5 anos,clasificacion d,2002-09-01,38,46,38,46,84
30501,ARANI,estado nutricional en menores de 5 anos,clasificacion d,2002-09-01,18,55,18,55,73
30403,ARBIETO,estado nutricional en menores de 5 anos,clasificacion d,2002-09-01,16,23,16,23,39
30601,ARQUE,estado nutricional en menores de 5 anos,clasificacion d,2002-09-01,40,43,40,43,83
50802,ATOCHA,estado nutricional en menores de 5 anos,clasificacion d,2002-09-01,3,97,3,97,100
20503,AUCAPATA,estado nutricional en menores de 5 anos,clasificacion d,2002-09-01,8,5,8,5,13
20502,AYATA,estado nutricional en menores de 5 anos,clasificacion d,2002-09-01,29,31,29,31,60
21303,AYO AYO,estado nutricional en menores de 5 anos,clasificacion d,2002-09-01,13,10,13,10,23
30301,AYOPAYA (V. DE INDEPENDENCIA),estado nutricional en menores de 5 anos,clasificacion d,2002-09-01,101,126,101,126,227
10201,AZURDUY,estado nutricional en menores de 5 anos,clasificacion d,2002-09-01,165,211,165,211,376
21203,BATALLAS,estado nutricional en menores de 5 anos,clasificacion d,2002-09-01,30,42,30,42,72
80802,BAURES,estado nutricional en menores de 5 anos,clasificacion d,2002-09-01,20,27,20,27,47
50104,BELEN DE URMIRI,estado nutricional en menores de 5 anos,clasificacion d,2002-09-01,10,27,10,27,37
60202,BERMEJO,estado nutricional en menores de 5 anos,clasificacion d,2002-09-01,8,10,8,10,18
50301,BETANZOS,estado nutricional en menores de 5 anos,clasificacion d,2002-09-01,335,362,335,362,697
31501,BOLIVAR,estado nutricional en menores de 5 anos,clasificacion d,2002-09-01,71,87,71,87,158
90103,BOLPEBRA,estado nutricional en menores de 5 anos,clasificacion d,2002-09-01,2,11,2,11,13
70707,BOYUIBE,estado nutricional en menores de 5 anos,clasificacion d,2002-09-01,11,46,11,46,57
70401,BUENA VISTA,estado nutricional en menores de 5 anos,clasificacion d,2002-09-01,59,60,59,60,119
70703,CABEZAS,estado nutricional en menores de 5 anos,clasificacion d,2002-09-01,27,32,27,32,59
20905,CAIROMA,estado nutricional en menores de 5 anos,clasificacion d,2002-09-01,37,40,37,40,77
51102,"CAIZA ""D""",estado nutricional en menores de 5 anos,clasificacion d,2002-09-01,125,104,125,104,229
21003,CAJUATA,estado nutricional en menores de 5 anos,clasificacion d,2002-09-01,10,12,10,12,22
20303,CALACOTO,estado nutricional en menores de 5 anos,clasificacion d,2002-09-01,16,19,16,19,35
21304,CALAMARCA,estado nutricional en menores de 5 anos,clasificacion d,2002-09-01,88,57,88,57,145
10701,CAMARGO,estado nutricional en menores de 5 anos,clasificacion d,2002-09-01,51,137,51,137,188
10901,CAMATAQUI (C. VILLA ABECIA),estado nutricional en menores de 5 anos,clasificacion d,2002-09-01,24,44,24,44,68
70706,CAMIRI,estado nutricional en menores de 5 anos,clasificacion d,2002-09-01,48,88,48,88,136
30701,CAPINOTA,estado nutricional en menores de 5 anos,clasificacion d,2002-09-01,32,56,32,56,88
20302,CAQUIAVIRI,estado nutricional en menores de 5 anos,clasificacion d,2002-09-01,25,29,25,29,54
40102,CARACOLLO,estado nutricional en menores de 5 anos,clasificacion d,2002-09-01,31,54,31,54,85
22001,CARANAVI,estado nutricional en menores de 5 anos,clasificacion d,2002-09-01,108,122,108,122,230
41503,CARANGAS,estado nutricional en menores de 5 anos,clasificacion d,2002-09-01,0,2,0,2,2
60302,CARAPARI,estado nutricional en menores de 5 anos,clasificacion d,2002-09-01,27,36,27,36,63
50702,CARIPUYO,estado nutricional en menores de 5 anos,clasificacion d,2002-09-01,61,77,61,77,138
21902,CATACORA,estado nutricional en menores de 5 anos,clasificacion d,2002-09-01,12,5,12,5,17
21803,CHACARILLA,estado nutricional en menores de 5 anos,clasificacion d,2002-09-01,0,1,0,1,1
40201,CHALLAPATA,estado nutricional en menores de 5 anos,clasificacion d,2002-09-01,40,109,40,109,149
50302,CHAQUI,estado nutricional en menores de 5 anos,clasificacion d,2002-09-01,77,51,77,51,128
70702,CHARAGUA,estado nutricional en menores de 5 anos,clasificacion d,2002-09-01,53,165,53,165,218
20305,CHARAÃ‘A,estado nutricional en menores de 5 anos,clasificacion d,2002-09-01,23,19,23,19,42
50202,CHAYANTA,estado nutricional en menores de 5 anos,clasificacion d,2002-09-01,53,55,53,55,108
31204,CHIMORE,estado nutricional en menores de 5 anos,clasificacion d,2002-09-01,4,5,4,5,9
40903,CHIPAYA,estado nutricional en menores de 5 anos,clasificacion d,2002-09-01,0,1,0,1,1
40302,CHOQUE COTA,estado nutricional en menores de 5 anos,clasificacion d,2002-09-01,12,0,12,0,12
21101,CHULUMANI (V. DE LA LIBERTAD),estado nutricional en menores de 5 anos,clasificacion d,2002-09-01,11,16,11,16,27
20501,CHUMA,estado nutricional en menores de 5 anos,clasificacion d,2002-09-01,35,36,35,36,71
30801,CLIZA,estado nutricional en menores de 5 anos,clasificacion d,2002-09-01,5,38,5,38,43
90101,COBIJA,estado nutricional en menores de 5 anos,clasificacion d,2002-09-01,89,59,89,59,148
30101,COCHABAMBA,estado nutricional en menores de 5 anos,clasificacion d,2002-09-01,359,373,359,373,732
30905,COLCAPIRHUA,estado nutricional en menores de 5 anos,clasificacion d,2002-09-01,57,42,57,42,99
50901,"COLCHA ""K""",estado nutricional en menores de 5 anos,clasificacion d,2002-09-01,58,50,58,50,108
21307,COLLANA,estado nutricional en menores de 5 anos,clasificacion d,2002-09-01,3,2,3,2,5
31002,COLOMI,estado nutricional en menores de 5 anos,clasificacion d,2002-09-01,32,57,32,57,89
50401,COLQUECHACA,estado nutricional en menores de 5 anos,clasificacion d,2002-09-01,141,118,141,118,259
21306,COLQUENCHA,estado nutricional en menores de 5 anos,clasificacion d,2002-09-01,11,23,11,23,34
21004,COLQUIRI,estado nutricional en menores de 5 anos,clasificacion d,2002-09-01,61,79,61,79,140
20304,COMANCHE,estado nutricional en menores de 5 anos,clasificacion d,2002-09-01,17,9,17,9,26
71301,COMARAPA,estado nutricional en menores de 5 anos,clasificacion d,2002-09-01,57,52,57,52,109
20605,COMBAYA,estado nutricional en menores de 5 anos,clasificacion d,2002-09-01,4,15,4,15,19
71101,CONCEPCION,estado nutricional en menores de 5 anos,clasificacion d,2002-09-01,11,18,11,18,29
21701,COPACABANA,estado nutricional en menores de 5 anos,clasificacion d,2002-09-01,5,25,5,25,30
21402,CORIPATA,estado nutricional en menores de 5 anos,clasificacion d,2002-09-01,2,13,2,13,15
20301,CORO CORO,estado nutricional en menores de 5 anos,clasificacion d,2002-09-01,47,32,47,32,79
21401,COROICO,estado nutricional en menores de 5 anos,clasificacion d,2002-09-01,21,12,21,12,33
40301,CORQUE,estado nutricional en menores de 5 anos,clasificacion d,2002-09-01,25,21,25,21,46
50601,COTAGAITA,estado nutricional en menores de 5 anos,clasificacion d,2002-09-01,56,97,56,97,153
70102,COTOCA,estado nutricional en menores de 5 anos,clasificacion d,2002-09-01,30,27,30,27,57
31405,CUCHUMUELA (V. G. VILLARROEL),estado nutricional en menores de 5 anos,clasificacion d,2002-09-01,11,9,11,9,20
70704,CUEVO,estado nutricional en menores de 5 anos,clasificacion d,2002-09-01,22,29,22,29,51
10902,CULPINA,estado nutricional en menores de 5 anos,clasificacion d,2002-09-01,213,320,213,320,533
40401,CURAHUARA DE CARANGAS,estado nutricional en menores de 5 anos,clasificacion d,2002-09-01,29,6,29,6,35
21602,CURVA,estado nutricional en menores de 5 anos,clasificacion d,2002-09-01,10,15,10,15,25
20804,DESAGUADERO,estado nutricional en menores de 5 anos,clasificacion d,2002-09-01,17,6,17,6,23
20105,EL ALTO,estado nutricional en menores de 5 anos,clasificacion d,2002-09-01,1515,1206,1515,1206,2721
40103,EL CHORO,estado nutricional en menores de 5 anos,clasificacion d,2002-09-01,9,0,9,0,9
71503,EL PUENTE(STC),estado nutricional en menores de 5 anos,clasificacion d,2002-09-01,3,93,3,93,96
60502,EL PUENTE(TJA),estado nutricional en menores de 5 anos,clasificacion d,2002-09-01,37,79,37,79,116
70105,EL TORNO,estado nutricional en menores de 5 anos,clasificacion d,2002-09-01,81,103,81,103,184
10405,EL VILLAR,estado nutricional en menores de 5 anos,clasificacion d,2002-09-01,37,145,37,145,182
60601,ENTRE RIOS,estado nutricional en menores de 5 anos,clasificacion d,2002-09-01,43,51,43,51,94
41101,EUCALIPTUS,estado nutricional en menores de 5 anos,clasificacion d,2002-09-01,16,18,16,18,34
80402,EXALTACION,estado nutricional en menores de 5 anos,clasificacion d,2002-09-01,1,13,1,13,14
90203,FILADELFIA,estado nutricional en menores de 5 anos,clasificacion d,2002-09-01,0,5,0,5,5
71002,GENERAL SAAVEDRA,estado nutricional en menores de 5 anos,clasificacion d,2002-09-01,17,16,17,16,33
21601,GRAL. J.J. PEREZ (CHARAZANI),estado nutricional en menores de 5 anos,clasificacion d,2002-09-01,54,70,54,70,124
20602,GUANAY,estado nutricional en menores de 5 anos,clasificacion d,2002-09-01,98,118,98,118,216
20802,GUAQUI,estado nutricional en menores de 5 anos,clasificacion d,2002-09-01,23,7,23,7,30
80202,GUAYARAMERIN,estado nutricional en menores de 5 anos,clasificacion d,2002-09-01,108,126,108,126,234
70705,GUTIERREZ,estado nutricional en menores de 5 anos,clasificacion d,2002-09-01,60,107,60,107,167
10502,HUACARETA,estado nutricional en menores de 5 anos,clasificacion d,2002-09-01,60,71,60,71,131
11002,HUACAYA (VILLA DE HUACAYA),estado nutricional en menores de 5 anos,clasificacion d,2002-09-01,13,33,13,33,46
40501,HUACHACALLA,estado nutricional en menores de 5 anos,clasificacion d,2002-09-01,5,0,5,0,5
40701,HUANUNI,estado nutricional en menores de 5 anos,clasificacion d,2002-09-01,93,47,93,47,140
80803,HUARACAJE,estado nutricional en menores de 5 anos,clasificacion d,2002-09-01,1,5,1,5,6
41601,HUAYLLAMARCA,estado nutricional en menores de 5 anos,clasificacion d,2002-09-01,17,5,17,5,22
21005,ICHOCA,estado nutricional en menores de 5 anos,clasificacion d,2002-09-01,11,15,11,15,26
10304,ICLA,estado nutricional en menores de 5 anos,clasificacion d,2002-09-01,135,187,135,187,322
10703,INCAHUASI,estado nutricional en menores de 5 anos,clasificacion d,2002-09-01,132,186,132,186,318
21001,INQUISIVI,estado nutricional en menores de 5 anos,clasificacion d,2002-09-01,42,83,42,83,125
21102,IRUPANA (VILLA DE LANZA),estado nutricional en menores de 5 anos,clasificacion d,2002-09-01,19,37,19,37,56
21501,IXIAMAS,estado nutricional en menores de 5 anos,clasificacion d,2002-09-01,35,39,35,39,74
21105,LA ASUNTA,estado nutricional en menores de 5 anos,clasificacion d,2002-09-01,36,57,36,57,93
70104,LA GUARDIA,estado nutricional en menores de 5 anos,clasificacion d,2002-09-01,64,35,64,35,99
20101,LA PAZ,estado nutricional en menores de 5 anos,clasificacion d,2002-09-01,1092,905,1092,905,1997
70701,LAGUNILLAS,estado nutricional en menores de 5 anos,clasificacion d,2002-09-01,34,33,34,33,67
21202,LAJA,estado nutricional en menores de 5 anos,clasificacion d,2002-09-01,20,27,20,27,47
10903,LAS CARRERAS,estado nutricional en menores de 5 anos,clasificacion d,2002-09-01,33,38,33,38,71
21006,LICOMA PAMPA,estado nutricional en menores de 5 anos,clasificacion d,2002-09-01,9,20,9,20,29
50203,LLALLAGUA,estado nutricional en menores de 5 anos,clasificacion d,2002-09-01,5,172,5,172,177
51401,LLICA,estado nutricional en menores de 5 anos,clasificacion d,2002-09-01,8,8,8,8,16
80601,LORETO,estado nutricional en menores de 5 anos,clasificacion d,2002-09-01,0,15,0,15,15
20901,LURIBAY,estado nutricional en menores de 5 anos,clasificacion d,2002-09-01,25,36,25,36,61
40702,MACHACAMARCA,estado nutricional en menores de 5 anos,clasificacion d,2002-09-01,9,15,9,15,24
11003,MACHARETI,estado nutricional en menores de 5 anos,clasificacion d,2002-09-01,52,103,52,103,155
80801,MAGDALENA,estado nutricional en menores de 5 anos,clasificacion d,2002-09-01,15,10,15,10,25
70903,MAIRANA,estado nutricional en menores de 5 anos,clasificacion d,2002-09-01,20,20,20,20,40
20904,MALLA,estado nutricional en menores de 5 anos,clasificacion d,2002-09-01,5,8,5,8,13
20103,MECAPACA,estado nutricional en menores de 5 anos,clasificacion d,2002-09-01,29,11,29,11,40
71003,MINEROS,estado nutricional en menores de 5 anos,clasificacion d,2002-09-01,6,3,6,3,9
31301,MIZQUE,estado nutricional en menores de 5 anos,clasificacion d,2002-09-01,28,39,28,39,67
20402,MOCOMOCO,estado nutricional en menores de 5 anos,clasificacion d,2002-09-01,35,25,35,25,60
51002,MOJINETE,estado nutricional en menores de 5 anos,clasificacion d,2002-09-01,0,10,0,10,10
10303,MOJOCOYA,estado nutricional en menores de 5 anos,clasificacion d,2002-09-01,59,97,59,97,156
10501,MONTEAGUDO,estado nutricional en menores de 5 anos,clasificacion d,2002-09-01,155,289,155,289,444
71001,MONTERO,estado nutricional en menores de 5 anos,clasificacion d,2002-09-01,210,162,210,162,372
70803,MORO MORO,estado nutricional en menores de 5 anos,clasificacion d,2002-09-01,24,31,24,31,55
30302,MOROCHATA,estado nutricional en menores de 5 anos,clasificacion d,2002-09-01,70,99,70,99,169
90401,NACEBE (SANTA ROSA DEL ABUNA),estado nutricional en menores de 5 anos,clasificacion d,2002-09-01,2,0,2,0,2
20307,NAZACARA DE PACAJES,estado nutricional en menores de 5 anos,clasificacion d,2002-09-01,2,2,2,2,4
90501,NUEVO MANOA (NUEVA ESPERANZA),estado nutricional en menores de 5 anos,clasificacion d,2002-09-01,2,3,2,3,5
50404,OCURI,estado nutricional en menores de 5 anos,clasificacion d,2002-09-01,46,85,46,85,131
70202,OKINAWA,estado nutricional en menores de 5 anos,clasificacion d,2002-09-01,13,21,13,21,34
30203,OMEREQUE,estado nutricional en menores de 5 anos,clasificacion d,2002-09-01,0,41,0,41,41
40101,ORURO,estado nutricional en menores de 5 anos,clasificacion d,2002-09-01,520,360,520,360,880
60201,PADCAYA,estado nutricional en menores de 5 anos,clasificacion d,2002-09-01,40,55,40,55,95
10401,PADILLA,estado nutricional en menores de 5 anos,clasificacion d,2002-09-01,140,264,140,264,404
70502,PAILON,estado nutricional en menores de 5 anos,clasificacion d,2002-09-01,55,51,55,51,106
20102,PALCA,estado nutricional en menores de 5 anos,clasificacion d,2002-09-01,54,75,54,75,129
21104,PALOS BLANCOS,estado nutricional en menores de 5 anos,clasificacion d,2002-09-01,52,74,52,74,126
40802,PAMPA AULLAGAS,estado nutricional en menores de 5 anos,clasificacion d,2002-09-01,12,22,12,22,34
70902,PAMPA GRANDE,estado nutricional en menores de 5 anos,clasificacion d,2002-09-01,19,20,19,20,39
21802,PAPEL PAMPA,estado nutricional en menores de 5 anos,clasificacion d,2002-09-01,9,1,9,1,10
30202,PASORAPA,estado nutricional en menores de 5 anos,clasificacion d,2002-09-01,15,29,15,29,44
21305,PATACAMAYA,estado nutricional en menores de 5 anos,clasificacion d,2002-09-01,52,47,52,47,99
40602,PAZÃ‘A,estado nutricional en menores de 5 anos,clasificacion d,2002-09-01,10,16,10,16,26
20702,PELECHUCO,estado nutricional en menores de 5 anos,clasificacion d,2002-09-01,53,47,53,47,100
50403,POCOATA,estado nutricional en menores de 5 anos,clasificacion d,2002-09-01,127,155,127,155,282
31203,POCONA,estado nutricional en menores de 5 anos,clasificacion d,2002-09-01,38,47,38,47,85
31202,POJO (CBBA),estado nutricional en menores de 5 anos,clasificacion d,2002-09-01,111,134,111,134,245
40601,POOPO,estado nutricional en menores de 5 anos,clasificacion d,2002-09-01,7,15,7,15,22
51203,PORCO,estado nutricional en menores de 5 anos,clasificacion d,2002-09-01,23,14,23,14,37
10103,POROMA,estado nutricional en menores de 5 anos,clasificacion d,2002-09-01,145,181,145,181,326
70103,PORONGO,estado nutricional en menores de 5 anos,clasificacion d,2002-09-01,14,12,14,12,26
70601,PORTACHUELO,estado nutricional en menores de 5 anos,clasificacion d,2002-09-01,40,35,40,35,75
90102,PORVENIR,estado nutricional en menores de 5 anos,clasificacion d,2002-09-01,13,15,13,15,28
70804,POSTRER VALLE,estado nutricional en menores de 5 anos,clasificacion d,2002-09-01,9,14,9,14,23
50101,POTOSI,estado nutricional en menores de 5 anos,clasificacion d,2002-09-01,510,378,510,378,888
10302,PRESTO,estado nutricional en menores de 5 anos,clasificacion d,2002-09-01,72,83,72,83,155
70805,PUCARA,estado nutricional en menores de 5 anos,clasificacion d,2002-09-01,0,1,0,1,1
21201,PUCARANI,estado nutricional en menores de 5 anos,clasificacion d,2002-09-01,25,53,25,53,78
20401,PUERTO ACOSTA,estado nutricional en menores de 5 anos,clasificacion d,2002-09-01,111,122,111,122,233
20403,PUERTO CARABUCO,estado nutricional en menores de 5 anos,clasificacion d,2002-09-01,43,38,43,38,81
90301,PUERTO GONZALO MORENO,estado nutricional en menores de 5 anos,clasificacion d,2002-09-01,6,16,6,16,22
21204,PUERTO PEREZ,estado nutricional en menores de 5 anos,clasificacion d,2002-09-01,12,6,12,6,18
71402,PUERTO QUIJARRO,estado nutricional en menores de 5 anos,clasificacion d,2002-09-01,39,22,39,22,61
90201,PUERTO RICO,estado nutricional en menores de 5 anos,clasificacion d,2002-09-01,3,19,3,19,22
71401,PUERTO SUAREZ,estado nutricional en menores de 5 anos,clasificacion d,2002-09-01,33,19,33,19,52
31205,PUERTO VILLARROEL,estado nutricional en menores de 5 anos,clasificacion d,2002-09-01,126,102,126,102,228
51101,PUNA,estado nutricional en menores de 5 anos,clasificacion d,2002-09-01,238,402,238,402,640
31401,PUNATA,estado nutricional en menores de 5 anos,clasificacion d,2002-09-01,49,6,49,6,55
20604,QUIABAYA,estado nutricional en menores de 5 anos,clasificacion d,2002-09-01,13,25,13,25,38
30901,QUILLACOLLO,estado nutricional en menores de 5 anos,clasificacion d,2002-09-01,61,63,61,63,124
21002,QUIME,estado nutricional en menores de 5 anos,clasificacion d,2002-09-01,53,53,53,53,106
70904,QUIRUSILLAS,estado nutricional en menores de 5 anos,clasificacion d,2002-09-01,1,1,1,1,2
50402,RAVELO,estado nutricional en menores de 5 anos,clasificacion d,2002-09-01,163,235,163,235,398
80301,REYES,estado nutricional en menores de 5 anos,clasificacion d,2002-09-01,18,13,18,13,31
80201,RIBERALTA,estado nutricional en menores de 5 anos,clasificacion d,2002-09-01,394,290,394,290,684
70503,ROBORE,estado nutricional en menores de 5 anos,clasificacion d,2002-09-01,21,43,21,43,64
80304,RURRENABAQUE,estado nutricional en menores de 5 anos,clasificacion d,2002-09-01,10,6,10,6,16
40901,SABAYA,estado nutricional en menores de 5 anos,clasificacion d,2002-09-01,0,12,0,12,12
31001,SACABA,estado nutricional en menores de 5 anos,clasificacion d,2002-09-01,180,134,180,134,314
30404,SACABAMBA,estado nutricional en menores de 5 anos,clasificacion d,2002-09-01,2,82,2,82,84
50701,SACACA,estado nutricional en menores de 5 anos,clasificacion d,2002-09-01,181,263,181,263,444
71302,SAIPINA,estado nutricional en menores de 5 anos,clasificacion d,2002-09-01,8,12,8,12,20
40801,SALINAS DE GARCI MENDOZA,estado nutricional en menores de 5 anos,clasificacion d,2002-09-01,11,12,11,12,23
70901,SAMAIPATA,estado nutricional en menores de 5 anos,clasificacion d,2002-09-01,32,18,32,18,50
51601,SAN AGUSTIN,estado nutricional en menores de 5 anos,clasificacion d,2002-09-01,4,0,4,0,4
80602,SAN ANDRES,estado nutricional en menores de 5 anos,clasificacion d,2002-09-01,6,24,6,24,30
51003,SAN ANTONIO DE ESMORUCO,estado nutricional en menores de 5 anos,clasificacion d,2002-09-01,1,14,1,14,15
71105,SAN ANTONIO DE LOMERIO,estado nutricional en menores de 5 anos,clasificacion d,2002-09-01,76,117,76,117,193
31403,SAN BENITO,estado nutricional en menores de 5 anos,clasificacion d,2002-09-01,26,15,26,15,41
80302,SAN BORJA,estado nutricional en menores de 5 anos,clasificacion d,2002-09-01,97,93,97,93,190
21502,SAN BUENA VENTURA,estado nutricional en menores de 5 anos,clasificacion d,2002-09-01,54,86,54,86,140
70402,SAN CARLOS,estado nutricional en menores de 5 anos,clasificacion d,2002-09-01,29,56,29,56,85
80501,SAN IGNACIO,estado nutricional en menores de 5 anos,clasificacion d,2002-09-01,104,149,104,149,253
70301,SAN IGNACIO DE VELASCO,estado nutricional en menores de 5 anos,clasificacion d,2002-09-01,188,164,188,164,352
80102,SAN JAVIER(BNI),estado nutricional en menores de 5 anos,clasificacion d,2002-09-01,0,34,0,34,34
71102,SAN JAVIER(STC),estado nutricional en menores de 5 anos,clasificacion d,2002-09-01,13,12,13,12,25
80701,SAN JOAQUIN,estado nutricional en menores de 5 anos,clasificacion d,2002-09-01,1,27,1,27,28
70501,SAN JOSE DE CHIQUITOS,estado nutricional en menores de 5 anos,clasificacion d,2002-09-01,28,24,28,24,52
71104,SAN JULIAN,estado nutricional en menores de 5 anos,clasificacion d,2002-09-01,118,107,118,107,225
90302,SAN LORENZO(PND),estado nutricional en menores de 5 anos,clasificacion d,2002-09-01,8,19,8,19,27
60501,SAN LORENZO(TJA),estado nutricional en menores de 5 anos,clasificacion d,2002-09-01,28,24,28,24,52
10702,SAN LUCAS,estado nutricional en menores de 5 anos,clasificacion d,2002-09-01,355,403,355,403,758
71201,SAN MATIAS,estado nutricional en menores de 5 anos,clasificacion d,2002-09-01,34,37,34,37,71
70302,SAN MIGUEL DE VELASCO,estado nutricional en menores de 5 anos,clasificacion d,2002-09-01,64,78,64,78,142
51001,SAN PABLO DE LIPEZ,estado nutricional en menores de 5 anos,clasificacion d,2002-09-01,8,10,8,10,18
50501,SAN PEDRO DE BUENA VISTA,estado nutricional en menores de 5 anos,clasificacion d,2002-09-01,112,265,112,265,377
21801,SAN PEDRO DE CURAHUARA,estado nutricional en menores de 5 anos,clasificacion d,2002-09-01,14,22,14,22,36
50902,SAN PEDRO DE QUEMES,estado nutricional en menores de 5 anos,clasificacion d,2002-09-01,3,1,3,1,4
21702,SAN PEDRO DE TIQUINA,estado nutricional en menores de 5 anos,clasificacion d,2002-09-01,2,4,2,4,6
70303,SAN RAFAEL,estado nutricional en menores de 5 anos,clasificacion d,2002-09-01,34,18,34,18,52
80702,SAN RAMON,estado nutricional en menores de 5 anos,clasificacion d,2002-09-01,6,8,6,8,14
80401,SANTA ANA,estado nutricional en menores de 5 anos,clasificacion d,2002-09-01,23,24,23,24,47
70101,SANTA CRUZ DE LA SIERRA,estado nutricional en menores de 5 anos,clasificacion d,2002-09-01,777,561,777,561,1338
80303,SANTA ROSA,estado nutricional en menores de 5 anos,clasificacion d,2002-09-01,11,9,11,9,20
70602,SANTA ROSA DEL SARA,estado nutricional en menores de 5 anos,clasificacion d,2002-09-01,14,16,14,16,30
20308,SANTIAGO DE CALLAPA,estado nutricional en menores de 5 anos,clasificacion d,2002-09-01,12,24,12,24,36
41401,SANTIAGO DE HUARI,estado nutricional en menores de 5 anos,clasificacion d,2002-09-01,14,27,14,27,41
21901,SANTIAGO DE MACHACA,estado nutricional en menores de 5 anos,clasificacion d,2002-09-01,21,19,21,19,40
30702,SANTIVAÃ‘ES,estado nutricional en menores de 5 anos,clasificacion d,2002-09-01,22,31,22,31,53
40202,SANTUARIO DE QUILLACAS,estado nutricional en menores de 5 anos,clasificacion d,2002-09-01,4,6,4,6,10
20902,SAPAHAQUI,estado nutricional en menores de 5 anos,clasificacion d,2002-09-01,11,6,11,6,17
90303,SENA,estado nutricional en menores de 5 anos,clasificacion d,2002-09-01,12,12,12,12,24
21301,SICA SICA (VILLA AROMA),estado nutricional en menores de 5 anos,clasificacion d,2002-09-01,40,24,40,24,64
30703,SICAYA,estado nutricional en menores de 5 anos,clasificacion d,2002-09-01,25,34,25,34,59
30902,SIPE SIPE,estado nutricional en menores de 5 anos,clasificacion d,2002-09-01,149,146,149,146,295
10403,SOPACHUY,estado nutricional en menores de 5 anos,clasificacion d,2002-09-01,58,75,58,75,133
20601,SORATA,estado nutricional en menores de 5 anos,clasificacion d,2002-09-01,34,71,34,71,105
10101,SUCRE,estado nutricional en menores de 5 anos,clasificacion d,2002-09-01,566,676,566,676,1242
31404,TACACHI,estado nutricional en menores de 5 anos,clasificacion d,2002-09-01,1,3,1,3,4
20603,TACACOMA,estado nutricional en menores de 5 anos,clasificacion d,2002-09-01,13,14,13,14,27
50303,TACOBAMBA,estado nutricional en menores de 5 anos,clasificacion d,2002-09-01,33,44,33,44,77
30602,TACOPAYA,estado nutricional en menores de 5 anos,clasificacion d,2002-09-01,91,101,91,101,192
51402,TAHUA,estado nutricional en menores de 5 anos,clasificacion d,2002-09-01,1,0,1,0,1
31101,TAPACARI,estado nutricional en menores de 5 anos,clasificacion d,2002-09-01,68,165,68,165,233
10601,TARABUCO,estado nutricional en menores de 5 anos,clasificacion d,2002-09-01,263,449,263,449,712
30401,TARATA,estado nutricional en menores de 5 anos,clasificacion d,2002-09-01,18,37,18,37,55
60101,TARIJA,estado nutricional en menores de 5 anos,clasificacion d,2002-09-01,215,197,215,197,412
10202,TARVITA,estado nutricional en menores de 5 anos,clasificacion d,2002-09-01,103,195,103,195,298
20803,TIAWANACU,estado nutricional en menores de 5 anos,clasificacion d,2002-09-01,19,24,19,24,43
50102,TINGUIPAYA,estado nutricional en menores de 5 anos,clasificacion d,2002-09-01,35,145,35,145,180
20606,TIPUANI,estado nutricional en menores de 5 anos,clasificacion d,2002-09-01,10,5,10,5,15
30903,TIQUIPAYA,estado nutricional en menores de 5 anos,clasificacion d,2002-09-01,26,67,26,67,93
31601,TIRAQUE (CBBA),estado nutricional en menores de 5 anos,clasificacion d,2002-09-01,134,175,134,175,309
21703,TITO YUPANQUI (PARQUIPUJIO),estado nutricional en menores de 5 anos,clasificacion d,2002-09-01,6,4,6,4,10
30802,TOCO,estado nutricional en menores de 5 anos,clasificacion d,2002-09-01,0,4,0,4,4
30803,TOLATA,estado nutricional en menores de 5 anos,clasificacion d,2002-09-01,5,4,5,4,9
41001,TOLEDO,estado nutricional en menores de 5 anos,clasificacion d,2002-09-01,3,17,3,17,20
51202,TOMAVE,estado nutricional en menores de 5 anos,clasificacion d,2002-09-01,52,84,52,84,136
10402,TOMINA,estado nutricional en menores de 5 anos,clasificacion d,2002-09-01,88,183,88,183,271
50502,TORO TORO,estado nutricional en menores de 5 anos,clasificacion d,2002-09-01,44,43,44,43,87
31201,TOTORA(CBBA),estado nutricional en menores de 5 anos,clasificacion d,2002-09-01,74,81,74,81,155
41301,TOTORA(ORR),estado nutricional en menores de 5 anos,clasificacion d,2002-09-01,12,16,12,16,28
70802,TRIGAL,estado nutricional en menores de 5 anos,clasificacion d,2002-09-01,3,5,3,5,8
80101,TRINIDAD,estado nutricional en menores de 5 anos,clasificacion d,2002-09-01,31,389,31,389,420
50801,TUPIZA,estado nutricional en menores de 5 anos,clasificacion d,2002-09-01,29,377,29,377,406
40402,TURCO,estado nutricional en menores de 5 anos,clasificacion d,2002-09-01,8,8,8,8,16
21302,UMALA,estado nutricional en menores de 5 anos,clasificacion d,2002-09-01,17,9,17,9,26
50201,UNCIA,estado nutricional en menores de 5 anos,clasificacion d,2002-09-01,5,30,5,30,35
60401,URIONDO (A. CONCEPCION),estado nutricional en menores de 5 anos,clasificacion d,2002-09-01,11,25,11,25,36
71502,URUBICHA,estado nutricional en menores de 5 anos,clasificacion d,2002-09-01,11,22,11,22,33
51201,UYUNI,estado nutricional en menores de 5 anos,clasificacion d,2002-09-01,59,112,59,112,171
30502,VACAS,estado nutricional en menores de 5 anos,clasificacion d,2002-09-01,58,19,58,19,77
70801,VALLEGRANDE,estado nutricional en menores de 5 anos,clasificacion d,2002-09-01,49,59,49,59,108
20801,VIACHA,estado nutricional en menores de 5 anos,clasificacion d,2002-09-01,59,133,59,133,192
31302,VILA VILA,estado nutricional en menores de 5 anos,clasificacion d,2002-09-01,6,23,6,23,29
60303,VILLA MONTES,estado nutricional en menores de 5 anos,clasificacion d,2002-09-01,46,37,46,37,83
31402,VILLA RIVERO,estado nutricional en menores de 5 anos,clasificacion d,2002-09-01,24,25,24,25,49
10801,VILLA SERRANO,estado nutricional en menores de 5 anos,clasificacion d,2002-09-01,105,274,105,274,379
31003,VILLA TUNARI,estado nutricional en menores de 5 anos,clasificacion d,2002-09-01,99,98,99,98,197
11001,VILLA VACA GUZMAN (MUYUPAMPA),estado nutricional en menores de 5 anos,clasificacion d,2002-09-01,56,99,56,99,155
51501,VILLAZON,estado nutricional en menores de 5 anos,clasificacion d,2002-09-01,131,180,131,180,311
30904,VINTO,estado nutricional en menores de 5 anos,clasificacion d,2002-09-01,36,5,36,5,41
50602,VITICHI,estado nutricional en menores de 5 anos,clasificacion d,2002-09-01,18,58,18,58,76
20306,WALDO BALLIVIAN,estado nutricional en menores de 5 anos,clasificacion d,2002-09-01,5,1,5,1,6
70201,WARNES,estado nutricional en menores de 5 anos,clasificacion d,2002-09-01,115,56,115,56,171
20903,YACO,estado nutricional en menores de 5 anos,clasificacion d,2002-09-01,15,16,15,16,31
60301,YACUIBA,estado nutricional en menores de 5 anos,clasificacion d,2002-09-01,114,119,114,119,233
10602,YAMPARAEZ,estado nutricional en menores de 5 anos,clasificacion d,2002-09-01,153,267,153,267,420
21103,YANACACHI,estado nutricional en menores de 5 anos,clasificacion d,2002-09-01,9,16,9,16,25
70403,YAPACANI,estado nutricional en menores de 5 anos,clasificacion d,2002-09-01,100,133,100,133,233
50103,YOCALLA,estado nutricional en menores de 5 anos,clasificacion d,2002-09-01,24,73,24,73,97
10102,YOTALA,estado nutricional en menores de 5 anos,clasificacion d,2002-09-01,100,190,100,190,290
60402,YUNCHARA,estado nutricional en menores de 5 anos,clasificacion d,2002-09-01,14,30,14,30,44
10301,ZUDAÃ‘EZ,estado nutricional en menores de 5 anos,clasificacion d,2002-09-01,66,129,66,129,195
51302,ACACIO,estado nutricional en menores de 5 anos,clasificacion d,2002-10-01,27,102,27,102,129
20201,ACHACACHI,estado nutricional en menores de 5 anos,clasificacion d,2002-10-01,193,179,193,179,372
20104,ACHOCALLA,estado nutricional en menores de 5 anos,clasificacion d,2002-10-01,34,30,34,30,64
30201,AIQUILE,estado nutricional en menores de 5 anos,clasificacion d,2002-10-01,50,78,50,78,128
31303,ALALAY,estado nutricional en menores de 5 anos,clasificacion d,2002-10-01,11,63,11,63,74
10404,ALCALA,estado nutricional en menores de 5 anos,clasificacion d,2002-10-01,38,65,38,65,103
20202,ANCORAIMES,estado nutricional en menores de 5 anos,clasificacion d,2002-10-01,69,135,69,135,204
41201,ANDAMARCA,estado nutricional en menores de 5 anos,clasificacion d,2002-10-01,1,1,1,1,2
30402,ANZALDO,estado nutricional en menores de 5 anos,clasificacion d,2002-10-01,17,108,17,108,125
20701,APOLO,estado nutricional en menores de 5 anos,clasificacion d,2002-10-01,43,35,43,35,78
51301,ARAMPAMPA,estado nutricional en menores de 5 anos,clasificacion d,2002-10-01,47,79,47,79,126
30501,ARANI,estado nutricional en menores de 5 anos,clasificacion d,2002-10-01,18,23,18,23,41
30403,ARBIETO,estado nutricional en menores de 5 anos,clasificacion d,2002-10-01,8,35,8,35,43
30601,ARQUE,estado nutricional en menores de 5 anos,clasificacion d,2002-10-01,39,42,39,42,81
71501,ASCENCION DE GUARAYOS,estado nutricional en menores de 5 anos,clasificacion d,2002-10-01,222,313,222,313,535
50802,ATOCHA,estado nutricional en menores de 5 anos,clasificacion d,2002-10-01,2,122,2,122,124
20503,AUCAPATA,estado nutricional en menores de 5 anos,clasificacion d,2002-10-01,18,8,18,8,26
20502,AYATA,estado nutricional en menores de 5 anos,clasificacion d,2002-10-01,39,36,39,36,75
21303,AYO AYO,estado nutricional en menores de 5 anos,clasificacion d,2002-10-01,24,2,24,2,26
30301,AYOPAYA (V. DE INDEPENDENCIA),estado nutricional en menores de 5 anos,clasificacion d,2002-10-01,156,156,156,156,312
10201,AZURDUY,estado nutricional en menores de 5 anos,clasificacion d,2002-10-01,126,207,126,207,333
21203,BATALLAS,estado nutricional en menores de 5 anos,clasificacion d,2002-10-01,33,51,33,51,84
80802,BAURES,estado nutricional en menores de 5 anos,clasificacion d,2002-10-01,28,42,28,42,70
41202,BELEN DE ANDAMARCA,estado nutricional en menores de 5 anos,clasificacion d,2002-10-01,0,3,0,3,3
50104,BELEN DE URMIRI,estado nutricional en menores de 5 anos,clasificacion d,2002-10-01,9,27,9,27,36
90104,BELLA FLOR,estado nutricional en menores de 5 anos,clasificacion d,2002-10-01,0,2,0,2,2
60202,BERMEJO,estado nutricional en menores de 5 anos,clasificacion d,2002-10-01,5,5,5,5,10
50301,BETANZOS,estado nutricional en menores de 5 anos,clasificacion d,2002-10-01,168,252,168,252,420
31501,BOLIVAR,estado nutricional en menores de 5 anos,clasificacion d,2002-10-01,70,105,70,105,175
90103,BOLPEBRA,estado nutricional en menores de 5 anos,clasificacion d,2002-10-01,1,24,1,24,25
70707,BOYUIBE,estado nutricional en menores de 5 anos,clasificacion d,2002-10-01,5,11,5,11,16
70703,CABEZAS,estado nutricional en menores de 5 anos,clasificacion d,2002-10-01,28,27,28,27,55
20905,CAIROMA,estado nutricional en menores de 5 anos,clasificacion d,2002-10-01,57,54,57,54,111
51102,"CAIZA ""D""",estado nutricional en menores de 5 anos,clasificacion d,2002-10-01,81,69,81,69,150
21003,CAJUATA,estado nutricional en menores de 5 anos,clasificacion d,2002-10-01,52,32,52,32,84
20303,CALACOTO,estado nutricional en menores de 5 anos,clasificacion d,2002-10-01,7,12,7,12,19
21304,CALAMARCA,estado nutricional en menores de 5 anos,clasificacion d,2002-10-01,115,107,115,107,222
10701,CAMARGO,estado nutricional en menores de 5 anos,clasificacion d,2002-10-01,69,165,69,165,234
10901,CAMATAQUI (C. VILLA ABECIA),estado nutricional en menores de 5 anos,clasificacion d,2002-10-01,25,36,25,36,61
70706,CAMIRI,estado nutricional en menores de 5 anos,clasificacion d,2002-10-01,169,129,169,129,298
30701,CAPINOTA,estado nutricional en menores de 5 anos,clasificacion d,2002-10-01,66,51,66,51,117
20302,CAQUIAVIRI,estado nutricional en menores de 5 anos,clasificacion d,2002-10-01,17,33,17,33,50
40102,CARACOLLO,estado nutricional en menores de 5 anos,clasificacion d,2002-10-01,17,74,17,74,91
22001,CARANAVI,estado nutricional en menores de 5 anos,clasificacion d,2002-10-01,147,123,147,123,270
41503,CARANGAS,estado nutricional en menores de 5 anos,clasificacion d,2002-10-01,0,2,0,2,2
60302,CARAPARI,estado nutricional en menores de 5 anos,clasificacion d,2002-10-01,42,61,42,61,103
50702,CARIPUYO,estado nutricional en menores de 5 anos,clasificacion d,2002-10-01,35,87,35,87,122
21803,CHACARILLA,estado nutricional en menores de 5 anos,clasificacion d,2002-10-01,1,0,1,0,1
40201,CHALLAPATA,estado nutricional en menores de 5 anos,clasificacion d,2002-10-01,48,102,48,102,150
50302,CHAQUI,estado nutricional en menores de 5 anos,clasificacion d,2002-10-01,61,87,61,87,148
70702,CHARAGUA,estado nutricional en menores de 5 anos,clasificacion d,2002-10-01,36,169,36,169,205
20305,CHARAÃ‘A,estado nutricional en menores de 5 anos,clasificacion d,2002-10-01,11,7,11,7,18
50202,CHAYANTA,estado nutricional en menores de 5 anos,clasificacion d,2002-10-01,39,58,39,58,97
31204,CHIMORE,estado nutricional en menores de 5 anos,clasificacion d,2002-10-01,12,17,12,17,29
40302,CHOQUE COTA,estado nutricional en menores de 5 anos,clasificacion d,2002-10-01,5,12,5,12,17
21101,CHULUMANI (V. DE LA LIBERTAD),estado nutricional en menores de 5 anos,clasificacion d,2002-10-01,4,14,4,14,18
20501,CHUMA,estado nutricional en menores de 5 anos,clasificacion d,2002-10-01,27,17,27,17,44
30801,CLIZA,estado nutricional en menores de 5 anos,clasificacion d,2002-10-01,14,34,14,34,48
90101,COBIJA,estado nutricional en menores de 5 anos,clasificacion d,2002-10-01,104,112,104,112,216
30101,COCHABAMBA,estado nutricional en menores de 5 anos,clasificacion d,2002-10-01,470,510,470,510,980
40902,COIPASA,estado nutricional en menores de 5 anos,clasificacion d,2002-10-01,1,2,1,2,3
30905,COLCAPIRHUA,estado nutricional en menores de 5 anos,clasificacion d,2002-10-01,46,68,46,68,114
50901,"COLCHA ""K""",estado nutricional en menores de 5 anos,clasificacion d,2002-10-01,65,84,65,84,149
21307,COLLANA,estado nutricional en menores de 5 anos,clasificacion d,2002-10-01,6,2,6,2,8
31002,COLOMI,estado nutricional en menores de 5 anos,clasificacion d,2002-10-01,34,82,34,82,116
50401,COLQUECHACA,estado nutricional en menores de 5 anos,clasificacion d,2002-10-01,192,206,192,206,398
21306,COLQUENCHA,estado nutricional en menores de 5 anos,clasificacion d,2002-10-01,29,37,29,37,66
21004,COLQUIRI,estado nutricional en menores de 5 anos,clasificacion d,2002-10-01,104,80,104,80,184
20304,COMANCHE,estado nutricional en menores de 5 anos,clasificacion d,2002-10-01,9,24,9,24,33
71301,COMARAPA,estado nutricional en menores de 5 anos,clasificacion d,2002-10-01,58,68,58,68,126
20605,COMBAYA,estado nutricional en menores de 5 anos,clasificacion d,2002-10-01,12,24,12,24,36
71101,CONCEPCION,estado nutricional en menores de 5 anos,clasificacion d,2002-10-01,74,30,74,30,104
21701,COPACABANA,estado nutricional en menores de 5 anos,clasificacion d,2002-10-01,46,31,46,31,77
21402,CORIPATA,estado nutricional en menores de 5 anos,clasificacion d,2002-10-01,2,10,2,10,12
20301,CORO CORO,estado nutricional en menores de 5 anos,clasificacion d,2002-10-01,19,23,19,23,42
21401,COROICO,estado nutricional en menores de 5 anos,clasificacion d,2002-10-01,20,18,20,18,38
40301,CORQUE,estado nutricional en menores de 5 anos,clasificacion d,2002-10-01,15,27,15,27,42
50601,COTAGAITA,estado nutricional en menores de 5 anos,clasificacion d,2002-10-01,127,300,127,300,427
70102,COTOCA,estado nutricional en menores de 5 anos,clasificacion d,2002-10-01,97,38,97,38,135
31405,CUCHUMUELA (V. G. VILLARROEL),estado nutricional en menores de 5 anos,clasificacion d,2002-10-01,11,10,11,10,21
70704,CUEVO,estado nutricional en menores de 5 anos,clasificacion d,2002-10-01,22,24,22,24,46
10902,CULPINA,estado nutricional en menores de 5 anos,clasificacion d,2002-10-01,184,216,184,216,400
40401,CURAHUARA DE CARANGAS,estado nutricional en menores de 5 anos,clasificacion d,2002-10-01,11,13,11,13,24
21602,CURVA,estado nutricional en menores de 5 anos,clasificacion d,2002-10-01,20,13,20,13,33
20804,DESAGUADERO,estado nutricional en menores de 5 anos,clasificacion d,2002-10-01,16,15,16,15,31
20105,EL ALTO,estado nutricional en menores de 5 anos,clasificacion d,2002-10-01,1970,1594,1970,1594,3564
40103,EL CHORO,estado nutricional en menores de 5 anos,clasificacion d,2002-10-01,4,5,4,5,9
71503,EL PUENTE(STC),estado nutricional en menores de 5 anos,clasificacion d,2002-10-01,12,95,12,95,107
60502,EL PUENTE(TJA),estado nutricional en menores de 5 anos,clasificacion d,2002-10-01,84,193,84,193,277
70105,EL TORNO,estado nutricional en menores de 5 anos,clasificacion d,2002-10-01,54,70,54,70,124
10405,EL VILLAR,estado nutricional en menores de 5 anos,clasificacion d,2002-10-01,46,130,46,130,176
60601,ENTRE RIOS,estado nutricional en menores de 5 anos,clasificacion d,2002-10-01,65,98,65,98,163
41101,EUCALIPTUS,estado nutricional en menores de 5 anos,clasificacion d,2002-10-01,15,10,15,10,25
80402,EXALTACION,estado nutricional en menores de 5 anos,clasificacion d,2002-10-01,2,2,2,2,4
90203,FILADELFIA,estado nutricional en menores de 5 anos,clasificacion d,2002-10-01,0,11,0,11,11
71002,GENERAL SAAVEDRA,estado nutricional en menores de 5 anos,clasificacion d,2002-10-01,60,118,60,118,178
21601,GRAL. J.J. PEREZ (CHARAZANI),estado nutricional en menores de 5 anos,clasificacion d,2002-10-01,34,85,34,85,119
20602,GUANAY,estado nutricional en menores de 5 anos,clasificacion d,2002-10-01,107,111,107,111,218
20802,GUAQUI,estado nutricional en menores de 5 anos,clasificacion d,2002-10-01,14,6,14,6,20
80202,GUAYARAMERIN,estado nutricional en menores de 5 anos,clasificacion d,2002-10-01,117,118,117,118,235
70705,GUTIERREZ,estado nutricional en menores de 5 anos,clasificacion d,2002-10-01,62,146,62,146,208
10502,HUACARETA,estado nutricional en menores de 5 anos,clasificacion d,2002-10-01,80,121,80,121,201
11002,HUACAYA (VILLA DE HUACAYA),estado nutricional en menores de 5 anos,clasificacion d,2002-10-01,4,26,4,26,30
40501,HUACHACALLA,estado nutricional en menores de 5 anos,clasificacion d,2002-10-01,0,12,0,12,12
40701,HUANUNI,estado nutricional en menores de 5 anos,clasificacion d,2002-10-01,96,96,96,96,192
80803,HUARACAJE,estado nutricional en menores de 5 anos,clasificacion d,2002-10-01,7,9,7,9,16
41601,HUAYLLAMARCA,estado nutricional en menores de 5 anos,clasificacion d,2002-10-01,17,23,17,23,40
21005,ICHOCA,estado nutricional en menores de 5 anos,clasificacion d,2002-10-01,30,30,30,30,60
10304,ICLA,estado nutricional en menores de 5 anos,clasificacion d,2002-10-01,108,179,108,179,287
10703,INCAHUASI,estado nutricional en menores de 5 anos,clasificacion d,2002-10-01,102,95,102,95,197
21001,INQUISIVI,estado nutricional en menores de 5 anos,clasificacion d,2002-10-01,90,64,90,64,154
21102,IRUPANA (VILLA DE LANZA),estado nutricional en menores de 5 anos,clasificacion d,2002-10-01,13,37,13,37,50
21501,IXIAMAS,estado nutricional en menores de 5 anos,clasificacion d,2002-10-01,34,50,34,50,84
21105,LA ASUNTA,estado nutricional en menores de 5 anos,clasificacion d,2002-10-01,39,21,39,21,60
70104,LA GUARDIA,estado nutricional en menores de 5 anos,clasificacion d,2002-10-01,47,47,47,47,94
20101,LA PAZ,estado nutricional en menores de 5 anos,clasificacion d,2002-10-01,1357,1152,1357,1152,2509
41501,LA RIVERA,estado nutricional en menores de 5 anos,clasificacion d,2002-10-01,1,0,1,0,1
70701,LAGUNILLAS,estado nutricional en menores de 5 anos,clasificacion d,2002-10-01,32,50,32,50,82
21202,LAJA,estado nutricional en menores de 5 anos,clasificacion d,2002-10-01,50,37,50,37,87
10903,LAS CARRERAS,estado nutricional en menores de 5 anos,clasificacion d,2002-10-01,38,46,38,46,84
21006,LICOMA PAMPA,estado nutricional en menores de 5 anos,clasificacion d,2002-10-01,13,14,13,14,27
50203,LLALLAGUA,estado nutricional en menores de 5 anos,clasificacion d,2002-10-01,20,182,20,182,202
51401,LLICA,estado nutricional en menores de 5 anos,clasificacion d,2002-10-01,16,11,16,11,27
80601,LORETO,estado nutricional en menores de 5 anos,clasificacion d,2002-10-01,11,14,11,14,25
20901,LURIBAY,estado nutricional en menores de 5 anos,clasificacion d,2002-10-01,34,32,34,32,66
40702,MACHACAMARCA,estado nutricional en menores de 5 anos,clasificacion d,2002-10-01,12,8,12,8,20
11003,MACHARETI,estado nutricional en menores de 5 anos,clasificacion d,2002-10-01,60,121,60,121,181
80801,MAGDALENA,estado nutricional en menores de 5 anos,clasificacion d,2002-10-01,23,32,23,32,55
70903,MAIRANA,estado nutricional en menores de 5 anos,clasificacion d,2002-10-01,19,23,19,23,42
20904,MALLA,estado nutricional en menores de 5 anos,clasificacion d,2002-10-01,5,6,5,6,11
20103,MECAPACA,estado nutricional en menores de 5 anos,clasificacion d,2002-10-01,25,47,25,47,72
71003,MINEROS,estado nutricional en menores de 5 anos,clasificacion d,2002-10-01,119,76,119,76,195
31301,MIZQUE,estado nutricional en menores de 5 anos,clasificacion d,2002-10-01,57,85,57,85,142
20402,MOCOMOCO,estado nutricional en menores de 5 anos,clasificacion d,2002-10-01,63,51,63,51,114
51002,MOJINETE,estado nutricional en menores de 5 anos,clasificacion d,2002-10-01,4,13,4,13,17
10303,MOJOCOYA,estado nutricional en menores de 5 anos,clasificacion d,2002-10-01,91,146,91,146,237
10501,MONTEAGUDO,estado nutricional en menores de 5 anos,clasificacion d,2002-10-01,145,227,145,227,372
71001,MONTERO,estado nutricional en menores de 5 anos,clasificacion d,2002-10-01,340,238,340,238,578
70803,MORO MORO,estado nutricional en menores de 5 anos,clasificacion d,2002-10-01,17,18,17,18,35
30302,MOROCHATA,estado nutricional en menores de 5 anos,clasificacion d,2002-10-01,76,113,76,113,189
90401,NACEBE (SANTA ROSA DEL ABUNA),estado nutricional en menores de 5 anos,clasificacion d,2002-10-01,3,10,3,10,13
20307,NAZACARA DE PACAJES,estado nutricional en menores de 5 anos,clasificacion d,2002-10-01,7,1,7,1,8
90501,NUEVO MANOA (NUEVA ESPERANZA),estado nutricional en menores de 5 anos,clasificacion d,2002-10-01,2,7,2,7,9
50404,OCURI,estado nutricional en menores de 5 anos,clasificacion d,2002-10-01,73,72,73,72,145
70202,OKINAWA,estado nutricional en menores de 5 anos,clasificacion d,2002-10-01,9,15,9,15,24
30203,OMEREQUE,estado nutricional en menores de 5 anos,clasificacion d,2002-10-01,0,38,0,38,38
40101,ORURO,estado nutricional en menores de 5 anos,clasificacion d,2002-10-01,699,559,699,559,1258
60201,PADCAYA,estado nutricional en menores de 5 anos,clasificacion d,2002-10-01,54,63,54,63,117
10401,PADILLA,estado nutricional en menores de 5 anos,clasificacion d,2002-10-01,132,248,132,248,380
70502,PAILON,estado nutricional en menores de 5 anos,clasificacion d,2002-10-01,20,17,20,17,37
20102,PALCA,estado nutricional en menores de 5 anos,clasificacion d,2002-10-01,29,48,29,48,77
21104,PALOS BLANCOS,estado nutricional en menores de 5 anos,clasificacion d,2002-10-01,73,72,73,72,145
40802,PAMPA AULLAGAS,estado nutricional en menores de 5 anos,clasificacion d,2002-10-01,12,28,12,28,40
70902,PAMPA GRANDE,estado nutricional en menores de 5 anos,clasificacion d,2002-10-01,22,30,22,30,52
21802,PAPEL PAMPA,estado nutricional en menores de 5 anos,clasificacion d,2002-10-01,11,11,11,11,22
30202,PASORAPA,estado nutricional en menores de 5 anos,clasificacion d,2002-10-01,23,38,23,38,61
21305,PATACAMAYA,estado nutricional en menores de 5 anos,clasificacion d,2002-10-01,66,45,66,45,111
40602,PAZÃ‘A,estado nutricional en menores de 5 anos,clasificacion d,2002-10-01,5,11,5,11,16
20702,PELECHUCO,estado nutricional en menores de 5 anos,clasificacion d,2002-10-01,24,21,24,21,45
50403,POCOATA,estado nutricional en menores de 5 anos,clasificacion d,2002-10-01,187,254,187,254,441
31203,POCONA,estado nutricional en menores de 5 anos,clasificacion d,2002-10-01,40,59,40,59,99
31202,POJO (CBBA),estado nutricional en menores de 5 anos,clasificacion d,2002-10-01,153,120,153,120,273
40601,POOPO,estado nutricional en menores de 5 anos,clasificacion d,2002-10-01,20,26,20,26,46
51203,PORCO,estado nutricional en menores de 5 anos,clasificacion d,2002-10-01,42,64,42,64,106
10103,POROMA,estado nutricional en menores de 5 anos,clasificacion d,2002-10-01,139,209,139,209,348
70103,PORONGO,estado nutricional en menores de 5 anos,clasificacion d,2002-10-01,16,15,16,15,31
70601,PORTACHUELO,estado nutricional en menores de 5 anos,clasificacion d,2002-10-01,54,30,54,30,84
90102,PORVENIR,estado nutricional en menores de 5 anos,clasificacion d,2002-10-01,7,1,7,1,8
70804,POSTRER VALLE,estado nutricional en menores de 5 anos,clasificacion d,2002-10-01,5,13,5,13,18
50101,POTOSI,estado nutricional en menores de 5 anos,clasificacion d,2002-10-01,592,541,592,541,1133
10302,PRESTO,estado nutricional en menores de 5 anos,clasificacion d,2002-10-01,78,108,78,108,186
70805,PUCARA,estado nutricional en menores de 5 anos,clasificacion d,2002-10-01,3,10,3,10,13
21201,PUCARANI,estado nutricional en menores de 5 anos,clasificacion d,2002-10-01,47,56,47,56,103
20401,PUERTO ACOSTA,estado nutricional en menores de 5 anos,clasificacion d,2002-10-01,99,86,99,86,185
20403,PUERTO CARABUCO,estado nutricional en menores de 5 anos,clasificacion d,2002-10-01,54,53,54,53,107
90301,PUERTO GONZALO MORENO,estado nutricional en menores de 5 anos,clasificacion d,2002-10-01,6,10,6,10,16
21204,PUERTO PEREZ,estado nutricional en menores de 5 anos,clasificacion d,2002-10-01,28,21,28,21,49
71402,PUERTO QUIJARRO,estado nutricional en menores de 5 anos,clasificacion d,2002-10-01,15,17,15,17,32
90201,PUERTO RICO,estado nutricional en menores de 5 anos,clasificacion d,2002-10-01,10,19,10,19,29
80703,PUERTO SILES,estado nutricional en menores de 5 anos,clasificacion d,2002-10-01,0,1,0,1,1
71401,PUERTO SUAREZ,estado nutricional en menores de 5 anos,clasificacion d,2002-10-01,68,25,68,25,93
31205,PUERTO VILLARROEL,estado nutricional en menores de 5 anos,clasificacion d,2002-10-01,163,132,163,132,295
51101,PUNA,estado nutricional en menores de 5 anos,clasificacion d,2002-10-01,53,68,53,68,121
31401,PUNATA,estado nutricional en menores de 5 anos,clasificacion d,2002-10-01,182,77,182,77,259
20604,QUIABAYA,estado nutricional en menores de 5 anos,clasificacion d,2002-10-01,14,44,14,44,58
30901,QUILLACOLLO,estado nutricional en menores de 5 anos,clasificacion d,2002-10-01,147,172,147,172,319
21002,QUIME,estado nutricional en menores de 5 anos,clasificacion d,2002-10-01,68,87,68,87,155
70904,QUIRUSILLAS,estado nutricional en menores de 5 anos,clasificacion d,2002-10-01,0,1,0,1,1
50402,RAVELO,estado nutricional en menores de 5 anos,clasificacion d,2002-10-01,181,199,181,199,380
80301,REYES,estado nutricional en menores de 5 anos,clasificacion d,2002-10-01,23,31,23,31,54
80201,RIBERALTA,estado nutricional en menores de 5 anos,clasificacion d,2002-10-01,451,317,451,317,768
70503,ROBORE,estado nutricional en menores de 5 anos,clasificacion d,2002-10-01,21,29,21,29,50
80304,RURRENABAQUE,estado nutricional en menores de 5 anos,clasificacion d,2002-10-01,31,5,31,5,36
40901,SABAYA,estado nutricional en menores de 5 anos,clasificacion d,2002-10-01,3,5,3,5,8
31001,SACABA,estado nutricional en menores de 5 anos,clasificacion d,2002-10-01,196,87,196,87,283
30404,SACABAMBA,estado nutricional en menores de 5 anos,clasificacion d,2002-10-01,25,70,25,70,95
50701,SACACA,estado nutricional en menores de 5 anos,clasificacion d,2002-10-01,127,290,127,290,417
71302,SAIPINA,estado nutricional en menores de 5 anos,clasificacion d,2002-10-01,12,9,12,9,21
40801,SALINAS DE GARCI MENDOZA,estado nutricional en menores de 5 anos,clasificacion d,2002-10-01,13,17,13,17,30
70901,SAMAIPATA,estado nutricional en menores de 5 anos,clasificacion d,2002-10-01,21,21,21,21,42
51601,SAN AGUSTIN,estado nutricional en menores de 5 anos,clasificacion d,2002-10-01,4,5,4,5,9
80602,SAN ANDRES,estado nutricional en menores de 5 anos,clasificacion d,2002-10-01,14,37,14,37,51
51003,SAN ANTONIO DE ESMORUCO,estado nutricional en menores de 5 anos,clasificacion d,2002-10-01,6,20,6,20,26
71105,SAN ANTONIO DE LOMERIO,estado nutricional en menores de 5 anos,clasificacion d,2002-10-01,86,145,86,145,231
31403,SAN BENITO,estado nutricional en menores de 5 anos,clasificacion d,2002-10-01,12,33,12,33,45
80302,SAN BORJA,estado nutricional en menores de 5 anos,clasificacion d,2002-10-01,137,147,137,147,284
21502,SAN BUENA VENTURA,estado nutricional en menores de 5 anos,clasificacion d,2002-10-01,27,25,27,25,52
80501,SAN IGNACIO,estado nutricional en menores de 5 anos,clasificacion d,2002-10-01,129,99,129,99,228
70301,SAN IGNACIO DE VELASCO,estado nutricional en menores de 5 anos,clasificacion d,2002-10-01,196,189,196,189,385
80102,SAN JAVIER(BNI),estado nutricional en menores de 5 anos,clasificacion d,2002-10-01,1,18,1,18,19
71102,SAN JAVIER(STC),estado nutricional en menores de 5 anos,clasificacion d,2002-10-01,49,63,49,63,112
80701,SAN JOAQUIN,estado nutricional en menores de 5 anos,clasificacion d,2002-10-01,9,14,9,14,23
70501,SAN JOSE DE CHIQUITOS,estado nutricional en menores de 5 anos,clasificacion d,2002-10-01,53,22,53,22,75
71104,SAN JULIAN,estado nutricional en menores de 5 anos,clasificacion d,2002-10-01,166,197,166,197,363
90302,SAN LORENZO(PND),estado nutricional en menores de 5 anos,clasificacion d,2002-10-01,4,36,4,36,40
60501,SAN LORENZO(TJA),estado nutricional en menores de 5 anos,clasificacion d,2002-10-01,36,20,36,20,56
10702,SAN LUCAS,estado nutricional en menores de 5 anos,clasificacion d,2002-10-01,481,481,481,481,962
71201,SAN MATIAS,estado nutricional en menores de 5 anos,clasificacion d,2002-10-01,66,40,66,40,106
70302,SAN MIGUEL DE VELASCO,estado nutricional en menores de 5 anos,clasificacion d,2002-10-01,85,141,85,141,226
51001,SAN PABLO DE LIPEZ,estado nutricional en menores de 5 anos,clasificacion d,2002-10-01,8,27,8,27,35
50501,SAN PEDRO DE BUENA VISTA,estado nutricional en menores de 5 anos,clasificacion d,2002-10-01,81,196,81,196,277
21801,SAN PEDRO DE CURAHUARA,estado nutricional en menores de 5 anos,clasificacion d,2002-10-01,23,35,23,35,58
50902,SAN PEDRO DE QUEMES,estado nutricional en menores de 5 anos,clasificacion d,2002-10-01,6,3,6,3,9
21702,SAN PEDRO DE TIQUINA,estado nutricional en menores de 5 anos,clasificacion d,2002-10-01,4,6,4,6,10
90202,SAN PEDRO(PND),estado nutricional en menores de 5 anos,clasificacion d,2002-10-01,4,1,4,1,5
70303,SAN RAFAEL,estado nutricional en menores de 5 anos,clasificacion d,2002-10-01,37,39,37,39,76
80702,SAN RAMON,estado nutricional en menores de 5 anos,clasificacion d,2002-10-01,14,4,14,4,18
80401,SANTA ANA,estado nutricional en menores de 5 anos,clasificacion d,2002-10-01,25,3,25,3,28
70101,SANTA CRUZ DE LA SIERRA,estado nutricional en menores de 5 anos,clasificacion d,2002-10-01,1052,640,1052,640,1692
80303,SANTA ROSA,estado nutricional en menores de 5 anos,clasificacion d,2002-10-01,7,17,7,17,24
70602,SANTA ROSA DEL SARA,estado nutricional en menores de 5 anos,clasificacion d,2002-10-01,12,16,12,16,28
20308,SANTIAGO DE CALLAPA,estado nutricional en menores de 5 anos,clasificacion d,2002-10-01,38,24,38,24,62
41401,SANTIAGO DE HUARI,estado nutricional en menores de 5 anos,clasificacion d,2002-10-01,22,38,22,38,60
21901,SANTIAGO DE MACHACA,estado nutricional en menores de 5 anos,clasificacion d,2002-10-01,10,10,10,10,20
30702,SANTIVAÃ‘ES,estado nutricional en menores de 5 anos,clasificacion d,2002-10-01,19,12,19,12,31
40202,SANTUARIO DE QUILLACAS,estado nutricional en menores de 5 anos,clasificacion d,2002-10-01,6,16,6,16,22
20902,SAPAHAQUI,estado nutricional en menores de 5 anos,clasificacion d,2002-10-01,47,41,47,41,88
90303,SENA,estado nutricional en menores de 5 anos,clasificacion d,2002-10-01,22,12,22,12,34
21301,SICA SICA (VILLA AROMA),estado nutricional en menores de 5 anos,clasificacion d,2002-10-01,59,57,59,57,116
30703,SICAYA,estado nutricional en menores de 5 anos,clasificacion d,2002-10-01,26,16,26,16,42
30902,SIPE SIPE,estado nutricional en menores de 5 anos,clasificacion d,2002-10-01,149,112,149,112,261
10403,SOPACHUY,estado nutricional en menores de 5 anos,clasificacion d,2002-10-01,57,82,57,82,139
20601,SORATA,estado nutricional en menores de 5 anos,clasificacion d,2002-10-01,75,113,75,113,188
10101,SUCRE,estado nutricional en menores de 5 anos,clasificacion d,2002-10-01,746,832,746,832,1578
31404,TACACHI,estado nutricional en menores de 5 anos,clasificacion d,2002-10-01,1,10,1,10,11
20603,TACACOMA,estado nutricional en menores de 5 anos,clasificacion d,2002-10-01,20,34,20,34,54
50303,TACOBAMBA,estado nutricional en menores de 5 anos,clasificacion d,2002-10-01,66,109,66,109,175
30602,TACOPAYA,estado nutricional en menores de 5 anos,clasificacion d,2002-10-01,55,163,55,163,218
51402,TAHUA,estado nutricional en menores de 5 anos,clasificacion d,2002-10-01,2,0,2,0,2
31101,TAPACARI,estado nutricional en menores de 5 anos,clasificacion d,2002-10-01,114,145,114,145,259
10601,TARABUCO,estado nutricional en menores de 5 anos,clasificacion d,2002-10-01,278,480,278,480,758
30401,TARATA,estado nutricional en menores de 5 anos,clasificacion d,2002-10-01,46,38,46,38,84
60101,TARIJA,estado nutricional en menores de 5 anos,clasificacion d,2002-10-01,310,301,310,301,611
10202,TARVITA,estado nutricional en menores de 5 anos,clasificacion d,2002-10-01,123,204,123,204,327
20803,TIAWANACU,estado nutricional en menores de 5 anos,clasificacion d,2002-10-01,20,23,20,23,43
50102,TINGUIPAYA,estado nutricional en menores de 5 anos,clasificacion d,2002-10-01,104,222,104,222,326
20606,TIPUANI,estado nutricional en menores de 5 anos,clasificacion d,2002-10-01,24,12,24,12,36
30903,TIQUIPAYA,estado nutricional en menores de 5 anos,clasificacion d,2002-10-01,91,97,91,97,188
31601,TIRAQUE (CBBA),estado nutricional en menores de 5 anos,clasificacion d,2002-10-01,99,194,99,194,293
21703,TITO YUPANQUI (PARQUIPUJIO),estado nutricional en menores de 5 anos,clasificacion d,2002-10-01,0,19,0,19,19
30802,TOCO,estado nutricional en menores de 5 anos,clasificacion d,2002-10-01,3,17,3,17,20
30803,TOLATA,estado nutricional en menores de 5 anos,clasificacion d,2002-10-01,3,0,3,0,3
41001,TOLEDO,estado nutricional en menores de 5 anos,clasificacion d,2002-10-01,9,12,9,12,21
51202,TOMAVE,estado nutricional en menores de 5 anos,clasificacion d,2002-10-01,64,78,64,78,142
10402,TOMINA,estado nutricional en menores de 5 anos,clasificacion d,2002-10-01,97,207,97,207,304
50502,TORO TORO,estado nutricional en menores de 5 anos,clasificacion d,2002-10-01,53,64,53,64,117
31201,TOTORA(CBBA),estado nutricional en menores de 5 anos,clasificacion d,2002-10-01,54,47,54,47,101
41301,TOTORA(ORR),estado nutricional en menores de 5 anos,clasificacion d,2002-10-01,12,8,12,8,20
70802,TRIGAL,estado nutricional en menores de 5 anos,clasificacion d,2002-10-01,4,5,4,5,9
80101,TRINIDAD,estado nutricional en menores de 5 anos,clasificacion d,2002-10-01,114,217,114,217,331
50801,TUPIZA,estado nutricional en menores de 5 anos,clasificacion d,2002-10-01,68,411,68,411,479
40402,TURCO,estado nutricional en menores de 5 anos,clasificacion d,2002-10-01,7,9,7,9,16
21302,UMALA,estado nutricional en menores de 5 anos,clasificacion d,2002-10-01,18,7,18,7,25
50201,UNCIA,estado nutricional en menores de 5 anos,clasificacion d,2002-10-01,4,0,4,0,4
60401,URIONDO (A. CONCEPCION),estado nutricional en menores de 5 anos,clasificacion d,2002-10-01,25,31,25,31,56
71502,URUBICHA,estado nutricional en menores de 5 anos,clasificacion d,2002-10-01,105,184,105,184,289
51201,UYUNI,estado nutricional en menores de 5 anos,clasificacion d,2002-10-01,82,130,82,130,212
30502,VACAS,estado nutricional en menores de 5 anos,clasificacion d,2002-10-01,37,54,37,54,91
70801,VALLEGRANDE,estado nutricional en menores de 5 anos,clasificacion d,2002-10-01,65,85,65,85,150
20801,VIACHA,estado nutricional en menores de 5 anos,clasificacion d,2002-10-01,106,114,106,114,220
31302,VILA VILA,estado nutricional en menores de 5 anos,clasificacion d,2002-10-01,17,95,17,95,112
60303,VILLA MONTES,estado nutricional en menores de 5 anos,clasificacion d,2002-10-01,49,59,49,59,108
90502,VILLA NUEVA (LOMA ALTA),estado nutricional en menores de 5 anos,clasificacion d,2002-10-01,1,0,1,0,1
31402,VILLA RIVERO,estado nutricional en menores de 5 anos,clasificacion d,2002-10-01,12,23,12,23,35
10801,VILLA SERRANO,estado nutricional en menores de 5 anos,clasificacion d,2002-10-01,107,242,107,242,349
31003,VILLA TUNARI,estado nutricional en menores de 5 anos,clasificacion d,2002-10-01,132,147,132,147,279
11001,VILLA VACA GUZMAN (MUYUPAMPA),estado nutricional en menores de 5 anos,clasificacion d,2002-10-01,59,117,59,117,176
51501,VILLAZON,estado nutricional en menores de 5 anos,clasificacion d,2002-10-01,147,233,147,233,380
30904,VINTO,estado nutricional en menores de 5 anos,clasificacion d,2002-10-01,77,39,77,39,116
50602,VITICHI,estado nutricional en menores de 5 anos,clasificacion d,2002-10-01,61,150,61,150,211
20306,WALDO BALLIVIAN,estado nutricional en menores de 5 anos,clasificacion d,2002-10-01,5,3,5,3,8
70201,WARNES,estado nutricional en menores de 5 anos,clasificacion d,2002-10-01,113,94,113,94,207
20903,YACO,estado nutricional en menores de 5 anos,clasificacion d,2002-10-01,32,59,32,59,91
60301,YACUIBA,estado nutricional en menores de 5 anos,clasificacion d,2002-10-01,99,112,99,112,211
10602,YAMPARAEZ,estado nutricional en menores de 5 anos,clasificacion d,2002-10-01,129,215,129,215,344
21103,YANACACHI,estado nutricional en menores de 5 anos,clasificacion d,2002-10-01,13,16,13,16,29
50103,YOCALLA,estado nutricional en menores de 5 anos,clasificacion d,2002-10-01,43,68,43,68,111
10102,YOTALA,estado nutricional en menores de 5 anos,clasificacion d,2002-10-01,105,191,105,191,296
60402,YUNCHARA,estado nutricional en menores de 5 anos,clasificacion d,2002-10-01,26,49,26,49,75
10301,ZUDAÃ‘EZ,estado nutricional en menores de 5 anos,clasificacion d,2002-10-01,75,125,75,125,200
51302,ACACIO,estado nutricional en menores de 5 anos,clasificacion d,2002-11-01,31,109,31,109,140
20201,ACHACACHI,estado nutricional en menores de 5 anos,clasificacion d,2002-11-01,187,196,187,196,383
20104,ACHOCALLA,estado nutricional en menores de 5 anos,clasificacion d,2002-11-01,32,18,32,18,50
30201,AIQUILE,estado nutricional en menores de 5 anos,clasificacion d,2002-11-01,58,84,58,84,142
31303,ALALAY,estado nutricional en menores de 5 anos,clasificacion d,2002-11-01,16,64,16,64,80
10404,ALCALA,estado nutricional en menores de 5 anos,clasificacion d,2002-11-01,32,72,32,72,104
20202,ANCORAIMES,estado nutricional en menores de 5 anos,clasificacion d,2002-11-01,78,136,78,136,214
41201,ANDAMARCA,estado nutricional en menores de 5 anos,clasificacion d,2002-11-01,8,3,8,3,11
40603,ANTEQUERA,estado nutricional en menores de 5 anos,clasificacion d,2002-11-01,4,4,4,4,8
30402,ANZALDO,estado nutricional en menores de 5 anos,clasificacion d,2002-11-01,11,81,11,81,92
20701,APOLO,estado nutricional en menores de 5 anos,clasificacion d,2002-11-01,64,66,64,66,130
51301,ARAMPAMPA,estado nutricional en menores de 5 anos,clasificacion d,2002-11-01,35,71,35,71,106
30501,ARANI,estado nutricional en menores de 5 anos,clasificacion d,2002-11-01,34,14,34,14,48
30403,ARBIETO,estado nutricional en menores de 5 anos,clasificacion d,2002-11-01,7,4,7,4,11
30601,ARQUE,estado nutricional en menores de 5 anos,clasificacion d,2002-11-01,37,31,37,31,68
50802,ATOCHA,estado nutricional en menores de 5 anos,clasificacion d,2002-11-01,1,99,1,99,100
20503,AUCAPATA,estado nutricional en menores de 5 anos,clasificacion d,2002-11-01,25,7,25,7,32
20502,AYATA,estado nutricional en menores de 5 anos,clasificacion d,2002-11-01,25,18,25,18,43
21303,AYO AYO,estado nutricional en menores de 5 anos,clasificacion d,2002-11-01,9,4,9,4,13
30301,AYOPAYA (V. DE INDEPENDENCIA),estado nutricional en menores de 5 anos,clasificacion d,2002-11-01,107,161,107,161,268
10201,AZURDUY,estado nutricional en menores de 5 anos,clasificacion d,2002-11-01,103,169,103,169,272
21203,BATALLAS,estado nutricional en menores de 5 anos,clasificacion d,2002-11-01,46,22,46,22,68
80802,BAURES,estado nutricional en menores de 5 anos,clasificacion d,2002-11-01,21,29,21,29,50
41202,BELEN DE ANDAMARCA,estado nutricional en menores de 5 anos,clasificacion d,2002-11-01,1,2,1,2,3
50104,BELEN DE URMIRI,estado nutricional en menores de 5 anos,clasificacion d,2002-11-01,9,17,9,17,26
90104,BELLA FLOR,estado nutricional en menores de 5 anos,clasificacion d,2002-11-01,0,8,0,8,8
60202,BERMEJO,estado nutricional en menores de 5 anos,clasificacion d,2002-11-01,11,10,11,10,21
50301,BETANZOS,estado nutricional en menores de 5 anos,clasificacion d,2002-11-01,336,449,336,449,785
31501,BOLIVAR,estado nutricional en menores de 5 anos,clasificacion d,2002-11-01,95,94,95,94,189
90103,BOLPEBRA,estado nutricional en menores de 5 anos,clasificacion d,2002-11-01,5,19,5,19,24
70707,BOYUIBE,estado nutricional en menores de 5 anos,clasificacion d,2002-11-01,5,16,5,16,21
70401,BUENA VISTA,estado nutricional en menores de 5 anos,clasificacion d,2002-11-01,35,40,35,40,75
70703,CABEZAS,estado nutricional en menores de 5 anos,clasificacion d,2002-11-01,39,57,39,57,96
20905,CAIROMA,estado nutricional en menores de 5 anos,clasificacion d,2002-11-01,27,23,27,23,50
51102,"CAIZA ""D""",estado nutricional en menores de 5 anos,clasificacion d,2002-11-01,131,116,131,116,247
21003,CAJUATA,estado nutricional en menores de 5 anos,clasificacion d,2002-11-01,36,56,36,56,92
20303,CALACOTO,estado nutricional en menores de 5 anos,clasificacion d,2002-11-01,24,9,24,9,33
21304,CALAMARCA,estado nutricional en menores de 5 anos,clasificacion d,2002-11-01,86,66,86,66,152
10701,CAMARGO,estado nutricional en menores de 5 anos,clasificacion d,2002-11-01,46,91,46,91,137
10901,CAMATAQUI (C. VILLA ABECIA),estado nutricional en menores de 5 anos,clasificacion d,2002-11-01,19,25,19,25,44
70706,CAMIRI,estado nutricional en menores de 5 anos,clasificacion d,2002-11-01,115,78,115,78,193
30701,CAPINOTA,estado nutricional en menores de 5 anos,clasificacion d,2002-11-01,54,58,54,58,112
20302,CAQUIAVIRI,estado nutricional en menores de 5 anos,clasificacion d,2002-11-01,23,37,23,37,60
40102,CARACOLLO,estado nutricional en menores de 5 anos,clasificacion d,2002-11-01,21,122,21,122,143
22001,CARANAVI,estado nutricional en menores de 5 anos,clasificacion d,2002-11-01,181,150,181,150,331
60302,CARAPARI,estado nutricional en menores de 5 anos,clasificacion d,2002-11-01,17,39,17,39,56
50702,CARIPUYO,estado nutricional en menores de 5 anos,clasificacion d,2002-11-01,90,97,90,97,187
21902,CATACORA,estado nutricional en menores de 5 anos,clasificacion d,2002-11-01,6,6,6,6,12
21803,CHACARILLA,estado nutricional en menores de 5 anos,clasificacion d,2002-11-01,1,0,1,0,1
40201,CHALLAPATA,estado nutricional en menores de 5 anos,clasificacion d,2002-11-01,45,90,45,90,135
50302,CHAQUI,estado nutricional en menores de 5 anos,clasificacion d,2002-11-01,97,60,97,60,157
70702,CHARAGUA,estado nutricional en menores de 5 anos,clasificacion d,2002-11-01,23,173,23,173,196
20305,CHARAÃ‘A,estado nutricional en menores de 5 anos,clasificacion d,2002-11-01,11,12,11,12,23
50202,CHAYANTA,estado nutricional en menores de 5 anos,clasificacion d,2002-11-01,80,119,80,119,199
31204,CHIMORE,estado nutricional en menores de 5 anos,clasificacion d,2002-11-01,15,18,15,18,33
40903,CHIPAYA,estado nutricional en menores de 5 anos,clasificacion d,2002-11-01,1,0,1,0,1
21101,CHULUMANI (V. DE LA LIBERTAD),estado nutricional en menores de 5 anos,clasificacion d,2002-11-01,14,5,14,5,19
20501,CHUMA,estado nutricional en menores de 5 anos,clasificacion d,2002-11-01,39,40,39,40,79
30801,CLIZA,estado nutricional en menores de 5 anos,clasificacion d,2002-11-01,9,6,9,6,15
90101,COBIJA,estado nutricional en menores de 5 anos,clasificacion d,2002-11-01,37,38,37,38,75
30101,COCHABAMBA,estado nutricional en menores de 5 anos,clasificacion d,2002-11-01,408,419,408,419,827
30905,COLCAPIRHUA,estado nutricional en menores de 5 anos,clasificacion d,2002-11-01,36,25,36,25,61
50901,"COLCHA ""K""",estado nutricional en menores de 5 anos,clasificacion d,2002-11-01,47,73,47,73,120
21307,COLLANA,estado nutricional en menores de 5 anos,clasificacion d,2002-11-01,2,1,2,1,3
31002,COLOMI,estado nutricional en menores de 5 anos,clasificacion d,2002-11-01,24,39,24,39,63
50401,COLQUECHACA,estado nutricional en menores de 5 anos,clasificacion d,2002-11-01,132,108,132,108,240
21306,COLQUENCHA,estado nutricional en menores de 5 anos,clasificacion d,2002-11-01,29,14,29,14,43
21004,COLQUIRI,estado nutricional en menores de 5 anos,clasificacion d,2002-11-01,98,89,98,89,187
20304,COMANCHE,estado nutricional en menores de 5 anos,clasificacion d,2002-11-01,11,10,11,10,21
71301,COMARAPA,estado nutricional en menores de 5 anos,clasificacion d,2002-11-01,62,37,62,37,99
20605,COMBAYA,estado nutricional en menores de 5 anos,clasificacion d,2002-11-01,3,13,3,13,16
71101,CONCEPCION,estado nutricional en menores de 5 anos,clasificacion d,2002-11-01,19,15,19,15,34
21701,COPACABANA,estado nutricional en menores de 5 anos,clasificacion d,2002-11-01,61,45,61,45,106
21402,CORIPATA,estado nutricional en menores de 5 anos,clasificacion d,2002-11-01,7,8,7,8,15
20301,CORO CORO,estado nutricional en menores de 5 anos,clasificacion d,2002-11-01,27,32,27,32,59
21401,COROICO,estado nutricional en menores de 5 anos,clasificacion d,2002-11-01,37,16,37,16,53
40301,CORQUE,estado nutricional en menores de 5 anos,clasificacion d,2002-11-01,9,9,9,9,18
50601,COTAGAITA,estado nutricional en menores de 5 anos,clasificacion d,2002-11-01,83,149,83,149,232
70102,COTOCA,estado nutricional en menores de 5 anos,clasificacion d,2002-11-01,46,47,46,47,93
31405,CUCHUMUELA (V. G. VILLARROEL),estado nutricional en menores de 5 anos,clasificacion d,2002-11-01,1,6,1,6,7
70704,CUEVO,estado nutricional en menores de 5 anos,clasificacion d,2002-11-01,17,35,17,35,52
10902,CULPINA,estado nutricional en menores de 5 anos,clasificacion d,2002-11-01,175,219,175,219,394
40401,CURAHUARA DE CARANGAS,estado nutricional en menores de 5 anos,clasificacion d,2002-11-01,14,11,14,11,25
21602,CURVA,estado nutricional en menores de 5 anos,clasificacion d,2002-11-01,19,14,19,14,33
20804,DESAGUADERO,estado nutricional en menores de 5 anos,clasificacion d,2002-11-01,13,9,13,9,22
20105,EL ALTO,estado nutricional en menores de 5 anos,clasificacion d,2002-11-01,1941,1296,1941,1296,3237
40103,EL CHORO,estado nutricional en menores de 5 anos,clasificacion d,2002-11-01,5,6,5,6,11
71503,EL PUENTE(STC),estado nutricional en menores de 5 anos,clasificacion d,2002-11-01,31,81,31,81,112
60502,EL PUENTE(TJA),estado nutricional en menores de 5 anos,clasificacion d,2002-11-01,66,154,66,154,220
70105,EL TORNO,estado nutricional en menores de 5 anos,clasificacion d,2002-11-01,73,55,73,55,128
10405,EL VILLAR,estado nutricional en menores de 5 anos,clasificacion d,2002-11-01,44,109,44,109,153
60601,ENTRE RIOS,estado nutricional en menores de 5 anos,clasificacion d,2002-11-01,25,39,25,39,64
40502,ESCARA,estado nutricional en menores de 5 anos,clasificacion d,2002-11-01,0,1,0,1,1
41101,EUCALIPTUS,estado nutricional en menores de 5 anos,clasificacion d,2002-11-01,22,19,22,19,41
90503,EUREKA (SANTOS MERCADO),estado nutricional en menores de 5 anos,clasificacion d,2002-11-01,2,1,2,1,3
80402,EXALTACION,estado nutricional en menores de 5 anos,clasificacion d,2002-11-01,3,17,3,17,20
90203,FILADELFIA,estado nutricional en menores de 5 anos,clasificacion d,2002-11-01,3,7,3,7,10
71002,GENERAL SAAVEDRA,estado nutricional en menores de 5 anos,clasificacion d,2002-11-01,61,100,61,100,161
21601,GRAL. J.J. PEREZ (CHARAZANI),estado nutricional en menores de 5 anos,clasificacion d,2002-11-01,34,47,34,47,81
20602,GUANAY,estado nutricional en menores de 5 anos,clasificacion d,2002-11-01,84,72,84,72,156
20802,GUAQUI,estado nutricional en menores de 5 anos,clasificacion d,2002-11-01,9,6,9,6,15
80202,GUAYARAMERIN,estado nutricional en menores de 5 anos,clasificacion d,2002-11-01,77,81,77,81,158
70705,GUTIERREZ,estado nutricional en menores de 5 anos,clasificacion d,2002-11-01,100,142,100,142,242
10502,HUACARETA,estado nutricional en menores de 5 anos,clasificacion d,2002-11-01,67,101,67,101,168
11002,HUACAYA (VILLA DE HUACAYA),estado nutricional en menores de 5 anos,clasificacion d,2002-11-01,8,18,8,18,26
40501,HUACHACALLA,estado nutricional en menores de 5 anos,clasificacion d,2002-11-01,0,15,0,15,15
40701,HUANUNI,estado nutricional en menores de 5 anos,clasificacion d,2002-11-01,70,48,70,48,118
80803,HUARACAJE,estado nutricional en menores de 5 anos,clasificacion d,2002-11-01,9,5,9,5,14
41601,HUAYLLAMARCA,estado nutricional en menores de 5 anos,clasificacion d,2002-11-01,23,19,23,19,42
21005,ICHOCA,estado nutricional en menores de 5 anos,clasificacion d,2002-11-01,20,26,20,26,46
10304,ICLA,estado nutricional en menores de 5 anos,clasificacion d,2002-11-01,128,237,128,237,365
10703,INCAHUASI,estado nutricional en menores de 5 anos,clasificacion d,2002-11-01,215,136,215,136,351
21001,INQUISIVI,estado nutricional en menores de 5 anos,clasificacion d,2002-11-01,91,106,91,106,197
21102,IRUPANA (VILLA DE LANZA),estado nutricional en menores de 5 anos,clasificacion d,2002-11-01,11,25,11,25,36
21501,IXIAMAS,estado nutricional en menores de 5 anos,clasificacion d,2002-11-01,28,39,28,39,67
21105,LA ASUNTA,estado nutricional en menores de 5 anos,clasificacion d,2002-11-01,20,22,20,22,42
70104,LA GUARDIA,estado nutricional en menores de 5 anos,clasificacion d,2002-11-01,54,37,54,37,91
20101,LA PAZ,estado nutricional en menores de 5 anos,clasificacion d,2002-11-01,1156,1002,1156,1002,2158
70701,LAGUNILLAS,estado nutricional en menores de 5 anos,clasificacion d,2002-11-01,39,49,39,49,88
21202,LAJA,estado nutricional en menores de 5 anos,clasificacion d,2002-11-01,23,19,23,19,42
10903,LAS CARRERAS,estado nutricional en menores de 5 anos,clasificacion d,2002-11-01,31,40,31,40,71
21006,LICOMA PAMPA,estado nutricional en menores de 5 anos,clasificacion d,2002-11-01,17,4,17,4,21
50203,LLALLAGUA,estado nutricional en menores de 5 anos,clasificacion d,2002-11-01,40,210,40,210,250
51401,LLICA,estado nutricional en menores de 5 anos,clasificacion d,2002-11-01,10,25,10,25,35
80601,LORETO,estado nutricional en menores de 5 anos,clasificacion d,2002-11-01,14,28,14,28,42
20901,LURIBAY,estado nutricional en menores de 5 anos,clasificacion d,2002-11-01,36,15,36,15,51
40702,MACHACAMARCA,estado nutricional en menores de 5 anos,clasificacion d,2002-11-01,6,3,6,3,9
11003,MACHARETI,estado nutricional en menores de 5 anos,clasificacion d,2002-11-01,43,91,43,91,134
80801,MAGDALENA,estado nutricional en menores de 5 anos,clasificacion d,2002-11-01,12,12,12,12,24
70903,MAIRANA,estado nutricional en menores de 5 anos,clasificacion d,2002-11-01,25,13,25,13,38
20904,MALLA,estado nutricional en menores de 5 anos,clasificacion d,2002-11-01,13,17,13,17,30
20103,MECAPACA,estado nutricional en menores de 5 anos,clasificacion d,2002-11-01,18,30,18,30,48
71003,MINEROS,estado nutricional en menores de 5 anos,clasificacion d,2002-11-01,114,66,114,66,180
31301,MIZQUE,estado nutricional en menores de 5 anos,clasificacion d,2002-11-01,11,31,11,31,42
20402,MOCOMOCO,estado nutricional en menores de 5 anos,clasificacion d,2002-11-01,36,26,36,26,62
51002,MOJINETE,estado nutricional en menores de 5 anos,clasificacion d,2002-11-01,5,14,5,14,19
10303,MOJOCOYA,estado nutricional en menores de 5 anos,clasificacion d,2002-11-01,71,113,71,113,184
10501,MONTEAGUDO,estado nutricional en menores de 5 anos,clasificacion d,2002-11-01,130,183,130,183,313
71001,MONTERO,estado nutricional en menores de 5 anos,clasificacion d,2002-11-01,252,177,252,177,429
70803,MORO MORO,estado nutricional en menores de 5 anos,clasificacion d,2002-11-01,18,20,18,20,38
30302,MOROCHATA,estado nutricional en menores de 5 anos,clasificacion d,2002-11-01,47,150,47,150,197
90401,NACEBE (SANTA ROSA DEL ABUNA),estado nutricional en menores de 5 anos,clasificacion d,2002-11-01,2,0,2,0,2
20307,NAZACARA DE PACAJES,estado nutricional en menores de 5 anos,clasificacion d,2002-11-01,1,0,1,0,1
90501,NUEVO MANOA (NUEVA ESPERANZA),estado nutricional en menores de 5 anos,clasificacion d,2002-11-01,2,0,2,0,2
50404,OCURI,estado nutricional en menores de 5 anos,clasificacion d,2002-11-01,45,106,45,106,151
70202,OKINAWA,estado nutricional en menores de 5 anos,clasificacion d,2002-11-01,8,26,8,26,34
30203,OMEREQUE,estado nutricional en menores de 5 anos,clasificacion d,2002-11-01,9,12,9,12,21
40101,ORURO,estado nutricional en menores de 5 anos,clasificacion d,2002-11-01,545,484,545,484,1029
60201,PADCAYA,estado nutricional en menores de 5 anos,clasificacion d,2002-11-01,53,54,53,54,107
10401,PADILLA,estado nutricional en menores de 5 anos,clasificacion d,2002-11-01,131,258,131,258,389
70502,PAILON,estado nutricional en menores de 5 anos,clasificacion d,2002-11-01,43,21,43,21,64
20102,PALCA,estado nutricional en menores de 5 anos,clasificacion d,2002-11-01,29,17,29,17,46
21104,PALOS BLANCOS,estado nutricional en menores de 5 anos,clasificacion d,2002-11-01,53,106,53,106,159
40802,PAMPA AULLAGAS,estado nutricional en menores de 5 anos,clasificacion d,2002-11-01,12,25,12,25,37
70902,PAMPA GRANDE,estado nutricional en menores de 5 anos,clasificacion d,2002-11-01,8,11,8,11,19
21802,PAPEL PAMPA,estado nutricional en menores de 5 anos,clasificacion d,2002-11-01,0,3,0,3,3
30202,PASORAPA,estado nutricional en menores de 5 anos,clasificacion d,2002-11-01,13,34,13,34,47
21305,PATACAMAYA,estado nutricional en menores de 5 anos,clasificacion d,2002-11-01,68,21,68,21,89
40602,PAZÃ‘A,estado nutricional en menores de 5 anos,clasificacion d,2002-11-01,9,24,9,24,33
20702,PELECHUCO,estado nutricional en menores de 5 anos,clasificacion d,2002-11-01,23,30,23,30,53
50403,POCOATA,estado nutricional en menores de 5 anos,clasificacion d,2002-11-01,199,168,199,168,367
31203,POCONA,estado nutricional en menores de 5 anos,clasificacion d,2002-11-01,68,32,68,32,100
31202,POJO (CBBA),estado nutricional en menores de 5 anos,clasificacion d,2002-11-01,114,113,114,113,227
40601,POOPO,estado nutricional en menores de 5 anos,clasificacion d,2002-11-01,8,23,8,23,31
10103,POROMA,estado nutricional en menores de 5 anos,clasificacion d,2002-11-01,101,159,101,159,260
70103,PORONGO,estado nutricional en menores de 5 anos,clasificacion d,2002-11-01,13,13,13,13,26
70601,PORTACHUELO,estado nutricional en menores de 5 anos,clasificacion d,2002-11-01,45,28,45,28,73
90102,PORVENIR,estado nutricional en menores de 5 anos,clasificacion d,2002-11-01,14,18,14,18,32
70804,POSTRER VALLE,estado nutricional en menores de 5 anos,clasificacion d,2002-11-01,3,8,3,8,11
50101,POTOSI,estado nutricional en menores de 5 anos,clasificacion d,2002-11-01,461,324,461,324,785
10302,PRESTO,estado nutricional en menores de 5 anos,clasificacion d,2002-11-01,79,84,79,84,163
70805,PUCARA,estado nutricional en menores de 5 anos,clasificacion d,2002-11-01,1,11,1,11,12
21201,PUCARANI,estado nutricional en menores de 5 anos,clasificacion d,2002-11-01,5,43,5,43,48
20401,PUERTO ACOSTA,estado nutricional en menores de 5 anos,clasificacion d,2002-11-01,58,64,58,64,122
20403,PUERTO CARABUCO,estado nutricional en menores de 5 anos,clasificacion d,2002-11-01,35,59,35,59,94
90301,PUERTO GONZALO MORENO,estado nutricional en menores de 5 anos,clasificacion d,2002-11-01,21,22,21,22,43
21204,PUERTO PEREZ,estado nutricional en menores de 5 anos,clasificacion d,2002-11-01,10,5,10,5,15
71402,PUERTO QUIJARRO,estado nutricional en menores de 5 anos,clasificacion d,2002-11-01,34,29,34,29,63
90201,PUERTO RICO,estado nutricional en menores de 5 anos,clasificacion d,2002-11-01,11,19,11,19,30
80703,PUERTO SILES,estado nutricional en menores de 5 anos,clasificacion d,2002-11-01,1,0,1,0,1
71401,PUERTO SUAREZ,estado nutricional en menores de 5 anos,clasificacion d,2002-11-01,44,13,44,13,57
31205,PUERTO VILLARROEL,estado nutricional en menores de 5 anos,clasificacion d,2002-11-01,154,120,154,120,274
51101,PUNA,estado nutricional en menores de 5 anos,clasificacion d,2002-11-01,209,243,209,243,452
31401,PUNATA,estado nutricional en menores de 5 anos,clasificacion d,2002-11-01,114,81,114,81,195
20604,QUIABAYA,estado nutricional en menores de 5 anos,clasificacion d,2002-11-01,8,11,8,11,19
30901,QUILLACOLLO,estado nutricional en menores de 5 anos,clasificacion d,2002-11-01,60,87,60,87,147
21002,QUIME,estado nutricional en menores de 5 anos,clasificacion d,2002-11-01,76,70,76,70,146
70904,QUIRUSILLAS,estado nutricional en menores de 5 anos,clasificacion d,2002-11-01,1,1,1,1,2
50402,RAVELO,estado nutricional en menores de 5 anos,clasificacion d,2002-11-01,155,141,155,141,296
80301,REYES,estado nutricional en menores de 5 anos,clasificacion d,2002-11-01,41,43,41,43,84
80201,RIBERALTA,estado nutricional en menores de 5 anos,clasificacion d,2002-11-01,330,207,330,207,537
70503,ROBORE,estado nutricional en menores de 5 anos,clasificacion d,2002-11-01,100,36,100,36,136
80304,RURRENABAQUE,estado nutricional en menores de 5 anos,clasificacion d,2002-11-01,5,9,5,9,14
40901,SABAYA,estado nutricional en menores de 5 anos,clasificacion d,2002-11-01,0,6,0,6,6
31001,SACABA,estado nutricional en menores de 5 anos,clasificacion d,2002-11-01,170,79,170,79,249
30404,SACABAMBA,estado nutricional en menores de 5 anos,clasificacion d,2002-11-01,6,51,6,51,57
50701,SACACA,estado nutricional en menores de 5 anos,clasificacion d,2002-11-01,160,267,160,267,427
71302,SAIPINA,estado nutricional en menores de 5 anos,clasificacion d,2002-11-01,25,27,25,27,52
40801,SALINAS DE GARCI MENDOZA,estado nutricional en menores de 5 anos,clasificacion d,2002-11-01,16,15,16,15,31
70901,SAMAIPATA,estado nutricional en menores de 5 anos,clasificacion d,2002-11-01,40,14,40,14,54
51601,SAN AGUSTIN,estado nutricional en menores de 5 anos,clasificacion d,2002-11-01,8,6,8,6,14
80602,SAN ANDRES,estado nutricional en menores de 5 anos,clasificacion d,2002-11-01,29,54,29,54,83
51003,SAN ANTONIO DE ESMORUCO,estado nutricional en menores de 5 anos,clasificacion d,2002-11-01,4,17,4,17,21
71105,SAN ANTONIO DE LOMERIO,estado nutricional en menores de 5 anos,clasificacion d,2002-11-01,65,103,65,103,168
31403,SAN BENITO,estado nutricional en menores de 5 anos,clasificacion d,2002-11-01,36,52,36,52,88
80302,SAN BORJA,estado nutricional en menores de 5 anos,clasificacion d,2002-11-01,114,100,114,100,214
21502,SAN BUENA VENTURA,estado nutricional en menores de 5 anos,clasificacion d,2002-11-01,40,88,40,88,128
70402,SAN CARLOS,estado nutricional en menores de 5 anos,clasificacion d,2002-11-01,58,45,58,45,103
80501,SAN IGNACIO,estado nutricional en menores de 5 anos,clasificacion d,2002-11-01,65,112,65,112,177
70301,SAN IGNACIO DE VELASCO,estado nutricional en menores de 5 anos,clasificacion d,2002-11-01,181,269,181,269,450
80102,SAN JAVIER(BNI),estado nutricional en menores de 5 anos,clasificacion d,2002-11-01,17,24,17,24,41
71102,SAN JAVIER(STC),estado nutricional en menores de 5 anos,clasificacion d,2002-11-01,31,23,31,23,54
80701,SAN JOAQUIN,estado nutricional en menores de 5 anos,clasificacion d,2002-11-01,0,11,0,11,11
70501,SAN JOSE DE CHIQUITOS,estado nutricional en menores de 5 anos,clasificacion d,2002-11-01,52,31,52,31,83
71104,SAN JULIAN,estado nutricional en menores de 5 anos,clasificacion d,2002-11-01,172,210,172,210,382
90302,SAN LORENZO(PND),estado nutricional en menores de 5 anos,clasificacion d,2002-11-01,4,7,4,7,11
60501,SAN LORENZO(TJA),estado nutricional en menores de 5 anos,clasificacion d,2002-11-01,30,15,30,15,45
10702,SAN LUCAS,estado nutricional en menores de 5 anos,clasificacion d,2002-11-01,323,383,323,383,706
70302,SAN MIGUEL DE VELASCO,estado nutricional en menores de 5 anos,clasificacion d,2002-11-01,22,36,22,36,58
51001,SAN PABLO DE LIPEZ,estado nutricional en menores de 5 anos,clasificacion d,2002-11-01,10,9,10,9,19
50501,SAN PEDRO DE BUENA VISTA,estado nutricional en menores de 5 anos,clasificacion d,2002-11-01,105,255,105,255,360
21801,SAN PEDRO DE CURAHUARA,estado nutricional en menores de 5 anos,clasificacion d,2002-11-01,22,28,22,28,50
50902,SAN PEDRO DE QUEMES,estado nutricional en menores de 5 anos,clasificacion d,2002-11-01,4,4,4,4,8
21702,SAN PEDRO DE TIQUINA,estado nutricional en menores de 5 anos,clasificacion d,2002-11-01,3,8,3,8,11
90202,SAN PEDRO(PND),estado nutricional en menores de 5 anos,clasificacion d,2002-11-01,12,16,12,16,28
70303,SAN RAFAEL,estado nutricional en menores de 5 anos,clasificacion d,2002-11-01,29,30,29,30,59
80702,SAN RAMON,estado nutricional en menores de 5 anos,clasificacion d,2002-11-01,8,0,8,0,8
80401,SANTA ANA,estado nutricional en menores de 5 anos,clasificacion d,2002-11-01,45,48,45,48,93
70101,SANTA CRUZ DE LA SIERRA,estado nutricional en menores de 5 anos,clasificacion d,2002-11-01,758,436,758,436,1194
80303,SANTA ROSA,estado nutricional en menores de 5 anos,clasificacion d,2002-11-01,11,5,11,5,16
70602,SANTA ROSA DEL SARA,estado nutricional en menores de 5 anos,clasificacion d,2002-11-01,4,7,4,7,11
20308,SANTIAGO DE CALLAPA,estado nutricional en menores de 5 anos,clasificacion d,2002-11-01,39,32,39,32,71
41401,SANTIAGO DE HUARI,estado nutricional en menores de 5 anos,clasificacion d,2002-11-01,10,37,10,37,47
21901,SANTIAGO DE MACHACA,estado nutricional en menores de 5 anos,clasificacion d,2002-11-01,5,2,5,2,7
30702,SANTIVAÃ‘ES,estado nutricional en menores de 5 anos,clasificacion d,2002-11-01,20,16,20,16,36
40202,SANTUARIO DE QUILLACAS,estado nutricional en menores de 5 anos,clasificacion d,2002-11-01,5,9,5,9,14
20902,SAPAHAQUI,estado nutricional en menores de 5 anos,clasificacion d,2002-11-01,30,52,30,52,82
90303,SENA,estado nutricional en menores de 5 anos,clasificacion d,2002-11-01,4,2,4,2,6
21301,SICA SICA (VILLA AROMA),estado nutricional en menores de 5 anos,clasificacion d,2002-11-01,52,63,52,63,115
30703,SICAYA,estado nutricional en menores de 5 anos,clasificacion d,2002-11-01,4,5,4,5,9
30902,SIPE SIPE,estado nutricional en menores de 5 anos,clasificacion d,2002-11-01,201,133,201,133,334
10403,SOPACHUY,estado nutricional en menores de 5 anos,clasificacion d,2002-11-01,42,46,42,46,88
20601,SORATA,estado nutricional en menores de 5 anos,clasificacion d,2002-11-01,59,117,59,117,176
10101,SUCRE,estado nutricional en menores de 5 anos,clasificacion d,2002-11-01,555,604,555,604,1159
31404,TACACHI,estado nutricional en menores de 5 anos,clasificacion d,2002-11-01,6,4,6,4,10
20603,TACACOMA,estado nutricional en menores de 5 anos,clasificacion d,2002-11-01,9,30,9,30,39
50303,TACOBAMBA,estado nutricional en menores de 5 anos,clasificacion d,2002-11-01,68,66,68,66,134
30602,TACOPAYA,estado nutricional en menores de 5 anos,clasificacion d,2002-11-01,79,124,79,124,203
51402,TAHUA,estado nutricional en menores de 5 anos,clasificacion d,2002-11-01,8,7,8,7,15
31101,TAPACARI,estado nutricional en menores de 5 anos,clasificacion d,2002-11-01,62,96,62,96,158
10601,TARABUCO,estado nutricional en menores de 5 anos,clasificacion d,2002-11-01,260,497,260,497,757
30401,TARATA,estado nutricional en menores de 5 anos,clasificacion d,2002-11-01,23,22,23,22,45
60101,TARIJA,estado nutricional en menores de 5 anos,clasificacion d,2002-11-01,227,206,227,206,433
10202,TARVITA,estado nutricional en menores de 5 anos,clasificacion d,2002-11-01,78,119,78,119,197
20803,TIAWANACU,estado nutricional en menores de 5 anos,clasificacion d,2002-11-01,19,22,19,22,41
50102,TINGUIPAYA,estado nutricional en menores de 5 anos,clasificacion d,2002-11-01,16,91,16,91,107
20606,TIPUANI,estado nutricional en menores de 5 anos,clasificacion d,2002-11-01,13,9,13,9,22
30903,TIQUIPAYA,estado nutricional en menores de 5 anos,clasificacion d,2002-11-01,115,82,115,82,197
31601,TIRAQUE (CBBA),estado nutricional en menores de 5 anos,clasificacion d,2002-11-01,113,113,113,113,226
21703,TITO YUPANQUI (PARQUIPUJIO),estado nutricional en menores de 5 anos,clasificacion d,2002-11-01,9,11,9,11,20
30802,TOCO,estado nutricional en menores de 5 anos,clasificacion d,2002-11-01,2,11,2,11,13
41502,TODOS SANTOS,estado nutricional en menores de 5 anos,clasificacion d,2002-11-01,0,1,0,1,1
30803,TOLATA,estado nutricional en menores de 5 anos,clasificacion d,2002-11-01,10,1,10,1,11
41001,TOLEDO,estado nutricional en menores de 5 anos,clasificacion d,2002-11-01,6,16,6,16,22
51202,TOMAVE,estado nutricional en menores de 5 anos,clasificacion d,2002-11-01,71,97,71,97,168
10402,TOMINA,estado nutricional en menores de 5 anos,clasificacion d,2002-11-01,101,200,101,200,301
50502,TORO TORO,estado nutricional en menores de 5 anos,clasificacion d,2002-11-01,31,51,31,51,82
31201,TOTORA(CBBA),estado nutricional en menores de 5 anos,clasificacion d,2002-11-01,43,34,43,34,77
41301,TOTORA(ORR),estado nutricional en menores de 5 anos,clasificacion d,2002-11-01,13,20,13,20,33
70802,TRIGAL,estado nutricional en menores de 5 anos,clasificacion d,2002-11-01,2,1,2,1,3
80101,TRINIDAD,estado nutricional en menores de 5 anos,clasificacion d,2002-11-01,127,181,127,181,308
50801,TUPIZA,estado nutricional en menores de 5 anos,clasificacion d,2002-11-01,52,338,52,338,390
40402,TURCO,estado nutricional en menores de 5 anos,clasificacion d,2002-11-01,8,5,8,5,13
21302,UMALA,estado nutricional en menores de 5 anos,clasificacion d,2002-11-01,18,9,18,9,27
50201,UNCIA,estado nutricional en menores de 5 anos,clasificacion d,2002-11-01,13,28,13,28,41
60401,URIONDO (A. CONCEPCION),estado nutricional en menores de 5 anos,clasificacion d,2002-11-01,13,21,13,21,34
71502,URUBICHA,estado nutricional en menores de 5 anos,clasificacion d,2002-11-01,41,31,41,31,72
51201,UYUNI,estado nutricional en menores de 5 anos,clasificacion d,2002-11-01,95,152,95,152,247
30502,VACAS,estado nutricional en menores de 5 anos,clasificacion d,2002-11-01,20,74,20,74,94
70801,VALLEGRANDE,estado nutricional en menores de 5 anos,clasificacion d,2002-11-01,50,66,50,66,116
20801,VIACHA,estado nutricional en menores de 5 anos,clasificacion d,2002-11-01,107,110,107,110,217
31302,VILA VILA,estado nutricional en menores de 5 anos,clasificacion d,2002-11-01,1,22,1,22,23
60303,VILLA MONTES,estado nutricional en menores de 5 anos,clasificacion d,2002-11-01,58,49,58,49,107
90502,VILLA NUEVA (LOMA ALTA),estado nutricional en menores de 5 anos,clasificacion d,2002-11-01,3,2,3,2,5
31402,VILLA RIVERO,estado nutricional en menores de 5 anos,clasificacion d,2002-11-01,26,2,26,2,28
10801,VILLA SERRANO,estado nutricional en menores de 5 anos,clasificacion d,2002-11-01,112,271,112,271,383
31003,VILLA TUNARI,estado nutricional en menores de 5 anos,clasificacion d,2002-11-01,77,88,77,88,165
11001,VILLA VACA GUZMAN (MUYUPAMPA),estado nutricional en menores de 5 anos,clasificacion d,2002-11-01,57,95,57,95,152
51501,VILLAZON,estado nutricional en menores de 5 anos,clasificacion d,2002-11-01,161,181,161,181,342
30904,VINTO,estado nutricional en menores de 5 anos,clasificacion d,2002-11-01,48,9,48,9,57
50602,VITICHI,estado nutricional en menores de 5 anos,clasificacion d,2002-11-01,72,121,72,121,193
20306,WALDO BALLIVIAN,estado nutricional en menores de 5 anos,clasificacion d,2002-11-01,1,2,1,2,3
70201,WARNES,estado nutricional en menores de 5 anos,clasificacion d,2002-11-01,108,95,108,95,203
20903,YACO,estado nutricional en menores de 5 anos,clasificacion d,2002-11-01,45,26,45,26,71
60301,YACUIBA,estado nutricional en menores de 5 anos,clasificacion d,2002-11-01,96,111,96,111,207
10602,YAMPARAEZ,estado nutricional en menores de 5 anos,clasificacion d,2002-11-01,171,293,171,293,464
21103,YANACACHI,estado nutricional en menores de 5 anos,clasificacion d,2002-11-01,7,16,7,16,23
70403,YAPACANI,estado nutricional en menores de 5 anos,clasificacion d,2002-11-01,57,99,57,99,156
50103,YOCALLA,estado nutricional en menores de 5 anos,clasificacion d,2002-11-01,38,83,38,83,121
10102,YOTALA,estado nutricional en menores de 5 anos,clasificacion d,2002-11-01,104,206,104,206,310
60402,YUNCHARA,estado nutricional en menores de 5 anos,clasificacion d,2002-11-01,26,29,26,29,55
10301,ZUDAÃ‘EZ,estado nutricional en menores de 5 anos,clasificacion d,2002-11-01,61,127,61,127,188
51302,ACACIO,estado nutricional en menores de 5 anos,clasificacion d,2002-12-01,29,112,29,112,141
20201,ACHACACHI,estado nutricional en menores de 5 anos,clasificacion d,2002-12-01,109,135,109,135,244
20104,ACHOCALLA,estado nutricional en menores de 5 anos,clasificacion d,2002-12-01,21,13,21,13,34
30201,AIQUILE,estado nutricional en menores de 5 anos,clasificacion d,2002-12-01,38,52,38,52,90
31303,ALALAY,estado nutricional en menores de 5 anos,clasificacion d,2002-12-01,1,25,1,25,26
10404,ALCALA,estado nutricional en menores de 5 anos,clasificacion d,2002-12-01,34,56,34,56,90
20202,ANCORAIMES,estado nutricional en menores de 5 anos,clasificacion d,2002-12-01,80,114,80,114,194
41201,ANDAMARCA,estado nutricional en menores de 5 anos,clasificacion d,2002-12-01,5,6,5,6,11
40603,ANTEQUERA,estado nutricional en menores de 5 anos,clasificacion d,2002-12-01,7,5,7,5,12
30402,ANZALDO,estado nutricional en menores de 5 anos,clasificacion d,2002-12-01,5,33,5,33,38
20701,APOLO,estado nutricional en menores de 5 anos,clasificacion d,2002-12-01,26,32,26,32,58
51301,ARAMPAMPA,estado nutricional en menores de 5 anos,clasificacion d,2002-12-01,37,109,37,109,146
30501,ARANI,estado nutricional en menores de 5 anos,clasificacion d,2002-12-01,10,10,10,10,20
30403,ARBIETO,estado nutricional en menores de 5 anos,clasificacion d,2002-12-01,4,4,4,4,8
30601,ARQUE,estado nutricional en menores de 5 anos,clasificacion d,2002-12-01,13,15,13,15,28
71501,ASCENCION DE GUARAYOS,estado nutricional en menores de 5 anos,clasificacion d,2002-12-01,8,15,8,15,23
50802,ATOCHA,estado nutricional en menores de 5 anos,clasificacion d,2002-12-01,4,80,4,80,84
20503,AUCAPATA,estado nutricional en menores de 5 anos,clasificacion d,2002-12-01,3,10,3,10,13
20502,AYATA,estado nutricional en menores de 5 anos,clasificacion d,2002-12-01,14,4,14,4,18
21303,AYO AYO,estado nutricional en menores de 5 anos,clasificacion d,2002-12-01,39,3,39,3,42
30301,AYOPAYA (V. DE INDEPENDENCIA),estado nutricional en menores de 5 anos,clasificacion d,2002-12-01,87,82,87,82,169
10201,AZURDUY,estado nutricional en menores de 5 anos,clasificacion d,2002-12-01,107,127,107,127,234
21203,BATALLAS,estado nutricional en menores de 5 anos,clasificacion d,2002-12-01,16,17,16,17,33
80802,BAURES,estado nutricional en menores de 5 anos,clasificacion d,2002-12-01,13,27,13,27,40
41202,BELEN DE ANDAMARCA,estado nutricional en menores de 5 anos,clasificacion d,2002-12-01,1,2,1,2,3
50104,BELEN DE URMIRI,estado nutricional en menores de 5 anos,clasificacion d,2002-12-01,9,15,9,15,24
90104,BELLA FLOR,estado nutricional en menores de 5 anos,clasificacion d,2002-12-01,0,4,0,4,4
60202,BERMEJO,estado nutricional en menores de 5 anos,clasificacion d,2002-12-01,10,14,10,14,24
50301,BETANZOS,estado nutricional en menores de 5 anos,clasificacion d,2002-12-01,167,196,167,196,363
31501,BOLIVAR,estado nutricional en menores de 5 anos,clasificacion d,2002-12-01,52,32,52,32,84
90103,BOLPEBRA,estado nutricional en menores de 5 anos,clasificacion d,2002-12-01,2,1,2,1,3
70707,BOYUIBE,estado nutricional en menores de 5 anos,clasificacion d,2002-12-01,2,9,2,9,11
70703,CABEZAS,estado nutricional en menores de 5 anos,clasificacion d,2002-12-01,29,27,29,27,56
20905,CAIROMA,estado nutricional en menores de 5 anos,clasificacion d,2002-12-01,35,34,35,34,69
51102,"CAIZA ""D""",estado nutricional en menores de 5 anos,clasificacion d,2002-12-01,84,87,84,87,171
21003,CAJUATA,estado nutricional en menores de 5 anos,clasificacion d,2002-12-01,20,17,20,17,37
20303,CALACOTO,estado nutricional en menores de 5 anos,clasificacion d,2002-12-01,17,5,17,5,22
21304,CALAMARCA,estado nutricional en menores de 5 anos,clasificacion d,2002-12-01,73,82,73,82,155
10701,CAMARGO,estado nutricional en menores de 5 anos,clasificacion d,2002-12-01,59,82,59,82,141
10901,CAMATAQUI (C. VILLA ABECIA),estado nutricional en menores de 5 anos,clasificacion d,2002-12-01,28,24,28,24,52
70706,CAMIRI,estado nutricional en menores de 5 anos,clasificacion d,2002-12-01,115,83,115,83,198
30701,CAPINOTA,estado nutricional en menores de 5 anos,clasificacion d,2002-12-01,43,43,43,43,86
20302,CAQUIAVIRI,estado nutricional en menores de 5 anos,clasificacion d,2002-12-01,11,23,11,23,34
40102,CARACOLLO,estado nutricional en menores de 5 anos,clasificacion d,2002-12-01,18,81,18,81,99
22001,CARANAVI,estado nutricional en menores de 5 anos,clasificacion d,2002-12-01,110,106,110,106,216
60302,CARAPARI,estado nutricional en menores de 5 anos,clasificacion d,2002-12-01,28,36,28,36,64
50702,CARIPUYO,estado nutricional en menores de 5 anos,clasificacion d,2002-12-01,53,102,53,102,155
21902,CATACORA,estado nutricional en menores de 5 anos,clasificacion d,2002-12-01,5,8,5,8,13
40201,CHALLAPATA,estado nutricional en menores de 5 anos,clasificacion d,2002-12-01,35,59,35,59,94
50302,CHAQUI,estado nutricional en menores de 5 anos,clasificacion d,2002-12-01,60,73,60,73,133
70702,CHARAGUA,estado nutricional en menores de 5 anos,clasificacion d,2002-12-01,55,148,55,148,203
20305,CHARAÃ‘A,estado nutricional en menores de 5 anos,clasificacion d,2002-12-01,5,6,5,6,11
50202,CHAYANTA,estado nutricional en menores de 5 anos,clasificacion d,2002-12-01,53,89,53,89,142
31204,CHIMORE,estado nutricional en menores de 5 anos,clasificacion d,2002-12-01,14,7,14,7,21
40903,CHIPAYA,estado nutricional en menores de 5 anos,clasificacion d,2002-12-01,0,1,0,1,1
21101,CHULUMANI (V. DE LA LIBERTAD),estado nutricional en menores de 5 anos,clasificacion d,2002-12-01,5,10,5,10,15
20501,CHUMA,estado nutricional en menores de 5 anos,clasificacion d,2002-12-01,31,23,31,23,54
30801,CLIZA,estado nutricional en menores de 5 anos,clasificacion d,2002-12-01,12,5,12,5,17
90101,COBIJA,estado nutricional en menores de 5 anos,clasificacion d,2002-12-01,94,87,94,87,181
30101,COCHABAMBA,estado nutricional en menores de 5 anos,clasificacion d,2002-12-01,388,327,388,327,715
40902,COIPASA,estado nutricional en menores de 5 anos,clasificacion d,2002-12-01,0,1,0,1,1
30905,COLCAPIRHUA,estado nutricional en menores de 5 anos,clasificacion d,2002-12-01,70,35,70,35,105
50901,"COLCHA ""K""",estado nutricional en menores de 5 anos,clasificacion d,2002-12-01,29,36,29,36,65
21307,COLLANA,estado nutricional en menores de 5 anos,clasificacion d,2002-12-01,3,0,3,0,3
31002,COLOMI,estado nutricional en menores de 5 anos,clasificacion d,2002-12-01,56,32,56,32,88
50401,COLQUECHACA,estado nutricional en menores de 5 anos,clasificacion d,2002-12-01,99,63,99,63,162
21306,COLQUENCHA,estado nutricional en menores de 5 anos,clasificacion d,2002-12-01,29,10,29,10,39
21004,COLQUIRI,estado nutricional en menores de 5 anos,clasificacion d,2002-12-01,46,40,46,40,86
20304,COMANCHE,estado nutricional en menores de 5 anos,clasificacion d,2002-12-01,10,12,10,12,22
71301,COMARAPA,estado nutricional en menores de 5 anos,clasificacion d,2002-12-01,63,54,63,54,117
20605,COMBAYA,estado nutricional en menores de 5 anos,clasificacion d,2002-12-01,12,13,12,13,25
71101,CONCEPCION,estado nutricional en menores de 5 anos,clasificacion d,2002-12-01,22,3,22,3,25
21701,COPACABANA,estado nutricional en menores de 5 anos,clasificacion d,2002-12-01,23,21,23,21,44
21402,CORIPATA,estado nutricional en menores de 5 anos,clasificacion d,2002-12-01,2,5,2,5,7
20301,CORO CORO,estado nutricional en menores de 5 anos,clasificacion d,2002-12-01,29,17,29,17,46
21401,COROICO,estado nutricional en menores de 5 anos,clasificacion d,2002-12-01,28,9,28,9,37
40301,CORQUE,estado nutricional en menores de 5 anos,clasificacion d,2002-12-01,18,16,18,16,34
50601,COTAGAITA,estado nutricional en menores de 5 anos,clasificacion d,2002-12-01,88,115,88,115,203
70102,COTOCA,estado nutricional en menores de 5 anos,clasificacion d,2002-12-01,22,21,22,21,43
70704,CUEVO,estado nutricional en menores de 5 anos,clasificacion d,2002-12-01,16,14,16,14,30
10902,CULPINA,estado nutricional en menores de 5 anos,clasificacion d,2002-12-01,141,181,141,181,322
40401,CURAHUARA DE CARANGAS,estado nutricional en menores de 5 anos,clasificacion d,2002-12-01,11,3,11,3,14
21602,CURVA,estado nutricional en menores de 5 anos,clasificacion d,2002-12-01,8,5,8,5,13
20804,DESAGUADERO,estado nutricional en menores de 5 anos,clasificacion d,2002-12-01,6,5,6,5,11
20105,EL ALTO,estado nutricional en menores de 5 anos,clasificacion d,2002-12-01,1543,951,1543,951,2494
40103,EL CHORO,estado nutricional en menores de 5 anos,clasificacion d,2002-12-01,6,5,6,5,11
71503,EL PUENTE(STC),estado nutricional en menores de 5 anos,clasificacion d,2002-12-01,15,101,15,101,116
60502,EL PUENTE(TJA),estado nutricional en menores de 5 anos,clasificacion d,2002-12-01,44,93,44,93,137
70105,EL TORNO,estado nutricional en menores de 5 anos,clasificacion d,2002-12-01,58,62,58,62,120
10405,EL VILLAR,estado nutricional en menores de 5 anos,clasificacion d,2002-12-01,44,115,44,115,159
60601,ENTRE RIOS,estado nutricional en menores de 5 anos,clasificacion d,2002-12-01,20,33,20,33,53
41101,EUCALIPTUS,estado nutricional en menores de 5 anos,clasificacion d,2002-12-01,6,7,6,7,13
90503,EUREKA (SANTOS MERCADO),estado nutricional en menores de 5 anos,clasificacion d,2002-12-01,2,0,2,0,2
80402,EXALTACION,estado nutricional en menores de 5 anos,clasificacion d,2002-12-01,8,19,8,19,27
71002,GENERAL SAAVEDRA,estado nutricional en menores de 5 anos,clasificacion d,2002-12-01,50,85,50,85,135
21601,GRAL. J.J. PEREZ (CHARAZANI),estado nutricional en menores de 5 anos,clasificacion d,2002-12-01,16,13,16,13,29
20602,GUANAY,estado nutricional en menores de 5 anos,clasificacion d,2002-12-01,68,67,68,67,135
20802,GUAQUI,estado nutricional en menores de 5 anos,clasificacion d,2002-12-01,10,4,10,4,14
80202,GUAYARAMERIN,estado nutricional en menores de 5 anos,clasificacion d,2002-12-01,80,94,80,94,174
70705,GUTIERREZ,estado nutricional en menores de 5 anos,clasificacion d,2002-12-01,83,119,83,119,202
10502,HUACARETA,estado nutricional en menores de 5 anos,clasificacion d,2002-12-01,48,79,48,79,127
11002,HUACAYA (VILLA DE HUACAYA),estado nutricional en menores de 5 anos,clasificacion d,2002-12-01,2,5,2,5,7
40501,HUACHACALLA,estado nutricional en menores de 5 anos,clasificacion d,2002-12-01,1,7,1,7,8
40701,HUANUNI,estado nutricional en menores de 5 anos,clasificacion d,2002-12-01,74,43,74,43,117
80803,HUARACAJE,estado nutricional en menores de 5 anos,clasificacion d,2002-12-01,8,4,8,4,12
41601,HUAYLLAMARCA,estado nutricional en menores de 5 anos,clasificacion d,2002-12-01,8,8,8,8,16
21005,ICHOCA,estado nutricional en menores de 5 anos,clasificacion d,2002-12-01,15,14,15,14,29
10304,ICLA,estado nutricional en menores de 5 anos,clasificacion d,2002-12-01,95,179,95,179,274
10703,INCAHUASI,estado nutricional en menores de 5 anos,clasificacion d,2002-12-01,131,122,131,122,253
21001,INQUISIVI,estado nutricional en menores de 5 anos,clasificacion d,2002-12-01,59,70,59,70,129
21102,IRUPANA (VILLA DE LANZA),estado nutricional en menores de 5 anos,clasificacion d,2002-12-01,15,36,15,36,51
21501,IXIAMAS,estado nutricional en menores de 5 anos,clasificacion d,2002-12-01,43,56,43,56,99
21105,LA ASUNTA,estado nutricional en menores de 5 anos,clasificacion d,2002-12-01,16,29,16,29,45
70104,LA GUARDIA,estado nutricional en menores de 5 anos,clasificacion d,2002-12-01,33,40,33,40,73
20101,LA PAZ,estado nutricional en menores de 5 anos,clasificacion d,2002-12-01,930,715,930,715,1645
41501,LA RIVERA,estado nutricional en menores de 5 anos,clasificacion d,2002-12-01,0,1,0,1,1
70701,LAGUNILLAS,estado nutricional en menores de 5 anos,clasificacion d,2002-12-01,45,41,45,41,86
21202,LAJA,estado nutricional en menores de 5 anos,clasificacion d,2002-12-01,16,18,16,18,34
10903,LAS CARRERAS,estado nutricional en menores de 5 anos,clasificacion d,2002-12-01,19,37,19,37,56
21006,LICOMA PAMPA,estado nutricional en menores de 5 anos,clasificacion d,2002-12-01,9,7,9,7,16
50203,LLALLAGUA,estado nutricional en menores de 5 anos,clasificacion d,2002-12-01,22,221,22,221,243
51401,LLICA,estado nutricional en menores de 5 anos,clasificacion d,2002-12-01,8,13,8,13,21
80601,LORETO,estado nutricional en menores de 5 anos,clasificacion d,2002-12-01,11,8,11,8,19
20901,LURIBAY,estado nutricional en menores de 5 anos,clasificacion d,2002-12-01,6,7,6,7,13
40702,MACHACAMARCA,estado nutricional en menores de 5 anos,clasificacion d,2002-12-01,10,8,10,8,18
11003,MACHARETI,estado nutricional en menores de 5 anos,clasificacion d,2002-12-01,40,107,40,107,147
80801,MAGDALENA,estado nutricional en menores de 5 anos,clasificacion d,2002-12-01,22,29,22,29,51
70903,MAIRANA,estado nutricional en menores de 5 anos,clasificacion d,2002-12-01,27,16,27,16,43
20904,MALLA,estado nutricional en menores de 5 anos,clasificacion d,2002-12-01,1,2,1,2,3
20103,MECAPACA,estado nutricional en menores de 5 anos,clasificacion d,2002-12-01,13,12,13,12,25
71003,MINEROS,estado nutricional en menores de 5 anos,clasificacion d,2002-12-01,115,84,115,84,199
31301,MIZQUE,estado nutricional en menores de 5 anos,clasificacion d,2002-12-01,67,35,67,35,102
20402,MOCOMOCO,estado nutricional en menores de 5 anos,clasificacion d,2002-12-01,33,21,33,21,54
51002,MOJINETE,estado nutricional en menores de 5 anos,clasificacion d,2002-12-01,0,4,0,4,4
10303,MOJOCOYA,estado nutricional en menores de 5 anos,clasificacion d,2002-12-01,56,94,56,94,150
10501,MONTEAGUDO,estado nutricional en menores de 5 anos,clasificacion d,2002-12-01,106,220,106,220,326
71001,MONTERO,estado nutricional en menores de 5 anos,clasificacion d,2002-12-01,244,145,244,145,389
70803,MORO MORO,estado nutricional en menores de 5 anos,clasificacion d,2002-12-01,4,7,4,7,11
30302,MOROCHATA,estado nutricional en menores de 5 anos,clasificacion d,2002-12-01,43,75,43,75,118
90401,NACEBE (SANTA ROSA DEL ABUNA),estado nutricional en menores de 5 anos,clasificacion d,2002-12-01,0,5,0,5,5
20307,NAZACARA DE PACAJES,estado nutricional en menores de 5 anos,clasificacion d,2002-12-01,3,1,3,1,4
90501,NUEVO MANOA (NUEVA ESPERANZA),estado nutricional en menores de 5 anos,clasificacion d,2002-12-01,1,2,1,2,3
50404,OCURI,estado nutricional en menores de 5 anos,clasificacion d,2002-12-01,46,102,46,102,148
70202,OKINAWA,estado nutricional en menores de 5 anos,clasificacion d,2002-12-01,8,14,8,14,22
30203,OMEREQUE,estado nutricional en menores de 5 anos,clasificacion d,2002-12-01,0,29,0,29,29
40101,ORURO,estado nutricional en menores de 5 anos,clasificacion d,2002-12-01,498,348,498,348,846
60201,PADCAYA,estado nutricional en menores de 5 anos,clasificacion d,2002-12-01,34,43,34,43,77
10401,PADILLA,estado nutricional en menores de 5 anos,clasificacion d,2002-12-01,120,203,120,203,323
70502,PAILON,estado nutricional en menores de 5 anos,clasificacion d,2002-12-01,24,25,24,25,49
20102,PALCA,estado nutricional en menores de 5 anos,clasificacion d,2002-12-01,18,26,18,26,44
21104,PALOS BLANCOS,estado nutricional en menores de 5 anos,clasificacion d,2002-12-01,37,51,37,51,88
40802,PAMPA AULLAGAS,estado nutricional en menores de 5 anos,clasificacion d,2002-12-01,12,15,12,15,27
70902,PAMPA GRANDE,estado nutricional en menores de 5 anos,clasificacion d,2002-12-01,8,10,8,10,18
21802,PAPEL PAMPA,estado nutricional en menores de 5 anos,clasificacion d,2002-12-01,8,9,8,9,17
30202,PASORAPA,estado nutricional en menores de 5 anos,clasificacion d,2002-12-01,26,34,26,34,60
21305,PATACAMAYA,estado nutricional en menores de 5 anos,clasificacion d,2002-12-01,34,19,34,19,53
40602,PAZÃ‘A,estado nutricional en menores de 5 anos,clasificacion d,2002-12-01,11,27,11,27,38
20702,PELECHUCO,estado nutricional en menores de 5 anos,clasificacion d,2002-12-01,20,12,20,12,32
50403,POCOATA,estado nutricional en menores de 5 anos,clasificacion d,2002-12-01,179,226,179,226,405
31203,POCONA,estado nutricional en menores de 5 anos,clasificacion d,2002-12-01,34,18,34,18,52
31202,POJO (CBBA),estado nutricional en menores de 5 anos,clasificacion d,2002-12-01,73,66,73,66,139
40601,POOPO,estado nutricional en menores de 5 anos,clasificacion d,2002-12-01,2,7,2,7,9
51203,PORCO,estado nutricional en menores de 5 anos,clasificacion d,2002-12-01,7,9,7,9,16
10103,POROMA,estado nutricional en menores de 5 anos,clasificacion d,2002-12-01,82,128,82,128,210
70103,PORONGO,estado nutricional en menores de 5 anos,clasificacion d,2002-12-01,11,11,11,11,22
70601,PORTACHUELO,estado nutricional en menores de 5 anos,clasificacion d,2002-12-01,46,32,46,32,78
90102,PORVENIR,estado nutricional en menores de 5 anos,clasificacion d,2002-12-01,11,12,11,12,23
70804,POSTRER VALLE,estado nutricional en menores de 5 anos,clasificacion d,2002-12-01,2,8,2,8,10
50101,POTOSI,estado nutricional en menores de 5 anos,clasificacion d,2002-12-01,410,280,410,280,690
10302,PRESTO,estado nutricional en menores de 5 anos,clasificacion d,2002-12-01,70,68,70,68,138
21201,PUCARANI,estado nutricional en menores de 5 anos,clasificacion d,2002-12-01,7,13,7,13,20
20401,PUERTO ACOSTA,estado nutricional en menores de 5 anos,clasificacion d,2002-12-01,60,79,60,79,139
20403,PUERTO CARABUCO,estado nutricional en menores de 5 anos,clasificacion d,2002-12-01,40,42,40,42,82
90301,PUERTO GONZALO MORENO,estado nutricional en menores de 5 anos,clasificacion d,2002-12-01,2,3,2,3,5
21204,PUERTO PEREZ,estado nutricional en menores de 5 anos,clasificacion d,2002-12-01,4,15,4,15,19
71402,PUERTO QUIJARRO,estado nutricional en menores de 5 anos,clasificacion d,2002-12-01,33,11,33,11,44
90201,PUERTO RICO,estado nutricional en menores de 5 anos,clasificacion d,2002-12-01,7,6,7,6,13
80703,PUERTO SILES,estado nutricional en menores de 5 anos,clasificacion d,2002-12-01,2,0,2,0,2
71401,PUERTO SUAREZ,estado nutricional en menores de 5 anos,clasificacion d,2002-12-01,45,17,45,17,62
31205,PUERTO VILLARROEL,estado nutricional en menores de 5 anos,clasificacion d,2002-12-01,129,106,129,106,235
51101,PUNA,estado nutricional en menores de 5 anos,clasificacion d,2002-12-01,81,58,81,58,139
31401,PUNATA,estado nutricional en menores de 5 anos,clasificacion d,2002-12-01,133,27,133,27,160
30901,QUILLACOLLO,estado nutricional en menores de 5 anos,clasificacion d,2002-12-01,50,35,50,35,85
21002,QUIME,estado nutricional en menores de 5 anos,clasificacion d,2002-12-01,41,19,41,19,60
70904,QUIRUSILLAS,estado nutricional en menores de 5 anos,clasificacion d,2002-12-01,0,2,0,2,2
50402,RAVELO,estado nutricional en menores de 5 anos,clasificacion d,2002-12-01,206,273,206,273,479
80301,REYES,estado nutricional en menores de 5 anos,clasificacion d,2002-12-01,22,17,22,17,39
80201,RIBERALTA,estado nutricional en menores de 5 anos,clasificacion d,2002-12-01,335,203,335,203,538
70503,ROBORE,estado nutricional en menores de 5 anos,clasificacion d,2002-12-01,49,26,49,26,75
80304,RURRENABAQUE,estado nutricional en menores de 5 anos,clasificacion d,2002-12-01,6,3,6,3,9
40901,SABAYA,estado nutricional en menores de 5 anos,clasificacion d,2002-12-01,0,11,0,11,11
31001,SACABA,estado nutricional en menores de 5 anos,clasificacion d,2002-12-01,85,55,85,55,140
30404,SACABAMBA,estado nutricional en menores de 5 anos,clasificacion d,2002-12-01,4,21,4,21,25
50701,SACACA,estado nutricional en menores de 5 anos,clasificacion d,2002-12-01,114,316,114,316,430
71302,SAIPINA,estado nutricional en menores de 5 anos,clasificacion d,2002-12-01,17,26,17,26,43
40801,SALINAS DE GARCI MENDOZA,estado nutricional en menores de 5 anos,clasificacion d,2002-12-01,13,18,13,18,31
70901,SAMAIPATA,estado nutricional en menores de 5 anos,clasificacion d,2002-12-01,28,19,28,19,47
51601,SAN AGUSTIN,estado nutricional en menores de 5 anos,clasificacion d,2002-12-01,3,10,3,10,13
80602,SAN ANDRES,estado nutricional en menores de 5 anos,clasificacion d,2002-12-01,17,15,17,15,32
51003,SAN ANTONIO DE ESMORUCO,estado nutricional en menores de 5 anos,clasificacion d,2002-12-01,3,5,3,5,8
71105,SAN ANTONIO DE LOMERIO,estado nutricional en menores de 5 anos,clasificacion d,2002-12-01,88,124,88,124,212
31403,SAN BENITO,estado nutricional en menores de 5 anos,clasificacion d,2002-12-01,8,8,8,8,16
80302,SAN BORJA,estado nutricional en menores de 5 anos,clasificacion d,2002-12-01,78,109,78,109,187
21502,SAN BUENA VENTURA,estado nutricional en menores de 5 anos,clasificacion d,2002-12-01,19,32,19,32,51
70402,SAN CARLOS,estado nutricional en menores de 5 anos,clasificacion d,2002-12-01,44,24,44,24,68
80501,SAN IGNACIO,estado nutricional en menores de 5 anos,clasificacion d,2002-12-01,57,52,57,52,109
70301,SAN IGNACIO DE VELASCO,estado nutricional en menores de 5 anos,clasificacion d,2002-12-01,167,279,167,279,446
80102,SAN JAVIER(BNI),estado nutricional en menores de 5 anos,clasificacion d,2002-12-01,2,0,2,0,2
71102,SAN JAVIER(STC),estado nutricional en menores de 5 anos,clasificacion d,2002-12-01,47,83,47,83,130
80701,SAN JOAQUIN,estado nutricional en menores de 5 anos,clasificacion d,2002-12-01,4,6,4,6,10
70501,SAN JOSE DE CHIQUITOS,estado nutricional en menores de 5 anos,clasificacion d,2002-12-01,25,13,25,13,38
71104,SAN JULIAN,estado nutricional en menores de 5 anos,clasificacion d,2002-12-01,92,138,92,138,230
90302,SAN LORENZO(PND),estado nutricional en menores de 5 anos,clasificacion d,2002-12-01,5,6,5,6,11
60501,SAN LORENZO(TJA),estado nutricional en menores de 5 anos,clasificacion d,2002-12-01,72,102,72,102,174
10702,SAN LUCAS,estado nutricional en menores de 5 anos,clasificacion d,2002-12-01,283,376,283,376,659
70302,SAN MIGUEL DE VELASCO,estado nutricional en menores de 5 anos,clasificacion d,2002-12-01,72,97,72,97,169
51001,SAN PABLO DE LIPEZ,estado nutricional en menores de 5 anos,clasificacion d,2002-12-01,5,21,5,21,26
50501,SAN PEDRO DE BUENA VISTA,estado nutricional en menores de 5 anos,clasificacion d,2002-12-01,75,173,75,173,248
21801,SAN PEDRO DE CURAHUARA,estado nutricional en menores de 5 anos,clasificacion d,2002-12-01,21,29,21,29,50
50902,SAN PEDRO DE QUEMES,estado nutricional en menores de 5 anos,clasificacion d,2002-12-01,4,0,4,0,4
21702,SAN PEDRO DE TIQUINA,estado nutricional en menores de 5 anos,clasificacion d,2002-12-01,7,8,7,8,15
70303,SAN RAFAEL,estado nutricional en menores de 5 anos,clasificacion d,2002-12-01,15,22,15,22,37
80702,SAN RAMON,estado nutricional en menores de 5 anos,clasificacion d,2002-12-01,2,1,2,1,3
80702,SAN RAMON,estado nutricional en menores de 5 anos,clasificacion d,2002-12-01,12,26,12,26,38
80401,SANTA ANA,estado nutricional en menores de 5 anos,clasificacion d,2002-12-01,29,51,29,51,80
70101,SANTA CRUZ DE LA SIERRA,estado nutricional en menores de 5 anos,clasificacion d,2002-12-01,600,272,600,272,872
80303,SANTA ROSA,estado nutricional en menores de 5 anos,clasificacion d,2002-12-01,13,11,13,11,24
70602,SANTA ROSA DEL SARA,estado nutricional en menores de 5 anos,clasificacion d,2002-12-01,12,37,12,37,49
20308,SANTIAGO DE CALLAPA,estado nutricional en menores de 5 anos,clasificacion d,2002-12-01,36,87,36,87,123
41401,SANTIAGO DE HUARI,estado nutricional en menores de 5 anos,clasificacion d,2002-12-01,9,15,9,15,24
21901,SANTIAGO DE MACHACA,estado nutricional en menores de 5 anos,clasificacion d,2002-12-01,5,7,5,7,12
30702,SANTIVAÃ‘ES,estado nutricional en menores de 5 anos,clasificacion d,2002-12-01,8,8,8,8,16
40202,SANTUARIO DE QUILLACAS,estado nutricional en menores de 5 anos,clasificacion d,2002-12-01,5,11,5,11,16
20902,SAPAHAQUI,estado nutricional en menores de 5 anos,clasificacion d,2002-12-01,19,27,19,27,46
90303,SENA,estado nutricional en menores de 5 anos,clasificacion d,2002-12-01,4,2,4,2,6
21301,SICA SICA (VILLA AROMA),estado nutricional en menores de 5 anos,clasificacion d,2002-12-01,49,44,49,44,93
30703,SICAYA,estado nutricional en menores de 5 anos,clasificacion d,2002-12-01,10,19,10,19,29
30902,SIPE SIPE,estado nutricional en menores de 5 anos,clasificacion d,2002-12-01,140,73,140,73,213
10403,SOPACHUY,estado nutricional en menores de 5 anos,clasificacion d,2002-12-01,70,67,70,67,137
20601,SORATA,estado nutricional en menores de 5 anos,clasificacion d,2002-12-01,37,89,37,89,126
10101,SUCRE,estado nutricional en menores de 5 anos,clasificacion d,2002-12-01,413,439,413,439,852
31404,TACACHI,estado nutricional en menores de 5 anos,clasificacion d,2002-12-01,2,6,2,6,8
20603,TACACOMA,estado nutricional en menores de 5 anos,clasificacion d,2002-12-01,13,35,13,35,48
50303,TACOBAMBA,estado nutricional en menores de 5 anos,clasificacion d,2002-12-01,39,62,39,62,101
30602,TACOPAYA,estado nutricional en menores de 5 anos,clasificacion d,2002-12-01,22,26,22,26,48
51402,TAHUA,estado nutricional en menores de 5 anos,clasificacion d,2002-12-01,3,6,3,6,9
31101,TAPACARI,estado nutricional en menores de 5 anos,clasificacion d,2002-12-01,52,79,52,79,131
10601,TARABUCO,estado nutricional en menores de 5 anos,clasificacion d,2002-12-01,288,453,288,453,741
30401,TARATA,estado nutricional en menores de 5 anos,clasificacion d,2002-12-01,6,6,6,6,12
60101,TARIJA,estado nutricional en menores de 5 anos,clasificacion d,2002-12-01,198,184,198,184,382
10202,TARVITA,estado nutricional en menores de 5 anos,clasificacion d,2002-12-01,94,218,94,218,312
20803,TIAWANACU,estado nutricional en menores de 5 anos,clasificacion d,2002-12-01,10,17,10,17,27
50102,TINGUIPAYA,estado nutricional en menores de 5 anos,clasificacion d,2002-12-01,35,78,35,78,113
20606,TIPUANI,estado nutricional en menores de 5 anos,clasificacion d,2002-12-01,11,9,11,9,20
30903,TIQUIPAYA,estado nutricional en menores de 5 anos,clasificacion d,2002-12-01,18,55,18,55,73
31601,TIRAQUE (CBBA),estado nutricional en menores de 5 anos,clasificacion d,2002-12-01,82,154,82,154,236
21703,TITO YUPANQUI (PARQUIPUJIO),estado nutricional en menores de 5 anos,clasificacion d,2002-12-01,4,5,4,5,9
30802,TOCO,estado nutricional en menores de 5 anos,clasificacion d,2002-12-01,3,5,3,5,8
41502,TODOS SANTOS,estado nutricional en menores de 5 anos,clasificacion d,2002-12-01,0,1,0,1,1
30803,TOLATA,estado nutricional en menores de 5 anos,clasificacion d,2002-12-01,2,1,2,1,3
41001,TOLEDO,estado nutricional en menores de 5 anos,clasificacion d,2002-12-01,11,5,11,5,16
51202,TOMAVE,estado nutricional en menores de 5 anos,clasificacion d,2002-12-01,40,62,40,62,102
10402,TOMINA,estado nutricional en menores de 5 anos,clasificacion d,2002-12-01,101,174,101,174,275
50502,TORO TORO,estado nutricional en menores de 5 anos,clasificacion d,2002-12-01,42,74,42,74,116
31201,TOTORA(CBBA),estado nutricional en menores de 5 anos,clasificacion d,2002-12-01,38,33,38,33,71
41301,TOTORA(ORR),estado nutricional en menores de 5 anos,clasificacion d,2002-12-01,16,13,16,13,29
70802,TRIGAL,estado nutricional en menores de 5 anos,clasificacion d,2002-12-01,4,4,4,4,8
80101,TRINIDAD,estado nutricional en menores de 5 anos,clasificacion d,2002-12-01,95,179,95,179,274
50801,TUPIZA,estado nutricional en menores de 5 anos,clasificacion d,2002-12-01,49,348,49,348,397
40402,TURCO,estado nutricional en menores de 5 anos,clasificacion d,2002-12-01,7,13,7,13,20
21302,UMALA,estado nutricional en menores de 5 anos,clasificacion d,2002-12-01,9,16,9,16,25
50201,UNCIA,estado nutricional en menores de 5 anos,clasificacion d,2002-12-01,12,3,12,3,15
60401,URIONDO (A. CONCEPCION),estado nutricional en menores de 5 anos,clasificacion d,2002-12-01,24,23,24,23,47
71502,URUBICHA,estado nutricional en menores de 5 anos,clasificacion d,2002-12-01,30,48,30,48,78
51201,UYUNI,estado nutricional en menores de 5 anos,clasificacion d,2002-12-01,53,81,53,81,134
30502,VACAS,estado nutricional en menores de 5 anos,clasificacion d,2002-12-01,26,52,26,52,78
70801,VALLEGRANDE,estado nutricional en menores de 5 anos,clasificacion d,2002-12-01,42,52,42,52,94
20801,VIACHA,estado nutricional en menores de 5 anos,clasificacion d,2002-12-01,64,81,64,81,145
31302,VILA VILA,estado nutricional en menores de 5 anos,clasificacion d,2002-12-01,3,31,3,31,34
60303,VILLA MONTES,estado nutricional en menores de 5 anos,clasificacion d,2002-12-01,44,41,44,41,85
31402,VILLA RIVERO,estado nutricional en menores de 5 anos,clasificacion d,2002-12-01,5,16,5,16,21
10801,VILLA SERRANO,estado nutricional en menores de 5 anos,clasificacion d,2002-12-01,106,200,106,200,306
31003,VILLA TUNARI,estado nutricional en menores de 5 anos,clasificacion d,2002-12-01,66,75,66,75,141
11001,VILLA VACA GUZMAN (MUYUPAMPA),estado nutricional en menores de 5 anos,clasificacion d,2002-12-01,76,91,76,91,167
51501,VILLAZON,estado nutricional en menores de 5 anos,clasificacion d,2002-12-01,147,169,147,169,316
30904,VINTO,estado nutricional en menores de 5 anos,clasificacion d,2002-12-01,47,22,47,22,69
50602,VITICHI,estado nutricional en menores de 5 anos,clasificacion d,2002-12-01,63,99,63,99,162
20306,WALDO BALLIVIAN,estado nutricional en menores de 5 anos,clasificacion d,2002-12-01,5,1,5,1,6
70201,WARNES,estado nutricional en menores de 5 anos,clasificacion d,2002-12-01,90,59,90,59,149
20903,YACO,estado nutricional en menores de 5 anos,clasificacion d,2002-12-01,12,19,12,19,31
60301,YACUIBA,estado nutricional en menores de 5 anos,clasificacion d,2002-12-01,75,62,75,62,137
10602,YAMPARAEZ,estado nutricional en menores de 5 anos,clasificacion d,2002-12-01,159,284,159,284,443
21103,YANACACHI,estado nutricional en menores de 5 anos,clasificacion d,2002-12-01,10,7,10,7,17
50103,YOCALLA,estado nutricional en menores de 5 anos,clasificacion d,2002-12-01,13,37,13,37,50
10102,YOTALA,estado nutricional en menores de 5 anos,clasificacion d,2002-12-01,83,157,83,157,240
60402,YUNCHARA,estado nutricional en menores de 5 anos,clasificacion d,2002-12-01,13,31,13,31,44
10301,ZUDAÃ‘EZ,estado nutricional en menores de 5 anos,clasificacion d,2002-12-01,53,119,53,119,172
51302,ACACIO,estado nutricional en menores de 5 anos,clasificacion d,2003-01-01,57,112,57,112,169
20201,ACHACACHI,estado nutricional en menores de 5 anos,clasificacion d,2003-01-01,143,152,143,152,295
20104,ACHOCALLA,estado nutricional en menores de 5 anos,clasificacion d,2003-01-01,16,10,16,10,26
30201,AIQUILE,estado nutricional en menores de 5 anos,clasificacion d,2003-01-01,42,28,42,28,70
31303,ALALAY,estado nutricional en menores de 5 anos,clasificacion d,2003-01-01,19,4,19,4,23
10404,ALCALA,estado nutricional en menores de 5 anos,clasificacion d,2003-01-01,29,56,29,56,85
20202,ANCORAIMES,estado nutricional en menores de 5 anos,clasificacion d,2003-01-01,72,125,72,125,197
41201,ANDAMARCA,estado nutricional en menores de 5 anos,clasificacion d,2003-01-01,4,3,4,3,7
40603,ANTEQUERA,estado nutricional en menores de 5 anos,clasificacion d,2003-01-01,7,4,7,4,11
30402,ANZALDO,estado nutricional en menores de 5 anos,clasificacion d,2003-01-01,15,27,15,27,42
20701,APOLO,estado nutricional en menores de 5 anos,clasificacion d,2003-01-01,39,38,39,38,77
51301,ARAMPAMPA,estado nutricional en menores de 5 anos,clasificacion d,2003-01-01,28,85,28,85,113
30501,ARANI,estado nutricional en menores de 5 anos,clasificacion d,2003-01-01,7,11,7,11,18
30403,ARBIETO,estado nutricional en menores de 5 anos,clasificacion d,2003-01-01,16,10,16,10,26
30601,ARQUE,estado nutricional en menores de 5 anos,clasificacion d,2003-01-01,19,19,19,19,38
50802,ATOCHA,estado nutricional en menores de 5 anos,clasificacion d,2003-01-01,18,108,18,108,126
20503,AUCAPATA,estado nutricional en menores de 5 anos,clasificacion d,2003-01-01,5,9,5,9,14
20502,AYATA,estado nutricional en menores de 5 anos,clasificacion d,2003-01-01,17,5,17,5,22
21303,AYO AYO,estado nutricional en menores de 5 anos,clasificacion d,2003-01-01,20,1,20,1,21
30301,AYOPAYA (V. DE INDEPENDENCIA),estado nutricional en menores de 5 anos,clasificacion d,2003-01-01,68,56,68,56,124
10201,AZURDUY,estado nutricional en menores de 5 anos,clasificacion d,2003-01-01,118,167,118,167,285
21203,BATALLAS,estado nutricional en menores de 5 anos,clasificacion d,2003-01-01,36,20,36,20,56
80802,BAURES,estado nutricional en menores de 5 anos,clasificacion d,2003-01-01,16,27,16,27,43
50104,BELEN DE URMIRI,estado nutricional en menores de 5 anos,clasificacion d,2003-01-01,8,17,8,17,25
90104,BELLA FLOR,estado nutricional en menores de 5 anos,clasificacion d,2003-01-01,1,11,1,11,12
60202,BERMEJO,estado nutricional en menores de 5 anos,clasificacion d,2003-01-01,5,12,5,12,17
50301,BETANZOS,estado nutricional en menores de 5 anos,clasificacion d,2003-01-01,329,315,329,315,644
31501,BOLIVAR,estado nutricional en menores de 5 anos,clasificacion d,2003-01-01,58,45,58,45,103
90103,BOLPEBRA,estado nutricional en menores de 5 anos,clasificacion d,2003-01-01,4,6,4,6,10
70707,BOYUIBE,estado nutricional en menores de 5 anos,clasificacion d,2003-01-01,4,11,4,11,15
70401,BUENA VISTA,estado nutricional en menores de 5 anos,clasificacion d,2003-01-01,49,39,49,39,88
70703,CABEZAS,estado nutricional en menores de 5 anos,clasificacion d,2003-01-01,32,71,32,71,103
20905,CAIROMA,estado nutricional en menores de 5 anos,clasificacion d,2003-01-01,26,17,26,17,43
51102,"CAIZA ""D""",estado nutricional en menores de 5 anos,clasificacion d,2003-01-01,104,91,104,91,195
21003,CAJUATA,estado nutricional en menores de 5 anos,clasificacion d,2003-01-01,39,35,39,35,74
20303,CALACOTO,estado nutricional en menores de 5 anos,clasificacion d,2003-01-01,15,8,15,8,23
21304,CALAMARCA,estado nutricional en menores de 5 anos,clasificacion d,2003-01-01,93,68,93,68,161
10701,CAMARGO,estado nutricional en menores de 5 anos,clasificacion d,2003-01-01,81,116,81,116,197
10901,CAMATAQUI (C. VILLA ABECIA),estado nutricional en menores de 5 anos,clasificacion d,2003-01-01,13,25,13,25,38
70706,CAMIRI,estado nutricional en menores de 5 anos,clasificacion d,2003-01-01,218,172,218,172,390
30701,CAPINOTA,estado nutricional en menores de 5 anos,clasificacion d,2003-01-01,28,35,28,35,63
20302,CAQUIAVIRI,estado nutricional en menores de 5 anos,clasificacion d,2003-01-01,19,28,19,28,47
40102,CARACOLLO,estado nutricional en menores de 5 anos,clasificacion d,2003-01-01,44,65,44,65,109
22001,CARANAVI,estado nutricional en menores de 5 anos,clasificacion d,2003-01-01,107,89,107,89,196
41503,CARANGAS,estado nutricional en menores de 5 anos,clasificacion d,2003-01-01,2,0,2,0,2
60302,CARAPARI,estado nutricional en menores de 5 anos,clasificacion d,2003-01-01,52,54,52,54,106
50702,CARIPUYO,estado nutricional en menores de 5 anos,clasificacion d,2003-01-01,66,124,66,124,190
21902,CATACORA,estado nutricional en menores de 5 anos,clasificacion d,2003-01-01,4,7,4,7,11
40201,CHALLAPATA,estado nutricional en menores de 5 anos,clasificacion d,2003-01-01,44,125,44,125,169
50302,CHAQUI,estado nutricional en menores de 5 anos,clasificacion d,2003-01-01,80,65,80,65,145
70702,CHARAGUA,estado nutricional en menores de 5 anos,clasificacion d,2003-01-01,66,157,66,157,223
20305,CHARAÃ‘A,estado nutricional en menores de 5 anos,clasificacion d,2003-01-01,5,12,5,12,17
50202,CHAYANTA,estado nutricional en menores de 5 anos,clasificacion d,2003-01-01,67,76,67,76,143
31204,CHIMORE,estado nutricional en menores de 5 anos,clasificacion d,2003-01-01,16,18,16,18,34
40903,CHIPAYA,estado nutricional en menores de 5 anos,clasificacion d,2003-01-01,7,1,7,1,8
40302,CHOQUE COTA,estado nutricional en menores de 5 anos,clasificacion d,2003-01-01,10,10,10,10,20
21101,CHULUMANI (V. DE LA LIBERTAD),estado nutricional en menores de 5 anos,clasificacion d,2003-01-01,3,18,3,18,21
20501,CHUMA,estado nutricional en menores de 5 anos,clasificacion d,2003-01-01,14,16,14,16,30
30801,CLIZA,estado nutricional en menores de 5 anos,clasificacion d,2003-01-01,19,7,19,7,26
90101,COBIJA,estado nutricional en menores de 5 anos,clasificacion d,2003-01-01,86,92,86,92,178
30101,COCHABAMBA,estado nutricional en menores de 5 anos,clasificacion d,2003-01-01,455,341,455,341,796
30905,COLCAPIRHUA,estado nutricional en menores de 5 anos,clasificacion d,2003-01-01,68,29,68,29,97
50901,"COLCHA ""K""",estado nutricional en menores de 5 anos,clasificacion d,2003-01-01,33,57,33,57,90
21307,COLLANA,estado nutricional en menores de 5 anos,clasificacion d,2003-01-01,0,8,0,8,8
31002,COLOMI,estado nutricional en menores de 5 anos,clasificacion d,2003-01-01,54,41,54,41,95
50401,COLQUECHACA,estado nutricional en menores de 5 anos,clasificacion d,2003-01-01,112,91,112,91,203
21306,COLQUENCHA,estado nutricional en menores de 5 anos,clasificacion d,2003-01-01,12,7,12,7,19
21004,COLQUIRI,estado nutricional en menores de 5 anos,clasificacion d,2003-01-01,89,72,89,72,161
20304,COMANCHE,estado nutricional en menores de 5 anos,clasificacion d,2003-01-01,4,3,4,3,7
71301,COMARAPA,estado nutricional en menores de 5 anos,clasificacion d,2003-01-01,76,46,76,46,122
20605,COMBAYA,estado nutricional en menores de 5 anos,clasificacion d,2003-01-01,9,8,9,8,17
71101,CONCEPCION,estado nutricional en menores de 5 anos,clasificacion d,2003-01-01,12,6,12,6,18
21701,COPACABANA,estado nutricional en menores de 5 anos,clasificacion d,2003-01-01,11,12,11,12,23
21402,CORIPATA,estado nutricional en menores de 5 anos,clasificacion d,2003-01-01,3,5,3,5,8
20301,CORO CORO,estado nutricional en menores de 5 anos,clasificacion d,2003-01-01,36,41,36,41,77
21401,COROICO,estado nutricional en menores de 5 anos,clasificacion d,2003-01-01,29,31,29,31,60
40301,CORQUE,estado nutricional en menores de 5 anos,clasificacion d,2003-01-01,15,5,15,5,20
50601,COTAGAITA,estado nutricional en menores de 5 anos,clasificacion d,2003-01-01,96,163,96,163,259
70102,COTOCA,estado nutricional en menores de 5 anos,clasificacion d,2003-01-01,80,41,80,41,121
31405,CUCHUMUELA (V. G. VILLARROEL),estado nutricional en menores de 5 anos,clasificacion d,2003-01-01,7,8,7,8,15
70704,CUEVO,estado nutricional en menores de 5 anos,clasificacion d,2003-01-01,21,15,21,15,36
10902,CULPINA,estado nutricional en menores de 5 anos,clasificacion d,2003-01-01,125,158,125,158,283
40401,CURAHUARA DE CARANGAS,estado nutricional en menores de 5 anos,clasificacion d,2003-01-01,10,13,10,13,23
21602,CURVA,estado nutricional en menores de 5 anos,clasificacion d,2003-01-01,16,16,16,16,32
20804,DESAGUADERO,estado nutricional en menores de 5 anos,clasificacion d,2003-01-01,10,3,10,3,13
20105,EL ALTO,estado nutricional en menores de 5 anos,clasificacion d,2003-01-01,1800,1079,1800,1079,2879
40103,EL CHORO,estado nutricional en menores de 5 anos,clasificacion d,2003-01-01,5,6,5,6,11
71503,EL PUENTE(STC),estado nutricional en menores de 5 anos,clasificacion d,2003-01-01,5,110,5,110,115
60502,EL PUENTE(TJA),estado nutricional en menores de 5 anos,clasificacion d,2003-01-01,26,75,26,75,101
70105,EL TORNO,estado nutricional en menores de 5 anos,clasificacion d,2003-01-01,76,107,76,107,183
10405,EL VILLAR,estado nutricional en menores de 5 anos,clasificacion d,2003-01-01,40,107,40,107,147
60601,ENTRE RIOS,estado nutricional en menores de 5 anos,clasificacion d,2003-01-01,46,39,46,39,85
40502,ESCARA,estado nutricional en menores de 5 anos,clasificacion d,2003-01-01,1,2,1,2,3
41101,EUCALIPTUS,estado nutricional en menores de 5 anos,clasificacion d,2003-01-01,8,9,8,9,17
80402,EXALTACION,estado nutricional en menores de 5 anos,clasificacion d,2003-01-01,6,12,6,12,18
90203,FILADELFIA,estado nutricional en menores de 5 anos,clasificacion d,2003-01-01,5,6,5,6,11
71002,GENERAL SAAVEDRA,estado nutricional en menores de 5 anos,clasificacion d,2003-01-01,98,121,98,121,219
21601,GRAL. J.J. PEREZ (CHARAZANI),estado nutricional en menores de 5 anos,clasificacion d,2003-01-01,5,0,5,0,5
20602,GUANAY,estado nutricional en menores de 5 anos,clasificacion d,2003-01-01,56,100,56,100,156
20802,GUAQUI,estado nutricional en menores de 5 anos,clasificacion d,2003-01-01,8,6,8,6,14
80202,GUAYARAMERIN,estado nutricional en menores de 5 anos,clasificacion d,2003-01-01,145,136,145,136,281
70705,GUTIERREZ,estado nutricional en menores de 5 anos,clasificacion d,2003-01-01,115,170,115,170,285
10502,HUACARETA,estado nutricional en menores de 5 anos,clasificacion d,2003-01-01,45,98,45,98,143
11002,HUACAYA (VILLA DE HUACAYA),estado nutricional en menores de 5 anos,clasificacion d,2003-01-01,12,21,12,21,33
40501,HUACHACALLA,estado nutricional en menores de 5 anos,clasificacion d,2003-01-01,2,4,2,4,6
40701,HUANUNI,estado nutricional en menores de 5 anos,clasificacion d,2003-01-01,86,56,86,56,142
80803,HUARACAJE,estado nutricional en menores de 5 anos,clasificacion d,2003-01-01,17,9,17,9,26
41601,HUAYLLAMARCA,estado nutricional en menores de 5 anos,clasificacion d,2003-01-01,15,24,15,24,39
21005,ICHOCA,estado nutricional en menores de 5 anos,clasificacion d,2003-01-01,21,37,21,37,58
10304,ICLA,estado nutricional en menores de 5 anos,clasificacion d,2003-01-01,53,111,53,111,164
10703,INCAHUASI,estado nutricional en menores de 5 anos,clasificacion d,2003-01-01,161,180,161,180,341
21001,INQUISIVI,estado nutricional en menores de 5 anos,clasificacion d,2003-01-01,79,121,79,121,200
21102,IRUPANA (VILLA DE LANZA),estado nutricional en menores de 5 anos,clasificacion d,2003-01-01,29,45,29,45,74
21501,IXIAMAS,estado nutricional en menores de 5 anos,clasificacion d,2003-01-01,23,47,23,47,70
21105,LA ASUNTA,estado nutricional en menores de 5 anos,clasificacion d,2003-01-01,17,36,17,36,53
70104,LA GUARDIA,estado nutricional en menores de 5 anos,clasificacion d,2003-01-01,99,77,99,77,176
20101,LA PAZ,estado nutricional en menores de 5 anos,clasificacion d,2003-01-01,1221,995,1221,995,2216
70701,LAGUNILLAS,estado nutricional en menores de 5 anos,clasificacion d,2003-01-01,43,62,43,62,105
21202,LAJA,estado nutricional en menores de 5 anos,clasificacion d,2003-01-01,12,18,12,18,30
10903,LAS CARRERAS,estado nutricional en menores de 5 anos,clasificacion d,2003-01-01,19,61,19,61,80
21006,LICOMA PAMPA,estado nutricional en menores de 5 anos,clasificacion d,2003-01-01,12,2,12,2,14
50203,LLALLAGUA,estado nutricional en menores de 5 anos,clasificacion d,2003-01-01,23,352,23,352,375
51401,LLICA,estado nutricional en menores de 5 anos,clasificacion d,2003-01-01,18,16,18,16,34
80601,LORETO,estado nutricional en menores de 5 anos,clasificacion d,2003-01-01,15,8,15,8,23
20901,LURIBAY,estado nutricional en menores de 5 anos,clasificacion d,2003-01-01,45,19,45,19,64
40702,MACHACAMARCA,estado nutricional en menores de 5 anos,clasificacion d,2003-01-01,7,6,7,6,13
11003,MACHARETI,estado nutricional en menores de 5 anos,clasificacion d,2003-01-01,54,80,54,80,134
80801,MAGDALENA,estado nutricional en menores de 5 anos,clasificacion d,2003-01-01,32,48,32,48,80
70903,MAIRANA,estado nutricional en menores de 5 anos,clasificacion d,2003-01-01,28,24,28,24,52
20904,MALLA,estado nutricional en menores de 5 anos,clasificacion d,2003-01-01,3,3,3,3,6
20103,MECAPACA,estado nutricional en menores de 5 anos,clasificacion d,2003-01-01,13,14,13,14,27
71003,MINEROS,estado nutricional en menores de 5 anos,clasificacion d,2003-01-01,151,141,151,141,292
31301,MIZQUE,estado nutricional en menores de 5 anos,clasificacion d,2003-01-01,15,6,15,6,21
20402,MOCOMOCO,estado nutricional en menores de 5 anos,clasificacion d,2003-01-01,29,23,29,23,52
51002,MOJINETE,estado nutricional en menores de 5 anos,clasificacion d,2003-01-01,2,15,2,15,17
10303,MOJOCOYA,estado nutricional en menores de 5 anos,clasificacion d,2003-01-01,63,110,63,110,173
10501,MONTEAGUDO,estado nutricional en menores de 5 anos,clasificacion d,2003-01-01,131,178,131,178,309
71001,MONTERO,estado nutricional en menores de 5 anos,clasificacion d,2003-01-01,480,255,480,255,735
70803,MORO MORO,estado nutricional en menores de 5 anos,clasificacion d,2003-01-01,7,13,7,13,20
30302,MOROCHATA,estado nutricional en menores de 5 anos,clasificacion d,2003-01-01,88,156,88,156,244
90401,NACEBE (SANTA ROSA DEL ABUNA),estado nutricional en menores de 5 anos,clasificacion d,2003-01-01,0,4,0,4,4
20307,NAZACARA DE PACAJES,estado nutricional en menores de 5 anos,clasificacion d,2003-01-01,3,2,3,2,5
90501,NUEVO MANOA (NUEVA ESPERANZA),estado nutricional en menores de 5 anos,clasificacion d,2003-01-01,0,5,0,5,5
50404,OCURI,estado nutricional en menores de 5 anos,clasificacion d,2003-01-01,41,158,41,158,199
70202,OKINAWA,estado nutricional en menores de 5 anos,clasificacion d,2003-01-01,16,25,16,25,41
30203,OMEREQUE,estado nutricional en menores de 5 anos,clasificacion d,2003-01-01,1,15,1,15,16
40101,ORURO,estado nutricional en menores de 5 anos,clasificacion d,2003-01-01,744,621,744,621,1365
60201,PADCAYA,estado nutricional en menores de 5 anos,clasificacion d,2003-01-01,29,23,29,23,52
10401,PADILLA,estado nutricional en menores de 5 anos,clasificacion d,2003-01-01,106,200,106,200,306
70502,PAILON,estado nutricional en menores de 5 anos,clasificacion d,2003-01-01,55,33,55,33,88
20102,PALCA,estado nutricional en menores de 5 anos,clasificacion d,2003-01-01,35,39,35,39,74
21104,PALOS BLANCOS,estado nutricional en menores de 5 anos,clasificacion d,2003-01-01,64,67,64,67,131
40802,PAMPA AULLAGAS,estado nutricional en menores de 5 anos,clasificacion d,2003-01-01,10,12,10,12,22
70902,PAMPA GRANDE,estado nutricional en menores de 5 anos,clasificacion d,2003-01-01,21,14,21,14,35
21802,PAPEL PAMPA,estado nutricional en menores de 5 anos,clasificacion d,2003-01-01,4,3,4,3,7
30202,PASORAPA,estado nutricional en menores de 5 anos,clasificacion d,2003-01-01,9,17,9,17,26
21305,PATACAMAYA,estado nutricional en menores de 5 anos,clasificacion d,2003-01-01,80,70,80,70,150
40602,PAZÃ‘A,estado nutricional en menores de 5 anos,clasificacion d,2003-01-01,9,12,9,12,21
20702,PELECHUCO,estado nutricional en menores de 5 anos,clasificacion d,2003-01-01,27,22,27,22,49
50403,POCOATA,estado nutricional en menores de 5 anos,clasificacion d,2003-01-01,151,167,151,167,318
31203,POCONA,estado nutricional en menores de 5 anos,clasificacion d,2003-01-01,18,15,18,15,33
31202,POJO (CBBA),estado nutricional en menores de 5 anos,clasificacion d,2003-01-01,66,70,66,70,136
40601,POOPO,estado nutricional en menores de 5 anos,clasificacion d,2003-01-01,3,16,3,16,19
51203,PORCO,estado nutricional en menores de 5 anos,clasificacion d,2003-01-01,21,8,21,8,29
10103,POROMA,estado nutricional en menores de 5 anos,clasificacion d,2003-01-01,97,124,97,124,221
70103,PORONGO,estado nutricional en menores de 5 anos,clasificacion d,2003-01-01,18,21,18,21,39
70601,PORTACHUELO,estado nutricional en menores de 5 anos,clasificacion d,2003-01-01,76,65,76,65,141
90102,PORVENIR,estado nutricional en menores de 5 anos,clasificacion d,2003-01-01,14,9,14,9,23
70804,POSTRER VALLE,estado nutricional en menores de 5 anos,clasificacion d,2003-01-01,9,4,9,4,13
50101,POTOSI,estado nutricional en menores de 5 anos,clasificacion d,2003-01-01,619,452,619,452,1071
10302,PRESTO,estado nutricional en menores de 5 anos,clasificacion d,2003-01-01,59,84,59,84,143
70805,PUCARA,estado nutricional en menores de 5 anos,clasificacion d,2003-01-01,1,1,1,1,2
21201,PUCARANI,estado nutricional en menores de 5 anos,clasificacion d,2003-01-01,18,21,18,21,39
20401,PUERTO ACOSTA,estado nutricional en menores de 5 anos,clasificacion d,2003-01-01,71,127,71,127,198
20403,PUERTO CARABUCO,estado nutricional en menores de 5 anos,clasificacion d,2003-01-01,48,97,48,97,145
90301,PUERTO GONZALO MORENO,estado nutricional en menores de 5 anos,clasificacion d,2003-01-01,6,38,6,38,44
21204,PUERTO PEREZ,estado nutricional en menores de 5 anos,clasificacion d,2003-01-01,10,5,10,5,15
71402,PUERTO QUIJARRO,estado nutricional en menores de 5 anos,clasificacion d,2003-01-01,60,14,60,14,74
90201,PUERTO RICO,estado nutricional en menores de 5 anos,clasificacion d,2003-01-01,4,10,4,10,14
80703,PUERTO SILES,estado nutricional en menores de 5 anos,clasificacion d,2003-01-01,0,1,0,1,1
71401,PUERTO SUAREZ,estado nutricional en menores de 5 anos,clasificacion d,2003-01-01,66,20,66,20,86
31205,PUERTO VILLARROEL,estado nutricional en menores de 5 anos,clasificacion d,2003-01-01,157,123,157,123,280
51101,PUNA,estado nutricional en menores de 5 anos,clasificacion d,2003-01-01,255,340,255,340,595
31401,PUNATA,estado nutricional en menores de 5 anos,clasificacion d,2003-01-01,115,14,115,14,129
20604,QUIABAYA,estado nutricional en menores de 5 anos,clasificacion d,2003-01-01,17,42,17,42,59
30901,QUILLACOLLO,estado nutricional en menores de 5 anos,clasificacion d,2003-01-01,49,48,49,48,97
21002,QUIME,estado nutricional en menores de 5 anos,clasificacion d,2003-01-01,63,48,63,48,111
70904,QUIRUSILLAS,estado nutricional en menores de 5 anos,clasificacion d,2003-01-01,3,2,3,2,5
50402,RAVELO,estado nutricional en menores de 5 anos,clasificacion d,2003-01-01,156,174,156,174,330
80301,REYES,estado nutricional en menores de 5 anos,clasificacion d,2003-01-01,26,30,26,30,56
80201,RIBERALTA,estado nutricional en menores de 5 anos,clasificacion d,2003-01-01,311,245,311,245,556
70503,ROBORE,estado nutricional en menores de 5 anos,clasificacion d,2003-01-01,51,49,51,49,100
40901,SABAYA,estado nutricional en menores de 5 anos,clasificacion d,2003-01-01,1,6,1,6,7
31001,SACABA,estado nutricional en menores de 5 anos,clasificacion d,2003-01-01,143,105,143,105,248
50701,SACACA,estado nutricional en menores de 5 anos,clasificacion d,2003-01-01,140,261,140,261,401
71302,SAIPINA,estado nutricional en menores de 5 anos,clasificacion d,2003-01-01,20,29,20,29,49
40801,SALINAS DE GARCI MENDOZA,estado nutricional en menores de 5 anos,clasificacion d,2003-01-01,17,15,17,15,32
70901,SAMAIPATA,estado nutricional en menores de 5 anos,clasificacion d,2003-01-01,30,18,30,18,48
51601,SAN AGUSTIN,estado nutricional en menores de 5 anos,clasificacion d,2003-01-01,2,1,2,1,3
80602,SAN ANDRES,estado nutricional en menores de 5 anos,clasificacion d,2003-01-01,3,16,3,16,19
51003,SAN ANTONIO DE ESMORUCO,estado nutricional en menores de 5 anos,clasificacion d,2003-01-01,3,11,3,11,14
71105,SAN ANTONIO DE LOMERIO,estado nutricional en menores de 5 anos,clasificacion d,2003-01-01,108,145,108,145,253
31403,SAN BENITO,estado nutricional en menores de 5 anos,clasificacion d,2003-01-01,12,29,12,29,41
80302,SAN BORJA,estado nutricional en menores de 5 anos,clasificacion d,2003-01-01,111,58,111,58,169
21502,SAN BUENA VENTURA,estado nutricional en menores de 5 anos,clasificacion d,2003-01-01,52,63,52,63,115
70402,SAN CARLOS,estado nutricional en menores de 5 anos,clasificacion d,2003-01-01,72,66,72,66,138
80501,SAN IGNACIO,estado nutricional en menores de 5 anos,clasificacion d,2003-01-01,79,71,79,71,150
70301,SAN IGNACIO DE VELASCO,estado nutricional en menores de 5 anos,clasificacion d,2003-01-01,205,177,205,177,382
80102,SAN JAVIER(BNI),estado nutricional en menores de 5 anos,clasificacion d,2003-01-01,3,5,3,5,8
71102,SAN JAVIER(STC),estado nutricional en menores de 5 anos,clasificacion d,2003-01-01,40,29,40,29,69
80701,SAN JOAQUIN,estado nutricional en menores de 5 anos,clasificacion d,2003-01-01,5,17,5,17,22
70501,SAN JOSE DE CHIQUITOS,estado nutricional en menores de 5 anos,clasificacion d,2003-01-01,57,29,57,29,86
71104,SAN JULIAN,estado nutricional en menores de 5 anos,clasificacion d,2003-01-01,131,127,131,127,258
90302,SAN LORENZO(PND),estado nutricional en menores de 5 anos,clasificacion d,2003-01-01,5,14,5,14,19
60501,SAN LORENZO(TJA),estado nutricional en menores de 5 anos,clasificacion d,2003-01-01,49,49,49,49,98
10702,SAN LUCAS,estado nutricional en menores de 5 anos,clasificacion d,2003-01-01,311,336,311,336,647
71201,SAN MATIAS,estado nutricional en menores de 5 anos,clasificacion d,2003-01-01,73,41,73,41,114
70302,SAN MIGUEL DE VELASCO,estado nutricional en menores de 5 anos,clasificacion d,2003-01-01,48,56,48,56,104
51001,SAN PABLO DE LIPEZ,estado nutricional en menores de 5 anos,clasificacion d,2003-01-01,6,24,6,24,30
50501,SAN PEDRO DE BUENA VISTA,estado nutricional en menores de 5 anos,clasificacion d,2003-01-01,80,156,80,156,236
21801,SAN PEDRO DE CURAHUARA,estado nutricional en menores de 5 anos,clasificacion d,2003-01-01,22,28,22,28,50
50902,SAN PEDRO DE QUEMES,estado nutricional en menores de 5 anos,clasificacion d,2003-01-01,3,2,3,2,5
21702,SAN PEDRO DE TIQUINA,estado nutricional en menores de 5 anos,clasificacion d,2003-01-01,3,8,3,8,11
90202,SAN PEDRO(PND),estado nutricional en menores de 5 anos,clasificacion d,2003-01-01,6,8,6,8,14
70303,SAN RAFAEL,estado nutricional en menores de 5 anos,clasificacion d,2003-01-01,32,43,32,43,75
80702,SAN RAMON,estado nutricional en menores de 5 anos,clasificacion d,2003-01-01,5,2,5,2,7
80702,SAN RAMON,estado nutricional en menores de 5 anos,clasificacion d,2003-01-01,4,16,4,16,20
80401,SANTA ANA,estado nutricional en menores de 5 anos,clasificacion d,2003-01-01,3,1,3,1,4
70101,SANTA CRUZ DE LA SIERRA,estado nutricional en menores de 5 anos,clasificacion d,2003-01-01,1147,637,1147,637,1784
80303,SANTA ROSA,estado nutricional en menores de 5 anos,clasificacion d,2003-01-01,8,4,8,4,12
70602,SANTA ROSA DEL SARA,estado nutricional en menores de 5 anos,clasificacion d,2003-01-01,10,16,10,16,26
20308,SANTIAGO DE CALLAPA,estado nutricional en menores de 5 anos,clasificacion d,2003-01-01,24,22,24,22,46
41401,SANTIAGO DE HUARI,estado nutricional en menores de 5 anos,clasificacion d,2003-01-01,20,48,20,48,68
21901,SANTIAGO DE MACHACA,estado nutricional en menores de 5 anos,clasificacion d,2003-01-01,5,8,5,8,13
30702,SANTIVAÃ‘ES,estado nutricional en menores de 5 anos,clasificacion d,2003-01-01,10,8,10,8,18
40202,SANTUARIO DE QUILLACAS,estado nutricional en menores de 5 anos,clasificacion d,2003-01-01,10,2,10,2,12
20902,SAPAHAQUI,estado nutricional en menores de 5 anos,clasificacion d,2003-01-01,11,8,11,8,19
90303,SENA,estado nutricional en menores de 5 anos,clasificacion d,2003-01-01,1,10,1,10,11
21301,SICA SICA (VILLA AROMA),estado nutricional en menores de 5 anos,clasificacion d,2003-01-01,85,82,85,82,167
30703,SICAYA,estado nutricional en menores de 5 anos,clasificacion d,2003-01-01,15,2,15,2,17
30902,SIPE SIPE,estado nutricional en menores de 5 anos,clasificacion d,2003-01-01,129,77,129,77,206
10403,SOPACHUY,estado nutricional en menores de 5 anos,clasificacion d,2003-01-01,39,48,39,48,87
20601,SORATA,estado nutricional en menores de 5 anos,clasificacion d,2003-01-01,25,78,25,78,103
10101,SUCRE,estado nutricional en menores de 5 anos,clasificacion d,2003-01-01,448,447,448,447,895
31404,TACACHI,estado nutricional en menores de 5 anos,clasificacion d,2003-01-01,11,4,11,4,15
20603,TACACOMA,estado nutricional en menores de 5 anos,clasificacion d,2003-01-01,9,15,9,15,24
50303,TACOBAMBA,estado nutricional en menores de 5 anos,clasificacion d,2003-01-01,18,36,18,36,54
30602,TACOPAYA,estado nutricional en menores de 5 anos,clasificacion d,2003-01-01,66,111,66,111,177
51402,TAHUA,estado nutricional en menores de 5 anos,clasificacion d,2003-01-01,4,0,4,0,4
31101,TAPACARI,estado nutricional en menores de 5 anos,clasificacion d,2003-01-01,53,80,53,80,133
10601,TARABUCO,estado nutricional en menores de 5 anos,clasificacion d,2003-01-01,268,450,268,450,718
30401,TARATA,estado nutricional en menores de 5 anos,clasificacion d,2003-01-01,20,23,20,23,43
60101,TARIJA,estado nutricional en menores de 5 anos,clasificacion d,2003-01-01,330,212,330,212,542
10202,TARVITA,estado nutricional en menores de 5 anos,clasificacion d,2003-01-01,95,181,95,181,276
20803,TIAWANACU,estado nutricional en menores de 5 anos,clasificacion d,2003-01-01,26,22,26,22,48
50102,TINGUIPAYA,estado nutricional en menores de 5 anos,clasificacion d,2003-01-01,64,85,64,85,149
20606,TIPUANI,estado nutricional en menores de 5 anos,clasificacion d,2003-01-01,15,9,15,9,24
30903,TIQUIPAYA,estado nutricional en menores de 5 anos,clasificacion d,2003-01-01,55,31,55,31,86
31601,TIRAQUE (CBBA),estado nutricional en menores de 5 anos,clasificacion d,2003-01-01,67,134,67,134,201
21703,TITO YUPANQUI (PARQUIPUJIO),estado nutricional en menores de 5 anos,clasificacion d,2003-01-01,3,1,3,1,4
30802,TOCO,estado nutricional en menores de 5 anos,clasificacion d,2003-01-01,6,2,6,2,8
30803,TOLATA,estado nutricional en menores de 5 anos,clasificacion d,2003-01-01,19,20,19,20,39
41001,TOLEDO,estado nutricional en menores de 5 anos,clasificacion d,2003-01-01,13,4,13,4,17
51202,TOMAVE,estado nutricional en menores de 5 anos,clasificacion d,2003-01-01,63,59,63,59,122
10402,TOMINA,estado nutricional en menores de 5 anos,clasificacion d,2003-01-01,83,150,83,150,233
50502,TORO TORO,estado nutricional en menores de 5 anos,clasificacion d,2003-01-01,47,40,47,40,87
31201,TOTORA(CBBA),estado nutricional en menores de 5 anos,clasificacion d,2003-01-01,22,29,22,29,51
41301,TOTORA(ORR),estado nutricional en menores de 5 anos,clasificacion d,2003-01-01,8,6,8,6,14
70802,TRIGAL,estado nutricional en menores de 5 anos,clasificacion d,2003-01-01,1,9,1,9,10
80101,TRINIDAD,estado nutricional en menores de 5 anos,clasificacion d,2003-01-01,200,263,200,263,463
50801,TUPIZA,estado nutricional en menores de 5 anos,clasificacion d,2003-01-01,114,312,114,312,426
40402,TURCO,estado nutricional en menores de 5 anos,clasificacion d,2003-01-01,10,13,10,13,23
21302,UMALA,estado nutricional en menores de 5 anos,clasificacion d,2003-01-01,22,18,22,18,40
50201,UNCIA,estado nutricional en menores de 5 anos,clasificacion d,2003-01-01,9,43,9,43,52
60401,URIONDO (A. CONCEPCION),estado nutricional en menores de 5 anos,clasificacion d,2003-01-01,27,22,27,22,49
71502,URUBICHA,estado nutricional en menores de 5 anos,clasificacion d,2003-01-01,16,22,16,22,38
51201,UYUNI,estado nutricional en menores de 5 anos,clasificacion d,2003-01-01,65,56,65,56,121
30502,VACAS,estado nutricional en menores de 5 anos,clasificacion d,2003-01-01,27,27,27,27,54
70801,VALLEGRANDE,estado nutricional en menores de 5 anos,clasificacion d,2003-01-01,72,71,72,71,143
20801,VIACHA,estado nutricional en menores de 5 anos,clasificacion d,2003-01-01,79,111,79,111,190
31302,VILA VILA,estado nutricional en menores de 5 anos,clasificacion d,2003-01-01,13,15,13,15,28
60303,VILLA MONTES,estado nutricional en menores de 5 anos,clasificacion d,2003-01-01,93,78,93,78,171
31402,VILLA RIVERO,estado nutricional en menores de 5 anos,clasificacion d,2003-01-01,32,10,32,10,42
10801,VILLA SERRANO,estado nutricional en menores de 5 anos,clasificacion d,2003-01-01,81,160,81,160,241
31003,VILLA TUNARI,estado nutricional en menores de 5 anos,clasificacion d,2003-01-01,99,135,99,135,234
11001,VILLA VACA GUZMAN (MUYUPAMPA),estado nutricional en menores de 5 anos,clasificacion d,2003-01-01,55,116,55,116,171
51501,VILLAZON,estado nutricional en menores de 5 anos,clasificacion d,2003-01-01,143,176,143,176,319
30904,VINTO,estado nutricional en menores de 5 anos,clasificacion d,2003-01-01,1,4,1,4,5
50602,VITICHI,estado nutricional en menores de 5 anos,clasificacion d,2003-01-01,81,97,81,97,178
20306,WALDO BALLIVIAN,estado nutricional en menores de 5 anos,clasificacion d,2003-01-01,1,1,1,1,2
70201,WARNES,estado nutricional en menores de 5 anos,clasificacion d,2003-01-01,122,96,122,96,218
20903,YACO,estado nutricional en menores de 5 anos,clasificacion d,2003-01-01,19,15,19,15,34
60301,YACUIBA,estado nutricional en menores de 5 anos,clasificacion d,2003-01-01,152,92,152,92,244
10602,YAMPARAEZ,estado nutricional en menores de 5 anos,clasificacion d,2003-01-01,140,280,140,280,420
21103,YANACACHI,estado nutricional en menores de 5 anos,clasificacion d,2003-01-01,7,10,7,10,17
70403,YAPACANI,estado nutricional en menores de 5 anos,clasificacion d,2003-01-01,140,117,140,117,257
50103,YOCALLA,estado nutricional en menores de 5 anos,clasificacion d,2003-01-01,30,66,30,66,96
10102,YOTALA,estado nutricional en menores de 5 anos,clasificacion d,2003-01-01,47,111,47,111,158
60402,YUNCHARA,estado nutricional en menores de 5 anos,clasificacion d,2003-01-01,20,22,20,22,42
10301,ZUDAÃ‘EZ,estado nutricional en menores de 5 anos,clasificacion d,2003-01-01,46,101,46,101,147
51302,ACACIO,estado nutricional en menores de 5 anos,clasificacion d,2003-02-01,49,83,49,83,132
20201,ACHACACHI,estado nutricional en menores de 5 anos,clasificacion d,2003-02-01,117,140,117,140,257
20104,ACHOCALLA,estado nutricional en menores de 5 anos,clasificacion d,2003-02-01,25,17,25,17,42
30201,AIQUILE,estado nutricional en menores de 5 anos,clasificacion d,2003-02-01,55,49,55,49,104
31303,ALALAY,estado nutricional en menores de 5 anos,clasificacion d,2003-02-01,11,17,11,17,28
10404,ALCALA,estado nutricional en menores de 5 anos,clasificacion d,2003-02-01,31,64,31,64,95
20202,ANCORAIMES,estado nutricional en menores de 5 anos,clasificacion d,2003-02-01,54,96,54,96,150
41201,ANDAMARCA,estado nutricional en menores de 5 anos,clasificacion d,2003-02-01,3,8,3,8,11
40603,ANTEQUERA,estado nutricional en menores de 5 anos,clasificacion d,2003-02-01,5,8,5,8,13
30402,ANZALDO,estado nutricional en menores de 5 anos,clasificacion d,2003-02-01,23,61,23,61,84
20701,APOLO,estado nutricional en menores de 5 anos,clasificacion d,2003-02-01,30,29,30,29,59
51301,ARAMPAMPA,estado nutricional en menores de 5 anos,clasificacion d,2003-02-01,44,102,44,102,146
30501,ARANI,estado nutricional en menores de 5 anos,clasificacion d,2003-02-01,8,15,8,15,23
30403,ARBIETO,estado nutricional en menores de 5 anos,clasificacion d,2003-02-01,16,13,16,13,29
30601,ARQUE,estado nutricional en menores de 5 anos,clasificacion d,2003-02-01,35,43,35,43,78
71501,ASCENCION DE GUARAYOS,estado nutricional en menores de 5 anos,clasificacion d,2003-02-01,190,253,190,253,443
50802,ATOCHA,estado nutricional en menores de 5 anos,clasificacion d,2003-02-01,23,144,23,144,167
20503,AUCAPATA,estado nutricional en menores de 5 anos,clasificacion d,2003-02-01,20,24,20,24,44
20502,AYATA,estado nutricional en menores de 5 anos,clasificacion d,2003-02-01,27,14,27,14,41
21303,AYO AYO,estado nutricional en menores de 5 anos,clasificacion d,2003-02-01,3,0,3,0,3
30301,AYOPAYA (V. DE INDEPENDENCIA),estado nutricional en menores de 5 anos,clasificacion d,2003-02-01,97,118,97,118,215
10201,AZURDUY,estado nutricional en menores de 5 anos,clasificacion d,2003-02-01,124,190,124,190,314
21203,BATALLAS,estado nutricional en menores de 5 anos,clasificacion d,2003-02-01,22,28,22,28,50
80802,BAURES,estado nutricional en menores de 5 anos,clasificacion d,2003-02-01,14,26,14,26,40
41202,BELEN DE ANDAMARCA,estado nutricional en menores de 5 anos,clasificacion d,2003-02-01,1,1,1,1,2
50104,BELEN DE URMIRI,estado nutricional en menores de 5 anos,clasificacion d,2003-02-01,5,15,5,15,20
90104,BELLA FLOR,estado nutricional en menores de 5 anos,clasificacion d,2003-02-01,1,0,1,0,1
60202,BERMEJO,estado nutricional en menores de 5 anos,clasificacion d,2003-02-01,10,23,10,23,33
50301,BETANZOS,estado nutricional en menores de 5 anos,clasificacion d,2003-02-01,168,199,168,199,367
31501,BOLIVAR,estado nutricional en menores de 5 anos,clasificacion d,2003-02-01,43,55,43,55,98
90103,BOLPEBRA,estado nutricional en menores de 5 anos,clasificacion d,2003-02-01,5,9,5,9,14
70707,BOYUIBE,estado nutricional en menores de 5 anos,clasificacion d,2003-02-01,11,16,11,16,27
70401,BUENA VISTA,estado nutricional en menores de 5 anos,clasificacion d,2003-02-01,38,31,38,31,69
70703,CABEZAS,estado nutricional en menores de 5 anos,clasificacion d,2003-02-01,42,53,42,53,95
20905,CAIROMA,estado nutricional en menores de 5 anos,clasificacion d,2003-02-01,61,52,61,52,113
51102,"CAIZA ""D""",estado nutricional en menores de 5 anos,clasificacion d,2003-02-01,71,83,71,83,154
21003,CAJUATA,estado nutricional en menores de 5 anos,clasificacion d,2003-02-01,26,20,26,20,46
20303,CALACOTO,estado nutricional en menores de 5 anos,clasificacion d,2003-02-01,8,4,8,4,12
21304,CALAMARCA,estado nutricional en menores de 5 anos,clasificacion d,2003-02-01,100,96,100,96,196
10701,CAMARGO,estado nutricional en menores de 5 anos,clasificacion d,2003-02-01,77,82,77,82,159
10901,CAMATAQUI (C. VILLA ABECIA),estado nutricional en menores de 5 anos,clasificacion d,2003-02-01,14,17,14,17,31
70706,CAMIRI,estado nutricional en menores de 5 anos,clasificacion d,2003-02-01,123,93,123,93,216
30701,CAPINOTA,estado nutricional en menores de 5 anos,clasificacion d,2003-02-01,13,25,13,25,38
20302,CAQUIAVIRI,estado nutricional en menores de 5 anos,clasificacion d,2003-02-01,18,25,18,25,43
40102,CARACOLLO,estado nutricional en menores de 5 anos,clasificacion d,2003-02-01,59,32,59,32,91
22001,CARANAVI,estado nutricional en menores de 5 anos,clasificacion d,2003-02-01,78,84,78,84,162
41503,CARANGAS,estado nutricional en menores de 5 anos,clasificacion d,2003-02-01,0,1,0,1,1
60302,CARAPARI,estado nutricional en menores de 5 anos,clasificacion d,2003-02-01,36,47,36,47,83
50702,CARIPUYO,estado nutricional en menores de 5 anos,clasificacion d,2003-02-01,72,64,72,64,136
21902,CATACORA,estado nutricional en menores de 5 anos,clasificacion d,2003-02-01,1,4,1,4,5
40201,CHALLAPATA,estado nutricional en menores de 5 anos,clasificacion d,2003-02-01,56,112,56,112,168
50302,CHAQUI,estado nutricional en menores de 5 anos,clasificacion d,2003-02-01,72,66,72,66,138
70702,CHARAGUA,estado nutricional en menores de 5 anos,clasificacion d,2003-02-01,85,147,85,147,232
20305,CHARAÃ‘A,estado nutricional en menores de 5 anos,clasificacion d,2003-02-01,4,4,4,4,8
50202,CHAYANTA,estado nutricional en menores de 5 anos,clasificacion d,2003-02-01,65,60,65,60,125
31204,CHIMORE,estado nutricional en menores de 5 anos,clasificacion d,2003-02-01,14,26,14,26,40
40302,CHOQUE COTA,estado nutricional en menores de 5 anos,clasificacion d,2003-02-01,8,11,8,11,19
21101,CHULUMANI (V. DE LA LIBERTAD),estado nutricional en menores de 5 anos,clasificacion d,2003-02-01,14,21,14,21,35
20501,CHUMA,estado nutricional en menores de 5 anos,clasificacion d,2003-02-01,16,24,16,24,40
30801,CLIZA,estado nutricional en menores de 5 anos,clasificacion d,2003-02-01,22,7,22,7,29
90101,COBIJA,estado nutricional en menores de 5 anos,clasificacion d,2003-02-01,42,72,42,72,114
30101,COCHABAMBA,estado nutricional en menores de 5 anos,clasificacion d,2003-02-01,464,412,464,412,876
30905,COLCAPIRHUA,estado nutricional en menores de 5 anos,clasificacion d,2003-02-01,19,12,19,12,31
50901,"COLCHA ""K""",estado nutricional en menores de 5 anos,clasificacion d,2003-02-01,34,48,34,48,82
21307,COLLANA,estado nutricional en menores de 5 anos,clasificacion d,2003-02-01,3,3,3,3,6
31002,COLOMI,estado nutricional en menores de 5 anos,clasificacion d,2003-02-01,66,59,66,59,125
50401,COLQUECHACA,estado nutricional en menores de 5 anos,clasificacion d,2003-02-01,80,34,80,34,114
21306,COLQUENCHA,estado nutricional en menores de 5 anos,clasificacion d,2003-02-01,19,4,19,4,23
21004,COLQUIRI,estado nutricional en menores de 5 anos,clasificacion d,2003-02-01,61,47,61,47,108
20304,COMANCHE,estado nutricional en menores de 5 anos,clasificacion d,2003-02-01,3,3,3,3,6
71301,COMARAPA,estado nutricional en menores de 5 anos,clasificacion d,2003-02-01,72,58,72,58,130
71101,CONCEPCION,estado nutricional en menores de 5 anos,clasificacion d,2003-02-01,34,16,34,16,50
21701,COPACABANA,estado nutricional en menores de 5 anos,clasificacion d,2003-02-01,44,42,44,42,86
21402,CORIPATA,estado nutricional en menores de 5 anos,clasificacion d,2003-02-01,15,3,15,3,18
20301,CORO CORO,estado nutricional en menores de 5 anos,clasificacion d,2003-02-01,27,21,27,21,48
21401,COROICO,estado nutricional en menores de 5 anos,clasificacion d,2003-02-01,17,14,17,14,31
40301,CORQUE,estado nutricional en menores de 5 anos,clasificacion d,2003-02-01,20,9,20,9,29
50601,COTAGAITA,estado nutricional en menores de 5 anos,clasificacion d,2003-02-01,75,158,75,158,233
70102,COTOCA,estado nutricional en menores de 5 anos,clasificacion d,2003-02-01,37,30,37,30,67
31405,CUCHUMUELA (V. G. VILLARROEL),estado nutricional en menores de 5 anos,clasificacion d,2003-02-01,3,2,3,2,5
70704,CUEVO,estado nutricional en menores de 5 anos,clasificacion d,2003-02-01,22,38,22,38,60
10902,CULPINA,estado nutricional en menores de 5 anos,clasificacion d,2003-02-01,155,192,155,192,347
40401,CURAHUARA DE CARANGAS,estado nutricional en menores de 5 anos,clasificacion d,2003-02-01,16,25,16,25,41
21602,CURVA,estado nutricional en menores de 5 anos,clasificacion d,2003-02-01,15,13,15,13,28
20804,DESAGUADERO,estado nutricional en menores de 5 anos,clasificacion d,2003-02-01,18,23,18,23,41
20105,EL ALTO,estado nutricional en menores de 5 anos,clasificacion d,2003-02-01,1470,901,1470,901,2371
40103,EL CHORO,estado nutricional en menores de 5 anos,clasificacion d,2003-02-01,5,8,5,8,13
71503,EL PUENTE(STC),estado nutricional en menores de 5 anos,clasificacion d,2003-02-01,30,85,30,85,115
60502,EL PUENTE(TJA),estado nutricional en menores de 5 anos,clasificacion d,2003-02-01,79,141,79,141,220
70105,EL TORNO,estado nutricional en menores de 5 anos,clasificacion d,2003-02-01,54,62,54,62,116
10405,EL VILLAR,estado nutricional en menores de 5 anos,clasificacion d,2003-02-01,38,135,38,135,173
60601,ENTRE RIOS,estado nutricional en menores de 5 anos,clasificacion d,2003-02-01,38,58,38,58,96
41101,EUCALIPTUS,estado nutricional en menores de 5 anos,clasificacion d,2003-02-01,29,36,29,36,65
80402,EXALTACION,estado nutricional en menores de 5 anos,clasificacion d,2003-02-01,4,7,4,7,11
90203,FILADELFIA,estado nutricional en menores de 5 anos,clasificacion d,2003-02-01,3,1,3,1,4
71002,GENERAL SAAVEDRA,estado nutricional en menores de 5 anos,clasificacion d,2003-02-01,64,89,64,89,153
21601,GRAL. J.J. PEREZ (CHARAZANI),estado nutricional en menores de 5 anos,clasificacion d,2003-02-01,9,15,9,15,24
20602,GUANAY,estado nutricional en menores de 5 anos,clasificacion d,2003-02-01,74,79,74,79,153
20802,GUAQUI,estado nutricional en menores de 5 anos,clasificacion d,2003-02-01,8,1,8,1,9
80202,GUAYARAMERIN,estado nutricional en menores de 5 anos,clasificacion d,2003-02-01,126,89,126,89,215
70705,GUTIERREZ,estado nutricional en menores de 5 anos,clasificacion d,2003-02-01,95,189,95,189,284
10502,HUACARETA,estado nutricional en menores de 5 anos,clasificacion d,2003-02-01,56,97,56,97,153
11002,HUACAYA (VILLA DE HUACAYA),estado nutricional en menores de 5 anos,clasificacion d,2003-02-01,12,25,12,25,37
40501,HUACHACALLA,estado nutricional en menores de 5 anos,clasificacion d,2003-02-01,3,1,3,1,4
40701,HUANUNI,estado nutricional en menores de 5 anos,clasificacion d,2003-02-01,43,34,43,34,77
80803,HUARACAJE,estado nutricional en menores de 5 anos,clasificacion d,2003-02-01,8,6,8,6,14
41601,HUAYLLAMARCA,estado nutricional en menores de 5 anos,clasificacion d,2003-02-01,9,20,9,20,29
21005,ICHOCA,estado nutricional en menores de 5 anos,clasificacion d,2003-02-01,15,19,15,19,34
10304,ICLA,estado nutricional en menores de 5 anos,clasificacion d,2003-02-01,64,95,64,95,159
10703,INCAHUASI,estado nutricional en menores de 5 anos,clasificacion d,2003-02-01,144,114,144,114,258
21001,INQUISIVI,estado nutricional en menores de 5 anos,clasificacion d,2003-02-01,54,55,54,55,109
21102,IRUPANA (VILLA DE LANZA),estado nutricional en menores de 5 anos,clasificacion d,2003-02-01,17,30,17,30,47
21501,IXIAMAS,estado nutricional en menores de 5 anos,clasificacion d,2003-02-01,22,28,22,28,50
21105,LA ASUNTA,estado nutricional en menores de 5 anos,clasificacion d,2003-02-01,22,16,22,16,38
70104,LA GUARDIA,estado nutricional en menores de 5 anos,clasificacion d,2003-02-01,53,33,53,33,86
20101,LA PAZ,estado nutricional en menores de 5 anos,clasificacion d,2003-02-01,968,789,968,789,1757
70701,LAGUNILLAS,estado nutricional en menores de 5 anos,clasificacion d,2003-02-01,42,49,42,49,91
21202,LAJA,estado nutricional en menores de 5 anos,clasificacion d,2003-02-01,12,11,12,11,23
10903,LAS CARRERAS,estado nutricional en menores de 5 anos,clasificacion d,2003-02-01,26,47,26,47,73
21006,LICOMA PAMPA,estado nutricional en menores de 5 anos,clasificacion d,2003-02-01,4,5,4,5,9
50203,LLALLAGUA,estado nutricional en menores de 5 anos,clasificacion d,2003-02-01,15,412,15,412,427
51401,LLICA,estado nutricional en menores de 5 anos,clasificacion d,2003-02-01,14,14,14,14,28
80601,LORETO,estado nutricional en menores de 5 anos,clasificacion d,2003-02-01,14,20,14,20,34
20901,LURIBAY,estado nutricional en menores de 5 anos,clasificacion d,2003-02-01,31,19,31,19,50
40702,MACHACAMARCA,estado nutricional en menores de 5 anos,clasificacion d,2003-02-01,11,16,11,16,27
11003,MACHARETI,estado nutricional en menores de 5 anos,clasificacion d,2003-02-01,42,92,42,92,134
80801,MAGDALENA,estado nutricional en menores de 5 anos,clasificacion d,2003-02-01,29,35,29,35,64
70903,MAIRANA,estado nutricional en menores de 5 anos,clasificacion d,2003-02-01,43,20,43,20,63
20904,MALLA,estado nutricional en menores de 5 anos,clasificacion d,2003-02-01,1,5,1,5,6
20103,MECAPACA,estado nutricional en menores de 5 anos,clasificacion d,2003-02-01,11,16,11,16,27
71003,MINEROS,estado nutricional en menores de 5 anos,clasificacion d,2003-02-01,130,83,130,83,213
31301,MIZQUE,estado nutricional en menores de 5 anos,clasificacion d,2003-02-01,51,45,51,45,96
20402,MOCOMOCO,estado nutricional en menores de 5 anos,clasificacion d,2003-02-01,52,50,52,50,102
51002,MOJINETE,estado nutricional en menores de 5 anos,clasificacion d,2003-02-01,4,16,4,16,20
10303,MOJOCOYA,estado nutricional en menores de 5 anos,clasificacion d,2003-02-01,55,106,55,106,161
10501,MONTEAGUDO,estado nutricional en menores de 5 anos,clasificacion d,2003-02-01,145,184,145,184,329
71001,MONTERO,estado nutricional en menores de 5 anos,clasificacion d,2003-02-01,314,157,314,157,471
70803,MORO MORO,estado nutricional en menores de 5 anos,clasificacion d,2003-02-01,7,12,7,12,19
30302,MOROCHATA,estado nutricional en menores de 5 anos,clasificacion d,2003-02-01,69,128,69,128,197
90401,NACEBE (SANTA ROSA DEL ABUNA),estado nutricional en menores de 5 anos,clasificacion d,2003-02-01,5,7,5,7,12
20307,NAZACARA DE PACAJES,estado nutricional en menores de 5 anos,clasificacion d,2003-02-01,5,0,5,0,5
50404,OCURI,estado nutricional en menores de 5 anos,clasificacion d,2003-02-01,32,71,32,71,103
70202,OKINAWA,estado nutricional en menores de 5 anos,clasificacion d,2003-02-01,7,22,7,22,29
30203,OMEREQUE,estado nutricional en menores de 5 anos,clasificacion d,2003-02-01,0,10,0,10,10
40101,ORURO,estado nutricional en menores de 5 anos,clasificacion d,2003-02-01,349,429,349,429,778
60201,PADCAYA,estado nutricional en menores de 5 anos,clasificacion d,2003-02-01,40,68,40,68,108
10401,PADILLA,estado nutricional en menores de 5 anos,clasificacion d,2003-02-01,97,210,97,210,307
70502,PAILON,estado nutricional en menores de 5 anos,clasificacion d,2003-02-01,34,24,34,24,58
20102,PALCA,estado nutricional en menores de 5 anos,clasificacion d,2003-02-01,47,22,47,22,69
21104,PALOS BLANCOS,estado nutricional en menores de 5 anos,clasificacion d,2003-02-01,77,81,77,81,158
40802,PAMPA AULLAGAS,estado nutricional en menores de 5 anos,clasificacion d,2003-02-01,9,18,9,18,27
70902,PAMPA GRANDE,estado nutricional en menores de 5 anos,clasificacion d,2003-02-01,10,16,10,16,26
21802,PAPEL PAMPA,estado nutricional en menores de 5 anos,clasificacion d,2003-02-01,4,2,4,2,6
30202,PASORAPA,estado nutricional en menores de 5 anos,clasificacion d,2003-02-01,15,32,15,32,47
21305,PATACAMAYA,estado nutricional en menores de 5 anos,clasificacion d,2003-02-01,121,86,121,86,207
40602,PAZÃ‘A,estado nutricional en menores de 5 anos,clasificacion d,2003-02-01,4,21,4,21,25
20702,PELECHUCO,estado nutricional en menores de 5 anos,clasificacion d,2003-02-01,37,32,37,32,69
50403,POCOATA,estado nutricional en menores de 5 anos,clasificacion d,2003-02-01,186,195,186,195,381
31203,POCONA,estado nutricional en menores de 5 anos,clasificacion d,2003-02-01,36,20,36,20,56
31202,POJO (CBBA),estado nutricional en menores de 5 anos,clasificacion d,2003-02-01,98,94,98,94,192
40601,POOPO,estado nutricional en menores de 5 anos,clasificacion d,2003-02-01,6,10,6,10,16
51203,PORCO,estado nutricional en menores de 5 anos,clasificacion d,2003-02-01,20,13,20,13,33
10103,POROMA,estado nutricional en menores de 5 anos,clasificacion d,2003-02-01,118,174,118,174,292
70103,PORONGO,estado nutricional en menores de 5 anos,clasificacion d,2003-02-01,9,7,9,7,16
70601,PORTACHUELO,estado nutricional en menores de 5 anos,clasificacion d,2003-02-01,50,35,50,35,85
90102,PORVENIR,estado nutricional en menores de 5 anos,clasificacion d,2003-02-01,14,18,14,18,32
70804,POSTRER VALLE,estado nutricional en menores de 5 anos,clasificacion d,2003-02-01,12,15,12,15,27
50101,POTOSI,estado nutricional en menores de 5 anos,clasificacion d,2003-02-01,474,352,474,352,826
10302,PRESTO,estado nutricional en menores de 5 anos,clasificacion d,2003-02-01,67,107,67,107,174
21201,PUCARANI,estado nutricional en menores de 5 anos,clasificacion d,2003-02-01,30,27,30,27,57
20401,PUERTO ACOSTA,estado nutricional en menores de 5 anos,clasificacion d,2003-02-01,66,118,66,118,184
20403,PUERTO CARABUCO,estado nutricional en menores de 5 anos,clasificacion d,2003-02-01,57,96,57,96,153
90301,PUERTO GONZALO MORENO,estado nutricional en menores de 5 anos,clasificacion d,2003-02-01,13,3,13,3,16
21204,PUERTO PEREZ,estado nutricional en menores de 5 anos,clasificacion d,2003-02-01,17,9,17,9,26
71402,PUERTO QUIJARRO,estado nutricional en menores de 5 anos,clasificacion d,2003-02-01,47,15,47,15,62
90201,PUERTO RICO,estado nutricional en menores de 5 anos,clasificacion d,2003-02-01,15,22,15,22,37
80703,PUERTO SILES,estado nutricional en menores de 5 anos,clasificacion d,2003-02-01,0,3,0,3,3
71401,PUERTO SUAREZ,estado nutricional en menores de 5 anos,clasificacion d,2003-02-01,44,22,44,22,66
31205,PUERTO VILLARROEL,estado nutricional en menores de 5 anos,clasificacion d,2003-02-01,150,127,150,127,277
51101,PUNA,estado nutricional en menores de 5 anos,clasificacion d,2003-02-01,42,67,42,67,109
31401,PUNATA,estado nutricional en menores de 5 anos,clasificacion d,2003-02-01,77,11,77,11,88
30901,QUILLACOLLO,estado nutricional en menores de 5 anos,clasificacion d,2003-02-01,81,83,81,83,164
21002,QUIME,estado nutricional en menores de 5 anos,clasificacion d,2003-02-01,82,48,82,48,130
70904,QUIRUSILLAS,estado nutricional en menores de 5 anos,clasificacion d,2003-02-01,4,5,4,5,9
50402,RAVELO,estado nutricional en menores de 5 anos,clasificacion d,2003-02-01,155,190,155,190,345
80301,REYES,estado nutricional en menores de 5 anos,clasificacion d,2003-02-01,31,43,31,43,74
80201,RIBERALTA,estado nutricional en menores de 5 anos,clasificacion d,2003-02-01,261,189,261,189,450
70503,ROBORE,estado nutricional en menores de 5 anos,clasificacion d,2003-02-01,27,63,27,63,90
80304,RURRENABAQUE,estado nutricional en menores de 5 anos,clasificacion d,2003-02-01,1,3,1,3,4
40901,SABAYA,estado nutricional en menores de 5 anos,clasificacion d,2003-02-01,1,4,1,4,5
31001,SACABA,estado nutricional en menores de 5 anos,clasificacion d,2003-02-01,98,93,98,93,191
30404,SACABAMBA,estado nutricional en menores de 5 anos,clasificacion d,2003-02-01,9,39,9,39,48
50701,SACACA,estado nutricional en menores de 5 anos,clasificacion d,2003-02-01,189,340,189,340,529
71302,SAIPINA,estado nutricional en menores de 5 anos,clasificacion d,2003-02-01,10,18,10,18,28
40801,SALINAS DE GARCI MENDOZA,estado nutricional en menores de 5 anos,clasificacion d,2003-02-01,5,18,5,18,23
70901,SAMAIPATA,estado nutricional en menores de 5 anos,clasificacion d,2003-02-01,26,18,26,18,44
51601,SAN AGUSTIN,estado nutricional en menores de 5 anos,clasificacion d,2003-02-01,4,5,4,5,9
80602,SAN ANDRES,estado nutricional en menores de 5 anos,clasificacion d,2003-02-01,27,44,27,44,71
51003,SAN ANTONIO DE ESMORUCO,estado nutricional en menores de 5 anos,clasificacion d,2003-02-01,4,13,4,13,17
71105,SAN ANTONIO DE LOMERIO,estado nutricional en menores de 5 anos,clasificacion d,2003-02-01,89,150,89,150,239
31403,SAN BENITO,estado nutricional en menores de 5 anos,clasificacion d,2003-02-01,46,19,46,19,65
80302,SAN BORJA,estado nutricional en menores de 5 anos,clasificacion d,2003-02-01,89,45,89,45,134
21502,SAN BUENA VENTURA,estado nutricional en menores de 5 anos,clasificacion d,2003-02-01,40,30,40,30,70
70402,SAN CARLOS,estado nutricional en menores de 5 anos,clasificacion d,2003-02-01,69,67,69,67,136
80501,SAN IGNACIO,estado nutricional en menores de 5 anos,clasificacion d,2003-02-01,74,91,74,91,165
70301,SAN IGNACIO DE VELASCO,estado nutricional en menores de 5 anos,clasificacion d,2003-02-01,215,185,215,185,400
80102,SAN JAVIER(BNI),estado nutricional en menores de 5 anos,clasificacion d,2003-02-01,5,9,5,9,14
71102,SAN JAVIER(STC),estado nutricional en menores de 5 anos,clasificacion d,2003-02-01,29,42,29,42,71
80701,SAN JOAQUIN,estado nutricional en menores de 5 anos,clasificacion d,2003-02-01,7,11,7,11,18
70501,SAN JOSE DE CHIQUITOS,estado nutricional en menores de 5 anos,clasificacion d,2003-02-01,44,19,44,19,63
71104,SAN JULIAN,estado nutricional en menores de 5 anos,clasificacion d,2003-02-01,196,249,196,249,445
90302,SAN LORENZO(PND),estado nutricional en menores de 5 anos,clasificacion d,2003-02-01,6,27,6,27,33
60501,SAN LORENZO(TJA),estado nutricional en menores de 5 anos,clasificacion d,2003-02-01,30,93,30,93,123
10702,SAN LUCAS,estado nutricional en menores de 5 anos,clasificacion d,2003-02-01,348,401,348,401,749
71201,SAN MATIAS,estado nutricional en menores de 5 anos,clasificacion d,2003-02-01,10,10,10,10,20
70302,SAN MIGUEL DE VELASCO,estado nutricional en menores de 5 anos,clasificacion d,2003-02-01,71,111,71,111,182
51001,SAN PABLO DE LIPEZ,estado nutricional en menores de 5 anos,clasificacion d,2003-02-01,4,13,4,13,17
50501,SAN PEDRO DE BUENA VISTA,estado nutricional en menores de 5 anos,clasificacion d,2003-02-01,122,259,122,259,381
21801,SAN PEDRO DE CURAHUARA,estado nutricional en menores de 5 anos,clasificacion d,2003-02-01,9,6,9,6,15
50902,SAN PEDRO DE QUEMES,estado nutricional en menores de 5 anos,clasificacion d,2003-02-01,6,5,6,5,11
21702,SAN PEDRO DE TIQUINA,estado nutricional en menores de 5 anos,clasificacion d,2003-02-01,2,10,2,10,12
70303,SAN RAFAEL,estado nutricional en menores de 5 anos,clasificacion d,2003-02-01,25,38,25,38,63
80702,SAN RAMON,estado nutricional en menores de 5 anos,clasificacion d,2003-02-01,5,3,5,3,8
80702,SAN RAMON,estado nutricional en menores de 5 anos,clasificacion d,2003-02-01,6,12,6,12,18
80401,SANTA ANA,estado nutricional en menores de 5 anos,clasificacion d,2003-02-01,1,1,1,1,2
70101,SANTA CRUZ DE LA SIERRA,estado nutricional en menores de 5 anos,clasificacion d,2003-02-01,767,418,767,418,1185
80303,SANTA ROSA,estado nutricional en menores de 5 anos,clasificacion d,2003-02-01,8,3,8,3,11
70602,SANTA ROSA DEL SARA,estado nutricional en menores de 5 anos,clasificacion d,2003-02-01,11,27,11,27,38
20308,SANTIAGO DE CALLAPA,estado nutricional en menores de 5 anos,clasificacion d,2003-02-01,12,17,12,17,29
41401,SANTIAGO DE HUARI,estado nutricional en menores de 5 anos,clasificacion d,2003-02-01,7,18,7,18,25
21901,SANTIAGO DE MACHACA,estado nutricional en menores de 5 anos,clasificacion d,2003-02-01,2,2,2,2,4
30702,SANTIVAÃ‘ES,estado nutricional en menores de 5 anos,clasificacion d,2003-02-01,19,17,19,17,36
40202,SANTUARIO DE QUILLACAS,estado nutricional en menores de 5 anos,clasificacion d,2003-02-01,12,17,12,17,29
20902,SAPAHAQUI,estado nutricional en menores de 5 anos,clasificacion d,2003-02-01,23,18,23,18,41
90303,SENA,estado nutricional en menores de 5 anos,clasificacion d,2003-02-01,5,3,5,3,8
21301,SICA SICA (VILLA AROMA),estado nutricional en menores de 5 anos,clasificacion d,2003-02-01,34,33,34,33,67
30703,SICAYA,estado nutricional en menores de 5 anos,clasificacion d,2003-02-01,1,13,1,13,14
30902,SIPE SIPE,estado nutricional en menores de 5 anos,clasificacion d,2003-02-01,84,54,84,54,138
10403,SOPACHUY,estado nutricional en menores de 5 anos,clasificacion d,2003-02-01,51,59,51,59,110
20601,SORATA,estado nutricional en menores de 5 anos,clasificacion d,2003-02-01,43,91,43,91,134
10101,SUCRE,estado nutricional en menores de 5 anos,clasificacion d,2003-02-01,513,668,513,668,1181
31404,TACACHI,estado nutricional en menores de 5 anos,clasificacion d,2003-02-01,8,2,8,2,10
50303,TACOBAMBA,estado nutricional en menores de 5 anos,clasificacion d,2003-02-01,37,49,37,49,86
30602,TACOPAYA,estado nutricional en menores de 5 anos,clasificacion d,2003-02-01,38,62,38,62,100
51402,TAHUA,estado nutricional en menores de 5 anos,clasificacion d,2003-02-01,7,10,7,10,17
31101,TAPACARI,estado nutricional en menores de 5 anos,clasificacion d,2003-02-01,64,82,64,82,146
10601,TARABUCO,estado nutricional en menores de 5 anos,clasificacion d,2003-02-01,228,399,228,399,627
30401,TARATA,estado nutricional en menores de 5 anos,clasificacion d,2003-02-01,18,19,18,19,37
60101,TARIJA,estado nutricional en menores de 5 anos,clasificacion d,2003-02-01,288,246,288,246,534
10202,TARVITA,estado nutricional en menores de 5 anos,clasificacion d,2003-02-01,120,191,120,191,311
20803,TIAWANACU,estado nutricional en menores de 5 anos,clasificacion d,2003-02-01,24,14,24,14,38
50102,TINGUIPAYA,estado nutricional en menores de 5 anos,clasificacion d,2003-02-01,17,11,17,11,28
20606,TIPUANI,estado nutricional en menores de 5 anos,clasificacion d,2003-02-01,1,0,1,0,1
30903,TIQUIPAYA,estado nutricional en menores de 5 anos,clasificacion d,2003-02-01,30,23,30,23,53
31601,TIRAQUE (CBBA),estado nutricional en menores de 5 anos,clasificacion d,2003-02-01,84,92,84,92,176
21703,TITO YUPANQUI (PARQUIPUJIO),estado nutricional en menores de 5 anos,clasificacion d,2003-02-01,7,1,7,1,8
30802,TOCO,estado nutricional en menores de 5 anos,clasificacion d,2003-02-01,1,6,1,6,7
30803,TOLATA,estado nutricional en menores de 5 anos,clasificacion d,2003-02-01,8,17,8,17,25
41001,TOLEDO,estado nutricional en menores de 5 anos,clasificacion d,2003-02-01,8,9,8,9,17
51202,TOMAVE,estado nutricional en menores de 5 anos,clasificacion d,2003-02-01,58,90,58,90,148
10402,TOMINA,estado nutricional en menores de 5 anos,clasificacion d,2003-02-01,91,168,91,168,259
50502,TORO TORO,estado nutricional en menores de 5 anos,clasificacion d,2003-02-01,94,85,94,85,179
31201,TOTORA(CBBA),estado nutricional en menores de 5 anos,clasificacion d,2003-02-01,36,29,36,29,65
41301,TOTORA(ORR),estado nutricional en menores de 5 anos,clasificacion d,2003-02-01,17,14,17,14,31
70802,TRIGAL,estado nutricional en menores de 5 anos,clasificacion d,2003-02-01,3,4,3,4,7
80101,TRINIDAD,estado nutricional en menores de 5 anos,clasificacion d,2003-02-01,150,166,150,166,316
50801,TUPIZA,estado nutricional en menores de 5 anos,clasificacion d,2003-02-01,87,386,87,386,473
40402,TURCO,estado nutricional en menores de 5 anos,clasificacion d,2003-02-01,10,16,10,16,26
21302,UMALA,estado nutricional en menores de 5 anos,clasificacion d,2003-02-01,22,31,22,31,53
50201,UNCIA,estado nutricional en menores de 5 anos,clasificacion d,2003-02-01,6,15,6,15,21
60401,URIONDO (A. CONCEPCION),estado nutricional en menores de 5 anos,clasificacion d,2003-02-01,30,26,30,26,56
71502,URUBICHA,estado nutricional en menores de 5 anos,clasificacion d,2003-02-01,55,102,55,102,157
51201,UYUNI,estado nutricional en menores de 5 anos,clasificacion d,2003-02-01,66,94,66,94,160
30502,VACAS,estado nutricional en menores de 5 anos,clasificacion d,2003-02-01,35,11,35,11,46
70801,VALLEGRANDE,estado nutricional en menores de 5 anos,clasificacion d,2003-02-01,48,49,48,49,97
20801,VIACHA,estado nutricional en menores de 5 anos,clasificacion d,2003-02-01,68,125,68,125,193
31302,VILA VILA,estado nutricional en menores de 5 anos,clasificacion d,2003-02-01,9,19,9,19,28
60303,VILLA MONTES,estado nutricional en menores de 5 anos,clasificacion d,2003-02-01,95,90,95,90,185
90502,VILLA NUEVA (LOMA ALTA),estado nutricional en menores de 5 anos,clasificacion d,2003-02-01,1,0,1,0,1
31402,VILLA RIVERO,estado nutricional en menores de 5 anos,clasificacion d,2003-02-01,24,4,24,4,28
10801,VILLA SERRANO,estado nutricional en menores de 5 anos,clasificacion d,2003-02-01,110,193,110,193,303
31003,VILLA TUNARI,estado nutricional en menores de 5 anos,clasificacion d,2003-02-01,128,91,128,91,219
11001,VILLA VACA GUZMAN (MUYUPAMPA),estado nutricional en menores de 5 anos,clasificacion d,2003-02-01,60,115,60,115,175
51501,VILLAZON,estado nutricional en menores de 5 anos,clasificacion d,2003-02-01,112,155,112,155,267
50602,VITICHI,estado nutricional en menores de 5 anos,clasificacion d,2003-02-01,98,147,98,147,245
20306,WALDO BALLIVIAN,estado nutricional en menores de 5 anos,clasificacion d,2003-02-01,6,4,6,4,10
70201,WARNES,estado nutricional en menores de 5 anos,clasificacion d,2003-02-01,88,63,88,63,151
20903,YACO,estado nutricional en menores de 5 anos,clasificacion d,2003-02-01,31,21,31,21,52
60301,YACUIBA,estado nutricional en menores de 5 anos,clasificacion d,2003-02-01,123,97,123,97,220
10602,YAMPARAEZ,estado nutricional en menores de 5 anos,clasificacion d,2003-02-01,149,280,149,280,429
21103,YANACACHI,estado nutricional en menores de 5 anos,clasificacion d,2003-02-01,6,4,6,4,10
70403,YAPACANI,estado nutricional en menores de 5 anos,clasificacion d,2003-02-01,141,91,141,91,232
50103,YOCALLA,estado nutricional en menores de 5 anos,clasificacion d,2003-02-01,39,66,39,66,105
10102,YOTALA,estado nutricional en menores de 5 anos,clasificacion d,2003-02-01,81,171,81,171,252
60402,YUNCHARA,estado nutricional en menores de 5 anos,clasificacion d,2003-02-01,19,25,19,25,44
10301,ZUDAÃ‘EZ,estado nutricional en menores de 5 anos,clasificacion d,2003-02-01,50,86,50,86,136
51302,ACACIO,estado nutricional en menores de 5 anos,clasificacion d,2003-03-01,52,68,52,68,120
20201,ACHACACHI,estado nutricional en menores de 5 anos,clasificacion d,2003-03-01,112,133,112,133,245
20104,ACHOCALLA,estado nutricional en menores de 5 anos,clasificacion d,2003-03-01,21,16,21,16,37
30201,AIQUILE,estado nutricional en menores de 5 anos,clasificacion d,2003-03-01,29,45,29,45,74
31303,ALALAY,estado nutricional en menores de 5 anos,clasificacion d,2003-03-01,9,13,9,13,22
10404,ALCALA,estado nutricional en menores de 5 anos,clasificacion d,2003-03-01,26,56,26,56,82
20202,ANCORAIMES,estado nutricional en menores de 5 anos,clasificacion d,2003-03-01,57,91,57,91,148
41201,ANDAMARCA,estado nutricional en menores de 5 anos,clasificacion d,2003-03-01,15,27,15,27,42
40603,ANTEQUERA,estado nutricional en menores de 5 anos,clasificacion d,2003-03-01,2,2,2,2,4
30402,ANZALDO,estado nutricional en menores de 5 anos,clasificacion d,2003-03-01,1,28,1,28,29
20701,APOLO,estado nutricional en menores de 5 anos,clasificacion d,2003-03-01,32,30,32,30,62
51301,ARAMPAMPA,estado nutricional en menores de 5 anos,clasificacion d,2003-03-01,37,83,37,83,120
30501,ARANI,estado nutricional en menores de 5 anos,clasificacion d,2003-03-01,7,25,7,25,32
30403,ARBIETO,estado nutricional en menores de 5 anos,clasificacion d,2003-03-01,3,6,3,6,9
30601,ARQUE,estado nutricional en menores de 5 anos,clasificacion d,2003-03-01,49,71,49,71,120
71501,ASCENCION DE GUARAYOS,estado nutricional en menores de 5 anos,clasificacion d,2003-03-01,1,1,1,1,2
50802,ATOCHA,estado nutricional en menores de 5 anos,clasificacion d,2003-03-01,18,135,18,135,153
20503,AUCAPATA,estado nutricional en menores de 5 anos,clasificacion d,2003-03-01,24,28,24,28,52
20502,AYATA,estado nutricional en menores de 5 anos,clasificacion d,2003-03-01,23,19,23,19,42
21303,AYO AYO,estado nutricional en menores de 5 anos,clasificacion d,2003-03-01,11,2,11,2,13
30301,AYOPAYA (V. DE INDEPENDENCIA),estado nutricional en menores de 5 anos,clasificacion d,2003-03-01,95,114,95,114,209
10201,AZURDUY,estado nutricional en menores de 5 anos,clasificacion d,2003-03-01,95,187,95,187,282
21203,BATALLAS,estado nutricional en menores de 5 anos,clasificacion d,2003-03-01,46,31,46,31,77
80802,BAURES,estado nutricional en menores de 5 anos,clasificacion d,2003-03-01,15,8,15,8,23
41202,BELEN DE ANDAMARCA,estado nutricional en menores de 5 anos,clasificacion d,2003-03-01,2,3,2,3,5
50104,BELEN DE URMIRI,estado nutricional en menores de 5 anos,clasificacion d,2003-03-01,3,8,3,8,11
90104,BELLA FLOR,estado nutricional en menores de 5 anos,clasificacion d,2003-03-01,7,12,7,12,19
60202,BERMEJO,estado nutricional en menores de 5 anos,clasificacion d,2003-03-01,7,13,7,13,20
50301,BETANZOS,estado nutricional en menores de 5 anos,clasificacion d,2003-03-01,248,313,248,313,561
31501,BOLIVAR,estado nutricional en menores de 5 anos,clasificacion d,2003-03-01,57,77,57,77,134
90103,BOLPEBRA,estado nutricional en menores de 5 anos,clasificacion d,2003-03-01,5,5,5,5,10
70707,BOYUIBE,estado nutricional en menores de 5 anos,clasificacion d,2003-03-01,10,8,10,8,18
70401,BUENA VISTA,estado nutricional en menores de 5 anos,clasificacion d,2003-03-01,35,43,35,43,78
70703,CABEZAS,estado nutricional en menores de 5 anos,clasificacion d,2003-03-01,15,9,15,9,24
20905,CAIROMA,estado nutricional en menores de 5 anos,clasificacion d,2003-03-01,18,20,18,20,38
51102,"CAIZA ""D""",estado nutricional en menores de 5 anos,clasificacion d,2003-03-01,126,118,126,118,244
21003,CAJUATA,estado nutricional en menores de 5 anos,clasificacion d,2003-03-01,16,11,16,11,27
20303,CALACOTO,estado nutricional en menores de 5 anos,clasificacion d,2003-03-01,8,7,8,7,15
21304,CALAMARCA,estado nutricional en menores de 5 anos,clasificacion d,2003-03-01,132,107,132,107,239
10701,CAMARGO,estado nutricional en menores de 5 anos,clasificacion d,2003-03-01,72,110,72,110,182
10901,CAMATAQUI (C. VILLA ABECIA),estado nutricional en menores de 5 anos,clasificacion d,2003-03-01,13,31,13,31,44
70706,CAMIRI,estado nutricional en menores de 5 anos,clasificacion d,2003-03-01,101,87,101,87,188
30701,CAPINOTA,estado nutricional en menores de 5 anos,clasificacion d,2003-03-01,26,76,26,76,102
20302,CAQUIAVIRI,estado nutricional en menores de 5 anos,clasificacion d,2003-03-01,21,33,21,33,54
40102,CARACOLLO,estado nutricional en menores de 5 anos,clasificacion d,2003-03-01,38,58,38,58,96
22001,CARANAVI,estado nutricional en menores de 5 anos,clasificacion d,2003-03-01,118,125,118,125,243
60302,CARAPARI,estado nutricional en menores de 5 anos,clasificacion d,2003-03-01,33,47,33,47,80
50702,CARIPUYO,estado nutricional en menores de 5 anos,clasificacion d,2003-03-01,45,57,45,57,102
40201,CHALLAPATA,estado nutricional en menores de 5 anos,clasificacion d,2003-03-01,41,80,41,80,121
50302,CHAQUI,estado nutricional en menores de 5 anos,clasificacion d,2003-03-01,77,74,77,74,151
70702,CHARAGUA,estado nutricional en menores de 5 anos,clasificacion d,2003-03-01,119,106,119,106,225
20305,CHARAÃ‘A,estado nutricional en menores de 5 anos,clasificacion d,2003-03-01,1,1,1,1,2
50202,CHAYANTA,estado nutricional en menores de 5 anos,clasificacion d,2003-03-01,44,35,44,35,79
31204,CHIMORE,estado nutricional en menores de 5 anos,clasificacion d,2003-03-01,17,21,17,21,38
40302,CHOQUE COTA,estado nutricional en menores de 5 anos,clasificacion d,2003-03-01,12,0,12,0,12
21101,CHULUMANI (V. DE LA LIBERTAD),estado nutricional en menores de 5 anos,clasificacion d,2003-03-01,17,19,17,19,36
20501,CHUMA,estado nutricional en menores de 5 anos,clasificacion d,2003-03-01,25,21,25,21,46
30801,CLIZA,estado nutricional en menores de 5 anos,clasificacion d,2003-03-01,7,13,7,13,20
90101,COBIJA,estado nutricional en menores de 5 anos,clasificacion d,2003-03-01,41,57,41,57,98
30101,COCHABAMBA,estado nutricional en menores de 5 anos,clasificacion d,2003-03-01,463,347,463,347,810
40902,COIPASA,estado nutricional en menores de 5 anos,clasificacion d,2003-03-01,0,3,0,3,3
30905,COLCAPIRHUA,estado nutricional en menores de 5 anos,clasificacion d,2003-03-01,15,16,15,16,31
50901,"COLCHA ""K""",estado nutricional en menores de 5 anos,clasificacion d,2003-03-01,38,50,38,50,88
21307,COLLANA,estado nutricional en menores de 5 anos,clasificacion d,2003-03-01,4,2,4,2,6
31002,COLOMI,estado nutricional en menores de 5 anos,clasificacion d,2003-03-01,49,55,49,55,104
50401,COLQUECHACA,estado nutricional en menores de 5 anos,clasificacion d,2003-03-01,134,56,134,56,190
21306,COLQUENCHA,estado nutricional en menores de 5 anos,clasificacion d,2003-03-01,26,12,26,12,38
21004,COLQUIRI,estado nutricional en menores de 5 anos,clasificacion d,2003-03-01,82,80,82,80,162
20304,COMANCHE,estado nutricional en menores de 5 anos,clasificacion d,2003-03-01,6,6,6,6,12
71301,COMARAPA,estado nutricional en menores de 5 anos,clasificacion d,2003-03-01,70,43,70,43,113
71101,CONCEPCION,estado nutricional en menores de 5 anos,clasificacion d,2003-03-01,6,5,6,5,11
21701,COPACABANA,estado nutricional en menores de 5 anos,clasificacion d,2003-03-01,34,30,34,30,64
21402,CORIPATA,estado nutricional en menores de 5 anos,clasificacion d,2003-03-01,6,7,6,7,13
20301,CORO CORO,estado nutricional en menores de 5 anos,clasificacion d,2003-03-01,36,31,36,31,67
21401,COROICO,estado nutricional en menores de 5 anos,clasificacion d,2003-03-01,19,20,19,20,39
40301,CORQUE,estado nutricional en menores de 5 anos,clasificacion d,2003-03-01,19,33,19,33,52
50601,COTAGAITA,estado nutricional en menores de 5 anos,clasificacion d,2003-03-01,84,98,84,98,182
70102,COTOCA,estado nutricional en menores de 5 anos,clasificacion d,2003-03-01,22,21,22,21,43
31405,CUCHUMUELA (V. G. VILLARROEL),estado nutricional en menores de 5 anos,clasificacion d,2003-03-01,1,3,1,3,4
70704,CUEVO,estado nutricional en menores de 5 anos,clasificacion d,2003-03-01,16,18,16,18,34
10902,CULPINA,estado nutricional en menores de 5 anos,clasificacion d,2003-03-01,154,159,154,159,313
40401,CURAHUARA DE CARANGAS,estado nutricional en menores de 5 anos,clasificacion d,2003-03-01,31,23,31,23,54
21602,CURVA,estado nutricional en menores de 5 anos,clasificacion d,2003-03-01,24,15,24,15,39
20804,DESAGUADERO,estado nutricional en menores de 5 anos,clasificacion d,2003-03-01,5,8,5,8,13
20105,EL ALTO,estado nutricional en menores de 5 anos,clasificacion d,2003-03-01,1407,850,1407,850,2257
40103,EL CHORO,estado nutricional en menores de 5 anos,clasificacion d,2003-03-01,7,6,7,6,13
71503,EL PUENTE(STC),estado nutricional en menores de 5 anos,clasificacion d,2003-03-01,26,128,26,128,154
60502,EL PUENTE(TJA),estado nutricional en menores de 5 anos,clasificacion d,2003-03-01,14,35,14,35,49
70105,EL TORNO,estado nutricional en menores de 5 anos,clasificacion d,2003-03-01,70,86,70,86,156
10405,EL VILLAR,estado nutricional en menores de 5 anos,clasificacion d,2003-03-01,47,133,47,133,180
60601,ENTRE RIOS,estado nutricional en menores de 5 anos,clasificacion d,2003-03-01,47,63,47,63,110
41101,EUCALIPTUS,estado nutricional en menores de 5 anos,clasificacion d,2003-03-01,11,13,11,13,24
90503,EUREKA (SANTOS MERCADO),estado nutricional en menores de 5 anos,clasificacion d,2003-03-01,1,0,1,0,1
80402,EXALTACION,estado nutricional en menores de 5 anos,clasificacion d,2003-03-01,0,13,0,13,13
90203,FILADELFIA,estado nutricional en menores de 5 anos,clasificacion d,2003-03-01,3,4,3,4,7
71002,GENERAL SAAVEDRA,estado nutricional en menores de 5 anos,clasificacion d,2003-03-01,76,123,76,123,199
21601,GRAL. J.J. PEREZ (CHARAZANI),estado nutricional en menores de 5 anos,clasificacion d,2003-03-01,18,26,18,26,44
20602,GUANAY,estado nutricional en menores de 5 anos,clasificacion d,2003-03-01,82,93,82,93,175
20802,GUAQUI,estado nutricional en menores de 5 anos,clasificacion d,2003-03-01,13,9,13,9,22
80202,GUAYARAMERIN,estado nutricional en menores de 5 anos,clasificacion d,2003-03-01,149,144,149,144,293
70705,GUTIERREZ,estado nutricional en menores de 5 anos,clasificacion d,2003-03-01,107,151,107,151,258
10502,HUACARETA,estado nutricional en menores de 5 anos,clasificacion d,2003-03-01,55,111,55,111,166
11002,HUACAYA (VILLA DE HUACAYA),estado nutricional en menores de 5 anos,clasificacion d,2003-03-01,11,16,11,16,27
40701,HUANUNI,estado nutricional en menores de 5 anos,clasificacion d,2003-03-01,80,76,80,76,156
80803,HUARACAJE,estado nutricional en menores de 5 anos,clasificacion d,2003-03-01,8,1,8,1,9
41601,HUAYLLAMARCA,estado nutricional en menores de 5 anos,clasificacion d,2003-03-01,10,11,10,11,21
21005,ICHOCA,estado nutricional en menores de 5 anos,clasificacion d,2003-03-01,20,29,20,29,49
10304,ICLA,estado nutricional en menores de 5 anos,clasificacion d,2003-03-01,115,167,115,167,282
10703,INCAHUASI,estado nutricional en menores de 5 anos,clasificacion d,2003-03-01,119,113,119,113,232
21001,INQUISIVI,estado nutricional en menores de 5 anos,clasificacion d,2003-03-01,67,92,67,92,159
21102,IRUPANA (VILLA DE LANZA),estado nutricional en menores de 5 anos,clasificacion d,2003-03-01,32,52,32,52,84
21501,IXIAMAS,estado nutricional en menores de 5 anos,clasificacion d,2003-03-01,21,24,21,24,45
21105,LA ASUNTA,estado nutricional en menores de 5 anos,clasificacion d,2003-03-01,52,32,52,32,84
70104,LA GUARDIA,estado nutricional en menores de 5 anos,clasificacion d,2003-03-01,55,32,55,32,87
20101,LA PAZ,estado nutricional en menores de 5 anos,clasificacion d,2003-03-01,1001,868,1001,868,1869
41501,LA RIVERA,estado nutricional en menores de 5 anos,clasificacion d,2003-03-01,0,3,0,3,3
70701,LAGUNILLAS,estado nutricional en menores de 5 anos,clasificacion d,2003-03-01,49,72,49,72,121
21202,LAJA,estado nutricional en menores de 5 anos,clasificacion d,2003-03-01,18,6,18,6,24
10903,LAS CARRERAS,estado nutricional en menores de 5 anos,clasificacion d,2003-03-01,23,34,23,34,57
21006,LICOMA PAMPA,estado nutricional en menores de 5 anos,clasificacion d,2003-03-01,11,5,11,5,16
50203,LLALLAGUA,estado nutricional en menores de 5 anos,clasificacion d,2003-03-01,16,219,16,219,235
51401,LLICA,estado nutricional en menores de 5 anos,clasificacion d,2003-03-01,17,9,17,9,26
80601,LORETO,estado nutricional en menores de 5 anos,clasificacion d,2003-03-01,13,9,13,9,22
20901,LURIBAY,estado nutricional en menores de 5 anos,clasificacion d,2003-03-01,29,11,29,11,40
40702,MACHACAMARCA,estado nutricional en menores de 5 anos,clasificacion d,2003-03-01,20,8,20,8,28
11003,MACHARETI,estado nutricional en menores de 5 anos,clasificacion d,2003-03-01,29,60,29,60,89
80801,MAGDALENA,estado nutricional en menores de 5 anos,clasificacion d,2003-03-01,26,31,26,31,57
70903,MAIRANA,estado nutricional en menores de 5 anos,clasificacion d,2003-03-01,24,24,24,24,48
20904,MALLA,estado nutricional en menores de 5 anos,clasificacion d,2003-03-01,1,5,1,5,6
20103,MECAPACA,estado nutricional en menores de 5 anos,clasificacion d,2003-03-01,10,31,10,31,41
71003,MINEROS,estado nutricional en menores de 5 anos,clasificacion d,2003-03-01,145,111,145,111,256
31301,MIZQUE,estado nutricional en menores de 5 anos,clasificacion d,2003-03-01,81,62,81,62,143
20402,MOCOMOCO,estado nutricional en menores de 5 anos,clasificacion d,2003-03-01,48,63,48,63,111
51002,MOJINETE,estado nutricional en menores de 5 anos,clasificacion d,2003-03-01,6,11,6,11,17
10303,MOJOCOYA,estado nutricional en menores de 5 anos,clasificacion d,2003-03-01,46,99,46,99,145
10501,MONTEAGUDO,estado nutricional en menores de 5 anos,clasificacion d,2003-03-01,129,165,129,165,294
71001,MONTERO,estado nutricional en menores de 5 anos,clasificacion d,2003-03-01,301,175,301,175,476
70803,MORO MORO,estado nutricional en menores de 5 anos,clasificacion d,2003-03-01,11,13,11,13,24
30302,MOROCHATA,estado nutricional en menores de 5 anos,clasificacion d,2003-03-01,97,106,97,106,203
90401,NACEBE (SANTA ROSA DEL ABUNA),estado nutricional en menores de 5 anos,clasificacion d,2003-03-01,4,2,4,2,6
20307,NAZACARA DE PACAJES,estado nutricional en menores de 5 anos,clasificacion d,2003-03-01,2,0,2,0,2
90501,NUEVO MANOA (NUEVA ESPERANZA),estado nutricional en menores de 5 anos,clasificacion d,2003-03-01,1,1,1,1,2
50404,OCURI,estado nutricional en menores de 5 anos,clasificacion d,2003-03-01,59,119,59,119,178
70202,OKINAWA,estado nutricional en menores de 5 anos,clasificacion d,2003-03-01,9,23,9,23,32
30203,OMEREQUE,estado nutricional en menores de 5 anos,clasificacion d,2003-03-01,0,26,0,26,26
40101,ORURO,estado nutricional en menores de 5 anos,clasificacion d,2003-03-01,503,514,503,514,1017
60201,PADCAYA,estado nutricional en menores de 5 anos,clasificacion d,2003-03-01,45,58,45,58,103
10401,PADILLA,estado nutricional en menores de 5 anos,clasificacion d,2003-03-01,103,215,103,215,318
70502,PAILON,estado nutricional en menores de 5 anos,clasificacion d,2003-03-01,29,24,29,24,53
20102,PALCA,estado nutricional en menores de 5 anos,clasificacion d,2003-03-01,35,24,35,24,59
21104,PALOS BLANCOS,estado nutricional en menores de 5 anos,clasificacion d,2003-03-01,69,108,69,108,177
40802,PAMPA AULLAGAS,estado nutricional en menores de 5 anos,clasificacion d,2003-03-01,11,24,11,24,35
70902,PAMPA GRANDE,estado nutricional en menores de 5 anos,clasificacion d,2003-03-01,11,10,11,10,21
21802,PAPEL PAMPA,estado nutricional en menores de 5 anos,clasificacion d,2003-03-01,7,8,7,8,15
30202,PASORAPA,estado nutricional en menores de 5 anos,clasificacion d,2003-03-01,4,11,4,11,15
21305,PATACAMAYA,estado nutricional en menores de 5 anos,clasificacion d,2003-03-01,52,44,52,44,96
40602,PAZÃ‘A,estado nutricional en menores de 5 anos,clasificacion d,2003-03-01,8,24,8,24,32
20702,PELECHUCO,estado nutricional en menores de 5 anos,clasificacion d,2003-03-01,16,19,16,19,35
50403,POCOATA,estado nutricional en menores de 5 anos,clasificacion d,2003-03-01,164,161,164,161,325
31203,POCONA,estado nutricional en menores de 5 anos,clasificacion d,2003-03-01,58,61,58,61,119
31202,POJO (CBBA),estado nutricional en menores de 5 anos,clasificacion d,2003-03-01,109,115,109,115,224
40601,POOPO,estado nutricional en menores de 5 anos,clasificacion d,2003-03-01,1,24,1,24,25
51203,PORCO,estado nutricional en menores de 5 anos,clasificacion d,2003-03-01,36,33,36,33,69
10103,POROMA,estado nutricional en menores de 5 anos,clasificacion d,2003-03-01,117,187,117,187,304
70103,PORONGO,estado nutricional en menores de 5 anos,clasificacion d,2003-03-01,15,15,15,15,30
70601,PORTACHUELO,estado nutricional en menores de 5 anos,clasificacion d,2003-03-01,54,46,54,46,100
90102,PORVENIR,estado nutricional en menores de 5 anos,clasificacion d,2003-03-01,4,2,4,2,6
70804,POSTRER VALLE,estado nutricional en menores de 5 anos,clasificacion d,2003-03-01,5,15,5,15,20
50101,POTOSI,estado nutricional en menores de 5 anos,clasificacion d,2003-03-01,504,363,504,363,867
10302,PRESTO,estado nutricional en menores de 5 anos,clasificacion d,2003-03-01,49,81,49,81,130
70805,PUCARA,estado nutricional en menores de 5 anos,clasificacion d,2003-03-01,2,6,2,6,8
21201,PUCARANI,estado nutricional en menores de 5 anos,clasificacion d,2003-03-01,20,31,20,31,51
20401,PUERTO ACOSTA,estado nutricional en menores de 5 anos,clasificacion d,2003-03-01,69,53,69,53,122
20403,PUERTO CARABUCO,estado nutricional en menores de 5 anos,clasificacion d,2003-03-01,47,63,47,63,110
90301,PUERTO GONZALO MORENO,estado nutricional en menores de 5 anos,clasificacion d,2003-03-01,9,6,9,6,15
21204,PUERTO PEREZ,estado nutricional en menores de 5 anos,clasificacion d,2003-03-01,11,2,11,2,13
71402,PUERTO QUIJARRO,estado nutricional en menores de 5 anos,clasificacion d,2003-03-01,36,24,36,24,60
90201,PUERTO RICO,estado nutricional en menores de 5 anos,clasificacion d,2003-03-01,2,19,2,19,21
71401,PUERTO SUAREZ,estado nutricional en menores de 5 anos,clasificacion d,2003-03-01,45,19,45,19,64
31205,PUERTO VILLARROEL,estado nutricional en menores de 5 anos,clasificacion d,2003-03-01,169,164,169,164,333
51101,PUNA,estado nutricional en menores de 5 anos,clasificacion d,2003-03-01,194,178,194,178,372
31401,PUNATA,estado nutricional en menores de 5 anos,clasificacion d,2003-03-01,112,37,112,37,149
30901,QUILLACOLLO,estado nutricional en menores de 5 anos,clasificacion d,2003-03-01,200,314,200,314,514
21002,QUIME,estado nutricional en menores de 5 anos,clasificacion d,2003-03-01,62,75,62,75,137
70904,QUIRUSILLAS,estado nutricional en menores de 5 anos,clasificacion d,2003-03-01,5,5,5,5,10
50402,RAVELO,estado nutricional en menores de 5 anos,clasificacion d,2003-03-01,175,166,175,166,341
80301,REYES,estado nutricional en menores de 5 anos,clasificacion d,2003-03-01,24,21,24,21,45
80201,RIBERALTA,estado nutricional en menores de 5 anos,clasificacion d,2003-03-01,288,236,288,236,524
70503,ROBORE,estado nutricional en menores de 5 anos,clasificacion d,2003-03-01,55,78,55,78,133
80304,RURRENABAQUE,estado nutricional en menores de 5 anos,clasificacion d,2003-03-01,13,10,13,10,23
40901,SABAYA,estado nutricional en menores de 5 anos,clasificacion d,2003-03-01,3,4,3,4,7
31001,SACABA,estado nutricional en menores de 5 anos,clasificacion d,2003-03-01,153,154,153,154,307
30404,SACABAMBA,estado nutricional en menores de 5 anos,clasificacion d,2003-03-01,12,29,12,29,41
50701,SACACA,estado nutricional en menores de 5 anos,clasificacion d,2003-03-01,173,286,173,286,459
71302,SAIPINA,estado nutricional en menores de 5 anos,clasificacion d,2003-03-01,15,15,15,15,30
40801,SALINAS DE GARCI MENDOZA,estado nutricional en menores de 5 anos,clasificacion d,2003-03-01,16,9,16,9,25
70901,SAMAIPATA,estado nutricional en menores de 5 anos,clasificacion d,2003-03-01,29,16,29,16,45
51601,SAN AGUSTIN,estado nutricional en menores de 5 anos,clasificacion d,2003-03-01,4,5,4,5,9
80602,SAN ANDRES,estado nutricional en menores de 5 anos,clasificacion d,2003-03-01,7,16,7,16,23
51003,SAN ANTONIO DE ESMORUCO,estado nutricional en menores de 5 anos,clasificacion d,2003-03-01,5,14,5,14,19
71105,SAN ANTONIO DE LOMERIO,estado nutricional en menores de 5 anos,clasificacion d,2003-03-01,82,115,82,115,197
31403,SAN BENITO,estado nutricional en menores de 5 anos,clasificacion d,2003-03-01,21,12,21,12,33
80302,SAN BORJA,estado nutricional en menores de 5 anos,clasificacion d,2003-03-01,114,55,114,55,169
21502,SAN BUENA VENTURA,estado nutricional en menores de 5 anos,clasificacion d,2003-03-01,27,23,27,23,50
70402,SAN CARLOS,estado nutricional en menores de 5 anos,clasificacion d,2003-03-01,75,57,75,57,132
80501,SAN IGNACIO,estado nutricional en menores de 5 anos,clasificacion d,2003-03-01,83,123,83,123,206
70301,SAN IGNACIO DE VELASCO,estado nutricional en menores de 5 anos,clasificacion d,2003-03-01,202,146,202,146,348
80102,SAN JAVIER(BNI),estado nutricional en menores de 5 anos,clasificacion d,2003-03-01,6,15,6,15,21
71102,SAN JAVIER(STC),estado nutricional en menores de 5 anos,clasificacion d,2003-03-01,31,48,31,48,79
80701,SAN JOAQUIN,estado nutricional en menores de 5 anos,clasificacion d,2003-03-01,5,11,5,11,16
70501,SAN JOSE DE CHIQUITOS,estado nutricional en menores de 5 anos,clasificacion d,2003-03-01,27,15,27,15,42
71104,SAN JULIAN,estado nutricional en menores de 5 anos,clasificacion d,2003-03-01,213,241,213,241,454
90302,SAN LORENZO(PND),estado nutricional en menores de 5 anos,clasificacion d,2003-03-01,29,44,29,44,73
60501,SAN LORENZO(TJA),estado nutricional en menores de 5 anos,clasificacion d,2003-03-01,42,67,42,67,109
10702,SAN LUCAS,estado nutricional en menores de 5 anos,clasificacion d,2003-03-01,393,429,393,429,822
70302,SAN MIGUEL DE VELASCO,estado nutricional en menores de 5 anos,clasificacion d,2003-03-01,59,58,59,58,117
51001,SAN PABLO DE LIPEZ,estado nutricional en menores de 5 anos,clasificacion d,2003-03-01,11,32,11,32,43
50501,SAN PEDRO DE BUENA VISTA,estado nutricional en menores de 5 anos,clasificacion d,2003-03-01,136,189,136,189,325
21801,SAN PEDRO DE CURAHUARA,estado nutricional en menores de 5 anos,clasificacion d,2003-03-01,14,19,14,19,33
50902,SAN PEDRO DE QUEMES,estado nutricional en menores de 5 anos,clasificacion d,2003-03-01,3,1,3,1,4
21702,SAN PEDRO DE TIQUINA,estado nutricional en menores de 5 anos,clasificacion d,2003-03-01,7,6,7,6,13
70303,SAN RAFAEL,estado nutricional en menores de 5 anos,clasificacion d,2003-03-01,41,53,41,53,94
80702,SAN RAMON,estado nutricional en menores de 5 anos,clasificacion d,2003-03-01,33,31,33,31,64
80702,SAN RAMON,estado nutricional en menores de 5 anos,clasificacion d,2003-03-01,1,4,1,4,5
80401,SANTA ANA,estado nutricional en menores de 5 anos,clasificacion d,2003-03-01,0,2,0,2,2
70101,SANTA CRUZ DE LA SIERRA,estado nutricional en menores de 5 anos,clasificacion d,2003-03-01,624,394,624,394,1018
80303,SANTA ROSA,estado nutricional en menores de 5 anos,clasificacion d,2003-03-01,13,3,13,3,16
70602,SANTA ROSA DEL SARA,estado nutricional en menores de 5 anos,clasificacion d,2003-03-01,12,16,12,16,28
20308,SANTIAGO DE CALLAPA,estado nutricional en menores de 5 anos,clasificacion d,2003-03-01,17,20,17,20,37
21901,SANTIAGO DE MACHACA,estado nutricional en menores de 5 anos,clasificacion d,2003-03-01,8,2,8,2,10
30702,SANTIVAÃ‘ES,estado nutricional en menores de 5 anos,clasificacion d,2003-03-01,21,19,21,19,40
40202,SANTUARIO DE QUILLACAS,estado nutricional en menores de 5 anos,clasificacion d,2003-03-01,11,9,11,9,20
20902,SAPAHAQUI,estado nutricional en menores de 5 anos,clasificacion d,2003-03-01,30,17,30,17,47
90303,SENA,estado nutricional en menores de 5 anos,clasificacion d,2003-03-01,1,14,1,14,15
21301,SICA SICA (VILLA AROMA),estado nutricional en menores de 5 anos,clasificacion d,2003-03-01,67,45,67,45,112
30703,SICAYA,estado nutricional en menores de 5 anos,clasificacion d,2003-03-01,8,2,8,2,10
30902,SIPE SIPE,estado nutricional en menores de 5 anos,clasificacion d,2003-03-01,125,66,125,66,191
10403,SOPACHUY,estado nutricional en menores de 5 anos,clasificacion d,2003-03-01,27,48,27,48,75
20601,SORATA,estado nutricional en menores de 5 anos,clasificacion d,2003-03-01,60,81,60,81,141
10101,SUCRE,estado nutricional en menores de 5 anos,clasificacion d,2003-03-01,485,569,485,569,1054
31404,TACACHI,estado nutricional en menores de 5 anos,clasificacion d,2003-03-01,9,4,9,4,13
50303,TACOBAMBA,estado nutricional en menores de 5 anos,clasificacion d,2003-03-01,71,61,71,61,132
30602,TACOPAYA,estado nutricional en menores de 5 anos,clasificacion d,2003-03-01,47,82,47,82,129
51402,TAHUA,estado nutricional en menores de 5 anos,clasificacion d,2003-03-01,6,6,6,6,12
31101,TAPACARI,estado nutricional en menores de 5 anos,clasificacion d,2003-03-01,79,74,79,74,153
10601,TARABUCO,estado nutricional en menores de 5 anos,clasificacion d,2003-03-01,247,390,247,390,637
30401,TARATA,estado nutricional en menores de 5 anos,clasificacion d,2003-03-01,32,15,32,15,47
60101,TARIJA,estado nutricional en menores de 5 anos,clasificacion d,2003-03-01,194,171,194,171,365
10202,TARVITA,estado nutricional en menores de 5 anos,clasificacion d,2003-03-01,114,145,114,145,259
20803,TIAWANACU,estado nutricional en menores de 5 anos,clasificacion d,2003-03-01,18,11,18,11,29
50102,TINGUIPAYA,estado nutricional en menores de 5 anos,clasificacion d,2003-03-01,48,89,48,89,137
20606,TIPUANI,estado nutricional en menores de 5 anos,clasificacion d,2003-03-01,9,9,9,9,18
30903,TIQUIPAYA,estado nutricional en menores de 5 anos,clasificacion d,2003-03-01,15,10,15,10,25
31601,TIRAQUE (CBBA),estado nutricional en menores de 5 anos,clasificacion d,2003-03-01,101,217,101,217,318
21703,TITO YUPANQUI (PARQUIPUJIO),estado nutricional en menores de 5 anos,clasificacion d,2003-03-01,6,10,6,10,16
30802,TOCO,estado nutricional en menores de 5 anos,clasificacion d,2003-03-01,6,9,6,9,15
41502,TODOS SANTOS,estado nutricional en menores de 5 anos,clasificacion d,2003-03-01,1,0,1,0,1
30803,TOLATA,estado nutricional en menores de 5 anos,clasificacion d,2003-03-01,7,8,7,8,15
41001,TOLEDO,estado nutricional en menores de 5 anos,clasificacion d,2003-03-01,12,8,12,8,20
51202,TOMAVE,estado nutricional en menores de 5 anos,clasificacion d,2003-03-01,57,104,57,104,161
10402,TOMINA,estado nutricional en menores de 5 anos,clasificacion d,2003-03-01,85,177,85,177,262
50502,TORO TORO,estado nutricional en menores de 5 anos,clasificacion d,2003-03-01,53,69,53,69,122
31201,TOTORA(CBBA),estado nutricional en menores de 5 anos,clasificacion d,2003-03-01,49,34,49,34,83
41301,TOTORA(ORR),estado nutricional en menores de 5 anos,clasificacion d,2003-03-01,13,24,13,24,37
70802,TRIGAL,estado nutricional en menores de 5 anos,clasificacion d,2003-03-01,7,6,7,6,13
80101,TRINIDAD,estado nutricional en menores de 5 anos,clasificacion d,2003-03-01,126,205,126,205,331
50801,TUPIZA,estado nutricional en menores de 5 anos,clasificacion d,2003-03-01,68,299,68,299,367
40402,TURCO,estado nutricional en menores de 5 anos,clasificacion d,2003-03-01,10,10,10,10,20
21302,UMALA,estado nutricional en menores de 5 anos,clasificacion d,2003-03-01,32,20,32,20,52
50201,UNCIA,estado nutricional en menores de 5 anos,clasificacion d,2003-03-01,7,38,7,38,45
60401,URIONDO (A. CONCEPCION),estado nutricional en menores de 5 anos,clasificacion d,2003-03-01,32,26,32,26,58
71502,URUBICHA,estado nutricional en menores de 5 anos,clasificacion d,2003-03-01,3,20,3,20,23
51201,UYUNI,estado nutricional en menores de 5 anos,clasificacion d,2003-03-01,94,85,94,85,179
30502,VACAS,estado nutricional en menores de 5 anos,clasificacion d,2003-03-01,16,6,16,6,22
70801,VALLEGRANDE,estado nutricional en menores de 5 anos,clasificacion d,2003-03-01,70,88,70,88,158
20801,VIACHA,estado nutricional en menores de 5 anos,clasificacion d,2003-03-01,78,74,78,74,152
31302,VILA VILA,estado nutricional en menores de 5 anos,clasificacion d,2003-03-01,12,20,12,20,32
60303,VILLA MONTES,estado nutricional en menores de 5 anos,clasificacion d,2003-03-01,73,76,73,76,149
90502,VILLA NUEVA (LOMA ALTA),estado nutricional en menores de 5 anos,clasificacion d,2003-03-01,1,0,1,0,1
31402,VILLA RIVERO,estado nutricional en menores de 5 anos,clasificacion d,2003-03-01,16,13,16,13,29
10801,VILLA SERRANO,estado nutricional en menores de 5 anos,clasificacion d,2003-03-01,98,178,98,178,276
31003,VILLA TUNARI,estado nutricional en menores de 5 anos,clasificacion d,2003-03-01,97,77,97,77,174
11001,VILLA VACA GUZMAN (MUYUPAMPA),estado nutricional en menores de 5 anos,clasificacion d,2003-03-01,54,81,54,81,135
51501,VILLAZON,estado nutricional en menores de 5 anos,clasificacion d,2003-03-01,81,142,81,142,223
50602,VITICHI,estado nutricional en menores de 5 anos,clasificacion d,2003-03-01,85,101,85,101,186
20306,WALDO BALLIVIAN,estado nutricional en menores de 5 anos,clasificacion d,2003-03-01,6,1,6,1,7
70201,WARNES,estado nutricional en menores de 5 anos,clasificacion d,2003-03-01,92,113,92,113,205
20903,YACO,estado nutricional en menores de 5 anos,clasificacion d,2003-03-01,13,7,13,7,20
60301,YACUIBA,estado nutricional en menores de 5 anos,clasificacion d,2003-03-01,110,84,110,84,194
10602,YAMPARAEZ,estado nutricional en menores de 5 anos,clasificacion d,2003-03-01,134,273,134,273,407
21103,YANACACHI,estado nutricional en menores de 5 anos,clasificacion d,2003-03-01,14,17,14,17,31
70403,YAPACANI,estado nutricional en menores de 5 anos,clasificacion d,2003-03-01,146,108,146,108,254
50103,YOCALLA,estado nutricional en menores de 5 anos,clasificacion d,2003-03-01,40,33,40,33,73
10102,YOTALA,estado nutricional en menores de 5 anos,clasificacion d,2003-03-01,86,151,86,151,237
60402,YUNCHARA,estado nutricional en menores de 5 anos,clasificacion d,2003-03-01,5,14,5,14,19
10301,ZUDAÃ‘EZ,estado nutricional en menores de 5 anos,clasificacion d,2003-03-01,49,94,49,94,143
51302,ACACIO,estado nutricional en menores de 5 anos,clasificacion d,2003-04-01,57,96,57,96,153
20201,ACHACACHI,estado nutricional en menores de 5 anos,clasificacion d,2003-04-01,108,86,108,86,194
20104,ACHOCALLA,estado nutricional en menores de 5 anos,clasificacion d,2003-04-01,23,17,23,17,40
30201,AIQUILE,estado nutricional en menores de 5 anos,clasificacion d,2003-04-01,68,56,68,56,124
31303,ALALAY,estado nutricional en menores de 5 anos,clasificacion d,2003-04-01,11,14,11,14,25
10404,ALCALA,estado nutricional en menores de 5 anos,clasificacion d,2003-04-01,35,83,35,83,118
20202,ANCORAIMES,estado nutricional en menores de 5 anos,clasificacion d,2003-04-01,39,46,39,46,85
41201,ANDAMARCA,estado nutricional en menores de 5 anos,clasificacion d,2003-04-01,4,11,4,11,15
40603,ANTEQUERA,estado nutricional en menores de 5 anos,clasificacion d,2003-04-01,2,5,2,5,7
30402,ANZALDO,estado nutricional en menores de 5 anos,clasificacion d,2003-04-01,25,64,25,64,89
20701,APOLO,estado nutricional en menores de 5 anos,clasificacion d,2003-04-01,29,25,29,25,54
51301,ARAMPAMPA,estado nutricional en menores de 5 anos,clasificacion d,2003-04-01,36,66,36,66,102
30501,ARANI,estado nutricional en menores de 5 anos,clasificacion d,2003-04-01,8,86,8,86,94
30403,ARBIETO,estado nutricional en menores de 5 anos,clasificacion d,2003-04-01,18,10,18,10,28
30601,ARQUE,estado nutricional en menores de 5 anos,clasificacion d,2003-04-01,35,43,35,43,78
71501,ASCENCION DE GUARAYOS,estado nutricional en menores de 5 anos,clasificacion d,2003-04-01,154,274,154,274,428
50802,ATOCHA,estado nutricional en menores de 5 anos,clasificacion d,2003-04-01,33,210,33,210,243
20503,AUCAPATA,estado nutricional en menores de 5 anos,clasificacion d,2003-04-01,25,41,25,41,66
20502,AYATA,estado nutricional en menores de 5 anos,clasificacion d,2003-04-01,40,17,40,17,57
21303,AYO AYO,estado nutricional en menores de 5 anos,clasificacion d,2003-04-01,9,10,9,10,19
30301,AYOPAYA (V. DE INDEPENDENCIA),estado nutricional en menores de 5 anos,clasificacion d,2003-04-01,70,126,70,126,196
10201,AZURDUY,estado nutricional en menores de 5 anos,clasificacion d,2003-04-01,128,169,128,169,297
21203,BATALLAS,estado nutricional en menores de 5 anos,clasificacion d,2003-04-01,38,25,38,25,63
80802,BAURES,estado nutricional en menores de 5 anos,clasificacion d,2003-04-01,31,26,31,26,57
41202,BELEN DE ANDAMARCA,estado nutricional en menores de 5 anos,clasificacion d,2003-04-01,1,3,1,3,4
50104,BELEN DE URMIRI,estado nutricional en menores de 5 anos,clasificacion d,2003-04-01,5,14,5,14,19
90104,BELLA FLOR,estado nutricional en menores de 5 anos,clasificacion d,2003-04-01,15,26,15,26,41
60202,BERMEJO,estado nutricional en menores de 5 anos,clasificacion d,2003-04-01,8,3,8,3,11
50301,BETANZOS,estado nutricional en menores de 5 anos,clasificacion d,2003-04-01,253,221,253,221,474
31501,BOLIVAR,estado nutricional en menores de 5 anos,clasificacion d,2003-04-01,67,111,67,111,178
90103,BOLPEBRA,estado nutricional en menores de 5 anos,clasificacion d,2003-04-01,3,13,3,13,16
70707,BOYUIBE,estado nutricional en menores de 5 anos,clasificacion d,2003-04-01,10,17,10,17,27
70401,BUENA VISTA,estado nutricional en menores de 5 anos,clasificacion d,2003-04-01,63,61,63,61,124
70703,CABEZAS,estado nutricional en menores de 5 anos,clasificacion d,2003-04-01,37,18,37,18,55
20905,CAIROMA,estado nutricional en menores de 5 anos,clasificacion d,2003-04-01,41,37,41,37,78
51102,"CAIZA ""D""",estado nutricional en menores de 5 anos,clasificacion d,2003-04-01,65,74,65,74,139
21003,CAJUATA,estado nutricional en menores de 5 anos,clasificacion d,2003-04-01,36,23,36,23,59
20303,CALACOTO,estado nutricional en menores de 5 anos,clasificacion d,2003-04-01,11,10,11,10,21
21304,CALAMARCA,estado nutricional en menores de 5 anos,clasificacion d,2003-04-01,152,109,152,109,261
10701,CAMARGO,estado nutricional en menores de 5 anos,clasificacion d,2003-04-01,70,101,70,101,171
10901,CAMATAQUI (C. VILLA ABECIA),estado nutricional en menores de 5 anos,clasificacion d,2003-04-01,23,53,23,53,76
70706,CAMIRI,estado nutricional en menores de 5 anos,clasificacion d,2003-04-01,183,165,183,165,348
30701,CAPINOTA,estado nutricional en menores de 5 anos,clasificacion d,2003-04-01,32,31,32,31,63
20302,CAQUIAVIRI,estado nutricional en menores de 5 anos,clasificacion d,2003-04-01,19,36,19,36,55
40102,CARACOLLO,estado nutricional en menores de 5 anos,clasificacion d,2003-04-01,78,74,78,74,152
22001,CARANAVI,estado nutricional en menores de 5 anos,clasificacion d,2003-04-01,128,94,128,94,222
41503,CARANGAS,estado nutricional en menores de 5 anos,clasificacion d,2003-04-01,0,2,0,2,2
60302,CARAPARI,estado nutricional en menores de 5 anos,clasificacion d,2003-04-01,27,41,27,41,68
50702,CARIPUYO,estado nutricional en menores de 5 anos,clasificacion d,2003-04-01,62,125,62,125,187
21902,CATACORA,estado nutricional en menores de 5 anos,clasificacion d,2003-04-01,1,1,1,1,2
40201,CHALLAPATA,estado nutricional en menores de 5 anos,clasificacion d,2003-04-01,63,110,63,110,173
50302,CHAQUI,estado nutricional en menores de 5 anos,clasificacion d,2003-04-01,51,73,51,73,124
70702,CHARAGUA,estado nutricional en menores de 5 anos,clasificacion d,2003-04-01,116,137,116,137,253
20305,CHARAÃ‘A,estado nutricional en menores de 5 anos,clasificacion d,2003-04-01,8,22,8,22,30
50202,CHAYANTA,estado nutricional en menores de 5 anos,clasificacion d,2003-04-01,56,32,56,32,88
31204,CHIMORE,estado nutricional en menores de 5 anos,clasificacion d,2003-04-01,35,31,35,31,66
40903,CHIPAYA,estado nutricional en menores de 5 anos,clasificacion d,2003-04-01,0,9,0,9,9
40302,CHOQUE COTA,estado nutricional en menores de 5 anos,clasificacion d,2003-04-01,9,13,9,13,22
21101,CHULUMANI (V. DE LA LIBERTAD),estado nutricional en menores de 5 anos,clasificacion d,2003-04-01,31,8,31,8,39
20501,CHUMA,estado nutricional en menores de 5 anos,clasificacion d,2003-04-01,46,37,46,37,83
30801,CLIZA,estado nutricional en menores de 5 anos,clasificacion d,2003-04-01,23,21,23,21,44
90101,COBIJA,estado nutricional en menores de 5 anos,clasificacion d,2003-04-01,45,21,45,21,66
30101,COCHABAMBA,estado nutricional en menores de 5 anos,clasificacion d,2003-04-01,673,480,673,480,1153
40902,COIPASA,estado nutricional en menores de 5 anos,clasificacion d,2003-04-01,0,1,0,1,1
30905,COLCAPIRHUA,estado nutricional en menores de 5 anos,clasificacion d,2003-04-01,5,8,5,8,13
50901,"COLCHA ""K""",estado nutricional en menores de 5 anos,clasificacion d,2003-04-01,49,66,49,66,115
21307,COLLANA,estado nutricional en menores de 5 anos,clasificacion d,2003-04-01,1,0,1,0,1
31002,COLOMI,estado nutricional en menores de 5 anos,clasificacion d,2003-04-01,76,75,76,75,151
50401,COLQUECHACA,estado nutricional en menores de 5 anos,clasificacion d,2003-04-01,152,87,152,87,239
21306,COLQUENCHA,estado nutricional en menores de 5 anos,clasificacion d,2003-04-01,22,16,22,16,38
21004,COLQUIRI,estado nutricional en menores de 5 anos,clasificacion d,2003-04-01,96,82,96,82,178
20304,COMANCHE,estado nutricional en menores de 5 anos,clasificacion d,2003-04-01,2,11,2,11,13
71301,COMARAPA,estado nutricional en menores de 5 anos,clasificacion d,2003-04-01,61,44,61,44,105
20605,COMBAYA,estado nutricional en menores de 5 anos,clasificacion d,2003-04-01,9,11,9,11,20
71101,CONCEPCION,estado nutricional en menores de 5 anos,clasificacion d,2003-04-01,8,55,8,55,63
21701,COPACABANA,estado nutricional en menores de 5 anos,clasificacion d,2003-04-01,30,37,30,37,67
21402,CORIPATA,estado nutricional en menores de 5 anos,clasificacion d,2003-04-01,4,0,4,0,4
20301,CORO CORO,estado nutricional en menores de 5 anos,clasificacion d,2003-04-01,32,33,32,33,65
21401,COROICO,estado nutricional en menores de 5 anos,clasificacion d,2003-04-01,29,21,29,21,50
40301,CORQUE,estado nutricional en menores de 5 anos,clasificacion d,2003-04-01,31,19,31,19,50
50601,COTAGAITA,estado nutricional en menores de 5 anos,clasificacion d,2003-04-01,118,201,118,201,319
70102,COTOCA,estado nutricional en menores de 5 anos,clasificacion d,2003-04-01,48,23,48,23,71
31405,CUCHUMUELA (V. G. VILLARROEL),estado nutricional en menores de 5 anos,clasificacion d,2003-04-01,5,4,5,4,9
70704,CUEVO,estado nutricional en menores de 5 anos,clasificacion d,2003-04-01,12,7,12,7,19
10902,CULPINA,estado nutricional en menores de 5 anos,clasificacion d,2003-04-01,220,185,220,185,405
40401,CURAHUARA DE CARANGAS,estado nutricional en menores de 5 anos,clasificacion d,2003-04-01,17,9,17,9,26
21602,CURVA,estado nutricional en menores de 5 anos,clasificacion d,2003-04-01,16,13,16,13,29
20804,DESAGUADERO,estado nutricional en menores de 5 anos,clasificacion d,2003-04-01,15,15,15,15,30
20105,EL ALTO,estado nutricional en menores de 5 anos,clasificacion d,2003-04-01,2238,1542,2238,1542,3780
40103,EL CHORO,estado nutricional en menores de 5 anos,clasificacion d,2003-04-01,9,2,9,2,11
71503,EL PUENTE(STC),estado nutricional en menores de 5 anos,clasificacion d,2003-04-01,12,77,12,77,89
60502,EL PUENTE(TJA),estado nutricional en menores de 5 anos,clasificacion d,2003-04-01,27,55,27,55,82
70105,EL TORNO,estado nutricional en menores de 5 anos,clasificacion d,2003-04-01,57,39,57,39,96
10405,EL VILLAR,estado nutricional en menores de 5 anos,clasificacion d,2003-04-01,45,133,45,133,178
60601,ENTRE RIOS,estado nutricional en menores de 5 anos,clasificacion d,2003-04-01,25,57,25,57,82
41101,EUCALIPTUS,estado nutricional en menores de 5 anos,clasificacion d,2003-04-01,26,28,26,28,54
80402,EXALTACION,estado nutricional en menores de 5 anos,clasificacion d,2003-04-01,11,25,11,25,36
90203,FILADELFIA,estado nutricional en menores de 5 anos,clasificacion d,2003-04-01,4,9,4,9,13
71002,GENERAL SAAVEDRA,estado nutricional en menores de 5 anos,clasificacion d,2003-04-01,90,106,90,106,196
21601,GRAL. J.J. PEREZ (CHARAZANI),estado nutricional en menores de 5 anos,clasificacion d,2003-04-01,23,32,23,32,55
20602,GUANAY,estado nutricional en menores de 5 anos,clasificacion d,2003-04-01,82,83,82,83,165
20802,GUAQUI,estado nutricional en menores de 5 anos,clasificacion d,2003-04-01,14,3,14,3,17
80202,GUAYARAMERIN,estado nutricional en menores de 5 anos,clasificacion d,2003-04-01,146,89,146,89,235
70705,GUTIERREZ,estado nutricional en menores de 5 anos,clasificacion d,2003-04-01,92,148,92,148,240
10502,HUACARETA,estado nutricional en menores de 5 anos,clasificacion d,2003-04-01,59,74,59,74,133
11002,HUACAYA (VILLA DE HUACAYA),estado nutricional en menores de 5 anos,clasificacion d,2003-04-01,8,15,8,15,23
40501,HUACHACALLA,estado nutricional en menores de 5 anos,clasificacion d,2003-04-01,0,3,0,3,3
40701,HUANUNI,estado nutricional en menores de 5 anos,clasificacion d,2003-04-01,61,48,61,48,109
80803,HUARACAJE,estado nutricional en menores de 5 anos,clasificacion d,2003-04-01,9,8,9,8,17
41601,HUAYLLAMARCA,estado nutricional en menores de 5 anos,clasificacion d,2003-04-01,13,16,13,16,29
21005,ICHOCA,estado nutricional en menores de 5 anos,clasificacion d,2003-04-01,15,15,15,15,30
10304,ICLA,estado nutricional en menores de 5 anos,clasificacion d,2003-04-01,107,199,107,199,306
10703,INCAHUASI,estado nutricional en menores de 5 anos,clasificacion d,2003-04-01,210,201,210,201,411
21001,INQUISIVI,estado nutricional en menores de 5 anos,clasificacion d,2003-04-01,67,81,67,81,148
21102,IRUPANA (VILLA DE LANZA),estado nutricional en menores de 5 anos,clasificacion d,2003-04-01,20,71,20,71,91
21501,IXIAMAS,estado nutricional en menores de 5 anos,clasificacion d,2003-04-01,30,38,30,38,68
21105,LA ASUNTA,estado nutricional en menores de 5 anos,clasificacion d,2003-04-01,36,26,36,26,62
70104,LA GUARDIA,estado nutricional en menores de 5 anos,clasificacion d,2003-04-01,78,58,78,58,136
20101,LA PAZ,estado nutricional en menores de 5 anos,clasificacion d,2003-04-01,1404,1286,1404,1286,2690
41501,LA RIVERA,estado nutricional en menores de 5 anos,clasificacion d,2003-04-01,0,2,0,2,2
70701,LAGUNILLAS,estado nutricional en menores de 5 anos,clasificacion d,2003-04-01,45,64,45,64,109
21202,LAJA,estado nutricional en menores de 5 anos,clasificacion d,2003-04-01,19,13,19,13,32
10903,LAS CARRERAS,estado nutricional en menores de 5 anos,clasificacion d,2003-04-01,20,61,20,61,81
21006,LICOMA PAMPA,estado nutricional en menores de 5 anos,clasificacion d,2003-04-01,9,18,9,18,27
50203,LLALLAGUA,estado nutricional en menores de 5 anos,clasificacion d,2003-04-01,6,224,6,224,230
51401,LLICA,estado nutricional en menores de 5 anos,clasificacion d,2003-04-01,19,17,19,17,36
80601,LORETO,estado nutricional en menores de 5 anos,clasificacion d,2003-04-01,9,10,9,10,19
20901,LURIBAY,estado nutricional en menores de 5 anos,clasificacion d,2003-04-01,83,52,83,52,135
40702,MACHACAMARCA,estado nutricional en menores de 5 anos,clasificacion d,2003-04-01,16,26,16,26,42
11003,MACHARETI,estado nutricional en menores de 5 anos,clasificacion d,2003-04-01,36,106,36,106,142
80801,MAGDALENA,estado nutricional en menores de 5 anos,clasificacion d,2003-04-01,27,22,27,22,49
70903,MAIRANA,estado nutricional en menores de 5 anos,clasificacion d,2003-04-01,26,22,26,22,48
20904,MALLA,estado nutricional en menores de 5 anos,clasificacion d,2003-04-01,1,2,1,2,3
20103,MECAPACA,estado nutricional en menores de 5 anos,clasificacion d,2003-04-01,13,29,13,29,42
71003,MINEROS,estado nutricional en menores de 5 anos,clasificacion d,2003-04-01,144,88,144,88,232
31301,MIZQUE,estado nutricional en menores de 5 anos,clasificacion d,2003-04-01,39,58,39,58,97
20402,MOCOMOCO,estado nutricional en menores de 5 anos,clasificacion d,2003-04-01,69,57,69,57,126
51002,MOJINETE,estado nutricional en menores de 5 anos,clasificacion d,2003-04-01,2,31,2,31,33
10303,MOJOCOYA,estado nutricional en menores de 5 anos,clasificacion d,2003-04-01,58,97,58,97,155
10501,MONTEAGUDO,estado nutricional en menores de 5 anos,clasificacion d,2003-04-01,132,200,132,200,332
71001,MONTERO,estado nutricional en menores de 5 anos,clasificacion d,2003-04-01,361,222,361,222,583
70803,MORO MORO,estado nutricional en menores de 5 anos,clasificacion d,2003-04-01,22,29,22,29,51
30302,MOROCHATA,estado nutricional en menores de 5 anos,clasificacion d,2003-04-01,156,174,156,174,330
90401,NACEBE (SANTA ROSA DEL ABUNA),estado nutricional en menores de 5 anos,clasificacion d,2003-04-01,3,7,3,7,10
20307,NAZACARA DE PACAJES,estado nutricional en menores de 5 anos,clasificacion d,2003-04-01,3,2,3,2,5
90501,NUEVO MANOA (NUEVA ESPERANZA),estado nutricional en menores de 5 anos,clasificacion d,2003-04-01,2,3,2,3,5
50404,OCURI,estado nutricional en menores de 5 anos,clasificacion d,2003-04-01,76,116,76,116,192
70202,OKINAWA,estado nutricional en menores de 5 anos,clasificacion d,2003-04-01,15,30,15,30,45
30203,OMEREQUE,estado nutricional en menores de 5 anos,clasificacion d,2003-04-01,15,17,15,17,32
40101,ORURO,estado nutricional en menores de 5 anos,clasificacion d,2003-04-01,563,702,563,702,1265
60201,PADCAYA,estado nutricional en menores de 5 anos,clasificacion d,2003-04-01,60,56,60,56,116
10401,PADILLA,estado nutricional en menores de 5 anos,clasificacion d,2003-04-01,126,221,126,221,347
70502,PAILON,estado nutricional en menores de 5 anos,clasificacion d,2003-04-01,26,28,26,28,54
20102,PALCA,estado nutricional en menores de 5 anos,clasificacion d,2003-04-01,44,49,44,49,93
21104,PALOS BLANCOS,estado nutricional en menores de 5 anos,clasificacion d,2003-04-01,68,113,68,113,181
40802,PAMPA AULLAGAS,estado nutricional en menores de 5 anos,clasificacion d,2003-04-01,11,19,11,19,30
70902,PAMPA GRANDE,estado nutricional en menores de 5 anos,clasificacion d,2003-04-01,14,12,14,12,26
21802,PAPEL PAMPA,estado nutricional en menores de 5 anos,clasificacion d,2003-04-01,14,13,14,13,27
30202,PASORAPA,estado nutricional en menores de 5 anos,clasificacion d,2003-04-01,15,26,15,26,41
21305,PATACAMAYA,estado nutricional en menores de 5 anos,clasificacion d,2003-04-01,107,52,107,52,159
40602,PAZÃ‘A,estado nutricional en menores de 5 anos,clasificacion d,2003-04-01,3,24,3,24,27
20702,PELECHUCO,estado nutricional en menores de 5 anos,clasificacion d,2003-04-01,34,37,34,37,71
50403,POCOATA,estado nutricional en menores de 5 anos,clasificacion d,2003-04-01,211,186,211,186,397
31203,POCONA,estado nutricional en menores de 5 anos,clasificacion d,2003-04-01,26,34,26,34,60
31202,POJO (CBBA),estado nutricional en menores de 5 anos,clasificacion d,2003-04-01,156,129,156,129,285
40601,POOPO,estado nutricional en menores de 5 anos,clasificacion d,2003-04-01,7,17,7,17,24
51203,PORCO,estado nutricional en menores de 5 anos,clasificacion d,2003-04-01,19,12,19,12,31
10103,POROMA,estado nutricional en menores de 5 anos,clasificacion d,2003-04-01,135,188,135,188,323
70103,PORONGO,estado nutricional en menores de 5 anos,clasificacion d,2003-04-01,18,20,18,20,38
70601,PORTACHUELO,estado nutricional en menores de 5 anos,clasificacion d,2003-04-01,62,47,62,47,109
90102,PORVENIR,estado nutricional en menores de 5 anos,clasificacion d,2003-04-01,15,10,15,10,25
70804,POSTRER VALLE,estado nutricional en menores de 5 anos,clasificacion d,2003-04-01,4,9,4,9,13
50101,POTOSI,estado nutricional en menores de 5 anos,clasificacion d,2003-04-01,728,482,728,482,1210
10302,PRESTO,estado nutricional en menores de 5 anos,clasificacion d,2003-04-01,67,105,67,105,172
70805,PUCARA,estado nutricional en menores de 5 anos,clasificacion d,2003-04-01,2,3,2,3,5
21201,PUCARANI,estado nutricional en menores de 5 anos,clasificacion d,2003-04-01,26,31,26,31,57
20401,PUERTO ACOSTA,estado nutricional en menores de 5 anos,clasificacion d,2003-04-01,74,58,74,58,132
20403,PUERTO CARABUCO,estado nutricional en menores de 5 anos,clasificacion d,2003-04-01,38,61,38,61,99
90301,PUERTO GONZALO MORENO,estado nutricional en menores de 5 anos,clasificacion d,2003-04-01,26,65,26,65,91
21204,PUERTO PEREZ,estado nutricional en menores de 5 anos,clasificacion d,2003-04-01,21,8,21,8,29
71402,PUERTO QUIJARRO,estado nutricional en menores de 5 anos,clasificacion d,2003-04-01,36,16,36,16,52
90201,PUERTO RICO,estado nutricional en menores de 5 anos,clasificacion d,2003-04-01,0,48,0,48,48
80703,PUERTO SILES,estado nutricional en menores de 5 anos,clasificacion d,2003-04-01,1,1,1,1,2
71401,PUERTO SUAREZ,estado nutricional en menores de 5 anos,clasificacion d,2003-04-01,39,26,39,26,65
31205,PUERTO VILLARROEL,estado nutricional en menores de 5 anos,clasificacion d,2003-04-01,248,183,248,183,431
51101,PUNA,estado nutricional en menores de 5 anos,clasificacion d,2003-04-01,75,109,75,109,184
31401,PUNATA,estado nutricional en menores de 5 anos,clasificacion d,2003-04-01,114,47,114,47,161
20604,QUIABAYA,estado nutricional en menores de 5 anos,clasificacion d,2003-04-01,13,26,13,26,39
30901,QUILLACOLLO,estado nutricional en menores de 5 anos,clasificacion d,2003-04-01,112,130,112,130,242
21002,QUIME,estado nutricional en menores de 5 anos,clasificacion d,2003-04-01,88,87,88,87,175
70904,QUIRUSILLAS,estado nutricional en menores de 5 anos,clasificacion d,2003-04-01,6,6,6,6,12
50402,RAVELO,estado nutricional en menores de 5 anos,clasificacion d,2003-04-01,163,197,163,197,360
80301,REYES,estado nutricional en menores de 5 anos,clasificacion d,2003-04-01,29,48,29,48,77
80201,RIBERALTA,estado nutricional en menores de 5 anos,clasificacion d,2003-04-01,340,276,340,276,616
70503,ROBORE,estado nutricional en menores de 5 anos,clasificacion d,2003-04-01,36,43,36,43,79
80304,RURRENABAQUE,estado nutricional en menores de 5 anos,clasificacion d,2003-04-01,14,5,14,5,19
40901,SABAYA,estado nutricional en menores de 5 anos,clasificacion d,2003-04-01,4,6,4,6,10
31001,SACABA,estado nutricional en menores de 5 anos,clasificacion d,2003-04-01,114,155,114,155,269
30404,SACABAMBA,estado nutricional en menores de 5 anos,clasificacion d,2003-04-01,1,17,1,17,18
50701,SACACA,estado nutricional en menores de 5 anos,clasificacion d,2003-04-01,170,349,170,349,519
71302,SAIPINA,estado nutricional en menores de 5 anos,clasificacion d,2003-04-01,6,17,6,17,23
40801,SALINAS DE GARCI MENDOZA,estado nutricional en menores de 5 anos,clasificacion d,2003-04-01,16,13,16,13,29
70901,SAMAIPATA,estado nutricional en menores de 5 anos,clasificacion d,2003-04-01,27,23,27,23,50
51601,SAN AGUSTIN,estado nutricional en menores de 5 anos,clasificacion d,2003-04-01,10,2,10,2,12
80602,SAN ANDRES,estado nutricional en menores de 5 anos,clasificacion d,2003-04-01,27,36,27,36,63
51003,SAN ANTONIO DE ESMORUCO,estado nutricional en menores de 5 anos,clasificacion d,2003-04-01,1,10,1,10,11
71105,SAN ANTONIO DE LOMERIO,estado nutricional en menores de 5 anos,clasificacion d,2003-04-01,69,95,69,95,164
31403,SAN BENITO,estado nutricional en menores de 5 anos,clasificacion d,2003-04-01,11,37,11,37,48
80302,SAN BORJA,estado nutricional en menores de 5 anos,clasificacion d,2003-04-01,154,110,154,110,264
21502,SAN BUENA VENTURA,estado nutricional en menores de 5 anos,clasificacion d,2003-04-01,37,32,37,32,69
70402,SAN CARLOS,estado nutricional en menores de 5 anos,clasificacion d,2003-04-01,48,80,48,80,128
80501,SAN IGNACIO,estado nutricional en menores de 5 anos,clasificacion d,2003-04-01,111,107,111,107,218
70301,SAN IGNACIO DE VELASCO,estado nutricional en menores de 5 anos,clasificacion d,2003-04-01,193,162,193,162,355
80102,SAN JAVIER(BNI),estado nutricional en menores de 5 anos,clasificacion d,2003-04-01,7,10,7,10,17
71102,SAN JAVIER(STC),estado nutricional en menores de 5 anos,clasificacion d,2003-04-01,35,51,35,51,86
80701,SAN JOAQUIN,estado nutricional en menores de 5 anos,clasificacion d,2003-04-01,4,9,4,9,13
70501,SAN JOSE DE CHIQUITOS,estado nutricional en menores de 5 anos,clasificacion d,2003-04-01,46,24,46,24,70
71104,SAN JULIAN,estado nutricional en menores de 5 anos,clasificacion d,2003-04-01,108,206,108,206,314
90302,SAN LORENZO(PND),estado nutricional en menores de 5 anos,clasificacion d,2003-04-01,7,6,7,6,13
60501,SAN LORENZO(TJA),estado nutricional en menores de 5 anos,clasificacion d,2003-04-01,60,101,60,101,161
10702,SAN LUCAS,estado nutricional en menores de 5 anos,clasificacion d,2003-04-01,351,375,351,375,726
70302,SAN MIGUEL DE VELASCO,estado nutricional en menores de 5 anos,clasificacion d,2003-04-01,58,77,58,77,135
51001,SAN PABLO DE LIPEZ,estado nutricional en menores de 5 anos,clasificacion d,2003-04-01,18,15,18,15,33
50501,SAN PEDRO DE BUENA VISTA,estado nutricional en menores de 5 anos,clasificacion d,2003-04-01,138,188,138,188,326
21801,SAN PEDRO DE CURAHUARA,estado nutricional en menores de 5 anos,clasificacion d,2003-04-01,13,11,13,11,24
50902,SAN PEDRO DE QUEMES,estado nutricional en menores de 5 anos,clasificacion d,2003-04-01,6,2,6,2,8
21702,SAN PEDRO DE TIQUINA,estado nutricional en menores de 5 anos,clasificacion d,2003-04-01,1,9,1,9,10
70303,SAN RAFAEL,estado nutricional en menores de 5 anos,clasificacion d,2003-04-01,18,32,18,32,50
80702,SAN RAMON,estado nutricional en menores de 5 anos,clasificacion d,2003-04-01,4,8,4,8,12
80401,SANTA ANA,estado nutricional en menores de 5 anos,clasificacion d,2003-04-01,1,5,1,5,6
70101,SANTA CRUZ DE LA SIERRA,estado nutricional en menores de 5 anos,clasificacion d,2003-04-01,993,636,993,636,1629
80303,SANTA ROSA,estado nutricional en menores de 5 anos,clasificacion d,2003-04-01,17,8,17,8,25
70602,SANTA ROSA DEL SARA,estado nutricional en menores de 5 anos,clasificacion d,2003-04-01,14,13,14,13,27
20308,SANTIAGO DE CALLAPA,estado nutricional en menores de 5 anos,clasificacion d,2003-04-01,15,19,15,19,34
41401,SANTIAGO DE HUARI,estado nutricional en menores de 5 anos,clasificacion d,2003-04-01,10,34,10,34,44
21901,SANTIAGO DE MACHACA,estado nutricional en menores de 5 anos,clasificacion d,2003-04-01,2,2,2,2,4
30702,SANTIVAÃ‘ES,estado nutricional en menores de 5 anos,clasificacion d,2003-04-01,16,11,16,11,27
40202,SANTUARIO DE QUILLACAS,estado nutricional en menores de 5 anos,clasificacion d,2003-04-01,10,14,10,14,24
20902,SAPAHAQUI,estado nutricional en menores de 5 anos,clasificacion d,2003-04-01,31,51,31,51,82
90303,SENA,estado nutricional en menores de 5 anos,clasificacion d,2003-04-01,7,6,7,6,13
21301,SICA SICA (VILLA AROMA),estado nutricional en menores de 5 anos,clasificacion d,2003-04-01,104,46,104,46,150
30703,SICAYA,estado nutricional en menores de 5 anos,clasificacion d,2003-04-01,24,14,24,14,38
30902,SIPE SIPE,estado nutricional en menores de 5 anos,clasificacion d,2003-04-01,123,114,123,114,237
10403,SOPACHUY,estado nutricional en menores de 5 anos,clasificacion d,2003-04-01,54,48,54,48,102
20601,SORATA,estado nutricional en menores de 5 anos,clasificacion d,2003-04-01,42,63,42,63,105
10101,SUCRE,estado nutricional en menores de 5 anos,clasificacion d,2003-04-01,558,673,558,673,1231
31404,TACACHI,estado nutricional en menores de 5 anos,clasificacion d,2003-04-01,7,3,7,3,10
20603,TACACOMA,estado nutricional en menores de 5 anos,clasificacion d,2003-04-01,16,26,16,26,42
50303,TACOBAMBA,estado nutricional en menores de 5 anos,clasificacion d,2003-04-01,51,77,51,77,128
30602,TACOPAYA,estado nutricional en menores de 5 anos,clasificacion d,2003-04-01,116,170,116,170,286
51402,TAHUA,estado nutricional en menores de 5 anos,clasificacion d,2003-04-01,2,0,2,0,2
31101,TAPACARI,estado nutricional en menores de 5 anos,clasificacion d,2003-04-01,96,137,96,137,233
10601,TARABUCO,estado nutricional en menores de 5 anos,clasificacion d,2003-04-01,288,465,288,465,753
30401,TARATA,estado nutricional en menores de 5 anos,clasificacion d,2003-04-01,31,168,31,168,199
60101,TARIJA,estado nutricional en menores de 5 anos,clasificacion d,2003-04-01,227,228,227,228,455
10202,TARVITA,estado nutricional en menores de 5 anos,clasificacion d,2003-04-01,116,213,116,213,329
20803,TIAWANACU,estado nutricional en menores de 5 anos,clasificacion d,2003-04-01,23,15,23,15,38
50102,TINGUIPAYA,estado nutricional en menores de 5 anos,clasificacion d,2003-04-01,28,32,28,32,60
20606,TIPUANI,estado nutricional en menores de 5 anos,clasificacion d,2003-04-01,14,13,14,13,27
30903,TIQUIPAYA,estado nutricional en menores de 5 anos,clasificacion d,2003-04-01,89,31,89,31,120
31601,TIRAQUE (CBBA),estado nutricional en menores de 5 anos,clasificacion d,2003-04-01,121,142,121,142,263
21703,TITO YUPANQUI (PARQUIPUJIO),estado nutricional en menores de 5 anos,clasificacion d,2003-04-01,7,0,7,0,7
30802,TOCO,estado nutricional en menores de 5 anos,clasificacion d,2003-04-01,9,11,9,11,20
30803,TOLATA,estado nutricional en menores de 5 anos,clasificacion d,2003-04-01,17,28,17,28,45
41001,TOLEDO,estado nutricional en menores de 5 anos,clasificacion d,2003-04-01,13,17,13,17,30
51202,TOMAVE,estado nutricional en menores de 5 anos,clasificacion d,2003-04-01,68,113,68,113,181
10402,TOMINA,estado nutricional en menores de 5 anos,clasificacion d,2003-04-01,116,222,116,222,338
50502,TORO TORO,estado nutricional en menores de 5 anos,clasificacion d,2003-04-01,74,70,74,70,144
31201,TOTORA(CBBA),estado nutricional en menores de 5 anos,clasificacion d,2003-04-01,52,38,52,38,90
41301,TOTORA(ORR),estado nutricional en menores de 5 anos,clasificacion d,2003-04-01,11,16,11,16,27
70802,TRIGAL,estado nutricional en menores de 5 anos,clasificacion d,2003-04-01,2,6,2,6,8
80101,TRINIDAD,estado nutricional en menores de 5 anos,clasificacion d,2003-04-01,145,252,145,252,397
50801,TUPIZA,estado nutricional en menores de 5 anos,clasificacion d,2003-04-01,129,430,129,430,559
40402,TURCO,estado nutricional en menores de 5 anos,clasificacion d,2003-04-01,9,16,9,16,25
21302,UMALA,estado nutricional en menores de 5 anos,clasificacion d,2003-04-01,4,4,4,4,8
50201,UNCIA,estado nutricional en menores de 5 anos,clasificacion d,2003-04-01,24,79,24,79,103
60401,URIONDO (A. CONCEPCION),estado nutricional en menores de 5 anos,clasificacion d,2003-04-01,30,29,30,29,59
71502,URUBICHA,estado nutricional en menores de 5 anos,clasificacion d,2003-04-01,98,176,98,176,274
51201,UYUNI,estado nutricional en menores de 5 anos,clasificacion d,2003-04-01,97,185,97,185,282
30502,VACAS,estado nutricional en menores de 5 anos,clasificacion d,2003-04-01,18,4,18,4,22
70801,VALLEGRANDE,estado nutricional en menores de 5 anos,clasificacion d,2003-04-01,67,69,67,69,136
20801,VIACHA,estado nutricional en menores de 5 anos,clasificacion d,2003-04-01,124,88,124,88,212
31302,VILA VILA,estado nutricional en menores de 5 anos,clasificacion d,2003-04-01,10,28,10,28,38
60303,VILLA MONTES,estado nutricional en menores de 5 anos,clasificacion d,2003-04-01,97,91,97,91,188
90502,VILLA NUEVA (LOMA ALTA),estado nutricional en menores de 5 anos,clasificacion d,2003-04-01,1,5,1,5,6
31402,VILLA RIVERO,estado nutricional en menores de 5 anos,clasificacion d,2003-04-01,17,12,17,12,29
10801,VILLA SERRANO,estado nutricional en menores de 5 anos,clasificacion d,2003-04-01,115,235,115,235,350
31003,VILLA TUNARI,estado nutricional en menores de 5 anos,clasificacion d,2003-04-01,126,109,126,109,235
11001,VILLA VACA GUZMAN (MUYUPAMPA),estado nutricional en menores de 5 anos,clasificacion d,2003-04-01,60,112,60,112,172
51501,VILLAZON,estado nutricional en menores de 5 anos,clasificacion d,2003-04-01,140,164,140,164,304
30904,VINTO,estado nutricional en menores de 5 anos,clasificacion d,2003-04-01,25,17,25,17,42
50602,VITICHI,estado nutricional en menores de 5 anos,clasificacion d,2003-04-01,93,152,93,152,245
20306,WALDO BALLIVIAN,estado nutricional en menores de 5 anos,clasificacion d,2003-04-01,5,3,5,3,8
70201,WARNES,estado nutricional en menores de 5 anos,clasificacion d,2003-04-01,92,68,92,68,160
20903,YACO,estado nutricional en menores de 5 anos,clasificacion d,2003-04-01,21,28,21,28,49
60301,YACUIBA,estado nutricional en menores de 5 anos,clasificacion d,2003-04-01,113,68,113,68,181
10602,YAMPARAEZ,estado nutricional en menores de 5 anos,clasificacion d,2003-04-01,149,274,149,274,423
21103,YANACACHI,estado nutricional en menores de 5 anos,clasificacion d,2003-04-01,6,14,6,14,20
70403,YAPACANI,estado nutricional en menores de 5 anos,clasificacion d,2003-04-01,161,141,161,141,302
50103,YOCALLA,estado nutricional en menores de 5 anos,clasificacion d,2003-04-01,19,27,19,27,46
10102,YOTALA,estado nutricional en menores de 5 anos,clasificacion d,2003-04-01,77,188,77,188,265
60402,YUNCHARA,estado nutricional en menores de 5 anos,clasificacion d,2003-04-01,35,60,35,60,95
10301,ZUDAÃ‘EZ,estado nutricional en menores de 5 anos,clasificacion d,2003-04-01,54,98,54,98,152
51302,ACACIO,estado nutricional en menores de 5 anos,clasificacion d,2003-05-01,62,126,62,126,188
20201,ACHACACHI,estado nutricional en menores de 5 anos,clasificacion d,2003-05-01,156,227,156,227,383
20104,ACHOCALLA,estado nutricional en menores de 5 anos,clasificacion d,2003-05-01,48,63,48,63,111
30201,AIQUILE,estado nutricional en menores de 5 anos,clasificacion d,2003-05-01,61,119,61,119,180
31303,ALALAY,estado nutricional en menores de 5 anos,clasificacion d,2003-05-01,15,12,15,12,27
10404,ALCALA,estado nutricional en menores de 5 anos,clasificacion d,2003-05-01,35,75,35,75,110
20202,ANCORAIMES,estado nutricional en menores de 5 anos,clasificacion d,2003-05-01,80,138,80,138,218
41201,ANDAMARCA,estado nutricional en menores de 5 anos,clasificacion d,2003-05-01,3,8,3,8,11
30402,ANZALDO,estado nutricional en menores de 5 anos,clasificacion d,2003-05-01,21,43,21,43,64
20701,APOLO,estado nutricional en menores de 5 anos,clasificacion d,2003-05-01,14,16,14,16,30
51301,ARAMPAMPA,estado nutricional en menores de 5 anos,clasificacion d,2003-05-01,39,111,39,111,150
30403,ARBIETO,estado nutricional en menores de 5 anos,clasificacion d,2003-05-01,7,5,7,5,12
30601,ARQUE,estado nutricional en menores de 5 anos,clasificacion d,2003-05-01,57,68,57,68,125
50802,ATOCHA,estado nutricional en menores de 5 anos,clasificacion d,2003-05-01,33,143,33,143,176
20503,AUCAPATA,estado nutricional en menores de 5 anos,clasificacion d,2003-05-01,32,45,32,45,77
20502,AYATA,estado nutricional en menores de 5 anos,clasificacion d,2003-05-01,31,12,31,12,43
21303,AYO AYO,estado nutricional en menores de 5 anos,clasificacion d,2003-05-01,8,22,8,22,30
30301,AYOPAYA (V. DE INDEPENDENCIA),estado nutricional en menores de 5 anos,clasificacion d,2003-05-01,83,140,83,140,223
10201,AZURDUY,estado nutricional en menores de 5 anos,clasificacion d,2003-05-01,130,206,130,206,336
21203,BATALLAS,estado nutricional en menores de 5 anos,clasificacion d,2003-05-01,30,48,30,48,78
80802,BAURES,estado nutricional en menores de 5 anos,clasificacion d,2003-05-01,16,37,16,37,53
41202,BELEN DE ANDAMARCA,estado nutricional en menores de 5 anos,clasificacion d,2003-05-01,2,4,2,4,6
50104,BELEN DE URMIRI,estado nutricional en menores de 5 anos,clasificacion d,2003-05-01,12,23,12,23,35
90104,BELLA FLOR,estado nutricional en menores de 5 anos,clasificacion d,2003-05-01,11,17,11,17,28
60202,BERMEJO,estado nutricional en menores de 5 anos,clasificacion d,2003-05-01,15,11,15,11,26
50301,BETANZOS,estado nutricional en menores de 5 anos,clasificacion d,2003-05-01,316,551,316,551,867
31501,BOLIVAR,estado nutricional en menores de 5 anos,clasificacion d,2003-05-01,86,153,86,153,239
90103,BOLPEBRA,estado nutricional en menores de 5 anos,clasificacion d,2003-05-01,12,7,12,7,19
70707,BOYUIBE,estado nutricional en menores de 5 anos,clasificacion d,2003-05-01,18,14,18,14,32
70401,BUENA VISTA,estado nutricional en menores de 5 anos,clasificacion d,2003-05-01,15,50,15,50,65
70703,CABEZAS,estado nutricional en menores de 5 anos,clasificacion d,2003-05-01,35,43,35,43,78
20905,CAIROMA,estado nutricional en menores de 5 anos,clasificacion d,2003-05-01,65,81,65,81,146
51102,"CAIZA ""D""",estado nutricional en menores de 5 anos,clasificacion d,2003-05-01,97,106,97,106,203
21003,CAJUATA,estado nutricional en menores de 5 anos,clasificacion d,2003-05-01,34,27,34,27,61
20303,CALACOTO,estado nutricional en menores de 5 anos,clasificacion d,2003-05-01,27,7,27,7,34
21304,CALAMARCA,estado nutricional en menores de 5 anos,clasificacion d,2003-05-01,100,77,100,77,177
10701,CAMARGO,estado nutricional en menores de 5 anos,clasificacion d,2003-05-01,111,157,111,157,268
10901,CAMATAQUI (C. VILLA ABECIA),estado nutricional en menores de 5 anos,clasificacion d,2003-05-01,17,37,17,37,54
70706,CAMIRI,estado nutricional en menores de 5 anos,clasificacion d,2003-05-01,120,103,120,103,223
30701,CAPINOTA,estado nutricional en menores de 5 anos,clasificacion d,2003-05-01,25,39,25,39,64
20302,CAQUIAVIRI,estado nutricional en menores de 5 anos,clasificacion d,2003-05-01,41,72,41,72,113
40102,CARACOLLO,estado nutricional en menores de 5 anos,clasificacion d,2003-05-01,43,54,43,54,97
22001,CARANAVI,estado nutricional en menores de 5 anos,clasificacion d,2003-05-01,189,176,189,176,365
60302,CARAPARI,estado nutricional en menores de 5 anos,clasificacion d,2003-05-01,22,38,22,38,60
50702,CARIPUYO,estado nutricional en menores de 5 anos,clasificacion d,2003-05-01,75,103,75,103,178
21902,CATACORA,estado nutricional en menores de 5 anos,clasificacion d,2003-05-01,8,12,8,12,20
40201,CHALLAPATA,estado nutricional en menores de 5 anos,clasificacion d,2003-05-01,84,144,84,144,228
50302,CHAQUI,estado nutricional en menores de 5 anos,clasificacion d,2003-05-01,67,85,67,85,152
70702,CHARAGUA,estado nutricional en menores de 5 anos,clasificacion d,2003-05-01,72,104,72,104,176
20305,CHARAÃ‘A,estado nutricional en menores de 5 anos,clasificacion d,2003-05-01,3,10,3,10,13
50202,CHAYANTA,estado nutricional en menores de 5 anos,clasificacion d,2003-05-01,58,89,58,89,147
31204,CHIMORE,estado nutricional en menores de 5 anos,clasificacion d,2003-05-01,11,18,11,18,29
40302,CHOQUE COTA,estado nutricional en menores de 5 anos,clasificacion d,2003-05-01,15,0,15,0,15
21101,CHULUMANI (V. DE LA LIBERTAD),estado nutricional en menores de 5 anos,clasificacion d,2003-05-01,7,17,7,17,24
20501,CHUMA,estado nutricional en menores de 5 anos,clasificacion d,2003-05-01,44,23,44,23,67
30801,CLIZA,estado nutricional en menores de 5 anos,clasificacion d,2003-05-01,16,10,16,10,26
90101,COBIJA,estado nutricional en menores de 5 anos,clasificacion d,2003-05-01,61,91,61,91,152
30101,COCHABAMBA,estado nutricional en menores de 5 anos,clasificacion d,2003-05-01,571,490,571,490,1061
30905,COLCAPIRHUA,estado nutricional en menores de 5 anos,clasificacion d,2003-05-01,2,8,2,8,10
50901,"COLCHA ""K""",estado nutricional en menores de 5 anos,clasificacion d,2003-05-01,59,98,59,98,157
21307,COLLANA,estado nutricional en menores de 5 anos,clasificacion d,2003-05-01,3,2,3,2,5
31002,COLOMI,estado nutricional en menores de 5 anos,clasificacion d,2003-05-01,116,62,116,62,178
50401,COLQUECHACA,estado nutricional en menores de 5 anos,clasificacion d,2003-05-01,133,80,133,80,213
21306,COLQUENCHA,estado nutricional en menores de 5 anos,clasificacion d,2003-05-01,20,22,20,22,42
21004,COLQUIRI,estado nutricional en menores de 5 anos,clasificacion d,2003-05-01,106,109,106,109,215
20304,COMANCHE,estado nutricional en menores de 5 anos,clasificacion d,2003-05-01,8,18,8,18,26
71301,COMARAPA,estado nutricional en menores de 5 anos,clasificacion d,2003-05-01,70,48,70,48,118
20605,COMBAYA,estado nutricional en menores de 5 anos,clasificacion d,2003-05-01,4,6,4,6,10
71101,CONCEPCION,estado nutricional en menores de 5 anos,clasificacion d,2003-05-01,27,9,27,9,36
21701,COPACABANA,estado nutricional en menores de 5 anos,clasificacion d,2003-05-01,29,29,29,29,58
21402,CORIPATA,estado nutricional en menores de 5 anos,clasificacion d,2003-05-01,9,2,9,2,11
20301,CORO CORO,estado nutricional en menores de 5 anos,clasificacion d,2003-05-01,29,35,29,35,64
21401,COROICO,estado nutricional en menores de 5 anos,clasificacion d,2003-05-01,33,29,33,29,62
40301,CORQUE,estado nutricional en menores de 5 anos,clasificacion d,2003-05-01,29,19,29,19,48
50601,COTAGAITA,estado nutricional en menores de 5 anos,clasificacion d,2003-05-01,156,299,156,299,455
70102,COTOCA,estado nutricional en menores de 5 anos,clasificacion d,2003-05-01,8,12,8,12,20
70704,CUEVO,estado nutricional en menores de 5 anos,clasificacion d,2003-05-01,7,22,7,22,29
10902,CULPINA,estado nutricional en menores de 5 anos,clasificacion d,2003-05-01,160,273,160,273,433
40401,CURAHUARA DE CARANGAS,estado nutricional en menores de 5 anos,clasificacion d,2003-05-01,7,40,7,40,47
21602,CURVA,estado nutricional en menores de 5 anos,clasificacion d,2003-05-01,37,28,37,28,65
20804,DESAGUADERO,estado nutricional en menores de 5 anos,clasificacion d,2003-05-01,4,9,4,9,13
20105,EL ALTO,estado nutricional en menores de 5 anos,clasificacion d,2003-05-01,2066,1540,2066,1540,3606
40103,EL CHORO,estado nutricional en menores de 5 anos,clasificacion d,2003-05-01,8,4,8,4,12
71503,EL PUENTE(STC),estado nutricional en menores de 5 anos,clasificacion d,2003-05-01,2,166,2,166,168
60502,EL PUENTE(TJA),estado nutricional en menores de 5 anos,clasificacion d,2003-05-01,82,192,82,192,274
70105,EL TORNO,estado nutricional en menores de 5 anos,clasificacion d,2003-05-01,58,64,58,64,122
10405,EL VILLAR,estado nutricional en menores de 5 anos,clasificacion d,2003-05-01,62,131,62,131,193
60601,ENTRE RIOS,estado nutricional en menores de 5 anos,clasificacion d,2003-05-01,17,46,17,46,63
40502,ESCARA,estado nutricional en menores de 5 anos,clasificacion d,2003-05-01,0,2,0,2,2
41101,EUCALIPTUS,estado nutricional en menores de 5 anos,clasificacion d,2003-05-01,3,8,3,8,11
80402,EXALTACION,estado nutricional en menores de 5 anos,clasificacion d,2003-05-01,0,75,0,75,75
90203,FILADELFIA,estado nutricional en menores de 5 anos,clasificacion d,2003-05-01,9,16,9,16,25
71002,GENERAL SAAVEDRA,estado nutricional en menores de 5 anos,clasificacion d,2003-05-01,102,118,102,118,220
21601,GRAL. J.J. PEREZ (CHARAZANI),estado nutricional en menores de 5 anos,clasificacion d,2003-05-01,34,36,34,36,70
20602,GUANAY,estado nutricional en menores de 5 anos,clasificacion d,2003-05-01,113,143,113,143,256
20802,GUAQUI,estado nutricional en menores de 5 anos,clasificacion d,2003-05-01,7,5,7,5,12
80202,GUAYARAMERIN,estado nutricional en menores de 5 anos,clasificacion d,2003-05-01,134,107,134,107,241
70705,GUTIERREZ,estado nutricional en menores de 5 anos,clasificacion d,2003-05-01,80,151,80,151,231
10502,HUACARETA,estado nutricional en menores de 5 anos,clasificacion d,2003-05-01,59,130,59,130,189
11002,HUACAYA (VILLA DE HUACAYA),estado nutricional en menores de 5 anos,clasificacion d,2003-05-01,21,24,21,24,45
40501,HUACHACALLA,estado nutricional en menores de 5 anos,clasificacion d,2003-05-01,1,0,1,0,1
40701,HUANUNI,estado nutricional en menores de 5 anos,clasificacion d,2003-05-01,68,50,68,50,118
80803,HUARACAJE,estado nutricional en menores de 5 anos,clasificacion d,2003-05-01,4,7,4,7,11
41601,HUAYLLAMARCA,estado nutricional en menores de 5 anos,clasificacion d,2003-05-01,15,23,15,23,38
21005,ICHOCA,estado nutricional en menores de 5 anos,clasificacion d,2003-05-01,27,53,27,53,80
10304,ICLA,estado nutricional en menores de 5 anos,clasificacion d,2003-05-01,125,252,125,252,377
10703,INCAHUASI,estado nutricional en menores de 5 anos,clasificacion d,2003-05-01,167,186,167,186,353
21001,INQUISIVI,estado nutricional en menores de 5 anos,clasificacion d,2003-05-01,111,175,111,175,286
21102,IRUPANA (VILLA DE LANZA),estado nutricional en menores de 5 anos,clasificacion d,2003-05-01,48,94,48,94,142
21501,IXIAMAS,estado nutricional en menores de 5 anos,clasificacion d,2003-05-01,40,24,40,24,64
21105,LA ASUNTA,estado nutricional en menores de 5 anos,clasificacion d,2003-05-01,32,42,32,42,74
70104,LA GUARDIA,estado nutricional en menores de 5 anos,clasificacion d,2003-05-01,59,33,59,33,92
20101,LA PAZ,estado nutricional en menores de 5 anos,clasificacion d,2003-05-01,1290,1114,1290,1114,2404
41501,LA RIVERA,estado nutricional en menores de 5 anos,clasificacion d,2003-05-01,0,1,0,1,1
70701,LAGUNILLAS,estado nutricional en menores de 5 anos,clasificacion d,2003-05-01,30,52,30,52,82
21202,LAJA,estado nutricional en menores de 5 anos,clasificacion d,2003-05-01,29,73,29,73,102
10903,LAS CARRERAS,estado nutricional en menores de 5 anos,clasificacion d,2003-05-01,19,61,19,61,80
21006,LICOMA PAMPA,estado nutricional en menores de 5 anos,clasificacion d,2003-05-01,28,82,28,82,110
50203,LLALLAGUA,estado nutricional en menores de 5 anos,clasificacion d,2003-05-01,12,345,12,345,357
51401,LLICA,estado nutricional en menores de 5 anos,clasificacion d,2003-05-01,11,23,11,23,34
80601,LORETO,estado nutricional en menores de 5 anos,clasificacion d,2003-05-01,7,16,7,16,23
20901,LURIBAY,estado nutricional en menores de 5 anos,clasificacion d,2003-05-01,50,38,50,38,88
40702,MACHACAMARCA,estado nutricional en menores de 5 anos,clasificacion d,2003-05-01,9,9,9,9,18
11003,MACHARETI,estado nutricional en menores de 5 anos,clasificacion d,2003-05-01,37,93,37,93,130
80801,MAGDALENA,estado nutricional en menores de 5 anos,clasificacion d,2003-05-01,40,77,40,77,117
70903,MAIRANA,estado nutricional en menores de 5 anos,clasificacion d,2003-05-01,28,22,28,22,50
20904,MALLA,estado nutricional en menores de 5 anos,clasificacion d,2003-05-01,2,3,2,3,5
20103,MECAPACA,estado nutricional en menores de 5 anos,clasificacion d,2003-05-01,20,21,20,21,41
71003,MINEROS,estado nutricional en menores de 5 anos,clasificacion d,2003-05-01,101,81,101,81,182
31301,MIZQUE,estado nutricional en menores de 5 anos,clasificacion d,2003-05-01,56,102,56,102,158
20402,MOCOMOCO,estado nutricional en menores de 5 anos,clasificacion d,2003-05-01,71,101,71,101,172
51002,MOJINETE,estado nutricional en menores de 5 anos,clasificacion d,2003-05-01,7,21,7,21,28
10303,MOJOCOYA,estado nutricional en menores de 5 anos,clasificacion d,2003-05-01,58,142,58,142,200
10501,MONTEAGUDO,estado nutricional en menores de 5 anos,clasificacion d,2003-05-01,136,241,136,241,377
71001,MONTERO,estado nutricional en menores de 5 anos,clasificacion d,2003-05-01,311,209,311,209,520
70803,MORO MORO,estado nutricional en menores de 5 anos,clasificacion d,2003-05-01,16,23,16,23,39
30302,MOROCHATA,estado nutricional en menores de 5 anos,clasificacion d,2003-05-01,195,247,195,247,442
90401,NACEBE (SANTA ROSA DEL ABUNA),estado nutricional en menores de 5 anos,clasificacion d,2003-05-01,4,8,4,8,12
20307,NAZACARA DE PACAJES,estado nutricional en menores de 5 anos,clasificacion d,2003-05-01,5,2,5,2,7
90501,NUEVO MANOA (NUEVA ESPERANZA),estado nutricional en menores de 5 anos,clasificacion d,2003-05-01,1,4,1,4,5
50404,OCURI,estado nutricional en menores de 5 anos,clasificacion d,2003-05-01,67,147,67,147,214
70202,OKINAWA,estado nutricional en menores de 5 anos,clasificacion d,2003-05-01,4,2,4,2,6
30203,OMEREQUE,estado nutricional en menores de 5 anos,clasificacion d,2003-05-01,11,23,11,23,34
40101,ORURO,estado nutricional en menores de 5 anos,clasificacion d,2003-05-01,523,623,523,623,1146
60201,PADCAYA,estado nutricional en menores de 5 anos,clasificacion d,2003-05-01,75,118,75,118,193
10401,PADILLA,estado nutricional en menores de 5 anos,clasificacion d,2003-05-01,110,252,110,252,362
70502,PAILON,estado nutricional en menores de 5 anos,clasificacion d,2003-05-01,20,11,20,11,31
20102,PALCA,estado nutricional en menores de 5 anos,clasificacion d,2003-05-01,64,94,64,94,158
21104,PALOS BLANCOS,estado nutricional en menores de 5 anos,clasificacion d,2003-05-01,97,204,97,204,301
40802,PAMPA AULLAGAS,estado nutricional en menores de 5 anos,clasificacion d,2003-05-01,10,15,10,15,25
70902,PAMPA GRANDE,estado nutricional en menores de 5 anos,clasificacion d,2003-05-01,18,20,18,20,38
21802,PAPEL PAMPA,estado nutricional en menores de 5 anos,clasificacion d,2003-05-01,9,21,9,21,30
30202,PASORAPA,estado nutricional en menores de 5 anos,clasificacion d,2003-05-01,18,37,18,37,55
21305,PATACAMAYA,estado nutricional en menores de 5 anos,clasificacion d,2003-05-01,73,19,73,19,92
40602,PAZÃ‘A,estado nutricional en menores de 5 anos,clasificacion d,2003-05-01,6,11,6,11,17
20702,PELECHUCO,estado nutricional en menores de 5 anos,clasificacion d,2003-05-01,46,47,46,47,93
50403,POCOATA,estado nutricional en menores de 5 anos,clasificacion d,2003-05-01,193,314,193,314,507
31203,POCONA,estado nutricional en menores de 5 anos,clasificacion d,2003-05-01,47,74,47,74,121
31202,POJO (CBBA),estado nutricional en menores de 5 anos,clasificacion d,2003-05-01,138,171,138,171,309
40601,POOPO,estado nutricional en menores de 5 anos,clasificacion d,2003-05-01,8,27,8,27,35
51203,PORCO,estado nutricional en menores de 5 anos,clasificacion d,2003-05-01,12,17,12,17,29
10103,POROMA,estado nutricional en menores de 5 anos,clasificacion d,2003-05-01,130,268,130,268,398
70103,PORONGO,estado nutricional en menores de 5 anos,clasificacion d,2003-05-01,23,23,23,23,46
70601,PORTACHUELO,estado nutricional en menores de 5 anos,clasificacion d,2003-05-01,43,26,43,26,69
90102,PORVENIR,estado nutricional en menores de 5 anos,clasificacion d,2003-05-01,11,13,11,13,24
70804,POSTRER VALLE,estado nutricional en menores de 5 anos,clasificacion d,2003-05-01,6,10,6,10,16
50101,POTOSI,estado nutricional en menores de 5 anos,clasificacion d,2003-05-01,638,552,638,552,1190
10302,PRESTO,estado nutricional en menores de 5 anos,clasificacion d,2003-05-01,105,168,105,168,273
70805,PUCARA,estado nutricional en menores de 5 anos,clasificacion d,2003-05-01,3,12,3,12,15
21201,PUCARANI,estado nutricional en menores de 5 anos,clasificacion d,2003-05-01,56,32,56,32,88
20401,PUERTO ACOSTA,estado nutricional en menores de 5 anos,clasificacion d,2003-05-01,104,187,104,187,291
20403,PUERTO CARABUCO,estado nutricional en menores de 5 anos,clasificacion d,2003-05-01,59,132,59,132,191
90301,PUERTO GONZALO MORENO,estado nutricional en menores de 5 anos,clasificacion d,2003-05-01,12,8,12,8,20
21204,PUERTO PEREZ,estado nutricional en menores de 5 anos,clasificacion d,2003-05-01,24,14,24,14,38
71402,PUERTO QUIJARRO,estado nutricional en menores de 5 anos,clasificacion d,2003-05-01,40,13,40,13,53
90201,PUERTO RICO,estado nutricional en menores de 5 anos,clasificacion d,2003-05-01,30,23,30,23,53
80703,PUERTO SILES,estado nutricional en menores de 5 anos,clasificacion d,2003-05-01,4,6,4,6,10
71401,PUERTO SUAREZ,estado nutricional en menores de 5 anos,clasificacion d,2003-05-01,31,9,31,9,40
31205,PUERTO VILLARROEL,estado nutricional en menores de 5 anos,clasificacion d,2003-05-01,167,154,167,154,321
51101,PUNA,estado nutricional en menores de 5 anos,clasificacion d,2003-05-01,237,391,237,391,628
20604,QUIABAYA,estado nutricional en menores de 5 anos,clasificacion d,2003-05-01,13,30,13,30,43
30901,QUILLACOLLO,estado nutricional en menores de 5 anos,clasificacion d,2003-05-01,116,137,116,137,253
21002,QUIME,estado nutricional en menores de 5 anos,clasificacion d,2003-05-01,91,131,91,131,222
70904,QUIRUSILLAS,estado nutricional en menores de 5 anos,clasificacion d,2003-05-01,4,0,4,0,4
50402,RAVELO,estado nutricional en menores de 5 anos,clasificacion d,2003-05-01,148,200,148,200,348
80301,REYES,estado nutricional en menores de 5 anos,clasificacion d,2003-05-01,51,82,51,82,133
80201,RIBERALTA,estado nutricional en menores de 5 anos,clasificacion d,2003-05-01,294,224,294,224,518
70503,ROBORE,estado nutricional en menores de 5 anos,clasificacion d,2003-05-01,40,37,40,37,77
80304,RURRENABAQUE,estado nutricional en menores de 5 anos,clasificacion d,2003-05-01,34,24,34,24,58
40901,SABAYA,estado nutricional en menores de 5 anos,clasificacion d,2003-05-01,2,9,2,9,11
31001,SACABA,estado nutricional en menores de 5 anos,clasificacion d,2003-05-01,148,193,148,193,341
30404,SACABAMBA,estado nutricional en menores de 5 anos,clasificacion d,2003-05-01,14,5,14,5,19
50701,SACACA,estado nutricional en menores de 5 anos,clasificacion d,2003-05-01,202,408,202,408,610
71302,SAIPINA,estado nutricional en menores de 5 anos,clasificacion d,2003-05-01,10,12,10,12,22
40801,SALINAS DE GARCI MENDOZA,estado nutricional en menores de 5 anos,clasificacion d,2003-05-01,11,18,11,18,29
70901,SAMAIPATA,estado nutricional en menores de 5 anos,clasificacion d,2003-05-01,27,15,27,15,42
51601,SAN AGUSTIN,estado nutricional en menores de 5 anos,clasificacion d,2003-05-01,10,13,10,13,23
80602,SAN ANDRES,estado nutricional en menores de 5 anos,clasificacion d,2003-05-01,12,8,12,8,20
51003,SAN ANTONIO DE ESMORUCO,estado nutricional en menores de 5 anos,clasificacion d,2003-05-01,5,15,5,15,20
71105,SAN ANTONIO DE LOMERIO,estado nutricional en menores de 5 anos,clasificacion d,2003-05-01,60,87,60,87,147
80302,SAN BORJA,estado nutricional en menores de 5 anos,clasificacion d,2003-05-01,188,202,188,202,390
21502,SAN BUENA VENTURA,estado nutricional en menores de 5 anos,clasificacion d,2003-05-01,32,22,32,22,54
70402,SAN CARLOS,estado nutricional en menores de 5 anos,clasificacion d,2003-05-01,82,48,82,48,130
80501,SAN IGNACIO,estado nutricional en menores de 5 anos,clasificacion d,2003-05-01,76,89,76,89,165
70301,SAN IGNACIO DE VELASCO,estado nutricional en menores de 5 anos,clasificacion d,2003-05-01,230,246,230,246,476
80102,SAN JAVIER(BNI),estado nutricional en menores de 5 anos,clasificacion d,2003-05-01,7,15,7,15,22
71102,SAN JAVIER(STC),estado nutricional en menores de 5 anos,clasificacion d,2003-05-01,17,42,17,42,59
80701,SAN JOAQUIN,estado nutricional en menores de 5 anos,clasificacion d,2003-05-01,7,11,7,11,18
70501,SAN JOSE DE CHIQUITOS,estado nutricional en menores de 5 anos,clasificacion d,2003-05-01,25,18,25,18,43
71104,SAN JULIAN,estado nutricional en menores de 5 anos,clasificacion d,2003-05-01,168,293,168,293,461
90302,SAN LORENZO(PND),estado nutricional en menores de 5 anos,clasificacion d,2003-05-01,12,5,12,5,17
60501,SAN LORENZO(TJA),estado nutricional en menores de 5 anos,clasificacion d,2003-05-01,41,87,41,87,128
10702,SAN LUCAS,estado nutricional en menores de 5 anos,clasificacion d,2003-05-01,411,597,411,597,1008
70302,SAN MIGUEL DE VELASCO,estado nutricional en menores de 5 anos,clasificacion d,2003-05-01,70,94,70,94,164
51001,SAN PABLO DE LIPEZ,estado nutricional en menores de 5 anos,clasificacion d,2003-05-01,15,37,15,37,52
50501,SAN PEDRO DE BUENA VISTA,estado nutricional en menores de 5 anos,clasificacion d,2003-05-01,161,279,161,279,440
21801,SAN PEDRO DE CURAHUARA,estado nutricional en menores de 5 anos,clasificacion d,2003-05-01,6,11,6,11,17
50902,SAN PEDRO DE QUEMES,estado nutricional en menores de 5 anos,clasificacion d,2003-05-01,2,4,2,4,6
21702,SAN PEDRO DE TIQUINA,estado nutricional en menores de 5 anos,clasificacion d,2003-05-01,7,17,7,17,24
70303,SAN RAFAEL,estado nutricional en menores de 5 anos,clasificacion d,2003-05-01,19,51,19,51,70
80702,SAN RAMON,estado nutricional en menores de 5 anos,clasificacion d,2003-05-01,4,5,4,5,9
80702,SAN RAMON,estado nutricional en menores de 5 anos,clasificacion d,2003-05-01,2,16,2,16,18
80401,SANTA ANA,estado nutricional en menores de 5 anos,clasificacion d,2003-05-01,0,19,0,19,19
70101,SANTA CRUZ DE LA SIERRA,estado nutricional en menores de 5 anos,clasificacion d,2003-05-01,294,163,294,163,457
80303,SANTA ROSA,estado nutricional en menores de 5 anos,clasificacion d,2003-05-01,8,18,8,18,26
70602,SANTA ROSA DEL SARA,estado nutricional en menores de 5 anos,clasificacion d,2003-05-01,6,9,6,9,15
20308,SANTIAGO DE CALLAPA,estado nutricional en menores de 5 anos,clasificacion d,2003-05-01,36,86,36,86,122
41401,SANTIAGO DE HUARI,estado nutricional en menores de 5 anos,clasificacion d,2003-05-01,10,21,10,21,31
21901,SANTIAGO DE MACHACA,estado nutricional en menores de 5 anos,clasificacion d,2003-05-01,17,24,17,24,41
30702,SANTIVAÃ‘ES,estado nutricional en menores de 5 anos,clasificacion d,2003-05-01,31,15,31,15,46
40202,SANTUARIO DE QUILLACAS,estado nutricional en menores de 5 anos,clasificacion d,2003-05-01,6,11,6,11,17
20902,SAPAHAQUI,estado nutricional en menores de 5 anos,clasificacion d,2003-05-01,29,41,29,41,70
90303,SENA,estado nutricional en menores de 5 anos,clasificacion d,2003-05-01,7,4,7,4,11
21301,SICA SICA (VILLA AROMA),estado nutricional en menores de 5 anos,clasificacion d,2003-05-01,86,73,86,73,159
30703,SICAYA,estado nutricional en menores de 5 anos,clasificacion d,2003-05-01,8,7,8,7,15
30902,SIPE SIPE,estado nutricional en menores de 5 anos,clasificacion d,2003-05-01,114,87,114,87,201
10403,SOPACHUY,estado nutricional en menores de 5 anos,clasificacion d,2003-05-01,43,98,43,98,141
20601,SORATA,estado nutricional en menores de 5 anos,clasificacion d,2003-05-01,59,114,59,114,173
10101,SUCRE,estado nutricional en menores de 5 anos,clasificacion d,2003-05-01,520,727,520,727,1247
20603,TACACOMA,estado nutricional en menores de 5 anos,clasificacion d,2003-05-01,14,28,14,28,42
50303,TACOBAMBA,estado nutricional en menores de 5 anos,clasificacion d,2003-05-01,84,112,84,112,196
30602,TACOPAYA,estado nutricional en menores de 5 anos,clasificacion d,2003-05-01,103,127,103,127,230
51402,TAHUA,estado nutricional en menores de 5 anos,clasificacion d,2003-05-01,10,6,10,6,16
31101,TAPACARI,estado nutricional en menores de 5 anos,clasificacion d,2003-05-01,173,184,173,184,357
10601,TARABUCO,estado nutricional en menores de 5 anos,clasificacion d,2003-05-01,331,513,331,513,844
30401,TARATA,estado nutricional en menores de 5 anos,clasificacion d,2003-05-01,10,263,10,263,273
60101,TARIJA,estado nutricional en menores de 5 anos,clasificacion d,2003-05-01,262,275,262,275,537
10202,TARVITA,estado nutricional en menores de 5 anos,clasificacion d,2003-05-01,140,227,140,227,367
20803,TIAWANACU,estado nutricional en menores de 5 anos,clasificacion d,2003-05-01,28,34,28,34,62
50102,TINGUIPAYA,estado nutricional en menores de 5 anos,clasificacion d,2003-05-01,81,215,81,215,296
20606,TIPUANI,estado nutricional en menores de 5 anos,clasificacion d,2003-05-01,18,13,18,13,31
30903,TIQUIPAYA,estado nutricional en menores de 5 anos,clasificacion d,2003-05-01,111,56,111,56,167
31601,TIRAQUE (CBBA),estado nutricional en menores de 5 anos,clasificacion d,2003-05-01,62,60,62,60,122
21703,TITO YUPANQUI (PARQUIPUJIO),estado nutricional en menores de 5 anos,clasificacion d,2003-05-01,4,18,4,18,22
30802,TOCO,estado nutricional en menores de 5 anos,clasificacion d,2003-05-01,12,11,12,11,23
41502,TODOS SANTOS,estado nutricional en menores de 5 anos,clasificacion d,2003-05-01,0,1,0,1,1
30803,TOLATA,estado nutricional en menores de 5 anos,clasificacion d,2003-05-01,16,22,16,22,38
41001,TOLEDO,estado nutricional en menores de 5 anos,clasificacion d,2003-05-01,5,6,5,6,11
51202,TOMAVE,estado nutricional en menores de 5 anos,clasificacion d,2003-05-01,65,130,65,130,195
10402,TOMINA,estado nutricional en menores de 5 anos,clasificacion d,2003-05-01,120,274,120,274,394
50502,TORO TORO,estado nutricional en menores de 5 anos,clasificacion d,2003-05-01,106,143,106,143,249
31201,TOTORA(CBBA),estado nutricional en menores de 5 anos,clasificacion d,2003-05-01,58,44,58,44,102
41301,TOTORA(ORR),estado nutricional en menores de 5 anos,clasificacion d,2003-05-01,28,39,28,39,67
70802,TRIGAL,estado nutricional en menores de 5 anos,clasificacion d,2003-05-01,6,3,6,3,9
80101,TRINIDAD,estado nutricional en menores de 5 anos,clasificacion d,2003-05-01,100,154,100,154,254
50801,TUPIZA,estado nutricional en menores de 5 anos,clasificacion d,2003-05-01,100,454,100,454,554
40402,TURCO,estado nutricional en menores de 5 anos,clasificacion d,2003-05-01,8,16,8,16,24
21302,UMALA,estado nutricional en menores de 5 anos,clasificacion d,2003-05-01,7,6,7,6,13
50201,UNCIA,estado nutricional en menores de 5 anos,clasificacion d,2003-05-01,52,44,52,44,96
60401,URIONDO (A. CONCEPCION),estado nutricional en menores de 5 anos,clasificacion d,2003-05-01,20,28,20,28,48
71502,URUBICHA,estado nutricional en menores de 5 anos,clasificacion d,2003-05-01,8,6,8,6,14
51201,UYUNI,estado nutricional en menores de 5 anos,clasificacion d,2003-05-01,86,145,86,145,231
70801,VALLEGRANDE,estado nutricional en menores de 5 anos,clasificacion d,2003-05-01,81,81,81,81,162
20801,VIACHA,estado nutricional en menores de 5 anos,clasificacion d,2003-05-01,145,190,145,190,335
31302,VILA VILA,estado nutricional en menores de 5 anos,clasificacion d,2003-05-01,43,73,43,73,116
60303,VILLA MONTES,estado nutricional en menores de 5 anos,clasificacion d,2003-05-01,65,61,65,61,126
10801,VILLA SERRANO,estado nutricional en menores de 5 anos,clasificacion d,2003-05-01,137,264,137,264,401
31003,VILLA TUNARI,estado nutricional en menores de 5 anos,clasificacion d,2003-05-01,118,131,118,131,249
11001,VILLA VACA GUZMAN (MUYUPAMPA),estado nutricional en menores de 5 anos,clasificacion d,2003-05-01,50,108,50,108,158
51501,VILLAZON,estado nutricional en menores de 5 anos,clasificacion d,2003-05-01,102,113,102,113,215
50602,VITICHI,estado nutricional en menores de 5 anos,clasificacion d,2003-05-01,110,219,110,219,329
20306,WALDO BALLIVIAN,estado nutricional en menores de 5 anos,clasificacion d,2003-05-01,3,1,3,1,4
70201,WARNES,estado nutricional en menores de 5 anos,clasificacion d,2003-05-01,7,5,7,5,12
20903,YACO,estado nutricional en menores de 5 anos,clasificacion d,2003-05-01,20,41,20,41,61
60301,YACUIBA,estado nutricional en menores de 5 anos,clasificacion d,2003-05-01,83,83,83,83,166
10602,YAMPARAEZ,estado nutricional en menores de 5 anos,clasificacion d,2003-05-01,153,301,153,301,454
21103,YANACACHI,estado nutricional en menores de 5 anos,clasificacion d,2003-05-01,17,29,17,29,46
70403,YAPACANI,estado nutricional en menores de 5 anos,clasificacion d,2003-05-01,102,172,102,172,274
50103,YOCALLA,estado nutricional en menores de 5 anos,clasificacion d,2003-05-01,28,69,28,69,97
10102,YOTALA,estado nutricional en menores de 5 anos,clasificacion d,2003-05-01,88,201,88,201,289
60402,YUNCHARA,estado nutricional en menores de 5 anos,clasificacion d,2003-05-01,23,30,23,30,53
10301,ZUDAÃ‘EZ,estado nutricional en menores de 5 anos,clasificacion d,2003-05-01,76,137,76,137,213
51302,ACACIO,estado nutricional en menores de 5 anos,clasificacion d,2003-06-01,54,130,54,130,184
20201,ACHACACHI,estado nutricional en menores de 5 anos,clasificacion d,2003-06-01,94,152,94,152,246
20104,ACHOCALLA,estado nutricional en menores de 5 anos,clasificacion d,2003-06-01,22,33,22,33,55
30201,AIQUILE,estado nutricional en menores de 5 anos,clasificacion d,2003-06-01,47,60,47,60,107
31303,ALALAY,estado nutricional en menores de 5 anos,clasificacion d,2003-06-01,9,15,9,15,24
10404,ALCALA,estado nutricional en menores de 5 anos,clasificacion d,2003-06-01,33,65,33,65,98
20202,ANCORAIMES,estado nutricional en menores de 5 anos,clasificacion d,2003-06-01,56,85,56,85,141
41201,ANDAMARCA,estado nutricional en menores de 5 anos,clasificacion d,2003-06-01,12,21,12,21,33
30402,ANZALDO,estado nutricional en menores de 5 anos,clasificacion d,2003-06-01,17,64,17,64,81
20701,APOLO,estado nutricional en menores de 5 anos,clasificacion d,2003-06-01,24,35,24,35,59
51301,ARAMPAMPA,estado nutricional en menores de 5 anos,clasificacion d,2003-06-01,47,121,47,121,168
30501,ARANI,estado nutricional en menores de 5 anos,clasificacion d,2003-06-01,10,33,10,33,43
30403,ARBIETO,estado nutricional en menores de 5 anos,clasificacion d,2003-06-01,10,6,10,6,16
30601,ARQUE,estado nutricional en menores de 5 anos,clasificacion d,2003-06-01,50,63,50,63,113
71501,ASCENCION DE GUARAYOS,estado nutricional en menores de 5 anos,clasificacion d,2003-06-01,179,266,179,266,445
50802,ATOCHA,estado nutricional en menores de 5 anos,clasificacion d,2003-06-01,12,103,12,103,115
20503,AUCAPATA,estado nutricional en menores de 5 anos,clasificacion d,2003-06-01,40,66,40,66,106
20502,AYATA,estado nutricional en menores de 5 anos,clasificacion d,2003-06-01,28,17,28,17,45
21303,AYO AYO,estado nutricional en menores de 5 anos,clasificacion d,2003-06-01,26,21,26,21,47
30301,AYOPAYA (V. DE INDEPENDENCIA),estado nutricional en menores de 5 anos,clasificacion d,2003-06-01,56,93,56,93,149
10201,AZURDUY,estado nutricional en menores de 5 anos,clasificacion d,2003-06-01,109,227,109,227,336
21203,BATALLAS,estado nutricional en menores de 5 anos,clasificacion d,2003-06-01,31,53,31,53,84
80802,BAURES,estado nutricional en menores de 5 anos,clasificacion d,2003-06-01,25,21,25,21,46
41202,BELEN DE ANDAMARCA,estado nutricional en menores de 5 anos,clasificacion d,2003-06-01,3,5,3,5,8
50104,BELEN DE URMIRI,estado nutricional en menores de 5 anos,clasificacion d,2003-06-01,10,19,10,19,29
90104,BELLA FLOR,estado nutricional en menores de 5 anos,clasificacion d,2003-06-01,23,30,23,30,53
60202,BERMEJO,estado nutricional en menores de 5 anos,clasificacion d,2003-06-01,11,14,11,14,25
50301,BETANZOS,estado nutricional en menores de 5 anos,clasificacion d,2003-06-01,197,215,197,215,412
31501,BOLIVAR,estado nutricional en menores de 5 anos,clasificacion d,2003-06-01,61,67,61,67,128
90103,BOLPEBRA,estado nutricional en menores de 5 anos,clasificacion d,2003-06-01,11,25,11,25,36
70707,BOYUIBE,estado nutricional en menores de 5 anos,clasificacion d,2003-06-01,13,20,13,20,33
70401,BUENA VISTA,estado nutricional en menores de 5 anos,clasificacion d,2003-06-01,38,54,38,54,92
70703,CABEZAS,estado nutricional en menores de 5 anos,clasificacion d,2003-06-01,27,43,27,43,70
20905,CAIROMA,estado nutricional en menores de 5 anos,clasificacion d,2003-06-01,67,77,67,77,144
51102,"CAIZA ""D""",estado nutricional en menores de 5 anos,clasificacion d,2003-06-01,50,70,50,70,120
21003,CAJUATA,estado nutricional en menores de 5 anos,clasificacion d,2003-06-01,19,26,19,26,45
20303,CALACOTO,estado nutricional en menores de 5 anos,clasificacion d,2003-06-01,12,8,12,8,20
21304,CALAMARCA,estado nutricional en menores de 5 anos,clasificacion d,2003-06-01,158,138,158,138,296
10701,CAMARGO,estado nutricional en menores de 5 anos,clasificacion d,2003-06-01,95,130,95,130,225
10901,CAMATAQUI (C. VILLA ABECIA),estado nutricional en menores de 5 anos,clasificacion d,2003-06-01,20,24,20,24,44
70706,CAMIRI,estado nutricional en menores de 5 anos,clasificacion d,2003-06-01,97,78,97,78,175
30701,CAPINOTA,estado nutricional en menores de 5 anos,clasificacion d,2003-06-01,21,37,21,37,58
20302,CAQUIAVIRI,estado nutricional en menores de 5 anos,clasificacion d,2003-06-01,27,48,27,48,75
40102,CARACOLLO,estado nutricional en menores de 5 anos,clasificacion d,2003-06-01,53,55,53,55,108
22001,CARANAVI,estado nutricional en menores de 5 anos,clasificacion d,2003-06-01,118,135,118,135,253
41503,CARANGAS,estado nutricional en menores de 5 anos,clasificacion d,2003-06-01,0,2,0,2,2
60302,CARAPARI,estado nutricional en menores de 5 anos,clasificacion d,2003-06-01,18,39,18,39,57
50702,CARIPUYO,estado nutricional en menores de 5 anos,clasificacion d,2003-06-01,82,166,82,166,248
40201,CHALLAPATA,estado nutricional en menores de 5 anos,clasificacion d,2003-06-01,71,99,71,99,170
50302,CHAQUI,estado nutricional en menores de 5 anos,clasificacion d,2003-06-01,50,65,50,65,115
70702,CHARAGUA,estado nutricional en menores de 5 anos,clasificacion d,2003-06-01,66,96,66,96,162
20305,CHARAÃ‘A,estado nutricional en menores de 5 anos,clasificacion d,2003-06-01,4,2,4,2,6
50202,CHAYANTA,estado nutricional en menores de 5 anos,clasificacion d,2003-06-01,53,92,53,92,145
31204,CHIMORE,estado nutricional en menores de 5 anos,clasificacion d,2003-06-01,23,17,23,17,40
40302,CHOQUE COTA,estado nutricional en menores de 5 anos,clasificacion d,2003-06-01,9,11,9,11,20
21101,CHULUMANI (V. DE LA LIBERTAD),estado nutricional en menores de 5 anos,clasificacion d,2003-06-01,3,17,3,17,20
20501,CHUMA,estado nutricional en menores de 5 anos,clasificacion d,2003-06-01,26,48,26,48,74
30801,CLIZA,estado nutricional en menores de 5 anos,clasificacion d,2003-06-01,12,18,12,18,30
90101,COBIJA,estado nutricional en menores de 5 anos,clasificacion d,2003-06-01,67,68,67,68,135
30101,COCHABAMBA,estado nutricional en menores de 5 anos,clasificacion d,2003-06-01,516,422,516,422,938
40902,COIPASA,estado nutricional en menores de 5 anos,clasificacion d,2003-06-01,0,1,0,1,1
30905,COLCAPIRHUA,estado nutricional en menores de 5 anos,clasificacion d,2003-06-01,20,18,20,18,38
50901,"COLCHA ""K""",estado nutricional en menores de 5 anos,clasificacion d,2003-06-01,45,53,45,53,98
21307,COLLANA,estado nutricional en menores de 5 anos,clasificacion d,2003-06-01,2,1,2,1,3
31002,COLOMI,estado nutricional en menores de 5 anos,clasificacion d,2003-06-01,58,58,58,58,116
50401,COLQUECHACA,estado nutricional en menores de 5 anos,clasificacion d,2003-06-01,218,131,218,131,349
21306,COLQUENCHA,estado nutricional en menores de 5 anos,clasificacion d,2003-06-01,19,18,19,18,37
21004,COLQUIRI,estado nutricional en menores de 5 anos,clasificacion d,2003-06-01,81,86,81,86,167
20304,COMANCHE,estado nutricional en menores de 5 anos,clasificacion d,2003-06-01,5,5,5,5,10
71301,COMARAPA,estado nutricional en menores de 5 anos,clasificacion d,2003-06-01,36,33,36,33,69
20605,COMBAYA,estado nutricional en menores de 5 anos,clasificacion d,2003-06-01,11,18,11,18,29
71101,CONCEPCION,estado nutricional en menores de 5 anos,clasificacion d,2003-06-01,1,28,1,28,29
21701,COPACABANA,estado nutricional en menores de 5 anos,clasificacion d,2003-06-01,50,25,50,25,75
21402,CORIPATA,estado nutricional en menores de 5 anos,clasificacion d,2003-06-01,5,0,5,0,5
20301,CORO CORO,estado nutricional en menores de 5 anos,clasificacion d,2003-06-01,25,29,25,29,54
21401,COROICO,estado nutricional en menores de 5 anos,clasificacion d,2003-06-01,26,34,26,34,60
40301,CORQUE,estado nutricional en menores de 5 anos,clasificacion d,2003-06-01,21,19,21,19,40
50601,COTAGAITA,estado nutricional en menores de 5 anos,clasificacion d,2003-06-01,154,288,154,288,442
70102,COTOCA,estado nutricional en menores de 5 anos,clasificacion d,2003-06-01,17,0,17,0,17
31405,CUCHUMUELA (V. G. VILLARROEL),estado nutricional en menores de 5 anos,clasificacion d,2003-06-01,5,9,5,9,14
70704,CUEVO,estado nutricional en menores de 5 anos,clasificacion d,2003-06-01,16,22,16,22,38
10902,CULPINA,estado nutricional en menores de 5 anos,clasificacion d,2003-06-01,183,203,183,203,386
40401,CURAHUARA DE CARANGAS,estado nutricional en menores de 5 anos,clasificacion d,2003-06-01,6,21,6,21,27
21602,CURVA,estado nutricional en menores de 5 anos,clasificacion d,2003-06-01,16,19,16,19,35
20804,DESAGUADERO,estado nutricional en menores de 5 anos,clasificacion d,2003-06-01,10,10,10,10,20
20105,EL ALTO,estado nutricional en menores de 5 anos,clasificacion d,2003-06-01,1760,1262,1760,1262,3022
40103,EL CHORO,estado nutricional en menores de 5 anos,clasificacion d,2003-06-01,2,7,2,7,9
71503,EL PUENTE(STC),estado nutricional en menores de 5 anos,clasificacion d,2003-06-01,13,98,13,98,111
60502,EL PUENTE(TJA),estado nutricional en menores de 5 anos,clasificacion d,2003-06-01,29,41,29,41,70
70105,EL TORNO,estado nutricional en menores de 5 anos,clasificacion d,2003-06-01,55,43,55,43,98
10405,EL VILLAR,estado nutricional en menores de 5 anos,clasificacion d,2003-06-01,36,122,36,122,158
60601,ENTRE RIOS,estado nutricional en menores de 5 anos,clasificacion d,2003-06-01,36,81,36,81,117
41101,EUCALIPTUS,estado nutricional en menores de 5 anos,clasificacion d,2003-06-01,27,40,27,40,67
90503,EUREKA (SANTOS MERCADO),estado nutricional en menores de 5 anos,clasificacion d,2003-06-01,0,2,0,2,2
80402,EXALTACION,estado nutricional en menores de 5 anos,clasificacion d,2003-06-01,0,31,0,31,31
90203,FILADELFIA,estado nutricional en menores de 5 anos,clasificacion d,2003-06-01,5,12,5,12,17
71002,GENERAL SAAVEDRA,estado nutricional en menores de 5 anos,clasificacion d,2003-06-01,86,134,86,134,220
21601,GRAL. J.J. PEREZ (CHARAZANI),estado nutricional en menores de 5 anos,clasificacion d,2003-06-01,42,92,42,92,134
20602,GUANAY,estado nutricional en menores de 5 anos,clasificacion d,2003-06-01,119,123,119,123,242
20802,GUAQUI,estado nutricional en menores de 5 anos,clasificacion d,2003-06-01,13,7,13,7,20
80202,GUAYARAMERIN,estado nutricional en menores de 5 anos,clasificacion d,2003-06-01,146,114,146,114,260
70705,GUTIERREZ,estado nutricional en menores de 5 anos,clasificacion d,2003-06-01,108,187,108,187,295
10502,HUACARETA,estado nutricional en menores de 5 anos,clasificacion d,2003-06-01,35,46,35,46,81
11002,HUACAYA (VILLA DE HUACAYA),estado nutricional en menores de 5 anos,clasificacion d,2003-06-01,5,10,5,10,15
40501,HUACHACALLA,estado nutricional en menores de 5 anos,clasificacion d,2003-06-01,6,3,6,3,9
40701,HUANUNI,estado nutricional en menores de 5 anos,clasificacion d,2003-06-01,80,84,80,84,164
80803,HUARACAJE,estado nutricional en menores de 5 anos,clasificacion d,2003-06-01,2,2,2,2,4
41601,HUAYLLAMARCA,estado nutricional en menores de 5 anos,clasificacion d,2003-06-01,21,21,21,21,42
21005,ICHOCA,estado nutricional en menores de 5 anos,clasificacion d,2003-06-01,17,30,17,30,47
10304,ICLA,estado nutricional en menores de 5 anos,clasificacion d,2003-06-01,114,208,114,208,322
10703,INCAHUASI,estado nutricional en menores de 5 anos,clasificacion d,2003-06-01,125,131,125,131,256
90402,INGAVI (HUMAITA),estado nutricional en menores de 5 anos,clasificacion d,2003-06-01,0,2,0,2,2
21001,INQUISIVI,estado nutricional en menores de 5 anos,clasificacion d,2003-06-01,78,116,78,116,194
21102,IRUPANA (VILLA DE LANZA),estado nutricional en menores de 5 anos,clasificacion d,2003-06-01,43,63,43,63,106
21501,IXIAMAS,estado nutricional en menores de 5 anos,clasificacion d,2003-06-01,33,30,33,30,63
21105,LA ASUNTA,estado nutricional en menores de 5 anos,clasificacion d,2003-06-01,54,48,54,48,102
70104,LA GUARDIA,estado nutricional en menores de 5 anos,clasificacion d,2003-06-01,47,47,47,47,94
20101,LA PAZ,estado nutricional en menores de 5 anos,clasificacion d,2003-06-01,1350,1162,1350,1162,2512
41501,LA RIVERA,estado nutricional en menores de 5 anos,clasificacion d,2003-06-01,1,0,1,0,1
70701,LAGUNILLAS,estado nutricional en menores de 5 anos,clasificacion d,2003-06-01,23,24,23,24,47
21202,LAJA,estado nutricional en menores de 5 anos,clasificacion d,2003-06-01,27,37,27,37,64
10903,LAS CARRERAS,estado nutricional en menores de 5 anos,clasificacion d,2003-06-01,11,38,11,38,49
21006,LICOMA PAMPA,estado nutricional en menores de 5 anos,clasificacion d,2003-06-01,2,47,2,47,49
50203,LLALLAGUA,estado nutricional en menores de 5 anos,clasificacion d,2003-06-01,16,370,16,370,386
51401,LLICA,estado nutricional en menores de 5 anos,clasificacion d,2003-06-01,12,7,12,7,19
80601,LORETO,estado nutricional en menores de 5 anos,clasificacion d,2003-06-01,3,11,3,11,14
20901,LURIBAY,estado nutricional en menores de 5 anos,clasificacion d,2003-06-01,60,53,60,53,113
40702,MACHACAMARCA,estado nutricional en menores de 5 anos,clasificacion d,2003-06-01,23,21,23,21,44
11003,MACHARETI,estado nutricional en menores de 5 anos,clasificacion d,2003-06-01,30,65,30,65,95
80801,MAGDALENA,estado nutricional en menores de 5 anos,clasificacion d,2003-06-01,26,38,26,38,64
70903,MAIRANA,estado nutricional en menores de 5 anos,clasificacion d,2003-06-01,28,19,28,19,47
20904,MALLA,estado nutricional en menores de 5 anos,clasificacion d,2003-06-01,11,12,11,12,23
20103,MECAPACA,estado nutricional en menores de 5 anos,clasificacion d,2003-06-01,15,28,15,28,43
71003,MINEROS,estado nutricional en menores de 5 anos,clasificacion d,2003-06-01,135,72,135,72,207
31301,MIZQUE,estado nutricional en menores de 5 anos,clasificacion d,2003-06-01,21,50,21,50,71
20402,MOCOMOCO,estado nutricional en menores de 5 anos,clasificacion d,2003-06-01,41,91,41,91,132
51002,MOJINETE,estado nutricional en menores de 5 anos,clasificacion d,2003-06-01,5,11,5,11,16
10303,MOJOCOYA,estado nutricional en menores de 5 anos,clasificacion d,2003-06-01,65,102,65,102,167
10501,MONTEAGUDO,estado nutricional en menores de 5 anos,clasificacion d,2003-06-01,111,155,111,155,266
71001,MONTERO,estado nutricional en menores de 5 anos,clasificacion d,2003-06-01,327,206,327,206,533
70803,MORO MORO,estado nutricional en menores de 5 anos,clasificacion d,2003-06-01,11,10,11,10,21
30302,MOROCHATA,estado nutricional en menores de 5 anos,clasificacion d,2003-06-01,100,144,100,144,244
90401,NACEBE (SANTA ROSA DEL ABUNA),estado nutricional en menores de 5 anos,clasificacion d,2003-06-01,3,7,3,7,10
50404,OCURI,estado nutricional en menores de 5 anos,clasificacion d,2003-06-01,67,119,67,119,186
30203,OMEREQUE,estado nutricional en menores de 5 anos,clasificacion d,2003-06-01,11,32,11,32,43
40101,ORURO,estado nutricional en menores de 5 anos,clasificacion d,2003-06-01,590,644,590,644,1234
60201,PADCAYA,estado nutricional en menores de 5 anos,clasificacion d,2003-06-01,69,130,69,130,199
10401,PADILLA,estado nutricional en menores de 5 anos,clasificacion d,2003-06-01,115,215,115,215,330
70502,PAILON,estado nutricional en menores de 5 anos,clasificacion d,2003-06-01,9,22,9,22,31
20102,PALCA,estado nutricional en menores de 5 anos,clasificacion d,2003-06-01,33,41,33,41,74
21104,PALOS BLANCOS,estado nutricional en menores de 5 anos,clasificacion d,2003-06-01,79,106,79,106,185
40802,PAMPA AULLAGAS,estado nutricional en menores de 5 anos,clasificacion d,2003-06-01,12,13,12,13,25
70902,PAMPA GRANDE,estado nutricional en menores de 5 anos,clasificacion d,2003-06-01,14,10,14,10,24
21802,PAPEL PAMPA,estado nutricional en menores de 5 anos,clasificacion d,2003-06-01,8,15,8,15,23
30202,PASORAPA,estado nutricional en menores de 5 anos,clasificacion d,2003-06-01,20,28,20,28,48
21305,PATACAMAYA,estado nutricional en menores de 5 anos,clasificacion d,2003-06-01,132,81,132,81,213
40602,PAZÃ‘A,estado nutricional en menores de 5 anos,clasificacion d,2003-06-01,16,8,16,8,24
20702,PELECHUCO,estado nutricional en menores de 5 anos,clasificacion d,2003-06-01,31,50,31,50,81
50403,POCOATA,estado nutricional en menores de 5 anos,clasificacion d,2003-06-01,175,242,175,242,417
31203,POCONA,estado nutricional en menores de 5 anos,clasificacion d,2003-06-01,40,32,40,32,72
31202,POJO (CBBA),estado nutricional en menores de 5 anos,clasificacion d,2003-06-01,82,100,82,100,182
40601,POOPO,estado nutricional en menores de 5 anos,clasificacion d,2003-06-01,6,25,6,25,31
51203,PORCO,estado nutricional en menores de 5 anos,clasificacion d,2003-06-01,19,20,19,20,39
10103,POROMA,estado nutricional en menores de 5 anos,clasificacion d,2003-06-01,282,299,282,299,581
70103,PORONGO,estado nutricional en menores de 5 anos,clasificacion d,2003-06-01,17,19,17,19,36
70601,PORTACHUELO,estado nutricional en menores de 5 anos,clasificacion d,2003-06-01,41,55,41,55,96
90102,PORVENIR,estado nutricional en menores de 5 anos,clasificacion d,2003-06-01,10,12,10,12,22
70804,POSTRER VALLE,estado nutricional en menores de 5 anos,clasificacion d,2003-06-01,5,8,5,8,13
50101,POTOSI,estado nutricional en menores de 5 anos,clasificacion d,2003-06-01,644,510,644,510,1154
10302,PRESTO,estado nutricional en menores de 5 anos,clasificacion d,2003-06-01,62,91,62,91,153
70805,PUCARA,estado nutricional en menores de 5 anos,clasificacion d,2003-06-01,1,0,1,0,1
21201,PUCARANI,estado nutricional en menores de 5 anos,clasificacion d,2003-06-01,64,84,64,84,148
20401,PUERTO ACOSTA,estado nutricional en menores de 5 anos,clasificacion d,2003-06-01,70,61,70,61,131
20403,PUERTO CARABUCO,estado nutricional en menores de 5 anos,clasificacion d,2003-06-01,28,59,28,59,87
90301,PUERTO GONZALO MORENO,estado nutricional en menores de 5 anos,clasificacion d,2003-06-01,10,7,10,7,17
21204,PUERTO PEREZ,estado nutricional en menores de 5 anos,clasificacion d,2003-06-01,25,23,25,23,48
71402,PUERTO QUIJARRO,estado nutricional en menores de 5 anos,clasificacion d,2003-06-01,42,17,42,17,59
90201,PUERTO RICO,estado nutricional en menores de 5 anos,clasificacion d,2003-06-01,0,16,0,16,16
80703,PUERTO SILES,estado nutricional en menores de 5 anos,clasificacion d,2003-06-01,14,66,14,66,80
71401,PUERTO SUAREZ,estado nutricional en menores de 5 anos,clasificacion d,2003-06-01,39,13,39,13,52
31205,PUERTO VILLARROEL,estado nutricional en menores de 5 anos,clasificacion d,2003-06-01,148,140,148,140,288
51101,PUNA,estado nutricional en menores de 5 anos,clasificacion d,2003-06-01,81,53,81,53,134
31401,PUNATA,estado nutricional en menores de 5 anos,clasificacion d,2003-06-01,40,20,40,20,60
20604,QUIABAYA,estado nutricional en menores de 5 anos,clasificacion d,2003-06-01,8,27,8,27,35
30901,QUILLACOLLO,estado nutricional en menores de 5 anos,clasificacion d,2003-06-01,87,96,87,96,183
21002,QUIME,estado nutricional en menores de 5 anos,clasificacion d,2003-06-01,82,97,82,97,179
70904,QUIRUSILLAS,estado nutricional en menores de 5 anos,clasificacion d,2003-06-01,3,2,3,2,5
50402,RAVELO,estado nutricional en menores de 5 anos,clasificacion d,2003-06-01,222,259,222,259,481
80301,REYES,estado nutricional en menores de 5 anos,clasificacion d,2003-06-01,2,16,2,16,18
80201,RIBERALTA,estado nutricional en menores de 5 anos,clasificacion d,2003-06-01,391,332,391,332,723
70503,ROBORE,estado nutricional en menores de 5 anos,clasificacion d,2003-06-01,27,22,27,22,49
80304,RURRENABAQUE,estado nutricional en menores de 5 anos,clasificacion d,2003-06-01,36,37,36,37,73
40901,SABAYA,estado nutricional en menores de 5 anos,clasificacion d,2003-06-01,4,7,4,7,11
31001,SACABA,estado nutricional en menores de 5 anos,clasificacion d,2003-06-01,61,36,61,36,97
30404,SACABAMBA,estado nutricional en menores de 5 anos,clasificacion d,2003-06-01,7,21,7,21,28
50701,SACACA,estado nutricional en menores de 5 anos,clasificacion d,2003-06-01,296,593,296,593,889
71302,SAIPINA,estado nutricional en menores de 5 anos,clasificacion d,2003-06-01,15,29,15,29,44
40801,SALINAS DE GARCI MENDOZA,estado nutricional en menores de 5 anos,clasificacion d,2003-06-01,11,11,11,11,22
70901,SAMAIPATA,estado nutricional en menores de 5 anos,clasificacion d,2003-06-01,14,15,14,15,29
51601,SAN AGUSTIN,estado nutricional en menores de 5 anos,clasificacion d,2003-06-01,5,3,5,3,8
80602,SAN ANDRES,estado nutricional en menores de 5 anos,clasificacion d,2003-06-01,9,5,9,5,14
51003,SAN ANTONIO DE ESMORUCO,estado nutricional en menores de 5 anos,clasificacion d,2003-06-01,0,4,0,4,4
71105,SAN ANTONIO DE LOMERIO,estado nutricional en menores de 5 anos,clasificacion d,2003-06-01,67,114,67,114,181
31403,SAN BENITO,estado nutricional en menores de 5 anos,clasificacion d,2003-06-01,19,27,19,27,46
80302,SAN BORJA,estado nutricional en menores de 5 anos,clasificacion d,2003-06-01,164,144,164,144,308
21502,SAN BUENA VENTURA,estado nutricional en menores de 5 anos,clasificacion d,2003-06-01,34,37,34,37,71
70402,SAN CARLOS,estado nutricional en menores de 5 anos,clasificacion d,2003-06-01,70,98,70,98,168
80501,SAN IGNACIO,estado nutricional en menores de 5 anos,clasificacion d,2003-06-01,67,74,67,74,141
70301,SAN IGNACIO DE VELASCO,estado nutricional en menores de 5 anos,clasificacion d,2003-06-01,213,153,213,153,366
80102,SAN JAVIER(BNI),estado nutricional en menores de 5 anos,clasificacion d,2003-06-01,6,12,6,12,18
71102,SAN JAVIER(STC),estado nutricional en menores de 5 anos,clasificacion d,2003-06-01,40,50,40,50,90
80701,SAN JOAQUIN,estado nutricional en menores de 5 anos,clasificacion d,2003-06-01,7,15,7,15,22
70501,SAN JOSE DE CHIQUITOS,estado nutricional en menores de 5 anos,clasificacion d,2003-06-01,47,15,47,15,62
71104,SAN JULIAN,estado nutricional en menores de 5 anos,clasificacion d,2003-06-01,135,139,135,139,274
90302,SAN LORENZO(PND),estado nutricional en menores de 5 anos,clasificacion d,2003-06-01,4,9,4,9,13
60501,SAN LORENZO(TJA),estado nutricional en menores de 5 anos,clasificacion d,2003-06-01,31,102,31,102,133
10702,SAN LUCAS,estado nutricional en menores de 5 anos,clasificacion d,2003-06-01,327,342,327,342,669
71201,SAN MATIAS,estado nutricional en menores de 5 anos,clasificacion d,2003-06-01,56,33,56,33,89
70302,SAN MIGUEL DE VELASCO,estado nutricional en menores de 5 anos,clasificacion d,2003-06-01,34,42,34,42,76
51001,SAN PABLO DE LIPEZ,estado nutricional en menores de 5 anos,clasificacion d,2003-06-01,4,8,4,8,12
50501,SAN PEDRO DE BUENA VISTA,estado nutricional en menores de 5 anos,clasificacion d,2003-06-01,133,331,133,331,464
21801,SAN PEDRO DE CURAHUARA,estado nutricional en menores de 5 anos,clasificacion d,2003-06-01,18,39,18,39,57
50902,SAN PEDRO DE QUEMES,estado nutricional en menores de 5 anos,clasificacion d,2003-06-01,1,4,1,4,5
21702,SAN PEDRO DE TIQUINA,estado nutricional en menores de 5 anos,clasificacion d,2003-06-01,5,12,5,12,17
70303,SAN RAFAEL,estado nutricional en menores de 5 anos,clasificacion d,2003-06-01,35,39,35,39,74
80702,SAN RAMON,estado nutricional en menores de 5 anos,clasificacion d,2003-06-01,7,10,7,10,17
70101,SANTA CRUZ DE LA SIERRA,estado nutricional en menores de 5 anos,clasificacion d,2003-06-01,674,440,674,440,1114
80303,SANTA ROSA,estado nutricional en menores de 5 anos,clasificacion d,2003-06-01,12,3,12,3,15
70602,SANTA ROSA DEL SARA,estado nutricional en menores de 5 anos,clasificacion d,2003-06-01,8,21,8,21,29
20308,SANTIAGO DE CALLAPA,estado nutricional en menores de 5 anos,clasificacion d,2003-06-01,19,27,19,27,46
41401,SANTIAGO DE HUARI,estado nutricional en menores de 5 anos,clasificacion d,2003-06-01,19,34,19,34,53
21901,SANTIAGO DE MACHACA,estado nutricional en menores de 5 anos,clasificacion d,2003-06-01,5,7,5,7,12
30702,SANTIVAÃ‘ES,estado nutricional en menores de 5 anos,clasificacion d,2003-06-01,18,19,18,19,37
40202,SANTUARIO DE QUILLACAS,estado nutricional en menores de 5 anos,clasificacion d,2003-06-01,9,13,9,13,22
20902,SAPAHAQUI,estado nutricional en menores de 5 anos,clasificacion d,2003-06-01,40,66,40,66,106
90303,SENA,estado nutricional en menores de 5 anos,clasificacion d,2003-06-01,12,3,12,3,15
21301,SICA SICA (VILLA AROMA),estado nutricional en menores de 5 anos,clasificacion d,2003-06-01,136,77,136,77,213
30703,SICAYA,estado nutricional en menores de 5 anos,clasificacion d,2003-06-01,13,6,13,6,19
30902,SIPE SIPE,estado nutricional en menores de 5 anos,clasificacion d,2003-06-01,126,103,126,103,229
10403,SOPACHUY,estado nutricional en menores de 5 anos,clasificacion d,2003-06-01,70,87,70,87,157
20601,SORATA,estado nutricional en menores de 5 anos,clasificacion d,2003-06-01,58,94,58,94,152
10101,SUCRE,estado nutricional en menores de 5 anos,clasificacion d,2003-06-01,580,740,580,740,1320
31404,TACACHI,estado nutricional en menores de 5 anos,clasificacion d,2003-06-01,1,6,1,6,7
20603,TACACOMA,estado nutricional en menores de 5 anos,clasificacion d,2003-06-01,40,100,40,100,140
50303,TACOBAMBA,estado nutricional en menores de 5 anos,clasificacion d,2003-06-01,67,113,67,113,180
30602,TACOPAYA,estado nutricional en menores de 5 anos,clasificacion d,2003-06-01,75,133,75,133,208
51402,TAHUA,estado nutricional en menores de 5 anos,clasificacion d,2003-06-01,6,3,6,3,9
31101,TAPACARI,estado nutricional en menores de 5 anos,clasificacion d,2003-06-01,104,193,104,193,297
10601,TARABUCO,estado nutricional en menores de 5 anos,clasificacion d,2003-06-01,346,550,346,550,896
30401,TARATA,estado nutricional en menores de 5 anos,clasificacion d,2003-06-01,34,26,34,26,60
60101,TARIJA,estado nutricional en menores de 5 anos,clasificacion d,2003-06-01,224,284,224,284,508
10202,TARVITA,estado nutricional en menores de 5 anos,clasificacion d,2003-06-01,71,169,71,169,240
20803,TIAWANACU,estado nutricional en menores de 5 anos,clasificacion d,2003-06-01,44,27,44,27,71
50102,TINGUIPAYA,estado nutricional en menores de 5 anos,clasificacion d,2003-06-01,91,280,91,280,371
20606,TIPUANI,estado nutricional en menores de 5 anos,clasificacion d,2003-06-01,18,8,18,8,26
30903,TIQUIPAYA,estado nutricional en menores de 5 anos,clasificacion d,2003-06-01,73,47,73,47,120
31601,TIRAQUE (CBBA),estado nutricional en menores de 5 anos,clasificacion d,2003-06-01,131,160,131,160,291
21703,TITO YUPANQUI (PARQUIPUJIO),estado nutricional en menores de 5 anos,clasificacion d,2003-06-01,11,6,11,6,17
30802,TOCO,estado nutricional en menores de 5 anos,clasificacion d,2003-06-01,0,5,0,5,5
30803,TOLATA,estado nutricional en menores de 5 anos,clasificacion d,2003-06-01,0,7,0,7,7
41001,TOLEDO,estado nutricional en menores de 5 anos,clasificacion d,2003-06-01,2,1,2,1,3
51202,TOMAVE,estado nutricional en menores de 5 anos,clasificacion d,2003-06-01,45,124,45,124,169
10402,TOMINA,estado nutricional en menores de 5 anos,clasificacion d,2003-06-01,109,207,109,207,316
50502,TORO TORO,estado nutricional en menores de 5 anos,clasificacion d,2003-06-01,102,121,102,121,223
31201,TOTORA(CBBA),estado nutricional en menores de 5 anos,clasificacion d,2003-06-01,68,57,68,57,125
41301,TOTORA(ORR),estado nutricional en menores de 5 anos,clasificacion d,2003-06-01,28,49,28,49,77
70802,TRIGAL,estado nutricional en menores de 5 anos,clasificacion d,2003-06-01,4,5,4,5,9
80101,TRINIDAD,estado nutricional en menores de 5 anos,clasificacion d,2003-06-01,148,175,148,175,323
50801,TUPIZA,estado nutricional en menores de 5 anos,clasificacion d,2003-06-01,111,185,111,185,296
40402,TURCO,estado nutricional en menores de 5 anos,clasificacion d,2003-06-01,15,33,15,33,48
21302,UMALA,estado nutricional en menores de 5 anos,clasificacion d,2003-06-01,13,2,13,2,15
50201,UNCIA,estado nutricional en menores de 5 anos,clasificacion d,2003-06-01,12,14,12,14,26
60401,URIONDO (A. CONCEPCION),estado nutricional en menores de 5 anos,clasificacion d,2003-06-01,47,59,47,59,106
71502,URUBICHA,estado nutricional en menores de 5 anos,clasificacion d,2003-06-01,91,164,91,164,255
51201,UYUNI,estado nutricional en menores de 5 anos,clasificacion d,2003-06-01,67,96,67,96,163
30502,VACAS,estado nutricional en menores de 5 anos,clasificacion d,2003-06-01,40,26,40,26,66
70801,VALLEGRANDE,estado nutricional en menores de 5 anos,clasificacion d,2003-06-01,71,61,71,61,132
20801,VIACHA,estado nutricional en menores de 5 anos,clasificacion d,2003-06-01,100,121,100,121,221
31302,VILA VILA,estado nutricional en menores de 5 anos,clasificacion d,2003-06-01,24,52,24,52,76
60303,VILLA MONTES,estado nutricional en menores de 5 anos,clasificacion d,2003-06-01,30,34,30,34,64
31402,VILLA RIVERO,estado nutricional en menores de 5 anos,clasificacion d,2003-06-01,16,16,16,16,32
10801,VILLA SERRANO,estado nutricional en menores de 5 anos,clasificacion d,2003-06-01,108,188,108,188,296
31003,VILLA TUNARI,estado nutricional en menores de 5 anos,clasificacion d,2003-06-01,142,147,142,147,289
11001,VILLA VACA GUZMAN (MUYUPAMPA),estado nutricional en menores de 5 anos,clasificacion d,2003-06-01,50,72,50,72,122
51501,VILLAZON,estado nutricional en menores de 5 anos,clasificacion d,2003-06-01,177,203,177,203,380
30904,VINTO,estado nutricional en menores de 5 anos,clasificacion d,2003-06-01,8,3,8,3,11
50602,VITICHI,estado nutricional en menores de 5 anos,clasificacion d,2003-06-01,109,150,109,150,259
20306,WALDO BALLIVIAN,estado nutricional en menores de 5 anos,clasificacion d,2003-06-01,1,2,1,2,3
20903,YACO,estado nutricional en menores de 5 anos,clasificacion d,2003-06-01,23,28,23,28,51
60301,YACUIBA,estado nutricional en menores de 5 anos,clasificacion d,2003-06-01,63,86,63,86,149
10602,YAMPARAEZ,estado nutricional en menores de 5 anos,clasificacion d,2003-06-01,150,301,150,301,451
21103,YANACACHI,estado nutricional en menores de 5 anos,clasificacion d,2003-06-01,15,21,15,21,36
70403,YAPACANI,estado nutricional en menores de 5 anos,clasificacion d,2003-06-01,107,155,107,155,262
50103,YOCALLA,estado nutricional en menores de 5 anos,clasificacion d,2003-06-01,27,50,27,50,77
10102,YOTALA,estado nutricional en menores de 5 anos,clasificacion d,2003-06-01,73,173,73,173,246
60402,YUNCHARA,estado nutricional en menores de 5 anos,clasificacion d,2003-06-01,13,29,13,29,42
10301,ZUDAÃ‘EZ,estado nutricional en menores de 5 anos,clasificacion d,2003-06-01,55,100,55,100,155
51302,ACACIO,estado nutricional en menores de 5 anos,clasificacion d,2003-07-01,72,115,72,115,187
20201,ACHACACHI,estado nutricional en menores de 5 anos,clasificacion d,2003-07-01,105,106,105,106,211
20104,ACHOCALLA,estado nutricional en menores de 5 anos,clasificacion d,2003-07-01,17,19,17,19,36
30201,AIQUILE,estado nutricional en menores de 5 anos,clasificacion d,2003-07-01,48,29,48,29,77
31303,ALALAY,estado nutricional en menores de 5 anos,clasificacion d,2003-07-01,12,22,12,22,34
10404,ALCALA,estado nutricional en menores de 5 anos,clasificacion d,2003-07-01,39,69,39,69,108
20202,ANCORAIMES,estado nutricional en menores de 5 anos,clasificacion d,2003-07-01,66,98,66,98,164
41201,ANDAMARCA,estado nutricional en menores de 5 anos,clasificacion d,2003-07-01,3,3,3,3,6
30402,ANZALDO,estado nutricional en menores de 5 anos,clasificacion d,2003-07-01,17,32,17,32,49
20701,APOLO,estado nutricional en menores de 5 anos,clasificacion d,2003-07-01,31,17,31,17,48
51301,ARAMPAMPA,estado nutricional en menores de 5 anos,clasificacion d,2003-07-01,29,85,29,85,114
30501,ARANI,estado nutricional en menores de 5 anos,clasificacion d,2003-07-01,10,27,10,27,37
30403,ARBIETO,estado nutricional en menores de 5 anos,clasificacion d,2003-07-01,10,3,10,3,13
30601,ARQUE,estado nutricional en menores de 5 anos,clasificacion d,2003-07-01,102,125,102,125,227
71501,ASCENCION DE GUARAYOS,estado nutricional en menores de 5 anos,clasificacion d,2003-07-01,4,5,4,5,9
50802,ATOCHA,estado nutricional en menores de 5 anos,clasificacion d,2003-07-01,5,199,5,199,204
20503,AUCAPATA,estado nutricional en menores de 5 anos,clasificacion d,2003-07-01,10,3,10,3,13
20502,AYATA,estado nutricional en menores de 5 anos,clasificacion d,2003-07-01,31,32,31,32,63
21303,AYO AYO,estado nutricional en menores de 5 anos,clasificacion d,2003-07-01,4,0,4,0,4
30301,AYOPAYA (V. DE INDEPENDENCIA),estado nutricional en menores de 5 anos,clasificacion d,2003-07-01,93,122,93,122,215
10201,AZURDUY,estado nutricional en menores de 5 anos,clasificacion d,2003-07-01,87,170,87,170,257
21203,BATALLAS,estado nutricional en menores de 5 anos,clasificacion d,2003-07-01,29,14,29,14,43
80802,BAURES,estado nutricional en menores de 5 anos,clasificacion d,2003-07-01,18,25,18,25,43
50104,BELEN DE URMIRI,estado nutricional en menores de 5 anos,clasificacion d,2003-07-01,8,23,8,23,31
90104,BELLA FLOR,estado nutricional en menores de 5 anos,clasificacion d,2003-07-01,20,25,20,25,45
60202,BERMEJO,estado nutricional en menores de 5 anos,clasificacion d,2003-07-01,21,31,21,31,52
50301,BETANZOS,estado nutricional en menores de 5 anos,clasificacion d,2003-07-01,246,304,246,304,550
31501,BOLIVAR,estado nutricional en menores de 5 anos,clasificacion d,2003-07-01,47,42,47,42,89
90103,BOLPEBRA,estado nutricional en menores de 5 anos,clasificacion d,2003-07-01,9,13,9,13,22
70707,BOYUIBE,estado nutricional en menores de 5 anos,clasificacion d,2003-07-01,5,11,5,11,16
70401,BUENA VISTA,estado nutricional en menores de 5 anos,clasificacion d,2003-07-01,32,57,32,57,89
70703,CABEZAS,estado nutricional en menores de 5 anos,clasificacion d,2003-07-01,12,5,12,5,17
20905,CAIROMA,estado nutricional en menores de 5 anos,clasificacion d,2003-07-01,45,34,45,34,79
51102,"CAIZA ""D""",estado nutricional en menores de 5 anos,clasificacion d,2003-07-01,99,123,99,123,222
21003,CAJUATA,estado nutricional en menores de 5 anos,clasificacion d,2003-07-01,16,12,16,12,28
20303,CALACOTO,estado nutricional en menores de 5 anos,clasificacion d,2003-07-01,15,18,15,18,33
21304,CALAMARCA,estado nutricional en menores de 5 anos,clasificacion d,2003-07-01,81,51,81,51,132
10701,CAMARGO,estado nutricional en menores de 5 anos,clasificacion d,2003-07-01,107,107,107,107,214
10901,CAMATAQUI (C. VILLA ABECIA),estado nutricional en menores de 5 anos,clasificacion d,2003-07-01,13,36,13,36,49
70706,CAMIRI,estado nutricional en menores de 5 anos,clasificacion d,2003-07-01,144,137,144,137,281
30701,CAPINOTA,estado nutricional en menores de 5 anos,clasificacion d,2003-07-01,26,24,26,24,50
20302,CAQUIAVIRI,estado nutricional en menores de 5 anos,clasificacion d,2003-07-01,49,46,49,46,95
40102,CARACOLLO,estado nutricional en menores de 5 anos,clasificacion d,2003-07-01,76,82,76,82,158
22001,CARANAVI,estado nutricional en menores de 5 anos,clasificacion d,2003-07-01,164,124,164,124,288
60302,CARAPARI,estado nutricional en menores de 5 anos,clasificacion d,2003-07-01,42,54,42,54,96
50702,CARIPUYO,estado nutricional en menores de 5 anos,clasificacion d,2003-07-01,69,122,69,122,191
21902,CATACORA,estado nutricional en menores de 5 anos,clasificacion d,2003-07-01,0,6,0,6,6
40201,CHALLAPATA,estado nutricional en menores de 5 anos,clasificacion d,2003-07-01,90,83,90,83,173
50302,CHAQUI,estado nutricional en menores de 5 anos,clasificacion d,2003-07-01,64,67,64,67,131
70702,CHARAGUA,estado nutricional en menores de 5 anos,clasificacion d,2003-07-01,99,111,99,111,210
20305,CHARAÃ‘A,estado nutricional en menores de 5 anos,clasificacion d,2003-07-01,7,13,7,13,20
50202,CHAYANTA,estado nutricional en menores de 5 anos,clasificacion d,2003-07-01,32,16,32,16,48
31204,CHIMORE,estado nutricional en menores de 5 anos,clasificacion d,2003-07-01,18,21,18,21,39
40903,CHIPAYA,estado nutricional en menores de 5 anos,clasificacion d,2003-07-01,1,0,1,0,1
21101,CHULUMANI (V. DE LA LIBERTAD),estado nutricional en menores de 5 anos,clasificacion d,2003-07-01,12,18,12,18,30
20501,CHUMA,estado nutricional en menores de 5 anos,clasificacion d,2003-07-01,27,30,27,30,57
30801,CLIZA,estado nutricional en menores de 5 anos,clasificacion d,2003-07-01,9,14,9,14,23
90101,COBIJA,estado nutricional en menores de 5 anos,clasificacion d,2003-07-01,108,118,108,118,226
30101,COCHABAMBA,estado nutricional en menores de 5 anos,clasificacion d,2003-07-01,525,371,525,371,896
30905,COLCAPIRHUA,estado nutricional en menores de 5 anos,clasificacion d,2003-07-01,25,25,25,25,50
50901,"COLCHA ""K""",estado nutricional en menores de 5 anos,clasificacion d,2003-07-01,55,53,55,53,108
21307,COLLANA,estado nutricional en menores de 5 anos,clasificacion d,2003-07-01,2,0,2,0,2
31002,COLOMI,estado nutricional en menores de 5 anos,clasificacion d,2003-07-01,69,74,69,74,143
50401,COLQUECHACA,estado nutricional en menores de 5 anos,clasificacion d,2003-07-01,224,147,224,147,371
21306,COLQUENCHA,estado nutricional en menores de 5 anos,clasificacion d,2003-07-01,19,12,19,12,31
21004,COLQUIRI,estado nutricional en menores de 5 anos,clasificacion d,2003-07-01,81,51,81,51,132
20304,COMANCHE,estado nutricional en menores de 5 anos,clasificacion d,2003-07-01,4,5,4,5,9
71301,COMARAPA,estado nutricional en menores de 5 anos,clasificacion d,2003-07-01,64,50,64,50,114
20605,COMBAYA,estado nutricional en menores de 5 anos,clasificacion d,2003-07-01,9,17,9,17,26
71101,CONCEPCION,estado nutricional en menores de 5 anos,clasificacion d,2003-07-01,12,9,12,9,21
21701,COPACABANA,estado nutricional en menores de 5 anos,clasificacion d,2003-07-01,17,20,17,20,37
20301,CORO CORO,estado nutricional en menores de 5 anos,clasificacion d,2003-07-01,34,34,34,34,68
21401,COROICO,estado nutricional en menores de 5 anos,clasificacion d,2003-07-01,18,8,18,8,26
40301,CORQUE,estado nutricional en menores de 5 anos,clasificacion d,2003-07-01,6,5,6,5,11
50601,COTAGAITA,estado nutricional en menores de 5 anos,clasificacion d,2003-07-01,72,143,72,143,215
70102,COTOCA,estado nutricional en menores de 5 anos,clasificacion d,2003-07-01,24,19,24,19,43
31405,CUCHUMUELA (V. G. VILLARROEL),estado nutricional en menores de 5 anos,clasificacion d,2003-07-01,8,9,8,9,17
70704,CUEVO,estado nutricional en menores de 5 anos,clasificacion d,2003-07-01,5,14,5,14,19
10902,CULPINA,estado nutricional en menores de 5 anos,clasificacion d,2003-07-01,163,170,163,170,333
40401,CURAHUARA DE CARANGAS,estado nutricional en menores de 5 anos,clasificacion d,2003-07-01,13,7,13,7,20
21602,CURVA,estado nutricional en menores de 5 anos,clasificacion d,2003-07-01,18,16,18,16,34
20804,DESAGUADERO,estado nutricional en menores de 5 anos,clasificacion d,2003-07-01,5,3,5,3,8
20105,EL ALTO,estado nutricional en menores de 5 anos,clasificacion d,2003-07-01,1913,1137,1913,1137,3050
40103,EL CHORO,estado nutricional en menores de 5 anos,clasificacion d,2003-07-01,1,1,1,1,2
71503,EL PUENTE(STC),estado nutricional en menores de 5 anos,clasificacion d,2003-07-01,25,147,25,147,172
60502,EL PUENTE(TJA),estado nutricional en menores de 5 anos,clasificacion d,2003-07-01,55,98,55,98,153
70105,EL TORNO,estado nutricional en menores de 5 anos,clasificacion d,2003-07-01,57,85,57,85,142
10405,EL VILLAR,estado nutricional en menores de 5 anos,clasificacion d,2003-07-01,43,121,43,121,164
60601,ENTRE RIOS,estado nutricional en menores de 5 anos,clasificacion d,2003-07-01,38,46,38,46,84
41101,EUCALIPTUS,estado nutricional en menores de 5 anos,clasificacion d,2003-07-01,14,11,14,11,25
80402,EXALTACION,estado nutricional en menores de 5 anos,clasificacion d,2003-07-01,9,14,9,14,23
90203,FILADELFIA,estado nutricional en menores de 5 anos,clasificacion d,2003-07-01,7,19,7,19,26
71002,GENERAL SAAVEDRA,estado nutricional en menores de 5 anos,clasificacion d,2003-07-01,81,141,81,141,222
21601,GRAL. J.J. PEREZ (CHARAZANI),estado nutricional en menores de 5 anos,clasificacion d,2003-07-01,39,40,39,40,79
20602,GUANAY,estado nutricional en menores de 5 anos,clasificacion d,2003-07-01,74,111,74,111,185
20802,GUAQUI,estado nutricional en menores de 5 anos,clasificacion d,2003-07-01,3,5,3,5,8
80202,GUAYARAMERIN,estado nutricional en menores de 5 anos,clasificacion d,2003-07-01,135,89,135,89,224
70705,GUTIERREZ,estado nutricional en menores de 5 anos,clasificacion d,2003-07-01,80,162,80,162,242
10502,HUACARETA,estado nutricional en menores de 5 anos,clasificacion d,2003-07-01,52,90,52,90,142
11002,HUACAYA (VILLA DE HUACAYA),estado nutricional en menores de 5 anos,clasificacion d,2003-07-01,7,18,7,18,25
40501,HUACHACALLA,estado nutricional en menores de 5 anos,clasificacion d,2003-07-01,2,1,2,1,3
40701,HUANUNI,estado nutricional en menores de 5 anos,clasificacion d,2003-07-01,40,52,40,52,92
80803,HUARACAJE,estado nutricional en menores de 5 anos,clasificacion d,2003-07-01,6,4,6,4,10
41601,HUAYLLAMARCA,estado nutricional en menores de 5 anos,clasificacion d,2003-07-01,4,16,4,16,20
21005,ICHOCA,estado nutricional en menores de 5 anos,clasificacion d,2003-07-01,23,39,23,39,62
10304,ICLA,estado nutricional en menores de 5 anos,clasificacion d,2003-07-01,122,188,122,188,310
10703,INCAHUASI,estado nutricional en menores de 5 anos,clasificacion d,2003-07-01,124,225,124,225,349
21001,INQUISIVI,estado nutricional en menores de 5 anos,clasificacion d,2003-07-01,82,80,82,80,162
21102,IRUPANA (VILLA DE LANZA),estado nutricional en menores de 5 anos,clasificacion d,2003-07-01,22,50,22,50,72
21501,IXIAMAS,estado nutricional en menores de 5 anos,clasificacion d,2003-07-01,22,20,22,20,42
21105,LA ASUNTA,estado nutricional en menores de 5 anos,clasificacion d,2003-07-01,46,62,46,62,108
70104,LA GUARDIA,estado nutricional en menores de 5 anos,clasificacion d,2003-07-01,55,38,55,38,93
20101,LA PAZ,estado nutricional en menores de 5 anos,clasificacion d,2003-07-01,1178,1088,1178,1088,2266
41501,LA RIVERA,estado nutricional en menores de 5 anos,clasificacion d,2003-07-01,2,1,2,1,3
70701,LAGUNILLAS,estado nutricional en menores de 5 anos,clasificacion d,2003-07-01,28,49,28,49,77
21202,LAJA,estado nutricional en menores de 5 anos,clasificacion d,2003-07-01,41,34,41,34,75
10903,LAS CARRERAS,estado nutricional en menores de 5 anos,clasificacion d,2003-07-01,11,51,11,51,62
21006,LICOMA PAMPA,estado nutricional en menores de 5 anos,clasificacion d,2003-07-01,8,10,8,10,18
50203,LLALLAGUA,estado nutricional en menores de 5 anos,clasificacion d,2003-07-01,54,259,54,259,313
51401,LLICA,estado nutricional en menores de 5 anos,clasificacion d,2003-07-01,5,12,5,12,17
80601,LORETO,estado nutricional en menores de 5 anos,clasificacion d,2003-07-01,8,20,8,20,28
20901,LURIBAY,estado nutricional en menores de 5 anos,clasificacion d,2003-07-01,15,23,15,23,38
40702,MACHACAMARCA,estado nutricional en menores de 5 anos,clasificacion d,2003-07-01,17,9,17,9,26
11003,MACHARETI,estado nutricional en menores de 5 anos,clasificacion d,2003-07-01,35,100,35,100,135
80801,MAGDALENA,estado nutricional en menores de 5 anos,clasificacion d,2003-07-01,15,17,15,17,32
70903,MAIRANA,estado nutricional en menores de 5 anos,clasificacion d,2003-07-01,28,26,28,26,54
20904,MALLA,estado nutricional en menores de 5 anos,clasificacion d,2003-07-01,7,4,7,4,11
20103,MECAPACA,estado nutricional en menores de 5 anos,clasificacion d,2003-07-01,17,23,17,23,40
71003,MINEROS,estado nutricional en menores de 5 anos,clasificacion d,2003-07-01,112,81,112,81,193
31301,MIZQUE,estado nutricional en menores de 5 anos,clasificacion d,2003-07-01,43,17,43,17,60
20402,MOCOMOCO,estado nutricional en menores de 5 anos,clasificacion d,2003-07-01,66,92,66,92,158
51002,MOJINETE,estado nutricional en menores de 5 anos,clasificacion d,2003-07-01,6,11,6,11,17
10303,MOJOCOYA,estado nutricional en menores de 5 anos,clasificacion d,2003-07-01,58,137,58,137,195
10501,MONTEAGUDO,estado nutricional en menores de 5 anos,clasificacion d,2003-07-01,106,158,106,158,264
71001,MONTERO,estado nutricional en menores de 5 anos,clasificacion d,2003-07-01,348,179,348,179,527
70803,MORO MORO,estado nutricional en menores de 5 anos,clasificacion d,2003-07-01,10,12,10,12,22
30302,MOROCHATA,estado nutricional en menores de 5 anos,clasificacion d,2003-07-01,132,138,132,138,270
20307,NAZACARA DE PACAJES,estado nutricional en menores de 5 anos,clasificacion d,2003-07-01,4,1,4,1,5
90501,NUEVO MANOA (NUEVA ESPERANZA),estado nutricional en menores de 5 anos,clasificacion d,2003-07-01,1,1,1,1,2
50404,OCURI,estado nutricional en menores de 5 anos,clasificacion d,2003-07-01,77,122,77,122,199
70202,OKINAWA,estado nutricional en menores de 5 anos,clasificacion d,2003-07-01,3,1,3,1,4
30203,OMEREQUE,estado nutricional en menores de 5 anos,clasificacion d,2003-07-01,17,41,17,41,58
40101,ORURO,estado nutricional en menores de 5 anos,clasificacion d,2003-07-01,572,567,572,567,1139
60201,PADCAYA,estado nutricional en menores de 5 anos,clasificacion d,2003-07-01,57,110,57,110,167
10401,PADILLA,estado nutricional en menores de 5 anos,clasificacion d,2003-07-01,100,220,100,220,320
70502,PAILON,estado nutricional en menores de 5 anos,clasificacion d,2003-07-01,36,22,36,22,58
20102,PALCA,estado nutricional en menores de 5 anos,clasificacion d,2003-07-01,24,33,24,33,57
21104,PALOS BLANCOS,estado nutricional en menores de 5 anos,clasificacion d,2003-07-01,41,73,41,73,114
40802,PAMPA AULLAGAS,estado nutricional en menores de 5 anos,clasificacion d,2003-07-01,17,24,17,24,41
70902,PAMPA GRANDE,estado nutricional en menores de 5 anos,clasificacion d,2003-07-01,16,20,16,20,36
21802,PAPEL PAMPA,estado nutricional en menores de 5 anos,clasificacion d,2003-07-01,4,11,4,11,15
30202,PASORAPA,estado nutricional en menores de 5 anos,clasificacion d,2003-07-01,19,29,19,29,48
21305,PATACAMAYA,estado nutricional en menores de 5 anos,clasificacion d,2003-07-01,49,25,49,25,74
40602,PAZÃ‘A,estado nutricional en menores de 5 anos,clasificacion d,2003-07-01,4,21,4,21,25
20702,PELECHUCO,estado nutricional en menores de 5 anos,clasificacion d,2003-07-01,27,19,27,19,46
50403,POCOATA,estado nutricional en menores de 5 anos,clasificacion d,2003-07-01,185,134,185,134,319
31203,POCONA,estado nutricional en menores de 5 anos,clasificacion d,2003-07-01,47,46,47,46,93
31202,POJO (CBBA),estado nutricional en menores de 5 anos,clasificacion d,2003-07-01,150,127,150,127,277
40601,POOPO,estado nutricional en menores de 5 anos,clasificacion d,2003-07-01,6,25,6,25,31
51203,PORCO,estado nutricional en menores de 5 anos,clasificacion d,2003-07-01,17,17,17,17,34
10103,POROMA,estado nutricional en menores de 5 anos,clasificacion d,2003-07-01,125,252,125,252,377
70103,PORONGO,estado nutricional en menores de 5 anos,clasificacion d,2003-07-01,11,10,11,10,21
70601,PORTACHUELO,estado nutricional en menores de 5 anos,clasificacion d,2003-07-01,65,53,65,53,118
90102,PORVENIR,estado nutricional en menores de 5 anos,clasificacion d,2003-07-01,12,18,12,18,30
70804,POSTRER VALLE,estado nutricional en menores de 5 anos,clasificacion d,2003-07-01,6,8,6,8,14
50101,POTOSI,estado nutricional en menores de 5 anos,clasificacion d,2003-07-01,778,546,778,546,1324
10302,PRESTO,estado nutricional en menores de 5 anos,clasificacion d,2003-07-01,70,97,70,97,167
70805,PUCARA,estado nutricional en menores de 5 anos,clasificacion d,2003-07-01,7,7,7,7,14
21201,PUCARANI,estado nutricional en menores de 5 anos,clasificacion d,2003-07-01,36,32,36,32,68
20401,PUERTO ACOSTA,estado nutricional en menores de 5 anos,clasificacion d,2003-07-01,62,69,62,69,131
20403,PUERTO CARABUCO,estado nutricional en menores de 5 anos,clasificacion d,2003-07-01,42,67,42,67,109
90301,PUERTO GONZALO MORENO,estado nutricional en menores de 5 anos,clasificacion d,2003-07-01,4,4,4,4,8
21204,PUERTO PEREZ,estado nutricional en menores de 5 anos,clasificacion d,2003-07-01,13,0,13,0,13
71402,PUERTO QUIJARRO,estado nutricional en menores de 5 anos,clasificacion d,2003-07-01,51,22,51,22,73
90201,PUERTO RICO,estado nutricional en menores de 5 anos,clasificacion d,2003-07-01,3,53,3,53,56
80703,PUERTO SILES,estado nutricional en menores de 5 anos,clasificacion d,2003-07-01,8,24,8,24,32
71401,PUERTO SUAREZ,estado nutricional en menores de 5 anos,clasificacion d,2003-07-01,23,20,23,20,43
31205,PUERTO VILLARROEL,estado nutricional en menores de 5 anos,clasificacion d,2003-07-01,181,176,181,176,357
51101,PUNA,estado nutricional en menores de 5 anos,clasificacion d,2003-07-01,170,219,170,219,389
31401,PUNATA,estado nutricional en menores de 5 anos,clasificacion d,2003-07-01,70,124,70,124,194
20604,QUIABAYA,estado nutricional en menores de 5 anos,clasificacion d,2003-07-01,5,20,5,20,25
30901,QUILLACOLLO,estado nutricional en menores de 5 anos,clasificacion d,2003-07-01,89,114,89,114,203
21002,QUIME,estado nutricional en menores de 5 anos,clasificacion d,2003-07-01,52,55,52,55,107
70904,QUIRUSILLAS,estado nutricional en menores de 5 anos,clasificacion d,2003-07-01,2,7,2,7,9
50402,RAVELO,estado nutricional en menores de 5 anos,clasificacion d,2003-07-01,115,141,115,141,256
80301,REYES,estado nutricional en menores de 5 anos,clasificacion d,2003-07-01,30,34,30,34,64
80201,RIBERALTA,estado nutricional en menores de 5 anos,clasificacion d,2003-07-01,383,275,383,275,658
70503,ROBORE,estado nutricional en menores de 5 anos,clasificacion d,2003-07-01,44,32,44,32,76
80304,RURRENABAQUE,estado nutricional en menores de 5 anos,clasificacion d,2003-07-01,32,21,32,21,53
40901,SABAYA,estado nutricional en menores de 5 anos,clasificacion d,2003-07-01,1,14,1,14,15
31001,SACABA,estado nutricional en menores de 5 anos,clasificacion d,2003-07-01,143,140,143,140,283
30404,SACABAMBA,estado nutricional en menores de 5 anos,clasificacion d,2003-07-01,12,30,12,30,42
50701,SACACA,estado nutricional en menores de 5 anos,clasificacion d,2003-07-01,218,460,218,460,678
71302,SAIPINA,estado nutricional en menores de 5 anos,clasificacion d,2003-07-01,11,27,11,27,38
40801,SALINAS DE GARCI MENDOZA,estado nutricional en menores de 5 anos,clasificacion d,2003-07-01,15,28,15,28,43
70901,SAMAIPATA,estado nutricional en menores de 5 anos,clasificacion d,2003-07-01,21,19,21,19,40
51601,SAN AGUSTIN,estado nutricional en menores de 5 anos,clasificacion d,2003-07-01,6,3,6,3,9
80602,SAN ANDRES,estado nutricional en menores de 5 anos,clasificacion d,2003-07-01,32,25,32,25,57
51003,SAN ANTONIO DE ESMORUCO,estado nutricional en menores de 5 anos,clasificacion d,2003-07-01,0,3,0,3,3
71105,SAN ANTONIO DE LOMERIO,estado nutricional en menores de 5 anos,clasificacion d,2003-07-01,81,108,81,108,189
31403,SAN BENITO,estado nutricional en menores de 5 anos,clasificacion d,2003-07-01,31,16,31,16,47
80302,SAN BORJA,estado nutricional en menores de 5 anos,clasificacion d,2003-07-01,113,118,113,118,231
21502,SAN BUENA VENTURA,estado nutricional en menores de 5 anos,clasificacion d,2003-07-01,49,46,49,46,95
70402,SAN CARLOS,estado nutricional en menores de 5 anos,clasificacion d,2003-07-01,90,100,90,100,190
80501,SAN IGNACIO,estado nutricional en menores de 5 anos,clasificacion d,2003-07-01,78,62,78,62,140
70301,SAN IGNACIO DE VELASCO,estado nutricional en menores de 5 anos,clasificacion d,2003-07-01,243,171,243,171,414
80102,SAN JAVIER(BNI),estado nutricional en menores de 5 anos,clasificacion d,2003-07-01,15,22,15,22,37
71102,SAN JAVIER(STC),estado nutricional en menores de 5 anos,clasificacion d,2003-07-01,43,63,43,63,106
80701,SAN JOAQUIN,estado nutricional en menores de 5 anos,clasificacion d,2003-07-01,7,17,7,17,24
70501,SAN JOSE DE CHIQUITOS,estado nutricional en menores de 5 anos,clasificacion d,2003-07-01,38,26,38,26,64
71104,SAN JULIAN,estado nutricional en menores de 5 anos,clasificacion d,2003-07-01,96,157,96,157,253
90302,SAN LORENZO(PND),estado nutricional en menores de 5 anos,clasificacion d,2003-07-01,5,8,5,8,13
60501,SAN LORENZO(TJA),estado nutricional en menores de 5 anos,clasificacion d,2003-07-01,44,51,44,51,95
10702,SAN LUCAS,estado nutricional en menores de 5 anos,clasificacion d,2003-07-01,312,372,312,372,684
70302,SAN MIGUEL DE VELASCO,estado nutricional en menores de 5 anos,clasificacion d,2003-07-01,43,50,43,50,93
51001,SAN PABLO DE LIPEZ,estado nutricional en menores de 5 anos,clasificacion d,2003-07-01,7,13,7,13,20
50501,SAN PEDRO DE BUENA VISTA,estado nutricional en menores de 5 anos,clasificacion d,2003-07-01,130,196,130,196,326
21801,SAN PEDRO DE CURAHUARA,estado nutricional en menores de 5 anos,clasificacion d,2003-07-01,19,17,19,17,36
50902,SAN PEDRO DE QUEMES,estado nutricional en menores de 5 anos,clasificacion d,2003-07-01,1,1,1,1,2
21702,SAN PEDRO DE TIQUINA,estado nutricional en menores de 5 anos,clasificacion d,2003-07-01,8,17,8,17,25
70303,SAN RAFAEL,estado nutricional en menores de 5 anos,clasificacion d,2003-07-01,36,34,36,34,70
80702,SAN RAMON,estado nutricional en menores de 5 anos,clasificacion d,2003-07-01,0,16,0,16,16
80702,SAN RAMON,estado nutricional en menores de 5 anos,clasificacion d,2003-07-01,11,29,11,29,40
80401,SANTA ANA,estado nutricional en menores de 5 anos,clasificacion d,2003-07-01,24,24,24,24,48
70101,SANTA CRUZ DE LA SIERRA,estado nutricional en menores de 5 anos,clasificacion d,2003-07-01,837,406,837,406,1243
80303,SANTA ROSA,estado nutricional en menores de 5 anos,clasificacion d,2003-07-01,12,4,12,4,16
70602,SANTA ROSA DEL SARA,estado nutricional en menores de 5 anos,clasificacion d,2003-07-01,15,18,15,18,33
20308,SANTIAGO DE CALLAPA,estado nutricional en menores de 5 anos,clasificacion d,2003-07-01,22,69,22,69,91
41401,SANTIAGO DE HUARI,estado nutricional en menores de 5 anos,clasificacion d,2003-07-01,11,23,11,23,34
21901,SANTIAGO DE MACHACA,estado nutricional en menores de 5 anos,clasificacion d,2003-07-01,5,8,5,8,13
30702,SANTIVAÃ‘ES,estado nutricional en menores de 5 anos,clasificacion d,2003-07-01,32,16,32,16,48
40202,SANTUARIO DE QUILLACAS,estado nutricional en menores de 5 anos,clasificacion d,2003-07-01,7,13,7,13,20
20902,SAPAHAQUI,estado nutricional en menores de 5 anos,clasificacion d,2003-07-01,31,33,31,33,64
90303,SENA,estado nutricional en menores de 5 anos,clasificacion d,2003-07-01,13,7,13,7,20
21301,SICA SICA (VILLA AROMA),estado nutricional en menores de 5 anos,clasificacion d,2003-07-01,87,62,87,62,149
30703,SICAYA,estado nutricional en menores de 5 anos,clasificacion d,2003-07-01,21,20,21,20,41
30902,SIPE SIPE,estado nutricional en menores de 5 anos,clasificacion d,2003-07-01,124,121,124,121,245
10403,SOPACHUY,estado nutricional en menores de 5 anos,clasificacion d,2003-07-01,58,80,58,80,138
20601,SORATA,estado nutricional en menores de 5 anos,clasificacion d,2003-07-01,63,87,63,87,150
10101,SUCRE,estado nutricional en menores de 5 anos,clasificacion d,2003-07-01,650,709,650,709,1359
31404,TACACHI,estado nutricional en menores de 5 anos,clasificacion d,2003-07-01,8,5,8,5,13
20603,TACACOMA,estado nutricional en menores de 5 anos,clasificacion d,2003-07-01,21,24,21,24,45
50303,TACOBAMBA,estado nutricional en menores de 5 anos,clasificacion d,2003-07-01,61,53,61,53,114
30602,TACOPAYA,estado nutricional en menores de 5 anos,clasificacion d,2003-07-01,55,96,55,96,151
51402,TAHUA,estado nutricional en menores de 5 anos,clasificacion d,2003-07-01,4,4,4,4,8
31101,TAPACARI,estado nutricional en menores de 5 anos,clasificacion d,2003-07-01,103,70,103,70,173
10601,TARABUCO,estado nutricional en menores de 5 anos,clasificacion d,2003-07-01,302,498,302,498,800
30401,TARATA,estado nutricional en menores de 5 anos,clasificacion d,2003-07-01,24,33,24,33,57
60101,TARIJA,estado nutricional en menores de 5 anos,clasificacion d,2003-07-01,394,342,394,342,736
10202,TARVITA,estado nutricional en menores de 5 anos,clasificacion d,2003-07-01,126,220,126,220,346
20803,TIAWANACU,estado nutricional en menores de 5 anos,clasificacion d,2003-07-01,20,17,20,17,37
50102,TINGUIPAYA,estado nutricional en menores de 5 anos,clasificacion d,2003-07-01,63,60,63,60,123
20606,TIPUANI,estado nutricional en menores de 5 anos,clasificacion d,2003-07-01,8,3,8,3,11
30903,TIQUIPAYA,estado nutricional en menores de 5 anos,clasificacion d,2003-07-01,21,11,21,11,32
31601,TIRAQUE (CBBA),estado nutricional en menores de 5 anos,clasificacion d,2003-07-01,131,137,131,137,268
21703,TITO YUPANQUI (PARQUIPUJIO),estado nutricional en menores de 5 anos,clasificacion d,2003-07-01,2,6,2,6,8
30802,TOCO,estado nutricional en menores de 5 anos,clasificacion d,2003-07-01,0,12,0,12,12
30803,TOLATA,estado nutricional en menores de 5 anos,clasificacion d,2003-07-01,7,4,7,4,11
41001,TOLEDO,estado nutricional en menores de 5 anos,clasificacion d,2003-07-01,10,13,10,13,23
51202,TOMAVE,estado nutricional en menores de 5 anos,clasificacion d,2003-07-01,39,61,39,61,100
10402,TOMINA,estado nutricional en menores de 5 anos,clasificacion d,2003-07-01,101,214,101,214,315
50502,TORO TORO,estado nutricional en menores de 5 anos,clasificacion d,2003-07-01,96,97,96,97,193
31201,TOTORA(CBBA),estado nutricional en menores de 5 anos,clasificacion d,2003-07-01,49,50,49,50,99
41301,TOTORA(ORR),estado nutricional en menores de 5 anos,clasificacion d,2003-07-01,22,21,22,21,43
70802,TRIGAL,estado nutricional en menores de 5 anos,clasificacion d,2003-07-01,4,4,4,4,8
80101,TRINIDAD,estado nutricional en menores de 5 anos,clasificacion d,2003-07-01,164,130,164,130,294
50801,TUPIZA,estado nutricional en menores de 5 anos,clasificacion d,2003-07-01,99,226,99,226,325
40402,TURCO,estado nutricional en menores de 5 anos,clasificacion d,2003-07-01,4,5,4,5,9
21302,UMALA,estado nutricional en menores de 5 anos,clasificacion d,2003-07-01,4,4,4,4,8
50201,UNCIA,estado nutricional en menores de 5 anos,clasificacion d,2003-07-01,21,15,21,15,36
60401,URIONDO (A. CONCEPCION),estado nutricional en menores de 5 anos,clasificacion d,2003-07-01,30,56,30,56,86
71502,URUBICHA,estado nutricional en menores de 5 anos,clasificacion d,2003-07-01,11,25,11,25,36
51201,UYUNI,estado nutricional en menores de 5 anos,clasificacion d,2003-07-01,80,114,80,114,194
30502,VACAS,estado nutricional en menores de 5 anos,clasificacion d,2003-07-01,48,11,48,11,59
70801,VALLEGRANDE,estado nutricional en menores de 5 anos,clasificacion d,2003-07-01,51,51,51,51,102
20801,VIACHA,estado nutricional en menores de 5 anos,clasificacion d,2003-07-01,105,60,105,60,165
31302,VILA VILA,estado nutricional en menores de 5 anos,clasificacion d,2003-07-01,8,7,8,7,15
60303,VILLA MONTES,estado nutricional en menores de 5 anos,clasificacion d,2003-07-01,80,86,80,86,166
31402,VILLA RIVERO,estado nutricional en menores de 5 anos,clasificacion d,2003-07-01,10,10,10,10,20
10801,VILLA SERRANO,estado nutricional en menores de 5 anos,clasificacion d,2003-07-01,112,253,112,253,365
31003,VILLA TUNARI,estado nutricional en menores de 5 anos,clasificacion d,2003-07-01,176,147,176,147,323
11001,VILLA VACA GUZMAN (MUYUPAMPA),estado nutricional en menores de 5 anos,clasificacion d,2003-07-01,49,74,49,74,123
51501,VILLAZON,estado nutricional en menores de 5 anos,clasificacion d,2003-07-01,107,140,107,140,247
30904,VINTO,estado nutricional en menores de 5 anos,clasificacion d,2003-07-01,66,21,66,21,87
50602,VITICHI,estado nutricional en menores de 5 anos,clasificacion d,2003-07-01,56,79,56,79,135
20306,WALDO BALLIVIAN,estado nutricional en menores de 5 anos,clasificacion d,2003-07-01,1,1,1,1,2
20903,YACO,estado nutricional en menores de 5 anos,clasificacion d,2003-07-01,23,29,23,29,52
60301,YACUIBA,estado nutricional en menores de 5 anos,clasificacion d,2003-07-01,77,63,77,63,140
10602,YAMPARAEZ,estado nutricional en menores de 5 anos,clasificacion d,2003-07-01,142,282,142,282,424
21103,YANACACHI,estado nutricional en menores de 5 anos,clasificacion d,2003-07-01,7,12,7,12,19
70403,YAPACANI,estado nutricional en menores de 5 anos,clasificacion d,2003-07-01,109,151,109,151,260
50103,YOCALLA,estado nutricional en menores de 5 anos,clasificacion d,2003-07-01,22,36,22,36,58
10102,YOTALA,estado nutricional en menores de 5 anos,clasificacion d,2003-07-01,61,208,61,208,269
60402,YUNCHARA,estado nutricional en menores de 5 anos,clasificacion d,2003-07-01,24,34,24,34,58
10301,ZUDAÃ‘EZ,estado nutricional en menores de 5 anos,clasificacion d,2003-07-01,62,125,62,125,187
51302,ACACIO,estado nutricional en menores de 5 anos,clasificacion d,2003-08-01,67,108,67,108,175
20201,ACHACACHI,estado nutricional en menores de 5 anos,clasificacion d,2003-08-01,100,105,100,105,205
20104,ACHOCALLA,estado nutricional en menores de 5 anos,clasificacion d,2003-08-01,21,16,21,16,37
30201,AIQUILE,estado nutricional en menores de 5 anos,clasificacion d,2003-08-01,42,54,42,54,96
31303,ALALAY,estado nutricional en menores de 5 anos,clasificacion d,2003-08-01,12,8,12,8,20
10404,ALCALA,estado nutricional en menores de 5 anos,clasificacion d,2003-08-01,32,70,32,70,102
20202,ANCORAIMES,estado nutricional en menores de 5 anos,clasificacion d,2003-08-01,51,89,51,89,140
41201,ANDAMARCA,estado nutricional en menores de 5 anos,clasificacion d,2003-08-01,7,4,7,4,11
30402,ANZALDO,estado nutricional en menores de 5 anos,clasificacion d,2003-08-01,9,46,9,46,55
20701,APOLO,estado nutricional en menores de 5 anos,clasificacion d,2003-08-01,46,53,46,53,99
51301,ARAMPAMPA,estado nutricional en menores de 5 anos,clasificacion d,2003-08-01,38,98,38,98,136
30501,ARANI,estado nutricional en menores de 5 anos,clasificacion d,2003-08-01,21,34,21,34,55
30403,ARBIETO,estado nutricional en menores de 5 anos,clasificacion d,2003-08-01,5,13,5,13,18
30601,ARQUE,estado nutricional en menores de 5 anos,clasificacion d,2003-08-01,35,38,35,38,73
71501,ASCENCION DE GUARAYOS,estado nutricional en menores de 5 anos,clasificacion d,2003-08-01,211,270,211,270,481
50802,ATOCHA,estado nutricional en menores de 5 anos,clasificacion d,2003-08-01,46,117,46,117,163
20503,AUCAPATA,estado nutricional en menores de 5 anos,clasificacion d,2003-08-01,39,51,39,51,90
20502,AYATA,estado nutricional en menores de 5 anos,clasificacion d,2003-08-01,22,12,22,12,34
21303,AYO AYO,estado nutricional en menores de 5 anos,clasificacion d,2003-08-01,16,4,16,4,20
30301,AYOPAYA (V. DE INDEPENDENCIA),estado nutricional en menores de 5 anos,clasificacion d,2003-08-01,109,127,109,127,236
10201,AZURDUY,estado nutricional en menores de 5 anos,clasificacion d,2003-08-01,170,326,170,326,496
21203,BATALLAS,estado nutricional en menores de 5 anos,clasificacion d,2003-08-01,32,22,32,22,54
80802,BAURES,estado nutricional en menores de 5 anos,clasificacion d,2003-08-01,16,16,16,16,32
41202,BELEN DE ANDAMARCA,estado nutricional en menores de 5 anos,clasificacion d,2003-08-01,1,0,1,0,1
50104,BELEN DE URMIRI,estado nutricional en menores de 5 anos,clasificacion d,2003-08-01,14,22,14,22,36
90104,BELLA FLOR,estado nutricional en menores de 5 anos,clasificacion d,2003-08-01,24,22,24,22,46
60202,BERMEJO,estado nutricional en menores de 5 anos,clasificacion d,2003-08-01,14,19,14,19,33
50301,BETANZOS,estado nutricional en menores de 5 anos,clasificacion d,2003-08-01,232,309,232,309,541
31501,BOLIVAR,estado nutricional en menores de 5 anos,clasificacion d,2003-08-01,66,77,66,77,143
90103,BOLPEBRA,estado nutricional en menores de 5 anos,clasificacion d,2003-08-01,0,6,0,6,6
70707,BOYUIBE,estado nutricional en menores de 5 anos,clasificacion d,2003-08-01,11,25,11,25,36
70401,BUENA VISTA,estado nutricional en menores de 5 anos,clasificacion d,2003-08-01,21,34,21,34,55
70703,CABEZAS,estado nutricional en menores de 5 anos,clasificacion d,2003-08-01,6,5,6,5,11
20905,CAIROMA,estado nutricional en menores de 5 anos,clasificacion d,2003-08-01,74,60,74,60,134
51102,"CAIZA ""D""",estado nutricional en menores de 5 anos,clasificacion d,2003-08-01,71,66,71,66,137
21003,CAJUATA,estado nutricional en menores de 5 anos,clasificacion d,2003-08-01,42,30,42,30,72
20303,CALACOTO,estado nutricional en menores de 5 anos,clasificacion d,2003-08-01,21,20,21,20,41
21304,CALAMARCA,estado nutricional en menores de 5 anos,clasificacion d,2003-08-01,185,146,185,146,331
10701,CAMARGO,estado nutricional en menores de 5 anos,clasificacion d,2003-08-01,60,67,60,67,127
10901,CAMATAQUI (C. VILLA ABECIA),estado nutricional en menores de 5 anos,clasificacion d,2003-08-01,21,17,21,17,38
70706,CAMIRI,estado nutricional en menores de 5 anos,clasificacion d,2003-08-01,95,94,95,94,189
30701,CAPINOTA,estado nutricional en menores de 5 anos,clasificacion d,2003-08-01,25,40,25,40,65
20302,CAQUIAVIRI,estado nutricional en menores de 5 anos,clasificacion d,2003-08-01,29,30,29,30,59
40102,CARACOLLO,estado nutricional en menores de 5 anos,clasificacion d,2003-08-01,47,42,47,42,89
22001,CARANAVI,estado nutricional en menores de 5 anos,clasificacion d,2003-08-01,153,128,153,128,281
41503,CARANGAS,estado nutricional en menores de 5 anos,clasificacion d,2003-08-01,0,3,0,3,3
60302,CARAPARI,estado nutricional en menores de 5 anos,clasificacion d,2003-08-01,33,22,33,22,55
50702,CARIPUYO,estado nutricional en menores de 5 anos,clasificacion d,2003-08-01,102,135,102,135,237
21902,CATACORA,estado nutricional en menores de 5 anos,clasificacion d,2003-08-01,4,6,4,6,10
40201,CHALLAPATA,estado nutricional en menores de 5 anos,clasificacion d,2003-08-01,92,108,92,108,200
50302,CHAQUI,estado nutricional en menores de 5 anos,clasificacion d,2003-08-01,34,48,34,48,82
70702,CHARAGUA,estado nutricional en menores de 5 anos,clasificacion d,2003-08-01,107,117,107,117,224
20305,CHARAÃ‘A,estado nutricional en menores de 5 anos,clasificacion d,2003-08-01,3,5,3,5,8
50202,CHAYANTA,estado nutricional en menores de 5 anos,clasificacion d,2003-08-01,36,45,36,45,81
31204,CHIMORE,estado nutricional en menores de 5 anos,clasificacion d,2003-08-01,19,9,19,9,28
40903,CHIPAYA,estado nutricional en menores de 5 anos,clasificacion d,2003-08-01,1,1,1,1,2
40302,CHOQUE COTA,estado nutricional en menores de 5 anos,clasificacion d,2003-08-01,9,10,9,10,19
21101,CHULUMANI (V. DE LA LIBERTAD),estado nutricional en menores de 5 anos,clasificacion d,2003-08-01,11,20,11,20,31
20501,CHUMA,estado nutricional en menores de 5 anos,clasificacion d,2003-08-01,30,4,30,4,34
30801,CLIZA,estado nutricional en menores de 5 anos,clasificacion d,2003-08-01,7,7,7,7,14
90101,COBIJA,estado nutricional en menores de 5 anos,clasificacion d,2003-08-01,78,90,78,90,168
30101,COCHABAMBA,estado nutricional en menores de 5 anos,clasificacion d,2003-08-01,441,362,441,362,803
40902,COIPASA,estado nutricional en menores de 5 anos,clasificacion d,2003-08-01,0,1,0,1,1
30905,COLCAPIRHUA,estado nutricional en menores de 5 anos,clasificacion d,2003-08-01,55,38,55,38,93
50901,"COLCHA ""K""",estado nutricional en menores de 5 anos,clasificacion d,2003-08-01,44,62,44,62,106
21307,COLLANA,estado nutricional en menores de 5 anos,clasificacion d,2003-08-01,5,1,5,1,6
31002,COLOMI,estado nutricional en menores de 5 anos,clasificacion d,2003-08-01,51,65,51,65,116
50401,COLQUECHACA,estado nutricional en menores de 5 anos,clasificacion d,2003-08-01,207,131,207,131,338
21306,COLQUENCHA,estado nutricional en menores de 5 anos,clasificacion d,2003-08-01,25,11,25,11,36
21004,COLQUIRI,estado nutricional en menores de 5 anos,clasificacion d,2003-08-01,90,63,90,63,153
20304,COMANCHE,estado nutricional en menores de 5 anos,clasificacion d,2003-08-01,5,3,5,3,8
71301,COMARAPA,estado nutricional en menores de 5 anos,clasificacion d,2003-08-01,66,47,66,47,113
20605,COMBAYA,estado nutricional en menores de 5 anos,clasificacion d,2003-08-01,13,9,13,9,22
71101,CONCEPCION,estado nutricional en menores de 5 anos,clasificacion d,2003-08-01,11,72,11,72,83
21701,COPACABANA,estado nutricional en menores de 5 anos,clasificacion d,2003-08-01,22,25,22,25,47
21402,CORIPATA,estado nutricional en menores de 5 anos,clasificacion d,2003-08-01,2,0,2,0,2
20301,CORO CORO,estado nutricional en menores de 5 anos,clasificacion d,2003-08-01,37,40,37,40,77
21401,COROICO,estado nutricional en menores de 5 anos,clasificacion d,2003-08-01,19,27,19,27,46
40301,CORQUE,estado nutricional en menores de 5 anos,clasificacion d,2003-08-01,18,3,18,3,21
50601,COTAGAITA,estado nutricional en menores de 5 anos,clasificacion d,2003-08-01,197,315,197,315,512
31405,CUCHUMUELA (V. G. VILLARROEL),estado nutricional en menores de 5 anos,clasificacion d,2003-08-01,4,6,4,6,10
70704,CUEVO,estado nutricional en menores de 5 anos,clasificacion d,2003-08-01,6,10,6,10,16
10902,CULPINA,estado nutricional en menores de 5 anos,clasificacion d,2003-08-01,148,185,148,185,333
40401,CURAHUARA DE CARANGAS,estado nutricional en menores de 5 anos,clasificacion d,2003-08-01,26,25,26,25,51
21602,CURVA,estado nutricional en menores de 5 anos,clasificacion d,2003-08-01,11,12,11,12,23
20804,DESAGUADERO,estado nutricional en menores de 5 anos,clasificacion d,2003-08-01,14,8,14,8,22
20105,EL ALTO,estado nutricional en menores de 5 anos,clasificacion d,2003-08-01,1742,1124,1742,1124,2866
40103,EL CHORO,estado nutricional en menores de 5 anos,clasificacion d,2003-08-01,4,3,4,3,7
71503,EL PUENTE(STC),estado nutricional en menores de 5 anos,clasificacion d,2003-08-01,8,73,8,73,81
60502,EL PUENTE(TJA),estado nutricional en menores de 5 anos,clasificacion d,2003-08-01,60,168,60,168,228
70105,EL TORNO,estado nutricional en menores de 5 anos,clasificacion d,2003-08-01,56,60,56,60,116
10405,EL VILLAR,estado nutricional en menores de 5 anos,clasificacion d,2003-08-01,51,124,51,124,175
60601,ENTRE RIOS,estado nutricional en menores de 5 anos,clasificacion d,2003-08-01,57,105,57,105,162
41101,EUCALIPTUS,estado nutricional en menores de 5 anos,clasificacion d,2003-08-01,21,30,21,30,51
80402,EXALTACION,estado nutricional en menores de 5 anos,clasificacion d,2003-08-01,17,23,17,23,40
90203,FILADELFIA,estado nutricional en menores de 5 anos,clasificacion d,2003-08-01,3,7,3,7,10
71002,GENERAL SAAVEDRA,estado nutricional en menores de 5 anos,clasificacion d,2003-08-01,67,69,67,69,136
21601,GRAL. J.J. PEREZ (CHARAZANI),estado nutricional en menores de 5 anos,clasificacion d,2003-08-01,38,62,38,62,100
20602,GUANAY,estado nutricional en menores de 5 anos,clasificacion d,2003-08-01,94,131,94,131,225
20802,GUAQUI,estado nutricional en menores de 5 anos,clasificacion d,2003-08-01,13,8,13,8,21
80202,GUAYARAMERIN,estado nutricional en menores de 5 anos,clasificacion d,2003-08-01,90,65,90,65,155
70705,GUTIERREZ,estado nutricional en menores de 5 anos,clasificacion d,2003-08-01,83,157,83,157,240
10502,HUACARETA,estado nutricional en menores de 5 anos,clasificacion d,2003-08-01,70,112,70,112,182
11002,HUACAYA (VILLA DE HUACAYA),estado nutricional en menores de 5 anos,clasificacion d,2003-08-01,16,41,16,41,57
40501,HUACHACALLA,estado nutricional en menores de 5 anos,clasificacion d,2003-08-01,5,0,5,0,5
40701,HUANUNI,estado nutricional en menores de 5 anos,clasificacion d,2003-08-01,39,36,39,36,75
80803,HUARACAJE,estado nutricional en menores de 5 anos,clasificacion d,2003-08-01,2,5,2,5,7
41601,HUAYLLAMARCA,estado nutricional en menores de 5 anos,clasificacion d,2003-08-01,6,15,6,15,21
21005,ICHOCA,estado nutricional en menores de 5 anos,clasificacion d,2003-08-01,18,16,18,16,34
10304,ICLA,estado nutricional en menores de 5 anos,clasificacion d,2003-08-01,103,170,103,170,273
10703,INCAHUASI,estado nutricional en menores de 5 anos,clasificacion d,2003-08-01,166,174,166,174,340
21001,INQUISIVI,estado nutricional en menores de 5 anos,clasificacion d,2003-08-01,97,95,97,95,192
21102,IRUPANA (VILLA DE LANZA),estado nutricional en menores de 5 anos,clasificacion d,2003-08-01,30,65,30,65,95
21501,IXIAMAS,estado nutricional en menores de 5 anos,clasificacion d,2003-08-01,24,40,24,40,64
21105,LA ASUNTA,estado nutricional en menores de 5 anos,clasificacion d,2003-08-01,44,31,44,31,75
70104,LA GUARDIA,estado nutricional en menores de 5 anos,clasificacion d,2003-08-01,45,35,45,35,80
20101,LA PAZ,estado nutricional en menores de 5 anos,clasificacion d,2003-08-01,1266,929,1266,929,2195
70701,LAGUNILLAS,estado nutricional en menores de 5 anos,clasificacion d,2003-08-01,23,41,23,41,64
21202,LAJA,estado nutricional en menores de 5 anos,clasificacion d,2003-08-01,9,7,9,7,16
10903,LAS CARRERAS,estado nutricional en menores de 5 anos,clasificacion d,2003-08-01,13,28,13,28,41
21006,LICOMA PAMPA,estado nutricional en menores de 5 anos,clasificacion d,2003-08-01,7,5,7,5,12
50203,LLALLAGUA,estado nutricional en menores de 5 anos,clasificacion d,2003-08-01,11,279,11,279,290
51401,LLICA,estado nutricional en menores de 5 anos,clasificacion d,2003-08-01,8,5,8,5,13
80601,LORETO,estado nutricional en menores de 5 anos,clasificacion d,2003-08-01,3,17,3,17,20
20901,LURIBAY,estado nutricional en menores de 5 anos,clasificacion d,2003-08-01,51,37,51,37,88
40702,MACHACAMARCA,estado nutricional en menores de 5 anos,clasificacion d,2003-08-01,14,7,14,7,21
11003,MACHARETI,estado nutricional en menores de 5 anos,clasificacion d,2003-08-01,29,81,29,81,110
80801,MAGDALENA,estado nutricional en menores de 5 anos,clasificacion d,2003-08-01,30,19,30,19,49
70903,MAIRANA,estado nutricional en menores de 5 anos,clasificacion d,2003-08-01,13,16,13,16,29
20904,MALLA,estado nutricional en menores de 5 anos,clasificacion d,2003-08-01,8,13,8,13,21
20103,MECAPACA,estado nutricional en menores de 5 anos,clasificacion d,2003-08-01,5,7,5,7,12
71003,MINEROS,estado nutricional en menores de 5 anos,clasificacion d,2003-08-01,127,78,127,78,205
31301,MIZQUE,estado nutricional en menores de 5 anos,clasificacion d,2003-08-01,37,36,37,36,73
20402,MOCOMOCO,estado nutricional en menores de 5 anos,clasificacion d,2003-08-01,36,58,36,58,94
51002,MOJINETE,estado nutricional en menores de 5 anos,clasificacion d,2003-08-01,2,4,2,4,6
10303,MOJOCOYA,estado nutricional en menores de 5 anos,clasificacion d,2003-08-01,59,129,59,129,188
10501,MONTEAGUDO,estado nutricional en menores de 5 anos,clasificacion d,2003-08-01,134,237,134,237,371
71001,MONTERO,estado nutricional en menores de 5 anos,clasificacion d,2003-08-01,196,160,196,160,356
70803,MORO MORO,estado nutricional en menores de 5 anos,clasificacion d,2003-08-01,8,19,8,19,27
30302,MOROCHATA,estado nutricional en menores de 5 anos,clasificacion d,2003-08-01,117,136,117,136,253
20307,NAZACARA DE PACAJES,estado nutricional en menores de 5 anos,clasificacion d,2003-08-01,2,4,2,4,6
50404,OCURI,estado nutricional en menores de 5 anos,clasificacion d,2003-08-01,106,113,106,113,219
30203,OMEREQUE,estado nutricional en menores de 5 anos,clasificacion d,2003-08-01,3,8,3,8,11
40101,ORURO,estado nutricional en menores de 5 anos,clasificacion d,2003-08-01,515,407,515,407,922
60201,PADCAYA,estado nutricional en menores de 5 anos,clasificacion d,2003-08-01,53,97,53,97,150
10401,PADILLA,estado nutricional en menores de 5 anos,clasificacion d,2003-08-01,101,235,101,235,336
70502,PAILON,estado nutricional en menores de 5 anos,clasificacion d,2003-08-01,17,13,17,13,30
20102,PALCA,estado nutricional en menores de 5 anos,clasificacion d,2003-08-01,24,48,24,48,72
21104,PALOS BLANCOS,estado nutricional en menores de 5 anos,clasificacion d,2003-08-01,53,51,53,51,104
40802,PAMPA AULLAGAS,estado nutricional en menores de 5 anos,clasificacion d,2003-08-01,10,20,10,20,30
70902,PAMPA GRANDE,estado nutricional en menores de 5 anos,clasificacion d,2003-08-01,11,8,11,8,19
21802,PAPEL PAMPA,estado nutricional en menores de 5 anos,clasificacion d,2003-08-01,6,7,6,7,13
30202,PASORAPA,estado nutricional en menores de 5 anos,clasificacion d,2003-08-01,9,25,9,25,34
21305,PATACAMAYA,estado nutricional en menores de 5 anos,clasificacion d,2003-08-01,119,86,119,86,205
40602,PAZÃ‘A,estado nutricional en menores de 5 anos,clasificacion d,2003-08-01,15,22,15,22,37
20702,PELECHUCO,estado nutricional en menores de 5 anos,clasificacion d,2003-08-01,26,14,26,14,40
50403,POCOATA,estado nutricional en menores de 5 anos,clasificacion d,2003-08-01,206,228,206,228,434
31203,POCONA,estado nutricional en menores de 5 anos,clasificacion d,2003-08-01,57,52,57,52,109
31202,POJO (CBBA),estado nutricional en menores de 5 anos,clasificacion d,2003-08-01,122,120,122,120,242
40601,POOPO,estado nutricional en menores de 5 anos,clasificacion d,2003-08-01,3,38,3,38,41
51203,PORCO,estado nutricional en menores de 5 anos,clasificacion d,2003-08-01,31,19,31,19,50
10103,POROMA,estado nutricional en menores de 5 anos,clasificacion d,2003-08-01,129,235,129,235,364
70103,PORONGO,estado nutricional en menores de 5 anos,clasificacion d,2003-08-01,22,14,22,14,36
70601,PORTACHUELO,estado nutricional en menores de 5 anos,clasificacion d,2003-08-01,51,64,51,64,115
90102,PORVENIR,estado nutricional en menores de 5 anos,clasificacion d,2003-08-01,9,22,9,22,31
70804,POSTRER VALLE,estado nutricional en menores de 5 anos,clasificacion d,2003-08-01,3,6,3,6,9
50101,POTOSI,estado nutricional en menores de 5 anos,clasificacion d,2003-08-01,608,410,608,410,1018
10302,PRESTO,estado nutricional en menores de 5 anos,clasificacion d,2003-08-01,68,84,68,84,152
70805,PUCARA,estado nutricional en menores de 5 anos,clasificacion d,2003-08-01,2,9,2,9,11
21201,PUCARANI,estado nutricional en menores de 5 anos,clasificacion d,2003-08-01,37,33,37,33,70
20401,PUERTO ACOSTA,estado nutricional en menores de 5 anos,clasificacion d,2003-08-01,68,76,68,76,144
20403,PUERTO CARABUCO,estado nutricional en menores de 5 anos,clasificacion d,2003-08-01,52,100,52,100,152
90301,PUERTO GONZALO MORENO,estado nutricional en menores de 5 anos,clasificacion d,2003-08-01,3,10,3,10,13
21204,PUERTO PEREZ,estado nutricional en menores de 5 anos,clasificacion d,2003-08-01,16,4,16,4,20
71402,PUERTO QUIJARRO,estado nutricional en menores de 5 anos,clasificacion d,2003-08-01,32,11,32,11,43
90201,PUERTO RICO,estado nutricional en menores de 5 anos,clasificacion d,2003-08-01,22,25,22,25,47
80703,PUERTO SILES,estado nutricional en menores de 5 anos,clasificacion d,2003-08-01,2,1,2,1,3
71401,PUERTO SUAREZ,estado nutricional en menores de 5 anos,clasificacion d,2003-08-01,15,16,15,16,31
31205,PUERTO VILLARROEL,estado nutricional en menores de 5 anos,clasificacion d,2003-08-01,139,123,139,123,262
51101,PUNA,estado nutricional en menores de 5 anos,clasificacion d,2003-08-01,3,1,3,1,4
31401,PUNATA,estado nutricional en menores de 5 anos,clasificacion d,2003-08-01,97,55,97,55,152
20604,QUIABAYA,estado nutricional en menores de 5 anos,clasificacion d,2003-08-01,9,16,9,16,25
30901,QUILLACOLLO,estado nutricional en menores de 5 anos,clasificacion d,2003-08-01,133,69,133,69,202
21002,QUIME,estado nutricional en menores de 5 anos,clasificacion d,2003-08-01,41,44,41,44,85
70904,QUIRUSILLAS,estado nutricional en menores de 5 anos,clasificacion d,2003-08-01,2,11,2,11,13
50402,RAVELO,estado nutricional en menores de 5 anos,clasificacion d,2003-08-01,157,165,157,165,322
80301,REYES,estado nutricional en menores de 5 anos,clasificacion d,2003-08-01,13,22,13,22,35
80201,RIBERALTA,estado nutricional en menores de 5 anos,clasificacion d,2003-08-01,313,218,313,218,531
70503,ROBORE,estado nutricional en menores de 5 anos,clasificacion d,2003-08-01,18,23,18,23,41
80304,RURRENABAQUE,estado nutricional en menores de 5 anos,clasificacion d,2003-08-01,29,18,29,18,47
40901,SABAYA,estado nutricional en menores de 5 anos,clasificacion d,2003-08-01,6,5,6,5,11
31001,SACABA,estado nutricional en menores de 5 anos,clasificacion d,2003-08-01,58,45,58,45,103
30404,SACABAMBA,estado nutricional en menores de 5 anos,clasificacion d,2003-08-01,20,72,20,72,92
50701,SACACA,estado nutricional en menores de 5 anos,clasificacion d,2003-08-01,197,347,197,347,544
71302,SAIPINA,estado nutricional en menores de 5 anos,clasificacion d,2003-08-01,18,38,18,38,56
40801,SALINAS DE GARCI MENDOZA,estado nutricional en menores de 5 anos,clasificacion d,2003-08-01,24,25,24,25,49
70901,SAMAIPATA,estado nutricional en menores de 5 anos,clasificacion d,2003-08-01,31,19,31,19,50
51601,SAN AGUSTIN,estado nutricional en menores de 5 anos,clasificacion d,2003-08-01,6,7,6,7,13
80602,SAN ANDRES,estado nutricional en menores de 5 anos,clasificacion d,2003-08-01,10,11,10,11,21
51003,SAN ANTONIO DE ESMORUCO,estado nutricional en menores de 5 anos,clasificacion d,2003-08-01,0,3,0,3,3
71105,SAN ANTONIO DE LOMERIO,estado nutricional en menores de 5 anos,clasificacion d,2003-08-01,82,118,82,118,200
31403,SAN BENITO,estado nutricional en menores de 5 anos,clasificacion d,2003-08-01,18,9,18,9,27
80302,SAN BORJA,estado nutricional en menores de 5 anos,clasificacion d,2003-08-01,122,119,122,119,241
21502,SAN BUENA VENTURA,estado nutricional en menores de 5 anos,clasificacion d,2003-08-01,37,22,37,22,59
70402,SAN CARLOS,estado nutricional en menores de 5 anos,clasificacion d,2003-08-01,88,59,88,59,147
80501,SAN IGNACIO,estado nutricional en menores de 5 anos,clasificacion d,2003-08-01,84,83,84,83,167
70301,SAN IGNACIO DE VELASCO,estado nutricional en menores de 5 anos,clasificacion d,2003-08-01,253,281,253,281,534
80102,SAN JAVIER(BNI),estado nutricional en menores de 5 anos,clasificacion d,2003-08-01,12,4,12,4,16
71102,SAN JAVIER(STC),estado nutricional en menores de 5 anos,clasificacion d,2003-08-01,27,32,27,32,59
80701,SAN JOAQUIN,estado nutricional en menores de 5 anos,clasificacion d,2003-08-01,15,14,15,14,29
70501,SAN JOSE DE CHIQUITOS,estado nutricional en menores de 5 anos,clasificacion d,2003-08-01,34,15,34,15,49
71104,SAN JULIAN,estado nutricional en menores de 5 anos,clasificacion d,2003-08-01,131,192,131,192,323
90302,SAN LORENZO(PND),estado nutricional en menores de 5 anos,clasificacion d,2003-08-01,17,4,17,4,21
60501,SAN LORENZO(TJA),estado nutricional en menores de 5 anos,clasificacion d,2003-08-01,64,74,64,74,138
10702,SAN LUCAS,estado nutricional en menores de 5 anos,clasificacion d,2003-08-01,395,441,395,441,836
71201,SAN MATIAS,estado nutricional en menores de 5 anos,clasificacion d,2003-08-01,42,23,42,23,65
70302,SAN MIGUEL DE VELASCO,estado nutricional en menores de 5 anos,clasificacion d,2003-08-01,59,56,59,56,115
51001,SAN PABLO DE LIPEZ,estado nutricional en menores de 5 anos,clasificacion d,2003-08-01,17,24,17,24,41
50501,SAN PEDRO DE BUENA VISTA,estado nutricional en menores de 5 anos,clasificacion d,2003-08-01,105,174,105,174,279
21801,SAN PEDRO DE CURAHUARA,estado nutricional en menores de 5 anos,clasificacion d,2003-08-01,18,32,18,32,50
50902,SAN PEDRO DE QUEMES,estado nutricional en menores de 5 anos,clasificacion d,2003-08-01,4,3,4,3,7
21702,SAN PEDRO DE TIQUINA,estado nutricional en menores de 5 anos,clasificacion d,2003-08-01,11,5,11,5,16
70303,SAN RAFAEL,estado nutricional en menores de 5 anos,clasificacion d,2003-08-01,28,22,28,22,50
80702,SAN RAMON,estado nutricional en menores de 5 anos,clasificacion d,2003-08-01,9,11,9,11,20
80401,SANTA ANA,estado nutricional en menores de 5 anos,clasificacion d,2003-08-01,38,23,38,23,61
70101,SANTA CRUZ DE LA SIERRA,estado nutricional en menores de 5 anos,clasificacion d,2003-08-01,484,265,484,265,749
80303,SANTA ROSA,estado nutricional en menores de 5 anos,clasificacion d,2003-08-01,25,23,25,23,48
70602,SANTA ROSA DEL SARA,estado nutricional en menores de 5 anos,clasificacion d,2003-08-01,9,28,9,28,37
20308,SANTIAGO DE CALLAPA,estado nutricional en menores de 5 anos,clasificacion d,2003-08-01,21,29,21,29,50
41401,SANTIAGO DE HUARI,estado nutricional en menores de 5 anos,clasificacion d,2003-08-01,33,45,33,45,78
21901,SANTIAGO DE MACHACA,estado nutricional en menores de 5 anos,clasificacion d,2003-08-01,8,8,8,8,16
30702,SANTIVAÃ‘ES,estado nutricional en menores de 5 anos,clasificacion d,2003-08-01,22,21,22,21,43
40202,SANTUARIO DE QUILLACAS,estado nutricional en menores de 5 anos,clasificacion d,2003-08-01,7,8,7,8,15
20902,SAPAHAQUI,estado nutricional en menores de 5 anos,clasificacion d,2003-08-01,59,66,59,66,125
90303,SENA,estado nutricional en menores de 5 anos,clasificacion d,2003-08-01,30,16,30,16,46
21301,SICA SICA (VILLA AROMA),estado nutricional en menores de 5 anos,clasificacion d,2003-08-01,109,72,109,72,181
30703,SICAYA,estado nutricional en menores de 5 anos,clasificacion d,2003-08-01,7,5,7,5,12
30902,SIPE SIPE,estado nutricional en menores de 5 anos,clasificacion d,2003-08-01,121,102,121,102,223
10403,SOPACHUY,estado nutricional en menores de 5 anos,clasificacion d,2003-08-01,60,88,60,88,148
20601,SORATA,estado nutricional en menores de 5 anos,clasificacion d,2003-08-01,52,66,52,66,118
10101,SUCRE,estado nutricional en menores de 5 anos,clasificacion d,2003-08-01,583,646,583,646,1229
31404,TACACHI,estado nutricional en menores de 5 anos,clasificacion d,2003-08-01,9,7,9,7,16
20603,TACACOMA,estado nutricional en menores de 5 anos,clasificacion d,2003-08-01,28,37,28,37,65
50303,TACOBAMBA,estado nutricional en menores de 5 anos,clasificacion d,2003-08-01,56,63,56,63,119
30602,TACOPAYA,estado nutricional en menores de 5 anos,clasificacion d,2003-08-01,111,127,111,127,238
51402,TAHUA,estado nutricional en menores de 5 anos,clasificacion d,2003-08-01,2,2,2,2,4
31101,TAPACARI,estado nutricional en menores de 5 anos,clasificacion d,2003-08-01,133,134,133,134,267
10601,TARABUCO,estado nutricional en menores de 5 anos,clasificacion d,2003-08-01,302,475,302,475,777
30401,TARATA,estado nutricional en menores de 5 anos,clasificacion d,2003-08-01,13,37,13,37,50
60101,TARIJA,estado nutricional en menores de 5 anos,clasificacion d,2003-08-01,263,286,263,286,549
10202,TARVITA,estado nutricional en menores de 5 anos,clasificacion d,2003-08-01,176,353,176,353,529
20803,TIAWANACU,estado nutricional en menores de 5 anos,clasificacion d,2003-08-01,10,12,10,12,22
50102,TINGUIPAYA,estado nutricional en menores de 5 anos,clasificacion d,2003-08-01,123,156,123,156,279
20606,TIPUANI,estado nutricional en menores de 5 anos,clasificacion d,2003-08-01,14,7,14,7,21
30903,TIQUIPAYA,estado nutricional en menores de 5 anos,clasificacion d,2003-08-01,64,38,64,38,102
31601,TIRAQUE (CBBA),estado nutricional en menores de 5 anos,clasificacion d,2003-08-01,137,132,137,132,269
21703,TITO YUPANQUI (PARQUIPUJIO),estado nutricional en menores de 5 anos,clasificacion d,2003-08-01,4,3,4,3,7
30802,TOCO,estado nutricional en menores de 5 anos,clasificacion d,2003-08-01,0,7,0,7,7
30803,TOLATA,estado nutricional en menores de 5 anos,clasificacion d,2003-08-01,10,29,10,29,39
41001,TOLEDO,estado nutricional en menores de 5 anos,clasificacion d,2003-08-01,13,15,13,15,28
51202,TOMAVE,estado nutricional en menores de 5 anos,clasificacion d,2003-08-01,52,73,52,73,125
10402,TOMINA,estado nutricional en menores de 5 anos,clasificacion d,2003-08-01,109,235,109,235,344
50502,TORO TORO,estado nutricional en menores de 5 anos,clasificacion d,2003-08-01,104,118,104,118,222
31201,TOTORA(CBBA),estado nutricional en menores de 5 anos,clasificacion d,2003-08-01,58,51,58,51,109
41301,TOTORA(ORR),estado nutricional en menores de 5 anos,clasificacion d,2003-08-01,21,26,21,26,47
70802,TRIGAL,estado nutricional en menores de 5 anos,clasificacion d,2003-08-01,2,3,2,3,5
80101,TRINIDAD,estado nutricional en menores de 5 anos,clasificacion d,2003-08-01,157,138,157,138,295
50801,TUPIZA,estado nutricional en menores de 5 anos,clasificacion d,2003-08-01,96,267,96,267,363
40402,TURCO,estado nutricional en menores de 5 anos,clasificacion d,2003-08-01,8,15,8,15,23
21302,UMALA,estado nutricional en menores de 5 anos,clasificacion d,2003-08-01,29,51,29,51,80
50201,UNCIA,estado nutricional en menores de 5 anos,clasificacion d,2003-08-01,19,9,19,9,28
60401,URIONDO (A. CONCEPCION),estado nutricional en menores de 5 anos,clasificacion d,2003-08-01,51,99,51,99,150
71502,URUBICHA,estado nutricional en menores de 5 anos,clasificacion d,2003-08-01,104,178,104,178,282
51201,UYUNI,estado nutricional en menores de 5 anos,clasificacion d,2003-08-01,63,88,63,88,151
30502,VACAS,estado nutricional en menores de 5 anos,clasificacion d,2003-08-01,51,26,51,26,77
70801,VALLEGRANDE,estado nutricional en menores de 5 anos,clasificacion d,2003-08-01,26,36,26,36,62
20801,VIACHA,estado nutricional en menores de 5 anos,clasificacion d,2003-08-01,84,52,84,52,136
31302,VILA VILA,estado nutricional en menores de 5 anos,clasificacion d,2003-08-01,22,35,22,35,57
60303,VILLA MONTES,estado nutricional en menores de 5 anos,clasificacion d,2003-08-01,44,33,44,33,77
31402,VILLA RIVERO,estado nutricional en menores de 5 anos,clasificacion d,2003-08-01,21,21,21,21,42
10801,VILLA SERRANO,estado nutricional en menores de 5 anos,clasificacion d,2003-08-01,133,266,133,266,399
31003,VILLA TUNARI,estado nutricional en menores de 5 anos,clasificacion d,2003-08-01,143,121,143,121,264
11001,VILLA VACA GUZMAN (MUYUPAMPA),estado nutricional en menores de 5 anos,clasificacion d,2003-08-01,41,60,41,60,101
51501,VILLAZON,estado nutricional en menores de 5 anos,clasificacion d,2003-08-01,127,182,127,182,309
30904,VINTO,estado nutricional en menores de 5 anos,clasificacion d,2003-08-01,35,25,35,25,60
50602,VITICHI,estado nutricional en menores de 5 anos,clasificacion d,2003-08-01,116,215,116,215,331
20306,WALDO BALLIVIAN,estado nutricional en menores de 5 anos,clasificacion d,2003-08-01,6,4,6,4,10
20903,YACO,estado nutricional en menores de 5 anos,clasificacion d,2003-08-01,33,17,33,17,50
60301,YACUIBA,estado nutricional en menores de 5 anos,clasificacion d,2003-08-01,77,68,77,68,145
10602,YAMPARAEZ,estado nutricional en menores de 5 anos,clasificacion d,2003-08-01,156,298,156,298,454
21103,YANACACHI,estado nutricional en menores de 5 anos,clasificacion d,2003-08-01,9,6,9,6,15
70403,YAPACANI,estado nutricional en menores de 5 anos,clasificacion d,2003-08-01,122,128,122,128,250
50103,YOCALLA,estado nutricional en menores de 5 anos,clasificacion d,2003-08-01,21,32,21,32,53
10102,YOTALA,estado nutricional en menores de 5 anos,clasificacion d,2003-08-01,99,187,99,187,286
60402,YUNCHARA,estado nutricional en menores de 5 anos,clasificacion d,2003-08-01,32,69,32,69,101
10301,ZUDAÃ‘EZ,estado nutricional en menores de 5 anos,clasificacion d,2003-08-01,59,128,59,128,187
51302,ACACIO,estado nutricional en menores de 5 anos,clasificacion d,2003-09-01,41,86,41,86,127
20201,ACHACACHI,estado nutricional en menores de 5 anos,clasificacion d,2003-09-01,135,142,135,142,277
20104,ACHOCALLA,estado nutricional en menores de 5 anos,clasificacion d,2003-09-01,13,23,13,23,36
30201,AIQUILE,estado nutricional en menores de 5 anos,clasificacion d,2003-09-01,62,46,62,46,108
31303,ALALAY,estado nutricional en menores de 5 anos,clasificacion d,2003-09-01,9,6,9,6,15
10404,ALCALA,estado nutricional en menores de 5 anos,clasificacion d,2003-09-01,32,78,32,78,110
20202,ANCORAIMES,estado nutricional en menores de 5 anos,clasificacion d,2003-09-01,69,103,69,103,172
41201,ANDAMARCA,estado nutricional en menores de 5 anos,clasificacion d,2003-09-01,13,17,13,17,30
30402,ANZALDO,estado nutricional en menores de 5 anos,clasificacion d,2003-09-01,19,49,19,49,68
20701,APOLO,estado nutricional en menores de 5 anos,clasificacion d,2003-09-01,54,42,54,42,96
51301,ARAMPAMPA,estado nutricional en menores de 5 anos,clasificacion d,2003-09-01,37,110,37,110,147
30501,ARANI,estado nutricional en menores de 5 anos,clasificacion d,2003-09-01,13,45,13,45,58
30403,ARBIETO,estado nutricional en menores de 5 anos,clasificacion d,2003-09-01,4,4,4,4,8
30601,ARQUE,estado nutricional en menores de 5 anos,clasificacion d,2003-09-01,72,77,72,77,149
71501,ASCENCION DE GUARAYOS,estado nutricional en menores de 5 anos,clasificacion d,2003-09-01,2,12,2,12,14
50802,ATOCHA,estado nutricional en menores de 5 anos,clasificacion d,2003-09-01,27,133,27,133,160
20503,AUCAPATA,estado nutricional en menores de 5 anos,clasificacion d,2003-09-01,10,7,10,7,17
20502,AYATA,estado nutricional en menores de 5 anos,clasificacion d,2003-09-01,10,3,10,3,13
21303,AYO AYO,estado nutricional en menores de 5 anos,clasificacion d,2003-09-01,16,3,16,3,19
30301,AYOPAYA (V. DE INDEPENDENCIA),estado nutricional en menores de 5 anos,clasificacion d,2003-09-01,87,101,87,101,188
10201,AZURDUY,estado nutricional en menores de 5 anos,clasificacion d,2003-09-01,160,278,160,278,438
21203,BATALLAS,estado nutricional en menores de 5 anos,clasificacion d,2003-09-01,20,20,20,20,40
80802,BAURES,estado nutricional en menores de 5 anos,clasificacion d,2003-09-01,18,14,18,14,32
41202,BELEN DE ANDAMARCA,estado nutricional en menores de 5 anos,clasificacion d,2003-09-01,3,0,3,0,3
50104,BELEN DE URMIRI,estado nutricional en menores de 5 anos,clasificacion d,2003-09-01,13,21,13,21,34
90104,BELLA FLOR,estado nutricional en menores de 5 anos,clasificacion d,2003-09-01,24,36,24,36,60
60202,BERMEJO,estado nutricional en menores de 5 anos,clasificacion d,2003-09-01,21,15,21,15,36
50301,BETANZOS,estado nutricional en menores de 5 anos,clasificacion d,2003-09-01,219,357,219,357,576
31501,BOLIVAR,estado nutricional en menores de 5 anos,clasificacion d,2003-09-01,98,105,98,105,203
90103,BOLPEBRA,estado nutricional en menores de 5 anos,clasificacion d,2003-09-01,9,12,9,12,21
70707,BOYUIBE,estado nutricional en menores de 5 anos,clasificacion d,2003-09-01,9,10,9,10,19
70401,BUENA VISTA,estado nutricional en menores de 5 anos,clasificacion d,2003-09-01,30,54,30,54,84
70703,CABEZAS,estado nutricional en menores de 5 anos,clasificacion d,2003-09-01,2,0,2,0,2
20905,CAIROMA,estado nutricional en menores de 5 anos,clasificacion d,2003-09-01,43,48,43,48,91
51102,"CAIZA ""D""",estado nutricional en menores de 5 anos,clasificacion d,2003-09-01,80,101,80,101,181
21003,CAJUATA,estado nutricional en menores de 5 anos,clasificacion d,2003-09-01,32,27,32,27,59
20303,CALACOTO,estado nutricional en menores de 5 anos,clasificacion d,2003-09-01,5,8,5,8,13
21304,CALAMARCA,estado nutricional en menores de 5 anos,clasificacion d,2003-09-01,102,108,102,108,210
10701,CAMARGO,estado nutricional en menores de 5 anos,clasificacion d,2003-09-01,110,125,110,125,235
10901,CAMATAQUI (C. VILLA ABECIA),estado nutricional en menores de 5 anos,clasificacion d,2003-09-01,6,24,6,24,30
70706,CAMIRI,estado nutricional en menores de 5 anos,clasificacion d,2003-09-01,151,155,151,155,306
30701,CAPINOTA,estado nutricional en menores de 5 anos,clasificacion d,2003-09-01,29,53,29,53,82
20302,CAQUIAVIRI,estado nutricional en menores de 5 anos,clasificacion d,2003-09-01,29,30,29,30,59
40102,CARACOLLO,estado nutricional en menores de 5 anos,clasificacion d,2003-09-01,28,42,28,42,70
22001,CARANAVI,estado nutricional en menores de 5 anos,clasificacion d,2003-09-01,121,77,121,77,198
41503,CARANGAS,estado nutricional en menores de 5 anos,clasificacion d,2003-09-01,0,2,0,2,2
60302,CARAPARI,estado nutricional en menores de 5 anos,clasificacion d,2003-09-01,23,34,23,34,57
50702,CARIPUYO,estado nutricional en menores de 5 anos,clasificacion d,2003-09-01,81,85,81,85,166
21902,CATACORA,estado nutricional en menores de 5 anos,clasificacion d,2003-09-01,0,1,0,1,1
40201,CHALLAPATA,estado nutricional en menores de 5 anos,clasificacion d,2003-09-01,71,63,71,63,134
50302,CHAQUI,estado nutricional en menores de 5 anos,clasificacion d,2003-09-01,43,58,43,58,101
70702,CHARAGUA,estado nutricional en menores de 5 anos,clasificacion d,2003-09-01,97,106,97,106,203
20305,CHARAÃ‘A,estado nutricional en menores de 5 anos,clasificacion d,2003-09-01,3,9,3,9,12
50202,CHAYANTA,estado nutricional en menores de 5 anos,clasificacion d,2003-09-01,48,68,48,68,116
31204,CHIMORE,estado nutricional en menores de 5 anos,clasificacion d,2003-09-01,16,18,16,18,34
40903,CHIPAYA,estado nutricional en menores de 5 anos,clasificacion d,2003-09-01,3,4,3,4,7
21101,CHULUMANI (V. DE LA LIBERTAD),estado nutricional en menores de 5 anos,clasificacion d,2003-09-01,28,20,28,20,48
20501,CHUMA,estado nutricional en menores de 5 anos,clasificacion d,2003-09-01,50,30,50,30,80
30801,CLIZA,estado nutricional en menores de 5 anos,clasificacion d,2003-09-01,12,11,12,11,23
90101,COBIJA,estado nutricional en menores de 5 anos,clasificacion d,2003-09-01,82,89,82,89,171
30101,COCHABAMBA,estado nutricional en menores de 5 anos,clasificacion d,2003-09-01,521,465,521,465,986
40902,COIPASA,estado nutricional en menores de 5 anos,clasificacion d,2003-09-01,3,1,3,1,4
30905,COLCAPIRHUA,estado nutricional en menores de 5 anos,clasificacion d,2003-09-01,60,43,60,43,103
50901,"COLCHA ""K""",estado nutricional en menores de 5 anos,clasificacion d,2003-09-01,40,36,40,36,76
21307,COLLANA,estado nutricional en menores de 5 anos,clasificacion d,2003-09-01,4,4,4,4,8
31002,COLOMI,estado nutricional en menores de 5 anos,clasificacion d,2003-09-01,81,105,81,105,186
50401,COLQUECHACA,estado nutricional en menores de 5 anos,clasificacion d,2003-09-01,186,164,186,164,350
21306,COLQUENCHA,estado nutricional en menores de 5 anos,clasificacion d,2003-09-01,29,16,29,16,45
21004,COLQUIRI,estado nutricional en menores de 5 anos,clasificacion d,2003-09-01,76,38,76,38,114
20304,COMANCHE,estado nutricional en menores de 5 anos,clasificacion d,2003-09-01,3,2,3,2,5
71301,COMARAPA,estado nutricional en menores de 5 anos,clasificacion d,2003-09-01,53,48,53,48,101
20605,COMBAYA,estado nutricional en menores de 5 anos,clasificacion d,2003-09-01,11,20,11,20,31
71101,CONCEPCION,estado nutricional en menores de 5 anos,clasificacion d,2003-09-01,12,44,12,44,56
21701,COPACABANA,estado nutricional en menores de 5 anos,clasificacion d,2003-09-01,26,22,26,22,48
21402,CORIPATA,estado nutricional en menores de 5 anos,clasificacion d,2003-09-01,3,0,3,0,3
20301,CORO CORO,estado nutricional en menores de 5 anos,clasificacion d,2003-09-01,31,28,31,28,59
21401,COROICO,estado nutricional en menores de 5 anos,clasificacion d,2003-09-01,36,20,36,20,56
40301,CORQUE,estado nutricional en menores de 5 anos,clasificacion d,2003-09-01,24,24,24,24,48
50601,COTAGAITA,estado nutricional en menores de 5 anos,clasificacion d,2003-09-01,99,112,99,112,211
31405,CUCHUMUELA (V. G. VILLARROEL),estado nutricional en menores de 5 anos,clasificacion d,2003-09-01,2,1,2,1,3
70704,CUEVO,estado nutricional en menores de 5 anos,clasificacion d,2003-09-01,18,9,18,9,27
10902,CULPINA,estado nutricional en menores de 5 anos,clasificacion d,2003-09-01,163,208,163,208,371
40401,CURAHUARA DE CARANGAS,estado nutricional en menores de 5 anos,clasificacion d,2003-09-01,13,11,13,11,24
21602,CURVA,estado nutricional en menores de 5 anos,clasificacion d,2003-09-01,12,14,12,14,26
20804,DESAGUADERO,estado nutricional en menores de 5 anos,clasificacion d,2003-09-01,10,8,10,8,18
20105,EL ALTO,estado nutricional en menores de 5 anos,clasificacion d,2003-09-01,1678,1019,1678,1019,2697
40103,EL CHORO,estado nutricional en menores de 5 anos,clasificacion d,2003-09-01,17,6,17,6,23
71503,EL PUENTE(STC),estado nutricional en menores de 5 anos,clasificacion d,2003-09-01,38,90,38,90,128
60502,EL PUENTE(TJA),estado nutricional en menores de 5 anos,clasificacion d,2003-09-01,76,149,76,149,225
70105,EL TORNO,estado nutricional en menores de 5 anos,clasificacion d,2003-09-01,67,74,67,74,141
10405,EL VILLAR,estado nutricional en menores de 5 anos,clasificacion d,2003-09-01,56,126,56,126,182
60601,ENTRE RIOS,estado nutricional en menores de 5 anos,clasificacion d,2003-09-01,45,65,45,65,110
41101,EUCALIPTUS,estado nutricional en menores de 5 anos,clasificacion d,2003-09-01,9,10,9,10,19
90503,EUREKA (SANTOS MERCADO),estado nutricional en menores de 5 anos,clasificacion d,2003-09-01,2,2,2,2,4
80402,EXALTACION,estado nutricional en menores de 5 anos,clasificacion d,2003-09-01,4,9,4,9,13
90203,FILADELFIA,estado nutricional en menores de 5 anos,clasificacion d,2003-09-01,7,8,7,8,15
71002,GENERAL SAAVEDRA,estado nutricional en menores de 5 anos,clasificacion d,2003-09-01,73,144,73,144,217
21601,GRAL. J.J. PEREZ (CHARAZANI),estado nutricional en menores de 5 anos,clasificacion d,2003-09-01,34,36,34,36,70
20602,GUANAY,estado nutricional en menores de 5 anos,clasificacion d,2003-09-01,140,91,140,91,231
20802,GUAQUI,estado nutricional en menores de 5 anos,clasificacion d,2003-09-01,15,6,15,6,21
80202,GUAYARAMERIN,estado nutricional en menores de 5 anos,clasificacion d,2003-09-01,114,88,114,88,202
70705,GUTIERREZ,estado nutricional en menores de 5 anos,clasificacion d,2003-09-01,80,156,80,156,236
10502,HUACARETA,estado nutricional en menores de 5 anos,clasificacion d,2003-09-01,57,88,57,88,145
11002,HUACAYA (VILLA DE HUACAYA),estado nutricional en menores de 5 anos,clasificacion d,2003-09-01,17,30,17,30,47
40501,HUACHACALLA,estado nutricional en menores de 5 anos,clasificacion d,2003-09-01,1,1,1,1,2
40701,HUANUNI,estado nutricional en menores de 5 anos,clasificacion d,2003-09-01,38,54,38,54,92
80803,HUARACAJE,estado nutricional en menores de 5 anos,clasificacion d,2003-09-01,3,3,3,3,6
41601,HUAYLLAMARCA,estado nutricional en menores de 5 anos,clasificacion d,2003-09-01,11,11,11,11,22
21005,ICHOCA,estado nutricional en menores de 5 anos,clasificacion d,2003-09-01,26,25,26,25,51
10304,ICLA,estado nutricional en menores de 5 anos,clasificacion d,2003-09-01,105,213,105,213,318
10703,INCAHUASI,estado nutricional en menores de 5 anos,clasificacion d,2003-09-01,155,127,155,127,282
21001,INQUISIVI,estado nutricional en menores de 5 anos,clasificacion d,2003-09-01,86,107,86,107,193
21102,IRUPANA (VILLA DE LANZA),estado nutricional en menores de 5 anos,clasificacion d,2003-09-01,25,48,25,48,73
21501,IXIAMAS,estado nutricional en menores de 5 anos,clasificacion d,2003-09-01,19,24,19,24,43
21105,LA ASUNTA,estado nutricional en menores de 5 anos,clasificacion d,2003-09-01,48,53,48,53,101
70104,LA GUARDIA,estado nutricional en menores de 5 anos,clasificacion d,2003-09-01,53,34,53,34,87
20101,LA PAZ,estado nutricional en menores de 5 anos,clasificacion d,2003-09-01,1146,861,1146,861,2007
41501,LA RIVERA,estado nutricional en menores de 5 anos,clasificacion d,2003-09-01,2,0,2,0,2
70701,LAGUNILLAS,estado nutricional en menores de 5 anos,clasificacion d,2003-09-01,20,38,20,38,58
21202,LAJA,estado nutricional en menores de 5 anos,clasificacion d,2003-09-01,28,12,28,12,40
10903,LAS CARRERAS,estado nutricional en menores de 5 anos,clasificacion d,2003-09-01,13,39,13,39,52
21006,LICOMA PAMPA,estado nutricional en menores de 5 anos,clasificacion d,2003-09-01,3,4,3,4,7
50203,LLALLAGUA,estado nutricional en menores de 5 anos,clasificacion d,2003-09-01,50,192,50,192,242
51401,LLICA,estado nutricional en menores de 5 anos,clasificacion d,2003-09-01,6,11,6,11,17
80601,LORETO,estado nutricional en menores de 5 anos,clasificacion d,2003-09-01,8,14,8,14,22
20901,LURIBAY,estado nutricional en menores de 5 anos,clasificacion d,2003-09-01,53,56,53,56,109
40702,MACHACAMARCA,estado nutricional en menores de 5 anos,clasificacion d,2003-09-01,2,5,2,5,7
11003,MACHARETI,estado nutricional en menores de 5 anos,clasificacion d,2003-09-01,24,72,24,72,96
80801,MAGDALENA,estado nutricional en menores de 5 anos,clasificacion d,2003-09-01,21,16,21,16,37
70903,MAIRANA,estado nutricional en menores de 5 anos,clasificacion d,2003-09-01,25,22,25,22,47
20904,MALLA,estado nutricional en menores de 5 anos,clasificacion d,2003-09-01,1,14,1,14,15
20103,MECAPACA,estado nutricional en menores de 5 anos,clasificacion d,2003-09-01,24,31,24,31,55
71003,MINEROS,estado nutricional en menores de 5 anos,clasificacion d,2003-09-01,113,84,113,84,197
31301,MIZQUE,estado nutricional en menores de 5 anos,clasificacion d,2003-09-01,10,13,10,13,23
20402,MOCOMOCO,estado nutricional en menores de 5 anos,clasificacion d,2003-09-01,62,60,62,60,122
51002,MOJINETE,estado nutricional en menores de 5 anos,clasificacion d,2003-09-01,4,3,4,3,7
10303,MOJOCOYA,estado nutricional en menores de 5 anos,clasificacion d,2003-09-01,66,133,66,133,199
10501,MONTEAGUDO,estado nutricional en menores de 5 anos,clasificacion d,2003-09-01,121,229,121,229,350
71001,MONTERO,estado nutricional en menores de 5 anos,clasificacion d,2003-09-01,210,143,210,143,353
70803,MORO MORO,estado nutricional en menores de 5 anos,clasificacion d,2003-09-01,6,19,6,19,25
30302,MOROCHATA,estado nutricional en menores de 5 anos,clasificacion d,2003-09-01,72,90,72,90,162
20307,NAZACARA DE PACAJES,estado nutricional en menores de 5 anos,clasificacion d,2003-09-01,1,0,1,0,1
90501,NUEVO MANOA (NUEVA ESPERANZA),estado nutricional en menores de 5 anos,clasificacion d,2003-09-01,0,1,0,1,1
50404,OCURI,estado nutricional en menores de 5 anos,clasificacion d,2003-09-01,110,122,110,122,232
30203,OMEREQUE,estado nutricional en menores de 5 anos,clasificacion d,2003-09-01,24,27,24,27,51
40101,ORURO,estado nutricional en menores de 5 anos,clasificacion d,2003-09-01,526,481,526,481,1007
60201,PADCAYA,estado nutricional en menores de 5 anos,clasificacion d,2003-09-01,43,63,43,63,106
10401,PADILLA,estado nutricional en menores de 5 anos,clasificacion d,2003-09-01,115,245,115,245,360
70502,PAILON,estado nutricional en menores de 5 anos,clasificacion d,2003-09-01,21,13,21,13,34
20102,PALCA,estado nutricional en menores de 5 anos,clasificacion d,2003-09-01,41,39,41,39,80
21104,PALOS BLANCOS,estado nutricional en menores de 5 anos,clasificacion d,2003-09-01,97,132,97,132,229
40802,PAMPA AULLAGAS,estado nutricional en menores de 5 anos,clasificacion d,2003-09-01,18,21,18,21,39
70902,PAMPA GRANDE,estado nutricional en menores de 5 anos,clasificacion d,2003-09-01,15,20,15,20,35
21802,PAPEL PAMPA,estado nutricional en menores de 5 anos,clasificacion d,2003-09-01,5,5,5,5,10
30202,PASORAPA,estado nutricional en menores de 5 anos,clasificacion d,2003-09-01,11,25,11,25,36
21305,PATACAMAYA,estado nutricional en menores de 5 anos,clasificacion d,2003-09-01,54,38,54,38,92
40602,PAZÃ‘A,estado nutricional en menores de 5 anos,clasificacion d,2003-09-01,13,20,13,20,33
20702,PELECHUCO,estado nutricional en menores de 5 anos,clasificacion d,2003-09-01,19,34,19,34,53
50403,POCOATA,estado nutricional en menores de 5 anos,clasificacion d,2003-09-01,165,184,165,184,349
31203,POCONA,estado nutricional en menores de 5 anos,clasificacion d,2003-09-01,37,48,37,48,85
31202,POJO (CBBA),estado nutricional en menores de 5 anos,clasificacion d,2003-09-01,111,128,111,128,239
40601,POOPO,estado nutricional en menores de 5 anos,clasificacion d,2003-09-01,9,35,9,35,44
51203,PORCO,estado nutricional en menores de 5 anos,clasificacion d,2003-09-01,22,17,22,17,39
10103,POROMA,estado nutricional en menores de 5 anos,clasificacion d,2003-09-01,126,249,126,249,375
70103,PORONGO,estado nutricional en menores de 5 anos,clasificacion d,2003-09-01,18,19,18,19,37
70601,PORTACHUELO,estado nutricional en menores de 5 anos,clasificacion d,2003-09-01,42,45,42,45,87
90102,PORVENIR,estado nutricional en menores de 5 anos,clasificacion d,2003-09-01,9,14,9,14,23
70804,POSTRER VALLE,estado nutricional en menores de 5 anos,clasificacion d,2003-09-01,9,23,9,23,32
50101,POTOSI,estado nutricional en menores de 5 anos,clasificacion d,2003-09-01,592,387,592,387,979
10302,PRESTO,estado nutricional en menores de 5 anos,clasificacion d,2003-09-01,70,100,70,100,170
70805,PUCARA,estado nutricional en menores de 5 anos,clasificacion d,2003-09-01,6,3,6,3,9
21201,PUCARANI,estado nutricional en menores de 5 anos,clasificacion d,2003-09-01,18,14,18,14,32
20401,PUERTO ACOSTA,estado nutricional en menores de 5 anos,clasificacion d,2003-09-01,76,105,76,105,181
20403,PUERTO CARABUCO,estado nutricional en menores de 5 anos,clasificacion d,2003-09-01,55,90,55,90,145
90301,PUERTO GONZALO MORENO,estado nutricional en menores de 5 anos,clasificacion d,2003-09-01,39,86,39,86,125
21204,PUERTO PEREZ,estado nutricional en menores de 5 anos,clasificacion d,2003-09-01,13,20,13,20,33
71402,PUERTO QUIJARRO,estado nutricional en menores de 5 anos,clasificacion d,2003-09-01,23,11,23,11,34
90201,PUERTO RICO,estado nutricional en menores de 5 anos,clasificacion d,2003-09-01,5,15,5,15,20
80703,PUERTO SILES,estado nutricional en menores de 5 anos,clasificacion d,2003-09-01,2,3,2,3,5
71401,PUERTO SUAREZ,estado nutricional en menores de 5 anos,clasificacion d,2003-09-01,30,24,30,24,54
31205,PUERTO VILLARROEL,estado nutricional en menores de 5 anos,clasificacion d,2003-09-01,170,144,170,144,314
51101,PUNA,estado nutricional en menores de 5 anos,clasificacion d,2003-09-01,204,225,204,225,429
31401,PUNATA,estado nutricional en menores de 5 anos,clasificacion d,2003-09-01,33,41,33,41,74
20604,QUIABAYA,estado nutricional en menores de 5 anos,clasificacion d,2003-09-01,10,22,10,22,32
30901,QUILLACOLLO,estado nutricional en menores de 5 anos,clasificacion d,2003-09-01,189,79,189,79,268
21002,QUIME,estado nutricional en menores de 5 anos,clasificacion d,2003-09-01,74,46,74,46,120
70904,QUIRUSILLAS,estado nutricional en menores de 5 anos,clasificacion d,2003-09-01,6,2,6,2,8
50402,RAVELO,estado nutricional en menores de 5 anos,clasificacion d,2003-09-01,209,230,209,230,439
80301,REYES,estado nutricional en menores de 5 anos,clasificacion d,2003-09-01,17,16,17,16,33
80201,RIBERALTA,estado nutricional en menores de 5 anos,clasificacion d,2003-09-01,378,283,378,283,661
70503,ROBORE,estado nutricional en menores de 5 anos,clasificacion d,2003-09-01,34,33,34,33,67
80304,RURRENABAQUE,estado nutricional en menores de 5 anos,clasificacion d,2003-09-01,35,21,35,21,56
40901,SABAYA,estado nutricional en menores de 5 anos,clasificacion d,2003-09-01,9,3,9,3,12
31001,SACABA,estado nutricional en menores de 5 anos,clasificacion d,2003-09-01,141,145,141,145,286
30404,SACABAMBA,estado nutricional en menores de 5 anos,clasificacion d,2003-09-01,22,25,22,25,47
50701,SACACA,estado nutricional en menores de 5 anos,clasificacion d,2003-09-01,210,464,210,464,674
71302,SAIPINA,estado nutricional en menores de 5 anos,clasificacion d,2003-09-01,9,15,9,15,24
40801,SALINAS DE GARCI MENDOZA,estado nutricional en menores de 5 anos,clasificacion d,2003-09-01,12,38,12,38,50
70901,SAMAIPATA,estado nutricional en menores de 5 anos,clasificacion d,2003-09-01,20,9,20,9,29
51601,SAN AGUSTIN,estado nutricional en menores de 5 anos,clasificacion d,2003-09-01,4,5,4,5,9
80602,SAN ANDRES,estado nutricional en menores de 5 anos,clasificacion d,2003-09-01,20,41,20,41,61
51003,SAN ANTONIO DE ESMORUCO,estado nutricional en menores de 5 anos,clasificacion d,2003-09-01,6,4,6,4,10
71105,SAN ANTONIO DE LOMERIO,estado nutricional en menores de 5 anos,clasificacion d,2003-09-01,69,115,69,115,184
31403,SAN BENITO,estado nutricional en menores de 5 anos,clasificacion d,2003-09-01,39,6,39,6,45
80302,SAN BORJA,estado nutricional en menores de 5 anos,clasificacion d,2003-09-01,138,135,138,135,273
21502,SAN BUENA VENTURA,estado nutricional en menores de 5 anos,clasificacion d,2003-09-01,29,39,29,39,68
70402,SAN CARLOS,estado nutricional en menores de 5 anos,clasificacion d,2003-09-01,78,76,78,76,154
80501,SAN IGNACIO,estado nutricional en menores de 5 anos,clasificacion d,2003-09-01,118,107,118,107,225
70301,SAN IGNACIO DE VELASCO,estado nutricional en menores de 5 anos,clasificacion d,2003-09-01,224,168,224,168,392
80102,SAN JAVIER(BNI),estado nutricional en menores de 5 anos,clasificacion d,2003-09-01,13,15,13,15,28
71102,SAN JAVIER(STC),estado nutricional en menores de 5 anos,clasificacion d,2003-09-01,31,42,31,42,73
80701,SAN JOAQUIN,estado nutricional en menores de 5 anos,clasificacion d,2003-09-01,8,4,8,4,12
70501,SAN JOSE DE CHIQUITOS,estado nutricional en menores de 5 anos,clasificacion d,2003-09-01,29,13,29,13,42
71104,SAN JULIAN,estado nutricional en menores de 5 anos,clasificacion d,2003-09-01,105,188,105,188,293
90302,SAN LORENZO(PND),estado nutricional en menores de 5 anos,clasificacion d,2003-09-01,4,9,4,9,13
60501,SAN LORENZO(TJA),estado nutricional en menores de 5 anos,clasificacion d,2003-09-01,45,42,45,42,87
10702,SAN LUCAS,estado nutricional en menores de 5 anos,clasificacion d,2003-09-01,456,569,456,569,1025
70302,SAN MIGUEL DE VELASCO,estado nutricional en menores de 5 anos,clasificacion d,2003-09-01,52,67,52,67,119
51001,SAN PABLO DE LIPEZ,estado nutricional en menores de 5 anos,clasificacion d,2003-09-01,13,20,13,20,33
50501,SAN PEDRO DE BUENA VISTA,estado nutricional en menores de 5 anos,clasificacion d,2003-09-01,141,202,141,202,343
21801,SAN PEDRO DE CURAHUARA,estado nutricional en menores de 5 anos,clasificacion d,2003-09-01,16,33,16,33,49
50902,SAN PEDRO DE QUEMES,estado nutricional en menores de 5 anos,clasificacion d,2003-09-01,2,3,2,3,5
21702,SAN PEDRO DE TIQUINA,estado nutricional en menores de 5 anos,clasificacion d,2003-09-01,7,8,7,8,15
70303,SAN RAFAEL,estado nutricional en menores de 5 anos,clasificacion d,2003-09-01,19,15,19,15,34
80702,SAN RAMON,estado nutricional en menores de 5 anos,clasificacion d,2003-09-01,4,15,4,15,19
80401,SANTA ANA,estado nutricional en menores de 5 anos,clasificacion d,2003-09-01,14,6,14,6,20
70101,SANTA CRUZ DE LA SIERRA,estado nutricional en menores de 5 anos,clasificacion d,2003-09-01,860,460,860,460,1320
80303,SANTA ROSA,estado nutricional en menores de 5 anos,clasificacion d,2003-09-01,11,15,11,15,26
70602,SANTA ROSA DEL SARA,estado nutricional en menores de 5 anos,clasificacion d,2003-09-01,12,7,12,7,19
20308,SANTIAGO DE CALLAPA,estado nutricional en menores de 5 anos,clasificacion d,2003-09-01,14,20,14,20,34
41401,SANTIAGO DE HUARI,estado nutricional en menores de 5 anos,clasificacion d,2003-09-01,16,33,16,33,49
21901,SANTIAGO DE MACHACA,estado nutricional en menores de 5 anos,clasificacion d,2003-09-01,7,8,7,8,15
30702,SANTIVAÃ‘ES,estado nutricional en menores de 5 anos,clasificacion d,2003-09-01,20,14,20,14,34
40202,SANTUARIO DE QUILLACAS,estado nutricional en menores de 5 anos,clasificacion d,2003-09-01,7,14,7,14,21
20902,SAPAHAQUI,estado nutricional en menores de 5 anos,clasificacion d,2003-09-01,25,19,25,19,44
90303,SENA,estado nutricional en menores de 5 anos,clasificacion d,2003-09-01,5,7,5,7,12
21301,SICA SICA (VILLA AROMA),estado nutricional en menores de 5 anos,clasificacion d,2003-09-01,97,101,97,101,198
30703,SICAYA,estado nutricional en menores de 5 anos,clasificacion d,2003-09-01,9,9,9,9,18
30902,SIPE SIPE,estado nutricional en menores de 5 anos,clasificacion d,2003-09-01,171,149,171,149,320
10403,SOPACHUY,estado nutricional en menores de 5 anos,clasificacion d,2003-09-01,75,116,75,116,191
20601,SORATA,estado nutricional en menores de 5 anos,clasificacion d,2003-09-01,30,75,30,75,105
10101,SUCRE,estado nutricional en menores de 5 anos,clasificacion d,2003-09-01,560,639,560,639,1199
31404,TACACHI,estado nutricional en menores de 5 anos,clasificacion d,2003-09-01,5,2,5,2,7
20603,TACACOMA,estado nutricional en menores de 5 anos,clasificacion d,2003-09-01,19,7,19,7,26
50303,TACOBAMBA,estado nutricional en menores de 5 anos,clasificacion d,2003-09-01,75,84,75,84,159
30602,TACOPAYA,estado nutricional en menores de 5 anos,clasificacion d,2003-09-01,79,119,79,119,198
51402,TAHUA,estado nutricional en menores de 5 anos,clasificacion d,2003-09-01,4,7,4,7,11
31101,TAPACARI,estado nutricional en menores de 5 anos,clasificacion d,2003-09-01,206,194,206,194,400
10601,TARABUCO,estado nutricional en menores de 5 anos,clasificacion d,2003-09-01,273,485,273,485,758
30401,TARATA,estado nutricional en menores de 5 anos,clasificacion d,2003-09-01,33,64,33,64,97
60101,TARIJA,estado nutricional en menores de 5 anos,clasificacion d,2003-09-01,174,174,174,174,348
10202,TARVITA,estado nutricional en menores de 5 anos,clasificacion d,2003-09-01,111,265,111,265,376
20803,TIAWANACU,estado nutricional en menores de 5 anos,clasificacion d,2003-09-01,26,13,26,13,39
50102,TINGUIPAYA,estado nutricional en menores de 5 anos,clasificacion d,2003-09-01,135,233,135,233,368
20606,TIPUANI,estado nutricional en menores de 5 anos,clasificacion d,2003-09-01,25,23,25,23,48
30903,TIQUIPAYA,estado nutricional en menores de 5 anos,clasificacion d,2003-09-01,54,52,54,52,106
31601,TIRAQUE (CBBA),estado nutricional en menores de 5 anos,clasificacion d,2003-09-01,126,150,126,150,276
21703,TITO YUPANQUI (PARQUIPUJIO),estado nutricional en menores de 5 anos,clasificacion d,2003-09-01,4,10,4,10,14
30802,TOCO,estado nutricional en menores de 5 anos,clasificacion d,2003-09-01,1,26,1,26,27
30803,TOLATA,estado nutricional en menores de 5 anos,clasificacion d,2003-09-01,18,12,18,12,30
41001,TOLEDO,estado nutricional en menores de 5 anos,clasificacion d,2003-09-01,10,6,10,6,16
51202,TOMAVE,estado nutricional en menores de 5 anos,clasificacion d,2003-09-01,79,82,79,82,161
10402,TOMINA,estado nutricional en menores de 5 anos,clasificacion d,2003-09-01,110,206,110,206,316
50502,TORO TORO,estado nutricional en menores de 5 anos,clasificacion d,2003-09-01,107,120,107,120,227
31201,TOTORA(CBBA),estado nutricional en menores de 5 anos,clasificacion d,2003-09-01,69,61,69,61,130
41301,TOTORA(ORR),estado nutricional en menores de 5 anos,clasificacion d,2003-09-01,14,34,14,34,48
80101,TRINIDAD,estado nutricional en menores de 5 anos,clasificacion d,2003-09-01,130,162,130,162,292
50801,TUPIZA,estado nutricional en menores de 5 anos,clasificacion d,2003-09-01,129,233,129,233,362
40402,TURCO,estado nutricional en menores de 5 anos,clasificacion d,2003-09-01,19,17,19,17,36
21302,UMALA,estado nutricional en menores de 5 anos,clasificacion d,2003-09-01,27,19,27,19,46
50201,UNCIA,estado nutricional en menores de 5 anos,clasificacion d,2003-09-01,35,13,35,13,48
60401,URIONDO (A. CONCEPCION),estado nutricional en menores de 5 anos,clasificacion d,2003-09-01,64,100,64,100,164
51201,UYUNI,estado nutricional en menores de 5 anos,clasificacion d,2003-09-01,51,62,51,62,113
30502,VACAS,estado nutricional en menores de 5 anos,clasificacion d,2003-09-01,31,24,31,24,55
70801,VALLEGRANDE,estado nutricional en menores de 5 anos,clasificacion d,2003-09-01,20,27,20,27,47
20801,VIACHA,estado nutricional en menores de 5 anos,clasificacion d,2003-09-01,95,87,95,87,182
31302,VILA VILA,estado nutricional en menores de 5 anos,clasificacion d,2003-09-01,11,17,11,17,28
60303,VILLA MONTES,estado nutricional en menores de 5 anos,clasificacion d,2003-09-01,74,75,74,75,149
31402,VILLA RIVERO,estado nutricional en menores de 5 anos,clasificacion d,2003-09-01,23,8,23,8,31
10801,VILLA SERRANO,estado nutricional en menores de 5 anos,clasificacion d,2003-09-01,112,247,112,247,359
31003,VILLA TUNARI,estado nutricional en menores de 5 anos,clasificacion d,2003-09-01,141,115,141,115,256
11001,VILLA VACA GUZMAN (MUYUPAMPA),estado nutricional en menores de 5 anos,clasificacion d,2003-09-01,41,48,41,48,89
51501,VILLAZON,estado nutricional en menores de 5 anos,clasificacion d,2003-09-01,121,140,121,140,261
30904,VINTO,estado nutricional en menores de 5 anos,clasificacion d,2003-09-01,55,37,55,37,92
50602,VITICHI,estado nutricional en menores de 5 anos,clasificacion d,2003-09-01,56,69,56,69,125
20306,WALDO BALLIVIAN,estado nutricional en menores de 5 anos,clasificacion d,2003-09-01,11,8,11,8,19
20903,YACO,estado nutricional en menores de 5 anos,clasificacion d,2003-09-01,22,20,22,20,42
60301,YACUIBA,estado nutricional en menores de 5 anos,clasificacion d,2003-09-01,0,66,0,66,66
10602,YAMPARAEZ,estado nutricional en menores de 5 anos,clasificacion d,2003-09-01,151,286,151,286,437
21103,YANACACHI,estado nutricional en menores de 5 anos,clasificacion d,2003-09-01,11,7,11,7,18
70403,YAPACANI,estado nutricional en menores de 5 anos,clasificacion d,2003-09-01,90,133,90,133,223
50103,YOCALLA,estado nutricional en menores de 5 anos,clasificacion d,2003-09-01,22,28,22,28,50
10102,YOTALA,estado nutricional en menores de 5 anos,clasificacion d,2003-09-01,102,174,102,174,276
60402,YUNCHARA,estado nutricional en menores de 5 anos,clasificacion d,2003-09-01,31,49,31,49,80
10301,ZUDAÃ‘EZ,estado nutricional en menores de 5 anos,clasificacion d,2003-09-01,61,113,61,113,174
51302,ACACIO,estado nutricional en menores de 5 anos,clasificacion d,2003-10-01,50,109,50,109,159
20201,ACHACACHI,estado nutricional en menores de 5 anos,clasificacion d,2003-10-01,112,106,112,106,218
20104,ACHOCALLA,estado nutricional en menores de 5 anos,clasificacion d,2003-10-01,14,17,14,17,31
30201,AIQUILE,estado nutricional en menores de 5 anos,clasificacion d,2003-10-01,52,86,52,86,138
31303,ALALAY,estado nutricional en menores de 5 anos,clasificacion d,2003-10-01,18,17,18,17,35
10404,ALCALA,estado nutricional en menores de 5 anos,clasificacion d,2003-10-01,30,82,30,82,112
20202,ANCORAIMES,estado nutricional en menores de 5 anos,clasificacion d,2003-10-01,56,74,56,74,130
41201,ANDAMARCA,estado nutricional en menores de 5 anos,clasificacion d,2003-10-01,6,7,6,7,13
30402,ANZALDO,estado nutricional en menores de 5 anos,clasificacion d,2003-10-01,22,57,22,57,79
20701,APOLO,estado nutricional en menores de 5 anos,clasificacion d,2003-10-01,16,18,16,18,34
51301,ARAMPAMPA,estado nutricional en menores de 5 anos,clasificacion d,2003-10-01,31,90,31,90,121
30501,ARANI,estado nutricional en menores de 5 anos,clasificacion d,2003-10-01,27,33,27,33,60
30403,ARBIETO,estado nutricional en menores de 5 anos,clasificacion d,2003-10-01,10,2,10,2,12
30601,ARQUE,estado nutricional en menores de 5 anos,clasificacion d,2003-10-01,68,99,68,99,167
71501,ASCENCION DE GUARAYOS,estado nutricional en menores de 5 anos,clasificacion d,2003-10-01,29,36,29,36,65
50802,ATOCHA,estado nutricional en menores de 5 anos,clasificacion d,2003-10-01,38,148,38,148,186
20503,AUCAPATA,estado nutricional en menores de 5 anos,clasificacion d,2003-10-01,10,14,10,14,24
20502,AYATA,estado nutricional en menores de 5 anos,clasificacion d,2003-10-01,16,22,16,22,38
21303,AYO AYO,estado nutricional en menores de 5 anos,clasificacion d,2003-10-01,14,17,14,17,31
30301,AYOPAYA (V. DE INDEPENDENCIA),estado nutricional en menores de 5 anos,clasificacion d,2003-10-01,103,142,103,142,245
10201,AZURDUY,estado nutricional en menores de 5 anos,clasificacion d,2003-10-01,145,316,145,316,461
21203,BATALLAS,estado nutricional en menores de 5 anos,clasificacion d,2003-10-01,29,27,29,27,56
80802,BAURES,estado nutricional en menores de 5 anos,clasificacion d,2003-10-01,18,17,18,17,35
41202,BELEN DE ANDAMARCA,estado nutricional en menores de 5 anos,clasificacion d,2003-10-01,4,2,4,2,6
50104,BELEN DE URMIRI,estado nutricional en menores de 5 anos,clasificacion d,2003-10-01,6,16,6,16,22
90104,BELLA FLOR,estado nutricional en menores de 5 anos,clasificacion d,2003-10-01,13,12,13,12,25
60202,BERMEJO,estado nutricional en menores de 5 anos,clasificacion d,2003-10-01,20,23,20,23,43
50301,BETANZOS,estado nutricional en menores de 5 anos,clasificacion d,2003-10-01,191,250,191,250,441
31501,BOLIVAR,estado nutricional en menores de 5 anos,clasificacion d,2003-10-01,87,81,87,81,168
90103,BOLPEBRA,estado nutricional en menores de 5 anos,clasificacion d,2003-10-01,9,16,9,16,25
70707,BOYUIBE,estado nutricional en menores de 5 anos,clasificacion d,2003-10-01,18,22,18,22,40
70401,BUENA VISTA,estado nutricional en menores de 5 anos,clasificacion d,2003-10-01,57,51,57,51,108
70703,CABEZAS,estado nutricional en menores de 5 anos,clasificacion d,2003-10-01,49,65,49,65,114
20905,CAIROMA,estado nutricional en menores de 5 anos,clasificacion d,2003-10-01,77,94,77,94,171
51102,"CAIZA ""D""",estado nutricional en menores de 5 anos,clasificacion d,2003-10-01,61,70,61,70,131
21003,CAJUATA,estado nutricional en menores de 5 anos,clasificacion d,2003-10-01,40,33,40,33,73
20303,CALACOTO,estado nutricional en menores de 5 anos,clasificacion d,2003-10-01,26,21,26,21,47
21304,CALAMARCA,estado nutricional en menores de 5 anos,clasificacion d,2003-10-01,197,183,197,183,380
10701,CAMARGO,estado nutricional en menores de 5 anos,clasificacion d,2003-10-01,97,130,97,130,227
10901,CAMATAQUI (C. VILLA ABECIA),estado nutricional en menores de 5 anos,clasificacion d,2003-10-01,17,27,17,27,44
70706,CAMIRI,estado nutricional en menores de 5 anos,clasificacion d,2003-10-01,135,137,135,137,272
30701,CAPINOTA,estado nutricional en menores de 5 anos,clasificacion d,2003-10-01,23,41,23,41,64
20302,CAQUIAVIRI,estado nutricional en menores de 5 anos,clasificacion d,2003-10-01,43,37,43,37,80
40102,CARACOLLO,estado nutricional en menores de 5 anos,clasificacion d,2003-10-01,54,77,54,77,131
22001,CARANAVI,estado nutricional en menores de 5 anos,clasificacion d,2003-10-01,100,138,100,138,238
60302,CARAPARI,estado nutricional en menores de 5 anos,clasificacion d,2003-10-01,25,30,25,30,55
50702,CARIPUYO,estado nutricional en menores de 5 anos,clasificacion d,2003-10-01,90,147,90,147,237
21902,CATACORA,estado nutricional en menores de 5 anos,clasificacion d,2003-10-01,4,8,4,8,12
40201,CHALLAPATA,estado nutricional en menores de 5 anos,clasificacion d,2003-10-01,107,145,107,145,252
50302,CHAQUI,estado nutricional en menores de 5 anos,clasificacion d,2003-10-01,17,46,17,46,63
70702,CHARAGUA,estado nutricional en menores de 5 anos,clasificacion d,2003-10-01,104,109,104,109,213
20305,CHARAÃ‘A,estado nutricional en menores de 5 anos,clasificacion d,2003-10-01,1,2,1,2,3
50202,CHAYANTA,estado nutricional en menores de 5 anos,clasificacion d,2003-10-01,99,204,99,204,303
31204,CHIMORE,estado nutricional en menores de 5 anos,clasificacion d,2003-10-01,21,16,21,16,37
40903,CHIPAYA,estado nutricional en menores de 5 anos,clasificacion d,2003-10-01,4,11,4,11,15
21101,CHULUMANI (V. DE LA LIBERTAD),estado nutricional en menores de 5 anos,clasificacion d,2003-10-01,14,14,14,14,28
20501,CHUMA,estado nutricional en menores de 5 anos,clasificacion d,2003-10-01,27,32,27,32,59
30801,CLIZA,estado nutricional en menores de 5 anos,clasificacion d,2003-10-01,11,8,11,8,19
90101,COBIJA,estado nutricional en menores de 5 anos,clasificacion d,2003-10-01,44,50,44,50,94
30101,COCHABAMBA,estado nutricional en menores de 5 anos,clasificacion d,2003-10-01,604,513,604,513,1117
40902,COIPASA,estado nutricional en menores de 5 anos,clasificacion d,2003-10-01,2,0,2,0,2
30905,COLCAPIRHUA,estado nutricional en menores de 5 anos,clasificacion d,2003-10-01,52,60,52,60,112
50901,"COLCHA ""K""",estado nutricional en menores de 5 anos,clasificacion d,2003-10-01,62,80,62,80,142
21307,COLLANA,estado nutricional en menores de 5 anos,clasificacion d,2003-10-01,7,1,7,1,8
31002,COLOMI,estado nutricional en menores de 5 anos,clasificacion d,2003-10-01,95,91,95,91,186
50401,COLQUECHACA,estado nutricional en menores de 5 anos,clasificacion d,2003-10-01,166,131,166,131,297
21306,COLQUENCHA,estado nutricional en menores de 5 anos,clasificacion d,2003-10-01,37,21,37,21,58
21004,COLQUIRI,estado nutricional en menores de 5 anos,clasificacion d,2003-10-01,84,45,84,45,129
20304,COMANCHE,estado nutricional en menores de 5 anos,clasificacion d,2003-10-01,5,2,5,2,7
71301,COMARAPA,estado nutricional en menores de 5 anos,clasificacion d,2003-10-01,69,42,69,42,111
20605,COMBAYA,estado nutricional en menores de 5 anos,clasificacion d,2003-10-01,1,10,1,10,11
71101,CONCEPCION,estado nutricional en menores de 5 anos,clasificacion d,2003-10-01,16,0,16,0,16
21701,COPACABANA,estado nutricional en menores de 5 anos,clasificacion d,2003-10-01,14,20,14,20,34
21402,CORIPATA,estado nutricional en menores de 5 anos,clasificacion d,2003-10-01,8,0,8,0,8
20301,CORO CORO,estado nutricional en menores de 5 anos,clasificacion d,2003-10-01,24,18,24,18,42
21401,COROICO,estado nutricional en menores de 5 anos,clasificacion d,2003-10-01,25,20,25,20,45
40301,CORQUE,estado nutricional en menores de 5 anos,clasificacion d,2003-10-01,43,13,43,13,56
50601,COTAGAITA,estado nutricional en menores de 5 anos,clasificacion d,2003-10-01,232,343,232,343,575
31405,CUCHUMUELA (V. G. VILLARROEL),estado nutricional en menores de 5 anos,clasificacion d,2003-10-01,9,13,9,13,22
70704,CUEVO,estado nutricional en menores de 5 anos,clasificacion d,2003-10-01,14,29,14,29,43
10902,CULPINA,estado nutricional en menores de 5 anos,clasificacion d,2003-10-01,199,242,199,242,441
40401,CURAHUARA DE CARANGAS,estado nutricional en menores de 5 anos,clasificacion d,2003-10-01,35,25,35,25,60
21602,CURVA,estado nutricional en menores de 5 anos,clasificacion d,2003-10-01,12,11,12,11,23
20804,DESAGUADERO,estado nutricional en menores de 5 anos,clasificacion d,2003-10-01,8,5,8,5,13
20105,EL ALTO,estado nutricional en menores de 5 anos,clasificacion d,2003-10-01,1578,916,1578,916,2494
40103,EL CHORO,estado nutricional en menores de 5 anos,clasificacion d,2003-10-01,8,4,8,4,12
71503,EL PUENTE(STC),estado nutricional en menores de 5 anos,clasificacion d,2003-10-01,23,72,23,72,95
60502,EL PUENTE(TJA),estado nutricional en menores de 5 anos,clasificacion d,2003-10-01,72,140,72,140,212
70105,EL TORNO,estado nutricional en menores de 5 anos,clasificacion d,2003-10-01,65,59,65,59,124
10405,EL VILLAR,estado nutricional en menores de 5 anos,clasificacion d,2003-10-01,54,137,54,137,191
60601,ENTRE RIOS,estado nutricional en menores de 5 anos,clasificacion d,2003-10-01,85,186,85,186,271
41101,EUCALIPTUS,estado nutricional en menores de 5 anos,clasificacion d,2003-10-01,17,17,17,17,34
80402,EXALTACION,estado nutricional en menores de 5 anos,clasificacion d,2003-10-01,27,39,27,39,66
90203,FILADELFIA,estado nutricional en menores de 5 anos,clasificacion d,2003-10-01,16,25,16,25,41
71002,GENERAL SAAVEDRA,estado nutricional en menores de 5 anos,clasificacion d,2003-10-01,102,119,102,119,221
21601,GRAL. J.J. PEREZ (CHARAZANI),estado nutricional en menores de 5 anos,clasificacion d,2003-10-01,52,89,52,89,141
20602,GUANAY,estado nutricional en menores de 5 anos,clasificacion d,2003-10-01,140,113,140,113,253
20802,GUAQUI,estado nutricional en menores de 5 anos,clasificacion d,2003-10-01,14,7,14,7,21
80202,GUAYARAMERIN,estado nutricional en menores de 5 anos,clasificacion d,2003-10-01,126,120,126,120,246
70705,GUTIERREZ,estado nutricional en menores de 5 anos,clasificacion d,2003-10-01,117,194,117,194,311
10502,HUACARETA,estado nutricional en menores de 5 anos,clasificacion d,2003-10-01,52,124,52,124,176
11002,HUACAYA (VILLA DE HUACAYA),estado nutricional en menores de 5 anos,clasificacion d,2003-10-01,11,30,11,30,41
40501,HUACHACALLA,estado nutricional en menores de 5 anos,clasificacion d,2003-10-01,1,1,1,1,2
40701,HUANUNI,estado nutricional en menores de 5 anos,clasificacion d,2003-10-01,55,52,55,52,107
80803,HUARACAJE,estado nutricional en menores de 5 anos,clasificacion d,2003-10-01,6,0,6,0,6
41601,HUAYLLAMARCA,estado nutricional en menores de 5 anos,clasificacion d,2003-10-01,12,16,12,16,28
21005,ICHOCA,estado nutricional en menores de 5 anos,clasificacion d,2003-10-01,31,20,31,20,51
10304,ICLA,estado nutricional en menores de 5 anos,clasificacion d,2003-10-01,84,152,84,152,236
10703,INCAHUASI,estado nutricional en menores de 5 anos,clasificacion d,2003-10-01,192,207,192,207,399
21001,INQUISIVI,estado nutricional en menores de 5 anos,clasificacion d,2003-10-01,66,56,66,56,122
21501,IXIAMAS,estado nutricional en menores de 5 anos,clasificacion d,2003-10-01,21,41,21,41,62
21105,LA ASUNTA,estado nutricional en menores de 5 anos,clasificacion d,2003-10-01,67,41,67,41,108
70104,LA GUARDIA,estado nutricional en menores de 5 anos,clasificacion d,2003-10-01,86,77,86,77,163
20101,LA PAZ,estado nutricional en menores de 5 anos,clasificacion d,2003-10-01,1254,1055,1254,1055,2309
41501,LA RIVERA,estado nutricional en menores de 5 anos,clasificacion d,2003-10-01,2,1,2,1,3
70701,LAGUNILLAS,estado nutricional en menores de 5 anos,clasificacion d,2003-10-01,35,61,35,61,96
21202,LAJA,estado nutricional en menores de 5 anos,clasificacion d,2003-10-01,28,23,28,23,51
10903,LAS CARRERAS,estado nutricional en menores de 5 anos,clasificacion d,2003-10-01,17,43,17,43,60
21006,LICOMA PAMPA,estado nutricional en menores de 5 anos,clasificacion d,2003-10-01,6,6,6,6,12
50203,LLALLAGUA,estado nutricional en menores de 5 anos,clasificacion d,2003-10-01,117,287,117,287,404
51401,LLICA,estado nutricional en menores de 5 anos,clasificacion d,2003-10-01,22,37,22,37,59
80601,LORETO,estado nutricional en menores de 5 anos,clasificacion d,2003-10-01,3,10,3,10,13
20901,LURIBAY,estado nutricional en menores de 5 anos,clasificacion d,2003-10-01,56,49,56,49,105
40702,MACHACAMARCA,estado nutricional en menores de 5 anos,clasificacion d,2003-10-01,11,16,11,16,27
11003,MACHARETI,estado nutricional en menores de 5 anos,clasificacion d,2003-10-01,40,123,40,123,163
80801,MAGDALENA,estado nutricional en menores de 5 anos,clasificacion d,2003-10-01,15,19,15,19,34
70903,MAIRANA,estado nutricional en menores de 5 anos,clasificacion d,2003-10-01,7,20,7,20,27
20904,MALLA,estado nutricional en menores de 5 anos,clasificacion d,2003-10-01,15,19,15,19,34
20103,MECAPACA,estado nutricional en menores de 5 anos,clasificacion d,2003-10-01,21,21,21,21,42
71003,MINEROS,estado nutricional en menores de 5 anos,clasificacion d,2003-10-01,137,110,137,110,247
31301,MIZQUE,estado nutricional en menores de 5 anos,clasificacion d,2003-10-01,62,45,62,45,107
20402,MOCOMOCO,estado nutricional en menores de 5 anos,clasificacion d,2003-10-01,50,56,50,56,106
51002,MOJINETE,estado nutricional en menores de 5 anos,clasificacion d,2003-10-01,3,6,3,6,9
10303,MOJOCOYA,estado nutricional en menores de 5 anos,clasificacion d,2003-10-01,62,137,62,137,199
10501,MONTEAGUDO,estado nutricional en menores de 5 anos,clasificacion d,2003-10-01,139,242,139,242,381
71001,MONTERO,estado nutricional en menores de 5 anos,clasificacion d,2003-10-01,310,238,310,238,548
70803,MORO MORO,estado nutricional en menores de 5 anos,clasificacion d,2003-10-01,14,23,14,23,37
30302,MOROCHATA,estado nutricional en menores de 5 anos,clasificacion d,2003-10-01,113,84,113,84,197
20307,NAZACARA DE PACAJES,estado nutricional en menores de 5 anos,clasificacion d,2003-10-01,3,0,3,0,3
90501,NUEVO MANOA (NUEVA ESPERANZA),estado nutricional en menores de 5 anos,clasificacion d,2003-10-01,2,2,2,2,4
50404,OCURI,estado nutricional en menores de 5 anos,clasificacion d,2003-10-01,86,103,86,103,189
30203,OMEREQUE,estado nutricional en menores de 5 anos,clasificacion d,2003-10-01,8,7,8,7,15
40101,ORURO,estado nutricional en menores de 5 anos,clasificacion d,2003-10-01,612,524,612,524,1136
60201,PADCAYA,estado nutricional en menores de 5 anos,clasificacion d,2003-10-01,52,105,52,105,157
10401,PADILLA,estado nutricional en menores de 5 anos,clasificacion d,2003-10-01,134,230,134,230,364
70502,PAILON,estado nutricional en menores de 5 anos,clasificacion d,2003-10-01,18,32,18,32,50
20102,PALCA,estado nutricional en menores de 5 anos,clasificacion d,2003-10-01,42,52,42,52,94
21104,PALOS BLANCOS,estado nutricional en menores de 5 anos,clasificacion d,2003-10-01,78,86,78,86,164
40802,PAMPA AULLAGAS,estado nutricional en menores de 5 anos,clasificacion d,2003-10-01,10,5,10,5,15
70902,PAMPA GRANDE,estado nutricional en menores de 5 anos,clasificacion d,2003-10-01,24,24,24,24,48
21802,PAPEL PAMPA,estado nutricional en menores de 5 anos,clasificacion d,2003-10-01,6,7,6,7,13
30202,PASORAPA,estado nutricional en menores de 5 anos,clasificacion d,2003-10-01,5,15,5,15,20
21305,PATACAMAYA,estado nutricional en menores de 5 anos,clasificacion d,2003-10-01,70,39,70,39,109
40602,PAZÃ‘A,estado nutricional en menores de 5 anos,clasificacion d,2003-10-01,12,10,12,10,22
20702,PELECHUCO,estado nutricional en menores de 5 anos,clasificacion d,2003-10-01,25,22,25,22,47
50403,POCOATA,estado nutricional en menores de 5 anos,clasificacion d,2003-10-01,162,219,162,219,381
31203,POCONA,estado nutricional en menores de 5 anos,clasificacion d,2003-10-01,57,66,57,66,123
31202,POJO (CBBA),estado nutricional en menores de 5 anos,clasificacion d,2003-10-01,125,140,125,140,265
40601,POOPO,estado nutricional en menores de 5 anos,clasificacion d,2003-10-01,8,21,8,21,29
51203,PORCO,estado nutricional en menores de 5 anos,clasificacion d,2003-10-01,3,3,3,3,6
10103,POROMA,estado nutricional en menores de 5 anos,clasificacion d,2003-10-01,134,213,134,213,347
70103,PORONGO,estado nutricional en menores de 5 anos,clasificacion d,2003-10-01,14,8,14,8,22
70601,PORTACHUELO,estado nutricional en menores de 5 anos,clasificacion d,2003-10-01,51,50,51,50,101
90102,PORVENIR,estado nutricional en menores de 5 anos,clasificacion d,2003-10-01,2,5,2,5,7
70804,POSTRER VALLE,estado nutricional en menores de 5 anos,clasificacion d,2003-10-01,9,17,9,17,26
50101,POTOSI,estado nutricional en menores de 5 anos,clasificacion d,2003-10-01,678,431,678,431,1109
10302,PRESTO,estado nutricional en menores de 5 anos,clasificacion d,2003-10-01,74,88,74,88,162
70805,PUCARA,estado nutricional en menores de 5 anos,clasificacion d,2003-10-01,22,35,22,35,57
21201,PUCARANI,estado nutricional en menores de 5 anos,clasificacion d,2003-10-01,25,26,25,26,51
20401,PUERTO ACOSTA,estado nutricional en menores de 5 anos,clasificacion d,2003-10-01,77,112,77,112,189
20403,PUERTO CARABUCO,estado nutricional en menores de 5 anos,clasificacion d,2003-10-01,43,89,43,89,132
90301,PUERTO GONZALO MORENO,estado nutricional en menores de 5 anos,clasificacion d,2003-10-01,24,48,24,48,72
21204,PUERTO PEREZ,estado nutricional en menores de 5 anos,clasificacion d,2003-10-01,7,23,7,23,30
71402,PUERTO QUIJARRO,estado nutricional en menores de 5 anos,clasificacion d,2003-10-01,35,9,35,9,44
90201,PUERTO RICO,estado nutricional en menores de 5 anos,clasificacion d,2003-10-01,0,18,0,18,18
71401,PUERTO SUAREZ,estado nutricional en menores de 5 anos,clasificacion d,2003-10-01,57,31,57,31,88
31205,PUERTO VILLARROEL,estado nutricional en menores de 5 anos,clasificacion d,2003-10-01,214,177,214,177,391
51101,PUNA,estado nutricional en menores de 5 anos,clasificacion d,2003-10-01,129,150,129,150,279
31401,PUNATA,estado nutricional en menores de 5 anos,clasificacion d,2003-10-01,96,87,96,87,183
20604,QUIABAYA,estado nutricional en menores de 5 anos,clasificacion d,2003-10-01,5,34,5,34,39
30901,QUILLACOLLO,estado nutricional en menores de 5 anos,clasificacion d,2003-10-01,177,118,177,118,295
21002,QUIME,estado nutricional en menores de 5 anos,clasificacion d,2003-10-01,72,79,72,79,151
70904,QUIRUSILLAS,estado nutricional en menores de 5 anos,clasificacion d,2003-10-01,6,6,6,6,12
50402,RAVELO,estado nutricional en menores de 5 anos,clasificacion d,2003-10-01,185,204,185,204,389
80301,REYES,estado nutricional en menores de 5 anos,clasificacion d,2003-10-01,52,81,52,81,133
80201,RIBERALTA,estado nutricional en menores de 5 anos,clasificacion d,2003-10-01,426,278,426,278,704
70503,ROBORE,estado nutricional en menores de 5 anos,clasificacion d,2003-10-01,35,18,35,18,53
80304,RURRENABAQUE,estado nutricional en menores de 5 anos,clasificacion d,2003-10-01,33,13,33,13,46
40901,SABAYA,estado nutricional en menores de 5 anos,clasificacion d,2003-10-01,9,5,9,5,14
31001,SACABA,estado nutricional en menores de 5 anos,clasificacion d,2003-10-01,92,34,92,34,126
30404,SACABAMBA,estado nutricional en menores de 5 anos,clasificacion d,2003-10-01,20,28,20,28,48
50701,SACACA,estado nutricional en menores de 5 anos,clasificacion d,2003-10-01,273,503,273,503,776
71302,SAIPINA,estado nutricional en menores de 5 anos,clasificacion d,2003-10-01,6,15,6,15,21
40801,SALINAS DE GARCI MENDOZA,estado nutricional en menores de 5 anos,clasificacion d,2003-10-01,16,15,16,15,31
70901,SAMAIPATA,estado nutricional en menores de 5 anos,clasificacion d,2003-10-01,37,36,37,36,73
51601,SAN AGUSTIN,estado nutricional en menores de 5 anos,clasificacion d,2003-10-01,12,12,12,12,24
80602,SAN ANDRES,estado nutricional en menores de 5 anos,clasificacion d,2003-10-01,8,10,8,10,18
51003,SAN ANTONIO DE ESMORUCO,estado nutricional en menores de 5 anos,clasificacion d,2003-10-01,4,23,4,23,27
71105,SAN ANTONIO DE LOMERIO,estado nutricional en menores de 5 anos,clasificacion d,2003-10-01,74,113,74,113,187
31403,SAN BENITO,estado nutricional en menores de 5 anos,clasificacion d,2003-10-01,17,18,17,18,35
80302,SAN BORJA,estado nutricional en menores de 5 anos,clasificacion d,2003-10-01,159,105,159,105,264
21502,SAN BUENA VENTURA,estado nutricional en menores de 5 anos,clasificacion d,2003-10-01,46,25,46,25,71
70402,SAN CARLOS,estado nutricional en menores de 5 anos,clasificacion d,2003-10-01,57,61,57,61,118
80501,SAN IGNACIO,estado nutricional en menores de 5 anos,clasificacion d,2003-10-01,103,127,103,127,230
70301,SAN IGNACIO DE VELASCO,estado nutricional en menores de 5 anos,clasificacion d,2003-10-01,250,188,250,188,438
80102,SAN JAVIER(BNI),estado nutricional en menores de 5 anos,clasificacion d,2003-10-01,8,11,8,11,19
71102,SAN JAVIER(STC),estado nutricional en menores de 5 anos,clasificacion d,2003-10-01,53,47,53,47,100
80701,SAN JOAQUIN,estado nutricional en menores de 5 anos,clasificacion d,2003-10-01,7,24,7,24,31
70501,SAN JOSE DE CHIQUITOS,estado nutricional en menores de 5 anos,clasificacion d,2003-10-01,37,22,37,22,59
71104,SAN JULIAN,estado nutricional en menores de 5 anos,clasificacion d,2003-10-01,89,152,89,152,241
90302,SAN LORENZO(PND),estado nutricional en menores de 5 anos,clasificacion d,2003-10-01,1,1,1,1,2
60501,SAN LORENZO(TJA),estado nutricional en menores de 5 anos,clasificacion d,2003-10-01,47,68,47,68,115
10702,SAN LUCAS,estado nutricional en menores de 5 anos,clasificacion d,2003-10-01,366,459,366,459,825
71201,SAN MATIAS,estado nutricional en menores de 5 anos,clasificacion d,2003-10-01,55,30,55,30,85
70302,SAN MIGUEL DE VELASCO,estado nutricional en menores de 5 anos,clasificacion d,2003-10-01,59,71,59,71,130
51001,SAN PABLO DE LIPEZ,estado nutricional en menores de 5 anos,clasificacion d,2003-10-01,20,17,20,17,37
50501,SAN PEDRO DE BUENA VISTA,estado nutricional en menores de 5 anos,clasificacion d,2003-10-01,157,253,157,253,410
21801,SAN PEDRO DE CURAHUARA,estado nutricional en menores de 5 anos,clasificacion d,2003-10-01,15,21,15,21,36
50902,SAN PEDRO DE QUEMES,estado nutricional en menores de 5 anos,clasificacion d,2003-10-01,3,1,3,1,4
21702,SAN PEDRO DE TIQUINA,estado nutricional en menores de 5 anos,clasificacion d,2003-10-01,3,4,3,4,7
90202,SAN PEDRO(PND),estado nutricional en menores de 5 anos,clasificacion d,2003-10-01,8,9,8,9,17
70303,SAN RAFAEL,estado nutricional en menores de 5 anos,clasificacion d,2003-10-01,31,38,31,38,69
80702,SAN RAMON,estado nutricional en menores de 5 anos,clasificacion d,2003-10-01,8,10,8,10,18
80401,SANTA ANA,estado nutricional en menores de 5 anos,clasificacion d,2003-10-01,32,24,32,24,56
70101,SANTA CRUZ DE LA SIERRA,estado nutricional en menores de 5 anos,clasificacion d,2003-10-01,1092,549,1092,549,1641
80303,SANTA ROSA,estado nutricional en menores de 5 anos,clasificacion d,2003-10-01,12,11,12,11,23
70602,SANTA ROSA DEL SARA,estado nutricional en menores de 5 anos,clasificacion d,2003-10-01,16,15,16,15,31
20308,SANTIAGO DE CALLAPA,estado nutricional en menores de 5 anos,clasificacion d,2003-10-01,29,42,29,42,71
41401,SANTIAGO DE HUARI,estado nutricional en menores de 5 anos,clasificacion d,2003-10-01,22,39,22,39,61
21901,SANTIAGO DE MACHACA,estado nutricional en menores de 5 anos,clasificacion d,2003-10-01,12,9,12,9,21
30702,SANTIVAÃ‘ES,estado nutricional en menores de 5 anos,clasificacion d,2003-10-01,21,20,21,20,41
40202,SANTUARIO DE QUILLACAS,estado nutricional en menores de 5 anos,clasificacion d,2003-10-01,5,8,5,8,13
20902,SAPAHAQUI,estado nutricional en menores de 5 anos,clasificacion d,2003-10-01,39,49,39,49,88
90303,SENA,estado nutricional en menores de 5 anos,clasificacion d,2003-10-01,5,6,5,6,11
21301,SICA SICA (VILLA AROMA),estado nutricional en menores de 5 anos,clasificacion d,2003-10-01,135,114,135,114,249
30703,SICAYA,estado nutricional en menores de 5 anos,clasificacion d,2003-10-01,10,14,10,14,24
30902,SIPE SIPE,estado nutricional en menores de 5 anos,clasificacion d,2003-10-01,145,117,145,117,262
10403,SOPACHUY,estado nutricional en menores de 5 anos,clasificacion d,2003-10-01,81,152,81,152,233
20601,SORATA,estado nutricional en menores de 5 anos,clasificacion d,2003-10-01,46,55,46,55,101
10101,SUCRE,estado nutricional en menores de 5 anos,clasificacion d,2003-10-01,446,597,446,597,1043
31404,TACACHI,estado nutricional en menores de 5 anos,clasificacion d,2003-10-01,11,0,11,0,11
20603,TACACOMA,estado nutricional en menores de 5 anos,clasificacion d,2003-10-01,13,2,13,2,15
50303,TACOBAMBA,estado nutricional en menores de 5 anos,clasificacion d,2003-10-01,68,117,68,117,185
30602,TACOPAYA,estado nutricional en menores de 5 anos,clasificacion d,2003-10-01,71,135,71,135,206
51402,TAHUA,estado nutricional en menores de 5 anos,clasificacion d,2003-10-01,8,5,8,5,13
31101,TAPACARI,estado nutricional en menores de 5 anos,clasificacion d,2003-10-01,138,130,138,130,268
10601,TARABUCO,estado nutricional en menores de 5 anos,clasificacion d,2003-10-01,262,490,262,490,752
30401,TARATA,estado nutricional en menores de 5 anos,clasificacion d,2003-10-01,40,27,40,27,67
60101,TARIJA,estado nutricional en menores de 5 anos,clasificacion d,2003-10-01,316,301,316,301,617
10202,TARVITA,estado nutricional en menores de 5 anos,clasificacion d,2003-10-01,109,163,109,163,272
20803,TIAWANACU,estado nutricional en menores de 5 anos,clasificacion d,2003-10-01,25,15,25,15,40
50102,TINGUIPAYA,estado nutricional en menores de 5 anos,clasificacion d,2003-10-01,170,286,170,286,456
20606,TIPUANI,estado nutricional en menores de 5 anos,clasificacion d,2003-10-01,9,20,9,20,29
30903,TIQUIPAYA,estado nutricional en menores de 5 anos,clasificacion d,2003-10-01,85,67,85,67,152
31601,TIRAQUE (CBBA),estado nutricional en menores de 5 anos,clasificacion d,2003-10-01,198,124,198,124,322
21703,TITO YUPANQUI (PARQUIPUJIO),estado nutricional en menores de 5 anos,clasificacion d,2003-10-01,13,11,13,11,24
30802,TOCO,estado nutricional en menores de 5 anos,clasificacion d,2003-10-01,1,11,1,11,12
30803,TOLATA,estado nutricional en menores de 5 anos,clasificacion d,2003-10-01,13,9,13,9,22
41001,TOLEDO,estado nutricional en menores de 5 anos,clasificacion d,2003-10-01,17,10,17,10,27
51202,TOMAVE,estado nutricional en menores de 5 anos,clasificacion d,2003-10-01,66,84,66,84,150
10402,TOMINA,estado nutricional en menores de 5 anos,clasificacion d,2003-10-01,126,256,126,256,382
50502,TORO TORO,estado nutricional en menores de 5 anos,clasificacion d,2003-10-01,95,106,95,106,201
31201,TOTORA(CBBA),estado nutricional en menores de 5 anos,clasificacion d,2003-10-01,50,40,50,40,90
41301,TOTORA(ORR),estado nutricional en menores de 5 anos,clasificacion d,2003-10-01,19,22,19,22,41
70802,TRIGAL,estado nutricional en menores de 5 anos,clasificacion d,2003-10-01,4,6,4,6,10
80101,TRINIDAD,estado nutricional en menores de 5 anos,clasificacion d,2003-10-01,177,185,177,185,362
50801,TUPIZA,estado nutricional en menores de 5 anos,clasificacion d,2003-10-01,167,255,167,255,422
40402,TURCO,estado nutricional en menores de 5 anos,clasificacion d,2003-10-01,15,18,15,18,33
21302,UMALA,estado nutricional en menores de 5 anos,clasificacion d,2003-10-01,6,40,6,40,46
50201,UNCIA,estado nutricional en menores de 5 anos,clasificacion d,2003-10-01,64,20,64,20,84
60401,URIONDO (A. CONCEPCION),estado nutricional en menores de 5 anos,clasificacion d,2003-10-01,93,143,93,143,236
71502,URUBICHA,estado nutricional en menores de 5 anos,clasificacion d,2003-10-01,96,192,96,192,288
51201,UYUNI,estado nutricional en menores de 5 anos,clasificacion d,2003-10-01,55,83,55,83,138
30502,VACAS,estado nutricional en menores de 5 anos,clasificacion d,2003-10-01,39,14,39,14,53
70801,VALLEGRANDE,estado nutricional en menores de 5 anos,clasificacion d,2003-10-01,65,105,65,105,170
20801,VIACHA,estado nutricional en menores de 5 anos,clasificacion d,2003-10-01,108,86,108,86,194
31302,VILA VILA,estado nutricional en menores de 5 anos,clasificacion d,2003-10-01,38,67,38,67,105
60303,VILLA MONTES,estado nutricional en menores de 5 anos,clasificacion d,2003-10-01,94,79,94,79,173
31402,VILLA RIVERO,estado nutricional en menores de 5 anos,clasificacion d,2003-10-01,22,19,22,19,41
10801,VILLA SERRANO,estado nutricional en menores de 5 anos,clasificacion d,2003-10-01,114,252,114,252,366
31003,VILLA TUNARI,estado nutricional en menores de 5 anos,clasificacion d,2003-10-01,219,275,219,275,494
11001,VILLA VACA GUZMAN (MUYUPAMPA),estado nutricional en menores de 5 anos,clasificacion d,2003-10-01,80,109,80,109,189
51501,VILLAZON,estado nutricional en menores de 5 anos,clasificacion d,2003-10-01,147,212,147,212,359
30904,VINTO,estado nutricional en menores de 5 anos,clasificacion d,2003-10-01,58,22,58,22,80
50602,VITICHI,estado nutricional en menores de 5 anos,clasificacion d,2003-10-01,132,226,132,226,358
20306,WALDO BALLIVIAN,estado nutricional en menores de 5 anos,clasificacion d,2003-10-01,13,9,13,9,22
20903,YACO,estado nutricional en menores de 5 anos,clasificacion d,2003-10-01,45,47,45,47,92
60301,YACUIBA,estado nutricional en menores de 5 anos,clasificacion d,2003-10-01,16,32,16,32,48
10602,YAMPARAEZ,estado nutricional en menores de 5 anos,clasificacion d,2003-10-01,154,288,154,288,442
21103,YANACACHI,estado nutricional en menores de 5 anos,clasificacion d,2003-10-01,13,10,13,10,23
70403,YAPACANI,estado nutricional en menores de 5 anos,clasificacion d,2003-10-01,153,136,153,136,289
50103,YOCALLA,estado nutricional en menores de 5 anos,clasificacion d,2003-10-01,28,62,28,62,90
10102,YOTALA,estado nutricional en menores de 5 anos,clasificacion d,2003-10-01,98,180,98,180,278
60402,YUNCHARA,estado nutricional en menores de 5 anos,clasificacion d,2003-10-01,69,95,69,95,164
10301,ZUDAÃ‘EZ,estado nutricional en menores de 5 anos,clasificacion d,2003-10-01,63,103,63,103,166
51302,ACACIO,estado nutricional en menores de 5 anos,clasificacion d,2003-11-01,48,80,48,80,128
20201,ACHACACHI,estado nutricional en menores de 5 anos,clasificacion d,2003-11-01,127,156,127,156,283
20104,ACHOCALLA,estado nutricional en menores de 5 anos,clasificacion d,2003-11-01,23,34,23,34,57
30201,AIQUILE,estado nutricional en menores de 5 anos,clasificacion d,2003-11-01,57,53,57,53,110
31303,ALALAY,estado nutricional en menores de 5 anos,clasificacion d,2003-11-01,12,9,12,9,21
10404,ALCALA,estado nutricional en menores de 5 anos,clasificacion d,2003-11-01,33,70,33,70,103
20202,ANCORAIMES,estado nutricional en menores de 5 anos,clasificacion d,2003-11-01,78,99,78,99,177
41201,ANDAMARCA,estado nutricional en menores de 5 anos,clasificacion d,2003-11-01,4,8,4,8,12
40603,ANTEQUERA,estado nutricional en menores de 5 anos,clasificacion d,2003-11-01,4,3,4,3,7
30402,ANZALDO,estado nutricional en menores de 5 anos,clasificacion d,2003-11-01,11,27,11,27,38
20701,APOLO,estado nutricional en menores de 5 anos,clasificacion d,2003-11-01,34,34,34,34,68
51301,ARAMPAMPA,estado nutricional en menores de 5 anos,clasificacion d,2003-11-01,30,84,30,84,114
30501,ARANI,estado nutricional en menores de 5 anos,clasificacion d,2003-11-01,32,23,32,23,55
30403,ARBIETO,estado nutricional en menores de 5 anos,clasificacion d,2003-11-01,7,2,7,2,9
30601,ARQUE,estado nutricional en menores de 5 anos,clasificacion d,2003-11-01,85,116,85,116,201
50802,ATOCHA,estado nutricional en menores de 5 anos,clasificacion d,2003-11-01,46,162,46,162,208
20503,AUCAPATA,estado nutricional en menores de 5 anos,clasificacion d,2003-11-01,34,37,34,37,71
20502,AYATA,estado nutricional en menores de 5 anos,clasificacion d,2003-11-01,64,54,64,54,118
21303,AYO AYO,estado nutricional en menores de 5 anos,clasificacion d,2003-11-01,11,5,11,5,16
30301,AYOPAYA (V. DE INDEPENDENCIA),estado nutricional en menores de 5 anos,clasificacion d,2003-11-01,43,55,43,55,98
10201,AZURDUY,estado nutricional en menores de 5 anos,clasificacion d,2003-11-01,157,340,157,340,497
21203,BATALLAS,estado nutricional en menores de 5 anos,clasificacion d,2003-11-01,35,26,35,26,61
80802,BAURES,estado nutricional en menores de 5 anos,clasificacion d,2003-11-01,12,10,12,10,22
41202,BELEN DE ANDAMARCA,estado nutricional en menores de 5 anos,clasificacion d,2003-11-01,2,0,2,0,2
50104,BELEN DE URMIRI,estado nutricional en menores de 5 anos,clasificacion d,2003-11-01,5,17,5,17,22
90104,BELLA FLOR,estado nutricional en menores de 5 anos,clasificacion d,2003-11-01,6,12,6,12,18
60202,BERMEJO,estado nutricional en menores de 5 anos,clasificacion d,2003-11-01,7,11,7,11,18
50301,BETANZOS,estado nutricional en menores de 5 anos,clasificacion d,2003-11-01,219,366,219,366,585
31501,BOLIVAR,estado nutricional en menores de 5 anos,clasificacion d,2003-11-01,47,71,47,71,118
90103,BOLPEBRA,estado nutricional en menores de 5 anos,clasificacion d,2003-11-01,5,11,5,11,16
70707,BOYUIBE,estado nutricional en menores de 5 anos,clasificacion d,2003-11-01,12,8,12,8,20
70401,BUENA VISTA,estado nutricional en menores de 5 anos,clasificacion d,2003-11-01,28,39,28,39,67
70703,CABEZAS,estado nutricional en menores de 5 anos,clasificacion d,2003-11-01,30,39,30,39,69
20905,CAIROMA,estado nutricional en menores de 5 anos,clasificacion d,2003-11-01,69,63,69,63,132
51102,"CAIZA ""D""",estado nutricional en menores de 5 anos,clasificacion d,2003-11-01,36,32,36,32,68
21003,CAJUATA,estado nutricional en menores de 5 anos,clasificacion d,2003-11-01,16,17,16,17,33
20303,CALACOTO,estado nutricional en menores de 5 anos,clasificacion d,2003-11-01,14,8,14,8,22
21304,CALAMARCA,estado nutricional en menores de 5 anos,clasificacion d,2003-11-01,102,85,102,85,187
10701,CAMARGO,estado nutricional en menores de 5 anos,clasificacion d,2003-11-01,125,146,125,146,271
10901,CAMATAQUI (C. VILLA ABECIA),estado nutricional en menores de 5 anos,clasificacion d,2003-11-01,18,16,18,16,34
70706,CAMIRI,estado nutricional en menores de 5 anos,clasificacion d,2003-11-01,144,115,144,115,259
30701,CAPINOTA,estado nutricional en menores de 5 anos,clasificacion d,2003-11-01,19,51,19,51,70
20302,CAQUIAVIRI,estado nutricional en menores de 5 anos,clasificacion d,2003-11-01,27,13,27,13,40
40102,CARACOLLO,estado nutricional en menores de 5 anos,clasificacion d,2003-11-01,50,64,50,64,114
22001,CARANAVI,estado nutricional en menores de 5 anos,clasificacion d,2003-11-01,199,207,199,207,406
60302,CARAPARI,estado nutricional en menores de 5 anos,clasificacion d,2003-11-01,30,40,30,40,70
50702,CARIPUYO,estado nutricional en menores de 5 anos,clasificacion d,2003-11-01,82,112,82,112,194
21902,CATACORA,estado nutricional en menores de 5 anos,clasificacion d,2003-11-01,1,4,1,4,5
21803,CHACARILLA,estado nutricional en menores de 5 anos,clasificacion d,2003-11-01,11,23,11,23,34
40201,CHALLAPATA,estado nutricional en menores de 5 anos,clasificacion d,2003-11-01,63,95,63,95,158
50302,CHAQUI,estado nutricional en menores de 5 anos,clasificacion d,2003-11-01,35,50,35,50,85
70702,CHARAGUA,estado nutricional en menores de 5 anos,clasificacion d,2003-11-01,119,117,119,117,236
20305,CHARAÃ‘A,estado nutricional en menores de 5 anos,clasificacion d,2003-11-01,3,3,3,3,6
50202,CHAYANTA,estado nutricional en menores de 5 anos,clasificacion d,2003-11-01,86,149,86,149,235
31204,CHIMORE,estado nutricional en menores de 5 anos,clasificacion d,2003-11-01,34,29,34,29,63
40903,CHIPAYA,estado nutricional en menores de 5 anos,clasificacion d,2003-11-01,1,5,1,5,6
40302,CHOQUE COTA,estado nutricional en menores de 5 anos,clasificacion d,2003-11-01,5,9,5,9,14
21101,CHULUMANI (V. DE LA LIBERTAD),estado nutricional en menores de 5 anos,clasificacion d,2003-11-01,26,65,26,65,91
20501,CHUMA,estado nutricional en menores de 5 anos,clasificacion d,2003-11-01,78,86,78,86,164
30801,CLIZA,estado nutricional en menores de 5 anos,clasificacion d,2003-11-01,14,2,14,2,16
90101,COBIJA,estado nutricional en menores de 5 anos,clasificacion d,2003-11-01,97,78,97,78,175
30101,COCHABAMBA,estado nutricional en menores de 5 anos,clasificacion d,2003-11-01,518,485,518,485,1003
40902,COIPASA,estado nutricional en menores de 5 anos,clasificacion d,2003-11-01,1,1,1,1,2
30905,COLCAPIRHUA,estado nutricional en menores de 5 anos,clasificacion d,2003-11-01,72,47,72,47,119
50901,"COLCHA ""K""",estado nutricional en menores de 5 anos,clasificacion d,2003-11-01,35,54,35,54,89
21307,COLLANA,estado nutricional en menores de 5 anos,clasificacion d,2003-11-01,3,3,3,3,6
31002,COLOMI,estado nutricional en menores de 5 anos,clasificacion d,2003-11-01,83,87,83,87,170
50401,COLQUECHACA,estado nutricional en menores de 5 anos,clasificacion d,2003-11-01,185,133,185,133,318
21306,COLQUENCHA,estado nutricional en menores de 5 anos,clasificacion d,2003-11-01,32,32,32,32,64
21004,COLQUIRI,estado nutricional en menores de 5 anos,clasificacion d,2003-11-01,85,74,85,74,159
20304,COMANCHE,estado nutricional en menores de 5 anos,clasificacion d,2003-11-01,12,16,12,16,28
71301,COMARAPA,estado nutricional en menores de 5 anos,clasificacion d,2003-11-01,54,57,54,57,111
20605,COMBAYA,estado nutricional en menores de 5 anos,clasificacion d,2003-11-01,4,12,4,12,16
71101,CONCEPCION,estado nutricional en menores de 5 anos,clasificacion d,2003-11-01,38,12,38,12,50
21701,COPACABANA,estado nutricional en menores de 5 anos,clasificacion d,2003-11-01,17,12,17,12,29
21402,CORIPATA,estado nutricional en menores de 5 anos,clasificacion d,2003-11-01,7,1,7,1,8
20301,CORO CORO,estado nutricional en menores de 5 anos,clasificacion d,2003-11-01,52,46,52,46,98
21401,COROICO,estado nutricional en menores de 5 anos,clasificacion d,2003-11-01,26,29,26,29,55
40301,CORQUE,estado nutricional en menores de 5 anos,clasificacion d,2003-11-01,21,32,21,32,53
50601,COTAGAITA,estado nutricional en menores de 5 anos,clasificacion d,2003-11-01,209,262,209,262,471
31405,CUCHUMUELA (V. G. VILLARROEL),estado nutricional en menores de 5 anos,clasificacion d,2003-11-01,8,3,8,3,11
70704,CUEVO,estado nutricional en menores de 5 anos,clasificacion d,2003-11-01,23,13,23,13,36
10902,CULPINA,estado nutricional en menores de 5 anos,clasificacion d,2003-11-01,227,296,227,296,523
40401,CURAHUARA DE CARANGAS,estado nutricional en menores de 5 anos,clasificacion d,2003-11-01,19,9,19,9,28
21602,CURVA,estado nutricional en menores de 5 anos,clasificacion d,2003-11-01,23,25,23,25,48
20804,DESAGUADERO,estado nutricional en menores de 5 anos,clasificacion d,2003-11-01,10,2,10,2,12
20105,EL ALTO,estado nutricional en menores de 5 anos,clasificacion d,2003-11-01,1699,1199,1699,1199,2898
40103,EL CHORO,estado nutricional en menores de 5 anos,clasificacion d,2003-11-01,8,7,8,7,15
71503,EL PUENTE(STC),estado nutricional en menores de 5 anos,clasificacion d,2003-11-01,60,58,60,58,118
60502,EL PUENTE(TJA),estado nutricional en menores de 5 anos,clasificacion d,2003-11-01,60,140,60,140,200
70105,EL TORNO,estado nutricional en menores de 5 anos,clasificacion d,2003-11-01,75,98,75,98,173
10405,EL VILLAR,estado nutricional en menores de 5 anos,clasificacion d,2003-11-01,65,157,65,157,222
60601,ENTRE RIOS,estado nutricional en menores de 5 anos,clasificacion d,2003-11-01,69,120,69,120,189
40502,ESCARA,estado nutricional en menores de 5 anos,clasificacion d,2003-11-01,1,3,1,3,4
41101,EUCALIPTUS,estado nutricional en menores de 5 anos,clasificacion d,2003-11-01,17,23,17,23,40
90503,EUREKA (SANTOS MERCADO),estado nutricional en menores de 5 anos,clasificacion d,2003-11-01,4,4,4,4,8
80402,EXALTACION,estado nutricional en menores de 5 anos,clasificacion d,2003-11-01,10,18,10,18,28
90203,FILADELFIA,estado nutricional en menores de 5 anos,clasificacion d,2003-11-01,6,25,6,25,31
71002,GENERAL SAAVEDRA,estado nutricional en menores de 5 anos,clasificacion d,2003-11-01,98,132,98,132,230
21601,GRAL. J.J. PEREZ (CHARAZANI),estado nutricional en menores de 5 anos,clasificacion d,2003-11-01,85,158,85,158,243
20602,GUANAY,estado nutricional en menores de 5 anos,clasificacion d,2003-11-01,108,158,108,158,266
20802,GUAQUI,estado nutricional en menores de 5 anos,clasificacion d,2003-11-01,17,6,17,6,23
80202,GUAYARAMERIN,estado nutricional en menores de 5 anos,clasificacion d,2003-11-01,80,92,80,92,172
70705,GUTIERREZ,estado nutricional en menores de 5 anos,clasificacion d,2003-11-01,90,170,90,170,260
10502,HUACARETA,estado nutricional en menores de 5 anos,clasificacion d,2003-11-01,64,123,64,123,187
11002,HUACAYA (VILLA DE HUACAYA),estado nutricional en menores de 5 anos,clasificacion d,2003-11-01,17,28,17,28,45
40501,HUACHACALLA,estado nutricional en menores de 5 anos,clasificacion d,2003-11-01,9,1,9,1,10
40701,HUANUNI,estado nutricional en menores de 5 anos,clasificacion d,2003-11-01,39,37,39,37,76
80803,HUARACAJE,estado nutricional en menores de 5 anos,clasificacion d,2003-11-01,8,12,8,12,20
41601,HUAYLLAMARCA,estado nutricional en menores de 5 anos,clasificacion d,2003-11-01,13,4,13,4,17
21005,ICHOCA,estado nutricional en menores de 5 anos,clasificacion d,2003-11-01,15,26,15,26,41
10304,ICLA,estado nutricional en menores de 5 anos,clasificacion d,2003-11-01,115,262,115,262,377
10703,INCAHUASI,estado nutricional en menores de 5 anos,clasificacion d,2003-11-01,237,273,237,273,510
21001,INQUISIVI,estado nutricional en menores de 5 anos,clasificacion d,2003-11-01,92,93,92,93,185
21102,IRUPANA (VILLA DE LANZA),estado nutricional en menores de 5 anos,clasificacion d,2003-11-01,41,72,41,72,113
21501,IXIAMAS,estado nutricional en menores de 5 anos,clasificacion d,2003-11-01,26,68,26,68,94
21105,LA ASUNTA,estado nutricional en menores de 5 anos,clasificacion d,2003-11-01,78,75,78,75,153
70104,LA GUARDIA,estado nutricional en menores de 5 anos,clasificacion d,2003-11-01,70,63,70,63,133
20101,LA PAZ,estado nutricional en menores de 5 anos,clasificacion d,2003-11-01,1146,1058,1146,1058,2204
41501,LA RIVERA,estado nutricional en menores de 5 anos,clasificacion d,2003-11-01,3,0,3,0,3
70701,LAGUNILLAS,estado nutricional en menores de 5 anos,clasificacion d,2003-11-01,31,24,31,24,55
21202,LAJA,estado nutricional en menores de 5 anos,clasificacion d,2003-11-01,27,29,27,29,56
10903,LAS CARRERAS,estado nutricional en menores de 5 anos,clasificacion d,2003-11-01,22,55,22,55,77
21006,LICOMA PAMPA,estado nutricional en menores de 5 anos,clasificacion d,2003-11-01,11,17,11,17,28
50203,LLALLAGUA,estado nutricional en menores de 5 anos,clasificacion d,2003-11-01,177,331,177,331,508
51401,LLICA,estado nutricional en menores de 5 anos,clasificacion d,2003-11-01,8,9,8,9,17
80601,LORETO,estado nutricional en menores de 5 anos,clasificacion d,2003-11-01,5,17,5,17,22
20901,LURIBAY,estado nutricional en menores de 5 anos,clasificacion d,2003-11-01,30,26,30,26,56
40702,MACHACAMARCA,estado nutricional en menores de 5 anos,clasificacion d,2003-11-01,5,2,5,2,7
11003,MACHARETI,estado nutricional en menores de 5 anos,clasificacion d,2003-11-01,28,78,28,78,106
80801,MAGDALENA,estado nutricional en menores de 5 anos,clasificacion d,2003-11-01,37,37,37,37,74
70903,MAIRANA,estado nutricional en menores de 5 anos,clasificacion d,2003-11-01,6,5,6,5,11
20103,MECAPACA,estado nutricional en menores de 5 anos,clasificacion d,2003-11-01,16,32,16,32,48
31301,MIZQUE,estado nutricional en menores de 5 anos,clasificacion d,2003-11-01,28,21,28,21,49
20402,MOCOMOCO,estado nutricional en menores de 5 anos,clasificacion d,2003-11-01,69,118,69,118,187
51002,MOJINETE,estado nutricional en menores de 5 anos,clasificacion d,2003-11-01,9,14,9,14,23
10303,MOJOCOYA,estado nutricional en menores de 5 anos,clasificacion d,2003-11-01,71,129,71,129,200
10501,MONTEAGUDO,estado nutricional en menores de 5 anos,clasificacion d,2003-11-01,137,247,137,247,384
70803,MORO MORO,estado nutricional en menores de 5 anos,clasificacion d,2003-11-01,6,11,6,11,17
30302,MOROCHATA,estado nutricional en menores de 5 anos,clasificacion d,2003-11-01,103,99,103,99,202
90401,NACEBE (SANTA ROSA DEL ABUNA),estado nutricional en menores de 5 anos,clasificacion d,2003-11-01,4,5,4,5,9
20307,NAZACARA DE PACAJES,estado nutricional en menores de 5 anos,clasificacion d,2003-11-01,1,5,1,5,6
50404,OCURI,estado nutricional en menores de 5 anos,clasificacion d,2003-11-01,103,106,103,106,209
30203,OMEREQUE,estado nutricional en menores de 5 anos,clasificacion d,2003-11-01,19,21,19,21,40
40101,ORURO,estado nutricional en menores de 5 anos,clasificacion d,2003-11-01,650,442,650,442,1092
60201,PADCAYA,estado nutricional en menores de 5 anos,clasificacion d,2003-11-01,44,51,44,51,95
10401,PADILLA,estado nutricional en menores de 5 anos,clasificacion d,2003-11-01,115,249,115,249,364
70502,PAILON,estado nutricional en menores de 5 anos,clasificacion d,2003-11-01,25,32,25,32,57
20102,PALCA,estado nutricional en menores de 5 anos,clasificacion d,2003-11-01,30,36,30,36,66
21104,PALOS BLANCOS,estado nutricional en menores de 5 anos,clasificacion d,2003-11-01,70,70,70,70,140
40802,PAMPA AULLAGAS,estado nutricional en menores de 5 anos,clasificacion d,2003-11-01,13,27,13,27,40
70902,PAMPA GRANDE,estado nutricional en menores de 5 anos,clasificacion d,2003-11-01,9,10,9,10,19
21802,PAPEL PAMPA,estado nutricional en menores de 5 anos,clasificacion d,2003-11-01,5,4,5,4,9
30202,PASORAPA,estado nutricional en menores de 5 anos,clasificacion d,2003-11-01,10,11,10,11,21
21305,PATACAMAYA,estado nutricional en menores de 5 anos,clasificacion d,2003-11-01,73,40,73,40,113
40602,PAZÃ‘A,estado nutricional en menores de 5 anos,clasificacion d,2003-11-01,11,14,11,14,25
20702,PELECHUCO,estado nutricional en menores de 5 anos,clasificacion d,2003-11-01,44,52,44,52,96
50403,POCOATA,estado nutricional en menores de 5 anos,clasificacion d,2003-11-01,168,240,168,240,408
31203,POCONA,estado nutricional en menores de 5 anos,clasificacion d,2003-11-01,53,46,53,46,99
31202,POJO (CBBA),estado nutricional en menores de 5 anos,clasificacion d,2003-11-01,145,154,145,154,299
40601,POOPO,estado nutricional en menores de 5 anos,clasificacion d,2003-11-01,16,18,16,18,34
51203,PORCO,estado nutricional en menores de 5 anos,clasificacion d,2003-11-01,24,43,24,43,67
10103,POROMA,estado nutricional en menores de 5 anos,clasificacion d,2003-11-01,179,203,179,203,382
70103,PORONGO,estado nutricional en menores de 5 anos,clasificacion d,2003-11-01,18,10,18,10,28
70601,PORTACHUELO,estado nutricional en menores de 5 anos,clasificacion d,2003-11-01,39,38,39,38,77
90102,PORVENIR,estado nutricional en menores de 5 anos,clasificacion d,2003-11-01,9,7,9,7,16
70804,POSTRER VALLE,estado nutricional en menores de 5 anos,clasificacion d,2003-11-01,4,9,4,9,13
50101,POTOSI,estado nutricional en menores de 5 anos,clasificacion d,2003-11-01,596,412,596,412,1008
10302,PRESTO,estado nutricional en menores de 5 anos,clasificacion d,2003-11-01,83,146,83,146,229
21201,PUCARANI,estado nutricional en menores de 5 anos,clasificacion d,2003-11-01,39,41,39,41,80
20401,PUERTO ACOSTA,estado nutricional en menores de 5 anos,clasificacion d,2003-11-01,83,82,83,82,165
20403,PUERTO CARABUCO,estado nutricional en menores de 5 anos,clasificacion d,2003-11-01,44,84,44,84,128
90301,PUERTO GONZALO MORENO,estado nutricional en menores de 5 anos,clasificacion d,2003-11-01,50,69,50,69,119
21204,PUERTO PEREZ,estado nutricional en menores de 5 anos,clasificacion d,2003-11-01,10,15,10,15,25
71402,PUERTO QUIJARRO,estado nutricional en menores de 5 anos,clasificacion d,2003-11-01,24,6,24,6,30
90201,PUERTO RICO,estado nutricional en menores de 5 anos,clasificacion d,2003-11-01,6,27,6,27,33
71401,PUERTO SUAREZ,estado nutricional en menores de 5 anos,clasificacion d,2003-11-01,47,40,47,40,87
31205,PUERTO VILLARROEL,estado nutricional en menores de 5 anos,clasificacion d,2003-11-01,140,173,140,173,313
51101,PUNA,estado nutricional en menores de 5 anos,clasificacion d,2003-11-01,179,217,179,217,396
31401,PUNATA,estado nutricional en menores de 5 anos,clasificacion d,2003-11-01,45,70,45,70,115
20604,QUIABAYA,estado nutricional en menores de 5 anos,clasificacion d,2003-11-01,11,13,11,13,24
30901,QUILLACOLLO,estado nutricional en menores de 5 anos,clasificacion d,2003-11-01,118,114,118,114,232
21002,QUIME,estado nutricional en menores de 5 anos,clasificacion d,2003-11-01,53,57,53,57,110
70904,QUIRUSILLAS,estado nutricional en menores de 5 anos,clasificacion d,2003-11-01,3,6,3,6,9
50402,RAVELO,estado nutricional en menores de 5 anos,clasificacion d,2003-11-01,147,189,147,189,336
80301,REYES,estado nutricional en menores de 5 anos,clasificacion d,2003-11-01,40,40,40,40,80
80201,RIBERALTA,estado nutricional en menores de 5 anos,clasificacion d,2003-11-01,351,249,351,249,600
70503,ROBORE,estado nutricional en menores de 5 anos,clasificacion d,2003-11-01,37,25,37,25,62
80304,RURRENABAQUE,estado nutricional en menores de 5 anos,clasificacion d,2003-11-01,32,21,32,21,53
40901,SABAYA,estado nutricional en menores de 5 anos,clasificacion d,2003-11-01,2,1,2,1,3
31001,SACABA,estado nutricional en menores de 5 anos,clasificacion d,2003-11-01,141,203,141,203,344
30404,SACABAMBA,estado nutricional en menores de 5 anos,clasificacion d,2003-11-01,22,31,22,31,53
50701,SACACA,estado nutricional en menores de 5 anos,clasificacion d,2003-11-01,279,433,279,433,712
71302,SAIPINA,estado nutricional en menores de 5 anos,clasificacion d,2003-11-01,12,27,12,27,39
40801,SALINAS DE GARCI MENDOZA,estado nutricional en menores de 5 anos,clasificacion d,2003-11-01,17,35,17,35,52
70901,SAMAIPATA,estado nutricional en menores de 5 anos,clasificacion d,2003-11-01,33,38,33,38,71
51601,SAN AGUSTIN,estado nutricional en menores de 5 anos,clasificacion d,2003-11-01,2,9,2,9,11
80602,SAN ANDRES,estado nutricional en menores de 5 anos,clasificacion d,2003-11-01,35,41,35,41,76
51003,SAN ANTONIO DE ESMORUCO,estado nutricional en menores de 5 anos,clasificacion d,2003-11-01,0,7,0,7,7
71105,SAN ANTONIO DE LOMERIO,estado nutricional en menores de 5 anos,clasificacion d,2003-11-01,69,102,69,102,171
31403,SAN BENITO,estado nutricional en menores de 5 anos,clasificacion d,2003-11-01,8,21,8,21,29
80302,SAN BORJA,estado nutricional en menores de 5 anos,clasificacion d,2003-11-01,135,132,135,132,267
21502,SAN BUENA VENTURA,estado nutricional en menores de 5 anos,clasificacion d,2003-11-01,45,28,45,28,73
70402,SAN CARLOS,estado nutricional en menores de 5 anos,clasificacion d,2003-11-01,52,60,52,60,112
80501,SAN IGNACIO,estado nutricional en menores de 5 anos,clasificacion d,2003-11-01,88,128,88,128,216
70301,SAN IGNACIO DE VELASCO,estado nutricional en menores de 5 anos,clasificacion d,2003-11-01,237,215,237,215,452
80102,SAN JAVIER(BNI),estado nutricional en menores de 5 anos,clasificacion d,2003-11-01,6,8,6,8,14
71102,SAN JAVIER(STC),estado nutricional en menores de 5 anos,clasificacion d,2003-11-01,59,75,59,75,134
80701,SAN JOAQUIN,estado nutricional en menores de 5 anos,clasificacion d,2003-11-01,3,1,3,1,4
70501,SAN JOSE DE CHIQUITOS,estado nutricional en menores de 5 anos,clasificacion d,2003-11-01,26,22,26,22,48
71104,SAN JULIAN,estado nutricional en menores de 5 anos,clasificacion d,2003-11-01,145,213,145,213,358
90302,SAN LORENZO(PND),estado nutricional en menores de 5 anos,clasificacion d,2003-11-01,11,7,11,7,18
60501,SAN LORENZO(TJA),estado nutricional en menores de 5 anos,clasificacion d,2003-11-01,59,98,59,98,157
10702,SAN LUCAS,estado nutricional en menores de 5 anos,clasificacion d,2003-11-01,473,614,473,614,1087
70302,SAN MIGUEL DE VELASCO,estado nutricional en menores de 5 anos,clasificacion d,2003-11-01,41,36,41,36,77
51001,SAN PABLO DE LIPEZ,estado nutricional en menores de 5 anos,clasificacion d,2003-11-01,18,35,18,35,53
50501,SAN PEDRO DE BUENA VISTA,estado nutricional en menores de 5 anos,clasificacion d,2003-11-01,151,220,151,220,371
21801,SAN PEDRO DE CURAHUARA,estado nutricional en menores de 5 anos,clasificacion d,2003-11-01,25,34,25,34,59
50902,SAN PEDRO DE QUEMES,estado nutricional en menores de 5 anos,clasificacion d,2003-11-01,1,1,1,1,2
21702,SAN PEDRO DE TIQUINA,estado nutricional en menores de 5 anos,clasificacion d,2003-11-01,11,20,11,20,31
70303,SAN RAFAEL,estado nutricional en menores de 5 anos,clasificacion d,2003-11-01,33,21,33,21,54
80702,SAN RAMON,estado nutricional en menores de 5 anos,clasificacion d,2003-11-01,2,0,2,0,2
80702,SAN RAMON,estado nutricional en menores de 5 anos,clasificacion d,2003-11-01,5,7,5,7,12
80401,SANTA ANA,estado nutricional en menores de 5 anos,clasificacion d,2003-11-01,29,18,29,18,47
70101,SANTA CRUZ DE LA SIERRA,estado nutricional en menores de 5 anos,clasificacion d,2003-11-01,379,180,379,180,559
80303,SANTA ROSA,estado nutricional en menores de 5 anos,clasificacion d,2003-11-01,13,6,13,6,19
70602,SANTA ROSA DEL SARA,estado nutricional en menores de 5 anos,clasificacion d,2003-11-01,5,13,5,13,18
20308,SANTIAGO DE CALLAPA,estado nutricional en menores de 5 anos,clasificacion d,2003-11-01,25,38,25,38,63
41401,SANTIAGO DE HUARI,estado nutricional en menores de 5 anos,clasificacion d,2003-11-01,28,35,28,35,63
21901,SANTIAGO DE MACHACA,estado nutricional en menores de 5 anos,clasificacion d,2003-11-01,18,32,18,32,50
30702,SANTIVAÃ‘ES,estado nutricional en menores de 5 anos,clasificacion d,2003-11-01,19,15,19,15,34
40202,SANTUARIO DE QUILLACAS,estado nutricional en menores de 5 anos,clasificacion d,2003-11-01,11,12,11,12,23
20902,SAPAHAQUI,estado nutricional en menores de 5 anos,clasificacion d,2003-11-01,56,54,56,54,110
90303,SENA,estado nutricional en menores de 5 anos,clasificacion d,2003-11-01,19,18,19,18,37
21301,SICA SICA (VILLA AROMA),estado nutricional en menores de 5 anos,clasificacion d,2003-11-01,141,84,141,84,225
30703,SICAYA,estado nutricional en menores de 5 anos,clasificacion d,2003-11-01,15,10,15,10,25
30902,SIPE SIPE,estado nutricional en menores de 5 anos,clasificacion d,2003-11-01,135,104,135,104,239
10403,SOPACHUY,estado nutricional en menores de 5 anos,clasificacion d,2003-11-01,88,164,88,164,252
20601,SORATA,estado nutricional en menores de 5 anos,clasificacion d,2003-11-01,47,98,47,98,145
10101,SUCRE,estado nutricional en menores de 5 anos,clasificacion d,2003-11-01,763,1328,763,1328,2091
31404,TACACHI,estado nutricional en menores de 5 anos,clasificacion d,2003-11-01,2,1,2,1,3
20603,TACACOMA,estado nutricional en menores de 5 anos,clasificacion d,2003-11-01,16,17,16,17,33
50303,TACOBAMBA,estado nutricional en menores de 5 anos,clasificacion d,2003-11-01,70,70,70,70,140
30602,TACOPAYA,estado nutricional en menores de 5 anos,clasificacion d,2003-11-01,76,126,76,126,202
51402,TAHUA,estado nutricional en menores de 5 anos,clasificacion d,2003-11-01,3,4,3,4,7
31101,TAPACARI,estado nutricional en menores de 5 anos,clasificacion d,2003-11-01,143,136,143,136,279
10601,TARABUCO,estado nutricional en menores de 5 anos,clasificacion d,2003-11-01,258,494,258,494,752
30401,TARATA,estado nutricional en menores de 5 anos,clasificacion d,2003-11-01,22,14,22,14,36
60101,TARIJA,estado nutricional en menores de 5 anos,clasificacion d,2003-11-01,190,236,190,236,426
10202,TARVITA,estado nutricional en menores de 5 anos,clasificacion d,2003-11-01,172,412,172,412,584
20803,TIAWANACU,estado nutricional en menores de 5 anos,clasificacion d,2003-11-01,36,15,36,15,51
50102,TINGUIPAYA,estado nutricional en menores de 5 anos,clasificacion d,2003-11-01,185,214,185,214,399
20606,TIPUANI,estado nutricional en menores de 5 anos,clasificacion d,2003-11-01,18,13,18,13,31
30903,TIQUIPAYA,estado nutricional en menores de 5 anos,clasificacion d,2003-11-01,22,9,22,9,31
31601,TIRAQUE (CBBA),estado nutricional en menores de 5 anos,clasificacion d,2003-11-01,125,101,125,101,226
21703,TITO YUPANQUI (PARQUIPUJIO),estado nutricional en menores de 5 anos,clasificacion d,2003-11-01,4,6,4,6,10
30802,TOCO,estado nutricional en menores de 5 anos,clasificacion d,2003-11-01,1,14,1,14,15
41502,TODOS SANTOS,estado nutricional en menores de 5 anos,clasificacion d,2003-11-01,0,1,0,1,1
30803,TOLATA,estado nutricional en menores de 5 anos,clasificacion d,2003-11-01,6,2,6,2,8
41001,TOLEDO,estado nutricional en menores de 5 anos,clasificacion d,2003-11-01,17,19,17,19,36
51202,TOMAVE,estado nutricional en menores de 5 anos,clasificacion d,2003-11-01,68,116,68,116,184
10402,TOMINA,estado nutricional en menores de 5 anos,clasificacion d,2003-11-01,121,245,121,245,366
50502,TORO TORO,estado nutricional en menores de 5 anos,clasificacion d,2003-11-01,118,143,118,143,261
31201,TOTORA(CBBA),estado nutricional en menores de 5 anos,clasificacion d,2003-11-01,48,50,48,50,98
41301,TOTORA(ORR),estado nutricional en menores de 5 anos,clasificacion d,2003-11-01,25,44,25,44,69
70802,TRIGAL,estado nutricional en menores de 5 anos,clasificacion d,2003-11-01,1,3,1,3,4
80101,TRINIDAD,estado nutricional en menores de 5 anos,clasificacion d,2003-11-01,202,185,202,185,387
50801,TUPIZA,estado nutricional en menores de 5 anos,clasificacion d,2003-11-01,107,204,107,204,311
40402,TURCO,estado nutricional en menores de 5 anos,clasificacion d,2003-11-01,27,22,27,22,49
21302,UMALA,estado nutricional en menores de 5 anos,clasificacion d,2003-11-01,30,20,30,20,50
50201,UNCIA,estado nutricional en menores de 5 anos,clasificacion d,2003-11-01,53,32,53,32,85
60401,URIONDO (A. CONCEPCION),estado nutricional en menores de 5 anos,clasificacion d,2003-11-01,71,102,71,102,173
71502,URUBICHA,estado nutricional en menores de 5 anos,clasificacion d,2003-11-01,16,14,16,14,30
51201,UYUNI,estado nutricional en menores de 5 anos,clasificacion d,2003-11-01,63,82,63,82,145
30502,VACAS,estado nutricional en menores de 5 anos,clasificacion d,2003-11-01,51,45,51,45,96
70801,VALLEGRANDE,estado nutricional en menores de 5 anos,clasificacion d,2003-11-01,9,15,9,15,24
20801,VIACHA,estado nutricional en menores de 5 anos,clasificacion d,2003-11-01,105,99,105,99,204
31302,VILA VILA,estado nutricional en menores de 5 anos,clasificacion d,2003-11-01,20,15,20,15,35
60303,VILLA MONTES,estado nutricional en menores de 5 anos,clasificacion d,2003-11-01,46,43,46,43,89
90502,VILLA NUEVA (LOMA ALTA),estado nutricional en menores de 5 anos,clasificacion d,2003-11-01,1,0,1,0,1
31402,VILLA RIVERO,estado nutricional en menores de 5 anos,clasificacion d,2003-11-01,21,9,21,9,30
10801,VILLA SERRANO,estado nutricional en menores de 5 anos,clasificacion d,2003-11-01,120,309,120,309,429
31003,VILLA TUNARI,estado nutricional en menores de 5 anos,clasificacion d,2003-11-01,179,189,179,189,368
11001,VILLA VACA GUZMAN (MUYUPAMPA),estado nutricional en menores de 5 anos,clasificacion d,2003-11-01,48,93,48,93,141
51501,VILLAZON,estado nutricional en menores de 5 anos,clasificacion d,2003-11-01,152,160,152,160,312
50602,VITICHI,estado nutricional en menores de 5 anos,clasificacion d,2003-11-01,124,202,124,202,326
20306,WALDO BALLIVIAN,estado nutricional en menores de 5 anos,clasificacion d,2003-11-01,11,12,11,12,23
20903,YACO,estado nutricional en menores de 5 anos,clasificacion d,2003-11-01,27,20,27,20,47
60301,YACUIBA,estado nutricional en menores de 5 anos,clasificacion d,2003-11-01,73,37,73,37,110
10602,YAMPARAEZ,estado nutricional en menores de 5 anos,clasificacion d,2003-11-01,152,307,152,307,459
21103,YANACACHI,estado nutricional en menores de 5 anos,clasificacion d,2003-11-01,24,21,24,21,45
70403,YAPACANI,estado nutricional en menores de 5 anos,clasificacion d,2003-11-01,90,136,90,136,226
50103,YOCALLA,estado nutricional en menores de 5 anos,clasificacion d,2003-11-01,40,81,40,81,121
10102,YOTALA,estado nutricional en menores de 5 anos,clasificacion d,2003-11-01,98,197,98,197,295
60402,YUNCHARA,estado nutricional en menores de 5 anos,clasificacion d,2003-11-01,68,125,68,125,193
10301,ZUDAÃ‘EZ,estado nutricional en menores de 5 anos,clasificacion d,2003-11-01,76,141,76,141,217
51302,ACACIO,estado nutricional en menores de 5 anos,clasificacion d,2003-12-01,62,116,62,116,178
20201,ACHACACHI,estado nutricional en menores de 5 anos,clasificacion d,2003-12-01,87,75,87,75,162
20104,ACHOCALLA,estado nutricional en menores de 5 anos,clasificacion d,2003-12-01,23,15,23,15,38
30201,AIQUILE,estado nutricional en menores de 5 anos,clasificacion d,2003-12-01,32,34,32,34,66
31303,ALALAY,estado nutricional en menores de 5 anos,clasificacion d,2003-12-01,14,24,14,24,38
10404,ALCALA,estado nutricional en menores de 5 anos,clasificacion d,2003-12-01,29,68,29,68,97
20202,ANCORAIMES,estado nutricional en menores de 5 anos,clasificacion d,2003-12-01,37,58,37,58,95
41201,ANDAMARCA,estado nutricional en menores de 5 anos,clasificacion d,2003-12-01,11,6,11,6,17
40603,ANTEQUERA,estado nutricional en menores de 5 anos,clasificacion d,2003-12-01,12,1,12,1,13
30402,ANZALDO,estado nutricional en menores de 5 anos,clasificacion d,2003-12-01,9,27,9,27,36
20701,APOLO,estado nutricional en menores de 5 anos,clasificacion d,2003-12-01,24,29,24,29,53
51301,ARAMPAMPA,estado nutricional en menores de 5 anos,clasificacion d,2003-12-01,23,38,23,38,61
30501,ARANI,estado nutricional en menores de 5 anos,clasificacion d,2003-12-01,23,21,23,21,44
30403,ARBIETO,estado nutricional en menores de 5 anos,clasificacion d,2003-12-01,4,0,4,0,4
30601,ARQUE,estado nutricional en menores de 5 anos,clasificacion d,2003-12-01,3,7,3,7,10
71501,ASCENCION DE GUARAYOS,estado nutricional en menores de 5 anos,clasificacion d,2003-12-01,174,279,174,279,453
50802,ATOCHA,estado nutricional en menores de 5 anos,clasificacion d,2003-12-01,57,146,57,146,203
20503,AUCAPATA,estado nutricional en menores de 5 anos,clasificacion d,2003-12-01,17,11,17,11,28
20502,AYATA,estado nutricional en menores de 5 anos,clasificacion d,2003-12-01,21,22,21,22,43
21303,AYO AYO,estado nutricional en menores de 5 anos,clasificacion d,2003-12-01,11,6,11,6,17
30301,AYOPAYA (V. DE INDEPENDENCIA),estado nutricional en menores de 5 anos,clasificacion d,2003-12-01,80,87,80,87,167
10201,AZURDUY,estado nutricional en menores de 5 anos,clasificacion d,2003-12-01,139,280,139,280,419
21203,BATALLAS,estado nutricional en menores de 5 anos,clasificacion d,2003-12-01,23,11,23,11,34
80802,BAURES,estado nutricional en menores de 5 anos,clasificacion d,2003-12-01,18,8,18,8,26
41202,BELEN DE ANDAMARCA,estado nutricional en menores de 5 anos,clasificacion d,2003-12-01,1,1,1,1,2
50104,BELEN DE URMIRI,estado nutricional en menores de 5 anos,clasificacion d,2003-12-01,7,14,7,14,21
90104,BELLA FLOR,estado nutricional en menores de 5 anos,clasificacion d,2003-12-01,9,31,9,31,40
60202,BERMEJO,estado nutricional en menores de 5 anos,clasificacion d,2003-12-01,4,6,4,6,10
50301,BETANZOS,estado nutricional en menores de 5 anos,clasificacion d,2003-12-01,186,300,186,300,486
90103,BOLPEBRA,estado nutricional en menores de 5 anos,clasificacion d,2003-12-01,4,7,4,7,11
70707,BOYUIBE,estado nutricional en menores de 5 anos,clasificacion d,2003-12-01,16,20,16,20,36
70401,BUENA VISTA,estado nutricional en menores de 5 anos,clasificacion d,2003-12-01,23,32,23,32,55
70703,CABEZAS,estado nutricional en menores de 5 anos,clasificacion d,2003-12-01,0,1,0,1,1
20905,CAIROMA,estado nutricional en menores de 5 anos,clasificacion d,2003-12-01,47,35,47,35,82
51102,"CAIZA ""D""",estado nutricional en menores de 5 anos,clasificacion d,2003-12-01,45,86,45,86,131
21003,CAJUATA,estado nutricional en menores de 5 anos,clasificacion d,2003-12-01,33,45,33,45,78
20303,CALACOTO,estado nutricional en menores de 5 anos,clasificacion d,2003-12-01,12,9,12,9,21
21304,CALAMARCA,estado nutricional en menores de 5 anos,clasificacion d,2003-12-01,174,162,174,162,336
10701,CAMARGO,estado nutricional en menores de 5 anos,clasificacion d,2003-12-01,91,160,91,160,251
10901,CAMATAQUI (C. VILLA ABECIA),estado nutricional en menores de 5 anos,clasificacion d,2003-12-01,8,14,8,14,22
70706,CAMIRI,estado nutricional en menores de 5 anos,clasificacion d,2003-12-01,121,110,121,110,231
30701,CAPINOTA,estado nutricional en menores de 5 anos,clasificacion d,2003-12-01,32,84,32,84,116
20302,CAQUIAVIRI,estado nutricional en menores de 5 anos,clasificacion d,2003-12-01,31,21,31,21,52
40102,CARACOLLO,estado nutricional en menores de 5 anos,clasificacion d,2003-12-01,73,37,73,37,110
22001,CARANAVI,estado nutricional en menores de 5 anos,clasificacion d,2003-12-01,178,162,178,162,340
60302,CARAPARI,estado nutricional en menores de 5 anos,clasificacion d,2003-12-01,12,40,12,40,52
50702,CARIPUYO,estado nutricional en menores de 5 anos,clasificacion d,2003-12-01,69,123,69,123,192
21803,CHACARILLA,estado nutricional en menores de 5 anos,clasificacion d,2003-12-01,10,25,10,25,35
40201,CHALLAPATA,estado nutricional en menores de 5 anos,clasificacion d,2003-12-01,65,166,65,166,231
50302,CHAQUI,estado nutricional en menores de 5 anos,clasificacion d,2003-12-01,18,47,18,47,65
70702,CHARAGUA,estado nutricional en menores de 5 anos,clasificacion d,2003-12-01,139,134,139,134,273
20305,CHARAÃ‘A,estado nutricional en menores de 5 anos,clasificacion d,2003-12-01,7,16,7,16,23
50202,CHAYANTA,estado nutricional en menores de 5 anos,clasificacion d,2003-12-01,101,169,101,169,270
31204,CHIMORE,estado nutricional en menores de 5 anos,clasificacion d,2003-12-01,28,27,28,27,55
40903,CHIPAYA,estado nutricional en menores de 5 anos,clasificacion d,2003-12-01,5,6,5,6,11
40302,CHOQUE COTA,estado nutricional en menores de 5 anos,clasificacion d,2003-12-01,3,4,3,4,7
21101,CHULUMANI (V. DE LA LIBERTAD),estado nutricional en menores de 5 anos,clasificacion d,2003-12-01,9,16,9,16,25
20501,CHUMA,estado nutricional en menores de 5 anos,clasificacion d,2003-12-01,21,15,21,15,36
30801,CLIZA,estado nutricional en menores de 5 anos,clasificacion d,2003-12-01,14,8,14,8,22
90101,COBIJA,estado nutricional en menores de 5 anos,clasificacion d,2003-12-01,57,74,57,74,131
30101,COCHABAMBA,estado nutricional en menores de 5 anos,clasificacion d,2003-12-01,570,499,570,499,1069
40902,COIPASA,estado nutricional en menores de 5 anos,clasificacion d,2003-12-01,1,2,1,2,3
30905,COLCAPIRHUA,estado nutricional en menores de 5 anos,clasificacion d,2003-12-01,60,44,60,44,104
50901,"COLCHA ""K""",estado nutricional en menores de 5 anos,clasificacion d,2003-12-01,32,29,32,29,61
21307,COLLANA,estado nutricional en menores de 5 anos,clasificacion d,2003-12-01,4,2,4,2,6
31002,COLOMI,estado nutricional en menores de 5 anos,clasificacion d,2003-12-01,60,50,60,50,110
50401,COLQUECHACA,estado nutricional en menores de 5 anos,clasificacion d,2003-12-01,130,94,130,94,224
21306,COLQUENCHA,estado nutricional en menores de 5 anos,clasificacion d,2003-12-01,28,8,28,8,36
21004,COLQUIRI,estado nutricional en menores de 5 anos,clasificacion d,2003-12-01,81,66,81,66,147
20304,COMANCHE,estado nutricional en menores de 5 anos,clasificacion d,2003-12-01,13,10,13,10,23
71301,COMARAPA,estado nutricional en menores de 5 anos,clasificacion d,2003-12-01,47,51,47,51,98
20605,COMBAYA,estado nutricional en menores de 5 anos,clasificacion d,2003-12-01,12,14,12,14,26
71101,CONCEPCION,estado nutricional en menores de 5 anos,clasificacion d,2003-12-01,21,3,21,3,24
21701,COPACABANA,estado nutricional en menores de 5 anos,clasificacion d,2003-12-01,9,12,9,12,21
21402,CORIPATA,estado nutricional en menores de 5 anos,clasificacion d,2003-12-01,1,2,1,2,3
20301,CORO CORO,estado nutricional en menores de 5 anos,clasificacion d,2003-12-01,23,21,23,21,44
21401,COROICO,estado nutricional en menores de 5 anos,clasificacion d,2003-12-01,25,28,25,28,53
40301,CORQUE,estado nutricional en menores de 5 anos,clasificacion d,2003-12-01,28,31,28,31,59
50601,COTAGAITA,estado nutricional en menores de 5 anos,clasificacion d,2003-12-01,95,134,95,134,229
31405,CUCHUMUELA (V. G. VILLARROEL),estado nutricional en menores de 5 anos,clasificacion d,2003-12-01,4,9,4,9,13
70704,CUEVO,estado nutricional en menores de 5 anos,clasificacion d,2003-12-01,13,11,13,11,24
10902,CULPINA,estado nutricional en menores de 5 anos,clasificacion d,2003-12-01,155,190,155,190,345
40401,CURAHUARA DE CARANGAS,estado nutricional en menores de 5 anos,clasificacion d,2003-12-01,32,28,32,28,60
21602,CURVA,estado nutricional en menores de 5 anos,clasificacion d,2003-12-01,8,13,8,13,21
20804,DESAGUADERO,estado nutricional en menores de 5 anos,clasificacion d,2003-12-01,7,1,7,1,8
20105,EL ALTO,estado nutricional en menores de 5 anos,clasificacion d,2003-12-01,1740,1062,1740,1062,2802
40103,EL CHORO,estado nutricional en menores de 5 anos,clasificacion d,2003-12-01,9,7,9,7,16
71503,EL PUENTE(STC),estado nutricional en menores de 5 anos,clasificacion d,2003-12-01,47,45,47,45,92
60502,EL PUENTE(TJA),estado nutricional en menores de 5 anos,clasificacion d,2003-12-01,34,78,34,78,112
70105,EL TORNO,estado nutricional en menores de 5 anos,clasificacion d,2003-12-01,64,52,64,52,116
10405,EL VILLAR,estado nutricional en menores de 5 anos,clasificacion d,2003-12-01,58,151,58,151,209
60601,ENTRE RIOS,estado nutricional en menores de 5 anos,clasificacion d,2003-12-01,52,43,52,43,95
41101,EUCALIPTUS,estado nutricional en menores de 5 anos,clasificacion d,2003-12-01,5,4,5,4,9
90503,EUREKA (SANTOS MERCADO),estado nutricional en menores de 5 anos,clasificacion d,2003-12-01,0,3,0,3,3
80402,EXALTACION,estado nutricional en menores de 5 anos,clasificacion d,2003-12-01,14,16,14,16,30
90203,FILADELFIA,estado nutricional en menores de 5 anos,clasificacion d,2003-12-01,0,8,0,8,8
71002,GENERAL SAAVEDRA,estado nutricional en menores de 5 anos,clasificacion d,2003-12-01,116,132,116,132,248
21601,GRAL. J.J. PEREZ (CHARAZANI),estado nutricional en menores de 5 anos,clasificacion d,2003-12-01,32,49,32,49,81
20602,GUANAY,estado nutricional en menores de 5 anos,clasificacion d,2003-12-01,104,101,104,101,205
20802,GUAQUI,estado nutricional en menores de 5 anos,clasificacion d,2003-12-01,13,6,13,6,19
80202,GUAYARAMERIN,estado nutricional en menores de 5 anos,clasificacion d,2003-12-01,102,57,102,57,159
70705,GUTIERREZ,estado nutricional en menores de 5 anos,clasificacion d,2003-12-01,85,158,85,158,243
10502,HUACARETA,estado nutricional en menores de 5 anos,clasificacion d,2003-12-01,41,78,41,78,119
11002,HUACAYA (VILLA DE HUACAYA),estado nutricional en menores de 5 anos,clasificacion d,2003-12-01,15,30,15,30,45
40501,HUACHACALLA,estado nutricional en menores de 5 anos,clasificacion d,2003-12-01,7,0,7,0,7
40701,HUANUNI,estado nutricional en menores de 5 anos,clasificacion d,2003-12-01,61,32,61,32,93
80803,HUARACAJE,estado nutricional en menores de 5 anos,clasificacion d,2003-12-01,3,4,3,4,7
41601,HUAYLLAMARCA,estado nutricional en menores de 5 anos,clasificacion d,2003-12-01,9,12,9,12,21
21005,ICHOCA,estado nutricional en menores de 5 anos,clasificacion d,2003-12-01,20,17,20,17,37
10304,ICLA,estado nutricional en menores de 5 anos,clasificacion d,2003-12-01,129,223,129,223,352
10703,INCAHUASI,estado nutricional en menores de 5 anos,clasificacion d,2003-12-01,83,103,83,103,186
21001,INQUISIVI,estado nutricional en menores de 5 anos,clasificacion d,2003-12-01,57,38,57,38,95
21102,IRUPANA (VILLA DE LANZA),estado nutricional en menores de 5 anos,clasificacion d,2003-12-01,21,35,21,35,56
21501,IXIAMAS,estado nutricional en menores de 5 anos,clasificacion d,2003-12-01,19,41,19,41,60
21105,LA ASUNTA,estado nutricional en menores de 5 anos,clasificacion d,2003-12-01,16,31,16,31,47
70104,LA GUARDIA,estado nutricional en menores de 5 anos,clasificacion d,2003-12-01,64,61,64,61,125
20101,LA PAZ,estado nutricional en menores de 5 anos,clasificacion d,2003-12-01,1057,897,1057,897,1954
41501,LA RIVERA,estado nutricional en menores de 5 anos,clasificacion d,2003-12-01,1,0,1,0,1
70701,LAGUNILLAS,estado nutricional en menores de 5 anos,clasificacion d,2003-12-01,17,33,17,33,50
21202,LAJA,estado nutricional en menores de 5 anos,clasificacion d,2003-12-01,25,27,25,27,52
10903,LAS CARRERAS,estado nutricional en menores de 5 anos,clasificacion d,2003-12-01,12,26,12,26,38
50203,LLALLAGUA,estado nutricional en menores de 5 anos,clasificacion d,2003-12-01,112,225,112,225,337
51401,LLICA,estado nutricional en menores de 5 anos,clasificacion d,2003-12-01,7,10,7,10,17
80601,LORETO,estado nutricional en menores de 5 anos,clasificacion d,2003-12-01,4,11,4,11,15
20901,LURIBAY,estado nutricional en menores de 5 anos,clasificacion d,2003-12-01,29,42,29,42,71
40702,MACHACAMARCA,estado nutricional en menores de 5 anos,clasificacion d,2003-12-01,3,9,3,9,12
11003,MACHARETI,estado nutricional en menores de 5 anos,clasificacion d,2003-12-01,40,106,40,106,146
80801,MAGDALENA,estado nutricional en menores de 5 anos,clasificacion d,2003-12-01,29,23,29,23,52
70903,MAIRANA,estado nutricional en menores de 5 anos,clasificacion d,2003-12-01,19,10,19,10,29
20904,MALLA,estado nutricional en menores de 5 anos,clasificacion d,2003-12-01,8,8,8,8,16
20103,MECAPACA,estado nutricional en menores de 5 anos,clasificacion d,2003-12-01,13,20,13,20,33
71003,MINEROS,estado nutricional en menores de 5 anos,clasificacion d,2003-12-01,88,59,88,59,147
31301,MIZQUE,estado nutricional en menores de 5 anos,clasificacion d,2003-12-01,2,16,2,16,18
20402,MOCOMOCO,estado nutricional en menores de 5 anos,clasificacion d,2003-12-01,30,35,30,35,65
51002,MOJINETE,estado nutricional en menores de 5 anos,clasificacion d,2003-12-01,4,10,4,10,14
10303,MOJOCOYA,estado nutricional en menores de 5 anos,clasificacion d,2003-12-01,57,114,57,114,171
10501,MONTEAGUDO,estado nutricional en menores de 5 anos,clasificacion d,2003-12-01,114,178,114,178,292
71001,MONTERO,estado nutricional en menores de 5 anos,clasificacion d,2003-12-01,188,155,188,155,343
70803,MORO MORO,estado nutricional en menores de 5 anos,clasificacion d,2003-12-01,3,4,3,4,7
30302,MOROCHATA,estado nutricional en menores de 5 anos,clasificacion d,2003-12-01,81,124,81,124,205
20307,NAZACARA DE PACAJES,estado nutricional en menores de 5 anos,clasificacion d,2003-12-01,1,3,1,3,4
90501,NUEVO MANOA (NUEVA ESPERANZA),estado nutricional en menores de 5 anos,clasificacion d,2003-12-01,0,1,0,1,1
50404,OCURI,estado nutricional en menores de 5 anos,clasificacion d,2003-12-01,61,133,61,133,194
30203,OMEREQUE,estado nutricional en menores de 5 anos,clasificacion d,2003-12-01,6,11,6,11,17
40101,ORURO,estado nutricional en menores de 5 anos,clasificacion d,2003-12-01,631,463,631,463,1094
60201,PADCAYA,estado nutricional en menores de 5 anos,clasificacion d,2003-12-01,48,73,48,73,121
10401,PADILLA,estado nutricional en menores de 5 anos,clasificacion d,2003-12-01,88,206,88,206,294
20102,PALCA,estado nutricional en menores de 5 anos,clasificacion d,2003-12-01,31,34,31,34,65
21104,PALOS BLANCOS,estado nutricional en menores de 5 anos,clasificacion d,2003-12-01,16,28,16,28,44
40802,PAMPA AULLAGAS,estado nutricional en menores de 5 anos,clasificacion d,2003-12-01,6,12,6,12,18
70902,PAMPA GRANDE,estado nutricional en menores de 5 anos,clasificacion d,2003-12-01,16,10,16,10,26
21802,PAPEL PAMPA,estado nutricional en menores de 5 anos,clasificacion d,2003-12-01,15,12,15,12,27
30202,PASORAPA,estado nutricional en menores de 5 anos,clasificacion d,2003-12-01,22,39,22,39,61
21305,PATACAMAYA,estado nutricional en menores de 5 anos,clasificacion d,2003-12-01,133,79,133,79,212
40602,PAZÃ‘A,estado nutricional en menores de 5 anos,clasificacion d,2003-12-01,7,9,7,9,16
20702,PELECHUCO,estado nutricional en menores de 5 anos,clasificacion d,2003-12-01,29,16,29,16,45
50403,POCOATA,estado nutricional en menores de 5 anos,clasificacion d,2003-12-01,107,205,107,205,312
31203,POCONA,estado nutricional en menores de 5 anos,clasificacion d,2003-12-01,25,28,25,28,53
31202,POJO (CBBA),estado nutricional en menores de 5 anos,clasificacion d,2003-12-01,76,90,76,90,166
40601,POOPO,estado nutricional en menores de 5 anos,clasificacion d,2003-12-01,10,12,10,12,22
51203,PORCO,estado nutricional en menores de 5 anos,clasificacion d,2003-12-01,22,46,22,46,68
10103,POROMA,estado nutricional en menores de 5 anos,clasificacion d,2003-12-01,91,137,91,137,228
70103,PORONGO,estado nutricional en menores de 5 anos,clasificacion d,2003-12-01,6,5,6,5,11
70601,PORTACHUELO,estado nutricional en menores de 5 anos,clasificacion d,2003-12-01,21,52,21,52,73
90102,PORVENIR,estado nutricional en menores de 5 anos,clasificacion d,2003-12-01,6,6,6,6,12
50101,POTOSI,estado nutricional en menores de 5 anos,clasificacion d,2003-12-01,561,383,561,383,944
10302,PRESTO,estado nutricional en menores de 5 anos,clasificacion d,2003-12-01,59,99,59,99,158
70805,PUCARA,estado nutricional en menores de 5 anos,clasificacion d,2003-12-01,13,14,13,14,27
21201,PUCARANI,estado nutricional en menores de 5 anos,clasificacion d,2003-12-01,39,43,39,43,82
20401,PUERTO ACOSTA,estado nutricional en menores de 5 anos,clasificacion d,2003-12-01,52,81,52,81,133
20403,PUERTO CARABUCO,estado nutricional en menores de 5 anos,clasificacion d,2003-12-01,39,67,39,67,106
90301,PUERTO GONZALO MORENO,estado nutricional en menores de 5 anos,clasificacion d,2003-12-01,7,4,7,4,11
21204,PUERTO PEREZ,estado nutricional en menores de 5 anos,clasificacion d,2003-12-01,13,15,13,15,28
90201,PUERTO RICO,estado nutricional en menores de 5 anos,clasificacion d,2003-12-01,0,7,0,7,7
80703,PUERTO SILES,estado nutricional en menores de 5 anos,clasificacion d,2003-12-01,8,11,8,11,19
31205,PUERTO VILLARROEL,estado nutricional en menores de 5 anos,clasificacion d,2003-12-01,139,129,139,129,268
51101,PUNA,estado nutricional en menores de 5 anos,clasificacion d,2003-12-01,119,137,119,137,256
31401,PUNATA,estado nutricional en menores de 5 anos,clasificacion d,2003-12-01,110,40,110,40,150
20604,QUIABAYA,estado nutricional en menores de 5 anos,clasificacion d,2003-12-01,6,8,6,8,14
30901,QUILLACOLLO,estado nutricional en menores de 5 anos,clasificacion d,2003-12-01,100,115,100,115,215
21002,QUIME,estado nutricional en menores de 5 anos,clasificacion d,2003-12-01,39,45,39,45,84
70904,QUIRUSILLAS,estado nutricional en menores de 5 anos,clasificacion d,2003-12-01,3,1,3,1,4
50402,RAVELO,estado nutricional en menores de 5 anos,clasificacion d,2003-12-01,96,113,96,113,209
80301,REYES,estado nutricional en menores de 5 anos,clasificacion d,2003-12-01,60,75,60,75,135
80201,RIBERALTA,estado nutricional en menores de 5 anos,clasificacion d,2003-12-01,396,261,396,261,657
80304,RURRENABAQUE,estado nutricional en menores de 5 anos,clasificacion d,2003-12-01,15,4,15,4,19
40901,SABAYA,estado nutricional en menores de 5 anos,clasificacion d,2003-12-01,8,6,8,6,14
31001,SACABA,estado nutricional en menores de 5 anos,clasificacion d,2003-12-01,97,23,97,23,120
30404,SACABAMBA,estado nutricional en menores de 5 anos,clasificacion d,2003-12-01,18,23,18,23,41
50701,SACACA,estado nutricional en menores de 5 anos,clasificacion d,2003-12-01,210,415,210,415,625
71302,SAIPINA,estado nutricional en menores de 5 anos,clasificacion d,2003-12-01,26,27,26,27,53
40801,SALINAS DE GARCI MENDOZA,estado nutricional en menores de 5 anos,clasificacion d,2003-12-01,23,43,23,43,66
70901,SAMAIPATA,estado nutricional en menores de 5 anos,clasificacion d,2003-12-01,24,24,24,24,48
51601,SAN AGUSTIN,estado nutricional en menores de 5 anos,clasificacion d,2003-12-01,10,5,10,5,15
80602,SAN ANDRES,estado nutricional en menores de 5 anos,clasificacion d,2003-12-01,32,28,32,28,60
51003,SAN ANTONIO DE ESMORUCO,estado nutricional en menores de 5 anos,clasificacion d,2003-12-01,0,2,0,2,2
31403,SAN BENITO,estado nutricional en menores de 5 anos,clasificacion d,2003-12-01,25,2,25,2,27
80302,SAN BORJA,estado nutricional en menores de 5 anos,clasificacion d,2003-12-01,143,150,143,150,293
21502,SAN BUENA VENTURA,estado nutricional en menores de 5 anos,clasificacion d,2003-12-01,58,43,58,43,101
70402,SAN CARLOS,estado nutricional en menores de 5 anos,clasificacion d,2003-12-01,68,71,68,71,139
80501,SAN IGNACIO,estado nutricional en menores de 5 anos,clasificacion d,2003-12-01,66,75,66,75,141
70301,SAN IGNACIO DE VELASCO,estado nutricional en menores de 5 anos,clasificacion d,2003-12-01,169,121,169,121,290
80102,SAN JAVIER(BNI),estado nutricional en menores de 5 anos,clasificacion d,2003-12-01,7,12,7,12,19
71102,SAN JAVIER(STC),estado nutricional en menores de 5 anos,clasificacion d,2003-12-01,32,26,32,26,58
80701,SAN JOAQUIN,estado nutricional en menores de 5 anos,clasificacion d,2003-12-01,8,14,8,14,22
71104,SAN JULIAN,estado nutricional en menores de 5 anos,clasificacion d,2003-12-01,101,121,101,121,222
90302,SAN LORENZO(PND),estado nutricional en menores de 5 anos,clasificacion d,2003-12-01,5,4,5,4,9
60501,SAN LORENZO(TJA),estado nutricional en menores de 5 anos,clasificacion d,2003-12-01,66,43,66,43,109
10702,SAN LUCAS,estado nutricional en menores de 5 anos,clasificacion d,2003-12-01,316,392,316,392,708
71201,SAN MATIAS,estado nutricional en menores de 5 anos,clasificacion d,2003-12-01,33,29,33,29,62
70302,SAN MIGUEL DE VELASCO,estado nutricional en menores de 5 anos,clasificacion d,2003-12-01,39,43,39,43,82
51001,SAN PABLO DE LIPEZ,estado nutricional en menores de 5 anos,clasificacion d,2003-12-01,8,6,8,6,14
50501,SAN PEDRO DE BUENA VISTA,estado nutricional en menores de 5 anos,clasificacion d,2003-12-01,140,255,140,255,395
21801,SAN PEDRO DE CURAHUARA,estado nutricional en menores de 5 anos,clasificacion d,2003-12-01,20,29,20,29,49
50902,SAN PEDRO DE QUEMES,estado nutricional en menores de 5 anos,clasificacion d,2003-12-01,1,4,1,4,5
21702,SAN PEDRO DE TIQUINA,estado nutricional en menores de 5 anos,clasificacion d,2003-12-01,3,4,3,4,7
70303,SAN RAFAEL,estado nutricional en menores de 5 anos,clasificacion d,2003-12-01,25,17,25,17,42
80702,SAN RAMON,estado nutricional en menores de 5 anos,clasificacion d,2003-12-01,2,0,2,0,2
80702,SAN RAMON,estado nutricional en menores de 5 anos,clasificacion d,2003-12-01,23,12,23,12,35
80401,SANTA ANA,estado nutricional en menores de 5 anos,clasificacion d,2003-12-01,44,42,44,42,86
70101,SANTA CRUZ DE LA SIERRA,estado nutricional en menores de 5 anos,clasificacion d,2003-12-01,456,202,456,202,658
80303,SANTA ROSA,estado nutricional en menores de 5 anos,clasificacion d,2003-12-01,36,31,36,31,67
70602,SANTA ROSA DEL SARA,estado nutricional en menores de 5 anos,clasificacion d,2003-12-01,12,28,12,28,40
20308,SANTIAGO DE CALLAPA,estado nutricional en menores de 5 anos,clasificacion d,2003-12-01,30,41,30,41,71
41401,SANTIAGO DE HUARI,estado nutricional en menores de 5 anos,clasificacion d,2003-12-01,13,23,13,23,36
21901,SANTIAGO DE MACHACA,estado nutricional en menores de 5 anos,clasificacion d,2003-12-01,20,22,20,22,42
30702,SANTIVAÃ‘ES,estado nutricional en menores de 5 anos,clasificacion d,2003-12-01,17,20,17,20,37
40202,SANTUARIO DE QUILLACAS,estado nutricional en menores de 5 anos,clasificacion d,2003-12-01,13,7,13,7,20
20902,SAPAHAQUI,estado nutricional en menores de 5 anos,clasificacion d,2003-12-01,37,44,37,44,81
90303,SENA,estado nutricional en menores de 5 anos,clasificacion d,2003-12-01,21,23,21,23,44
21301,SICA SICA (VILLA AROMA),estado nutricional en menores de 5 anos,clasificacion d,2003-12-01,107,59,107,59,166
30703,SICAYA,estado nutricional en menores de 5 anos,clasificacion d,2003-12-01,10,17,10,17,27
30902,SIPE SIPE,estado nutricional en menores de 5 anos,clasificacion d,2003-12-01,110,80,110,80,190
10403,SOPACHUY,estado nutricional en menores de 5 anos,clasificacion d,2003-12-01,31,65,31,65,96
20601,SORATA,estado nutricional en menores de 5 anos,clasificacion d,2003-12-01,42,69,42,69,111
10101,SUCRE,estado nutricional en menores de 5 anos,clasificacion d,2003-12-01,410,459,410,459,869
31404,TACACHI,estado nutricional en menores de 5 anos,clasificacion d,2003-12-01,5,0,5,0,5
20603,TACACOMA,estado nutricional en menores de 5 anos,clasificacion d,2003-12-01,21,25,21,25,46
50303,TACOBAMBA,estado nutricional en menores de 5 anos,clasificacion d,2003-12-01,74,101,74,101,175
30602,TACOPAYA,estado nutricional en menores de 5 anos,clasificacion d,2003-12-01,19,35,19,35,54
31101,TAPACARI,estado nutricional en menores de 5 anos,clasificacion d,2003-12-01,91,110,91,110,201
10601,TARABUCO,estado nutricional en menores de 5 anos,clasificacion d,2003-12-01,258,501,258,501,759
30401,TARATA,estado nutricional en menores de 5 anos,clasificacion d,2003-12-01,29,10,29,10,39
60101,TARIJA,estado nutricional en menores de 5 anos,clasificacion d,2003-12-01,478,421,478,421,899
10202,TARVITA,estado nutricional en menores de 5 anos,clasificacion d,2003-12-01,42,78,42,78,120
20803,TIAWANACU,estado nutricional en menores de 5 anos,clasificacion d,2003-12-01,11,11,11,11,22
50102,TINGUIPAYA,estado nutricional en menores de 5 anos,clasificacion d,2003-12-01,170,239,170,239,409
20606,TIPUANI,estado nutricional en menores de 5 anos,clasificacion d,2003-12-01,11,15,11,15,26
30903,TIQUIPAYA,estado nutricional en menores de 5 anos,clasificacion d,2003-12-01,34,26,34,26,60
31601,TIRAQUE (CBBA),estado nutricional en menores de 5 anos,clasificacion d,2003-12-01,179,132,179,132,311
21703,TITO YUPANQUI (PARQUIPUJIO),estado nutricional en menores de 5 anos,clasificacion d,2003-12-01,5,1,5,1,6
30802,TOCO,estado nutricional en menores de 5 anos,clasificacion d,2003-12-01,0,13,0,13,13
30803,TOLATA,estado nutricional en menores de 5 anos,clasificacion d,2003-12-01,6,4,6,4,10
41001,TOLEDO,estado nutricional en menores de 5 anos,clasificacion d,2003-12-01,5,2,5,2,7
51202,TOMAVE,estado nutricional en menores de 5 anos,clasificacion d,2003-12-01,50,67,50,67,117
10402,TOMINA,estado nutricional en menores de 5 anos,clasificacion d,2003-12-01,108,243,108,243,351
50502,TORO TORO,estado nutricional en menores de 5 anos,clasificacion d,2003-12-01,92,118,92,118,210
31201,TOTORA(CBBA),estado nutricional en menores de 5 anos,clasificacion d,2003-12-01,45,35,45,35,80
41301,TOTORA(ORR),estado nutricional en menores de 5 anos,clasificacion d,2003-12-01,22,11,22,11,33
70802,TRIGAL,estado nutricional en menores de 5 anos,clasificacion d,2003-12-01,2,1,2,1,3
80101,TRINIDAD,estado nutricional en menores de 5 anos,clasificacion d,2003-12-01,166,166,166,166,332
50801,TUPIZA,estado nutricional en menores de 5 anos,clasificacion d,2003-12-01,139,253,139,253,392
40402,TURCO,estado nutricional en menores de 5 anos,clasificacion d,2003-12-01,10,15,10,15,25
21302,UMALA,estado nutricional en menores de 5 anos,clasificacion d,2003-12-01,43,63,43,63,106
50201,UNCIA,estado nutricional en menores de 5 anos,clasificacion d,2003-12-01,19,16,19,16,35
60401,URIONDO (A. CONCEPCION),estado nutricional en menores de 5 anos,clasificacion d,2003-12-01,37,71,37,71,108
71502,URUBICHA,estado nutricional en menores de 5 anos,clasificacion d,2003-12-01,41,60,41,60,101
51201,UYUNI,estado nutricional en menores de 5 anos,clasificacion d,2003-12-01,39,55,39,55,94
30502,VACAS,estado nutricional en menores de 5 anos,clasificacion d,2003-12-01,30,17,30,17,47
70801,VALLEGRANDE,estado nutricional en menores de 5 anos,clasificacion d,2003-12-01,31,45,31,45,76
20801,VIACHA,estado nutricional en menores de 5 anos,clasificacion d,2003-12-01,115,83,115,83,198
31302,VILA VILA,estado nutricional en menores de 5 anos,clasificacion d,2003-12-01,6,22,6,22,28
60303,VILLA MONTES,estado nutricional en menores de 5 anos,clasificacion d,2003-12-01,59,46,59,46,105
31402,VILLA RIVERO,estado nutricional en menores de 5 anos,clasificacion d,2003-12-01,29,16,29,16,45
10801,VILLA SERRANO,estado nutricional en menores de 5 anos,clasificacion d,2003-12-01,107,206,107,206,313
31003,VILLA TUNARI,estado nutricional en menores de 5 anos,clasificacion d,2003-12-01,128,121,128,121,249
11001,VILLA VACA GUZMAN (MUYUPAMPA),estado nutricional en menores de 5 anos,clasificacion d,2003-12-01,67,135,67,135,202
51501,VILLAZON,estado nutricional en menores de 5 anos,clasificacion d,2003-12-01,156,194,156,194,350
30904,VINTO,estado nutricional en menores de 5 anos,clasificacion d,2003-12-01,18,10,18,10,28
50602,VITICHI,estado nutricional en menores de 5 anos,clasificacion d,2003-12-01,56,87,56,87,143
20306,WALDO BALLIVIAN,estado nutricional en menores de 5 anos,clasificacion d,2003-12-01,9,12,9,12,21
20903,YACO,estado nutricional en menores de 5 anos,clasificacion d,2003-12-01,58,40,58,40,98
60301,YACUIBA,estado nutricional en menores de 5 anos,clasificacion d,2003-12-01,62,73,62,73,135
10602,YAMPARAEZ,estado nutricional en menores de 5 anos,clasificacion d,2003-12-01,154,300,154,300,454
21103,YANACACHI,estado nutricional en menores de 5 anos,clasificacion d,2003-12-01,12,15,12,15,27
70403,YAPACANI,estado nutricional en menores de 5 anos,clasificacion d,2003-12-01,152,128,152,128,280
50103,YOCALLA,estado nutricional en menores de 5 anos,clasificacion d,2003-12-01,20,52,20,52,72
10102,YOTALA,estado nutricional en menores de 5 anos,clasificacion d,2003-12-01,52,114,52,114,166
60402,YUNCHARA,estado nutricional en menores de 5 anos,clasificacion d,2003-12-01,32,71,32,71,103
10301,ZUDAÃ‘EZ,estado nutricional en menores de 5 anos,clasificacion d,2003-12-01,59,139,59,139,198
