codigo_municipio,municipio,grupo,variable,mes,total-H,total-M,TOTAL-H1,TOTAL-M1,TOTAL
51302,ACACIO,estado nutricional en menores de 5 anos,clasificacion e,2001-01-01,1,41,1,41,42
20201,ACHACACHI,estado nutricional en menores de 5 anos,clasificacion e,2001-01-01,0,9,0,9,9
20104,ACHOCALLA,estado nutricional en menores de 5 anos,clasificacion e,2001-01-01,0,3,0,3,3
30201,AIQUILE,estado nutricional en menores de 5 anos,clasificacion e,2001-01-01,6,8,6,8,14
31303,ALALAY,estado nutricional en menores de 5 anos,clasificacion e,2001-01-01,5,0,5,0,5
10404,ALCALA,estado nutricional en menores de 5 anos,clasificacion e,2001-01-01,0,10,0,10,10
20202,ANCORAIMES,estado nutricional en menores de 5 anos,clasificacion e,2001-01-01,0,22,0,22,22
20701,APOLO,estado nutricional en menores de 5 anos,clasificacion e,2001-01-01,3,1,3,1,4
51301,ARAMPAMPA,estado nutricional en menores de 5 anos,clasificacion e,2001-01-01,0,3,0,3,3
30501,ARANI,estado nutricional en menores de 5 anos,clasificacion e,2001-01-01,0,31,0,31,31
71501,ASCENCION DE GUARAYOS,estado nutricional en menores de 5 anos,clasificacion e,2001-01-01,0,5,0,5,5
50802,ATOCHA,estado nutricional en menores de 5 anos,clasificacion e,2001-01-01,0,2,0,2,2
20503,AUCAPATA,estado nutricional en menores de 5 anos,clasificacion e,2001-01-01,0,1,0,1,1
30301,AYOPAYA (V. DE INDEPENDENCIA),estado nutricional en menores de 5 anos,clasificacion e,2001-01-01,0,27,0,27,27
10201,AZURDUY,estado nutricional en menores de 5 anos,clasificacion e,2001-01-01,0,39,0,39,39
21203,BATALLAS,estado nutricional en menores de 5 anos,clasificacion e,2001-01-01,0,2,0,2,2
80802,BAURES,estado nutricional en menores de 5 anos,clasificacion e,2001-01-01,0,4,0,4,4
41202,BELEN DE ANDAMARCA,estado nutricional en menores de 5 anos,clasificacion e,2001-01-01,0,1,0,1,1
50104,BELEN DE URMIRI,estado nutricional en menores de 5 anos,clasificacion e,2001-01-01,2,0,2,0,2
90104,BELLA FLOR,estado nutricional en menores de 5 anos,clasificacion e,2001-01-01,0,4,0,4,4
60202,BERMEJO,estado nutricional en menores de 5 anos,clasificacion e,2001-01-01,0,19,0,19,19
50301,BETANZOS,estado nutricional en menores de 5 anos,clasificacion e,2001-01-01,13,173,13,173,186
31501,BOLIVAR,estado nutricional en menores de 5 anos,clasificacion e,2001-01-01,0,14,0,14,14
70707,BOYUIBE,estado nutricional en menores de 5 anos,clasificacion e,2001-01-01,0,1,0,1,1
70703,CABEZAS,estado nutricional en menores de 5 anos,clasificacion e,2001-01-01,14,14,14,14,28
20905,CAIROMA,estado nutricional en menores de 5 anos,clasificacion e,2001-01-01,6,5,6,5,11
51102,"CAIZA ""D""",estado nutricional en menores de 5 anos,clasificacion e,2001-01-01,0,12,0,12,12
21003,CAJUATA,estado nutricional en menores de 5 anos,clasificacion e,2001-01-01,0,11,0,11,11
20303,CALACOTO,estado nutricional en menores de 5 anos,clasificacion e,2001-01-01,0,1,0,1,1
21304,CALAMARCA,estado nutricional en menores de 5 anos,clasificacion e,2001-01-01,0,8,0,8,8
10701,CAMARGO,estado nutricional en menores de 5 anos,clasificacion e,2001-01-01,0,26,0,26,26
70706,CAMIRI,estado nutricional en menores de 5 anos,clasificacion e,2001-01-01,1,80,1,80,81
30701,CAPINOTA,estado nutricional en menores de 5 anos,clasificacion e,2001-01-01,5,15,5,15,20
20302,CAQUIAVIRI,estado nutricional en menores de 5 anos,clasificacion e,2001-01-01,0,2,0,2,2
40102,CARACOLLO,estado nutricional en menores de 5 anos,clasificacion e,2001-01-01,0,15,0,15,15
22001,CARANAVI,estado nutricional en menores de 5 anos,clasificacion e,2001-01-01,2,25,2,25,27
60302,CARAPARI,estado nutricional en menores de 5 anos,clasificacion e,2001-01-01,0,16,0,16,16
50702,CARIPUYO,estado nutricional en menores de 5 anos,clasificacion e,2001-01-01,0,19,0,19,19
40201,CHALLAPATA,estado nutricional en menores de 5 anos,clasificacion e,2001-01-01,1,16,1,16,17
50302,CHAQUI,estado nutricional en menores de 5 anos,clasificacion e,2001-01-01,0,36,0,36,36
70702,CHARAGUA,estado nutricional en menores de 5 anos,clasificacion e,2001-01-01,16,34,16,34,50
20305,CHARAÃ‘A,estado nutricional en menores de 5 anos,clasificacion e,2001-01-01,2,0,2,0,2
50202,CHAYANTA,estado nutricional en menores de 5 anos,clasificacion e,2001-01-01,23,60,23,60,83
31204,CHIMORE,estado nutricional en menores de 5 anos,clasificacion e,2001-01-01,1,12,1,12,13
40903,CHIPAYA,estado nutricional en menores de 5 anos,clasificacion e,2001-01-01,0,3,0,3,3
21101,CHULUMANI (V. DE LA LIBERTAD),estado nutricional en menores de 5 anos,clasificacion e,2001-01-01,0,6,0,6,6
20501,CHUMA,estado nutricional en menores de 5 anos,clasificacion e,2001-01-01,0,5,0,5,5
90101,COBIJA,estado nutricional en menores de 5 anos,clasificacion e,2001-01-01,0,30,0,30,30
30101,COCHABAMBA,estado nutricional en menores de 5 anos,clasificacion e,2001-01-01,87,75,87,75,162
30905,COLCAPIRHUA,estado nutricional en menores de 5 anos,clasificacion e,2001-01-01,0,34,0,34,34
50901,"COLCHA ""K""",estado nutricional en menores de 5 anos,clasificacion e,2001-01-01,0,7,0,7,7
31002,COLOMI,estado nutricional en menores de 5 anos,clasificacion e,2001-01-01,0,15,0,15,15
70603,COLPA BELGICA,estado nutricional en menores de 5 anos,clasificacion e,2001-01-01,3,2,3,2,5
50401,COLQUECHACA,estado nutricional en menores de 5 anos,clasificacion e,2001-01-01,0,39,0,39,39
21306,COLQUENCHA,estado nutricional en menores de 5 anos,clasificacion e,2001-01-01,0,2,0,2,2
21004,COLQUIRI,estado nutricional en menores de 5 anos,clasificacion e,2001-01-01,2,113,2,113,115
20304,COMANCHE,estado nutricional en menores de 5 anos,clasificacion e,2001-01-01,0,10,0,10,10
71301,COMARAPA,estado nutricional en menores de 5 anos,clasificacion e,2001-01-01,0,1,0,1,1
20605,COMBAYA,estado nutricional en menores de 5 anos,clasificacion e,2001-01-01,0,2,0,2,2
71101,CONCEPCION,estado nutricional en menores de 5 anos,clasificacion e,2001-01-01,14,0,14,0,14
21701,COPACABANA,estado nutricional en menores de 5 anos,clasificacion e,2001-01-01,0,13,0,13,13
20301,CORO CORO,estado nutricional en menores de 5 anos,clasificacion e,2001-01-01,2,16,2,16,18
21401,COROICO,estado nutricional en menores de 5 anos,clasificacion e,2001-01-01,0,2,0,2,2
40301,CORQUE,estado nutricional en menores de 5 anos,clasificacion e,2001-01-01,0,8,0,8,8
50601,COTAGAITA,estado nutricional en menores de 5 anos,clasificacion e,2001-01-01,0,12,0,12,12
70704,CUEVO,estado nutricional en menores de 5 anos,clasificacion e,2001-01-01,4,19,4,19,23
10902,CULPINA,estado nutricional en menores de 5 anos,clasificacion e,2001-01-01,0,57,0,57,57
40401,CURAHUARA DE CARANGAS,estado nutricional en menores de 5 anos,clasificacion e,2001-01-01,1,3,1,3,4
20804,DESAGUADERO,estado nutricional en menores de 5 anos,clasificacion e,2001-01-01,0,6,0,6,6
20105,EL ALTO,estado nutricional en menores de 5 anos,clasificacion e,2001-01-01,43,373,43,373,416
71503,EL PUENTE(STC),estado nutricional en menores de 5 anos,clasificacion e,2001-01-01,0,34,0,34,34
60502,EL PUENTE(TJA),estado nutricional en menores de 5 anos,clasificacion e,2001-01-01,0,15,0,15,15
70105,EL TORNO,estado nutricional en menores de 5 anos,clasificacion e,2001-01-01,3,25,3,25,28
10405,EL VILLAR,estado nutricional en menores de 5 anos,clasificacion e,2001-01-01,3,53,3,53,56
60601,ENTRE RIOS,estado nutricional en menores de 5 anos,clasificacion e,2001-01-01,1,16,1,16,17
41101,EUCALIPTUS,estado nutricional en menores de 5 anos,clasificacion e,2001-01-01,0,7,0,7,7
71002,GENERAL SAAVEDRA,estado nutricional en menores de 5 anos,clasificacion e,2001-01-01,10,24,10,24,34
20602,GUANAY,estado nutricional en menores de 5 anos,clasificacion e,2001-01-01,5,11,5,11,16
20802,GUAQUI,estado nutricional en menores de 5 anos,clasificacion e,2001-01-01,0,3,0,3,3
80202,GUAYARAMERIN,estado nutricional en menores de 5 anos,clasificacion e,2001-01-01,0,21,0,21,21
70705,GUTIERREZ,estado nutricional en menores de 5 anos,clasificacion e,2001-01-01,2,96,2,96,98
10502,HUACARETA,estado nutricional en menores de 5 anos,clasificacion e,2001-01-01,3,52,3,52,55
11002,HUACAYA (VILLA DE HUACAYA),estado nutricional en menores de 5 anos,clasificacion e,2001-01-01,1,4,1,4,5
40501,HUACHACALLA,estado nutricional en menores de 5 anos,clasificacion e,2001-01-01,0,4,0,4,4
40701,HUANUNI,estado nutricional en menores de 5 anos,clasificacion e,2001-01-01,0,15,0,15,15
80803,HUARACAJE,estado nutricional en menores de 5 anos,clasificacion e,2001-01-01,0,3,0,3,3
41601,HUAYLLAMARCA,estado nutricional en menores de 5 anos,clasificacion e,2001-01-01,1,1,1,1,2
21005,ICHOCA,estado nutricional en menores de 5 anos,clasificacion e,2001-01-01,0,12,0,12,12
10304,ICLA,estado nutricional en menores de 5 anos,clasificacion e,2001-01-01,0,90,0,90,90
10703,INCAHUASI,estado nutricional en menores de 5 anos,clasificacion e,2001-01-01,1,38,1,38,39
21001,INQUISIVI,estado nutricional en menores de 5 anos,clasificacion e,2001-01-01,0,57,0,57,57
21102,IRUPANA (VILLA DE LANZA),estado nutricional en menores de 5 anos,clasificacion e,2001-01-01,2,4,2,4,6
21501,IXIAMAS,estado nutricional en menores de 5 anos,clasificacion e,2001-01-01,0,6,0,6,6
21105,LA ASUNTA,estado nutricional en menores de 5 anos,clasificacion e,2001-01-01,0,15,0,15,15
70104,LA GUARDIA,estado nutricional en menores de 5 anos,clasificacion e,2001-01-01,2,58,2,58,60
20101,LA PAZ,estado nutricional en menores de 5 anos,clasificacion e,2001-01-01,17,190,17,190,207
70701,LAGUNILLAS,estado nutricional en menores de 5 anos,clasificacion e,2001-01-01,6,20,6,20,26
21202,LAJA,estado nutricional en menores de 5 anos,clasificacion e,2001-01-01,0,6,0,6,6
10903,LAS CARRERAS,estado nutricional en menores de 5 anos,clasificacion e,2001-01-01,0,20,0,20,20
21006,LICOMA PAMPA,estado nutricional en menores de 5 anos,clasificacion e,2001-01-01,0,4,0,4,4
50203,LLALLAGUA,estado nutricional en menores de 5 anos,clasificacion e,2001-01-01,0,28,0,28,28
51401,LLICA,estado nutricional en menores de 5 anos,clasificacion e,2001-01-01,0,2,0,2,2
40702,MACHACAMARCA,estado nutricional en menores de 5 anos,clasificacion e,2001-01-01,0,1,0,1,1
11003,MACHARETI,estado nutricional en menores de 5 anos,clasificacion e,2001-01-01,0,31,0,31,31
80801,MAGDALENA,estado nutricional en menores de 5 anos,clasificacion e,2001-01-01,0,16,0,16,16
70903,MAIRANA,estado nutricional en menores de 5 anos,clasificacion e,2001-01-01,0,8,0,8,8
71003,MINEROS,estado nutricional en menores de 5 anos,clasificacion e,2001-01-01,2,66,2,66,68
31301,MIZQUE,estado nutricional en menores de 5 anos,clasificacion e,2001-01-01,8,3,8,3,11
20402,MOCOMOCO,estado nutricional en menores de 5 anos,clasificacion e,2001-01-01,0,18,0,18,18
10303,MOJOCOYA,estado nutricional en menores de 5 anos,clasificacion e,2001-01-01,2,18,2,18,20
10501,MONTEAGUDO,estado nutricional en menores de 5 anos,clasificacion e,2001-01-01,5,108,5,108,113
71001,MONTERO,estado nutricional en menores de 5 anos,clasificacion e,2001-01-01,14,116,14,116,130
70803,MORO MORO,estado nutricional en menores de 5 anos,clasificacion e,2001-01-01,1,2,1,2,3
30302,MOROCHATA,estado nutricional en menores de 5 anos,clasificacion e,2001-01-01,0,9,0,9,9
50404,OCURI,estado nutricional en menores de 5 anos,clasificacion e,2001-01-01,3,14,3,14,17
70202,OKINAWA,estado nutricional en menores de 5 anos,clasificacion e,2001-01-01,0,1,0,1,1
30203,OMEREQUE,estado nutricional en menores de 5 anos,clasificacion e,2001-01-01,0,4,0,4,4
40101,ORURO,estado nutricional en menores de 5 anos,clasificacion e,2001-01-01,11,124,11,124,135
60201,PADCAYA,estado nutricional en menores de 5 anos,clasificacion e,2001-01-01,0,18,0,18,18
10401,PADILLA,estado nutricional en menores de 5 anos,clasificacion e,2001-01-01,1,69,1,69,70
70502,PAILON,estado nutricional en menores de 5 anos,clasificacion e,2001-01-01,8,9,8,9,17
20102,PALCA,estado nutricional en menores de 5 anos,clasificacion e,2001-01-01,0,1,0,1,1
21104,PALOS BLANCOS,estado nutricional en menores de 5 anos,clasificacion e,2001-01-01,0,39,0,39,39
40802,PAMPA AULLAGAS,estado nutricional en menores de 5 anos,clasificacion e,2001-01-01,0,1,0,1,1
70902,PAMPA GRANDE,estado nutricional en menores de 5 anos,clasificacion e,2001-01-01,0,9,0,9,9
30202,PASORAPA,estado nutricional en menores de 5 anos,clasificacion e,2001-01-01,0,16,0,16,16
40602,PAZÃ‘A,estado nutricional en menores de 5 anos,clasificacion e,2001-01-01,0,7,0,7,7
20702,PELECHUCO,estado nutricional en menores de 5 anos,clasificacion e,2001-01-01,5,0,5,0,5
50403,POCOATA,estado nutricional en menores de 5 anos,clasificacion e,2001-01-01,1,46,1,46,47
31203,POCONA,estado nutricional en menores de 5 anos,clasificacion e,2001-01-01,0,6,0,6,6
31202,POJO (CBBA),estado nutricional en menores de 5 anos,clasificacion e,2001-01-01,0,49,0,49,49
40601,POOPO,estado nutricional en menores de 5 anos,clasificacion e,2001-01-01,4,2,4,2,6
51203,PORCO,estado nutricional en menores de 5 anos,clasificacion e,2001-01-01,0,5,0,5,5
10103,POROMA,estado nutricional en menores de 5 anos,clasificacion e,2001-01-01,11,67,11,67,78
70103,PORONGO,estado nutricional en menores de 5 anos,clasificacion e,2001-01-01,0,20,0,20,20
70601,PORTACHUELO,estado nutricional en menores de 5 anos,clasificacion e,2001-01-01,0,7,0,7,7
90102,PORVENIR,estado nutricional en menores de 5 anos,clasificacion e,2001-01-01,0,8,0,8,8
50101,POTOSI,estado nutricional en menores de 5 anos,clasificacion e,2001-01-01,2,102,2,102,104
10302,PRESTO,estado nutricional en menores de 5 anos,clasificacion e,2001-01-01,0,44,0,44,44
70805,PUCARA,estado nutricional en menores de 5 anos,clasificacion e,2001-01-01,0,1,0,1,1
21201,PUCARANI,estado nutricional en menores de 5 anos,clasificacion e,2001-01-01,1,12,1,12,13
20401,PUERTO ACOSTA,estado nutricional en menores de 5 anos,clasificacion e,2001-01-01,0,4,0,4,4
20403,PUERTO CARABUCO,estado nutricional en menores de 5 anos,clasificacion e,2001-01-01,2,23,2,23,25
21204,PUERTO PEREZ,estado nutricional en menores de 5 anos,clasificacion e,2001-01-01,0,1,0,1,1
71402,PUERTO QUIJARRO,estado nutricional en menores de 5 anos,clasificacion e,2001-01-01,0,12,0,12,12
90201,PUERTO RICO,estado nutricional en menores de 5 anos,clasificacion e,2001-01-01,1,3,1,3,4
71401,PUERTO SUAREZ,estado nutricional en menores de 5 anos,clasificacion e,2001-01-01,1,26,1,26,27
31205,PUERTO VILLARROEL,estado nutricional en menores de 5 anos,clasificacion e,2001-01-01,19,46,19,46,65
51101,PUNA,estado nutricional en menores de 5 anos,clasificacion e,2001-01-01,0,110,0,110,110
31401,PUNATA,estado nutricional en menores de 5 anos,clasificacion e,2001-01-01,4,15,4,15,19
20604,QUIABAYA,estado nutricional en menores de 5 anos,clasificacion e,2001-01-01,0,4,0,4,4
21002,QUIME,estado nutricional en menores de 5 anos,clasificacion e,2001-01-01,1,22,1,22,23
70904,QUIRUSILLAS,estado nutricional en menores de 5 anos,clasificacion e,2001-01-01,0,1,0,1,1
50402,RAVELO,estado nutricional en menores de 5 anos,clasificacion e,2001-01-01,2,50,2,50,52
80301,REYES,estado nutricional en menores de 5 anos,clasificacion e,2001-01-01,1,14,1,14,15
80201,RIBERALTA,estado nutricional en menores de 5 anos,clasificacion e,2001-01-01,13,137,13,137,150
70503,ROBORE,estado nutricional en menores de 5 anos,clasificacion e,2001-01-01,3,21,3,21,24
80304,RURRENABAQUE,estado nutricional en menores de 5 anos,clasificacion e,2001-01-01,1,0,1,0,1
31001,SACABA,estado nutricional en menores de 5 anos,clasificacion e,2001-01-01,45,42,45,42,87
50701,SACACA,estado nutricional en menores de 5 anos,clasificacion e,2001-01-01,4,51,4,51,55
71302,SAIPINA,estado nutricional en menores de 5 anos,clasificacion e,2001-01-01,1,2,1,2,3
40801,SALINAS DE GARCI MENDOZA,estado nutricional en menores de 5 anos,clasificacion e,2001-01-01,0,3,0,3,3
70901,SAMAIPATA,estado nutricional en menores de 5 anos,clasificacion e,2001-01-01,0,7,0,7,7
80602,SAN ANDRES,estado nutricional en menores de 5 anos,clasificacion e,2001-01-01,0,16,0,16,16
71105,SAN ANTONIO DE LOMERIO,estado nutricional en menores de 5 anos,clasificacion e,2001-01-01,5,47,5,47,52
31403,SAN BENITO,estado nutricional en menores de 5 anos,clasificacion e,2001-01-01,4,8,4,8,12
80302,SAN BORJA,estado nutricional en menores de 5 anos,clasificacion e,2001-01-01,2,29,2,29,31
21502,SAN BUENA VENTURA,estado nutricional en menores de 5 anos,clasificacion e,2001-01-01,1,21,1,21,22
80501,SAN IGNACIO,estado nutricional en menores de 5 anos,clasificacion e,2001-01-01,9,28,9,28,37
70301,SAN IGNACIO DE VELASCO,estado nutricional en menores de 5 anos,clasificacion e,2001-01-01,3,87,3,87,90
80102,SAN JAVIER(BNI),estado nutricional en menores de 5 anos,clasificacion e,2001-01-01,0,5,0,5,5
71102,SAN JAVIER(STC),estado nutricional en menores de 5 anos,clasificacion e,2001-01-01,45,35,45,35,80
80701,SAN JOAQUIN,estado nutricional en menores de 5 anos,clasificacion e,2001-01-01,2,1,2,1,3
70501,SAN JOSE DE CHIQUITOS,estado nutricional en menores de 5 anos,clasificacion e,2001-01-01,2,50,2,50,52
71104,SAN JULIAN,estado nutricional en menores de 5 anos,clasificacion e,2001-01-01,1,61,1,61,62
60501,SAN LORENZO(TJA),estado nutricional en menores de 5 anos,clasificacion e,2001-01-01,1,4,1,4,5
10702,SAN LUCAS,estado nutricional en menores de 5 anos,clasificacion e,2001-01-01,2,113,2,113,115
71201,SAN MATIAS,estado nutricional en menores de 5 anos,clasificacion e,2001-01-01,0,14,0,14,14
70302,SAN MIGUEL DE VELASCO,estado nutricional en menores de 5 anos,clasificacion e,2001-01-01,0,47,0,47,47
51001,SAN PABLO DE LIPEZ,estado nutricional en menores de 5 anos,clasificacion e,2001-01-01,1,9,1,9,10
50501,SAN PEDRO DE BUENA VISTA,estado nutricional en menores de 5 anos,clasificacion e,2001-01-01,2,47,2,47,49
21801,SAN PEDRO DE CURAHUARA,estado nutricional en menores de 5 anos,clasificacion e,2001-01-01,0,2,0,2,2
50902,SAN PEDRO DE QUEMES,estado nutricional en menores de 5 anos,clasificacion e,2001-01-01,1,1,1,1,2
21702,SAN PEDRO DE TIQUINA,estado nutricional en menores de 5 anos,clasificacion e,2001-01-01,1,2,1,2,3
70303,SAN RAFAEL,estado nutricional en menores de 5 anos,clasificacion e,2001-01-01,2,13,2,13,15
80702,SAN RAMON,estado nutricional en menores de 5 anos,clasificacion e,2001-01-01,0,21,0,21,21
80702,SAN RAMON,estado nutricional en menores de 5 anos,clasificacion e,2001-01-01,0,1,0,1,1
70101,SANTA CRUZ DE LA SIERRA,estado nutricional en menores de 5 anos,clasificacion e,2001-01-01,20,41,20,41,61
80303,SANTA ROSA,estado nutricional en menores de 5 anos,clasificacion e,2001-01-01,0,3,0,3,3
70602,SANTA ROSA DEL SARA,estado nutricional en menores de 5 anos,clasificacion e,2001-01-01,0,1,0,1,1
20308,SANTIAGO DE CALLAPA,estado nutricional en menores de 5 anos,clasificacion e,2001-01-01,0,1,0,1,1
41401,SANTIAGO DE HUARI,estado nutricional en menores de 5 anos,clasificacion e,2001-01-01,0,5,0,5,5
30702,SANTIVAÃ‘ES,estado nutricional en menores de 5 anos,clasificacion e,2001-01-01,3,1,3,1,4
40202,SANTUARIO DE QUILLACAS,estado nutricional en menores de 5 anos,clasificacion e,2001-01-01,0,1,0,1,1
21301,SICA SICA (VILLA AROMA),estado nutricional en menores de 5 anos,clasificacion e,2001-01-01,0,4,0,4,4
30703,SICAYA,estado nutricional en menores de 5 anos,clasificacion e,2001-01-01,0,2,0,2,2
30902,SIPE SIPE,estado nutricional en menores de 5 anos,clasificacion e,2001-01-01,1,71,1,71,72
10403,SOPACHUY,estado nutricional en menores de 5 anos,clasificacion e,2001-01-01,2,49,2,49,51
20601,SORATA,estado nutricional en menores de 5 anos,clasificacion e,2001-01-01,4,4,4,4,8
10101,SUCRE,estado nutricional en menores de 5 anos,clasificacion e,2001-01-01,30,325,30,325,355
31404,TACACHI,estado nutricional en menores de 5 anos,clasificacion e,2001-01-01,0,2,0,2,2
20603,TACACOMA,estado nutricional en menores de 5 anos,clasificacion e,2001-01-01,0,6,0,6,6
50303,TACOBAMBA,estado nutricional en menores de 5 anos,clasificacion e,2001-01-01,0,22,0,22,22
30602,TACOPAYA,estado nutricional en menores de 5 anos,clasificacion e,2001-01-01,0,3,0,3,3
31101,TAPACARI,estado nutricional en menores de 5 anos,clasificacion e,2001-01-01,2,32,2,32,34
10601,TARABUCO,estado nutricional en menores de 5 anos,clasificacion e,2001-01-01,4,195,4,195,199
60101,TARIJA,estado nutricional en menores de 5 anos,clasificacion e,2001-01-01,3,36,3,36,39
10202,TARVITA,estado nutricional en menores de 5 anos,clasificacion e,2001-01-01,0,37,0,37,37
20803,TIAWANACU,estado nutricional en menores de 5 anos,clasificacion e,2001-01-01,0,6,0,6,6
50102,TINGUIPAYA,estado nutricional en menores de 5 anos,clasificacion e,2001-01-01,1,14,1,14,15
20606,TIPUANI,estado nutricional en menores de 5 anos,clasificacion e,2001-01-01,2,5,2,5,7
30903,TIQUIPAYA,estado nutricional en menores de 5 anos,clasificacion e,2001-01-01,0,2,0,2,2
31601,TIRAQUE (CBBA),estado nutricional en menores de 5 anos,clasificacion e,2001-01-01,1,25,1,25,26
41001,TOLEDO,estado nutricional en menores de 5 anos,clasificacion e,2001-01-01,0,4,0,4,4
51202,TOMAVE,estado nutricional en menores de 5 anos,clasificacion e,2001-01-01,0,15,0,15,15
10402,TOMINA,estado nutricional en menores de 5 anos,clasificacion e,2001-01-01,0,72,0,72,72
31201,TOTORA(CBBA),estado nutricional en menores de 5 anos,clasificacion e,2001-01-01,0,22,0,22,22
41301,TOTORA(ORR),estado nutricional en menores de 5 anos,clasificacion e,2001-01-01,0,2,0,2,2
70802,TRIGAL,estado nutricional en menores de 5 anos,clasificacion e,2001-01-01,0,4,0,4,4
80101,TRINIDAD,estado nutricional en menores de 5 anos,clasificacion e,2001-01-01,0,7,0,7,7
50801,TUPIZA,estado nutricional en menores de 5 anos,clasificacion e,2001-01-01,1,102,1,102,103
40402,TURCO,estado nutricional en menores de 5 anos,clasificacion e,2001-01-01,0,1,0,1,1
50201,UNCIA,estado nutricional en menores de 5 anos,clasificacion e,2001-01-01,3,11,3,11,14
60401,URIONDO (A. CONCEPCION),estado nutricional en menores de 5 anos,clasificacion e,2001-01-01,0,8,0,8,8
71502,URUBICHA,estado nutricional en menores de 5 anos,clasificacion e,2001-01-01,0,8,0,8,8
51201,UYUNI,estado nutricional en menores de 5 anos,clasificacion e,2001-01-01,3,19,3,19,22
30502,VACAS,estado nutricional en menores de 5 anos,clasificacion e,2001-01-01,2,3,2,3,5
70801,VALLEGRANDE,estado nutricional en menores de 5 anos,clasificacion e,2001-01-01,1,7,1,7,8
20801,VIACHA,estado nutricional en menores de 5 anos,clasificacion e,2001-01-01,4,17,4,17,21
60303,VILLA MONTES,estado nutricional en menores de 5 anos,clasificacion e,2001-01-01,2,58,2,58,60
31402,VILLA RIVERO,estado nutricional en menores de 5 anos,clasificacion e,2001-01-01,0,1,0,1,1
10801,VILLA SERRANO,estado nutricional en menores de 5 anos,clasificacion e,2001-01-01,8,85,8,85,93
31003,VILLA TUNARI,estado nutricional en menores de 5 anos,clasificacion e,2001-01-01,1,8,1,8,9
11001,VILLA VACA GUZMAN (MUYUPAMPA),estado nutricional en menores de 5 anos,clasificacion e,2001-01-01,1,45,1,45,46
51501,VILLAZON,estado nutricional en menores de 5 anos,clasificacion e,2001-01-01,1,37,1,37,38
70201,WARNES,estado nutricional en menores de 5 anos,clasificacion e,2001-01-01,0,2,0,2,2
20903,YACO,estado nutricional en menores de 5 anos,clasificacion e,2001-01-01,7,3,7,3,10
60301,YACUIBA,estado nutricional en menores de 5 anos,clasificacion e,2001-01-01,1,76,1,76,77
10602,YAMPARAEZ,estado nutricional en menores de 5 anos,clasificacion e,2001-01-01,0,98,0,98,98
21103,YANACACHI,estado nutricional en menores de 5 anos,clasificacion e,2001-01-01,0,1,0,1,1
50103,YOCALLA,estado nutricional en menores de 5 anos,clasificacion e,2001-01-01,0,12,0,12,12
10102,YOTALA,estado nutricional en menores de 5 anos,clasificacion e,2001-01-01,2,58,2,58,60
60402,YUNCHARA,estado nutricional en menores de 5 anos,clasificacion e,2001-01-01,2,18,2,18,20
10301,ZUDAÃ‘EZ,estado nutricional en menores de 5 anos,clasificacion e,2001-01-01,0,58,0,58,58
51302,ACACIO,estado nutricional en menores de 5 anos,clasificacion e,2001-02-01,0,57,0,57,57
20201,ACHACACHI,estado nutricional en menores de 5 anos,clasificacion e,2001-02-01,1,37,1,37,38
20104,ACHOCALLA,estado nutricional en menores de 5 anos,clasificacion e,2001-02-01,0,1,0,1,1
30201,AIQUILE,estado nutricional en menores de 5 anos,clasificacion e,2001-02-01,0,19,0,19,19
10404,ALCALA,estado nutricional en menores de 5 anos,clasificacion e,2001-02-01,0,26,0,26,26
20202,ANCORAIMES,estado nutricional en menores de 5 anos,clasificacion e,2001-02-01,0,39,0,39,39
30402,ANZALDO,estado nutricional en menores de 5 anos,clasificacion e,2001-02-01,2,24,2,24,26
51301,ARAMPAMPA,estado nutricional en menores de 5 anos,clasificacion e,2001-02-01,0,22,0,22,22
30501,ARANI,estado nutricional en menores de 5 anos,clasificacion e,2001-02-01,0,11,0,11,11
30403,ARBIETO,estado nutricional en menores de 5 anos,clasificacion e,2001-02-01,1,4,1,4,5
30601,ARQUE,estado nutricional en menores de 5 anos,clasificacion e,2001-02-01,0,3,0,3,3
71501,ASCENCION DE GUARAYOS,estado nutricional en menores de 5 anos,clasificacion e,2001-02-01,2,124,2,124,126
50802,ATOCHA,estado nutricional en menores de 5 anos,clasificacion e,2001-02-01,0,2,0,2,2
20503,AUCAPATA,estado nutricional en menores de 5 anos,clasificacion e,2001-02-01,0,11,0,11,11
20502,AYATA,estado nutricional en menores de 5 anos,clasificacion e,2001-02-01,0,1,0,1,1
30301,AYOPAYA (V. DE INDEPENDENCIA),estado nutricional en menores de 5 anos,clasificacion e,2001-02-01,2,29,2,29,31
10201,AZURDUY,estado nutricional en menores de 5 anos,clasificacion e,2001-02-01,1,70,1,70,71
21203,BATALLAS,estado nutricional en menores de 5 anos,clasificacion e,2001-02-01,0,5,0,5,5
80802,BAURES,estado nutricional en menores de 5 anos,clasificacion e,2001-02-01,0,1,0,1,1
50104,BELEN DE URMIRI,estado nutricional en menores de 5 anos,clasificacion e,2001-02-01,0,3,0,3,3
90104,BELLA FLOR,estado nutricional en menores de 5 anos,clasificacion e,2001-02-01,1,4,1,4,5
60202,BERMEJO,estado nutricional en menores de 5 anos,clasificacion e,2001-02-01,0,7,0,7,7
50301,BETANZOS,estado nutricional en menores de 5 anos,clasificacion e,2001-02-01,10,114,10,114,124
31501,BOLIVAR,estado nutricional en menores de 5 anos,clasificacion e,2001-02-01,0,45,0,45,45
90103,BOLPEBRA,estado nutricional en menores de 5 anos,clasificacion e,2001-02-01,0,4,0,4,4
70707,BOYUIBE,estado nutricional en menores de 5 anos,clasificacion e,2001-02-01,0,4,0,4,4
70703,CABEZAS,estado nutricional en menores de 5 anos,clasificacion e,2001-02-01,9,18,9,18,27
20905,CAIROMA,estado nutricional en menores de 5 anos,clasificacion e,2001-02-01,3,6,3,6,9
51102,"CAIZA ""D""",estado nutricional en menores de 5 anos,clasificacion e,2001-02-01,0,34,0,34,34
21003,CAJUATA,estado nutricional en menores de 5 anos,clasificacion e,2001-02-01,0,15,0,15,15
21304,CALAMARCA,estado nutricional en menores de 5 anos,clasificacion e,2001-02-01,0,5,0,5,5
10701,CAMARGO,estado nutricional en menores de 5 anos,clasificacion e,2001-02-01,6,27,6,27,33
10901,CAMATAQUI (C. VILLA ABECIA),estado nutricional en menores de 5 anos,clasificacion e,2001-02-01,0,2,0,2,2
70706,CAMIRI,estado nutricional en menores de 5 anos,clasificacion e,2001-02-01,1,25,1,25,26
30701,CAPINOTA,estado nutricional en menores de 5 anos,clasificacion e,2001-02-01,23,6,23,6,29
20302,CAQUIAVIRI,estado nutricional en menores de 5 anos,clasificacion e,2001-02-01,0,6,0,6,6
40102,CARACOLLO,estado nutricional en menores de 5 anos,clasificacion e,2001-02-01,0,17,0,17,17
22001,CARANAVI,estado nutricional en menores de 5 anos,clasificacion e,2001-02-01,2,36,2,36,38
60302,CARAPARI,estado nutricional en menores de 5 anos,clasificacion e,2001-02-01,0,10,0,10,10
50702,CARIPUYO,estado nutricional en menores de 5 anos,clasificacion e,2001-02-01,0,52,0,52,52
40201,CHALLAPATA,estado nutricional en menores de 5 anos,clasificacion e,2001-02-01,0,15,0,15,15
50302,CHAQUI,estado nutricional en menores de 5 anos,clasificacion e,2001-02-01,0,32,0,32,32
70702,CHARAGUA,estado nutricional en menores de 5 anos,clasificacion e,2001-02-01,25,36,25,36,61
50202,CHAYANTA,estado nutricional en menores de 5 anos,clasificacion e,2001-02-01,0,65,0,65,65
31204,CHIMORE,estado nutricional en menores de 5 anos,clasificacion e,2001-02-01,1,18,1,18,19
21101,CHULUMANI (V. DE LA LIBERTAD),estado nutricional en menores de 5 anos,clasificacion e,2001-02-01,0,9,0,9,9
20501,CHUMA,estado nutricional en menores de 5 anos,clasificacion e,2001-02-01,0,12,0,12,12
30801,CLIZA,estado nutricional en menores de 5 anos,clasificacion e,2001-02-01,2,7,2,7,9
90101,COBIJA,estado nutricional en menores de 5 anos,clasificacion e,2001-02-01,2,17,2,17,19
30101,COCHABAMBA,estado nutricional en menores de 5 anos,clasificacion e,2001-02-01,112,66,112,66,178
40902,COIPASA,estado nutricional en menores de 5 anos,clasificacion e,2001-02-01,0,1,0,1,1
30905,COLCAPIRHUA,estado nutricional en menores de 5 anos,clasificacion e,2001-02-01,0,22,0,22,22
50901,"COLCHA ""K""",estado nutricional en menores de 5 anos,clasificacion e,2001-02-01,0,13,0,13,13
31002,COLOMI,estado nutricional en menores de 5 anos,clasificacion e,2001-02-01,0,5,0,5,5
70603,COLPA BELGICA,estado nutricional en menores de 5 anos,clasificacion e,2001-02-01,1,4,1,4,5
50401,COLQUECHACA,estado nutricional en menores de 5 anos,clasificacion e,2001-02-01,3,30,3,30,33
21306,COLQUENCHA,estado nutricional en menores de 5 anos,clasificacion e,2001-02-01,0,2,0,2,2
21004,COLQUIRI,estado nutricional en menores de 5 anos,clasificacion e,2001-02-01,0,40,0,40,40
20304,COMANCHE,estado nutricional en menores de 5 anos,clasificacion e,2001-02-01,0,5,0,5,5
71301,COMARAPA,estado nutricional en menores de 5 anos,clasificacion e,2001-02-01,1,6,1,6,7
20605,COMBAYA,estado nutricional en menores de 5 anos,clasificacion e,2001-02-01,0,2,0,2,2
71101,CONCEPCION,estado nutricional en menores de 5 anos,clasificacion e,2001-02-01,1,13,1,13,14
21701,COPACABANA,estado nutricional en menores de 5 anos,clasificacion e,2001-02-01,0,4,0,4,4
21402,CORIPATA,estado nutricional en menores de 5 anos,clasificacion e,2001-02-01,0,8,0,8,8
20301,CORO CORO,estado nutricional en menores de 5 anos,clasificacion e,2001-02-01,0,9,0,9,9
21401,COROICO,estado nutricional en menores de 5 anos,clasificacion e,2001-02-01,0,2,0,2,2
40301,CORQUE,estado nutricional en menores de 5 anos,clasificacion e,2001-02-01,0,3,0,3,3
50601,COTAGAITA,estado nutricional en menores de 5 anos,clasificacion e,2001-02-01,1,31,1,31,32
70102,COTOCA,estado nutricional en menores de 5 anos,clasificacion e,2001-02-01,4,15,4,15,19
70704,CUEVO,estado nutricional en menores de 5 anos,clasificacion e,2001-02-01,2,14,2,14,16
10902,CULPINA,estado nutricional en menores de 5 anos,clasificacion e,2001-02-01,5,65,5,65,70
21602,CURVA,estado nutricional en menores de 5 anos,clasificacion e,2001-02-01,0,1,0,1,1
20804,DESAGUADERO,estado nutricional en menores de 5 anos,clasificacion e,2001-02-01,0,5,0,5,5
20105,EL ALTO,estado nutricional en menores de 5 anos,clasificacion e,2001-02-01,47,366,47,366,413
71503,EL PUENTE(STC),estado nutricional en menores de 5 anos,clasificacion e,2001-02-01,3,33,3,33,36
60502,EL PUENTE(TJA),estado nutricional en menores de 5 anos,clasificacion e,2001-02-01,0,13,0,13,13
70105,EL TORNO,estado nutricional en menores de 5 anos,clasificacion e,2001-02-01,0,11,0,11,11
10405,EL VILLAR,estado nutricional en menores de 5 anos,clasificacion e,2001-02-01,4,48,4,48,52
60601,ENTRE RIOS,estado nutricional en menores de 5 anos,clasificacion e,2001-02-01,0,36,0,36,36
40502,ESCARA,estado nutricional en menores de 5 anos,clasificacion e,2001-02-01,0,1,0,1,1
41101,EUCALIPTUS,estado nutricional en menores de 5 anos,clasificacion e,2001-02-01,2,6,2,6,8
90203,FILADELFIA,estado nutricional en menores de 5 anos,clasificacion e,2001-02-01,1,1,1,1,2
71002,GENERAL SAAVEDRA,estado nutricional en menores de 5 anos,clasificacion e,2001-02-01,2,52,2,52,54
21601,GRAL. J.J. PEREZ (CHARAZANI),estado nutricional en menores de 5 anos,clasificacion e,2001-02-01,0,4,0,4,4
20602,GUANAY,estado nutricional en menores de 5 anos,clasificacion e,2001-02-01,2,18,2,18,20
20802,GUAQUI,estado nutricional en menores de 5 anos,clasificacion e,2001-02-01,0,4,0,4,4
80202,GUAYARAMERIN,estado nutricional en menores de 5 anos,clasificacion e,2001-02-01,0,22,0,22,22
70705,GUTIERREZ,estado nutricional en menores de 5 anos,clasificacion e,2001-02-01,3,67,3,67,70
10502,HUACARETA,estado nutricional en menores de 5 anos,clasificacion e,2001-02-01,0,57,0,57,57
11002,HUACAYA (VILLA DE HUACAYA),estado nutricional en menores de 5 anos,clasificacion e,2001-02-01,1,29,1,29,30
40501,HUACHACALLA,estado nutricional en menores de 5 anos,clasificacion e,2001-02-01,0,1,0,1,1
40701,HUANUNI,estado nutricional en menores de 5 anos,clasificacion e,2001-02-01,2,47,2,47,49
41601,HUAYLLAMARCA,estado nutricional en menores de 5 anos,clasificacion e,2001-02-01,0,3,0,3,3
21005,ICHOCA,estado nutricional en menores de 5 anos,clasificacion e,2001-02-01,0,5,0,5,5
10304,ICLA,estado nutricional en menores de 5 anos,clasificacion e,2001-02-01,0,86,0,86,86
10703,INCAHUASI,estado nutricional en menores de 5 anos,clasificacion e,2001-02-01,1,49,1,49,50
21001,INQUISIVI,estado nutricional en menores de 5 anos,clasificacion e,2001-02-01,0,35,0,35,35
21102,IRUPANA (VILLA DE LANZA),estado nutricional en menores de 5 anos,clasificacion e,2001-02-01,0,11,0,11,11
21501,IXIAMAS,estado nutricional en menores de 5 anos,clasificacion e,2001-02-01,0,17,0,17,17
21105,LA ASUNTA,estado nutricional en menores de 5 anos,clasificacion e,2001-02-01,5,27,5,27,32
70104,LA GUARDIA,estado nutricional en menores de 5 anos,clasificacion e,2001-02-01,3,20,3,20,23
20101,LA PAZ,estado nutricional en menores de 5 anos,clasificacion e,2001-02-01,25,217,25,217,242
70701,LAGUNILLAS,estado nutricional en menores de 5 anos,clasificacion e,2001-02-01,7,6,7,6,13
21202,LAJA,estado nutricional en menores de 5 anos,clasificacion e,2001-02-01,0,10,0,10,10
10903,LAS CARRERAS,estado nutricional en menores de 5 anos,clasificacion e,2001-02-01,0,18,0,18,18
21006,LICOMA PAMPA,estado nutricional en menores de 5 anos,clasificacion e,2001-02-01,0,2,0,2,2
50203,LLALLAGUA,estado nutricional en menores de 5 anos,clasificacion e,2001-02-01,2,64,2,64,66
51401,LLICA,estado nutricional en menores de 5 anos,clasificacion e,2001-02-01,0,1,0,1,1
80601,LORETO,estado nutricional en menores de 5 anos,clasificacion e,2001-02-01,0,1,0,1,1
20901,LURIBAY,estado nutricional en menores de 5 anos,clasificacion e,2001-02-01,1,0,1,0,1
11003,MACHARETI,estado nutricional en menores de 5 anos,clasificacion e,2001-02-01,0,26,0,26,26
80801,MAGDALENA,estado nutricional en menores de 5 anos,clasificacion e,2001-02-01,0,1,0,1,1
70903,MAIRANA,estado nutricional en menores de 5 anos,clasificacion e,2001-02-01,0,8,0,8,8
20904,MALLA,estado nutricional en menores de 5 anos,clasificacion e,2001-02-01,2,1,2,1,3
71003,MINEROS,estado nutricional en menores de 5 anos,clasificacion e,2001-02-01,1,77,1,77,78
31301,MIZQUE,estado nutricional en menores de 5 anos,clasificacion e,2001-02-01,7,4,7,4,11
20402,MOCOMOCO,estado nutricional en menores de 5 anos,clasificacion e,2001-02-01,1,25,1,25,26
51002,MOJINETE,estado nutricional en menores de 5 anos,clasificacion e,2001-02-01,0,2,0,2,2
10303,MOJOCOYA,estado nutricional en menores de 5 anos,clasificacion e,2001-02-01,2,33,2,33,35
10501,MONTEAGUDO,estado nutricional en menores de 5 anos,clasificacion e,2001-02-01,0,68,0,68,68
71001,MONTERO,estado nutricional en menores de 5 anos,clasificacion e,2001-02-01,27,91,27,91,118
30302,MOROCHATA,estado nutricional en menores de 5 anos,clasificacion e,2001-02-01,2,23,2,23,25
50404,OCURI,estado nutricional en menores de 5 anos,clasificacion e,2001-02-01,5,21,5,21,26
70202,OKINAWA,estado nutricional en menores de 5 anos,clasificacion e,2001-02-01,0,5,0,5,5
30203,OMEREQUE,estado nutricional en menores de 5 anos,clasificacion e,2001-02-01,0,12,0,12,12
40101,ORURO,estado nutricional en menores de 5 anos,clasificacion e,2001-02-01,10,115,10,115,125
60201,PADCAYA,estado nutricional en menores de 5 anos,clasificacion e,2001-02-01,2,13,2,13,15
10401,PADILLA,estado nutricional en menores de 5 anos,clasificacion e,2001-02-01,0,83,0,83,83
70502,PAILON,estado nutricional en menores de 5 anos,clasificacion e,2001-02-01,3,4,3,4,7
21104,PALOS BLANCOS,estado nutricional en menores de 5 anos,clasificacion e,2001-02-01,0,32,0,32,32
40802,PAMPA AULLAGAS,estado nutricional en menores de 5 anos,clasificacion e,2001-02-01,0,1,0,1,1
70902,PAMPA GRANDE,estado nutricional en menores de 5 anos,clasificacion e,2001-02-01,0,10,0,10,10
30202,PASORAPA,estado nutricional en menores de 5 anos,clasificacion e,2001-02-01,0,4,0,4,4
40602,PAZÃ‘A,estado nutricional en menores de 5 anos,clasificacion e,2001-02-01,0,2,0,2,2
20702,PELECHUCO,estado nutricional en menores de 5 anos,clasificacion e,2001-02-01,1,6,1,6,7
50403,POCOATA,estado nutricional en menores de 5 anos,clasificacion e,2001-02-01,15,40,15,40,55
31203,POCONA,estado nutricional en menores de 5 anos,clasificacion e,2001-02-01,3,2,3,2,5
31202,POJO (CBBA),estado nutricional en menores de 5 anos,clasificacion e,2001-02-01,5,35,5,35,40
40601,POOPO,estado nutricional en menores de 5 anos,clasificacion e,2001-02-01,0,2,0,2,2
51203,PORCO,estado nutricional en menores de 5 anos,clasificacion e,2001-02-01,1,5,1,5,6
10103,POROMA,estado nutricional en menores de 5 anos,clasificacion e,2001-02-01,0,74,0,74,74
70103,PORONGO,estado nutricional en menores de 5 anos,clasificacion e,2001-02-01,0,3,0,3,3
70601,PORTACHUELO,estado nutricional en menores de 5 anos,clasificacion e,2001-02-01,0,32,0,32,32
90102,PORVENIR,estado nutricional en menores de 5 anos,clasificacion e,2001-02-01,1,6,1,6,7
50101,POTOSI,estado nutricional en menores de 5 anos,clasificacion e,2001-02-01,2,112,2,112,114
10302,PRESTO,estado nutricional en menores de 5 anos,clasificacion e,2001-02-01,2,50,2,50,52
70805,PUCARA,estado nutricional en menores de 5 anos,clasificacion e,2001-02-01,0,1,0,1,1
21201,PUCARANI,estado nutricional en menores de 5 anos,clasificacion e,2001-02-01,1,16,1,16,17
20401,PUERTO ACOSTA,estado nutricional en menores de 5 anos,clasificacion e,2001-02-01,10,30,10,30,40
20403,PUERTO CARABUCO,estado nutricional en menores de 5 anos,clasificacion e,2001-02-01,9,25,9,25,34
90301,PUERTO GONZALO MORENO,estado nutricional en menores de 5 anos,clasificacion e,2001-02-01,0,5,0,5,5
21204,PUERTO PEREZ,estado nutricional en menores de 5 anos,clasificacion e,2001-02-01,1,0,1,0,1
71402,PUERTO QUIJARRO,estado nutricional en menores de 5 anos,clasificacion e,2001-02-01,0,4,0,4,4
90201,PUERTO RICO,estado nutricional en menores de 5 anos,clasificacion e,2001-02-01,1,2,1,2,3
71401,PUERTO SUAREZ,estado nutricional en menores de 5 anos,clasificacion e,2001-02-01,2,25,2,25,27
31205,PUERTO VILLARROEL,estado nutricional en menores de 5 anos,clasificacion e,2001-02-01,2,57,2,57,59
51101,PUNA,estado nutricional en menores de 5 anos,clasificacion e,2001-02-01,3,70,3,70,73
31401,PUNATA,estado nutricional en menores de 5 anos,clasificacion e,2001-02-01,2,13,2,13,15
20604,QUIABAYA,estado nutricional en menores de 5 anos,clasificacion e,2001-02-01,0,19,0,19,19
30901,QUILLACOLLO,estado nutricional en menores de 5 anos,clasificacion e,2001-02-01,0,3,0,3,3
21002,QUIME,estado nutricional en menores de 5 anos,clasificacion e,2001-02-01,1,31,1,31,32
70904,QUIRUSILLAS,estado nutricional en menores de 5 anos,clasificacion e,2001-02-01,1,0,1,0,1
50402,RAVELO,estado nutricional en menores de 5 anos,clasificacion e,2001-02-01,4,76,4,76,80
80301,REYES,estado nutricional en menores de 5 anos,clasificacion e,2001-02-01,0,5,0,5,5
80201,RIBERALTA,estado nutricional en menores de 5 anos,clasificacion e,2001-02-01,2,90,2,90,92
70503,ROBORE,estado nutricional en menores de 5 anos,clasificacion e,2001-02-01,2,13,2,13,15
80304,RURRENABAQUE,estado nutricional en menores de 5 anos,clasificacion e,2001-02-01,2,3,2,3,5
40901,SABAYA,estado nutricional en menores de 5 anos,clasificacion e,2001-02-01,0,1,0,1,1
31001,SACABA,estado nutricional en menores de 5 anos,clasificacion e,2001-02-01,8,45,8,45,53
30404,SACABAMBA,estado nutricional en menores de 5 anos,clasificacion e,2001-02-01,0,19,0,19,19
50701,SACACA,estado nutricional en menores de 5 anos,clasificacion e,2001-02-01,3,171,3,171,174
71302,SAIPINA,estado nutricional en menores de 5 anos,clasificacion e,2001-02-01,0,14,0,14,14
40801,SALINAS DE GARCI MENDOZA,estado nutricional en menores de 5 anos,clasificacion e,2001-02-01,0,3,0,3,3
70901,SAMAIPATA,estado nutricional en menores de 5 anos,clasificacion e,2001-02-01,0,8,0,8,8
51601,SAN AGUSTIN,estado nutricional en menores de 5 anos,clasificacion e,2001-02-01,0,1,0,1,1
80602,SAN ANDRES,estado nutricional en menores de 5 anos,clasificacion e,2001-02-01,0,7,0,7,7
71105,SAN ANTONIO DE LOMERIO,estado nutricional en menores de 5 anos,clasificacion e,2001-02-01,12,74,12,74,86
31403,SAN BENITO,estado nutricional en menores de 5 anos,clasificacion e,2001-02-01,0,23,0,23,23
80302,SAN BORJA,estado nutricional en menores de 5 anos,clasificacion e,2001-02-01,1,39,1,39,40
21502,SAN BUENA VENTURA,estado nutricional en menores de 5 anos,clasificacion e,2001-02-01,0,20,0,20,20
70402,SAN CARLOS,estado nutricional en menores de 5 anos,clasificacion e,2001-02-01,1,4,1,4,5
80501,SAN IGNACIO,estado nutricional en menores de 5 anos,clasificacion e,2001-02-01,0,42,0,42,42
70301,SAN IGNACIO DE VELASCO,estado nutricional en menores de 5 anos,clasificacion e,2001-02-01,14,75,14,75,89
80102,SAN JAVIER(BNI),estado nutricional en menores de 5 anos,clasificacion e,2001-02-01,0,3,0,3,3
80701,SAN JOAQUIN,estado nutricional en menores de 5 anos,clasificacion e,2001-02-01,1,2,1,2,3
70501,SAN JOSE DE CHIQUITOS,estado nutricional en menores de 5 anos,clasificacion e,2001-02-01,0,14,0,14,14
71104,SAN JULIAN,estado nutricional en menores de 5 anos,clasificacion e,2001-02-01,4,50,4,50,54
90302,SAN LORENZO(PND),estado nutricional en menores de 5 anos,clasificacion e,2001-02-01,1,0,1,0,1
60501,SAN LORENZO(TJA),estado nutricional en menores de 5 anos,clasificacion e,2001-02-01,2,4,2,4,6
10702,SAN LUCAS,estado nutricional en menores de 5 anos,clasificacion e,2001-02-01,3,96,3,96,99
71201,SAN MATIAS,estado nutricional en menores de 5 anos,clasificacion e,2001-02-01,2,23,2,23,25
70302,SAN MIGUEL DE VELASCO,estado nutricional en menores de 5 anos,clasificacion e,2001-02-01,0,65,0,65,65
51001,SAN PABLO DE LIPEZ,estado nutricional en menores de 5 anos,clasificacion e,2001-02-01,0,2,0,2,2
50501,SAN PEDRO DE BUENA VISTA,estado nutricional en menores de 5 anos,clasificacion e,2001-02-01,4,50,4,50,54
50902,SAN PEDRO DE QUEMES,estado nutricional en menores de 5 anos,clasificacion e,2001-02-01,0,3,0,3,3
70303,SAN RAFAEL,estado nutricional en menores de 5 anos,clasificacion e,2001-02-01,0,6,0,6,6
80702,SAN RAMON,estado nutricional en menores de 5 anos,clasificacion e,2001-02-01,0,5,0,5,5
80702,SAN RAMON,estado nutricional en menores de 5 anos,clasificacion e,2001-02-01,2,0,2,0,2
80401,SANTA ANA,estado nutricional en menores de 5 anos,clasificacion e,2001-02-01,11,3,11,3,14
70101,SANTA CRUZ DE LA SIERRA,estado nutricional en menores de 5 anos,clasificacion e,2001-02-01,27,49,27,49,76
80303,SANTA ROSA,estado nutricional en menores de 5 anos,clasificacion e,2001-02-01,0,5,0,5,5
70602,SANTA ROSA DEL SARA,estado nutricional en menores de 5 anos,clasificacion e,2001-02-01,0,4,0,4,4
41401,SANTIAGO DE HUARI,estado nutricional en menores de 5 anos,clasificacion e,2001-02-01,0,9,0,9,9
30702,SANTIVAÃ‘ES,estado nutricional en menores de 5 anos,clasificacion e,2001-02-01,3,11,3,11,14
40202,SANTUARIO DE QUILLACAS,estado nutricional en menores de 5 anos,clasificacion e,2001-02-01,0,4,0,4,4
21301,SICA SICA (VILLA AROMA),estado nutricional en menores de 5 anos,clasificacion e,2001-02-01,0,8,0,8,8
30703,SICAYA,estado nutricional en menores de 5 anos,clasificacion e,2001-02-01,0,4,0,4,4
30902,SIPE SIPE,estado nutricional en menores de 5 anos,clasificacion e,2001-02-01,2,73,2,73,75
10403,SOPACHUY,estado nutricional en menores de 5 anos,clasificacion e,2001-02-01,69,75,69,75,144
20601,SORATA,estado nutricional en menores de 5 anos,clasificacion e,2001-02-01,1,10,1,10,11
10101,SUCRE,estado nutricional en menores de 5 anos,clasificacion e,2001-02-01,10,290,10,290,300
31404,TACACHI,estado nutricional en menores de 5 anos,clasificacion e,2001-02-01,0,5,0,5,5
20603,TACACOMA,estado nutricional en menores de 5 anos,clasificacion e,2001-02-01,1,10,1,10,11
50303,TACOBAMBA,estado nutricional en menores de 5 anos,clasificacion e,2001-02-01,1,14,1,14,15
30602,TACOPAYA,estado nutricional en menores de 5 anos,clasificacion e,2001-02-01,0,23,0,23,23
51402,TAHUA,estado nutricional en menores de 5 anos,clasificacion e,2001-02-01,0,2,0,2,2
31101,TAPACARI,estado nutricional en menores de 5 anos,clasificacion e,2001-02-01,2,24,2,24,26
10601,TARABUCO,estado nutricional en menores de 5 anos,clasificacion e,2001-02-01,7,197,7,197,204
30401,TARATA,estado nutricional en menores de 5 anos,clasificacion e,2001-02-01,1,7,1,7,8
60101,TARIJA,estado nutricional en menores de 5 anos,clasificacion e,2001-02-01,1,25,1,25,26
10202,TARVITA,estado nutricional en menores de 5 anos,clasificacion e,2001-02-01,1,37,1,37,38
20803,TIAWANACU,estado nutricional en menores de 5 anos,clasificacion e,2001-02-01,0,6,0,6,6
50102,TINGUIPAYA,estado nutricional en menores de 5 anos,clasificacion e,2001-02-01,2,26,2,26,28
20606,TIPUANI,estado nutricional en menores de 5 anos,clasificacion e,2001-02-01,2,5,2,5,7
30903,TIQUIPAYA,estado nutricional en menores de 5 anos,clasificacion e,2001-02-01,6,14,6,14,20
31601,TIRAQUE (CBBA),estado nutricional en menores de 5 anos,clasificacion e,2001-02-01,1,33,1,33,34
30802,TOCO,estado nutricional en menores de 5 anos,clasificacion e,2001-02-01,0,1,0,1,1
41001,TOLEDO,estado nutricional en menores de 5 anos,clasificacion e,2001-02-01,0,4,0,4,4
51202,TOMAVE,estado nutricional en menores de 5 anos,clasificacion e,2001-02-01,7,23,7,23,30
10402,TOMINA,estado nutricional en menores de 5 anos,clasificacion e,2001-02-01,0,68,0,68,68
50502,TORO TORO,estado nutricional en menores de 5 anos,clasificacion e,2001-02-01,1,1,1,1,2
31201,TOTORA(CBBA),estado nutricional en menores de 5 anos,clasificacion e,2001-02-01,1,24,1,24,25
41301,TOTORA(ORR),estado nutricional en menores de 5 anos,clasificacion e,2001-02-01,0,12,0,12,12
70802,TRIGAL,estado nutricional en menores de 5 anos,clasificacion e,2001-02-01,0,1,0,1,1
80101,TRINIDAD,estado nutricional en menores de 5 anos,clasificacion e,2001-02-01,7,43,7,43,50
50801,TUPIZA,estado nutricional en menores de 5 anos,clasificacion e,2001-02-01,1,36,1,36,37
21302,UMALA,estado nutricional en menores de 5 anos,clasificacion e,2001-02-01,0,2,0,2,2
50201,UNCIA,estado nutricional en menores de 5 anos,clasificacion e,2001-02-01,3,31,3,31,34
60401,URIONDO (A. CONCEPCION),estado nutricional en menores de 5 anos,clasificacion e,2001-02-01,1,8,1,8,9
51201,UYUNI,estado nutricional en menores de 5 anos,clasificacion e,2001-02-01,2,12,2,12,14
30502,VACAS,estado nutricional en menores de 5 anos,clasificacion e,2001-02-01,1,14,1,14,15
70801,VALLEGRANDE,estado nutricional en menores de 5 anos,clasificacion e,2001-02-01,0,15,0,15,15
20801,VIACHA,estado nutricional en menores de 5 anos,clasificacion e,2001-02-01,0,22,0,22,22
31302,VILA VILA,estado nutricional en menores de 5 anos,clasificacion e,2001-02-01,5,1,5,1,6
60303,VILLA MONTES,estado nutricional en menores de 5 anos,clasificacion e,2001-02-01,1,30,1,30,31
31402,VILLA RIVERO,estado nutricional en menores de 5 anos,clasificacion e,2001-02-01,0,7,0,7,7
10801,VILLA SERRANO,estado nutricional en menores de 5 anos,clasificacion e,2001-02-01,4,64,4,64,68
31003,VILLA TUNARI,estado nutricional en menores de 5 anos,clasificacion e,2001-02-01,0,20,0,20,20
11001,VILLA VACA GUZMAN (MUYUPAMPA),estado nutricional en menores de 5 anos,clasificacion e,2001-02-01,0,39,0,39,39
51501,VILLAZON,estado nutricional en menores de 5 anos,clasificacion e,2001-02-01,0,36,0,36,36
50602,VITICHI,estado nutricional en menores de 5 anos,clasificacion e,2001-02-01,0,4,0,4,4
70201,WARNES,estado nutricional en menores de 5 anos,clasificacion e,2001-02-01,0,34,0,34,34
60301,YACUIBA,estado nutricional en menores de 5 anos,clasificacion e,2001-02-01,3,35,3,35,38
10602,YAMPARAEZ,estado nutricional en menores de 5 anos,clasificacion e,2001-02-01,0,95,0,95,95
21103,YANACACHI,estado nutricional en menores de 5 anos,clasificacion e,2001-02-01,0,1,0,1,1
50103,YOCALLA,estado nutricional en menores de 5 anos,clasificacion e,2001-02-01,0,23,0,23,23
10102,YOTALA,estado nutricional en menores de 5 anos,clasificacion e,2001-02-01,0,68,0,68,68
60402,YUNCHARA,estado nutricional en menores de 5 anos,clasificacion e,2001-02-01,1,6,1,6,7
10301,ZUDAÃ‘EZ,estado nutricional en menores de 5 anos,clasificacion e,2001-02-01,0,50,0,50,50
51302,ACACIO,estado nutricional en menores de 5 anos,clasificacion e,2001-03-01,0,43,0,43,43
20201,ACHACACHI,estado nutricional en menores de 5 anos,clasificacion e,2001-03-01,0,41,0,41,41
20104,ACHOCALLA,estado nutricional en menores de 5 anos,clasificacion e,2001-03-01,0,4,0,4,4
30201,AIQUILE,estado nutricional en menores de 5 anos,clasificacion e,2001-03-01,0,34,0,34,34
31303,ALALAY,estado nutricional en menores de 5 anos,clasificacion e,2001-03-01,2,0,2,0,2
10404,ALCALA,estado nutricional en menores de 5 anos,clasificacion e,2001-03-01,0,40,0,40,40
20202,ANCORAIMES,estado nutricional en menores de 5 anos,clasificacion e,2001-03-01,0,37,0,37,37
41201,ANDAMARCA,estado nutricional en menores de 5 anos,clasificacion e,2001-03-01,0,4,0,4,4
40603,ANTEQUERA,estado nutricional en menores de 5 anos,clasificacion e,2001-03-01,0,1,0,1,1
30402,ANZALDO,estado nutricional en menores de 5 anos,clasificacion e,2001-03-01,3,27,3,27,30
51301,ARAMPAMPA,estado nutricional en menores de 5 anos,clasificacion e,2001-03-01,0,19,0,19,19
30501,ARANI,estado nutricional en menores de 5 anos,clasificacion e,2001-03-01,0,18,0,18,18
30403,ARBIETO,estado nutricional en menores de 5 anos,clasificacion e,2001-03-01,0,6,0,6,6
30601,ARQUE,estado nutricional en menores de 5 anos,clasificacion e,2001-03-01,1,13,1,13,14
50802,ATOCHA,estado nutricional en menores de 5 anos,clasificacion e,2001-03-01,0,18,0,18,18
20503,AUCAPATA,estado nutricional en menores de 5 anos,clasificacion e,2001-03-01,0,6,0,6,6
20502,AYATA,estado nutricional en menores de 5 anos,clasificacion e,2001-03-01,0,1,0,1,1
21303,AYO AYO,estado nutricional en menores de 5 anos,clasificacion e,2001-03-01,0,4,0,4,4
30301,AYOPAYA (V. DE INDEPENDENCIA),estado nutricional en menores de 5 anos,clasificacion e,2001-03-01,4,50,4,50,54
10201,AZURDUY,estado nutricional en menores de 5 anos,clasificacion e,2001-03-01,0,61,0,61,61
21203,BATALLAS,estado nutricional en menores de 5 anos,clasificacion e,2001-03-01,0,8,0,8,8
80802,BAURES,estado nutricional en menores de 5 anos,clasificacion e,2001-03-01,6,11,6,11,17
41202,BELEN DE ANDAMARCA,estado nutricional en menores de 5 anos,clasificacion e,2001-03-01,0,1,0,1,1
50104,BELEN DE URMIRI,estado nutricional en menores de 5 anos,clasificacion e,2001-03-01,0,9,0,9,9
90104,BELLA FLOR,estado nutricional en menores de 5 anos,clasificacion e,2001-03-01,0,2,0,2,2
60202,BERMEJO,estado nutricional en menores de 5 anos,clasificacion e,2001-03-01,0,7,0,7,7
50301,BETANZOS,estado nutricional en menores de 5 anos,clasificacion e,2001-03-01,8,130,8,130,138
31501,BOLIVAR,estado nutricional en menores de 5 anos,clasificacion e,2001-03-01,0,24,0,24,24
90103,BOLPEBRA,estado nutricional en menores de 5 anos,clasificacion e,2001-03-01,0,3,0,3,3
70707,BOYUIBE,estado nutricional en menores de 5 anos,clasificacion e,2001-03-01,0,7,0,7,7
70401,BUENA VISTA,estado nutricional en menores de 5 anos,clasificacion e,2001-03-01,8,8,8,8,16
70703,CABEZAS,estado nutricional en menores de 5 anos,clasificacion e,2001-03-01,3,7,3,7,10
20905,CAIROMA,estado nutricional en menores de 5 anos,clasificacion e,2001-03-01,13,9,13,9,22
51102,"CAIZA ""D""",estado nutricional en menores de 5 anos,clasificacion e,2001-03-01,1,63,1,63,64
21003,CAJUATA,estado nutricional en menores de 5 anos,clasificacion e,2001-03-01,0,13,0,13,13
20303,CALACOTO,estado nutricional en menores de 5 anos,clasificacion e,2001-03-01,1,0,1,0,1
21304,CALAMARCA,estado nutricional en menores de 5 anos,clasificacion e,2001-03-01,2,7,2,7,9
10701,CAMARGO,estado nutricional en menores de 5 anos,clasificacion e,2001-03-01,0,48,0,48,48
10901,CAMATAQUI (C. VILLA ABECIA),estado nutricional en menores de 5 anos,clasificacion e,2001-03-01,0,19,0,19,19
70706,CAMIRI,estado nutricional en menores de 5 anos,clasificacion e,2001-03-01,2,58,2,58,60
30701,CAPINOTA,estado nutricional en menores de 5 anos,clasificacion e,2001-03-01,5,26,5,26,31
20302,CAQUIAVIRI,estado nutricional en menores de 5 anos,clasificacion e,2001-03-01,0,10,0,10,10
40102,CARACOLLO,estado nutricional en menores de 5 anos,clasificacion e,2001-03-01,1,12,1,12,13
22001,CARANAVI,estado nutricional en menores de 5 anos,clasificacion e,2001-03-01,3,48,3,48,51
60302,CARAPARI,estado nutricional en menores de 5 anos,clasificacion e,2001-03-01,0,9,0,9,9
50702,CARIPUYO,estado nutricional en menores de 5 anos,clasificacion e,2001-03-01,0,44,0,44,44
21803,CHACARILLA,estado nutricional en menores de 5 anos,clasificacion e,2001-03-01,0,2,0,2,2
40201,CHALLAPATA,estado nutricional en menores de 5 anos,clasificacion e,2001-03-01,0,16,0,16,16
50302,CHAQUI,estado nutricional en menores de 5 anos,clasificacion e,2001-03-01,0,31,0,31,31
70702,CHARAGUA,estado nutricional en menores de 5 anos,clasificacion e,2001-03-01,1,79,1,79,80
20305,CHARAÃ‘A,estado nutricional en menores de 5 anos,clasificacion e,2001-03-01,0,3,0,3,3
50202,CHAYANTA,estado nutricional en menores de 5 anos,clasificacion e,2001-03-01,0,53,0,53,53
31204,CHIMORE,estado nutricional en menores de 5 anos,clasificacion e,2001-03-01,0,9,0,9,9
40903,CHIPAYA,estado nutricional en menores de 5 anos,clasificacion e,2001-03-01,0,3,0,3,3
21101,CHULUMANI (V. DE LA LIBERTAD),estado nutricional en menores de 5 anos,clasificacion e,2001-03-01,0,6,0,6,6
20501,CHUMA,estado nutricional en menores de 5 anos,clasificacion e,2001-03-01,0,6,0,6,6
30801,CLIZA,estado nutricional en menores de 5 anos,clasificacion e,2001-03-01,1,11,1,11,12
90101,COBIJA,estado nutricional en menores de 5 anos,clasificacion e,2001-03-01,3,19,3,19,22
30101,COCHABAMBA,estado nutricional en menores de 5 anos,clasificacion e,2001-03-01,12,99,12,99,111
40902,COIPASA,estado nutricional en menores de 5 anos,clasificacion e,2001-03-01,0,1,0,1,1
30905,COLCAPIRHUA,estado nutricional en menores de 5 anos,clasificacion e,2001-03-01,0,3,0,3,3
50901,"COLCHA ""K""",estado nutricional en menores de 5 anos,clasificacion e,2001-03-01,0,19,0,19,19
31002,COLOMI,estado nutricional en menores de 5 anos,clasificacion e,2001-03-01,0,5,0,5,5
50401,COLQUECHACA,estado nutricional en menores de 5 anos,clasificacion e,2001-03-01,1,44,1,44,45
21306,COLQUENCHA,estado nutricional en menores de 5 anos,clasificacion e,2001-03-01,0,2,0,2,2
21004,COLQUIRI,estado nutricional en menores de 5 anos,clasificacion e,2001-03-01,2,78,2,78,80
20304,COMANCHE,estado nutricional en menores de 5 anos,clasificacion e,2001-03-01,0,11,0,11,11
71301,COMARAPA,estado nutricional en menores de 5 anos,clasificacion e,2001-03-01,0,2,0,2,2
20605,COMBAYA,estado nutricional en menores de 5 anos,clasificacion e,2001-03-01,0,4,0,4,4
71101,CONCEPCION,estado nutricional en menores de 5 anos,clasificacion e,2001-03-01,0,16,0,16,16
21701,COPACABANA,estado nutricional en menores de 5 anos,clasificacion e,2001-03-01,0,19,0,19,19
21402,CORIPATA,estado nutricional en menores de 5 anos,clasificacion e,2001-03-01,0,7,0,7,7
20301,CORO CORO,estado nutricional en menores de 5 anos,clasificacion e,2001-03-01,0,8,0,8,8
21401,COROICO,estado nutricional en menores de 5 anos,clasificacion e,2001-03-01,1,8,1,8,9
40301,CORQUE,estado nutricional en menores de 5 anos,clasificacion e,2001-03-01,2,6,2,6,8
50601,COTAGAITA,estado nutricional en menores de 5 anos,clasificacion e,2001-03-01,0,50,0,50,50
70102,COTOCA,estado nutricional en menores de 5 anos,clasificacion e,2001-03-01,0,11,0,11,11
31405,CUCHUMUELA (V. G. VILLARROEL),estado nutricional en menores de 5 anos,clasificacion e,2001-03-01,1,12,1,12,13
70704,CUEVO,estado nutricional en menores de 5 anos,clasificacion e,2001-03-01,0,14,0,14,14
10902,CULPINA,estado nutricional en menores de 5 anos,clasificacion e,2001-03-01,1,94,1,94,95
40401,CURAHUARA DE CARANGAS,estado nutricional en menores de 5 anos,clasificacion e,2001-03-01,0,3,0,3,3
21602,CURVA,estado nutricional en menores de 5 anos,clasificacion e,2001-03-01,0,5,0,5,5
20804,DESAGUADERO,estado nutricional en menores de 5 anos,clasificacion e,2001-03-01,0,7,0,7,7
20105,EL ALTO,estado nutricional en menores de 5 anos,clasificacion e,2001-03-01,69,504,69,504,573
71503,EL PUENTE(STC),estado nutricional en menores de 5 anos,clasificacion e,2001-03-01,0,19,0,19,19
60502,EL PUENTE(TJA),estado nutricional en menores de 5 anos,clasificacion e,2001-03-01,0,3,0,3,3
70105,EL TORNO,estado nutricional en menores de 5 anos,clasificacion e,2001-03-01,1,25,1,25,26
10405,EL VILLAR,estado nutricional en menores de 5 anos,clasificacion e,2001-03-01,3,56,3,56,59
60601,ENTRE RIOS,estado nutricional en menores de 5 anos,clasificacion e,2001-03-01,1,38,1,38,39
40502,ESCARA,estado nutricional en menores de 5 anos,clasificacion e,2001-03-01,0,1,0,1,1
41101,EUCALIPTUS,estado nutricional en menores de 5 anos,clasificacion e,2001-03-01,0,12,0,12,12
90203,FILADELFIA,estado nutricional en menores de 5 anos,clasificacion e,2001-03-01,0,1,0,1,1
71002,GENERAL SAAVEDRA,estado nutricional en menores de 5 anos,clasificacion e,2001-03-01,3,27,3,27,30
21601,GRAL. J.J. PEREZ (CHARAZANI),estado nutricional en menores de 5 anos,clasificacion e,2001-03-01,0,5,0,5,5
20602,GUANAY,estado nutricional en menores de 5 anos,clasificacion e,2001-03-01,2,7,2,7,9
20802,GUAQUI,estado nutricional en menores de 5 anos,clasificacion e,2001-03-01,0,7,0,7,7
80202,GUAYARAMERIN,estado nutricional en menores de 5 anos,clasificacion e,2001-03-01,3,28,3,28,31
70705,GUTIERREZ,estado nutricional en menores de 5 anos,clasificacion e,2001-03-01,7,70,7,70,77
10502,HUACARETA,estado nutricional en menores de 5 anos,clasificacion e,2001-03-01,4,80,4,80,84
11002,HUACAYA (VILLA DE HUACAYA),estado nutricional en menores de 5 anos,clasificacion e,2001-03-01,0,27,0,27,27
40501,HUACHACALLA,estado nutricional en menores de 5 anos,clasificacion e,2001-03-01,0,1,0,1,1
40701,HUANUNI,estado nutricional en menores de 5 anos,clasificacion e,2001-03-01,0,37,0,37,37
80803,HUARACAJE,estado nutricional en menores de 5 anos,clasificacion e,2001-03-01,0,4,0,4,4
41601,HUAYLLAMARCA,estado nutricional en menores de 5 anos,clasificacion e,2001-03-01,0,5,0,5,5
21005,ICHOCA,estado nutricional en menores de 5 anos,clasificacion e,2001-03-01,0,13,0,13,13
10304,ICLA,estado nutricional en menores de 5 anos,clasificacion e,2001-03-01,2,109,2,109,111
10703,INCAHUASI,estado nutricional en menores de 5 anos,clasificacion e,2001-03-01,0,92,0,92,92
21001,INQUISIVI,estado nutricional en menores de 5 anos,clasificacion e,2001-03-01,0,33,0,33,33
21102,IRUPANA (VILLA DE LANZA),estado nutricional en menores de 5 anos,clasificacion e,2001-03-01,0,8,0,8,8
21501,IXIAMAS,estado nutricional en menores de 5 anos,clasificacion e,2001-03-01,0,9,0,9,9
21105,LA ASUNTA,estado nutricional en menores de 5 anos,clasificacion e,2001-03-01,4,17,4,17,21
70104,LA GUARDIA,estado nutricional en menores de 5 anos,clasificacion e,2001-03-01,3,40,3,40,43
20101,LA PAZ,estado nutricional en menores de 5 anos,clasificacion e,2001-03-01,24,285,24,285,309
70701,LAGUNILLAS,estado nutricional en menores de 5 anos,clasificacion e,2001-03-01,4,22,4,22,26
21202,LAJA,estado nutricional en menores de 5 anos,clasificacion e,2001-03-01,0,13,0,13,13
10903,LAS CARRERAS,estado nutricional en menores de 5 anos,clasificacion e,2001-03-01,0,26,0,26,26
21006,LICOMA PAMPA,estado nutricional en menores de 5 anos,clasificacion e,2001-03-01,0,1,0,1,1
50203,LLALLAGUA,estado nutricional en menores de 5 anos,clasificacion e,2001-03-01,2,46,2,46,48
51401,LLICA,estado nutricional en menores de 5 anos,clasificacion e,2001-03-01,0,4,0,4,4
40702,MACHACAMARCA,estado nutricional en menores de 5 anos,clasificacion e,2001-03-01,0,2,0,2,2
11003,MACHARETI,estado nutricional en menores de 5 anos,clasificacion e,2001-03-01,1,64,1,64,65
80801,MAGDALENA,estado nutricional en menores de 5 anos,clasificacion e,2001-03-01,0,8,0,8,8
70903,MAIRANA,estado nutricional en menores de 5 anos,clasificacion e,2001-03-01,0,10,0,10,10
71003,MINEROS,estado nutricional en menores de 5 anos,clasificacion e,2001-03-01,2,73,2,73,75
31301,MIZQUE,estado nutricional en menores de 5 anos,clasificacion e,2001-03-01,29,18,29,18,47
20402,MOCOMOCO,estado nutricional en menores de 5 anos,clasificacion e,2001-03-01,0,15,0,15,15
51002,MOJINETE,estado nutricional en menores de 5 anos,clasificacion e,2001-03-01,0,5,0,5,5
10303,MOJOCOYA,estado nutricional en menores de 5 anos,clasificacion e,2001-03-01,0,36,0,36,36
10501,MONTEAGUDO,estado nutricional en menores de 5 anos,clasificacion e,2001-03-01,2,129,2,129,131
71001,MONTERO,estado nutricional en menores de 5 anos,clasificacion e,2001-03-01,17,153,17,153,170
70803,MORO MORO,estado nutricional en menores de 5 anos,clasificacion e,2001-03-01,0,1,0,1,1
30302,MOROCHATA,estado nutricional en menores de 5 anos,clasificacion e,2001-03-01,7,26,7,26,33
50404,OCURI,estado nutricional en menores de 5 anos,clasificacion e,2001-03-01,2,25,2,25,27
70202,OKINAWA,estado nutricional en menores de 5 anos,clasificacion e,2001-03-01,0,5,0,5,5
30203,OMEREQUE,estado nutricional en menores de 5 anos,clasificacion e,2001-03-01,1,13,1,13,14
40101,ORURO,estado nutricional en menores de 5 anos,clasificacion e,2001-03-01,15,180,15,180,195
60201,PADCAYA,estado nutricional en menores de 5 anos,clasificacion e,2001-03-01,0,16,0,16,16
10401,PADILLA,estado nutricional en menores de 5 anos,clasificacion e,2001-03-01,0,136,0,136,136
70502,PAILON,estado nutricional en menores de 5 anos,clasificacion e,2001-03-01,1,7,1,7,8
21104,PALOS BLANCOS,estado nutricional en menores de 5 anos,clasificacion e,2001-03-01,3,36,3,36,39
40802,PAMPA AULLAGAS,estado nutricional en menores de 5 anos,clasificacion e,2001-03-01,0,7,0,7,7
70902,PAMPA GRANDE,estado nutricional en menores de 5 anos,clasificacion e,2001-03-01,0,7,0,7,7
21305,PATACAMAYA,estado nutricional en menores de 5 anos,clasificacion e,2001-03-01,0,5,0,5,5
40602,PAZÃ‘A,estado nutricional en menores de 5 anos,clasificacion e,2001-03-01,0,6,0,6,6
20702,PELECHUCO,estado nutricional en menores de 5 anos,clasificacion e,2001-03-01,2,14,2,14,16
50403,POCOATA,estado nutricional en menores de 5 anos,clasificacion e,2001-03-01,9,53,9,53,62
31203,POCONA,estado nutricional en menores de 5 anos,clasificacion e,2001-03-01,1,35,1,35,36
31202,POJO (CBBA),estado nutricional en menores de 5 anos,clasificacion e,2001-03-01,4,43,4,43,47
40601,POOPO,estado nutricional en menores de 5 anos,clasificacion e,2001-03-01,0,6,0,6,6
51203,PORCO,estado nutricional en menores de 5 anos,clasificacion e,2001-03-01,0,14,0,14,14
10103,POROMA,estado nutricional en menores de 5 anos,clasificacion e,2001-03-01,4,113,4,113,117
70103,PORONGO,estado nutricional en menores de 5 anos,clasificacion e,2001-03-01,0,17,0,17,17
70601,PORTACHUELO,estado nutricional en menores de 5 anos,clasificacion e,2001-03-01,2,4,2,4,6
90102,PORVENIR,estado nutricional en menores de 5 anos,clasificacion e,2001-03-01,0,5,0,5,5
70804,POSTRER VALLE,estado nutricional en menores de 5 anos,clasificacion e,2001-03-01,0,1,0,1,1
50101,POTOSI,estado nutricional en menores de 5 anos,clasificacion e,2001-03-01,2,96,2,96,98
10302,PRESTO,estado nutricional en menores de 5 anos,clasificacion e,2001-03-01,0,44,0,44,44
70805,PUCARA,estado nutricional en menores de 5 anos,clasificacion e,2001-03-01,0,3,0,3,3
21201,PUCARANI,estado nutricional en menores de 5 anos,clasificacion e,2001-03-01,0,11,0,11,11
20401,PUERTO ACOSTA,estado nutricional en menores de 5 anos,clasificacion e,2001-03-01,3,19,3,19,22
20403,PUERTO CARABUCO,estado nutricional en menores de 5 anos,clasificacion e,2001-03-01,5,21,5,21,26
90301,PUERTO GONZALO MORENO,estado nutricional en menores de 5 anos,clasificacion e,2001-03-01,0,5,0,5,5
21204,PUERTO PEREZ,estado nutricional en menores de 5 anos,clasificacion e,2001-03-01,0,3,0,3,3
71402,PUERTO QUIJARRO,estado nutricional en menores de 5 anos,clasificacion e,2001-03-01,0,7,0,7,7
90201,PUERTO RICO,estado nutricional en menores de 5 anos,clasificacion e,2001-03-01,0,1,0,1,1
71401,PUERTO SUAREZ,estado nutricional en menores de 5 anos,clasificacion e,2001-03-01,4,25,4,25,29
31205,PUERTO VILLARROEL,estado nutricional en menores de 5 anos,clasificacion e,2001-03-01,3,23,3,23,26
51101,PUNA,estado nutricional en menores de 5 anos,clasificacion e,2001-03-01,5,81,5,81,86
31401,PUNATA,estado nutricional en menores de 5 anos,clasificacion e,2001-03-01,3,8,3,8,11
20604,QUIABAYA,estado nutricional en menores de 5 anos,clasificacion e,2001-03-01,0,23,0,23,23
30901,QUILLACOLLO,estado nutricional en menores de 5 anos,clasificacion e,2001-03-01,2,15,2,15,17
21002,QUIME,estado nutricional en menores de 5 anos,clasificacion e,2001-03-01,0,27,0,27,27
70904,QUIRUSILLAS,estado nutricional en menores de 5 anos,clasificacion e,2001-03-01,0,3,0,3,3
50402,RAVELO,estado nutricional en menores de 5 anos,clasificacion e,2001-03-01,0,74,0,74,74
80301,REYES,estado nutricional en menores de 5 anos,clasificacion e,2001-03-01,0,7,0,7,7
80201,RIBERALTA,estado nutricional en menores de 5 anos,clasificacion e,2001-03-01,1,114,1,114,115
70503,ROBORE,estado nutricional en menores de 5 anos,clasificacion e,2001-03-01,0,24,0,24,24
40901,SABAYA,estado nutricional en menores de 5 anos,clasificacion e,2001-03-01,0,1,0,1,1
31001,SACABA,estado nutricional en menores de 5 anos,clasificacion e,2001-03-01,29,24,29,24,53
30404,SACABAMBA,estado nutricional en menores de 5 anos,clasificacion e,2001-03-01,0,24,0,24,24
50701,SACACA,estado nutricional en menores de 5 anos,clasificacion e,2001-03-01,1,81,1,81,82
71302,SAIPINA,estado nutricional en menores de 5 anos,clasificacion e,2001-03-01,0,1,0,1,1
40801,SALINAS DE GARCI MENDOZA,estado nutricional en menores de 5 anos,clasificacion e,2001-03-01,0,2,0,2,2
70901,SAMAIPATA,estado nutricional en menores de 5 anos,clasificacion e,2001-03-01,0,8,0,8,8
51601,SAN AGUSTIN,estado nutricional en menores de 5 anos,clasificacion e,2001-03-01,0,2,0,2,2
80602,SAN ANDRES,estado nutricional en menores de 5 anos,clasificacion e,2001-03-01,0,8,0,8,8
51003,SAN ANTONIO DE ESMORUCO,estado nutricional en menores de 5 anos,clasificacion e,2001-03-01,0,4,0,4,4
71105,SAN ANTONIO DE LOMERIO,estado nutricional en menores de 5 anos,clasificacion e,2001-03-01,15,101,15,101,116
31403,SAN BENITO,estado nutricional en menores de 5 anos,clasificacion e,2001-03-01,0,17,0,17,17
80302,SAN BORJA,estado nutricional en menores de 5 anos,clasificacion e,2001-03-01,0,33,0,33,33
21502,SAN BUENA VENTURA,estado nutricional en menores de 5 anos,clasificacion e,2001-03-01,1,27,1,27,28
70402,SAN CARLOS,estado nutricional en menores de 5 anos,clasificacion e,2001-03-01,0,20,0,20,20
80501,SAN IGNACIO,estado nutricional en menores de 5 anos,clasificacion e,2001-03-01,2,37,2,37,39
70301,SAN IGNACIO DE VELASCO,estado nutricional en menores de 5 anos,clasificacion e,2001-03-01,2,37,2,37,39
80102,SAN JAVIER(BNI),estado nutricional en menores de 5 anos,clasificacion e,2001-03-01,1,2,1,2,3
71102,SAN JAVIER(STC),estado nutricional en menores de 5 anos,clasificacion e,2001-03-01,2,30,2,30,32
80701,SAN JOAQUIN,estado nutricional en menores de 5 anos,clasificacion e,2001-03-01,0,3,0,3,3
70501,SAN JOSE DE CHIQUITOS,estado nutricional en menores de 5 anos,clasificacion e,2001-03-01,1,23,1,23,24
71104,SAN JULIAN,estado nutricional en menores de 5 anos,clasificacion e,2001-03-01,2,69,2,69,71
90302,SAN LORENZO(PND),estado nutricional en menores de 5 anos,clasificacion e,2001-03-01,0,9,0,9,9
60501,SAN LORENZO(TJA),estado nutricional en menores de 5 anos,clasificacion e,2001-03-01,2,21,2,21,23
10702,SAN LUCAS,estado nutricional en menores de 5 anos,clasificacion e,2001-03-01,1,198,1,198,199
71201,SAN MATIAS,estado nutricional en menores de 5 anos,clasificacion e,2001-03-01,1,21,1,21,22
70302,SAN MIGUEL DE VELASCO,estado nutricional en menores de 5 anos,clasificacion e,2001-03-01,0,14,0,14,14
51001,SAN PABLO DE LIPEZ,estado nutricional en menores de 5 anos,clasificacion e,2001-03-01,0,13,0,13,13
50501,SAN PEDRO DE BUENA VISTA,estado nutricional en menores de 5 anos,clasificacion e,2001-03-01,0,108,0,108,108
21801,SAN PEDRO DE CURAHUARA,estado nutricional en menores de 5 anos,clasificacion e,2001-03-01,0,3,0,3,3
50902,SAN PEDRO DE QUEMES,estado nutricional en menores de 5 anos,clasificacion e,2001-03-01,0,3,0,3,3
21702,SAN PEDRO DE TIQUINA,estado nutricional en menores de 5 anos,clasificacion e,2001-03-01,0,2,0,2,2
70303,SAN RAFAEL,estado nutricional en menores de 5 anos,clasificacion e,2001-03-01,0,13,0,13,13
80702,SAN RAMON,estado nutricional en menores de 5 anos,clasificacion e,2001-03-01,0,20,0,20,20
70101,SANTA CRUZ DE LA SIERRA,estado nutricional en menores de 5 anos,clasificacion e,2001-03-01,28,69,28,69,97
80303,SANTA ROSA,estado nutricional en menores de 5 anos,clasificacion e,2001-03-01,0,8,0,8,8
70602,SANTA ROSA DEL SARA,estado nutricional en menores de 5 anos,clasificacion e,2001-03-01,0,1,0,1,1
41401,SANTIAGO DE HUARI,estado nutricional en menores de 5 anos,clasificacion e,2001-03-01,0,11,0,11,11
30702,SANTIVAÃ‘ES,estado nutricional en menores de 5 anos,clasificacion e,2001-03-01,3,11,3,11,14
40202,SANTUARIO DE QUILLACAS,estado nutricional en menores de 5 anos,clasificacion e,2001-03-01,0,3,0,3,3
20902,SAPAHAQUI,estado nutricional en menores de 5 anos,clasificacion e,2001-03-01,1,6,1,6,7
21301,SICA SICA (VILLA AROMA),estado nutricional en menores de 5 anos,clasificacion e,2001-03-01,0,5,0,5,5
30703,SICAYA,estado nutricional en menores de 5 anos,clasificacion e,2001-03-01,0,2,0,2,2
30902,SIPE SIPE,estado nutricional en menores de 5 anos,clasificacion e,2001-03-01,35,67,35,67,102
10403,SOPACHUY,estado nutricional en menores de 5 anos,clasificacion e,2001-03-01,0,69,0,69,69
20601,SORATA,estado nutricional en menores de 5 anos,clasificacion e,2001-03-01,1,8,1,8,9
10101,SUCRE,estado nutricional en menores de 5 anos,clasificacion e,2001-03-01,8,333,8,333,341
31404,TACACHI,estado nutricional en menores de 5 anos,clasificacion e,2001-03-01,0,6,0,6,6
20603,TACACOMA,estado nutricional en menores de 5 anos,clasificacion e,2001-03-01,0,22,0,22,22
50303,TACOBAMBA,estado nutricional en menores de 5 anos,clasificacion e,2001-03-01,4,18,4,18,22
30602,TACOPAYA,estado nutricional en menores de 5 anos,clasificacion e,2001-03-01,0,60,0,60,60
51402,TAHUA,estado nutricional en menores de 5 anos,clasificacion e,2001-03-01,0,2,0,2,2
31101,TAPACARI,estado nutricional en menores de 5 anos,clasificacion e,2001-03-01,9,41,9,41,50
10601,TARABUCO,estado nutricional en menores de 5 anos,clasificacion e,2001-03-01,3,225,3,225,228
30401,TARATA,estado nutricional en menores de 5 anos,clasificacion e,2001-03-01,1,18,1,18,19
60101,TARIJA,estado nutricional en menores de 5 anos,clasificacion e,2001-03-01,3,48,3,48,51
10202,TARVITA,estado nutricional en menores de 5 anos,clasificacion e,2001-03-01,2,50,2,50,52
20803,TIAWANACU,estado nutricional en menores de 5 anos,clasificacion e,2001-03-01,0,7,0,7,7
50102,TINGUIPAYA,estado nutricional en menores de 5 anos,clasificacion e,2001-03-01,5,44,5,44,49
20606,TIPUANI,estado nutricional en menores de 5 anos,clasificacion e,2001-03-01,2,4,2,4,6
30903,TIQUIPAYA,estado nutricional en menores de 5 anos,clasificacion e,2001-03-01,2,53,2,53,55
31601,TIRAQUE (CBBA),estado nutricional en menores de 5 anos,clasificacion e,2001-03-01,2,10,2,10,12
30802,TOCO,estado nutricional en menores de 5 anos,clasificacion e,2001-03-01,1,1,1,1,2
41001,TOLEDO,estado nutricional en menores de 5 anos,clasificacion e,2001-03-01,0,10,0,10,10
51202,TOMAVE,estado nutricional en menores de 5 anos,clasificacion e,2001-03-01,2,23,2,23,25
10402,TOMINA,estado nutricional en menores de 5 anos,clasificacion e,2001-03-01,0,75,0,75,75
50502,TORO TORO,estado nutricional en menores de 5 anos,clasificacion e,2001-03-01,0,2,0,2,2
31201,TOTORA(CBBA),estado nutricional en menores de 5 anos,clasificacion e,2001-03-01,3,29,3,29,32
41301,TOTORA(ORR),estado nutricional en menores de 5 anos,clasificacion e,2001-03-01,0,5,0,5,5
70802,TRIGAL,estado nutricional en menores de 5 anos,clasificacion e,2001-03-01,0,2,0,2,2
80101,TRINIDAD,estado nutricional en menores de 5 anos,clasificacion e,2001-03-01,4,39,4,39,43
50801,TUPIZA,estado nutricional en menores de 5 anos,clasificacion e,2001-03-01,4,104,4,104,108
21302,UMALA,estado nutricional en menores de 5 anos,clasificacion e,2001-03-01,0,3,0,3,3
50201,UNCIA,estado nutricional en menores de 5 anos,clasificacion e,2001-03-01,1,26,1,26,27
60401,URIONDO (A. CONCEPCION),estado nutricional en menores de 5 anos,clasificacion e,2001-03-01,0,3,0,3,3
71502,URUBICHA,estado nutricional en menores de 5 anos,clasificacion e,2001-03-01,0,21,0,21,21
51201,UYUNI,estado nutricional en menores de 5 anos,clasificacion e,2001-03-01,1,18,1,18,19
30502,VACAS,estado nutricional en menores de 5 anos,clasificacion e,2001-03-01,2,10,2,10,12
70801,VALLEGRANDE,estado nutricional en menores de 5 anos,clasificacion e,2001-03-01,0,27,0,27,27
20801,VIACHA,estado nutricional en menores de 5 anos,clasificacion e,2001-03-01,1,32,1,32,33
31302,VILA VILA,estado nutricional en menores de 5 anos,clasificacion e,2001-03-01,9,6,9,6,15
60303,VILLA MONTES,estado nutricional en menores de 5 anos,clasificacion e,2001-03-01,0,26,0,26,26
31402,VILLA RIVERO,estado nutricional en menores de 5 anos,clasificacion e,2001-03-01,0,7,0,7,7
10801,VILLA SERRANO,estado nutricional en menores de 5 anos,clasificacion e,2001-03-01,1,72,1,72,73
31003,VILLA TUNARI,estado nutricional en menores de 5 anos,clasificacion e,2001-03-01,3,38,3,38,41
11001,VILLA VACA GUZMAN (MUYUPAMPA),estado nutricional en menores de 5 anos,clasificacion e,2001-03-01,1,33,1,33,34
51501,VILLAZON,estado nutricional en menores de 5 anos,clasificacion e,2001-03-01,0,47,0,47,47
50602,VITICHI,estado nutricional en menores de 5 anos,clasificacion e,2001-03-01,0,16,0,16,16
20306,WALDO BALLIVIAN,estado nutricional en menores de 5 anos,clasificacion e,2001-03-01,0,1,0,1,1
70201,WARNES,estado nutricional en menores de 5 anos,clasificacion e,2001-03-01,1,42,1,42,43
20903,YACO,estado nutricional en menores de 5 anos,clasificacion e,2001-03-01,0,7,0,7,7
60301,YACUIBA,estado nutricional en menores de 5 anos,clasificacion e,2001-03-01,6,44,6,44,50
10602,YAMPARAEZ,estado nutricional en menores de 5 anos,clasificacion e,2001-03-01,1,90,1,90,91
70403,YAPACANI,estado nutricional en menores de 5 anos,clasificacion e,2001-03-01,16,32,16,32,48
50103,YOCALLA,estado nutricional en menores de 5 anos,clasificacion e,2001-03-01,0,9,0,9,9
10102,YOTALA,estado nutricional en menores de 5 anos,clasificacion e,2001-03-01,0,72,0,72,72
60402,YUNCHARA,estado nutricional en menores de 5 anos,clasificacion e,2001-03-01,2,2,2,2,4
10301,ZUDAÃ‘EZ,estado nutricional en menores de 5 anos,clasificacion e,2001-03-01,0,60,0,60,60
51302,ACACIO,estado nutricional en menores de 5 anos,clasificacion e,2001-04-01,0,69,0,69,69
20201,ACHACACHI,estado nutricional en menores de 5 anos,clasificacion e,2001-04-01,0,19,0,19,19
20104,ACHOCALLA,estado nutricional en menores de 5 anos,clasificacion e,2001-04-01,0,15,0,15,15
30201,AIQUILE,estado nutricional en menores de 5 anos,clasificacion e,2001-04-01,3,26,3,26,29
31303,ALALAY,estado nutricional en menores de 5 anos,clasificacion e,2001-04-01,7,3,7,3,10
10404,ALCALA,estado nutricional en menores de 5 anos,clasificacion e,2001-04-01,0,26,0,26,26
20202,ANCORAIMES,estado nutricional en menores de 5 anos,clasificacion e,2001-04-01,0,31,0,31,31
41201,ANDAMARCA,estado nutricional en menores de 5 anos,clasificacion e,2001-04-01,0,3,0,3,3
40603,ANTEQUERA,estado nutricional en menores de 5 anos,clasificacion e,2001-04-01,0,3,0,3,3
30402,ANZALDO,estado nutricional en menores de 5 anos,clasificacion e,2001-04-01,1,37,1,37,38
20701,APOLO,estado nutricional en menores de 5 anos,clasificacion e,2001-04-01,1,1,1,1,2
51301,ARAMPAMPA,estado nutricional en menores de 5 anos,clasificacion e,2001-04-01,0,33,0,33,33
30501,ARANI,estado nutricional en menores de 5 anos,clasificacion e,2001-04-01,0,6,0,6,6
30403,ARBIETO,estado nutricional en menores de 5 anos,clasificacion e,2001-04-01,3,14,3,14,17
30601,ARQUE,estado nutricional en menores de 5 anos,clasificacion e,2001-04-01,0,44,0,44,44
71501,ASCENCION DE GUARAYOS,estado nutricional en menores de 5 anos,clasificacion e,2001-04-01,0,148,0,148,148
50802,ATOCHA,estado nutricional en menores de 5 anos,clasificacion e,2001-04-01,0,16,0,16,16
20503,AUCAPATA,estado nutricional en menores de 5 anos,clasificacion e,2001-04-01,0,9,0,9,9
20502,AYATA,estado nutricional en menores de 5 anos,clasificacion e,2001-04-01,0,1,0,1,1
21303,AYO AYO,estado nutricional en menores de 5 anos,clasificacion e,2001-04-01,0,2,0,2,2
30301,AYOPAYA (V. DE INDEPENDENCIA),estado nutricional en menores de 5 anos,clasificacion e,2001-04-01,0,40,0,40,40
10201,AZURDUY,estado nutricional en menores de 5 anos,clasificacion e,2001-04-01,0,62,0,62,62
21203,BATALLAS,estado nutricional en menores de 5 anos,clasificacion e,2001-04-01,2,19,2,19,21
80802,BAURES,estado nutricional en menores de 5 anos,clasificacion e,2001-04-01,0,12,0,12,12
50104,BELEN DE URMIRI,estado nutricional en menores de 5 anos,clasificacion e,2001-04-01,2,6,2,6,8
90104,BELLA FLOR,estado nutricional en menores de 5 anos,clasificacion e,2001-04-01,0,6,0,6,6
60202,BERMEJO,estado nutricional en menores de 5 anos,clasificacion e,2001-04-01,0,2,0,2,2
50301,BETANZOS,estado nutricional en menores de 5 anos,clasificacion e,2001-04-01,0,103,0,103,103
90103,BOLPEBRA,estado nutricional en menores de 5 anos,clasificacion e,2001-04-01,0,3,0,3,3
70707,BOYUIBE,estado nutricional en menores de 5 anos,clasificacion e,2001-04-01,0,10,0,10,10
70401,BUENA VISTA,estado nutricional en menores de 5 anos,clasificacion e,2001-04-01,2,25,2,25,27
70703,CABEZAS,estado nutricional en menores de 5 anos,clasificacion e,2001-04-01,0,6,0,6,6
20905,CAIROMA,estado nutricional en menores de 5 anos,clasificacion e,2001-04-01,0,6,0,6,6
51102,"CAIZA ""D""",estado nutricional en menores de 5 anos,clasificacion e,2001-04-01,3,36,3,36,39
21003,CAJUATA,estado nutricional en menores de 5 anos,clasificacion e,2001-04-01,0,9,0,9,9
20303,CALACOTO,estado nutricional en menores de 5 anos,clasificacion e,2001-04-01,0,5,0,5,5
21304,CALAMARCA,estado nutricional en menores de 5 anos,clasificacion e,2001-04-01,1,15,1,15,16
10701,CAMARGO,estado nutricional en menores de 5 anos,clasificacion e,2001-04-01,2,21,2,21,23
10901,CAMATAQUI (C. VILLA ABECIA),estado nutricional en menores de 5 anos,clasificacion e,2001-04-01,0,14,0,14,14
70706,CAMIRI,estado nutricional en menores de 5 anos,clasificacion e,2001-04-01,2,26,2,26,28
20302,CAQUIAVIRI,estado nutricional en menores de 5 anos,clasificacion e,2001-04-01,0,13,0,13,13
40102,CARACOLLO,estado nutricional en menores de 5 anos,clasificacion e,2001-04-01,1,22,1,22,23
22001,CARANAVI,estado nutricional en menores de 5 anos,clasificacion e,2001-04-01,2,80,2,80,82
60302,CARAPARI,estado nutricional en menores de 5 anos,clasificacion e,2001-04-01,0,12,0,12,12
50702,CARIPUYO,estado nutricional en menores de 5 anos,clasificacion e,2001-04-01,2,36,2,36,38
21902,CATACORA,estado nutricional en menores de 5 anos,clasificacion e,2001-04-01,0,1,0,1,1
21803,CHACARILLA,estado nutricional en menores de 5 anos,clasificacion e,2001-04-01,0,2,0,2,2
40201,CHALLAPATA,estado nutricional en menores de 5 anos,clasificacion e,2001-04-01,2,28,2,28,30
50302,CHAQUI,estado nutricional en menores de 5 anos,clasificacion e,2001-04-01,0,42,0,42,42
70702,CHARAGUA,estado nutricional en menores de 5 anos,clasificacion e,2001-04-01,3,54,3,54,57
20305,CHARAÃ‘A,estado nutricional en menores de 5 anos,clasificacion e,2001-04-01,0,8,0,8,8
50202,CHAYANTA,estado nutricional en menores de 5 anos,clasificacion e,2001-04-01,0,9,0,9,9
31204,CHIMORE,estado nutricional en menores de 5 anos,clasificacion e,2001-04-01,2,23,2,23,25
21101,CHULUMANI (V. DE LA LIBERTAD),estado nutricional en menores de 5 anos,clasificacion e,2001-04-01,0,20,0,20,20
20501,CHUMA,estado nutricional en menores de 5 anos,clasificacion e,2001-04-01,0,2,0,2,2
30801,CLIZA,estado nutricional en menores de 5 anos,clasificacion e,2001-04-01,1,5,1,5,6
90101,COBIJA,estado nutricional en menores de 5 anos,clasificacion e,2001-04-01,2,24,2,24,26
30101,COCHABAMBA,estado nutricional en menores de 5 anos,clasificacion e,2001-04-01,16,129,16,129,145
30905,COLCAPIRHUA,estado nutricional en menores de 5 anos,clasificacion e,2001-04-01,1,8,1,8,9
50901,"COLCHA ""K""",estado nutricional en menores de 5 anos,clasificacion e,2001-04-01,0,18,0,18,18
31002,COLOMI,estado nutricional en menores de 5 anos,clasificacion e,2001-04-01,1,23,1,23,24
70603,COLPA BELGICA,estado nutricional en menores de 5 anos,clasificacion e,2001-04-01,0,6,0,6,6
50401,COLQUECHACA,estado nutricional en menores de 5 anos,clasificacion e,2001-04-01,0,42,0,42,42
21306,COLQUENCHA,estado nutricional en menores de 5 anos,clasificacion e,2001-04-01,5,14,5,14,19
21004,COLQUIRI,estado nutricional en menores de 5 anos,clasificacion e,2001-04-01,2,77,2,77,79
20304,COMANCHE,estado nutricional en menores de 5 anos,clasificacion e,2001-04-01,0,11,0,11,11
71301,COMARAPA,estado nutricional en menores de 5 anos,clasificacion e,2001-04-01,0,15,0,15,15
20605,COMBAYA,estado nutricional en menores de 5 anos,clasificacion e,2001-04-01,0,1,0,1,1
71101,CONCEPCION,estado nutricional en menores de 5 anos,clasificacion e,2001-04-01,0,44,0,44,44
21701,COPACABANA,estado nutricional en menores de 5 anos,clasificacion e,2001-04-01,0,18,0,18,18
21402,CORIPATA,estado nutricional en menores de 5 anos,clasificacion e,2001-04-01,0,5,0,5,5
20301,CORO CORO,estado nutricional en menores de 5 anos,clasificacion e,2001-04-01,1,31,1,31,32
21401,COROICO,estado nutricional en menores de 5 anos,clasificacion e,2001-04-01,0,21,0,21,21
40301,CORQUE,estado nutricional en menores de 5 anos,clasificacion e,2001-04-01,0,16,0,16,16
50601,COTAGAITA,estado nutricional en menores de 5 anos,clasificacion e,2001-04-01,0,61,0,61,61
31405,CUCHUMUELA (V. G. VILLARROEL),estado nutricional en menores de 5 anos,clasificacion e,2001-04-01,0,2,0,2,2
70704,CUEVO,estado nutricional en menores de 5 anos,clasificacion e,2001-04-01,0,15,0,15,15
10902,CULPINA,estado nutricional en menores de 5 anos,clasificacion e,2001-04-01,2,84,2,84,86
40401,CURAHUARA DE CARANGAS,estado nutricional en menores de 5 anos,clasificacion e,2001-04-01,0,3,0,3,3
21602,CURVA,estado nutricional en menores de 5 anos,clasificacion e,2001-04-01,0,2,0,2,2
20804,DESAGUADERO,estado nutricional en menores de 5 anos,clasificacion e,2001-04-01,0,3,0,3,3
20105,EL ALTO,estado nutricional en menores de 5 anos,clasificacion e,2001-04-01,77,546,77,546,623
71503,EL PUENTE(STC),estado nutricional en menores de 5 anos,clasificacion e,2001-04-01,0,32,0,32,32
60502,EL PUENTE(TJA),estado nutricional en menores de 5 anos,clasificacion e,2001-04-01,1,14,1,14,15
70105,EL TORNO,estado nutricional en menores de 5 anos,clasificacion e,2001-04-01,0,6,0,6,6
10405,EL VILLAR,estado nutricional en menores de 5 anos,clasificacion e,2001-04-01,3,74,3,74,77
60601,ENTRE RIOS,estado nutricional en menores de 5 anos,clasificacion e,2001-04-01,1,12,1,12,13
41101,EUCALIPTUS,estado nutricional en menores de 5 anos,clasificacion e,2001-04-01,1,6,1,6,7
80402,EXALTACION,estado nutricional en menores de 5 anos,clasificacion e,2001-04-01,0,2,0,2,2
90203,FILADELFIA,estado nutricional en menores de 5 anos,clasificacion e,2001-04-01,1,2,1,2,3
71002,GENERAL SAAVEDRA,estado nutricional en menores de 5 anos,clasificacion e,2001-04-01,0,18,0,18,18
21601,GRAL. J.J. PEREZ (CHARAZANI),estado nutricional en menores de 5 anos,clasificacion e,2001-04-01,0,13,0,13,13
20602,GUANAY,estado nutricional en menores de 5 anos,clasificacion e,2001-04-01,2,25,2,25,27
20802,GUAQUI,estado nutricional en menores de 5 anos,clasificacion e,2001-04-01,0,3,0,3,3
80202,GUAYARAMERIN,estado nutricional en menores de 5 anos,clasificacion e,2001-04-01,5,28,5,28,33
70705,GUTIERREZ,estado nutricional en menores de 5 anos,clasificacion e,2001-04-01,4,93,4,93,97
10502,HUACARETA,estado nutricional en menores de 5 anos,clasificacion e,2001-04-01,0,64,0,64,64
11002,HUACAYA (VILLA DE HUACAYA),estado nutricional en menores de 5 anos,clasificacion e,2001-04-01,0,11,0,11,11
40701,HUANUNI,estado nutricional en menores de 5 anos,clasificacion e,2001-04-01,0,14,0,14,14
80803,HUARACAJE,estado nutricional en menores de 5 anos,clasificacion e,2001-04-01,0,8,0,8,8
41601,HUAYLLAMARCA,estado nutricional en menores de 5 anos,clasificacion e,2001-04-01,0,2,0,2,2
21005,ICHOCA,estado nutricional en menores de 5 anos,clasificacion e,2001-04-01,0,7,0,7,7
10304,ICLA,estado nutricional en menores de 5 anos,clasificacion e,2001-04-01,3,118,3,118,121
10703,INCAHUASI,estado nutricional en menores de 5 anos,clasificacion e,2001-04-01,0,76,0,76,76
21001,INQUISIVI,estado nutricional en menores de 5 anos,clasificacion e,2001-04-01,2,25,2,25,27
21102,IRUPANA (VILLA DE LANZA),estado nutricional en menores de 5 anos,clasificacion e,2001-04-01,0,15,0,15,15
21501,IXIAMAS,estado nutricional en menores de 5 anos,clasificacion e,2001-04-01,1,9,1,9,10
21105,LA ASUNTA,estado nutricional en menores de 5 anos,clasificacion e,2001-04-01,2,14,2,14,16
20101,LA PAZ,estado nutricional en menores de 5 anos,clasificacion e,2001-04-01,30,197,30,197,227
70701,LAGUNILLAS,estado nutricional en menores de 5 anos,clasificacion e,2001-04-01,4,32,4,32,36
21202,LAJA,estado nutricional en menores de 5 anos,clasificacion e,2001-04-01,0,9,0,9,9
10903,LAS CARRERAS,estado nutricional en menores de 5 anos,clasificacion e,2001-04-01,0,17,0,17,17
21006,LICOMA PAMPA,estado nutricional en menores de 5 anos,clasificacion e,2001-04-01,0,1,0,1,1
50203,LLALLAGUA,estado nutricional en menores de 5 anos,clasificacion e,2001-04-01,0,62,0,62,62
51401,LLICA,estado nutricional en menores de 5 anos,clasificacion e,2001-04-01,0,3,0,3,3
80601,LORETO,estado nutricional en menores de 5 anos,clasificacion e,2001-04-01,0,1,0,1,1
20901,LURIBAY,estado nutricional en menores de 5 anos,clasificacion e,2001-04-01,0,5,0,5,5
40702,MACHACAMARCA,estado nutricional en menores de 5 anos,clasificacion e,2001-04-01,2,2,2,2,4
11003,MACHARETI,estado nutricional en menores de 5 anos,clasificacion e,2001-04-01,2,35,2,35,37
80801,MAGDALENA,estado nutricional en menores de 5 anos,clasificacion e,2001-04-01,0,5,0,5,5
70903,MAIRANA,estado nutricional en menores de 5 anos,clasificacion e,2001-04-01,0,9,0,9,9
20904,MALLA,estado nutricional en menores de 5 anos,clasificacion e,2001-04-01,0,1,0,1,1
20103,MECAPACA,estado nutricional en menores de 5 anos,clasificacion e,2001-04-01,3,22,3,22,25
71003,MINEROS,estado nutricional en menores de 5 anos,clasificacion e,2001-04-01,4,60,4,60,64
31301,MIZQUE,estado nutricional en menores de 5 anos,clasificacion e,2001-04-01,35,9,35,9,44
20402,MOCOMOCO,estado nutricional en menores de 5 anos,clasificacion e,2001-04-01,0,35,0,35,35
51002,MOJINETE,estado nutricional en menores de 5 anos,clasificacion e,2001-04-01,0,2,0,2,2
10303,MOJOCOYA,estado nutricional en menores de 5 anos,clasificacion e,2001-04-01,1,42,1,42,43
10501,MONTEAGUDO,estado nutricional en menores de 5 anos,clasificacion e,2001-04-01,0,88,0,88,88
71001,MONTERO,estado nutricional en menores de 5 anos,clasificacion e,2001-04-01,26,127,26,127,153
30302,MOROCHATA,estado nutricional en menores de 5 anos,clasificacion e,2001-04-01,0,43,0,43,43
90401,NACEBE (SANTA ROSA DEL ABUNA),estado nutricional en menores de 5 anos,clasificacion e,2001-04-01,0,2,0,2,2
50404,OCURI,estado nutricional en menores de 5 anos,clasificacion e,2001-04-01,4,35,4,35,39
70202,OKINAWA,estado nutricional en menores de 5 anos,clasificacion e,2001-04-01,0,8,0,8,8
30203,OMEREQUE,estado nutricional en menores de 5 anos,clasificacion e,2001-04-01,0,12,0,12,12
40101,ORURO,estado nutricional en menores de 5 anos,clasificacion e,2001-04-01,6,185,6,185,191
60201,PADCAYA,estado nutricional en menores de 5 anos,clasificacion e,2001-04-01,0,15,0,15,15
10401,PADILLA,estado nutricional en menores de 5 anos,clasificacion e,2001-04-01,2,112,2,112,114
70502,PAILON,estado nutricional en menores de 5 anos,clasificacion e,2001-04-01,1,16,1,16,17
20102,PALCA,estado nutricional en menores de 5 anos,clasificacion e,2001-04-01,13,15,13,15,28
21104,PALOS BLANCOS,estado nutricional en menores de 5 anos,clasificacion e,2001-04-01,0,24,0,24,24
40802,PAMPA AULLAGAS,estado nutricional en menores de 5 anos,clasificacion e,2001-04-01,0,1,0,1,1
70902,PAMPA GRANDE,estado nutricional en menores de 5 anos,clasificacion e,2001-04-01,0,11,0,11,11
21802,PAPEL PAMPA,estado nutricional en menores de 5 anos,clasificacion e,2001-04-01,0,1,0,1,1
30202,PASORAPA,estado nutricional en menores de 5 anos,clasificacion e,2001-04-01,0,9,0,9,9
21305,PATACAMAYA,estado nutricional en menores de 5 anos,clasificacion e,2001-04-01,2,18,2,18,20
40602,PAZÃ‘A,estado nutricional en menores de 5 anos,clasificacion e,2001-04-01,1,5,1,5,6
20702,PELECHUCO,estado nutricional en menores de 5 anos,clasificacion e,2001-04-01,1,6,1,6,7
50403,POCOATA,estado nutricional en menores de 5 anos,clasificacion e,2001-04-01,8,57,8,57,65
31203,POCONA,estado nutricional en menores de 5 anos,clasificacion e,2001-04-01,0,13,0,13,13
31202,POJO (CBBA),estado nutricional en menores de 5 anos,clasificacion e,2001-04-01,1,56,1,56,57
40601,POOPO,estado nutricional en menores de 5 anos,clasificacion e,2001-04-01,0,3,0,3,3
51203,PORCO,estado nutricional en menores de 5 anos,clasificacion e,2001-04-01,0,13,0,13,13
10103,POROMA,estado nutricional en menores de 5 anos,clasificacion e,2001-04-01,1,72,1,72,73
70103,PORONGO,estado nutricional en menores de 5 anos,clasificacion e,2001-04-01,0,4,0,4,4
70601,PORTACHUELO,estado nutricional en menores de 5 anos,clasificacion e,2001-04-01,1,4,1,4,5
90102,PORVENIR,estado nutricional en menores de 5 anos,clasificacion e,2001-04-01,0,3,0,3,3
50101,POTOSI,estado nutricional en menores de 5 anos,clasificacion e,2001-04-01,5,207,5,207,212
10302,PRESTO,estado nutricional en menores de 5 anos,clasificacion e,2001-04-01,0,50,0,50,50
70805,PUCARA,estado nutricional en menores de 5 anos,clasificacion e,2001-04-01,0,7,0,7,7
21201,PUCARANI,estado nutricional en menores de 5 anos,clasificacion e,2001-04-01,0,3,0,3,3
20401,PUERTO ACOSTA,estado nutricional en menores de 5 anos,clasificacion e,2001-04-01,1,35,1,35,36
20403,PUERTO CARABUCO,estado nutricional en menores de 5 anos,clasificacion e,2001-04-01,0,38,0,38,38
90301,PUERTO GONZALO MORENO,estado nutricional en menores de 5 anos,clasificacion e,2001-04-01,0,3,0,3,3
21204,PUERTO PEREZ,estado nutricional en menores de 5 anos,clasificacion e,2001-04-01,0,2,0,2,2
71402,PUERTO QUIJARRO,estado nutricional en menores de 5 anos,clasificacion e,2001-04-01,0,4,0,4,4
90201,PUERTO RICO,estado nutricional en menores de 5 anos,clasificacion e,2001-04-01,1,2,1,2,3
80703,PUERTO SILES,estado nutricional en menores de 5 anos,clasificacion e,2001-04-01,1,1,1,1,2
71401,PUERTO SUAREZ,estado nutricional en menores de 5 anos,clasificacion e,2001-04-01,1,14,1,14,15
31205,PUERTO VILLARROEL,estado nutricional en menores de 5 anos,clasificacion e,2001-04-01,3,29,3,29,32
51101,PUNA,estado nutricional en menores de 5 anos,clasificacion e,2001-04-01,5,102,5,102,107
31401,PUNATA,estado nutricional en menores de 5 anos,clasificacion e,2001-04-01,0,12,0,12,12
20604,QUIABAYA,estado nutricional en menores de 5 anos,clasificacion e,2001-04-01,0,20,0,20,20
30901,QUILLACOLLO,estado nutricional en menores de 5 anos,clasificacion e,2001-04-01,0,11,0,11,11
21002,QUIME,estado nutricional en menores de 5 anos,clasificacion e,2001-04-01,0,27,0,27,27
50402,RAVELO,estado nutricional en menores de 5 anos,clasificacion e,2001-04-01,2,133,2,133,135
80301,REYES,estado nutricional en menores de 5 anos,clasificacion e,2001-04-01,2,7,2,7,9
80201,RIBERALTA,estado nutricional en menores de 5 anos,clasificacion e,2001-04-01,1,119,1,119,120
70503,ROBORE,estado nutricional en menores de 5 anos,clasificacion e,2001-04-01,1,18,1,18,19
80304,RURRENABAQUE,estado nutricional en menores de 5 anos,clasificacion e,2001-04-01,1,0,1,0,1
31001,SACABA,estado nutricional en menores de 5 anos,clasificacion e,2001-04-01,3,48,3,48,51
30404,SACABAMBA,estado nutricional en menores de 5 anos,clasificacion e,2001-04-01,1,23,1,23,24
50701,SACACA,estado nutricional en menores de 5 anos,clasificacion e,2001-04-01,1,133,1,133,134
71302,SAIPINA,estado nutricional en menores de 5 anos,clasificacion e,2001-04-01,0,2,0,2,2
70901,SAMAIPATA,estado nutricional en menores de 5 anos,clasificacion e,2001-04-01,0,7,0,7,7
80602,SAN ANDRES,estado nutricional en menores de 5 anos,clasificacion e,2001-04-01,0,4,0,4,4
51003,SAN ANTONIO DE ESMORUCO,estado nutricional en menores de 5 anos,clasificacion e,2001-04-01,0,2,0,2,2
71105,SAN ANTONIO DE LOMERIO,estado nutricional en menores de 5 anos,clasificacion e,2001-04-01,11,42,11,42,53
31403,SAN BENITO,estado nutricional en menores de 5 anos,clasificacion e,2001-04-01,1,8,1,8,9
80302,SAN BORJA,estado nutricional en menores de 5 anos,clasificacion e,2001-04-01,1,23,1,23,24
21502,SAN BUENA VENTURA,estado nutricional en menores de 5 anos,clasificacion e,2001-04-01,0,18,0,18,18
70402,SAN CARLOS,estado nutricional en menores de 5 anos,clasificacion e,2001-04-01,13,27,13,27,40
80501,SAN IGNACIO,estado nutricional en menores de 5 anos,clasificacion e,2001-04-01,0,44,0,44,44
70301,SAN IGNACIO DE VELASCO,estado nutricional en menores de 5 anos,clasificacion e,2001-04-01,2,114,2,114,116
80102,SAN JAVIER(BNI),estado nutricional en menores de 5 anos,clasificacion e,2001-04-01,0,3,0,3,3
71102,SAN JAVIER(STC),estado nutricional en menores de 5 anos,clasificacion e,2001-04-01,4,2,4,2,6
70501,SAN JOSE DE CHIQUITOS,estado nutricional en menores de 5 anos,clasificacion e,2001-04-01,0,19,0,19,19
71104,SAN JULIAN,estado nutricional en menores de 5 anos,clasificacion e,2001-04-01,0,81,0,81,81
60501,SAN LORENZO(TJA),estado nutricional en menores de 5 anos,clasificacion e,2001-04-01,1,11,1,11,12
10702,SAN LUCAS,estado nutricional en menores de 5 anos,clasificacion e,2001-04-01,1,210,1,210,211
71201,SAN MATIAS,estado nutricional en menores de 5 anos,clasificacion e,2001-04-01,1,12,1,12,13
70302,SAN MIGUEL DE VELASCO,estado nutricional en menores de 5 anos,clasificacion e,2001-04-01,0,23,0,23,23
51001,SAN PABLO DE LIPEZ,estado nutricional en menores de 5 anos,clasificacion e,2001-04-01,0,1,0,1,1
50501,SAN PEDRO DE BUENA VISTA,estado nutricional en menores de 5 anos,clasificacion e,2001-04-01,0,71,0,71,71
21801,SAN PEDRO DE CURAHUARA,estado nutricional en menores de 5 anos,clasificacion e,2001-04-01,0,8,0,8,8
50902,SAN PEDRO DE QUEMES,estado nutricional en menores de 5 anos,clasificacion e,2001-04-01,0,4,0,4,4
21702,SAN PEDRO DE TIQUINA,estado nutricional en menores de 5 anos,clasificacion e,2001-04-01,0,2,0,2,2
70303,SAN RAFAEL,estado nutricional en menores de 5 anos,clasificacion e,2001-04-01,1,15,1,15,16
80401,SANTA ANA,estado nutricional en menores de 5 anos,clasificacion e,2001-04-01,1,11,1,11,12
70101,SANTA CRUZ DE LA SIERRA,estado nutricional en menores de 5 anos,clasificacion e,2001-04-01,7,77,7,77,84
80303,SANTA ROSA,estado nutricional en menores de 5 anos,clasificacion e,2001-04-01,2,1,2,1,3
70602,SANTA ROSA DEL SARA,estado nutricional en menores de 5 anos,clasificacion e,2001-04-01,3,1,3,1,4
20308,SANTIAGO DE CALLAPA,estado nutricional en menores de 5 anos,clasificacion e,2001-04-01,0,3,0,3,3
41401,SANTIAGO DE HUARI,estado nutricional en menores de 5 anos,clasificacion e,2001-04-01,0,11,0,11,11
21901,SANTIAGO DE MACHACA,estado nutricional en menores de 5 anos,clasificacion e,2001-04-01,0,1,0,1,1
30702,SANTIVAÃ‘ES,estado nutricional en menores de 5 anos,clasificacion e,2001-04-01,9,16,9,16,25
40202,SANTUARIO DE QUILLACAS,estado nutricional en menores de 5 anos,clasificacion e,2001-04-01,0,6,0,6,6
20902,SAPAHAQUI,estado nutricional en menores de 5 anos,clasificacion e,2001-04-01,0,10,0,10,10
21301,SICA SICA (VILLA AROMA),estado nutricional en menores de 5 anos,clasificacion e,2001-04-01,0,18,0,18,18
30703,SICAYA,estado nutricional en menores de 5 anos,clasificacion e,2001-04-01,0,3,0,3,3
10403,SOPACHUY,estado nutricional en menores de 5 anos,clasificacion e,2001-04-01,2,98,2,98,100
20601,SORATA,estado nutricional en menores de 5 anos,clasificacion e,2001-04-01,0,12,0,12,12
10101,SUCRE,estado nutricional en menores de 5 anos,clasificacion e,2001-04-01,2,311,2,311,313
31404,TACACHI,estado nutricional en menores de 5 anos,clasificacion e,2001-04-01,0,1,0,1,1
20603,TACACOMA,estado nutricional en menores de 5 anos,clasificacion e,2001-04-01,0,4,0,4,4
50303,TACOBAMBA,estado nutricional en menores de 5 anos,clasificacion e,2001-04-01,0,40,0,40,40
30602,TACOPAYA,estado nutricional en menores de 5 anos,clasificacion e,2001-04-01,1,54,1,54,55
51402,TAHUA,estado nutricional en menores de 5 anos,clasificacion e,2001-04-01,0,3,0,3,3
31101,TAPACARI,estado nutricional en menores de 5 anos,clasificacion e,2001-04-01,0,39,0,39,39
10601,TARABUCO,estado nutricional en menores de 5 anos,clasificacion e,2001-04-01,3,235,3,235,238
30401,TARATA,estado nutricional en menores de 5 anos,clasificacion e,2001-04-01,0,10,0,10,10
60101,TARIJA,estado nutricional en menores de 5 anos,clasificacion e,2001-04-01,7,41,7,41,48
10202,TARVITA,estado nutricional en menores de 5 anos,clasificacion e,2001-04-01,0,55,0,55,55
20803,TIAWANACU,estado nutricional en menores de 5 anos,clasificacion e,2001-04-01,0,11,0,11,11
50102,TINGUIPAYA,estado nutricional en menores de 5 anos,clasificacion e,2001-04-01,2,33,2,33,35
20606,TIPUANI,estado nutricional en menores de 5 anos,clasificacion e,2001-04-01,0,8,0,8,8
30903,TIQUIPAYA,estado nutricional en menores de 5 anos,clasificacion e,2001-04-01,2,24,2,24,26
31601,TIRAQUE (CBBA),estado nutricional en menores de 5 anos,clasificacion e,2001-04-01,1,16,1,16,17
30802,TOCO,estado nutricional en menores de 5 anos,clasificacion e,2001-04-01,0,1,0,1,1
30803,TOLATA,estado nutricional en menores de 5 anos,clasificacion e,2001-04-01,0,1,0,1,1
41001,TOLEDO,estado nutricional en menores de 5 anos,clasificacion e,2001-04-01,0,4,0,4,4
51202,TOMAVE,estado nutricional en menores de 5 anos,clasificacion e,2001-04-01,1,29,1,29,30
10402,TOMINA,estado nutricional en menores de 5 anos,clasificacion e,2001-04-01,0,107,0,107,107
50502,TORO TORO,estado nutricional en menores de 5 anos,clasificacion e,2001-04-01,0,1,0,1,1
31201,TOTORA(CBBA),estado nutricional en menores de 5 anos,clasificacion e,2001-04-01,1,51,1,51,52
41301,TOTORA(ORR),estado nutricional en menores de 5 anos,clasificacion e,2001-04-01,0,7,0,7,7
70802,TRIGAL,estado nutricional en menores de 5 anos,clasificacion e,2001-04-01,0,4,0,4,4
80101,TRINIDAD,estado nutricional en menores de 5 anos,clasificacion e,2001-04-01,8,47,8,47,55
50801,TUPIZA,estado nutricional en menores de 5 anos,clasificacion e,2001-04-01,5,92,5,92,97
40402,TURCO,estado nutricional en menores de 5 anos,clasificacion e,2001-04-01,0,1,0,1,1
60401,URIONDO (A. CONCEPCION),estado nutricional en menores de 5 anos,clasificacion e,2001-04-01,0,6,0,6,6
71502,URUBICHA,estado nutricional en menores de 5 anos,clasificacion e,2001-04-01,0,16,0,16,16
51201,UYUNI,estado nutricional en menores de 5 anos,clasificacion e,2001-04-01,0,50,0,50,50
30502,VACAS,estado nutricional en menores de 5 anos,clasificacion e,2001-04-01,0,8,0,8,8
70801,VALLEGRANDE,estado nutricional en menores de 5 anos,clasificacion e,2001-04-01,3,15,3,15,18
20801,VIACHA,estado nutricional en menores de 5 anos,clasificacion e,2001-04-01,2,34,2,34,36
31302,VILA VILA,estado nutricional en menores de 5 anos,clasificacion e,2001-04-01,2,0,2,0,2
60303,VILLA MONTES,estado nutricional en menores de 5 anos,clasificacion e,2001-04-01,4,17,4,17,21
31402,VILLA RIVERO,estado nutricional en menores de 5 anos,clasificacion e,2001-04-01,1,7,1,7,8
10801,VILLA SERRANO,estado nutricional en menores de 5 anos,clasificacion e,2001-04-01,0,88,0,88,88
31003,VILLA TUNARI,estado nutricional en menores de 5 anos,clasificacion e,2001-04-01,0,25,0,25,25
11001,VILLA VACA GUZMAN (MUYUPAMPA),estado nutricional en menores de 5 anos,clasificacion e,2001-04-01,1,31,1,31,32
51501,VILLAZON,estado nutricional en menores de 5 anos,clasificacion e,2001-04-01,0,45,0,45,45
30904,VINTO,estado nutricional en menores de 5 anos,clasificacion e,2001-04-01,1,23,1,23,24
50602,VITICHI,estado nutricional en menores de 5 anos,clasificacion e,2001-04-01,0,25,0,25,25
70201,WARNES,estado nutricional en menores de 5 anos,clasificacion e,2001-04-01,4,32,4,32,36
20903,YACO,estado nutricional en menores de 5 anos,clasificacion e,2001-04-01,0,14,0,14,14
60301,YACUIBA,estado nutricional en menores de 5 anos,clasificacion e,2001-04-01,1,27,1,27,28
10602,YAMPARAEZ,estado nutricional en menores de 5 anos,clasificacion e,2001-04-01,0,81,0,81,81
21103,YANACACHI,estado nutricional en menores de 5 anos,clasificacion e,2001-04-01,0,3,0,3,3
70403,YAPACANI,estado nutricional en menores de 5 anos,clasificacion e,2001-04-01,1,15,1,15,16
50103,YOCALLA,estado nutricional en menores de 5 anos,clasificacion e,2001-04-01,3,37,3,37,40
10102,YOTALA,estado nutricional en menores de 5 anos,clasificacion e,2001-04-01,0,53,0,53,53
60402,YUNCHARA,estado nutricional en menores de 5 anos,clasificacion e,2001-04-01,0,6,0,6,6
10301,ZUDAÃ‘EZ,estado nutricional en menores de 5 anos,clasificacion e,2001-04-01,3,55,3,55,58
51302,ACACIO,estado nutricional en menores de 5 anos,clasificacion e,2001-05-01,0,53,0,53,53
20201,ACHACACHI,estado nutricional en menores de 5 anos,clasificacion e,2001-05-01,0,39,0,39,39
20104,ACHOCALLA,estado nutricional en menores de 5 anos,clasificacion e,2001-05-01,0,6,0,6,6
30201,AIQUILE,estado nutricional en menores de 5 anos,clasificacion e,2001-05-01,8,39,8,39,47
31303,ALALAY,estado nutricional en menores de 5 anos,clasificacion e,2001-05-01,8,0,8,0,8
10404,ALCALA,estado nutricional en menores de 5 anos,clasificacion e,2001-05-01,0,14,0,14,14
20202,ANCORAIMES,estado nutricional en menores de 5 anos,clasificacion e,2001-05-01,0,41,0,41,41
41201,ANDAMARCA,estado nutricional en menores de 5 anos,clasificacion e,2001-05-01,0,1,0,1,1
40603,ANTEQUERA,estado nutricional en menores de 5 anos,clasificacion e,2001-05-01,1,4,1,4,5
30402,ANZALDO,estado nutricional en menores de 5 anos,clasificacion e,2001-05-01,0,36,0,36,36
20701,APOLO,estado nutricional en menores de 5 anos,clasificacion e,2001-05-01,0,1,0,1,1
51301,ARAMPAMPA,estado nutricional en menores de 5 anos,clasificacion e,2001-05-01,1,22,1,22,23
30501,ARANI,estado nutricional en menores de 5 anos,clasificacion e,2001-05-01,0,5,0,5,5
30403,ARBIETO,estado nutricional en menores de 5 anos,clasificacion e,2001-05-01,0,7,0,7,7
30601,ARQUE,estado nutricional en menores de 5 anos,clasificacion e,2001-05-01,2,30,2,30,32
71501,ASCENCION DE GUARAYOS,estado nutricional en menores de 5 anos,clasificacion e,2001-05-01,0,13,0,13,13
50802,ATOCHA,estado nutricional en menores de 5 anos,clasificacion e,2001-05-01,0,5,0,5,5
20503,AUCAPATA,estado nutricional en menores de 5 anos,clasificacion e,2001-05-01,5,5,5,5,10
20502,AYATA,estado nutricional en menores de 5 anos,clasificacion e,2001-05-01,5,5,5,5,10
21303,AYO AYO,estado nutricional en menores de 5 anos,clasificacion e,2001-05-01,4,3,4,3,7
30301,AYOPAYA (V. DE INDEPENDENCIA),estado nutricional en menores de 5 anos,clasificacion e,2001-05-01,1,58,1,58,59
10201,AZURDUY,estado nutricional en menores de 5 anos,clasificacion e,2001-05-01,0,59,0,59,59
21203,BATALLAS,estado nutricional en menores de 5 anos,clasificacion e,2001-05-01,1,15,1,15,16
80802,BAURES,estado nutricional en menores de 5 anos,clasificacion e,2001-05-01,0,16,0,16,16
41202,BELEN DE ANDAMARCA,estado nutricional en menores de 5 anos,clasificacion e,2001-05-01,0,1,0,1,1
50104,BELEN DE URMIRI,estado nutricional en menores de 5 anos,clasificacion e,2001-05-01,0,7,0,7,7
90104,BELLA FLOR,estado nutricional en menores de 5 anos,clasificacion e,2001-05-01,0,2,0,2,2
60202,BERMEJO,estado nutricional en menores de 5 anos,clasificacion e,2001-05-01,0,1,0,1,1
50301,BETANZOS,estado nutricional en menores de 5 anos,clasificacion e,2001-05-01,5,197,5,197,202
31501,BOLIVAR,estado nutricional en menores de 5 anos,clasificacion e,2001-05-01,0,81,0,81,81
90103,BOLPEBRA,estado nutricional en menores de 5 anos,clasificacion e,2001-05-01,0,2,0,2,2
70707,BOYUIBE,estado nutricional en menores de 5 anos,clasificacion e,2001-05-01,1,5,1,5,6
70401,BUENA VISTA,estado nutricional en menores de 5 anos,clasificacion e,2001-05-01,1,6,1,6,7
70703,CABEZAS,estado nutricional en menores de 5 anos,clasificacion e,2001-05-01,0,21,0,21,21
20905,CAIROMA,estado nutricional en menores de 5 anos,clasificacion e,2001-05-01,0,4,0,4,4
51102,"CAIZA ""D""",estado nutricional en menores de 5 anos,clasificacion e,2001-05-01,1,47,1,47,48
21003,CAJUATA,estado nutricional en menores de 5 anos,clasificacion e,2001-05-01,0,1,0,1,1
20303,CALACOTO,estado nutricional en menores de 5 anos,clasificacion e,2001-05-01,0,2,0,2,2
21304,CALAMARCA,estado nutricional en menores de 5 anos,clasificacion e,2001-05-01,0,12,0,12,12
10701,CAMARGO,estado nutricional en menores de 5 anos,clasificacion e,2001-05-01,0,51,0,51,51
10901,CAMATAQUI (C. VILLA ABECIA),estado nutricional en menores de 5 anos,clasificacion e,2001-05-01,0,8,0,8,8
70706,CAMIRI,estado nutricional en menores de 5 anos,clasificacion e,2001-05-01,2,29,2,29,31
30701,CAPINOTA,estado nutricional en menores de 5 anos,clasificacion e,2001-05-01,5,37,5,37,42
20302,CAQUIAVIRI,estado nutricional en menores de 5 anos,clasificacion e,2001-05-01,0,10,0,10,10
40102,CARACOLLO,estado nutricional en menores de 5 anos,clasificacion e,2001-05-01,2,15,2,15,17
22001,CARANAVI,estado nutricional en menores de 5 anos,clasificacion e,2001-05-01,5,52,5,52,57
41503,CARANGAS,estado nutricional en menores de 5 anos,clasificacion e,2001-05-01,0,2,0,2,2
60302,CARAPARI,estado nutricional en menores de 5 anos,clasificacion e,2001-05-01,0,10,0,10,10
50702,CARIPUYO,estado nutricional en menores de 5 anos,clasificacion e,2001-05-01,0,36,0,36,36
21902,CATACORA,estado nutricional en menores de 5 anos,clasificacion e,2001-05-01,0,1,0,1,1
21803,CHACARILLA,estado nutricional en menores de 5 anos,clasificacion e,2001-05-01,0,1,0,1,1
40201,CHALLAPATA,estado nutricional en menores de 5 anos,clasificacion e,2001-05-01,10,17,10,17,27
50302,CHAQUI,estado nutricional en menores de 5 anos,clasificacion e,2001-05-01,0,26,0,26,26
70702,CHARAGUA,estado nutricional en menores de 5 anos,clasificacion e,2001-05-01,1,61,1,61,62
50202,CHAYANTA,estado nutricional en menores de 5 anos,clasificacion e,2001-05-01,1,41,1,41,42
31204,CHIMORE,estado nutricional en menores de 5 anos,clasificacion e,2001-05-01,5,14,5,14,19
40302,CHOQUE COTA,estado nutricional en menores de 5 anos,clasificacion e,2001-05-01,1,6,1,6,7
21101,CHULUMANI (V. DE LA LIBERTAD),estado nutricional en menores de 5 anos,clasificacion e,2001-05-01,0,1,0,1,1
20501,CHUMA,estado nutricional en menores de 5 anos,clasificacion e,2001-05-01,3,4,3,4,7
30801,CLIZA,estado nutricional en menores de 5 anos,clasificacion e,2001-05-01,2,4,2,4,6
90101,COBIJA,estado nutricional en menores de 5 anos,clasificacion e,2001-05-01,0,31,0,31,31
30101,COCHABAMBA,estado nutricional en menores de 5 anos,clasificacion e,2001-05-01,21,97,21,97,118
30905,COLCAPIRHUA,estado nutricional en menores de 5 anos,clasificacion e,2001-05-01,0,2,0,2,2
50901,"COLCHA ""K""",estado nutricional en menores de 5 anos,clasificacion e,2001-05-01,1,13,1,13,14
31002,COLOMI,estado nutricional en menores de 5 anos,clasificacion e,2001-05-01,0,34,0,34,34
70603,COLPA BELGICA,estado nutricional en menores de 5 anos,clasificacion e,2001-05-01,0,8,0,8,8
50401,COLQUECHACA,estado nutricional en menores de 5 anos,clasificacion e,2001-05-01,0,46,0,46,46
21306,COLQUENCHA,estado nutricional en menores de 5 anos,clasificacion e,2001-05-01,2,2,2,2,4
21004,COLQUIRI,estado nutricional en menores de 5 anos,clasificacion e,2001-05-01,2,67,2,67,69
20304,COMANCHE,estado nutricional en menores de 5 anos,clasificacion e,2001-05-01,3,4,3,4,7
71301,COMARAPA,estado nutricional en menores de 5 anos,clasificacion e,2001-05-01,0,2,0,2,2
71101,CONCEPCION,estado nutricional en menores de 5 anos,clasificacion e,2001-05-01,2,16,2,16,18
21701,COPACABANA,estado nutricional en menores de 5 anos,clasificacion e,2001-05-01,1,14,1,14,15
21402,CORIPATA,estado nutricional en menores de 5 anos,clasificacion e,2001-05-01,0,2,0,2,2
20301,CORO CORO,estado nutricional en menores de 5 anos,clasificacion e,2001-05-01,1,19,1,19,20
21401,COROICO,estado nutricional en menores de 5 anos,clasificacion e,2001-05-01,1,12,1,12,13
40301,CORQUE,estado nutricional en menores de 5 anos,clasificacion e,2001-05-01,0,8,0,8,8
50601,COTAGAITA,estado nutricional en menores de 5 anos,clasificacion e,2001-05-01,0,77,0,77,77
70102,COTOCA,estado nutricional en menores de 5 anos,clasificacion e,2001-05-01,0,4,0,4,4
31405,CUCHUMUELA (V. G. VILLARROEL),estado nutricional en menores de 5 anos,clasificacion e,2001-05-01,0,4,0,4,4
70704,CUEVO,estado nutricional en menores de 5 anos,clasificacion e,2001-05-01,0,12,0,12,12
10902,CULPINA,estado nutricional en menores de 5 anos,clasificacion e,2001-05-01,6,126,6,126,132
40401,CURAHUARA DE CARANGAS,estado nutricional en menores de 5 anos,clasificacion e,2001-05-01,2,1,2,1,3
21602,CURVA,estado nutricional en menores de 5 anos,clasificacion e,2001-05-01,0,2,0,2,2
20804,DESAGUADERO,estado nutricional en menores de 5 anos,clasificacion e,2001-05-01,0,6,0,6,6
20105,EL ALTO,estado nutricional en menores de 5 anos,clasificacion e,2001-05-01,111,676,111,676,787
71503,EL PUENTE(STC),estado nutricional en menores de 5 anos,clasificacion e,2001-05-01,0,32,0,32,32
60502,EL PUENTE(TJA),estado nutricional en menores de 5 anos,clasificacion e,2001-05-01,1,13,1,13,14
70105,EL TORNO,estado nutricional en menores de 5 anos,clasificacion e,2001-05-01,1,21,1,21,22
10405,EL VILLAR,estado nutricional en menores de 5 anos,clasificacion e,2001-05-01,0,61,0,61,61
60601,ENTRE RIOS,estado nutricional en menores de 5 anos,clasificacion e,2001-05-01,0,15,0,15,15
41101,EUCALIPTUS,estado nutricional en menores de 5 anos,clasificacion e,2001-05-01,0,6,0,6,6
80402,EXALTACION,estado nutricional en menores de 5 anos,clasificacion e,2001-05-01,1,7,1,7,8
71002,GENERAL SAAVEDRA,estado nutricional en menores de 5 anos,clasificacion e,2001-05-01,2,25,2,25,27
21601,GRAL. J.J. PEREZ (CHARAZANI),estado nutricional en menores de 5 anos,clasificacion e,2001-05-01,2,0,2,0,2
20602,GUANAY,estado nutricional en menores de 5 anos,clasificacion e,2001-05-01,0,21,0,21,21
20802,GUAQUI,estado nutricional en menores de 5 anos,clasificacion e,2001-05-01,0,7,0,7,7
80202,GUAYARAMERIN,estado nutricional en menores de 5 anos,clasificacion e,2001-05-01,3,20,3,20,23
70705,GUTIERREZ,estado nutricional en menores de 5 anos,clasificacion e,2001-05-01,1,57,1,57,58
10502,HUACARETA,estado nutricional en menores de 5 anos,clasificacion e,2001-05-01,0,54,0,54,54
11002,HUACAYA (VILLA DE HUACAYA),estado nutricional en menores de 5 anos,clasificacion e,2001-05-01,0,8,0,8,8
40701,HUANUNI,estado nutricional en menores de 5 anos,clasificacion e,2001-05-01,1,1,1,1,2
80803,HUARACAJE,estado nutricional en menores de 5 anos,clasificacion e,2001-05-01,0,4,0,4,4
41601,HUAYLLAMARCA,estado nutricional en menores de 5 anos,clasificacion e,2001-05-01,0,4,0,4,4
21005,ICHOCA,estado nutricional en menores de 5 anos,clasificacion e,2001-05-01,0,2,0,2,2
10304,ICLA,estado nutricional en menores de 5 anos,clasificacion e,2001-05-01,0,112,0,112,112
10703,INCAHUASI,estado nutricional en menores de 5 anos,clasificacion e,2001-05-01,2,106,2,106,108
21001,INQUISIVI,estado nutricional en menores de 5 anos,clasificacion e,2001-05-01,6,50,6,50,56
21102,IRUPANA (VILLA DE LANZA),estado nutricional en menores de 5 anos,clasificacion e,2001-05-01,2,7,2,7,9
21501,IXIAMAS,estado nutricional en menores de 5 anos,clasificacion e,2001-05-01,0,12,0,12,12
21105,LA ASUNTA,estado nutricional en menores de 5 anos,clasificacion e,2001-05-01,1,13,1,13,14
70104,LA GUARDIA,estado nutricional en menores de 5 anos,clasificacion e,2001-05-01,0,34,0,34,34
20101,LA PAZ,estado nutricional en menores de 5 anos,clasificacion e,2001-05-01,47,318,47,318,365
70701,LAGUNILLAS,estado nutricional en menores de 5 anos,clasificacion e,2001-05-01,3,4,3,4,7
21202,LAJA,estado nutricional en menores de 5 anos,clasificacion e,2001-05-01,0,13,0,13,13
10903,LAS CARRERAS,estado nutricional en menores de 5 anos,clasificacion e,2001-05-01,0,21,0,21,21
21006,LICOMA PAMPA,estado nutricional en menores de 5 anos,clasificacion e,2001-05-01,0,4,0,4,4
50203,LLALLAGUA,estado nutricional en menores de 5 anos,clasificacion e,2001-05-01,0,77,0,77,77
51401,LLICA,estado nutricional en menores de 5 anos,clasificacion e,2001-05-01,0,3,0,3,3
20901,LURIBAY,estado nutricional en menores de 5 anos,clasificacion e,2001-05-01,0,4,0,4,4
40702,MACHACAMARCA,estado nutricional en menores de 5 anos,clasificacion e,2001-05-01,0,2,0,2,2
11003,MACHARETI,estado nutricional en menores de 5 anos,clasificacion e,2001-05-01,1,31,1,31,32
80801,MAGDALENA,estado nutricional en menores de 5 anos,clasificacion e,2001-05-01,0,4,0,4,4
70903,MAIRANA,estado nutricional en menores de 5 anos,clasificacion e,2001-05-01,0,9,0,9,9
20103,MECAPACA,estado nutricional en menores de 5 anos,clasificacion e,2001-05-01,0,7,0,7,7
71003,MINEROS,estado nutricional en menores de 5 anos,clasificacion e,2001-05-01,1,57,1,57,58
31301,MIZQUE,estado nutricional en menores de 5 anos,clasificacion e,2001-05-01,59,16,59,16,75
20402,MOCOMOCO,estado nutricional en menores de 5 anos,clasificacion e,2001-05-01,5,18,5,18,23
51002,MOJINETE,estado nutricional en menores de 5 anos,clasificacion e,2001-05-01,0,4,0,4,4
10303,MOJOCOYA,estado nutricional en menores de 5 anos,clasificacion e,2001-05-01,0,15,0,15,15
10501,MONTEAGUDO,estado nutricional en menores de 5 anos,clasificacion e,2001-05-01,2,85,2,85,87
71001,MONTERO,estado nutricional en menores de 5 anos,clasificacion e,2001-05-01,14,98,14,98,112
70803,MORO MORO,estado nutricional en menores de 5 anos,clasificacion e,2001-05-01,0,6,0,6,6
30302,MOROCHATA,estado nutricional en menores de 5 anos,clasificacion e,2001-05-01,5,8,5,8,13
90401,NACEBE (SANTA ROSA DEL ABUNA),estado nutricional en menores de 5 anos,clasificacion e,2001-05-01,0,5,0,5,5
90501,NUEVO MANOA (NUEVA ESPERANZA),estado nutricional en menores de 5 anos,clasificacion e,2001-05-01,0,1,0,1,1
50404,OCURI,estado nutricional en menores de 5 anos,clasificacion e,2001-05-01,1,29,1,29,30
70202,OKINAWA,estado nutricional en menores de 5 anos,clasificacion e,2001-05-01,0,4,0,4,4
30203,OMEREQUE,estado nutricional en menores de 5 anos,clasificacion e,2001-05-01,0,6,0,6,6
40101,ORURO,estado nutricional en menores de 5 anos,clasificacion e,2001-05-01,9,174,9,174,183
60201,PADCAYA,estado nutricional en menores de 5 anos,clasificacion e,2001-05-01,3,11,3,11,14
10401,PADILLA,estado nutricional en menores de 5 anos,clasificacion e,2001-05-01,2,120,2,120,122
70502,PAILON,estado nutricional en menores de 5 anos,clasificacion e,2001-05-01,1,10,1,10,11
20102,PALCA,estado nutricional en menores de 5 anos,clasificacion e,2001-05-01,0,17,0,17,17
21104,PALOS BLANCOS,estado nutricional en menores de 5 anos,clasificacion e,2001-05-01,1,14,1,14,15
40802,PAMPA AULLAGAS,estado nutricional en menores de 5 anos,clasificacion e,2001-05-01,0,1,0,1,1
70902,PAMPA GRANDE,estado nutricional en menores de 5 anos,clasificacion e,2001-05-01,1,5,1,5,6
21802,PAPEL PAMPA,estado nutricional en menores de 5 anos,clasificacion e,2001-05-01,0,1,0,1,1
30202,PASORAPA,estado nutricional en menores de 5 anos,clasificacion e,2001-05-01,0,4,0,4,4
21305,PATACAMAYA,estado nutricional en menores de 5 anos,clasificacion e,2001-05-01,6,7,6,7,13
40602,PAZÃ‘A,estado nutricional en menores de 5 anos,clasificacion e,2001-05-01,1,12,1,12,13
20702,PELECHUCO,estado nutricional en menores de 5 anos,clasificacion e,2001-05-01,0,13,0,13,13
50403,POCOATA,estado nutricional en menores de 5 anos,clasificacion e,2001-05-01,13,68,13,68,81
31203,POCONA,estado nutricional en menores de 5 anos,clasificacion e,2001-05-01,0,25,0,25,25
31202,POJO (CBBA),estado nutricional en menores de 5 anos,clasificacion e,2001-05-01,10,56,10,56,66
40601,POOPO,estado nutricional en menores de 5 anos,clasificacion e,2001-05-01,1,6,1,6,7
51203,PORCO,estado nutricional en menores de 5 anos,clasificacion e,2001-05-01,1,22,1,22,23
10103,POROMA,estado nutricional en menores de 5 anos,clasificacion e,2001-05-01,2,82,2,82,84
70103,PORONGO,estado nutricional en menores de 5 anos,clasificacion e,2001-05-01,0,8,0,8,8
70601,PORTACHUELO,estado nutricional en menores de 5 anos,clasificacion e,2001-05-01,9,20,9,20,29
90102,PORVENIR,estado nutricional en menores de 5 anos,clasificacion e,2001-05-01,0,6,0,6,6
50101,POTOSI,estado nutricional en menores de 5 anos,clasificacion e,2001-05-01,6,317,6,317,323
10302,PRESTO,estado nutricional en menores de 5 anos,clasificacion e,2001-05-01,0,43,0,43,43
21201,PUCARANI,estado nutricional en menores de 5 anos,clasificacion e,2001-05-01,1,16,1,16,17
20401,PUERTO ACOSTA,estado nutricional en menores de 5 anos,clasificacion e,2001-05-01,3,28,3,28,31
20403,PUERTO CARABUCO,estado nutricional en menores de 5 anos,clasificacion e,2001-05-01,0,33,0,33,33
90301,PUERTO GONZALO MORENO,estado nutricional en menores de 5 anos,clasificacion e,2001-05-01,0,6,0,6,6
21204,PUERTO PEREZ,estado nutricional en menores de 5 anos,clasificacion e,2001-05-01,0,1,0,1,1
71402,PUERTO QUIJARRO,estado nutricional en menores de 5 anos,clasificacion e,2001-05-01,0,4,0,4,4
71401,PUERTO SUAREZ,estado nutricional en menores de 5 anos,clasificacion e,2001-05-01,11,0,11,0,11
31205,PUERTO VILLARROEL,estado nutricional en menores de 5 anos,clasificacion e,2001-05-01,21,43,21,43,64
51101,PUNA,estado nutricional en menores de 5 anos,clasificacion e,2001-05-01,2,143,2,143,145
31401,PUNATA,estado nutricional en menores de 5 anos,clasificacion e,2001-05-01,19,103,19,103,122
20604,QUIABAYA,estado nutricional en menores de 5 anos,clasificacion e,2001-05-01,0,15,0,15,15
21002,QUIME,estado nutricional en menores de 5 anos,clasificacion e,2001-05-01,0,29,0,29,29
50402,RAVELO,estado nutricional en menores de 5 anos,clasificacion e,2001-05-01,2,135,2,135,137
80301,REYES,estado nutricional en menores de 5 anos,clasificacion e,2001-05-01,1,6,1,6,7
80201,RIBERALTA,estado nutricional en menores de 5 anos,clasificacion e,2001-05-01,5,154,5,154,159
70503,ROBORE,estado nutricional en menores de 5 anos,clasificacion e,2001-05-01,3,20,3,20,23
80304,RURRENABAQUE,estado nutricional en menores de 5 anos,clasificacion e,2001-05-01,1,3,1,3,4
31001,SACABA,estado nutricional en menores de 5 anos,clasificacion e,2001-05-01,51,45,51,45,96
30404,SACABAMBA,estado nutricional en menores de 5 anos,clasificacion e,2001-05-01,0,28,0,28,28
50701,SACACA,estado nutricional en menores de 5 anos,clasificacion e,2001-05-01,2,145,2,145,147
40801,SALINAS DE GARCI MENDOZA,estado nutricional en menores de 5 anos,clasificacion e,2001-05-01,3,3,3,3,6
70901,SAMAIPATA,estado nutricional en menores de 5 anos,clasificacion e,2001-05-01,0,4,0,4,4
80602,SAN ANDRES,estado nutricional en menores de 5 anos,clasificacion e,2001-05-01,0,3,0,3,3
51003,SAN ANTONIO DE ESMORUCO,estado nutricional en menores de 5 anos,clasificacion e,2001-05-01,1,0,1,0,1
71105,SAN ANTONIO DE LOMERIO,estado nutricional en menores de 5 anos,clasificacion e,2001-05-01,0,97,0,97,97
31403,SAN BENITO,estado nutricional en menores de 5 anos,clasificacion e,2001-05-01,0,14,0,14,14
80302,SAN BORJA,estado nutricional en menores de 5 anos,clasificacion e,2001-05-01,0,21,0,21,21
21502,SAN BUENA VENTURA,estado nutricional en menores de 5 anos,clasificacion e,2001-05-01,1,24,1,24,25
70402,SAN CARLOS,estado nutricional en menores de 5 anos,clasificacion e,2001-05-01,2,15,2,15,17
80501,SAN IGNACIO,estado nutricional en menores de 5 anos,clasificacion e,2001-05-01,2,28,2,28,30
70301,SAN IGNACIO DE VELASCO,estado nutricional en menores de 5 anos,clasificacion e,2001-05-01,2,103,2,103,105
80102,SAN JAVIER(BNI),estado nutricional en menores de 5 anos,clasificacion e,2001-05-01,0,8,0,8,8
71102,SAN JAVIER(STC),estado nutricional en menores de 5 anos,clasificacion e,2001-05-01,2,12,2,12,14
70501,SAN JOSE DE CHIQUITOS,estado nutricional en menores de 5 anos,clasificacion e,2001-05-01,0,14,0,14,14
71104,SAN JULIAN,estado nutricional en menores de 5 anos,clasificacion e,2001-05-01,13,45,13,45,58
90302,SAN LORENZO(PND),estado nutricional en menores de 5 anos,clasificacion e,2001-05-01,0,28,0,28,28
60501,SAN LORENZO(TJA),estado nutricional en menores de 5 anos,clasificacion e,2001-05-01,0,21,0,21,21
10702,SAN LUCAS,estado nutricional en menores de 5 anos,clasificacion e,2001-05-01,2,228,2,228,230
71201,SAN MATIAS,estado nutricional en menores de 5 anos,clasificacion e,2001-05-01,1,16,1,16,17
70302,SAN MIGUEL DE VELASCO,estado nutricional en menores de 5 anos,clasificacion e,2001-05-01,0,17,0,17,17
51001,SAN PABLO DE LIPEZ,estado nutricional en menores de 5 anos,clasificacion e,2001-05-01,0,5,0,5,5
50501,SAN PEDRO DE BUENA VISTA,estado nutricional en menores de 5 anos,clasificacion e,2001-05-01,5,155,5,155,160
21801,SAN PEDRO DE CURAHUARA,estado nutricional en menores de 5 anos,clasificacion e,2001-05-01,0,2,0,2,2
21702,SAN PEDRO DE TIQUINA,estado nutricional en menores de 5 anos,clasificacion e,2001-05-01,0,1,0,1,1
90202,SAN PEDRO(PND),estado nutricional en menores de 5 anos,clasificacion e,2001-05-01,0,1,0,1,1
70303,SAN RAFAEL,estado nutricional en menores de 5 anos,clasificacion e,2001-05-01,3,14,3,14,17
80702,SAN RAMON,estado nutricional en menores de 5 anos,clasificacion e,2001-05-01,0,7,0,7,7
80401,SANTA ANA,estado nutricional en menores de 5 anos,clasificacion e,2001-05-01,1,9,1,9,10
70101,SANTA CRUZ DE LA SIERRA,estado nutricional en menores de 5 anos,clasificacion e,2001-05-01,7,68,7,68,75
80303,SANTA ROSA,estado nutricional en menores de 5 anos,clasificacion e,2001-05-01,1,4,1,4,5
70602,SANTA ROSA DEL SARA,estado nutricional en menores de 5 anos,clasificacion e,2001-05-01,0,4,0,4,4
20308,SANTIAGO DE CALLAPA,estado nutricional en menores de 5 anos,clasificacion e,2001-05-01,0,2,0,2,2
41401,SANTIAGO DE HUARI,estado nutricional en menores de 5 anos,clasificacion e,2001-05-01,2,7,2,7,9
30702,SANTIVAÃ‘ES,estado nutricional en menores de 5 anos,clasificacion e,2001-05-01,5,4,5,4,9
40202,SANTUARIO DE QUILLACAS,estado nutricional en menores de 5 anos,clasificacion e,2001-05-01,1,3,1,3,4
20902,SAPAHAQUI,estado nutricional en menores de 5 anos,clasificacion e,2001-05-01,0,5,0,5,5
21301,SICA SICA (VILLA AROMA),estado nutricional en menores de 5 anos,clasificacion e,2001-05-01,3,11,3,11,14
30703,SICAYA,estado nutricional en menores de 5 anos,clasificacion e,2001-05-01,0,4,0,4,4
30902,SIPE SIPE,estado nutricional en menores de 5 anos,clasificacion e,2001-05-01,8,112,8,112,120
10403,SOPACHUY,estado nutricional en menores de 5 anos,clasificacion e,2001-05-01,3,81,3,81,84
20601,SORATA,estado nutricional en menores de 5 anos,clasificacion e,2001-05-01,0,12,0,12,12
10101,SUCRE,estado nutricional en menores de 5 anos,clasificacion e,2001-05-01,9,410,9,410,419
31404,TACACHI,estado nutricional en menores de 5 anos,clasificacion e,2001-05-01,1,4,1,4,5
20603,TACACOMA,estado nutricional en menores de 5 anos,clasificacion e,2001-05-01,0,14,0,14,14
50303,TACOBAMBA,estado nutricional en menores de 5 anos,clasificacion e,2001-05-01,0,25,0,25,25
30602,TACOPAYA,estado nutricional en menores de 5 anos,clasificacion e,2001-05-01,0,25,0,25,25
51402,TAHUA,estado nutricional en menores de 5 anos,clasificacion e,2001-05-01,0,4,0,4,4
31101,TAPACARI,estado nutricional en menores de 5 anos,clasificacion e,2001-05-01,2,27,2,27,29
10601,TARABUCO,estado nutricional en menores de 5 anos,clasificacion e,2001-05-01,0,260,0,260,260
30401,TARATA,estado nutricional en menores de 5 anos,clasificacion e,2001-05-01,0,29,0,29,29
60101,TARIJA,estado nutricional en menores de 5 anos,clasificacion e,2001-05-01,5,71,5,71,76
10202,TARVITA,estado nutricional en menores de 5 anos,clasificacion e,2001-05-01,2,65,2,65,67
20803,TIAWANACU,estado nutricional en menores de 5 anos,clasificacion e,2001-05-01,5,6,5,6,11
50102,TINGUIPAYA,estado nutricional en menores de 5 anos,clasificacion e,2001-05-01,1,25,1,25,26
20606,TIPUANI,estado nutricional en menores de 5 anos,clasificacion e,2001-05-01,4,0,4,0,4
30903,TIQUIPAYA,estado nutricional en menores de 5 anos,clasificacion e,2001-05-01,0,1,0,1,1
31601,TIRAQUE (CBBA),estado nutricional en menores de 5 anos,clasificacion e,2001-05-01,17,27,17,27,44
21703,TITO YUPANQUI (PARQUIPUJIO),estado nutricional en menores de 5 anos,clasificacion e,2001-05-01,0,2,0,2,2
30802,TOCO,estado nutricional en menores de 5 anos,clasificacion e,2001-05-01,0,9,0,9,9
41001,TOLEDO,estado nutricional en menores de 5 anos,clasificacion e,2001-05-01,0,3,0,3,3
51202,TOMAVE,estado nutricional en menores de 5 anos,clasificacion e,2001-05-01,4,39,4,39,43
10402,TOMINA,estado nutricional en menores de 5 anos,clasificacion e,2001-05-01,0,103,0,103,103
50502,TORO TORO,estado nutricional en menores de 5 anos,clasificacion e,2001-05-01,1,0,1,0,1
31201,TOTORA(CBBA),estado nutricional en menores de 5 anos,clasificacion e,2001-05-01,0,32,0,32,32
41301,TOTORA(ORR),estado nutricional en menores de 5 anos,clasificacion e,2001-05-01,0,3,0,3,3
70802,TRIGAL,estado nutricional en menores de 5 anos,clasificacion e,2001-05-01,0,7,0,7,7
80101,TRINIDAD,estado nutricional en menores de 5 anos,clasificacion e,2001-05-01,2,41,2,41,43
50801,TUPIZA,estado nutricional en menores de 5 anos,clasificacion e,2001-05-01,0,74,0,74,74
40402,TURCO,estado nutricional en menores de 5 anos,clasificacion e,2001-05-01,2,0,2,0,2
50201,UNCIA,estado nutricional en menores de 5 anos,clasificacion e,2001-05-01,0,42,0,42,42
60401,URIONDO (A. CONCEPCION),estado nutricional en menores de 5 anos,clasificacion e,2001-05-01,0,2,0,2,2
71502,URUBICHA,estado nutricional en menores de 5 anos,clasificacion e,2001-05-01,0,12,0,12,12
51201,UYUNI,estado nutricional en menores de 5 anos,clasificacion e,2001-05-01,0,32,0,32,32
30502,VACAS,estado nutricional en menores de 5 anos,clasificacion e,2001-05-01,0,6,0,6,6
70801,VALLEGRANDE,estado nutricional en menores de 5 anos,clasificacion e,2001-05-01,0,10,0,10,10
20801,VIACHA,estado nutricional en menores de 5 anos,clasificacion e,2001-05-01,2,55,2,55,57
31302,VILA VILA,estado nutricional en menores de 5 anos,clasificacion e,2001-05-01,4,10,4,10,14
60303,VILLA MONTES,estado nutricional en menores de 5 anos,clasificacion e,2001-05-01,0,25,0,25,25
90502,VILLA NUEVA (LOMA ALTA),estado nutricional en menores de 5 anos,clasificacion e,2001-05-01,0,1,0,1,1
31402,VILLA RIVERO,estado nutricional en menores de 5 anos,clasificacion e,2001-05-01,2,3,2,3,5
10801,VILLA SERRANO,estado nutricional en menores de 5 anos,clasificacion e,2001-05-01,0,99,0,99,99
31003,VILLA TUNARI,estado nutricional en menores de 5 anos,clasificacion e,2001-05-01,4,36,4,36,40
11001,VILLA VACA GUZMAN (MUYUPAMPA),estado nutricional en menores de 5 anos,clasificacion e,2001-05-01,0,34,0,34,34
51501,VILLAZON,estado nutricional en menores de 5 anos,clasificacion e,2001-05-01,0,61,0,61,61
30904,VINTO,estado nutricional en menores de 5 anos,clasificacion e,2001-05-01,2,29,2,29,31
50602,VITICHI,estado nutricional en menores de 5 anos,clasificacion e,2001-05-01,0,12,0,12,12
20306,WALDO BALLIVIAN,estado nutricional en menores de 5 anos,clasificacion e,2001-05-01,3,0,3,0,3
70201,WARNES,estado nutricional en menores de 5 anos,clasificacion e,2001-05-01,3,32,3,32,35
20903,YACO,estado nutricional en menores de 5 anos,clasificacion e,2001-05-01,0,4,0,4,4
60301,YACUIBA,estado nutricional en menores de 5 anos,clasificacion e,2001-05-01,2,24,2,24,26
10602,YAMPARAEZ,estado nutricional en menores de 5 anos,clasificacion e,2001-05-01,2,104,2,104,106
21103,YANACACHI,estado nutricional en menores de 5 anos,clasificacion e,2001-05-01,0,6,0,6,6
70403,YAPACANI,estado nutricional en menores de 5 anos,clasificacion e,2001-05-01,5,35,5,35,40
50103,YOCALLA,estado nutricional en menores de 5 anos,clasificacion e,2001-05-01,0,14,0,14,14
10102,YOTALA,estado nutricional en menores de 5 anos,clasificacion e,2001-05-01,0,78,0,78,78
60402,YUNCHARA,estado nutricional en menores de 5 anos,clasificacion e,2001-05-01,0,5,0,5,5
10301,ZUDAÃ‘EZ,estado nutricional en menores de 5 anos,clasificacion e,2001-05-01,1,67,1,67,68
51302,ACACIO,estado nutricional en menores de 5 anos,clasificacion e,2001-06-01,0,28,0,28,28
20201,ACHACACHI,estado nutricional en menores de 5 anos,clasificacion e,2001-06-01,1,36,1,36,37
20104,ACHOCALLA,estado nutricional en menores de 5 anos,clasificacion e,2001-06-01,0,9,0,9,9
30201,AIQUILE,estado nutricional en menores de 5 anos,clasificacion e,2001-06-01,4,10,4,10,14
31303,ALALAY,estado nutricional en menores de 5 anos,clasificacion e,2001-06-01,3,4,3,4,7
10404,ALCALA,estado nutricional en menores de 5 anos,clasificacion e,2001-06-01,0,22,0,22,22
20202,ANCORAIMES,estado nutricional en menores de 5 anos,clasificacion e,2001-06-01,0,39,0,39,39
41201,ANDAMARCA,estado nutricional en menores de 5 anos,clasificacion e,2001-06-01,0,3,0,3,3
30402,ANZALDO,estado nutricional en menores de 5 anos,clasificacion e,2001-06-01,1,22,1,22,23
20701,APOLO,estado nutricional en menores de 5 anos,clasificacion e,2001-06-01,3,3,3,3,6
51301,ARAMPAMPA,estado nutricional en menores de 5 anos,clasificacion e,2001-06-01,0,39,0,39,39
30501,ARANI,estado nutricional en menores de 5 anos,clasificacion e,2001-06-01,0,9,0,9,9
30403,ARBIETO,estado nutricional en menores de 5 anos,clasificacion e,2001-06-01,0,7,0,7,7
30601,ARQUE,estado nutricional en menores de 5 anos,clasificacion e,2001-06-01,1,41,1,41,42
71501,ASCENCION DE GUARAYOS,estado nutricional en menores de 5 anos,clasificacion e,2001-06-01,2,112,2,112,114
50802,ATOCHA,estado nutricional en menores de 5 anos,clasificacion e,2001-06-01,1,10,1,10,11
20503,AUCAPATA,estado nutricional en menores de 5 anos,clasificacion e,2001-06-01,1,6,1,6,7
21303,AYO AYO,estado nutricional en menores de 5 anos,clasificacion e,2001-06-01,0,5,0,5,5
30301,AYOPAYA (V. DE INDEPENDENCIA),estado nutricional en menores de 5 anos,clasificacion e,2001-06-01,0,57,0,57,57
10201,AZURDUY,estado nutricional en menores de 5 anos,clasificacion e,2001-06-01,0,89,0,89,89
21203,BATALLAS,estado nutricional en menores de 5 anos,clasificacion e,2001-06-01,0,13,0,13,13
80802,BAURES,estado nutricional en menores de 5 anos,clasificacion e,2001-06-01,0,9,0,9,9
50104,BELEN DE URMIRI,estado nutricional en menores de 5 anos,clasificacion e,2001-06-01,0,5,0,5,5
90104,BELLA FLOR,estado nutricional en menores de 5 anos,clasificacion e,2001-06-01,0,2,0,2,2
60202,BERMEJO,estado nutricional en menores de 5 anos,clasificacion e,2001-06-01,0,4,0,4,4
50301,BETANZOS,estado nutricional en menores de 5 anos,clasificacion e,2001-06-01,1,75,1,75,76
31501,BOLIVAR,estado nutricional en menores de 5 anos,clasificacion e,2001-06-01,0,16,0,16,16
90103,BOLPEBRA,estado nutricional en menores de 5 anos,clasificacion e,2001-06-01,0,1,0,1,1
70707,BOYUIBE,estado nutricional en menores de 5 anos,clasificacion e,2001-06-01,0,7,0,7,7
70401,BUENA VISTA,estado nutricional en menores de 5 anos,clasificacion e,2001-06-01,6,10,6,10,16
70703,CABEZAS,estado nutricional en menores de 5 anos,clasificacion e,2001-06-01,1,14,1,14,15
20905,CAIROMA,estado nutricional en menores de 5 anos,clasificacion e,2001-06-01,0,26,0,26,26
51102,"CAIZA ""D""",estado nutricional en menores de 5 anos,clasificacion e,2001-06-01,4,51,4,51,55
21003,CAJUATA,estado nutricional en menores de 5 anos,clasificacion e,2001-06-01,0,3,0,3,3
20303,CALACOTO,estado nutricional en menores de 5 anos,clasificacion e,2001-06-01,1,0,1,0,1
21304,CALAMARCA,estado nutricional en menores de 5 anos,clasificacion e,2001-06-01,3,10,3,10,13
10701,CAMARGO,estado nutricional en menores de 5 anos,clasificacion e,2001-06-01,0,57,0,57,57
10901,CAMATAQUI (C. VILLA ABECIA),estado nutricional en menores de 5 anos,clasificacion e,2001-06-01,0,3,0,3,3
70706,CAMIRI,estado nutricional en menores de 5 anos,clasificacion e,2001-06-01,6,21,6,21,27
30701,CAPINOTA,estado nutricional en menores de 5 anos,clasificacion e,2001-06-01,14,16,14,16,30
20302,CAQUIAVIRI,estado nutricional en menores de 5 anos,clasificacion e,2001-06-01,0,4,0,4,4
40102,CARACOLLO,estado nutricional en menores de 5 anos,clasificacion e,2001-06-01,0,6,0,6,6
22001,CARANAVI,estado nutricional en menores de 5 anos,clasificacion e,2001-06-01,17,36,17,36,53
60302,CARAPARI,estado nutricional en menores de 5 anos,clasificacion e,2001-06-01,0,9,0,9,9
50702,CARIPUYO,estado nutricional en menores de 5 anos,clasificacion e,2001-06-01,3,82,3,82,85
21803,CHACARILLA,estado nutricional en menores de 5 anos,clasificacion e,2001-06-01,0,2,0,2,2
40201,CHALLAPATA,estado nutricional en menores de 5 anos,clasificacion e,2001-06-01,3,1,3,1,4
50302,CHAQUI,estado nutricional en menores de 5 anos,clasificacion e,2001-06-01,0,27,0,27,27
70702,CHARAGUA,estado nutricional en menores de 5 anos,clasificacion e,2001-06-01,0,44,0,44,44
20305,CHARAÃ‘A,estado nutricional en menores de 5 anos,clasificacion e,2001-06-01,0,1,0,1,1
50202,CHAYANTA,estado nutricional en menores de 5 anos,clasificacion e,2001-06-01,0,46,0,46,46
31204,CHIMORE,estado nutricional en menores de 5 anos,clasificacion e,2001-06-01,8,24,8,24,32
40302,CHOQUE COTA,estado nutricional en menores de 5 anos,clasificacion e,2001-06-01,0,1,0,1,1
21101,CHULUMANI (V. DE LA LIBERTAD),estado nutricional en menores de 5 anos,clasificacion e,2001-06-01,0,6,0,6,6
20501,CHUMA,estado nutricional en menores de 5 anos,clasificacion e,2001-06-01,4,4,4,4,8
30801,CLIZA,estado nutricional en menores de 5 anos,clasificacion e,2001-06-01,2,13,2,13,15
90101,COBIJA,estado nutricional en menores de 5 anos,clasificacion e,2001-06-01,19,8,19,8,27
30101,COCHABAMBA,estado nutricional en menores de 5 anos,clasificacion e,2001-06-01,28,66,28,66,94
50901,"COLCHA ""K""",estado nutricional en menores de 5 anos,clasificacion e,2001-06-01,1,13,1,13,14
31002,COLOMI,estado nutricional en menores de 5 anos,clasificacion e,2001-06-01,1,21,1,21,22
70603,COLPA BELGICA,estado nutricional en menores de 5 anos,clasificacion e,2001-06-01,1,1,1,1,2
50401,COLQUECHACA,estado nutricional en menores de 5 anos,clasificacion e,2001-06-01,1,84,1,84,85
21306,COLQUENCHA,estado nutricional en menores de 5 anos,clasificacion e,2001-06-01,3,4,3,4,7
21004,COLQUIRI,estado nutricional en menores de 5 anos,clasificacion e,2001-06-01,0,94,0,94,94
20304,COMANCHE,estado nutricional en menores de 5 anos,clasificacion e,2001-06-01,0,9,0,9,9
71301,COMARAPA,estado nutricional en menores de 5 anos,clasificacion e,2001-06-01,0,6,0,6,6
20605,COMBAYA,estado nutricional en menores de 5 anos,clasificacion e,2001-06-01,0,6,0,6,6
71101,CONCEPCION,estado nutricional en menores de 5 anos,clasificacion e,2001-06-01,1,39,1,39,40
21701,COPACABANA,estado nutricional en menores de 5 anos,clasificacion e,2001-06-01,0,10,0,10,10
21402,CORIPATA,estado nutricional en menores de 5 anos,clasificacion e,2001-06-01,0,3,0,3,3
20301,CORO CORO,estado nutricional en menores de 5 anos,clasificacion e,2001-06-01,1,18,1,18,19
21401,COROICO,estado nutricional en menores de 5 anos,clasificacion e,2001-06-01,6,8,6,8,14
40301,CORQUE,estado nutricional en menores de 5 anos,clasificacion e,2001-06-01,0,8,0,8,8
50601,COTAGAITA,estado nutricional en menores de 5 anos,clasificacion e,2001-06-01,0,67,0,67,67
70102,COTOCA,estado nutricional en menores de 5 anos,clasificacion e,2001-06-01,0,2,0,2,2
31405,CUCHUMUELA (V. G. VILLARROEL),estado nutricional en menores de 5 anos,clasificacion e,2001-06-01,0,8,0,8,8
70704,CUEVO,estado nutricional en menores de 5 anos,clasificacion e,2001-06-01,9,8,9,8,17
10902,CULPINA,estado nutricional en menores de 5 anos,clasificacion e,2001-06-01,1,119,1,119,120
40401,CURAHUARA DE CARANGAS,estado nutricional en menores de 5 anos,clasificacion e,2001-06-01,3,1,3,1,4
21602,CURVA,estado nutricional en menores de 5 anos,clasificacion e,2001-06-01,0,4,0,4,4
20804,DESAGUADERO,estado nutricional en menores de 5 anos,clasificacion e,2001-06-01,6,0,6,0,6
20105,EL ALTO,estado nutricional en menores de 5 anos,clasificacion e,2001-06-01,169,368,169,368,537
71503,EL PUENTE(STC),estado nutricional en menores de 5 anos,clasificacion e,2001-06-01,0,30,0,30,30
60502,EL PUENTE(TJA),estado nutricional en menores de 5 anos,clasificacion e,2001-06-01,1,8,1,8,9
70105,EL TORNO,estado nutricional en menores de 5 anos,clasificacion e,2001-06-01,0,24,0,24,24
10405,EL VILLAR,estado nutricional en menores de 5 anos,clasificacion e,2001-06-01,0,60,0,60,60
60601,ENTRE RIOS,estado nutricional en menores de 5 anos,clasificacion e,2001-06-01,1,12,1,12,13
41101,EUCALIPTUS,estado nutricional en menores de 5 anos,clasificacion e,2001-06-01,0,4,0,4,4
80402,EXALTACION,estado nutricional en menores de 5 anos,clasificacion e,2001-06-01,0,2,0,2,2
71002,GENERAL SAAVEDRA,estado nutricional en menores de 5 anos,clasificacion e,2001-06-01,4,16,4,16,20
21601,GRAL. J.J. PEREZ (CHARAZANI),estado nutricional en menores de 5 anos,clasificacion e,2001-06-01,0,4,0,4,4
20602,GUANAY,estado nutricional en menores de 5 anos,clasificacion e,2001-06-01,4,46,4,46,50
20802,GUAQUI,estado nutricional en menores de 5 anos,clasificacion e,2001-06-01,0,3,0,3,3
80202,GUAYARAMERIN,estado nutricional en menores de 5 anos,clasificacion e,2001-06-01,2,22,2,22,24
70705,GUTIERREZ,estado nutricional en menores de 5 anos,clasificacion e,2001-06-01,5,36,5,36,41
10502,HUACARETA,estado nutricional en menores de 5 anos,clasificacion e,2001-06-01,0,52,0,52,52
11002,HUACAYA (VILLA DE HUACAYA),estado nutricional en menores de 5 anos,clasificacion e,2001-06-01,0,8,0,8,8
40501,HUACHACALLA,estado nutricional en menores de 5 anos,clasificacion e,2001-06-01,0,1,0,1,1
40701,HUANUNI,estado nutricional en menores de 5 anos,clasificacion e,2001-06-01,1,1,1,1,2
80803,HUARACAJE,estado nutricional en menores de 5 anos,clasificacion e,2001-06-01,0,6,0,6,6
41601,HUAYLLAMARCA,estado nutricional en menores de 5 anos,clasificacion e,2001-06-01,0,5,0,5,5
21005,ICHOCA,estado nutricional en menores de 5 anos,clasificacion e,2001-06-01,0,13,0,13,13
10304,ICLA,estado nutricional en menores de 5 anos,clasificacion e,2001-06-01,25,110,25,110,135
10703,INCAHUASI,estado nutricional en menores de 5 anos,clasificacion e,2001-06-01,0,132,0,132,132
21001,INQUISIVI,estado nutricional en menores de 5 anos,clasificacion e,2001-06-01,0,37,0,37,37
21102,IRUPANA (VILLA DE LANZA),estado nutricional en menores de 5 anos,clasificacion e,2001-06-01,0,6,0,6,6
21501,IXIAMAS,estado nutricional en menores de 5 anos,clasificacion e,2001-06-01,12,26,12,26,38
21105,LA ASUNTA,estado nutricional en menores de 5 anos,clasificacion e,2001-06-01,7,9,7,9,16
70104,LA GUARDIA,estado nutricional en menores de 5 anos,clasificacion e,2001-06-01,0,22,0,22,22
20101,LA PAZ,estado nutricional en menores de 5 anos,clasificacion e,2001-06-01,115,189,115,189,304
70701,LAGUNILLAS,estado nutricional en menores de 5 anos,clasificacion e,2001-06-01,5,18,5,18,23
21202,LAJA,estado nutricional en menores de 5 anos,clasificacion e,2001-06-01,0,6,0,6,6
10903,LAS CARRERAS,estado nutricional en menores de 5 anos,clasificacion e,2001-06-01,0,6,0,6,6
21006,LICOMA PAMPA,estado nutricional en menores de 5 anos,clasificacion e,2001-06-01,2,0,2,0,2
50203,LLALLAGUA,estado nutricional en menores de 5 anos,clasificacion e,2001-06-01,2,55,2,55,57
51401,LLICA,estado nutricional en menores de 5 anos,clasificacion e,2001-06-01,0,2,0,2,2
20901,LURIBAY,estado nutricional en menores de 5 anos,clasificacion e,2001-06-01,0,11,0,11,11
40702,MACHACAMARCA,estado nutricional en menores de 5 anos,clasificacion e,2001-06-01,2,1,2,1,3
11003,MACHARETI,estado nutricional en menores de 5 anos,clasificacion e,2001-06-01,1,39,1,39,40
80801,MAGDALENA,estado nutricional en menores de 5 anos,clasificacion e,2001-06-01,0,4,0,4,4
70903,MAIRANA,estado nutricional en menores de 5 anos,clasificacion e,2001-06-01,0,2,0,2,2
20904,MALLA,estado nutricional en menores de 5 anos,clasificacion e,2001-06-01,1,0,1,0,1
20103,MECAPACA,estado nutricional en menores de 5 anos,clasificacion e,2001-06-01,1,15,1,15,16
71003,MINEROS,estado nutricional en menores de 5 anos,clasificacion e,2001-06-01,0,26,0,26,26
31301,MIZQUE,estado nutricional en menores de 5 anos,clasificacion e,2001-06-01,14,22,14,22,36
20402,MOCOMOCO,estado nutricional en menores de 5 anos,clasificacion e,2001-06-01,4,5,4,5,9
51002,MOJINETE,estado nutricional en menores de 5 anos,clasificacion e,2001-06-01,0,3,0,3,3
10303,MOJOCOYA,estado nutricional en menores de 5 anos,clasificacion e,2001-06-01,0,38,0,38,38
10501,MONTEAGUDO,estado nutricional en menores de 5 anos,clasificacion e,2001-06-01,1,73,1,73,74
71001,MONTERO,estado nutricional en menores de 5 anos,clasificacion e,2001-06-01,1,53,1,53,54
30302,MOROCHATA,estado nutricional en menores de 5 anos,clasificacion e,2001-06-01,16,27,16,27,43
90401,NACEBE (SANTA ROSA DEL ABUNA),estado nutricional en menores de 5 anos,clasificacion e,2001-06-01,0,2,0,2,2
90501,NUEVO MANOA (NUEVA ESPERANZA),estado nutricional en menores de 5 anos,clasificacion e,2001-06-01,0,2,0,2,2
50404,OCURI,estado nutricional en menores de 5 anos,clasificacion e,2001-06-01,0,98,0,98,98
70202,OKINAWA,estado nutricional en menores de 5 anos,clasificacion e,2001-06-01,0,1,0,1,1
30203,OMEREQUE,estado nutricional en menores de 5 anos,clasificacion e,2001-06-01,0,11,0,11,11
40101,ORURO,estado nutricional en menores de 5 anos,clasificacion e,2001-06-01,6,196,6,196,202
60201,PADCAYA,estado nutricional en menores de 5 anos,clasificacion e,2001-06-01,2,17,2,17,19
10401,PADILLA,estado nutricional en menores de 5 anos,clasificacion e,2001-06-01,0,98,0,98,98
70502,PAILON,estado nutricional en menores de 5 anos,clasificacion e,2001-06-01,1,10,1,10,11
20102,PALCA,estado nutricional en menores de 5 anos,clasificacion e,2001-06-01,7,13,7,13,20
21104,PALOS BLANCOS,estado nutricional en menores de 5 anos,clasificacion e,2001-06-01,11,13,11,13,24
40802,PAMPA AULLAGAS,estado nutricional en menores de 5 anos,clasificacion e,2001-06-01,2,1,2,1,3
70902,PAMPA GRANDE,estado nutricional en menores de 5 anos,clasificacion e,2001-06-01,0,12,0,12,12
30202,PASORAPA,estado nutricional en menores de 5 anos,clasificacion e,2001-06-01,0,9,0,9,9
21305,PATACAMAYA,estado nutricional en menores de 5 anos,clasificacion e,2001-06-01,12,6,12,6,18
40602,PAZÃ‘A,estado nutricional en menores de 5 anos,clasificacion e,2001-06-01,0,2,0,2,2
20702,PELECHUCO,estado nutricional en menores de 5 anos,clasificacion e,2001-06-01,2,5,2,5,7
50403,POCOATA,estado nutricional en menores de 5 anos,clasificacion e,2001-06-01,13,116,13,116,129
31203,POCONA,estado nutricional en menores de 5 anos,clasificacion e,2001-06-01,1,16,1,16,17
31202,POJO (CBBA),estado nutricional en menores de 5 anos,clasificacion e,2001-06-01,2,49,2,49,51
40601,POOPO,estado nutricional en menores de 5 anos,clasificacion e,2001-06-01,0,15,0,15,15
51203,PORCO,estado nutricional en menores de 5 anos,clasificacion e,2001-06-01,0,41,0,41,41
10103,POROMA,estado nutricional en menores de 5 anos,clasificacion e,2001-06-01,1,126,1,126,127
70103,PORONGO,estado nutricional en menores de 5 anos,clasificacion e,2001-06-01,0,9,0,9,9
70601,PORTACHUELO,estado nutricional en menores de 5 anos,clasificacion e,2001-06-01,8,4,8,4,12
90102,PORVENIR,estado nutricional en menores de 5 anos,clasificacion e,2001-06-01,0,5,0,5,5
50101,POTOSI,estado nutricional en menores de 5 anos,clasificacion e,2001-06-01,8,309,8,309,317
10302,PRESTO,estado nutricional en menores de 5 anos,clasificacion e,2001-06-01,1,65,1,65,66
21201,PUCARANI,estado nutricional en menores de 5 anos,clasificacion e,2001-06-01,3,25,3,25,28
20401,PUERTO ACOSTA,estado nutricional en menores de 5 anos,clasificacion e,2001-06-01,18,20,18,20,38
20403,PUERTO CARABUCO,estado nutricional en menores de 5 anos,clasificacion e,2001-06-01,27,20,27,20,47
90301,PUERTO GONZALO MORENO,estado nutricional en menores de 5 anos,clasificacion e,2001-06-01,0,1,0,1,1
21204,PUERTO PEREZ,estado nutricional en menores de 5 anos,clasificacion e,2001-06-01,1,2,1,2,3
71402,PUERTO QUIJARRO,estado nutricional en menores de 5 anos,clasificacion e,2001-06-01,9,0,9,0,9
90201,PUERTO RICO,estado nutricional en menores de 5 anos,clasificacion e,2001-06-01,1,3,1,3,4
80703,PUERTO SILES,estado nutricional en menores de 5 anos,clasificacion e,2001-06-01,0,2,0,2,2
71401,PUERTO SUAREZ,estado nutricional en menores de 5 anos,clasificacion e,2001-06-01,17,6,17,6,23
31205,PUERTO VILLARROEL,estado nutricional en menores de 5 anos,clasificacion e,2001-06-01,25,34,25,34,59
51101,PUNA,estado nutricional en menores de 5 anos,clasificacion e,2001-06-01,4,114,4,114,118
31401,PUNATA,estado nutricional en menores de 5 anos,clasificacion e,2001-06-01,63,220,63,220,283
20604,QUIABAYA,estado nutricional en menores de 5 anos,clasificacion e,2001-06-01,0,15,0,15,15
21002,QUIME,estado nutricional en menores de 5 anos,clasificacion e,2001-06-01,16,12,16,12,28
50402,RAVELO,estado nutricional en menores de 5 anos,clasificacion e,2001-06-01,2,215,2,215,217
80301,REYES,estado nutricional en menores de 5 anos,clasificacion e,2001-06-01,0,16,0,16,16
80201,RIBERALTA,estado nutricional en menores de 5 anos,clasificacion e,2001-06-01,2,38,2,38,40
70503,ROBORE,estado nutricional en menores de 5 anos,clasificacion e,2001-06-01,0,17,0,17,17
80304,RURRENABAQUE,estado nutricional en menores de 5 anos,clasificacion e,2001-06-01,5,2,5,2,7
31001,SACABA,estado nutricional en menores de 5 anos,clasificacion e,2001-06-01,40,56,40,56,96
30404,SACABAMBA,estado nutricional en menores de 5 anos,clasificacion e,2001-06-01,0,27,0,27,27
50701,SACACA,estado nutricional en menores de 5 anos,clasificacion e,2001-06-01,4,197,4,197,201
71302,SAIPINA,estado nutricional en menores de 5 anos,clasificacion e,2001-06-01,0,6,0,6,6
40801,SALINAS DE GARCI MENDOZA,estado nutricional en menores de 5 anos,clasificacion e,2001-06-01,1,0,1,0,1
70901,SAMAIPATA,estado nutricional en menores de 5 anos,clasificacion e,2001-06-01,0,4,0,4,4
80602,SAN ANDRES,estado nutricional en menores de 5 anos,clasificacion e,2001-06-01,0,1,0,1,1
51003,SAN ANTONIO DE ESMORUCO,estado nutricional en menores de 5 anos,clasificacion e,2001-06-01,0,2,0,2,2
71105,SAN ANTONIO DE LOMERIO,estado nutricional en menores de 5 anos,clasificacion e,2001-06-01,13,65,13,65,78
31403,SAN BENITO,estado nutricional en menores de 5 anos,clasificacion e,2001-06-01,0,14,0,14,14
80302,SAN BORJA,estado nutricional en menores de 5 anos,clasificacion e,2001-06-01,1,15,1,15,16
21502,SAN BUENA VENTURA,estado nutricional en menores de 5 anos,clasificacion e,2001-06-01,0,11,0,11,11
70402,SAN CARLOS,estado nutricional en menores de 5 anos,clasificacion e,2001-06-01,2,21,2,21,23
80501,SAN IGNACIO,estado nutricional en menores de 5 anos,clasificacion e,2001-06-01,0,99,0,99,99
70301,SAN IGNACIO DE VELASCO,estado nutricional en menores de 5 anos,clasificacion e,2001-06-01,17,107,17,107,124
80102,SAN JAVIER(BNI),estado nutricional en menores de 5 anos,clasificacion e,2001-06-01,0,1,0,1,1
71102,SAN JAVIER(STC),estado nutricional en menores de 5 anos,clasificacion e,2001-06-01,2,11,2,11,13
80701,SAN JOAQUIN,estado nutricional en menores de 5 anos,clasificacion e,2001-06-01,1,0,1,0,1
70501,SAN JOSE DE CHIQUITOS,estado nutricional en menores de 5 anos,clasificacion e,2001-06-01,8,8,8,8,16
71104,SAN JULIAN,estado nutricional en menores de 5 anos,clasificacion e,2001-06-01,14,87,14,87,101
90302,SAN LORENZO(PND),estado nutricional en menores de 5 anos,clasificacion e,2001-06-01,0,3,0,3,3
60501,SAN LORENZO(TJA),estado nutricional en menores de 5 anos,clasificacion e,2001-06-01,0,4,0,4,4
10702,SAN LUCAS,estado nutricional en menores de 5 anos,clasificacion e,2001-06-01,1,263,1,263,264
71201,SAN MATIAS,estado nutricional en menores de 5 anos,clasificacion e,2001-06-01,0,36,0,36,36
70302,SAN MIGUEL DE VELASCO,estado nutricional en menores de 5 anos,clasificacion e,2001-06-01,0,12,0,12,12
51001,SAN PABLO DE LIPEZ,estado nutricional en menores de 5 anos,clasificacion e,2001-06-01,0,3,0,3,3
50501,SAN PEDRO DE BUENA VISTA,estado nutricional en menores de 5 anos,clasificacion e,2001-06-01,3,188,3,188,191
21801,SAN PEDRO DE CURAHUARA,estado nutricional en menores de 5 anos,clasificacion e,2001-06-01,0,7,0,7,7
90202,SAN PEDRO(PND),estado nutricional en menores de 5 anos,clasificacion e,2001-06-01,0,3,0,3,3
70303,SAN RAFAEL,estado nutricional en menores de 5 anos,clasificacion e,2001-06-01,1,7,1,7,8
80702,SAN RAMON,estado nutricional en menores de 5 anos,clasificacion e,2001-06-01,1,2,1,2,3
80702,SAN RAMON,estado nutricional en menores de 5 anos,clasificacion e,2001-06-01,3,4,3,4,7
70101,SANTA CRUZ DE LA SIERRA,estado nutricional en menores de 5 anos,clasificacion e,2001-06-01,25,60,25,60,85
80303,SANTA ROSA,estado nutricional en menores de 5 anos,clasificacion e,2001-06-01,1,1,1,1,2
70602,SANTA ROSA DEL SARA,estado nutricional en menores de 5 anos,clasificacion e,2001-06-01,0,4,0,4,4
20308,SANTIAGO DE CALLAPA,estado nutricional en menores de 5 anos,clasificacion e,2001-06-01,4,1,4,1,5
41401,SANTIAGO DE HUARI,estado nutricional en menores de 5 anos,clasificacion e,2001-06-01,0,1,0,1,1
21901,SANTIAGO DE MACHACA,estado nutricional en menores de 5 anos,clasificacion e,2001-06-01,2,5,2,5,7
30702,SANTIVAÃ‘ES,estado nutricional en menores de 5 anos,clasificacion e,2001-06-01,0,14,0,14,14
40202,SANTUARIO DE QUILLACAS,estado nutricional en menores de 5 anos,clasificacion e,2001-06-01,2,4,2,4,6
20902,SAPAHAQUI,estado nutricional en menores de 5 anos,clasificacion e,2001-06-01,0,7,0,7,7
90303,SENA,estado nutricional en menores de 5 anos,clasificacion e,2001-06-01,0,2,0,2,2
21301,SICA SICA (VILLA AROMA),estado nutricional en menores de 5 anos,clasificacion e,2001-06-01,2,8,2,8,10
30703,SICAYA,estado nutricional en menores de 5 anos,clasificacion e,2001-06-01,0,9,0,9,9
30902,SIPE SIPE,estado nutricional en menores de 5 anos,clasificacion e,2001-06-01,2,27,2,27,29
10403,SOPACHUY,estado nutricional en menores de 5 anos,clasificacion e,2001-06-01,1,98,1,98,99
20601,SORATA,estado nutricional en menores de 5 anos,clasificacion e,2001-06-01,0,19,0,19,19
10101,SUCRE,estado nutricional en menores de 5 anos,clasificacion e,2001-06-01,10,349,10,349,359
31404,TACACHI,estado nutricional en menores de 5 anos,clasificacion e,2001-06-01,0,3,0,3,3
20603,TACACOMA,estado nutricional en menores de 5 anos,clasificacion e,2001-06-01,0,7,0,7,7
50303,TACOBAMBA,estado nutricional en menores de 5 anos,clasificacion e,2001-06-01,0,27,0,27,27
30602,TACOPAYA,estado nutricional en menores de 5 anos,clasificacion e,2001-06-01,1,5,1,5,6
31101,TAPACARI,estado nutricional en menores de 5 anos,clasificacion e,2001-06-01,0,72,0,72,72
10601,TARABUCO,estado nutricional en menores de 5 anos,clasificacion e,2001-06-01,0,251,0,251,251
30401,TARATA,estado nutricional en menores de 5 anos,clasificacion e,2001-06-01,0,10,0,10,10
60101,TARIJA,estado nutricional en menores de 5 anos,clasificacion e,2001-06-01,3,47,3,47,50
10202,TARVITA,estado nutricional en menores de 5 anos,clasificacion e,2001-06-01,0,67,0,67,67
20803,TIAWANACU,estado nutricional en menores de 5 anos,clasificacion e,2001-06-01,0,1,0,1,1
50102,TINGUIPAYA,estado nutricional en menores de 5 anos,clasificacion e,2001-06-01,4,67,4,67,71
20606,TIPUANI,estado nutricional en menores de 5 anos,clasificacion e,2001-06-01,6,5,6,5,11
31601,TIRAQUE (CBBA),estado nutricional en menores de 5 anos,clasificacion e,2001-06-01,20,68,20,68,88
30802,TOCO,estado nutricional en menores de 5 anos,clasificacion e,2001-06-01,0,7,0,7,7
41001,TOLEDO,estado nutricional en menores de 5 anos,clasificacion e,2001-06-01,0,1,0,1,1
51202,TOMAVE,estado nutricional en menores de 5 anos,clasificacion e,2001-06-01,0,62,0,62,62
10402,TOMINA,estado nutricional en menores de 5 anos,clasificacion e,2001-06-01,1,89,1,89,90
31201,TOTORA(CBBA),estado nutricional en menores de 5 anos,clasificacion e,2001-06-01,0,23,0,23,23
41301,TOTORA(ORR),estado nutricional en menores de 5 anos,clasificacion e,2001-06-01,0,18,0,18,18
70802,TRIGAL,estado nutricional en menores de 5 anos,clasificacion e,2001-06-01,0,1,0,1,1
80101,TRINIDAD,estado nutricional en menores de 5 anos,clasificacion e,2001-06-01,6,49,6,49,55
50801,TUPIZA,estado nutricional en menores de 5 anos,clasificacion e,2001-06-01,0,77,0,77,77
40402,TURCO,estado nutricional en menores de 5 anos,clasificacion e,2001-06-01,1,1,1,1,2
21302,UMALA,estado nutricional en menores de 5 anos,clasificacion e,2001-06-01,0,3,0,3,3
50201,UNCIA,estado nutricional en menores de 5 anos,clasificacion e,2001-06-01,1,9,1,9,10
60401,URIONDO (A. CONCEPCION),estado nutricional en menores de 5 anos,clasificacion e,2001-06-01,0,2,0,2,2
71502,URUBICHA,estado nutricional en menores de 5 anos,clasificacion e,2001-06-01,0,13,0,13,13
51201,UYUNI,estado nutricional en menores de 5 anos,clasificacion e,2001-06-01,0,26,0,26,26
30502,VACAS,estado nutricional en menores de 5 anos,clasificacion e,2001-06-01,2,10,2,10,12
70801,VALLEGRANDE,estado nutricional en menores de 5 anos,clasificacion e,2001-06-01,6,18,6,18,24
20801,VIACHA,estado nutricional en menores de 5 anos,clasificacion e,2001-06-01,0,26,0,26,26
31302,VILA VILA,estado nutricional en menores de 5 anos,clasificacion e,2001-06-01,8,6,8,6,14
60303,VILLA MONTES,estado nutricional en menores de 5 anos,clasificacion e,2001-06-01,5,12,5,12,17
31402,VILLA RIVERO,estado nutricional en menores de 5 anos,clasificacion e,2001-06-01,0,12,0,12,12
10801,VILLA SERRANO,estado nutricional en menores de 5 anos,clasificacion e,2001-06-01,2,90,2,90,92
31003,VILLA TUNARI,estado nutricional en menores de 5 anos,clasificacion e,2001-06-01,14,15,14,15,29
11001,VILLA VACA GUZMAN (MUYUPAMPA),estado nutricional en menores de 5 anos,clasificacion e,2001-06-01,0,24,0,24,24
51501,VILLAZON,estado nutricional en menores de 5 anos,clasificacion e,2001-06-01,0,53,0,53,53
50602,VITICHI,estado nutricional en menores de 5 anos,clasificacion e,2001-06-01,0,27,0,27,27
70201,WARNES,estado nutricional en menores de 5 anos,clasificacion e,2001-06-01,2,18,2,18,20
20903,YACO,estado nutricional en menores de 5 anos,clasificacion e,2001-06-01,0,5,0,5,5
60301,YACUIBA,estado nutricional en menores de 5 anos,clasificacion e,2001-06-01,1,16,1,16,17
10602,YAMPARAEZ,estado nutricional en menores de 5 anos,clasificacion e,2001-06-01,5,105,5,105,110
21103,YANACACHI,estado nutricional en menores de 5 anos,clasificacion e,2001-06-01,0,1,0,1,1
70403,YAPACANI,estado nutricional en menores de 5 anos,clasificacion e,2001-06-01,3,38,3,38,41
50103,YOCALLA,estado nutricional en menores de 5 anos,clasificacion e,2001-06-01,0,22,0,22,22
10102,YOTALA,estado nutricional en menores de 5 anos,clasificacion e,2001-06-01,0,82,0,82,82
60402,YUNCHARA,estado nutricional en menores de 5 anos,clasificacion e,2001-06-01,0,13,0,13,13
10301,ZUDAÃ‘EZ,estado nutricional en menores de 5 anos,clasificacion e,2001-06-01,0,45,0,45,45
51302,ACACIO,estado nutricional en menores de 5 anos,clasificacion e,2001-07-01,0,39,0,39,39
20201,ACHACACHI,estado nutricional en menores de 5 anos,clasificacion e,2001-07-01,0,34,0,34,34
20104,ACHOCALLA,estado nutricional en menores de 5 anos,clasificacion e,2001-07-01,0,7,0,7,7
30201,AIQUILE,estado nutricional en menores de 5 anos,clasificacion e,2001-07-01,6,26,6,26,32
31303,ALALAY,estado nutricional en menores de 5 anos,clasificacion e,2001-07-01,5,1,5,1,6
10404,ALCALA,estado nutricional en menores de 5 anos,clasificacion e,2001-07-01,0,23,0,23,23
20202,ANCORAIMES,estado nutricional en menores de 5 anos,clasificacion e,2001-07-01,0,46,0,46,46
30402,ANZALDO,estado nutricional en menores de 5 anos,clasificacion e,2001-07-01,0,30,0,30,30
20701,APOLO,estado nutricional en menores de 5 anos,clasificacion e,2001-07-01,5,0,5,0,5
51301,ARAMPAMPA,estado nutricional en menores de 5 anos,clasificacion e,2001-07-01,0,43,0,43,43
30501,ARANI,estado nutricional en menores de 5 anos,clasificacion e,2001-07-01,0,13,0,13,13
30403,ARBIETO,estado nutricional en menores de 5 anos,clasificacion e,2001-07-01,0,12,0,12,12
30601,ARQUE,estado nutricional en menores de 5 anos,clasificacion e,2001-07-01,2,14,2,14,16
71501,ASCENCION DE GUARAYOS,estado nutricional en menores de 5 anos,clasificacion e,2001-07-01,0,9,0,9,9
50802,ATOCHA,estado nutricional en menores de 5 anos,clasificacion e,2001-07-01,0,16,0,16,16
20503,AUCAPATA,estado nutricional en menores de 5 anos,clasificacion e,2001-07-01,0,2,0,2,2
21303,AYO AYO,estado nutricional en menores de 5 anos,clasificacion e,2001-07-01,0,6,0,6,6
30301,AYOPAYA (V. DE INDEPENDENCIA),estado nutricional en menores de 5 anos,clasificacion e,2001-07-01,21,35,21,35,56
10201,AZURDUY,estado nutricional en menores de 5 anos,clasificacion e,2001-07-01,0,40,0,40,40
21203,BATALLAS,estado nutricional en menores de 5 anos,clasificacion e,2001-07-01,0,15,0,15,15
80802,BAURES,estado nutricional en menores de 5 anos,clasificacion e,2001-07-01,6,2,6,2,8
41202,BELEN DE ANDAMARCA,estado nutricional en menores de 5 anos,clasificacion e,2001-07-01,0,1,0,1,1
50104,BELEN DE URMIRI,estado nutricional en menores de 5 anos,clasificacion e,2001-07-01,0,4,0,4,4
90104,BELLA FLOR,estado nutricional en menores de 5 anos,clasificacion e,2001-07-01,0,6,0,6,6
60202,BERMEJO,estado nutricional en menores de 5 anos,clasificacion e,2001-07-01,0,1,0,1,1
50301,BETANZOS,estado nutricional en menores de 5 anos,clasificacion e,2001-07-01,1,176,1,176,177
31501,BOLIVAR,estado nutricional en menores de 5 anos,clasificacion e,2001-07-01,0,50,0,50,50
90103,BOLPEBRA,estado nutricional en menores de 5 anos,clasificacion e,2001-07-01,0,1,0,1,1
70707,BOYUIBE,estado nutricional en menores de 5 anos,clasificacion e,2001-07-01,0,2,0,2,2
70401,BUENA VISTA,estado nutricional en menores de 5 anos,clasificacion e,2001-07-01,2,8,2,8,10
70703,CABEZAS,estado nutricional en menores de 5 anos,clasificacion e,2001-07-01,1,26,1,26,27
20905,CAIROMA,estado nutricional en menores de 5 anos,clasificacion e,2001-07-01,0,27,0,27,27
51102,"CAIZA ""D""",estado nutricional en menores de 5 anos,clasificacion e,2001-07-01,0,50,0,50,50
21003,CAJUATA,estado nutricional en menores de 5 anos,clasificacion e,2001-07-01,6,2,6,2,8
20303,CALACOTO,estado nutricional en menores de 5 anos,clasificacion e,2001-07-01,1,7,1,7,8
21304,CALAMARCA,estado nutricional en menores de 5 anos,clasificacion e,2001-07-01,3,4,3,4,7
10701,CAMARGO,estado nutricional en menores de 5 anos,clasificacion e,2001-07-01,0,21,0,21,21
10901,CAMATAQUI (C. VILLA ABECIA),estado nutricional en menores de 5 anos,clasificacion e,2001-07-01,0,15,0,15,15
70706,CAMIRI,estado nutricional en menores de 5 anos,clasificacion e,2001-07-01,27,22,27,22,49
30701,CAPINOTA,estado nutricional en menores de 5 anos,clasificacion e,2001-07-01,13,25,13,25,38
20302,CAQUIAVIRI,estado nutricional en menores de 5 anos,clasificacion e,2001-07-01,0,4,0,4,4
40102,CARACOLLO,estado nutricional en menores de 5 anos,clasificacion e,2001-07-01,0,2,0,2,2
22001,CARANAVI,estado nutricional en menores de 5 anos,clasificacion e,2001-07-01,25,41,25,41,66
60302,CARAPARI,estado nutricional en menores de 5 anos,clasificacion e,2001-07-01,2,11,2,11,13
50702,CARIPUYO,estado nutricional en menores de 5 anos,clasificacion e,2001-07-01,0,26,0,26,26
40201,CHALLAPATA,estado nutricional en menores de 5 anos,clasificacion e,2001-07-01,10,5,10,5,15
50302,CHAQUI,estado nutricional en menores de 5 anos,clasificacion e,2001-07-01,0,34,0,34,34
70702,CHARAGUA,estado nutricional en menores de 5 anos,clasificacion e,2001-07-01,0,44,0,44,44
20305,CHARAÃ‘A,estado nutricional en menores de 5 anos,clasificacion e,2001-07-01,0,2,0,2,2
50202,CHAYANTA,estado nutricional en menores de 5 anos,clasificacion e,2001-07-01,0,54,0,54,54
31204,CHIMORE,estado nutricional en menores de 5 anos,clasificacion e,2001-07-01,10,25,10,25,35
40302,CHOQUE COTA,estado nutricional en menores de 5 anos,clasificacion e,2001-07-01,0,4,0,4,4
21101,CHULUMANI (V. DE LA LIBERTAD),estado nutricional en menores de 5 anos,clasificacion e,2001-07-01,0,3,0,3,3
20501,CHUMA,estado nutricional en menores de 5 anos,clasificacion e,2001-07-01,7,4,7,4,11
30801,CLIZA,estado nutricional en menores de 5 anos,clasificacion e,2001-07-01,0,10,0,10,10
90101,COBIJA,estado nutricional en menores de 5 anos,clasificacion e,2001-07-01,14,14,14,14,28
30101,COCHABAMBA,estado nutricional en menores de 5 anos,clasificacion e,2001-07-01,38,31,38,31,69
30905,COLCAPIRHUA,estado nutricional en menores de 5 anos,clasificacion e,2001-07-01,1,0,1,0,1
50901,"COLCHA ""K""",estado nutricional en menores de 5 anos,clasificacion e,2001-07-01,0,9,0,9,9
31002,COLOMI,estado nutricional en menores de 5 anos,clasificacion e,2001-07-01,3,77,3,77,80
50401,COLQUECHACA,estado nutricional en menores de 5 anos,clasificacion e,2001-07-01,0,23,0,23,23
21306,COLQUENCHA,estado nutricional en menores de 5 anos,clasificacion e,2001-07-01,3,1,3,1,4
21004,COLQUIRI,estado nutricional en menores de 5 anos,clasificacion e,2001-07-01,2,83,2,83,85
20304,COMANCHE,estado nutricional en menores de 5 anos,clasificacion e,2001-07-01,2,4,2,4,6
71301,COMARAPA,estado nutricional en menores de 5 anos,clasificacion e,2001-07-01,1,18,1,18,19
20605,COMBAYA,estado nutricional en menores de 5 anos,clasificacion e,2001-07-01,0,4,0,4,4
71101,CONCEPCION,estado nutricional en menores de 5 anos,clasificacion e,2001-07-01,0,1,0,1,1
21701,COPACABANA,estado nutricional en menores de 5 anos,clasificacion e,2001-07-01,0,6,0,6,6
21402,CORIPATA,estado nutricional en menores de 5 anos,clasificacion e,2001-07-01,0,3,0,3,3
20301,CORO CORO,estado nutricional en menores de 5 anos,clasificacion e,2001-07-01,1,10,1,10,11
21401,COROICO,estado nutricional en menores de 5 anos,clasificacion e,2001-07-01,8,5,8,5,13
40301,CORQUE,estado nutricional en menores de 5 anos,clasificacion e,2001-07-01,0,12,0,12,12
50601,COTAGAITA,estado nutricional en menores de 5 anos,clasificacion e,2001-07-01,1,44,1,44,45
70102,COTOCA,estado nutricional en menores de 5 anos,clasificacion e,2001-07-01,0,3,0,3,3
31405,CUCHUMUELA (V. G. VILLARROEL),estado nutricional en menores de 5 anos,clasificacion e,2001-07-01,0,1,0,1,1
70704,CUEVO,estado nutricional en menores de 5 anos,clasificacion e,2001-07-01,7,7,7,7,14
10902,CULPINA,estado nutricional en menores de 5 anos,clasificacion e,2001-07-01,1,71,1,71,72
40401,CURAHUARA DE CARANGAS,estado nutricional en menores de 5 anos,clasificacion e,2001-07-01,4,3,4,3,7
21602,CURVA,estado nutricional en menores de 5 anos,clasificacion e,2001-07-01,3,0,3,0,3
20804,DESAGUADERO,estado nutricional en menores de 5 anos,clasificacion e,2001-07-01,2,6,2,6,8
20105,EL ALTO,estado nutricional en menores de 5 anos,clasificacion e,2001-07-01,255,400,255,400,655
71503,EL PUENTE(STC),estado nutricional en menores de 5 anos,clasificacion e,2001-07-01,4,27,4,27,31
60502,EL PUENTE(TJA),estado nutricional en menores de 5 anos,clasificacion e,2001-07-01,2,8,2,8,10
70105,EL TORNO,estado nutricional en menores de 5 anos,clasificacion e,2001-07-01,1,29,1,29,30
10405,EL VILLAR,estado nutricional en menores de 5 anos,clasificacion e,2001-07-01,0,60,0,60,60
60601,ENTRE RIOS,estado nutricional en menores de 5 anos,clasificacion e,2001-07-01,1,17,1,17,18
41101,EUCALIPTUS,estado nutricional en menores de 5 anos,clasificacion e,2001-07-01,0,10,0,10,10
71002,GENERAL SAAVEDRA,estado nutricional en menores de 5 anos,clasificacion e,2001-07-01,0,20,0,20,20
21601,GRAL. J.J. PEREZ (CHARAZANI),estado nutricional en menores de 5 anos,clasificacion e,2001-07-01,1,1,1,1,2
20602,GUANAY,estado nutricional en menores de 5 anos,clasificacion e,2001-07-01,3,50,3,50,53
20802,GUAQUI,estado nutricional en menores de 5 anos,clasificacion e,2001-07-01,1,5,1,5,6
80202,GUAYARAMERIN,estado nutricional en menores de 5 anos,clasificacion e,2001-07-01,2,31,2,31,33
70705,GUTIERREZ,estado nutricional en menores de 5 anos,clasificacion e,2001-07-01,5,42,5,42,47
10502,HUACARETA,estado nutricional en menores de 5 anos,clasificacion e,2001-07-01,0,36,0,36,36
40501,HUACHACALLA,estado nutricional en menores de 5 anos,clasificacion e,2001-07-01,1,0,1,0,1
40701,HUANUNI,estado nutricional en menores de 5 anos,clasificacion e,2001-07-01,0,13,0,13,13
80803,HUARACAJE,estado nutricional en menores de 5 anos,clasificacion e,2001-07-01,0,7,0,7,7
41601,HUAYLLAMARCA,estado nutricional en menores de 5 anos,clasificacion e,2001-07-01,0,2,0,2,2
21005,ICHOCA,estado nutricional en menores de 5 anos,clasificacion e,2001-07-01,0,6,0,6,6
10304,ICLA,estado nutricional en menores de 5 anos,clasificacion e,2001-07-01,46,58,46,58,104
10703,INCAHUASI,estado nutricional en menores de 5 anos,clasificacion e,2001-07-01,1,110,1,110,111
21001,INQUISIVI,estado nutricional en menores de 5 anos,clasificacion e,2001-07-01,0,45,0,45,45
21102,IRUPANA (VILLA DE LANZA),estado nutricional en menores de 5 anos,clasificacion e,2001-07-01,0,12,0,12,12
21501,IXIAMAS,estado nutricional en menores de 5 anos,clasificacion e,2001-07-01,1,12,1,12,13
21105,LA ASUNTA,estado nutricional en menores de 5 anos,clasificacion e,2001-07-01,7,9,7,9,16
70104,LA GUARDIA,estado nutricional en menores de 5 anos,clasificacion e,2001-07-01,0,21,0,21,21
20101,LA PAZ,estado nutricional en menores de 5 anos,clasificacion e,2001-07-01,138,198,138,198,336
70701,LAGUNILLAS,estado nutricional en menores de 5 anos,clasificacion e,2001-07-01,2,5,2,5,7
21202,LAJA,estado nutricional en menores de 5 anos,clasificacion e,2001-07-01,0,12,0,12,12
10903,LAS CARRERAS,estado nutricional en menores de 5 anos,clasificacion e,2001-07-01,0,39,0,39,39
21006,LICOMA PAMPA,estado nutricional en menores de 5 anos,clasificacion e,2001-07-01,2,0,2,0,2
50203,LLALLAGUA,estado nutricional en menores de 5 anos,clasificacion e,2001-07-01,2,48,2,48,50
51401,LLICA,estado nutricional en menores de 5 anos,clasificacion e,2001-07-01,0,3,0,3,3
80601,LORETO,estado nutricional en menores de 5 anos,clasificacion e,2001-07-01,0,4,0,4,4
20901,LURIBAY,estado nutricional en menores de 5 anos,clasificacion e,2001-07-01,0,4,0,4,4
11003,MACHARETI,estado nutricional en menores de 5 anos,clasificacion e,2001-07-01,0,23,0,23,23
80801,MAGDALENA,estado nutricional en menores de 5 anos,clasificacion e,2001-07-01,0,4,0,4,4
70903,MAIRANA,estado nutricional en menores de 5 anos,clasificacion e,2001-07-01,0,7,0,7,7
20103,MECAPACA,estado nutricional en menores de 5 anos,clasificacion e,2001-07-01,0,8,0,8,8
71003,MINEROS,estado nutricional en menores de 5 anos,clasificacion e,2001-07-01,4,32,4,32,36
31301,MIZQUE,estado nutricional en menores de 5 anos,clasificacion e,2001-07-01,35,16,35,16,51
20402,MOCOMOCO,estado nutricional en menores de 5 anos,clasificacion e,2001-07-01,5,7,5,7,12
51002,MOJINETE,estado nutricional en menores de 5 anos,clasificacion e,2001-07-01,0,6,0,6,6
10303,MOJOCOYA,estado nutricional en menores de 5 anos,clasificacion e,2001-07-01,1,34,1,34,35
10501,MONTEAGUDO,estado nutricional en menores de 5 anos,clasificacion e,2001-07-01,3,81,3,81,84
71001,MONTERO,estado nutricional en menores de 5 anos,clasificacion e,2001-07-01,8,71,8,71,79
70803,MORO MORO,estado nutricional en menores de 5 anos,clasificacion e,2001-07-01,4,0,4,0,4
30302,MOROCHATA,estado nutricional en menores de 5 anos,clasificacion e,2001-07-01,11,13,11,13,24
90401,NACEBE (SANTA ROSA DEL ABUNA),estado nutricional en menores de 5 anos,clasificacion e,2001-07-01,0,2,0,2,2
50404,OCURI,estado nutricional en menores de 5 anos,clasificacion e,2001-07-01,1,37,1,37,38
70202,OKINAWA,estado nutricional en menores de 5 anos,clasificacion e,2001-07-01,0,2,0,2,2
30203,OMEREQUE,estado nutricional en menores de 5 anos,clasificacion e,2001-07-01,0,3,0,3,3
40101,ORURO,estado nutricional en menores de 5 anos,clasificacion e,2001-07-01,12,156,12,156,168
60201,PADCAYA,estado nutricional en menores de 5 anos,clasificacion e,2001-07-01,1,27,1,27,28
10401,PADILLA,estado nutricional en menores de 5 anos,clasificacion e,2001-07-01,1,126,1,126,127
70502,PAILON,estado nutricional en menores de 5 anos,clasificacion e,2001-07-01,1,19,1,19,20
20102,PALCA,estado nutricional en menores de 5 anos,clasificacion e,2001-07-01,6,5,6,5,11
21104,PALOS BLANCOS,estado nutricional en menores de 5 anos,clasificacion e,2001-07-01,6,24,6,24,30
40802,PAMPA AULLAGAS,estado nutricional en menores de 5 anos,clasificacion e,2001-07-01,4,2,4,2,6
70902,PAMPA GRANDE,estado nutricional en menores de 5 anos,clasificacion e,2001-07-01,0,4,0,4,4
30202,PASORAPA,estado nutricional en menores de 5 anos,clasificacion e,2001-07-01,0,6,0,6,6
21305,PATACAMAYA,estado nutricional en menores de 5 anos,clasificacion e,2001-07-01,10,12,10,12,22
40602,PAZÃ‘A,estado nutricional en menores de 5 anos,clasificacion e,2001-07-01,1,2,1,2,3
20702,PELECHUCO,estado nutricional en menores de 5 anos,clasificacion e,2001-07-01,1,2,1,2,3
50403,POCOATA,estado nutricional en menores de 5 anos,clasificacion e,2001-07-01,6,39,6,39,45
31203,POCONA,estado nutricional en menores de 5 anos,clasificacion e,2001-07-01,3,1,3,1,4
31202,POJO (CBBA),estado nutricional en menores de 5 anos,clasificacion e,2001-07-01,12,34,12,34,46
40601,POOPO,estado nutricional en menores de 5 anos,clasificacion e,2001-07-01,0,9,0,9,9
51203,PORCO,estado nutricional en menores de 5 anos,clasificacion e,2001-07-01,0,10,0,10,10
10103,POROMA,estado nutricional en menores de 5 anos,clasificacion e,2001-07-01,0,156,0,156,156
70103,PORONGO,estado nutricional en menores de 5 anos,clasificacion e,2001-07-01,0,5,0,5,5
70601,PORTACHUELO,estado nutricional en menores de 5 anos,clasificacion e,2001-07-01,4,6,4,6,10
70804,POSTRER VALLE,estado nutricional en menores de 5 anos,clasificacion e,2001-07-01,0,1,0,1,1
50101,POTOSI,estado nutricional en menores de 5 anos,clasificacion e,2001-07-01,4,233,4,233,237
10302,PRESTO,estado nutricional en menores de 5 anos,clasificacion e,2001-07-01,1,36,1,36,37
21201,PUCARANI,estado nutricional en menores de 5 anos,clasificacion e,2001-07-01,0,14,0,14,14
20401,PUERTO ACOSTA,estado nutricional en menores de 5 anos,clasificacion e,2001-07-01,15,13,15,13,28
20403,PUERTO CARABUCO,estado nutricional en menores de 5 anos,clasificacion e,2001-07-01,21,21,21,21,42
90301,PUERTO GONZALO MORENO,estado nutricional en menores de 5 anos,clasificacion e,2001-07-01,0,7,0,7,7
21204,PUERTO PEREZ,estado nutricional en menores de 5 anos,clasificacion e,2001-07-01,0,2,0,2,2
71402,PUERTO QUIJARRO,estado nutricional en menores de 5 anos,clasificacion e,2001-07-01,7,0,7,0,7
90201,PUERTO RICO,estado nutricional en menores de 5 anos,clasificacion e,2001-07-01,7,6,7,6,13
80703,PUERTO SILES,estado nutricional en menores de 5 anos,clasificacion e,2001-07-01,0,2,0,2,2
71401,PUERTO SUAREZ,estado nutricional en menores de 5 anos,clasificacion e,2001-07-01,13,2,13,2,15
31205,PUERTO VILLARROEL,estado nutricional en menores de 5 anos,clasificacion e,2001-07-01,28,32,28,32,60
51101,PUNA,estado nutricional en menores de 5 anos,clasificacion e,2001-07-01,3,78,3,78,81
31401,PUNATA,estado nutricional en menores de 5 anos,clasificacion e,2001-07-01,110,212,110,212,322
20604,QUIABAYA,estado nutricional en menores de 5 anos,clasificacion e,2001-07-01,0,6,0,6,6
30901,QUILLACOLLO,estado nutricional en menores de 5 anos,clasificacion e,2001-07-01,1,1,1,1,2
21002,QUIME,estado nutricional en menores de 5 anos,clasificacion e,2001-07-01,9,14,9,14,23
70904,QUIRUSILLAS,estado nutricional en menores de 5 anos,clasificacion e,2001-07-01,0,1,0,1,1
50402,RAVELO,estado nutricional en menores de 5 anos,clasificacion e,2001-07-01,1,87,1,87,88
80301,REYES,estado nutricional en menores de 5 anos,clasificacion e,2001-07-01,0,8,0,8,8
80201,RIBERALTA,estado nutricional en menores de 5 anos,clasificacion e,2001-07-01,3,123,3,123,126
70503,ROBORE,estado nutricional en menores de 5 anos,clasificacion e,2001-07-01,0,27,0,27,27
80304,RURRENABAQUE,estado nutricional en menores de 5 anos,clasificacion e,2001-07-01,4,4,4,4,8
40901,SABAYA,estado nutricional en menores de 5 anos,clasificacion e,2001-07-01,0,2,0,2,2
31001,SACABA,estado nutricional en menores de 5 anos,clasificacion e,2001-07-01,9,65,9,65,74
30404,SACABAMBA,estado nutricional en menores de 5 anos,clasificacion e,2001-07-01,0,25,0,25,25
50701,SACACA,estado nutricional en menores de 5 anos,clasificacion e,2001-07-01,2,36,2,36,38
71302,SAIPINA,estado nutricional en menores de 5 anos,clasificacion e,2001-07-01,0,3,0,3,3
40801,SALINAS DE GARCI MENDOZA,estado nutricional en menores de 5 anos,clasificacion e,2001-07-01,5,3,5,3,8
51601,SAN AGUSTIN,estado nutricional en menores de 5 anos,clasificacion e,2001-07-01,0,2,0,2,2
80602,SAN ANDRES,estado nutricional en menores de 5 anos,clasificacion e,2001-07-01,0,7,0,7,7
51003,SAN ANTONIO DE ESMORUCO,estado nutricional en menores de 5 anos,clasificacion e,2001-07-01,0,2,0,2,2
71105,SAN ANTONIO DE LOMERIO,estado nutricional en menores de 5 anos,clasificacion e,2001-07-01,32,61,32,61,93
31403,SAN BENITO,estado nutricional en menores de 5 anos,clasificacion e,2001-07-01,0,5,0,5,5
80302,SAN BORJA,estado nutricional en menores de 5 anos,clasificacion e,2001-07-01,2,33,2,33,35
21502,SAN BUENA VENTURA,estado nutricional en menores de 5 anos,clasificacion e,2001-07-01,1,16,1,16,17
70402,SAN CARLOS,estado nutricional en menores de 5 anos,clasificacion e,2001-07-01,1,22,1,22,23
80501,SAN IGNACIO,estado nutricional en menores de 5 anos,clasificacion e,2001-07-01,0,36,0,36,36
70301,SAN IGNACIO DE VELASCO,estado nutricional en menores de 5 anos,clasificacion e,2001-07-01,33,96,33,96,129
80102,SAN JAVIER(BNI),estado nutricional en menores de 5 anos,clasificacion e,2001-07-01,0,6,0,6,6
71102,SAN JAVIER(STC),estado nutricional en menores de 5 anos,clasificacion e,2001-07-01,3,7,3,7,10
70501,SAN JOSE DE CHIQUITOS,estado nutricional en menores de 5 anos,clasificacion e,2001-07-01,6,5,6,5,11
71104,SAN JULIAN,estado nutricional en menores de 5 anos,clasificacion e,2001-07-01,4,42,4,42,46
60501,SAN LORENZO(TJA),estado nutricional en menores de 5 anos,clasificacion e,2001-07-01,0,4,0,4,4
10702,SAN LUCAS,estado nutricional en menores de 5 anos,clasificacion e,2001-07-01,0,243,0,243,243
71201,SAN MATIAS,estado nutricional en menores de 5 anos,clasificacion e,2001-07-01,1,17,1,17,18
70302,SAN MIGUEL DE VELASCO,estado nutricional en menores de 5 anos,clasificacion e,2001-07-01,0,15,0,15,15
51001,SAN PABLO DE LIPEZ,estado nutricional en menores de 5 anos,clasificacion e,2001-07-01,0,6,0,6,6
50501,SAN PEDRO DE BUENA VISTA,estado nutricional en menores de 5 anos,clasificacion e,2001-07-01,1,71,1,71,72
21801,SAN PEDRO DE CURAHUARA,estado nutricional en menores de 5 anos,clasificacion e,2001-07-01,0,1,0,1,1
90202,SAN PEDRO(PND),estado nutricional en menores de 5 anos,clasificacion e,2001-07-01,2,0,2,0,2
70303,SAN RAFAEL,estado nutricional en menores de 5 anos,clasificacion e,2001-07-01,2,3,2,3,5
80702,SAN RAMON,estado nutricional en menores de 5 anos,clasificacion e,2001-07-01,0,2,0,2,2
80401,SANTA ANA,estado nutricional en menores de 5 anos,clasificacion e,2001-07-01,0,3,0,3,3
70101,SANTA CRUZ DE LA SIERRA,estado nutricional en menores de 5 anos,clasificacion e,2001-07-01,48,109,48,109,157
70602,SANTA ROSA DEL SARA,estado nutricional en menores de 5 anos,clasificacion e,2001-07-01,1,7,1,7,8
20308,SANTIAGO DE CALLAPA,estado nutricional en menores de 5 anos,clasificacion e,2001-07-01,0,4,0,4,4
41401,SANTIAGO DE HUARI,estado nutricional en menores de 5 anos,clasificacion e,2001-07-01,3,3,3,3,6
21901,SANTIAGO DE MACHACA,estado nutricional en menores de 5 anos,clasificacion e,2001-07-01,0,5,0,5,5
30702,SANTIVAÃ‘ES,estado nutricional en menores de 5 anos,clasificacion e,2001-07-01,9,7,9,7,16
40202,SANTUARIO DE QUILLACAS,estado nutricional en menores de 5 anos,clasificacion e,2001-07-01,0,2,0,2,2
20902,SAPAHAQUI,estado nutricional en menores de 5 anos,clasificacion e,2001-07-01,0,15,0,15,15
21301,SICA SICA (VILLA AROMA),estado nutricional en menores de 5 anos,clasificacion e,2001-07-01,6,6,6,6,12
30703,SICAYA,estado nutricional en menores de 5 anos,clasificacion e,2001-07-01,0,2,0,2,2
30902,SIPE SIPE,estado nutricional en menores de 5 anos,clasificacion e,2001-07-01,17,49,17,49,66
10403,SOPACHUY,estado nutricional en menores de 5 anos,clasificacion e,2001-07-01,1,116,1,116,117
20601,SORATA,estado nutricional en menores de 5 anos,clasificacion e,2001-07-01,1,5,1,5,6
10101,SUCRE,estado nutricional en menores de 5 anos,clasificacion e,2001-07-01,12,350,12,350,362
20603,TACACOMA,estado nutricional en menores de 5 anos,clasificacion e,2001-07-01,0,10,0,10,10
50303,TACOBAMBA,estado nutricional en menores de 5 anos,clasificacion e,2001-07-01,0,34,0,34,34
30602,TACOPAYA,estado nutricional en menores de 5 anos,clasificacion e,2001-07-01,0,10,0,10,10
51402,TAHUA,estado nutricional en menores de 5 anos,clasificacion e,2001-07-01,0,1,0,1,1
31101,TAPACARI,estado nutricional en menores de 5 anos,clasificacion e,2001-07-01,0,26,0,26,26
10601,TARABUCO,estado nutricional en menores de 5 anos,clasificacion e,2001-07-01,2,247,2,247,249
30401,TARATA,estado nutricional en menores de 5 anos,clasificacion e,2001-07-01,1,10,1,10,11
60101,TARIJA,estado nutricional en menores de 5 anos,clasificacion e,2001-07-01,8,56,8,56,64
10202,TARVITA,estado nutricional en menores de 5 anos,clasificacion e,2001-07-01,1,68,1,68,69
20803,TIAWANACU,estado nutricional en menores de 5 anos,clasificacion e,2001-07-01,6,5,6,5,11
50102,TINGUIPAYA,estado nutricional en menores de 5 anos,clasificacion e,2001-07-01,3,23,3,23,26
20606,TIPUANI,estado nutricional en menores de 5 anos,clasificacion e,2001-07-01,1,1,1,1,2
30903,TIQUIPAYA,estado nutricional en menores de 5 anos,clasificacion e,2001-07-01,2,31,2,31,33
31601,TIRAQUE (CBBA),estado nutricional en menores de 5 anos,clasificacion e,2001-07-01,11,39,11,39,50
30802,TOCO,estado nutricional en menores de 5 anos,clasificacion e,2001-07-01,0,8,0,8,8
30803,TOLATA,estado nutricional en menores de 5 anos,clasificacion e,2001-07-01,0,2,0,2,2
41001,TOLEDO,estado nutricional en menores de 5 anos,clasificacion e,2001-07-01,0,2,0,2,2
51202,TOMAVE,estado nutricional en menores de 5 anos,clasificacion e,2001-07-01,6,28,6,28,34
10402,TOMINA,estado nutricional en menores de 5 anos,clasificacion e,2001-07-01,0,98,0,98,98
50502,TORO TORO,estado nutricional en menores de 5 anos,clasificacion e,2001-07-01,0,13,0,13,13
31201,TOTORA(CBBA),estado nutricional en menores de 5 anos,clasificacion e,2001-07-01,19,17,19,17,36
41301,TOTORA(ORR),estado nutricional en menores de 5 anos,clasificacion e,2001-07-01,0,4,0,4,4
70802,TRIGAL,estado nutricional en menores de 5 anos,clasificacion e,2001-07-01,1,0,1,0,1
80101,TRINIDAD,estado nutricional en menores de 5 anos,clasificacion e,2001-07-01,8,96,8,96,104
50801,TUPIZA,estado nutricional en menores de 5 anos,clasificacion e,2001-07-01,1,45,1,45,46
40402,TURCO,estado nutricional en menores de 5 anos,clasificacion e,2001-07-01,2,3,2,3,5
21302,UMALA,estado nutricional en menores de 5 anos,clasificacion e,2001-07-01,0,5,0,5,5
50201,UNCIA,estado nutricional en menores de 5 anos,clasificacion e,2001-07-01,1,50,1,50,51
60401,URIONDO (A. CONCEPCION),estado nutricional en menores de 5 anos,clasificacion e,2001-07-01,0,1,0,1,1
71502,URUBICHA,estado nutricional en menores de 5 anos,clasificacion e,2001-07-01,0,8,0,8,8
51201,UYUNI,estado nutricional en menores de 5 anos,clasificacion e,2001-07-01,0,20,0,20,20
30502,VACAS,estado nutricional en menores de 5 anos,clasificacion e,2001-07-01,0,14,0,14,14
70801,VALLEGRANDE,estado nutricional en menores de 5 anos,clasificacion e,2001-07-01,11,8,11,8,19
20801,VIACHA,estado nutricional en menores de 5 anos,clasificacion e,2001-07-01,6,23,6,23,29
31302,VILA VILA,estado nutricional en menores de 5 anos,clasificacion e,2001-07-01,8,6,8,6,14
60303,VILLA MONTES,estado nutricional en menores de 5 anos,clasificacion e,2001-07-01,5,19,5,19,24
10801,VILLA SERRANO,estado nutricional en menores de 5 anos,clasificacion e,2001-07-01,0,92,0,92,92
31003,VILLA TUNARI,estado nutricional en menores de 5 anos,clasificacion e,2001-07-01,31,13,31,13,44
11001,VILLA VACA GUZMAN (MUYUPAMPA),estado nutricional en menores de 5 anos,clasificacion e,2001-07-01,1,19,1,19,20
51501,VILLAZON,estado nutricional en menores de 5 anos,clasificacion e,2001-07-01,0,16,0,16,16
30904,VINTO,estado nutricional en menores de 5 anos,clasificacion e,2001-07-01,14,4,14,4,18
50602,VITICHI,estado nutricional en menores de 5 anos,clasificacion e,2001-07-01,1,6,1,6,7
70201,WARNES,estado nutricional en menores de 5 anos,clasificacion e,2001-07-01,7,30,7,30,37
20903,YACO,estado nutricional en menores de 5 anos,clasificacion e,2001-07-01,0,7,0,7,7
60301,YACUIBA,estado nutricional en menores de 5 anos,clasificacion e,2001-07-01,2,38,2,38,40
10602,YAMPARAEZ,estado nutricional en menores de 5 anos,clasificacion e,2001-07-01,1,92,1,92,93
70403,YAPACANI,estado nutricional en menores de 5 anos,clasificacion e,2001-07-01,6,49,6,49,55
50103,YOCALLA,estado nutricional en menores de 5 anos,clasificacion e,2001-07-01,0,17,0,17,17
10102,YOTALA,estado nutricional en menores de 5 anos,clasificacion e,2001-07-01,1,62,1,62,63
60402,YUNCHARA,estado nutricional en menores de 5 anos,clasificacion e,2001-07-01,1,8,1,8,9
10301,ZUDAÃ‘EZ,estado nutricional en menores de 5 anos,clasificacion e,2001-07-01,0,107,0,107,107
51302,ACACIO,estado nutricional en menores de 5 anos,clasificacion e,2001-08-01,0,52,0,52,52
20201,ACHACACHI,estado nutricional en menores de 5 anos,clasificacion e,2001-08-01,1,27,1,27,28
20104,ACHOCALLA,estado nutricional en menores de 5 anos,clasificacion e,2001-08-01,0,4,0,4,4
30201,AIQUILE,estado nutricional en menores de 5 anos,clasificacion e,2001-08-01,1,21,1,21,22
31303,ALALAY,estado nutricional en menores de 5 anos,clasificacion e,2001-08-01,2,0,2,0,2
10404,ALCALA,estado nutricional en menores de 5 anos,clasificacion e,2001-08-01,0,23,0,23,23
20202,ANCORAIMES,estado nutricional en menores de 5 anos,clasificacion e,2001-08-01,0,28,0,28,28
41201,ANDAMARCA,estado nutricional en menores de 5 anos,clasificacion e,2001-08-01,0,1,0,1,1
30402,ANZALDO,estado nutricional en menores de 5 anos,clasificacion e,2001-08-01,0,26,0,26,26
20701,APOLO,estado nutricional en menores de 5 anos,clasificacion e,2001-08-01,7,2,7,2,9
51301,ARAMPAMPA,estado nutricional en menores de 5 anos,clasificacion e,2001-08-01,0,39,0,39,39
30501,ARANI,estado nutricional en menores de 5 anos,clasificacion e,2001-08-01,2,31,2,31,33
30403,ARBIETO,estado nutricional en menores de 5 anos,clasificacion e,2001-08-01,0,6,0,6,6
30601,ARQUE,estado nutricional en menores de 5 anos,clasificacion e,2001-08-01,19,24,19,24,43
71501,ASCENCION DE GUARAYOS,estado nutricional en menores de 5 anos,clasificacion e,2001-08-01,42,54,42,54,96
50802,ATOCHA,estado nutricional en menores de 5 anos,clasificacion e,2001-08-01,0,20,0,20,20
20503,AUCAPATA,estado nutricional en menores de 5 anos,clasificacion e,2001-08-01,0,8,0,8,8
20502,AYATA,estado nutricional en menores de 5 anos,clasificacion e,2001-08-01,8,2,8,2,10
21303,AYO AYO,estado nutricional en menores de 5 anos,clasificacion e,2001-08-01,0,11,0,11,11
30301,AYOPAYA (V. DE INDEPENDENCIA),estado nutricional en menores de 5 anos,clasificacion e,2001-08-01,28,20,28,20,48
10201,AZURDUY,estado nutricional en menores de 5 anos,clasificacion e,2001-08-01,0,50,0,50,50
21203,BATALLAS,estado nutricional en menores de 5 anos,clasificacion e,2001-08-01,0,13,0,13,13
80802,BAURES,estado nutricional en menores de 5 anos,clasificacion e,2001-08-01,6,4,6,4,10
50104,BELEN DE URMIRI,estado nutricional en menores de 5 anos,clasificacion e,2001-08-01,0,18,0,18,18
90104,BELLA FLOR,estado nutricional en menores de 5 anos,clasificacion e,2001-08-01,0,4,0,4,4
60202,BERMEJO,estado nutricional en menores de 5 anos,clasificacion e,2001-08-01,0,3,0,3,3
50301,BETANZOS,estado nutricional en menores de 5 anos,clasificacion e,2001-08-01,0,89,0,89,89
31501,BOLIVAR,estado nutricional en menores de 5 anos,clasificacion e,2001-08-01,39,10,39,10,49
90103,BOLPEBRA,estado nutricional en menores de 5 anos,clasificacion e,2001-08-01,0,1,0,1,1
70707,BOYUIBE,estado nutricional en menores de 5 anos,clasificacion e,2001-08-01,0,12,0,12,12
70401,BUENA VISTA,estado nutricional en menores de 5 anos,clasificacion e,2001-08-01,16,14,16,14,30
70703,CABEZAS,estado nutricional en menores de 5 anos,clasificacion e,2001-08-01,2,9,2,9,11
20905,CAIROMA,estado nutricional en menores de 5 anos,clasificacion e,2001-08-01,0,4,0,4,4
51102,"CAIZA ""D""",estado nutricional en menores de 5 anos,clasificacion e,2001-08-01,1,42,1,42,43
21003,CAJUATA,estado nutricional en menores de 5 anos,clasificacion e,2001-08-01,2,6,2,6,8
20303,CALACOTO,estado nutricional en menores de 5 anos,clasificacion e,2001-08-01,1,2,1,2,3
21304,CALAMARCA,estado nutricional en menores de 5 anos,clasificacion e,2001-08-01,1,13,1,13,14
10701,CAMARGO,estado nutricional en menores de 5 anos,clasificacion e,2001-08-01,2,41,2,41,43
10901,CAMATAQUI (C. VILLA ABECIA),estado nutricional en menores de 5 anos,clasificacion e,2001-08-01,0,9,0,9,9
70706,CAMIRI,estado nutricional en menores de 5 anos,clasificacion e,2001-08-01,12,19,12,19,31
30701,CAPINOTA,estado nutricional en menores de 5 anos,clasificacion e,2001-08-01,17,20,17,20,37
20302,CAQUIAVIRI,estado nutricional en menores de 5 anos,clasificacion e,2001-08-01,0,2,0,2,2
40102,CARACOLLO,estado nutricional en menores de 5 anos,clasificacion e,2001-08-01,3,3,3,3,6
22001,CARANAVI,estado nutricional en menores de 5 anos,clasificacion e,2001-08-01,24,44,24,44,68
60302,CARAPARI,estado nutricional en menores de 5 anos,clasificacion e,2001-08-01,1,3,1,3,4
50702,CARIPUYO,estado nutricional en menores de 5 anos,clasificacion e,2001-08-01,0,54,0,54,54
21902,CATACORA,estado nutricional en menores de 5 anos,clasificacion e,2001-08-01,0,2,0,2,2
21803,CHACARILLA,estado nutricional en menores de 5 anos,clasificacion e,2001-08-01,0,1,0,1,1
40201,CHALLAPATA,estado nutricional en menores de 5 anos,clasificacion e,2001-08-01,9,2,9,2,11
50302,CHAQUI,estado nutricional en menores de 5 anos,clasificacion e,2001-08-01,0,15,0,15,15
70702,CHARAGUA,estado nutricional en menores de 5 anos,clasificacion e,2001-08-01,0,46,0,46,46
20305,CHARAÃ‘A,estado nutricional en menores de 5 anos,clasificacion e,2001-08-01,0,1,0,1,1
50202,CHAYANTA,estado nutricional en menores de 5 anos,clasificacion e,2001-08-01,0,35,0,35,35
31204,CHIMORE,estado nutricional en menores de 5 anos,clasificacion e,2001-08-01,1,13,1,13,14
21101,CHULUMANI (V. DE LA LIBERTAD),estado nutricional en menores de 5 anos,clasificacion e,2001-08-01,0,4,0,4,4
20501,CHUMA,estado nutricional en menores de 5 anos,clasificacion e,2001-08-01,1,2,1,2,3
30801,CLIZA,estado nutricional en menores de 5 anos,clasificacion e,2001-08-01,1,13,1,13,14
90101,COBIJA,estado nutricional en menores de 5 anos,clasificacion e,2001-08-01,24,16,24,16,40
30101,COCHABAMBA,estado nutricional en menores de 5 anos,clasificacion e,2001-08-01,64,48,64,48,112
30905,COLCAPIRHUA,estado nutricional en menores de 5 anos,clasificacion e,2001-08-01,9,6,9,6,15
50901,"COLCHA ""K""",estado nutricional en menores de 5 anos,clasificacion e,2001-08-01,0,14,0,14,14
31002,COLOMI,estado nutricional en menores de 5 anos,clasificacion e,2001-08-01,2,90,2,90,92
70603,COLPA BELGICA,estado nutricional en menores de 5 anos,clasificacion e,2001-08-01,2,2,2,2,4
50401,COLQUECHACA,estado nutricional en menores de 5 anos,clasificacion e,2001-08-01,11,35,11,35,46
21306,COLQUENCHA,estado nutricional en menores de 5 anos,clasificacion e,2001-08-01,1,6,1,6,7
21004,COLQUIRI,estado nutricional en menores de 5 anos,clasificacion e,2001-08-01,40,59,40,59,99
20304,COMANCHE,estado nutricional en menores de 5 anos,clasificacion e,2001-08-01,3,4,3,4,7
71301,COMARAPA,estado nutricional en menores de 5 anos,clasificacion e,2001-08-01,0,12,0,12,12
20605,COMBAYA,estado nutricional en menores de 5 anos,clasificacion e,2001-08-01,0,2,0,2,2
71101,CONCEPCION,estado nutricional en menores de 5 anos,clasificacion e,2001-08-01,3,2,3,2,5
21701,COPACABANA,estado nutricional en menores de 5 anos,clasificacion e,2001-08-01,0,10,0,10,10
21402,CORIPATA,estado nutricional en menores de 5 anos,clasificacion e,2001-08-01,0,5,0,5,5
20301,CORO CORO,estado nutricional en menores de 5 anos,clasificacion e,2001-08-01,0,26,0,26,26
21401,COROICO,estado nutricional en menores de 5 anos,clasificacion e,2001-08-01,7,7,7,7,14
40301,CORQUE,estado nutricional en menores de 5 anos,clasificacion e,2001-08-01,2,4,2,4,6
50601,COTAGAITA,estado nutricional en menores de 5 anos,clasificacion e,2001-08-01,0,39,0,39,39
70102,COTOCA,estado nutricional en menores de 5 anos,clasificacion e,2001-08-01,0,3,0,3,3
31405,CUCHUMUELA (V. G. VILLARROEL),estado nutricional en menores de 5 anos,clasificacion e,2001-08-01,0,5,0,5,5
70704,CUEVO,estado nutricional en menores de 5 anos,clasificacion e,2001-08-01,4,11,4,11,15
10902,CULPINA,estado nutricional en menores de 5 anos,clasificacion e,2001-08-01,2,119,2,119,121
40401,CURAHUARA DE CARANGAS,estado nutricional en menores de 5 anos,clasificacion e,2001-08-01,3,2,3,2,5
21602,CURVA,estado nutricional en menores de 5 anos,clasificacion e,2001-08-01,2,0,2,0,2
20804,DESAGUADERO,estado nutricional en menores de 5 anos,clasificacion e,2001-08-01,1,4,1,4,5
20105,EL ALTO,estado nutricional en menores de 5 anos,clasificacion e,2001-08-01,242,348,242,348,590
71503,EL PUENTE(STC),estado nutricional en menores de 5 anos,clasificacion e,2001-08-01,5,29,5,29,34
60502,EL PUENTE(TJA),estado nutricional en menores de 5 anos,clasificacion e,2001-08-01,3,8,3,8,11
70105,EL TORNO,estado nutricional en menores de 5 anos,clasificacion e,2001-08-01,1,35,1,35,36
10405,EL VILLAR,estado nutricional en menores de 5 anos,clasificacion e,2001-08-01,0,67,0,67,67
60601,ENTRE RIOS,estado nutricional en menores de 5 anos,clasificacion e,2001-08-01,2,20,2,20,22
41101,EUCALIPTUS,estado nutricional en menores de 5 anos,clasificacion e,2001-08-01,0,5,0,5,5
80402,EXALTACION,estado nutricional en menores de 5 anos,clasificacion e,2001-08-01,0,5,0,5,5
90203,FILADELFIA,estado nutricional en menores de 5 anos,clasificacion e,2001-08-01,0,4,0,4,4
71002,GENERAL SAAVEDRA,estado nutricional en menores de 5 anos,clasificacion e,2001-08-01,0,33,0,33,33
21601,GRAL. J.J. PEREZ (CHARAZANI),estado nutricional en menores de 5 anos,clasificacion e,2001-08-01,11,6,11,6,17
20602,GUANAY,estado nutricional en menores de 5 anos,clasificacion e,2001-08-01,1,37,1,37,38
20802,GUAQUI,estado nutricional en menores de 5 anos,clasificacion e,2001-08-01,0,7,0,7,7
80202,GUAYARAMERIN,estado nutricional en menores de 5 anos,clasificacion e,2001-08-01,5,76,5,76,81
70705,GUTIERREZ,estado nutricional en menores de 5 anos,clasificacion e,2001-08-01,8,40,8,40,48
10502,HUACARETA,estado nutricional en menores de 5 anos,clasificacion e,2001-08-01,3,51,3,51,54
80803,HUARACAJE,estado nutricional en menores de 5 anos,clasificacion e,2001-08-01,4,1,4,1,5
41601,HUAYLLAMARCA,estado nutricional en menores de 5 anos,clasificacion e,2001-08-01,0,4,0,4,4
21005,ICHOCA,estado nutricional en menores de 5 anos,clasificacion e,2001-08-01,0,1,0,1,1
10304,ICLA,estado nutricional en menores de 5 anos,clasificacion e,2001-08-01,57,67,57,67,124
10703,INCAHUASI,estado nutricional en menores de 5 anos,clasificacion e,2001-08-01,0,127,0,127,127
21001,INQUISIVI,estado nutricional en menores de 5 anos,clasificacion e,2001-08-01,1,32,1,32,33
21102,IRUPANA (VILLA DE LANZA),estado nutricional en menores de 5 anos,clasificacion e,2001-08-01,1,10,1,10,11
21501,IXIAMAS,estado nutricional en menores de 5 anos,clasificacion e,2001-08-01,1,15,1,15,16
21105,LA ASUNTA,estado nutricional en menores de 5 anos,clasificacion e,2001-08-01,1,3,1,3,4
70104,LA GUARDIA,estado nutricional en menores de 5 anos,clasificacion e,2001-08-01,0,19,0,19,19
20101,LA PAZ,estado nutricional en menores de 5 anos,clasificacion e,2001-08-01,150,194,150,194,344
70701,LAGUNILLAS,estado nutricional en menores de 5 anos,clasificacion e,2001-08-01,17,35,17,35,52
21202,LAJA,estado nutricional en menores de 5 anos,clasificacion e,2001-08-01,3,14,3,14,17
10903,LAS CARRERAS,estado nutricional en menores de 5 anos,clasificacion e,2001-08-01,0,9,0,9,9
50203,LLALLAGUA,estado nutricional en menores de 5 anos,clasificacion e,2001-08-01,3,53,3,53,56
51401,LLICA,estado nutricional en menores de 5 anos,clasificacion e,2001-08-01,0,1,0,1,1
20901,LURIBAY,estado nutricional en menores de 5 anos,clasificacion e,2001-08-01,0,4,0,4,4
40702,MACHACAMARCA,estado nutricional en menores de 5 anos,clasificacion e,2001-08-01,4,3,4,3,7
11003,MACHARETI,estado nutricional en menores de 5 anos,clasificacion e,2001-08-01,0,46,0,46,46
80801,MAGDALENA,estado nutricional en menores de 5 anos,clasificacion e,2001-08-01,2,4,2,4,6
70903,MAIRANA,estado nutricional en menores de 5 anos,clasificacion e,2001-08-01,2,6,2,6,8
20904,MALLA,estado nutricional en menores de 5 anos,clasificacion e,2001-08-01,0,2,0,2,2
20103,MECAPACA,estado nutricional en menores de 5 anos,clasificacion e,2001-08-01,0,21,0,21,21
71003,MINEROS,estado nutricional en menores de 5 anos,clasificacion e,2001-08-01,3,34,3,34,37
31301,MIZQUE,estado nutricional en menores de 5 anos,clasificacion e,2001-08-01,19,12,19,12,31
20402,MOCOMOCO,estado nutricional en menores de 5 anos,clasificacion e,2001-08-01,2,11,2,11,13
51002,MOJINETE,estado nutricional en menores de 5 anos,clasificacion e,2001-08-01,0,5,0,5,5
10303,MOJOCOYA,estado nutricional en menores de 5 anos,clasificacion e,2001-08-01,0,35,0,35,35
10501,MONTEAGUDO,estado nutricional en menores de 5 anos,clasificacion e,2001-08-01,1,108,1,108,109
71001,MONTERO,estado nutricional en menores de 5 anos,clasificacion e,2001-08-01,6,137,6,137,143
70803,MORO MORO,estado nutricional en menores de 5 anos,clasificacion e,2001-08-01,4,0,4,0,4
30302,MOROCHATA,estado nutricional en menores de 5 anos,clasificacion e,2001-08-01,34,42,34,42,76
90401,NACEBE (SANTA ROSA DEL ABUNA),estado nutricional en menores de 5 anos,clasificacion e,2001-08-01,0,5,0,5,5
90501,NUEVO MANOA (NUEVA ESPERANZA),estado nutricional en menores de 5 anos,clasificacion e,2001-08-01,0,2,0,2,2
50404,OCURI,estado nutricional en menores de 5 anos,clasificacion e,2001-08-01,4,43,4,43,47
30203,OMEREQUE,estado nutricional en menores de 5 anos,clasificacion e,2001-08-01,0,6,0,6,6
40101,ORURO,estado nutricional en menores de 5 anos,clasificacion e,2001-08-01,3,187,3,187,190
60201,PADCAYA,estado nutricional en menores de 5 anos,clasificacion e,2001-08-01,2,10,2,10,12
10401,PADILLA,estado nutricional en menores de 5 anos,clasificacion e,2001-08-01,0,134,0,134,134
70502,PAILON,estado nutricional en menores de 5 anos,clasificacion e,2001-08-01,0,9,0,9,9
20102,PALCA,estado nutricional en menores de 5 anos,clasificacion e,2001-08-01,18,13,18,13,31
21104,PALOS BLANCOS,estado nutricional en menores de 5 anos,clasificacion e,2001-08-01,6,3,6,3,9
40802,PAMPA AULLAGAS,estado nutricional en menores de 5 anos,clasificacion e,2001-08-01,4,0,4,0,4
70902,PAMPA GRANDE,estado nutricional en menores de 5 anos,clasificacion e,2001-08-01,2,7,2,7,9
21802,PAPEL PAMPA,estado nutricional en menores de 5 anos,clasificacion e,2001-08-01,0,1,0,1,1
30202,PASORAPA,estado nutricional en menores de 5 anos,clasificacion e,2001-08-01,0,7,0,7,7
21305,PATACAMAYA,estado nutricional en menores de 5 anos,clasificacion e,2001-08-01,9,10,9,10,19
40602,PAZÃ‘A,estado nutricional en menores de 5 anos,clasificacion e,2001-08-01,0,1,0,1,1
20702,PELECHUCO,estado nutricional en menores de 5 anos,clasificacion e,2001-08-01,2,0,2,0,2
50403,POCOATA,estado nutricional en menores de 5 anos,clasificacion e,2001-08-01,16,48,16,48,64
31203,POCONA,estado nutricional en menores de 5 anos,clasificacion e,2001-08-01,1,22,1,22,23
31202,POJO (CBBA),estado nutricional en menores de 5 anos,clasificacion e,2001-08-01,13,36,13,36,49
40601,POOPO,estado nutricional en menores de 5 anos,clasificacion e,2001-08-01,0,7,0,7,7
51203,PORCO,estado nutricional en menores de 5 anos,clasificacion e,2001-08-01,0,15,0,15,15
10103,POROMA,estado nutricional en menores de 5 anos,clasificacion e,2001-08-01,0,101,0,101,101
70103,PORONGO,estado nutricional en menores de 5 anos,clasificacion e,2001-08-01,0,8,0,8,8
70601,PORTACHUELO,estado nutricional en menores de 5 anos,clasificacion e,2001-08-01,3,6,3,6,9
90102,PORVENIR,estado nutricional en menores de 5 anos,clasificacion e,2001-08-01,0,4,0,4,4
70804,POSTRER VALLE,estado nutricional en menores de 5 anos,clasificacion e,2001-08-01,1,1,1,1,2
50101,POTOSI,estado nutricional en menores de 5 anos,clasificacion e,2001-08-01,6,250,6,250,256
10302,PRESTO,estado nutricional en menores de 5 anos,clasificacion e,2001-08-01,2,72,2,72,74
70805,PUCARA,estado nutricional en menores de 5 anos,clasificacion e,2001-08-01,0,3,0,3,3
21201,PUCARANI,estado nutricional en menores de 5 anos,clasificacion e,2001-08-01,1,27,1,27,28
20401,PUERTO ACOSTA,estado nutricional en menores de 5 anos,clasificacion e,2001-08-01,31,12,31,12,43
20403,PUERTO CARABUCO,estado nutricional en menores de 5 anos,clasificacion e,2001-08-01,17,13,17,13,30
90301,PUERTO GONZALO MORENO,estado nutricional en menores de 5 anos,clasificacion e,2001-08-01,0,11,0,11,11
21204,PUERTO PEREZ,estado nutricional en menores de 5 anos,clasificacion e,2001-08-01,0,3,0,3,3
71402,PUERTO QUIJARRO,estado nutricional en menores de 5 anos,clasificacion e,2001-08-01,8,4,8,4,12
90201,PUERTO RICO,estado nutricional en menores de 5 anos,clasificacion e,2001-08-01,0,2,0,2,2
80703,PUERTO SILES,estado nutricional en menores de 5 anos,clasificacion e,2001-08-01,1,9,1,9,10
71401,PUERTO SUAREZ,estado nutricional en menores de 5 anos,clasificacion e,2001-08-01,18,0,18,0,18
31205,PUERTO VILLARROEL,estado nutricional en menores de 5 anos,clasificacion e,2001-08-01,30,42,30,42,72
51101,PUNA,estado nutricional en menores de 5 anos,clasificacion e,2001-08-01,4,85,4,85,89
31401,PUNATA,estado nutricional en menores de 5 anos,clasificacion e,2001-08-01,3,19,3,19,22
20604,QUIABAYA,estado nutricional en menores de 5 anos,clasificacion e,2001-08-01,0,14,0,14,14
30901,QUILLACOLLO,estado nutricional en menores de 5 anos,clasificacion e,2001-08-01,0,5,0,5,5
21002,QUIME,estado nutricional en menores de 5 anos,clasificacion e,2001-08-01,16,13,16,13,29
70904,QUIRUSILLAS,estado nutricional en menores de 5 anos,clasificacion e,2001-08-01,0,1,0,1,1
50402,RAVELO,estado nutricional en menores de 5 anos,clasificacion e,2001-08-01,2,174,2,174,176
80301,REYES,estado nutricional en menores de 5 anos,clasificacion e,2001-08-01,1,13,1,13,14
80201,RIBERALTA,estado nutricional en menores de 5 anos,clasificacion e,2001-08-01,7,187,7,187,194
70503,ROBORE,estado nutricional en menores de 5 anos,clasificacion e,2001-08-01,0,10,0,10,10
80304,RURRENABAQUE,estado nutricional en menores de 5 anos,clasificacion e,2001-08-01,9,8,9,8,17
31001,SACABA,estado nutricional en menores de 5 anos,clasificacion e,2001-08-01,124,73,124,73,197
30404,SACABAMBA,estado nutricional en menores de 5 anos,clasificacion e,2001-08-01,1,33,1,33,34
50701,SACACA,estado nutricional en menores de 5 anos,clasificacion e,2001-08-01,2,97,2,97,99
71302,SAIPINA,estado nutricional en menores de 5 anos,clasificacion e,2001-08-01,1,0,1,0,1
40801,SALINAS DE GARCI MENDOZA,estado nutricional en menores de 5 anos,clasificacion e,2001-08-01,2,0,2,0,2
51601,SAN AGUSTIN,estado nutricional en menores de 5 anos,clasificacion e,2001-08-01,0,4,0,4,4
80602,SAN ANDRES,estado nutricional en menores de 5 anos,clasificacion e,2001-08-01,2,12,2,12,14
51003,SAN ANTONIO DE ESMORUCO,estado nutricional en menores de 5 anos,clasificacion e,2001-08-01,0,4,0,4,4
71105,SAN ANTONIO DE LOMERIO,estado nutricional en menores de 5 anos,clasificacion e,2001-08-01,32,63,32,63,95
31403,SAN BENITO,estado nutricional en menores de 5 anos,clasificacion e,2001-08-01,0,11,0,11,11
80302,SAN BORJA,estado nutricional en menores de 5 anos,clasificacion e,2001-08-01,0,31,0,31,31
21502,SAN BUENA VENTURA,estado nutricional en menores de 5 anos,clasificacion e,2001-08-01,1,8,1,8,9
70402,SAN CARLOS,estado nutricional en menores de 5 anos,clasificacion e,2001-08-01,0,9,0,9,9
80501,SAN IGNACIO,estado nutricional en menores de 5 anos,clasificacion e,2001-08-01,2,36,2,36,38
70301,SAN IGNACIO DE VELASCO,estado nutricional en menores de 5 anos,clasificacion e,2001-08-01,47,89,47,89,136
80102,SAN JAVIER(BNI),estado nutricional en menores de 5 anos,clasificacion e,2001-08-01,0,5,0,5,5
71102,SAN JAVIER(STC),estado nutricional en menores de 5 anos,clasificacion e,2001-08-01,3,8,3,8,11
80701,SAN JOAQUIN,estado nutricional en menores de 5 anos,clasificacion e,2001-08-01,0,3,0,3,3
70501,SAN JOSE DE CHIQUITOS,estado nutricional en menores de 5 anos,clasificacion e,2001-08-01,13,5,13,5,18
71104,SAN JULIAN,estado nutricional en menores de 5 anos,clasificacion e,2001-08-01,24,34,24,34,58
90302,SAN LORENZO(PND),estado nutricional en menores de 5 anos,clasificacion e,2001-08-01,1,6,1,6,7
60501,SAN LORENZO(TJA),estado nutricional en menores de 5 anos,clasificacion e,2001-08-01,11,66,11,66,77
10702,SAN LUCAS,estado nutricional en menores de 5 anos,clasificacion e,2001-08-01,5,296,5,296,301
71201,SAN MATIAS,estado nutricional en menores de 5 anos,clasificacion e,2001-08-01,0,26,0,26,26
70302,SAN MIGUEL DE VELASCO,estado nutricional en menores de 5 anos,clasificacion e,2001-08-01,0,15,0,15,15
51001,SAN PABLO DE LIPEZ,estado nutricional en menores de 5 anos,clasificacion e,2001-08-01,0,8,0,8,8
50501,SAN PEDRO DE BUENA VISTA,estado nutricional en menores de 5 anos,clasificacion e,2001-08-01,1,168,1,168,169
21801,SAN PEDRO DE CURAHUARA,estado nutricional en menores de 5 anos,clasificacion e,2001-08-01,0,11,0,11,11
21702,SAN PEDRO DE TIQUINA,estado nutricional en menores de 5 anos,clasificacion e,2001-08-01,0,1,0,1,1
90202,SAN PEDRO(PND),estado nutricional en menores de 5 anos,clasificacion e,2001-08-01,2,5,2,5,7
70303,SAN RAFAEL,estado nutricional en menores de 5 anos,clasificacion e,2001-08-01,4,5,4,5,9
80702,SAN RAMON,estado nutricional en menores de 5 anos,clasificacion e,2001-08-01,3,4,3,4,7
80401,SANTA ANA,estado nutricional en menores de 5 anos,clasificacion e,2001-08-01,0,1,0,1,1
70101,SANTA CRUZ DE LA SIERRA,estado nutricional en menores de 5 anos,clasificacion e,2001-08-01,61,98,61,98,159
80303,SANTA ROSA,estado nutricional en menores de 5 anos,clasificacion e,2001-08-01,8,30,8,30,38
70602,SANTA ROSA DEL SARA,estado nutricional en menores de 5 anos,clasificacion e,2001-08-01,3,12,3,12,15
20308,SANTIAGO DE CALLAPA,estado nutricional en menores de 5 anos,clasificacion e,2001-08-01,2,3,2,3,5
41401,SANTIAGO DE HUARI,estado nutricional en menores de 5 anos,clasificacion e,2001-08-01,1,8,1,8,9
21901,SANTIAGO DE MACHACA,estado nutricional en menores de 5 anos,clasificacion e,2001-08-01,0,11,0,11,11
30702,SANTIVAÃ‘ES,estado nutricional en menores de 5 anos,clasificacion e,2001-08-01,7,4,7,4,11
40202,SANTUARIO DE QUILLACAS,estado nutricional en menores de 5 anos,clasificacion e,2001-08-01,1,4,1,4,5
20902,SAPAHAQUI,estado nutricional en menores de 5 anos,clasificacion e,2001-08-01,0,12,0,12,12
90303,SENA,estado nutricional en menores de 5 anos,clasificacion e,2001-08-01,0,7,0,7,7
21301,SICA SICA (VILLA AROMA),estado nutricional en menores de 5 anos,clasificacion e,2001-08-01,4,19,4,19,23
30703,SICAYA,estado nutricional en menores de 5 anos,clasificacion e,2001-08-01,0,7,0,7,7
30902,SIPE SIPE,estado nutricional en menores de 5 anos,clasificacion e,2001-08-01,34,29,34,29,63
10403,SOPACHUY,estado nutricional en menores de 5 anos,clasificacion e,2001-08-01,0,94,0,94,94
20601,SORATA,estado nutricional en menores de 5 anos,clasificacion e,2001-08-01,0,18,0,18,18
10101,SUCRE,estado nutricional en menores de 5 anos,clasificacion e,2001-08-01,21,302,21,302,323
31404,TACACHI,estado nutricional en menores de 5 anos,clasificacion e,2001-08-01,0,2,0,2,2
20603,TACACOMA,estado nutricional en menores de 5 anos,clasificacion e,2001-08-01,0,4,0,4,4
50303,TACOBAMBA,estado nutricional en menores de 5 anos,clasificacion e,2001-08-01,0,68,0,68,68
30602,TACOPAYA,estado nutricional en menores de 5 anos,clasificacion e,2001-08-01,1,42,1,42,43
51402,TAHUA,estado nutricional en menores de 5 anos,clasificacion e,2001-08-01,0,1,0,1,1
31101,TAPACARI,estado nutricional en menores de 5 anos,clasificacion e,2001-08-01,4,45,4,45,49
10601,TARABUCO,estado nutricional en menores de 5 anos,clasificacion e,2001-08-01,0,261,0,261,261
30401,TARATA,estado nutricional en menores de 5 anos,clasificacion e,2001-08-01,2,22,2,22,24
60101,TARIJA,estado nutricional en menores de 5 anos,clasificacion e,2001-08-01,12,59,12,59,71
10202,TARVITA,estado nutricional en menores de 5 anos,clasificacion e,2001-08-01,0,49,0,49,49
20803,TIAWANACU,estado nutricional en menores de 5 anos,clasificacion e,2001-08-01,5,4,5,4,9
50102,TINGUIPAYA,estado nutricional en menores de 5 anos,clasificacion e,2001-08-01,2,55,2,55,57
20606,TIPUANI,estado nutricional en menores de 5 anos,clasificacion e,2001-08-01,1,3,1,3,4
30903,TIQUIPAYA,estado nutricional en menores de 5 anos,clasificacion e,2001-08-01,3,9,3,9,12
31601,TIRAQUE (CBBA),estado nutricional en menores de 5 anos,clasificacion e,2001-08-01,19,21,19,21,40
30802,TOCO,estado nutricional en menores de 5 anos,clasificacion e,2001-08-01,0,6,0,6,6
41001,TOLEDO,estado nutricional en menores de 5 anos,clasificacion e,2001-08-01,3,3,3,3,6
51202,TOMAVE,estado nutricional en menores de 5 anos,clasificacion e,2001-08-01,0,43,0,43,43
10402,TOMINA,estado nutricional en menores de 5 anos,clasificacion e,2001-08-01,1,129,1,129,130
50502,TORO TORO,estado nutricional en menores de 5 anos,clasificacion e,2001-08-01,3,3,3,3,6
31201,TOTORA(CBBA),estado nutricional en menores de 5 anos,clasificacion e,2001-08-01,18,21,18,21,39
41301,TOTORA(ORR),estado nutricional en menores de 5 anos,clasificacion e,2001-08-01,0,5,0,5,5
70802,TRIGAL,estado nutricional en menores de 5 anos,clasificacion e,2001-08-01,1,2,1,2,3
80101,TRINIDAD,estado nutricional en menores de 5 anos,clasificacion e,2001-08-01,11,69,11,69,80
50801,TUPIZA,estado nutricional en menores de 5 anos,clasificacion e,2001-08-01,0,86,0,86,86
40402,TURCO,estado nutricional en menores de 5 anos,clasificacion e,2001-08-01,3,0,3,0,3
21302,UMALA,estado nutricional en menores de 5 anos,clasificacion e,2001-08-01,1,6,1,6,7
50201,UNCIA,estado nutricional en menores de 5 anos,clasificacion e,2001-08-01,0,9,0,9,9
60401,URIONDO (A. CONCEPCION),estado nutricional en menores de 5 anos,clasificacion e,2001-08-01,0,4,0,4,4
71502,URUBICHA,estado nutricional en menores de 5 anos,clasificacion e,2001-08-01,0,59,0,59,59
51201,UYUNI,estado nutricional en menores de 5 anos,clasificacion e,2001-08-01,0,50,0,50,50
30502,VACAS,estado nutricional en menores de 5 anos,clasificacion e,2001-08-01,0,2,0,2,2
70801,VALLEGRANDE,estado nutricional en menores de 5 anos,clasificacion e,2001-08-01,8,14,8,14,22
20801,VIACHA,estado nutricional en menores de 5 anos,clasificacion e,2001-08-01,1,31,1,31,32
31302,VILA VILA,estado nutricional en menores de 5 anos,clasificacion e,2001-08-01,15,4,15,4,19
60303,VILLA MONTES,estado nutricional en menores de 5 anos,clasificacion e,2001-08-01,7,12,7,12,19
90502,VILLA NUEVA (LOMA ALTA),estado nutricional en menores de 5 anos,clasificacion e,2001-08-01,0,1,0,1,1
31402,VILLA RIVERO,estado nutricional en menores de 5 anos,clasificacion e,2001-08-01,0,4,0,4,4
10801,VILLA SERRANO,estado nutricional en menores de 5 anos,clasificacion e,2001-08-01,1,75,1,75,76
31003,VILLA TUNARI,estado nutricional en menores de 5 anos,clasificacion e,2001-08-01,29,22,29,22,51
11001,VILLA VACA GUZMAN (MUYUPAMPA),estado nutricional en menores de 5 anos,clasificacion e,2001-08-01,4,30,4,30,34
51501,VILLAZON,estado nutricional en menores de 5 anos,clasificacion e,2001-08-01,2,42,2,42,44
30904,VINTO,estado nutricional en menores de 5 anos,clasificacion e,2001-08-01,7,1,7,1,8
50602,VITICHI,estado nutricional en menores de 5 anos,clasificacion e,2001-08-01,0,20,0,20,20
20306,WALDO BALLIVIAN,estado nutricional en menores de 5 anos,clasificacion e,2001-08-01,0,1,0,1,1
70201,WARNES,estado nutricional en menores de 5 anos,clasificacion e,2001-08-01,14,29,14,29,43
20903,YACO,estado nutricional en menores de 5 anos,clasificacion e,2001-08-01,0,6,0,6,6
60301,YACUIBA,estado nutricional en menores de 5 anos,clasificacion e,2001-08-01,9,8,9,8,17
10602,YAMPARAEZ,estado nutricional en menores de 5 anos,clasificacion e,2001-08-01,0,103,0,103,103
21103,YANACACHI,estado nutricional en menores de 5 anos,clasificacion e,2001-08-01,2,2,2,2,4
70403,YAPACANI,estado nutricional en menores de 5 anos,clasificacion e,2001-08-01,7,27,7,27,34
50103,YOCALLA,estado nutricional en menores de 5 anos,clasificacion e,2001-08-01,0,10,0,10,10
10102,YOTALA,estado nutricional en menores de 5 anos,clasificacion e,2001-08-01,5,61,5,61,66
60402,YUNCHARA,estado nutricional en menores de 5 anos,clasificacion e,2001-08-01,3,11,3,11,14
10301,ZUDAÃ‘EZ,estado nutricional en menores de 5 anos,clasificacion e,2001-08-01,0,112,0,112,112
51302,ACACIO,estado nutricional en menores de 5 anos,clasificacion e,2001-09-01,1,71,1,71,72
20201,ACHACACHI,estado nutricional en menores de 5 anos,clasificacion e,2001-09-01,0,42,0,42,42
30201,AIQUILE,estado nutricional en menores de 5 anos,clasificacion e,2001-09-01,6,44,6,44,50
31303,ALALAY,estado nutricional en menores de 5 anos,clasificacion e,2001-09-01,4,3,4,3,7
10404,ALCALA,estado nutricional en menores de 5 anos,clasificacion e,2001-09-01,0,19,0,19,19
20202,ANCORAIMES,estado nutricional en menores de 5 anos,clasificacion e,2001-09-01,0,37,0,37,37
41201,ANDAMARCA,estado nutricional en menores de 5 anos,clasificacion e,2001-09-01,3,0,3,0,3
30402,ANZALDO,estado nutricional en menores de 5 anos,clasificacion e,2001-09-01,1,12,1,12,13
20701,APOLO,estado nutricional en menores de 5 anos,clasificacion e,2001-09-01,1,4,1,4,5
51301,ARAMPAMPA,estado nutricional en menores de 5 anos,clasificacion e,2001-09-01,0,25,0,25,25
30501,ARANI,estado nutricional en menores de 5 anos,clasificacion e,2001-09-01,0,7,0,7,7
30403,ARBIETO,estado nutricional en menores de 5 anos,clasificacion e,2001-09-01,0,3,0,3,3
30601,ARQUE,estado nutricional en menores de 5 anos,clasificacion e,2001-09-01,8,19,8,19,27
71501,ASCENCION DE GUARAYOS,estado nutricional en menores de 5 anos,clasificacion e,2001-09-01,1,8,1,8,9
50802,ATOCHA,estado nutricional en menores de 5 anos,clasificacion e,2001-09-01,0,15,0,15,15
20503,AUCAPATA,estado nutricional en menores de 5 anos,clasificacion e,2001-09-01,14,3,14,3,17
20502,AYATA,estado nutricional en menores de 5 anos,clasificacion e,2001-09-01,3,2,3,2,5
21303,AYO AYO,estado nutricional en menores de 5 anos,clasificacion e,2001-09-01,0,2,0,2,2
30301,AYOPAYA (V. DE INDEPENDENCIA),estado nutricional en menores de 5 anos,clasificacion e,2001-09-01,28,37,28,37,65
10201,AZURDUY,estado nutricional en menores de 5 anos,clasificacion e,2001-09-01,1,42,1,42,43
21203,BATALLAS,estado nutricional en menores de 5 anos,clasificacion e,2001-09-01,0,10,0,10,10
80802,BAURES,estado nutricional en menores de 5 anos,clasificacion e,2001-09-01,3,3,3,3,6
50104,BELEN DE URMIRI,estado nutricional en menores de 5 anos,clasificacion e,2001-09-01,0,5,0,5,5
90104,BELLA FLOR,estado nutricional en menores de 5 anos,clasificacion e,2001-09-01,1,1,1,1,2
60202,BERMEJO,estado nutricional en menores de 5 anos,clasificacion e,2001-09-01,2,3,2,3,5
50301,BETANZOS,estado nutricional en menores de 5 anos,clasificacion e,2001-09-01,2,194,2,194,196
31501,BOLIVAR,estado nutricional en menores de 5 anos,clasificacion e,2001-09-01,17,8,17,8,25
90103,BOLPEBRA,estado nutricional en menores de 5 anos,clasificacion e,2001-09-01,0,1,0,1,1
70707,BOYUIBE,estado nutricional en menores de 5 anos,clasificacion e,2001-09-01,0,2,0,2,2
70401,BUENA VISTA,estado nutricional en menores de 5 anos,clasificacion e,2001-09-01,9,11,9,11,20
70703,CABEZAS,estado nutricional en menores de 5 anos,clasificacion e,2001-09-01,0,21,0,21,21
20905,CAIROMA,estado nutricional en menores de 5 anos,clasificacion e,2001-09-01,0,16,0,16,16
51102,"CAIZA ""D""",estado nutricional en menores de 5 anos,clasificacion e,2001-09-01,3,40,3,40,43
21003,CAJUATA,estado nutricional en menores de 5 anos,clasificacion e,2001-09-01,1,1,1,1,2
20303,CALACOTO,estado nutricional en menores de 5 anos,clasificacion e,2001-09-01,5,2,5,2,7
21304,CALAMARCA,estado nutricional en menores de 5 anos,clasificacion e,2001-09-01,0,8,0,8,8
10701,CAMARGO,estado nutricional en menores de 5 anos,clasificacion e,2001-09-01,0,37,0,37,37
10901,CAMATAQUI (C. VILLA ABECIA),estado nutricional en menores de 5 anos,clasificacion e,2001-09-01,0,6,0,6,6
70706,CAMIRI,estado nutricional en menores de 5 anos,clasificacion e,2001-09-01,25,23,25,23,48
30701,CAPINOTA,estado nutricional en menores de 5 anos,clasificacion e,2001-09-01,20,28,20,28,48
20302,CAQUIAVIRI,estado nutricional en menores de 5 anos,clasificacion e,2001-09-01,2,3,2,3,5
40102,CARACOLLO,estado nutricional en menores de 5 anos,clasificacion e,2001-09-01,3,7,3,7,10
22001,CARANAVI,estado nutricional en menores de 5 anos,clasificacion e,2001-09-01,13,39,13,39,52
60302,CARAPARI,estado nutricional en menores de 5 anos,clasificacion e,2001-09-01,1,1,1,1,2
50702,CARIPUYO,estado nutricional en menores de 5 anos,clasificacion e,2001-09-01,2,58,2,58,60
21902,CATACORA,estado nutricional en menores de 5 anos,clasificacion e,2001-09-01,0,2,0,2,2
21803,CHACARILLA,estado nutricional en menores de 5 anos,clasificacion e,2001-09-01,0,4,0,4,4
40201,CHALLAPATA,estado nutricional en menores de 5 anos,clasificacion e,2001-09-01,9,4,9,4,13
50302,CHAQUI,estado nutricional en menores de 5 anos,clasificacion e,2001-09-01,0,26,0,26,26
70702,CHARAGUA,estado nutricional en menores de 5 anos,clasificacion e,2001-09-01,0,62,0,62,62
20305,CHARAÃ‘A,estado nutricional en menores de 5 anos,clasificacion e,2001-09-01,0,3,0,3,3
50202,CHAYANTA,estado nutricional en menores de 5 anos,clasificacion e,2001-09-01,0,31,0,31,31
31204,CHIMORE,estado nutricional en menores de 5 anos,clasificacion e,2001-09-01,6,16,6,16,22
40302,CHOQUE COTA,estado nutricional en menores de 5 anos,clasificacion e,2001-09-01,0,2,0,2,2
21101,CHULUMANI (V. DE LA LIBERTAD),estado nutricional en menores de 5 anos,clasificacion e,2001-09-01,0,3,0,3,3
20501,CHUMA,estado nutricional en menores de 5 anos,clasificacion e,2001-09-01,7,1,7,1,8
30801,CLIZA,estado nutricional en menores de 5 anos,clasificacion e,2001-09-01,2,7,2,7,9
90101,COBIJA,estado nutricional en menores de 5 anos,clasificacion e,2001-09-01,35,15,35,15,50
30101,COCHABAMBA,estado nutricional en menores de 5 anos,clasificacion e,2001-09-01,44,44,44,44,88
30905,COLCAPIRHUA,estado nutricional en menores de 5 anos,clasificacion e,2001-09-01,63,31,63,31,94
50901,"COLCHA ""K""",estado nutricional en menores de 5 anos,clasificacion e,2001-09-01,0,10,0,10,10
21307,COLLANA,estado nutricional en menores de 5 anos,clasificacion e,2001-09-01,1,0,1,0,1
31002,COLOMI,estado nutricional en menores de 5 anos,clasificacion e,2001-09-01,6,28,6,28,34
70603,COLPA BELGICA,estado nutricional en menores de 5 anos,clasificacion e,2001-09-01,7,1,7,1,8
50401,COLQUECHACA,estado nutricional en menores de 5 anos,clasificacion e,2001-09-01,9,54,9,54,63
21306,COLQUENCHA,estado nutricional en menores de 5 anos,clasificacion e,2001-09-01,2,3,2,3,5
21004,COLQUIRI,estado nutricional en menores de 5 anos,clasificacion e,2001-09-01,41,14,41,14,55
20304,COMANCHE,estado nutricional en menores de 5 anos,clasificacion e,2001-09-01,2,7,2,7,9
71301,COMARAPA,estado nutricional en menores de 5 anos,clasificacion e,2001-09-01,7,3,7,3,10
20605,COMBAYA,estado nutricional en menores de 5 anos,clasificacion e,2001-09-01,0,5,0,5,5
71101,CONCEPCION,estado nutricional en menores de 5 anos,clasificacion e,2001-09-01,4,4,4,4,8
21701,COPACABANA,estado nutricional en menores de 5 anos,clasificacion e,2001-09-01,0,10,0,10,10
21402,CORIPATA,estado nutricional en menores de 5 anos,clasificacion e,2001-09-01,0,3,0,3,3
20301,CORO CORO,estado nutricional en menores de 5 anos,clasificacion e,2001-09-01,1,0,1,0,1
21401,COROICO,estado nutricional en menores de 5 anos,clasificacion e,2001-09-01,4,3,4,3,7
40301,CORQUE,estado nutricional en menores de 5 anos,clasificacion e,2001-09-01,0,9,0,9,9
50601,COTAGAITA,estado nutricional en menores de 5 anos,clasificacion e,2001-09-01,1,53,1,53,54
70102,COTOCA,estado nutricional en menores de 5 anos,clasificacion e,2001-09-01,0,5,0,5,5
31405,CUCHUMUELA (V. G. VILLARROEL),estado nutricional en menores de 5 anos,clasificacion e,2001-09-01,0,1,0,1,1
70704,CUEVO,estado nutricional en menores de 5 anos,clasificacion e,2001-09-01,7,14,7,14,21
10902,CULPINA,estado nutricional en menores de 5 anos,clasificacion e,2001-09-01,1,115,1,115,116
40401,CURAHUARA DE CARANGAS,estado nutricional en menores de 5 anos,clasificacion e,2001-09-01,4,2,4,2,6
21602,CURVA,estado nutricional en menores de 5 anos,clasificacion e,2001-09-01,4,2,4,2,6
20804,DESAGUADERO,estado nutricional en menores de 5 anos,clasificacion e,2001-09-01,1,11,1,11,12
20105,EL ALTO,estado nutricional en menores de 5 anos,clasificacion e,2001-09-01,215,310,215,310,525
71503,EL PUENTE(STC),estado nutricional en menores de 5 anos,clasificacion e,2001-09-01,0,36,0,36,36
60502,EL PUENTE(TJA),estado nutricional en menores de 5 anos,clasificacion e,2001-09-01,4,5,4,5,9
70105,EL TORNO,estado nutricional en menores de 5 anos,clasificacion e,2001-09-01,0,32,0,32,32
10405,EL VILLAR,estado nutricional en menores de 5 anos,clasificacion e,2001-09-01,0,42,0,42,42
60601,ENTRE RIOS,estado nutricional en menores de 5 anos,clasificacion e,2001-09-01,2,10,2,10,12
41101,EUCALIPTUS,estado nutricional en menores de 5 anos,clasificacion e,2001-09-01,0,1,0,1,1
80402,EXALTACION,estado nutricional en menores de 5 anos,clasificacion e,2001-09-01,2,0,2,0,2
90203,FILADELFIA,estado nutricional en menores de 5 anos,clasificacion e,2001-09-01,0,4,0,4,4
71002,GENERAL SAAVEDRA,estado nutricional en menores de 5 anos,clasificacion e,2001-09-01,0,36,0,36,36
21601,GRAL. J.J. PEREZ (CHARAZANI),estado nutricional en menores de 5 anos,clasificacion e,2001-09-01,0,4,0,4,4
20602,GUANAY,estado nutricional en menores de 5 anos,clasificacion e,2001-09-01,8,23,8,23,31
20802,GUAQUI,estado nutricional en menores de 5 anos,clasificacion e,2001-09-01,0,5,0,5,5
80202,GUAYARAMERIN,estado nutricional en menores de 5 anos,clasificacion e,2001-09-01,37,25,37,25,62
70705,GUTIERREZ,estado nutricional en menores de 5 anos,clasificacion e,2001-09-01,1,32,1,32,33
10502,HUACARETA,estado nutricional en menores de 5 anos,clasificacion e,2001-09-01,1,50,1,50,51
40701,HUANUNI,estado nutricional en menores de 5 anos,clasificacion e,2001-09-01,0,7,0,7,7
80803,HUARACAJE,estado nutricional en menores de 5 anos,clasificacion e,2001-09-01,1,0,1,0,1
41601,HUAYLLAMARCA,estado nutricional en menores de 5 anos,clasificacion e,2001-09-01,0,4,0,4,4
21005,ICHOCA,estado nutricional en menores de 5 anos,clasificacion e,2001-09-01,0,3,0,3,3
10304,ICLA,estado nutricional en menores de 5 anos,clasificacion e,2001-09-01,59,73,59,73,132
10703,INCAHUASI,estado nutricional en menores de 5 anos,clasificacion e,2001-09-01,5,96,5,96,101
21001,INQUISIVI,estado nutricional en menores de 5 anos,clasificacion e,2001-09-01,2,23,2,23,25
21102,IRUPANA (VILLA DE LANZA),estado nutricional en menores de 5 anos,clasificacion e,2001-09-01,1,7,1,7,8
21501,IXIAMAS,estado nutricional en menores de 5 anos,clasificacion e,2001-09-01,2,6,2,6,8
21105,LA ASUNTA,estado nutricional en menores de 5 anos,clasificacion e,2001-09-01,7,16,7,16,23
70104,LA GUARDIA,estado nutricional en menores de 5 anos,clasificacion e,2001-09-01,0,7,0,7,7
20101,LA PAZ,estado nutricional en menores de 5 anos,clasificacion e,2001-09-01,125,171,125,171,296
70701,LAGUNILLAS,estado nutricional en menores de 5 anos,clasificacion e,2001-09-01,5,17,5,17,22
21202,LAJA,estado nutricional en menores de 5 anos,clasificacion e,2001-09-01,0,16,0,16,16
10903,LAS CARRERAS,estado nutricional en menores de 5 anos,clasificacion e,2001-09-01,0,11,0,11,11
50203,LLALLAGUA,estado nutricional en menores de 5 anos,clasificacion e,2001-09-01,0,58,0,58,58
51401,LLICA,estado nutricional en menores de 5 anos,clasificacion e,2001-09-01,0,2,0,2,2
20901,LURIBAY,estado nutricional en menores de 5 anos,clasificacion e,2001-09-01,0,1,0,1,1
40702,MACHACAMARCA,estado nutricional en menores de 5 anos,clasificacion e,2001-09-01,1,2,1,2,3
11003,MACHARETI,estado nutricional en menores de 5 anos,clasificacion e,2001-09-01,0,25,0,25,25
80801,MAGDALENA,estado nutricional en menores de 5 anos,clasificacion e,2001-09-01,0,3,0,3,3
70903,MAIRANA,estado nutricional en menores de 5 anos,clasificacion e,2001-09-01,2,7,2,7,9
20103,MECAPACA,estado nutricional en menores de 5 anos,clasificacion e,2001-09-01,4,5,4,5,9
71003,MINEROS,estado nutricional en menores de 5 anos,clasificacion e,2001-09-01,5,38,5,38,43
31301,MIZQUE,estado nutricional en menores de 5 anos,clasificacion e,2001-09-01,5,8,5,8,13
20402,MOCOMOCO,estado nutricional en menores de 5 anos,clasificacion e,2001-09-01,10,14,10,14,24
51002,MOJINETE,estado nutricional en menores de 5 anos,clasificacion e,2001-09-01,0,5,0,5,5
10303,MOJOCOYA,estado nutricional en menores de 5 anos,clasificacion e,2001-09-01,0,47,0,47,47
10501,MONTEAGUDO,estado nutricional en menores de 5 anos,clasificacion e,2001-09-01,2,79,2,79,81
71001,MONTERO,estado nutricional en menores de 5 anos,clasificacion e,2001-09-01,2,87,2,87,89
70803,MORO MORO,estado nutricional en menores de 5 anos,clasificacion e,2001-09-01,4,5,4,5,9
30302,MOROCHATA,estado nutricional en menores de 5 anos,clasificacion e,2001-09-01,30,31,30,31,61
90401,NACEBE (SANTA ROSA DEL ABUNA),estado nutricional en menores de 5 anos,clasificacion e,2001-09-01,0,8,0,8,8
50404,OCURI,estado nutricional en menores de 5 anos,clasificacion e,2001-09-01,28,33,28,33,61
70202,OKINAWA,estado nutricional en menores de 5 anos,clasificacion e,2001-09-01,0,1,0,1,1
30203,OMEREQUE,estado nutricional en menores de 5 anos,clasificacion e,2001-09-01,0,7,0,7,7
40101,ORURO,estado nutricional en menores de 5 anos,clasificacion e,2001-09-01,8,130,8,130,138
60201,PADCAYA,estado nutricional en menores de 5 anos,clasificacion e,2001-09-01,1,6,1,6,7
10401,PADILLA,estado nutricional en menores de 5 anos,clasificacion e,2001-09-01,4,128,4,128,132
70502,PAILON,estado nutricional en menores de 5 anos,clasificacion e,2001-09-01,0,15,0,15,15
20102,PALCA,estado nutricional en menores de 5 anos,clasificacion e,2001-09-01,14,18,14,18,32
21104,PALOS BLANCOS,estado nutricional en menores de 5 anos,clasificacion e,2001-09-01,11,55,11,55,66
40802,PAMPA AULLAGAS,estado nutricional en menores de 5 anos,clasificacion e,2001-09-01,3,3,3,3,6
70902,PAMPA GRANDE,estado nutricional en menores de 5 anos,clasificacion e,2001-09-01,0,2,0,2,2
21802,PAPEL PAMPA,estado nutricional en menores de 5 anos,clasificacion e,2001-09-01,0,2,0,2,2
30202,PASORAPA,estado nutricional en menores de 5 anos,clasificacion e,2001-09-01,0,5,0,5,5
21305,PATACAMAYA,estado nutricional en menores de 5 anos,clasificacion e,2001-09-01,7,1,7,1,8
40602,PAZÃ‘A,estado nutricional en menores de 5 anos,clasificacion e,2001-09-01,0,6,0,6,6
20702,PELECHUCO,estado nutricional en menores de 5 anos,clasificacion e,2001-09-01,9,3,9,3,12
50403,POCOATA,estado nutricional en menores de 5 anos,clasificacion e,2001-09-01,28,46,28,46,74
31203,POCONA,estado nutricional en menores de 5 anos,clasificacion e,2001-09-01,10,36,10,36,46
31202,POJO (CBBA),estado nutricional en menores de 5 anos,clasificacion e,2001-09-01,5,35,5,35,40
40601,POOPO,estado nutricional en menores de 5 anos,clasificacion e,2001-09-01,1,12,1,12,13
51203,PORCO,estado nutricional en menores de 5 anos,clasificacion e,2001-09-01,1,11,1,11,12
10103,POROMA,estado nutricional en menores de 5 anos,clasificacion e,2001-09-01,3,85,3,85,88
70103,PORONGO,estado nutricional en menores de 5 anos,clasificacion e,2001-09-01,1,4,1,4,5
70601,PORTACHUELO,estado nutricional en menores de 5 anos,clasificacion e,2001-09-01,5,8,5,8,13
90102,PORVENIR,estado nutricional en menores de 5 anos,clasificacion e,2001-09-01,0,2,0,2,2
70804,POSTRER VALLE,estado nutricional en menores de 5 anos,clasificacion e,2001-09-01,2,1,2,1,3
50101,POTOSI,estado nutricional en menores de 5 anos,clasificacion e,2001-09-01,3,230,3,230,233
10302,PRESTO,estado nutricional en menores de 5 anos,clasificacion e,2001-09-01,0,39,0,39,39
21201,PUCARANI,estado nutricional en menores de 5 anos,clasificacion e,2001-09-01,1,16,1,16,17
20403,PUERTO CARABUCO,estado nutricional en menores de 5 anos,clasificacion e,2001-09-01,34,36,34,36,70
90301,PUERTO GONZALO MORENO,estado nutricional en menores de 5 anos,clasificacion e,2001-09-01,0,13,0,13,13
21204,PUERTO PEREZ,estado nutricional en menores de 5 anos,clasificacion e,2001-09-01,0,4,0,4,4
71402,PUERTO QUIJARRO,estado nutricional en menores de 5 anos,clasificacion e,2001-09-01,9,0,9,0,9
90201,PUERTO RICO,estado nutricional en menores de 5 anos,clasificacion e,2001-09-01,1,4,1,4,5
80703,PUERTO SILES,estado nutricional en menores de 5 anos,clasificacion e,2001-09-01,1,2,1,2,3
71401,PUERTO SUAREZ,estado nutricional en menores de 5 anos,clasificacion e,2001-09-01,15,10,15,10,25
31205,PUERTO VILLARROEL,estado nutricional en menores de 5 anos,clasificacion e,2001-09-01,27,26,27,26,53
51101,PUNA,estado nutricional en menores de 5 anos,clasificacion e,2001-09-01,6,112,6,112,118
31401,PUNATA,estado nutricional en menores de 5 anos,clasificacion e,2001-09-01,2,7,2,7,9
20604,QUIABAYA,estado nutricional en menores de 5 anos,clasificacion e,2001-09-01,1,14,1,14,15
30901,QUILLACOLLO,estado nutricional en menores de 5 anos,clasificacion e,2001-09-01,0,13,0,13,13
21002,QUIME,estado nutricional en menores de 5 anos,clasificacion e,2001-09-01,6,19,6,19,25
50402,RAVELO,estado nutricional en menores de 5 anos,clasificacion e,2001-09-01,7,201,7,201,208
80301,REYES,estado nutricional en menores de 5 anos,clasificacion e,2001-09-01,2,31,2,31,33
80201,RIBERALTA,estado nutricional en menores de 5 anos,clasificacion e,2001-09-01,3,151,3,151,154
70503,ROBORE,estado nutricional en menores de 5 anos,clasificacion e,2001-09-01,1,15,1,15,16
80304,RURRENABAQUE,estado nutricional en menores de 5 anos,clasificacion e,2001-09-01,7,5,7,5,12
31001,SACABA,estado nutricional en menores de 5 anos,clasificacion e,2001-09-01,25,65,25,65,90
30404,SACABAMBA,estado nutricional en menores de 5 anos,clasificacion e,2001-09-01,0,19,0,19,19
50701,SACACA,estado nutricional en menores de 5 anos,clasificacion e,2001-09-01,0,128,0,128,128
71302,SAIPINA,estado nutricional en menores de 5 anos,clasificacion e,2001-09-01,5,3,5,3,8
40801,SALINAS DE GARCI MENDOZA,estado nutricional en menores de 5 anos,clasificacion e,2001-09-01,2,1,2,1,3
70901,SAMAIPATA,estado nutricional en menores de 5 anos,clasificacion e,2001-09-01,0,2,0,2,2
80602,SAN ANDRES,estado nutricional en menores de 5 anos,clasificacion e,2001-09-01,1,12,1,12,13
51003,SAN ANTONIO DE ESMORUCO,estado nutricional en menores de 5 anos,clasificacion e,2001-09-01,0,7,0,7,7
71105,SAN ANTONIO DE LOMERIO,estado nutricional en menores de 5 anos,clasificacion e,2001-09-01,34,41,34,41,75
31403,SAN BENITO,estado nutricional en menores de 5 anos,clasificacion e,2001-09-01,0,7,0,7,7
80302,SAN BORJA,estado nutricional en menores de 5 anos,clasificacion e,2001-09-01,23,13,23,13,36
21502,SAN BUENA VENTURA,estado nutricional en menores de 5 anos,clasificacion e,2001-09-01,3,18,3,18,21
70402,SAN CARLOS,estado nutricional en menores de 5 anos,clasificacion e,2001-09-01,1,6,1,6,7
80501,SAN IGNACIO,estado nutricional en menores de 5 anos,clasificacion e,2001-09-01,9,35,9,35,44
70301,SAN IGNACIO DE VELASCO,estado nutricional en menores de 5 anos,clasificacion e,2001-09-01,50,64,50,64,114
80102,SAN JAVIER(BNI),estado nutricional en menores de 5 anos,clasificacion e,2001-09-01,0,5,0,5,5
71102,SAN JAVIER(STC),estado nutricional en menores de 5 anos,clasificacion e,2001-09-01,2,3,2,3,5
80701,SAN JOAQUIN,estado nutricional en menores de 5 anos,clasificacion e,2001-09-01,0,4,0,4,4
70501,SAN JOSE DE CHIQUITOS,estado nutricional en menores de 5 anos,clasificacion e,2001-09-01,14,3,14,3,17
71104,SAN JULIAN,estado nutricional en menores de 5 anos,clasificacion e,2001-09-01,15,25,15,25,40
90302,SAN LORENZO(PND),estado nutricional en menores de 5 anos,clasificacion e,2001-09-01,0,5,0,5,5
60501,SAN LORENZO(TJA),estado nutricional en menores de 5 anos,clasificacion e,2001-09-01,0,12,0,12,12
10702,SAN LUCAS,estado nutricional en menores de 5 anos,clasificacion e,2001-09-01,3,257,3,257,260
71201,SAN MATIAS,estado nutricional en menores de 5 anos,clasificacion e,2001-09-01,11,14,11,14,25
70302,SAN MIGUEL DE VELASCO,estado nutricional en menores de 5 anos,clasificacion e,2001-09-01,0,61,0,61,61
51001,SAN PABLO DE LIPEZ,estado nutricional en menores de 5 anos,clasificacion e,2001-09-01,0,9,0,9,9
50501,SAN PEDRO DE BUENA VISTA,estado nutricional en menores de 5 anos,clasificacion e,2001-09-01,1,138,1,138,139
90202,SAN PEDRO(PND),estado nutricional en menores de 5 anos,clasificacion e,2001-09-01,1,0,1,0,1
70303,SAN RAFAEL,estado nutricional en menores de 5 anos,clasificacion e,2001-09-01,11,9,11,9,20
80702,SAN RAMON,estado nutricional en menores de 5 anos,clasificacion e,2001-09-01,0,1,0,1,1
80702,SAN RAMON,estado nutricional en menores de 5 anos,clasificacion e,2001-09-01,2,1,2,1,3
80401,SANTA ANA,estado nutricional en menores de 5 anos,clasificacion e,2001-09-01,0,1,0,1,1
70101,SANTA CRUZ DE LA SIERRA,estado nutricional en menores de 5 anos,clasificacion e,2001-09-01,45,47,45,47,92
80303,SANTA ROSA,estado nutricional en menores de 5 anos,clasificacion e,2001-09-01,2,1,2,1,3
70602,SANTA ROSA DEL SARA,estado nutricional en menores de 5 anos,clasificacion e,2001-09-01,2,2,2,2,4
20308,SANTIAGO DE CALLAPA,estado nutricional en menores de 5 anos,clasificacion e,2001-09-01,0,2,0,2,2
41401,SANTIAGO DE HUARI,estado nutricional en menores de 5 anos,clasificacion e,2001-09-01,9,4,9,4,13
21901,SANTIAGO DE MACHACA,estado nutricional en menores de 5 anos,clasificacion e,2001-09-01,0,4,0,4,4
30702,SANTIVAÃ‘ES,estado nutricional en menores de 5 anos,clasificacion e,2001-09-01,9,3,9,3,12
40202,SANTUARIO DE QUILLACAS,estado nutricional en menores de 5 anos,clasificacion e,2001-09-01,1,6,1,6,7
20902,SAPAHAQUI,estado nutricional en menores de 5 anos,clasificacion e,2001-09-01,0,6,0,6,6
90303,SENA,estado nutricional en menores de 5 anos,clasificacion e,2001-09-01,0,2,0,2,2
21301,SICA SICA (VILLA AROMA),estado nutricional en menores de 5 anos,clasificacion e,2001-09-01,5,7,5,7,12
30703,SICAYA,estado nutricional en menores de 5 anos,clasificacion e,2001-09-01,0,9,0,9,9
30902,SIPE SIPE,estado nutricional en menores de 5 anos,clasificacion e,2001-09-01,33,20,33,20,53
10403,SOPACHUY,estado nutricional en menores de 5 anos,clasificacion e,2001-09-01,1,16,1,16,17
20601,SORATA,estado nutricional en menores de 5 anos,clasificacion e,2001-09-01,0,16,0,16,16
10101,SUCRE,estado nutricional en menores de 5 anos,clasificacion e,2001-09-01,5,258,5,258,263
31404,TACACHI,estado nutricional en menores de 5 anos,clasificacion e,2001-09-01,0,2,0,2,2
20603,TACACOMA,estado nutricional en menores de 5 anos,clasificacion e,2001-09-01,0,5,0,5,5
50303,TACOBAMBA,estado nutricional en menores de 5 anos,clasificacion e,2001-09-01,2,60,2,60,62
30602,TACOPAYA,estado nutricional en menores de 5 anos,clasificacion e,2001-09-01,7,10,7,10,17
51402,TAHUA,estado nutricional en menores de 5 anos,clasificacion e,2001-09-01,1,2,1,2,3
31101,TAPACARI,estado nutricional en menores de 5 anos,clasificacion e,2001-09-01,1,42,1,42,43
10601,TARABUCO,estado nutricional en menores de 5 anos,clasificacion e,2001-09-01,2,216,2,216,218
30401,TARATA,estado nutricional en menores de 5 anos,clasificacion e,2001-09-01,1,12,1,12,13
60101,TARIJA,estado nutricional en menores de 5 anos,clasificacion e,2001-09-01,6,37,6,37,43
10202,TARVITA,estado nutricional en menores de 5 anos,clasificacion e,2001-09-01,0,32,0,32,32
20803,TIAWANACU,estado nutricional en menores de 5 anos,clasificacion e,2001-09-01,3,7,3,7,10
50102,TINGUIPAYA,estado nutricional en menores de 5 anos,clasificacion e,2001-09-01,17,40,17,40,57
20606,TIPUANI,estado nutricional en menores de 5 anos,clasificacion e,2001-09-01,1,0,1,0,1
30903,TIQUIPAYA,estado nutricional en menores de 5 anos,clasificacion e,2001-09-01,0,6,0,6,6
31601,TIRAQUE (CBBA),estado nutricional en menores de 5 anos,clasificacion e,2001-09-01,22,29,22,29,51
30802,TOCO,estado nutricional en menores de 5 anos,clasificacion e,2001-09-01,0,3,0,3,3
41001,TOLEDO,estado nutricional en menores de 5 anos,clasificacion e,2001-09-01,2,0,2,0,2
51202,TOMAVE,estado nutricional en menores de 5 anos,clasificacion e,2001-09-01,0,29,0,29,29
10402,TOMINA,estado nutricional en menores de 5 anos,clasificacion e,2001-09-01,0,84,0,84,84
50502,TORO TORO,estado nutricional en menores de 5 anos,clasificacion e,2001-09-01,0,9,0,9,9
31201,TOTORA(CBBA),estado nutricional en menores de 5 anos,clasificacion e,2001-09-01,10,8,10,8,18
41301,TOTORA(ORR),estado nutricional en menores de 5 anos,clasificacion e,2001-09-01,0,7,0,7,7
70802,TRIGAL,estado nutricional en menores de 5 anos,clasificacion e,2001-09-01,2,0,2,0,2
80101,TRINIDAD,estado nutricional en menores de 5 anos,clasificacion e,2001-09-01,13,74,13,74,87
50801,TUPIZA,estado nutricional en menores de 5 anos,clasificacion e,2001-09-01,0,74,0,74,74
40402,TURCO,estado nutricional en menores de 5 anos,clasificacion e,2001-09-01,0,1,0,1,1
21302,UMALA,estado nutricional en menores de 5 anos,clasificacion e,2001-09-01,0,8,0,8,8
50201,UNCIA,estado nutricional en menores de 5 anos,clasificacion e,2001-09-01,0,28,0,28,28
60401,URIONDO (A. CONCEPCION),estado nutricional en menores de 5 anos,clasificacion e,2001-09-01,0,3,0,3,3
71502,URUBICHA,estado nutricional en menores de 5 anos,clasificacion e,2001-09-01,0,26,0,26,26
51201,UYUNI,estado nutricional en menores de 5 anos,clasificacion e,2001-09-01,1,42,1,42,43
30502,VACAS,estado nutricional en menores de 5 anos,clasificacion e,2001-09-01,0,11,0,11,11
70801,VALLEGRANDE,estado nutricional en menores de 5 anos,clasificacion e,2001-09-01,4,9,4,9,13
20801,VIACHA,estado nutricional en menores de 5 anos,clasificacion e,2001-09-01,0,30,0,30,30
31302,VILA VILA,estado nutricional en menores de 5 anos,clasificacion e,2001-09-01,9,11,9,11,20
60303,VILLA MONTES,estado nutricional en menores de 5 anos,clasificacion e,2001-09-01,7,9,7,9,16
31402,VILLA RIVERO,estado nutricional en menores de 5 anos,clasificacion e,2001-09-01,0,8,0,8,8
10801,VILLA SERRANO,estado nutricional en menores de 5 anos,clasificacion e,2001-09-01,0,84,0,84,84
31003,VILLA TUNARI,estado nutricional en menores de 5 anos,clasificacion e,2001-09-01,10,14,10,14,24
11001,VILLA VACA GUZMAN (MUYUPAMPA),estado nutricional en menores de 5 anos,clasificacion e,2001-09-01,1,46,1,46,47
51501,VILLAZON,estado nutricional en menores de 5 anos,clasificacion e,2001-09-01,0,46,0,46,46
50602,VITICHI,estado nutricional en menores de 5 anos,clasificacion e,2001-09-01,0,36,0,36,36
70201,WARNES,estado nutricional en menores de 5 anos,clasificacion e,2001-09-01,15,14,15,14,29
20903,YACO,estado nutricional en menores de 5 anos,clasificacion e,2001-09-01,0,14,0,14,14
60301,YACUIBA,estado nutricional en menores de 5 anos,clasificacion e,2001-09-01,3,4,3,4,7
10602,YAMPARAEZ,estado nutricional en menores de 5 anos,clasificacion e,2001-09-01,0,83,0,83,83
70403,YAPACANI,estado nutricional en menores de 5 anos,clasificacion e,2001-09-01,14,28,14,28,42
50103,YOCALLA,estado nutricional en menores de 5 anos,clasificacion e,2001-09-01,0,15,0,15,15
10102,YOTALA,estado nutricional en menores de 5 anos,clasificacion e,2001-09-01,1,66,1,66,67
60402,YUNCHARA,estado nutricional en menores de 5 anos,clasificacion e,2001-09-01,5,5,5,5,10
10301,ZUDAÃ‘EZ,estado nutricional en menores de 5 anos,clasificacion e,2001-09-01,1,82,1,82,83
51302,ACACIO,estado nutricional en menores de 5 anos,clasificacion e,2001-10-01,0,44,0,44,44
20201,ACHACACHI,estado nutricional en menores de 5 anos,clasificacion e,2001-10-01,1,20,1,20,21
20104,ACHOCALLA,estado nutricional en menores de 5 anos,clasificacion e,2001-10-01,1,5,1,5,6
30201,AIQUILE,estado nutricional en menores de 5 anos,clasificacion e,2001-10-01,22,18,22,18,40
31303,ALALAY,estado nutricional en menores de 5 anos,clasificacion e,2001-10-01,0,4,0,4,4
10404,ALCALA,estado nutricional en menores de 5 anos,clasificacion e,2001-10-01,0,30,0,30,30
20202,ANCORAIMES,estado nutricional en menores de 5 anos,clasificacion e,2001-10-01,0,36,0,36,36
41201,ANDAMARCA,estado nutricional en menores de 5 anos,clasificacion e,2001-10-01,2,0,2,0,2
30402,ANZALDO,estado nutricional en menores de 5 anos,clasificacion e,2001-10-01,4,24,4,24,28
20701,APOLO,estado nutricional en menores de 5 anos,clasificacion e,2001-10-01,6,1,6,1,7
51301,ARAMPAMPA,estado nutricional en menores de 5 anos,clasificacion e,2001-10-01,0,19,0,19,19
30501,ARANI,estado nutricional en menores de 5 anos,clasificacion e,2001-10-01,4,23,4,23,27
30403,ARBIETO,estado nutricional en menores de 5 anos,clasificacion e,2001-10-01,0,3,0,3,3
30601,ARQUE,estado nutricional en menores de 5 anos,clasificacion e,2001-10-01,8,15,8,15,23
71501,ASCENCION DE GUARAYOS,estado nutricional en menores de 5 anos,clasificacion e,2001-10-01,45,67,45,67,112
50802,ATOCHA,estado nutricional en menores de 5 anos,clasificacion e,2001-10-01,0,25,0,25,25
20503,AUCAPATA,estado nutricional en menores de 5 anos,clasificacion e,2001-10-01,0,2,0,2,2
20502,AYATA,estado nutricional en menores de 5 anos,clasificacion e,2001-10-01,16,0,16,0,16
21303,AYO AYO,estado nutricional en menores de 5 anos,clasificacion e,2001-10-01,5,3,5,3,8
30301,AYOPAYA (V. DE INDEPENDENCIA),estado nutricional en menores de 5 anos,clasificacion e,2001-10-01,23,35,23,35,58
10201,AZURDUY,estado nutricional en menores de 5 anos,clasificacion e,2001-10-01,0,74,0,74,74
21203,BATALLAS,estado nutricional en menores de 5 anos,clasificacion e,2001-10-01,1,7,1,7,8
80802,BAURES,estado nutricional en menores de 5 anos,clasificacion e,2001-10-01,9,9,9,9,18
41202,BELEN DE ANDAMARCA,estado nutricional en menores de 5 anos,clasificacion e,2001-10-01,0,1,0,1,1
50104,BELEN DE URMIRI,estado nutricional en menores de 5 anos,clasificacion e,2001-10-01,0,5,0,5,5
60202,BERMEJO,estado nutricional en menores de 5 anos,clasificacion e,2001-10-01,1,5,1,5,6
50301,BETANZOS,estado nutricional en menores de 5 anos,clasificacion e,2001-10-01,0,81,0,81,81
31501,BOLIVAR,estado nutricional en menores de 5 anos,clasificacion e,2001-10-01,37,10,37,10,47
90103,BOLPEBRA,estado nutricional en menores de 5 anos,clasificacion e,2001-10-01,0,2,0,2,2
70707,BOYUIBE,estado nutricional en menores de 5 anos,clasificacion e,2001-10-01,3,9,3,9,12
70401,BUENA VISTA,estado nutricional en menores de 5 anos,clasificacion e,2001-10-01,12,21,12,21,33
70703,CABEZAS,estado nutricional en menores de 5 anos,clasificacion e,2001-10-01,1,22,1,22,23
20905,CAIROMA,estado nutricional en menores de 5 anos,clasificacion e,2001-10-01,0,1,0,1,1
51102,"CAIZA ""D""",estado nutricional en menores de 5 anos,clasificacion e,2001-10-01,2,37,2,37,39
21003,CAJUATA,estado nutricional en menores de 5 anos,clasificacion e,2001-10-01,6,1,6,1,7
20303,CALACOTO,estado nutricional en menores de 5 anos,clasificacion e,2001-10-01,1,0,1,0,1
21304,CALAMARCA,estado nutricional en menores de 5 anos,clasificacion e,2001-10-01,3,6,3,6,9
10701,CAMARGO,estado nutricional en menores de 5 anos,clasificacion e,2001-10-01,0,35,0,35,35
10901,CAMATAQUI (C. VILLA ABECIA),estado nutricional en menores de 5 anos,clasificacion e,2001-10-01,0,2,0,2,2
70706,CAMIRI,estado nutricional en menores de 5 anos,clasificacion e,2001-10-01,21,25,21,25,46
30701,CAPINOTA,estado nutricional en menores de 5 anos,clasificacion e,2001-10-01,24,27,24,27,51
20302,CAQUIAVIRI,estado nutricional en menores de 5 anos,clasificacion e,2001-10-01,4,5,4,5,9
40102,CARACOLLO,estado nutricional en menores de 5 anos,clasificacion e,2001-10-01,2,5,2,5,7
22001,CARANAVI,estado nutricional en menores de 5 anos,clasificacion e,2001-10-01,23,38,23,38,61
60302,CARAPARI,estado nutricional en menores de 5 anos,clasificacion e,2001-10-01,0,9,0,9,9
50702,CARIPUYO,estado nutricional en menores de 5 anos,clasificacion e,2001-10-01,0,46,0,46,46
21803,CHACARILLA,estado nutricional en menores de 5 anos,clasificacion e,2001-10-01,0,1,0,1,1
40201,CHALLAPATA,estado nutricional en menores de 5 anos,clasificacion e,2001-10-01,9,9,9,9,18
50302,CHAQUI,estado nutricional en menores de 5 anos,clasificacion e,2001-10-01,0,28,0,28,28
70702,CHARAGUA,estado nutricional en menores de 5 anos,clasificacion e,2001-10-01,1,67,1,67,68
20305,CHARAÃ‘A,estado nutricional en menores de 5 anos,clasificacion e,2001-10-01,0,8,0,8,8
50202,CHAYANTA,estado nutricional en menores de 5 anos,clasificacion e,2001-10-01,1,42,1,42,43
31204,CHIMORE,estado nutricional en menores de 5 anos,clasificacion e,2001-10-01,7,15,7,15,22
21101,CHULUMANI (V. DE LA LIBERTAD),estado nutricional en menores de 5 anos,clasificacion e,2001-10-01,0,1,0,1,1
20501,CHUMA,estado nutricional en menores de 5 anos,clasificacion e,2001-10-01,5,10,5,10,15
30801,CLIZA,estado nutricional en menores de 5 anos,clasificacion e,2001-10-01,0,16,0,16,16
90101,COBIJA,estado nutricional en menores de 5 anos,clasificacion e,2001-10-01,29,15,29,15,44
30101,COCHABAMBA,estado nutricional en menores de 5 anos,clasificacion e,2001-10-01,72,110,72,110,182
30905,COLCAPIRHUA,estado nutricional en menores de 5 anos,clasificacion e,2001-10-01,32,17,32,17,49
50901,"COLCHA ""K""",estado nutricional en menores de 5 anos,clasificacion e,2001-10-01,0,8,0,8,8
31002,COLOMI,estado nutricional en menores de 5 anos,clasificacion e,2001-10-01,7,14,7,14,21
70603,COLPA BELGICA,estado nutricional en menores de 5 anos,clasificacion e,2001-10-01,3,0,3,0,3
50401,COLQUECHACA,estado nutricional en menores de 5 anos,clasificacion e,2001-10-01,0,39,0,39,39
21306,COLQUENCHA,estado nutricional en menores de 5 anos,clasificacion e,2001-10-01,6,6,6,6,12
21004,COLQUIRI,estado nutricional en menores de 5 anos,clasificacion e,2001-10-01,22,17,22,17,39
20304,COMANCHE,estado nutricional en menores de 5 anos,clasificacion e,2001-10-01,4,4,4,4,8
71301,COMARAPA,estado nutricional en menores de 5 anos,clasificacion e,2001-10-01,3,7,3,7,10
20605,COMBAYA,estado nutricional en menores de 5 anos,clasificacion e,2001-10-01,0,4,0,4,4
71101,CONCEPCION,estado nutricional en menores de 5 anos,clasificacion e,2001-10-01,21,7,21,7,28
21701,COPACABANA,estado nutricional en menores de 5 anos,clasificacion e,2001-10-01,0,7,0,7,7
21402,CORIPATA,estado nutricional en menores de 5 anos,clasificacion e,2001-10-01,0,1,0,1,1
20301,CORO CORO,estado nutricional en menores de 5 anos,clasificacion e,2001-10-01,13,5,13,5,18
21401,COROICO,estado nutricional en menores de 5 anos,clasificacion e,2001-10-01,14,5,14,5,19
40301,CORQUE,estado nutricional en menores de 5 anos,clasificacion e,2001-10-01,1,14,1,14,15
50601,COTAGAITA,estado nutricional en menores de 5 anos,clasificacion e,2001-10-01,2,42,2,42,44
70102,COTOCA,estado nutricional en menores de 5 anos,clasificacion e,2001-10-01,0,15,0,15,15
70704,CUEVO,estado nutricional en menores de 5 anos,clasificacion e,2001-10-01,5,10,5,10,15
10902,CULPINA,estado nutricional en menores de 5 anos,clasificacion e,2001-10-01,6,106,6,106,112
40401,CURAHUARA DE CARANGAS,estado nutricional en menores de 5 anos,clasificacion e,2001-10-01,2,0,2,0,2
21602,CURVA,estado nutricional en menores de 5 anos,clasificacion e,2001-10-01,3,0,3,0,3
20804,DESAGUADERO,estado nutricional en menores de 5 anos,clasificacion e,2001-10-01,0,7,0,7,7
20105,EL ALTO,estado nutricional en menores de 5 anos,clasificacion e,2001-10-01,368,415,368,415,783
71503,EL PUENTE(STC),estado nutricional en menores de 5 anos,clasificacion e,2001-10-01,2,20,2,20,22
60502,EL PUENTE(TJA),estado nutricional en menores de 5 anos,clasificacion e,2001-10-01,3,15,3,15,18
70105,EL TORNO,estado nutricional en menores de 5 anos,clasificacion e,2001-10-01,3,29,3,29,32
10405,EL VILLAR,estado nutricional en menores de 5 anos,clasificacion e,2001-10-01,0,59,0,59,59
60601,ENTRE RIOS,estado nutricional en menores de 5 anos,clasificacion e,2001-10-01,5,8,5,8,13
41101,EUCALIPTUS,estado nutricional en menores de 5 anos,clasificacion e,2001-10-01,0,10,0,10,10
80402,EXALTACION,estado nutricional en menores de 5 anos,clasificacion e,2001-10-01,2,5,2,5,7
90203,FILADELFIA,estado nutricional en menores de 5 anos,clasificacion e,2001-10-01,0,5,0,5,5
71002,GENERAL SAAVEDRA,estado nutricional en menores de 5 anos,clasificacion e,2001-10-01,2,33,2,33,35
21601,GRAL. J.J. PEREZ (CHARAZANI),estado nutricional en menores de 5 anos,clasificacion e,2001-10-01,0,1,0,1,1
20602,GUANAY,estado nutricional en menores de 5 anos,clasificacion e,2001-10-01,9,48,9,48,57
20802,GUAQUI,estado nutricional en menores de 5 anos,clasificacion e,2001-10-01,1,4,1,4,5
80202,GUAYARAMERIN,estado nutricional en menores de 5 anos,clasificacion e,2001-10-01,37,26,37,26,63
70705,GUTIERREZ,estado nutricional en menores de 5 anos,clasificacion e,2001-10-01,11,49,11,49,60
10502,HUACARETA,estado nutricional en menores de 5 anos,clasificacion e,2001-10-01,1,63,1,63,64
40701,HUANUNI,estado nutricional en menores de 5 anos,clasificacion e,2001-10-01,0,3,0,3,3
80803,HUARACAJE,estado nutricional en menores de 5 anos,clasificacion e,2001-10-01,6,2,6,2,8
41601,HUAYLLAMARCA,estado nutricional en menores de 5 anos,clasificacion e,2001-10-01,1,3,1,3,4
21005,ICHOCA,estado nutricional en menores de 5 anos,clasificacion e,2001-10-01,0,2,0,2,2
10304,ICLA,estado nutricional en menores de 5 anos,clasificacion e,2001-10-01,27,79,27,79,106
10703,INCAHUASI,estado nutricional en menores de 5 anos,clasificacion e,2001-10-01,0,91,0,91,91
21001,INQUISIVI,estado nutricional en menores de 5 anos,clasificacion e,2001-10-01,1,21,1,21,22
21102,IRUPANA (VILLA DE LANZA),estado nutricional en menores de 5 anos,clasificacion e,2001-10-01,2,5,2,5,7
21501,IXIAMAS,estado nutricional en menores de 5 anos,clasificacion e,2001-10-01,1,10,1,10,11
21105,LA ASUNTA,estado nutricional en menores de 5 anos,clasificacion e,2001-10-01,3,29,3,29,32
70104,LA GUARDIA,estado nutricional en menores de 5 anos,clasificacion e,2001-10-01,1,25,1,25,26
20101,LA PAZ,estado nutricional en menores de 5 anos,clasificacion e,2001-10-01,140,192,140,192,332
70701,LAGUNILLAS,estado nutricional en menores de 5 anos,clasificacion e,2001-10-01,6,8,6,8,14
21202,LAJA,estado nutricional en menores de 5 anos,clasificacion e,2001-10-01,0,23,0,23,23
10903,LAS CARRERAS,estado nutricional en menores de 5 anos,clasificacion e,2001-10-01,0,11,0,11,11
50203,LLALLAGUA,estado nutricional en menores de 5 anos,clasificacion e,2001-10-01,4,38,4,38,42
51401,LLICA,estado nutricional en menores de 5 anos,clasificacion e,2001-10-01,0,9,0,9,9
20901,LURIBAY,estado nutricional en menores de 5 anos,clasificacion e,2001-10-01,0,11,0,11,11
11003,MACHARETI,estado nutricional en menores de 5 anos,clasificacion e,2001-10-01,1,31,1,31,32
80801,MAGDALENA,estado nutricional en menores de 5 anos,clasificacion e,2001-10-01,4,6,4,6,10
70903,MAIRANA,estado nutricional en menores de 5 anos,clasificacion e,2001-10-01,1,7,1,7,8
20103,MECAPACA,estado nutricional en menores de 5 anos,clasificacion e,2001-10-01,2,6,2,6,8
71003,MINEROS,estado nutricional en menores de 5 anos,clasificacion e,2001-10-01,0,39,0,39,39
31301,MIZQUE,estado nutricional en menores de 5 anos,clasificacion e,2001-10-01,7,17,7,17,24
20402,MOCOMOCO,estado nutricional en menores de 5 anos,clasificacion e,2001-10-01,5,4,5,4,9
51002,MOJINETE,estado nutricional en menores de 5 anos,clasificacion e,2001-10-01,0,3,0,3,3
10303,MOJOCOYA,estado nutricional en menores de 5 anos,clasificacion e,2001-10-01,0,40,0,40,40
10501,MONTEAGUDO,estado nutricional en menores de 5 anos,clasificacion e,2001-10-01,0,45,0,45,45
71001,MONTERO,estado nutricional en menores de 5 anos,clasificacion e,2001-10-01,9,142,9,142,151
70803,MORO MORO,estado nutricional en menores de 5 anos,clasificacion e,2001-10-01,1,1,1,1,2
30302,MOROCHATA,estado nutricional en menores de 5 anos,clasificacion e,2001-10-01,15,29,15,29,44
90401,NACEBE (SANTA ROSA DEL ABUNA),estado nutricional en menores de 5 anos,clasificacion e,2001-10-01,0,2,0,2,2
20307,NAZACARA DE PACAJES,estado nutricional en menores de 5 anos,clasificacion e,2001-10-01,0,1,0,1,1
50404,OCURI,estado nutricional en menores de 5 anos,clasificacion e,2001-10-01,22,42,22,42,64
70202,OKINAWA,estado nutricional en menores de 5 anos,clasificacion e,2001-10-01,0,2,0,2,2
30203,OMEREQUE,estado nutricional en menores de 5 anos,clasificacion e,2001-10-01,0,4,0,4,4
40101,ORURO,estado nutricional en menores de 5 anos,clasificacion e,2001-10-01,12,213,12,213,225
60201,PADCAYA,estado nutricional en menores de 5 anos,clasificacion e,2001-10-01,4,13,4,13,17
10401,PADILLA,estado nutricional en menores de 5 anos,clasificacion e,2001-10-01,0,111,0,111,111
70502,PAILON,estado nutricional en menores de 5 anos,clasificacion e,2001-10-01,2,22,2,22,24
20102,PALCA,estado nutricional en menores de 5 anos,clasificacion e,2001-10-01,17,11,17,11,28
21104,PALOS BLANCOS,estado nutricional en menores de 5 anos,clasificacion e,2001-10-01,11,18,11,18,29
40802,PAMPA AULLAGAS,estado nutricional en menores de 5 anos,clasificacion e,2001-10-01,2,3,2,3,5
70902,PAMPA GRANDE,estado nutricional en menores de 5 anos,clasificacion e,2001-10-01,4,2,4,2,6
30202,PASORAPA,estado nutricional en menores de 5 anos,clasificacion e,2001-10-01,0,20,0,20,20
21305,PATACAMAYA,estado nutricional en menores de 5 anos,clasificacion e,2001-10-01,12,2,12,2,14
40602,PAZÃ‘A,estado nutricional en menores de 5 anos,clasificacion e,2001-10-01,0,5,0,5,5
20702,PELECHUCO,estado nutricional en menores de 5 anos,clasificacion e,2001-10-01,0,1,0,1,1
50403,POCOATA,estado nutricional en menores de 5 anos,clasificacion e,2001-10-01,15,34,15,34,49
31203,POCONA,estado nutricional en menores de 5 anos,clasificacion e,2001-10-01,0,30,0,30,30
31202,POJO (CBBA),estado nutricional en menores de 5 anos,clasificacion e,2001-10-01,13,25,13,25,38
40601,POOPO,estado nutricional en menores de 5 anos,clasificacion e,2001-10-01,0,9,0,9,9
51203,PORCO,estado nutricional en menores de 5 anos,clasificacion e,2001-10-01,0,35,0,35,35
10103,POROMA,estado nutricional en menores de 5 anos,clasificacion e,2001-10-01,0,113,0,113,113
70103,PORONGO,estado nutricional en menores de 5 anos,clasificacion e,2001-10-01,0,4,0,4,4
70601,PORTACHUELO,estado nutricional en menores de 5 anos,clasificacion e,2001-10-01,10,9,10,9,19
90102,PORVENIR,estado nutricional en menores de 5 anos,clasificacion e,2001-10-01,1,11,1,11,12
70804,POSTRER VALLE,estado nutricional en menores de 5 anos,clasificacion e,2001-10-01,1,1,1,1,2
50101,POTOSI,estado nutricional en menores de 5 anos,clasificacion e,2001-10-01,9,279,9,279,288
10302,PRESTO,estado nutricional en menores de 5 anos,clasificacion e,2001-10-01,0,78,0,78,78
21201,PUCARANI,estado nutricional en menores de 5 anos,clasificacion e,2001-10-01,0,7,0,7,7
20401,PUERTO ACOSTA,estado nutricional en menores de 5 anos,clasificacion e,2001-10-01,22,18,22,18,40
20403,PUERTO CARABUCO,estado nutricional en menores de 5 anos,clasificacion e,2001-10-01,17,10,17,10,27
90301,PUERTO GONZALO MORENO,estado nutricional en menores de 5 anos,clasificacion e,2001-10-01,0,16,0,16,16
21204,PUERTO PEREZ,estado nutricional en menores de 5 anos,clasificacion e,2001-10-01,0,2,0,2,2
71402,PUERTO QUIJARRO,estado nutricional en menores de 5 anos,clasificacion e,2001-10-01,16,2,16,2,18
90201,PUERTO RICO,estado nutricional en menores de 5 anos,clasificacion e,2001-10-01,0,1,0,1,1
71401,PUERTO SUAREZ,estado nutricional en menores de 5 anos,clasificacion e,2001-10-01,16,4,16,4,20
31205,PUERTO VILLARROEL,estado nutricional en menores de 5 anos,clasificacion e,2001-10-01,41,29,41,29,70
51101,PUNA,estado nutricional en menores de 5 anos,clasificacion e,2001-10-01,1,104,1,104,105
31401,PUNATA,estado nutricional en menores de 5 anos,clasificacion e,2001-10-01,12,20,12,20,32
20604,QUIABAYA,estado nutricional en menores de 5 anos,clasificacion e,2001-10-01,0,13,0,13,13
30901,QUILLACOLLO,estado nutricional en menores de 5 anos,clasificacion e,2001-10-01,2,2,2,2,4
21002,QUIME,estado nutricional en menores de 5 anos,clasificacion e,2001-10-01,5,20,5,20,25
50402,RAVELO,estado nutricional en menores de 5 anos,clasificacion e,2001-10-01,2,132,2,132,134
80301,REYES,estado nutricional en menores de 5 anos,clasificacion e,2001-10-01,2,4,2,4,6
80201,RIBERALTA,estado nutricional en menores de 5 anos,clasificacion e,2001-10-01,84,175,84,175,259
70503,ROBORE,estado nutricional en menores de 5 anos,clasificacion e,2001-10-01,1,15,1,15,16
80304,RURRENABAQUE,estado nutricional en menores de 5 anos,clasificacion e,2001-10-01,7,7,7,7,14
31001,SACABA,estado nutricional en menores de 5 anos,clasificacion e,2001-10-01,30,64,30,64,94
30404,SACABAMBA,estado nutricional en menores de 5 anos,clasificacion e,2001-10-01,0,35,0,35,35
50701,SACACA,estado nutricional en menores de 5 anos,clasificacion e,2001-10-01,1,70,1,70,71
71302,SAIPINA,estado nutricional en menores de 5 anos,clasificacion e,2001-10-01,7,1,7,1,8
40801,SALINAS DE GARCI MENDOZA,estado nutricional en menores de 5 anos,clasificacion e,2001-10-01,2,2,2,2,4
70901,SAMAIPATA,estado nutricional en menores de 5 anos,clasificacion e,2001-10-01,8,4,8,4,12
51601,SAN AGUSTIN,estado nutricional en menores de 5 anos,clasificacion e,2001-10-01,0,1,0,1,1
80602,SAN ANDRES,estado nutricional en menores de 5 anos,clasificacion e,2001-10-01,0,6,0,6,6
51003,SAN ANTONIO DE ESMORUCO,estado nutricional en menores de 5 anos,clasificacion e,2001-10-01,0,1,0,1,1
71105,SAN ANTONIO DE LOMERIO,estado nutricional en menores de 5 anos,clasificacion e,2001-10-01,50,46,50,46,96
31403,SAN BENITO,estado nutricional en menores de 5 anos,clasificacion e,2001-10-01,0,6,0,6,6
80302,SAN BORJA,estado nutricional en menores de 5 anos,clasificacion e,2001-10-01,16,14,16,14,30
21502,SAN BUENA VENTURA,estado nutricional en menores de 5 anos,clasificacion e,2001-10-01,5,9,5,9,14
70402,SAN CARLOS,estado nutricional en menores de 5 anos,clasificacion e,2001-10-01,0,8,0,8,8
80501,SAN IGNACIO,estado nutricional en menores de 5 anos,clasificacion e,2001-10-01,5,40,5,40,45
70301,SAN IGNACIO DE VELASCO,estado nutricional en menores de 5 anos,clasificacion e,2001-10-01,68,106,68,106,174
80102,SAN JAVIER(BNI),estado nutricional en menores de 5 anos,clasificacion e,2001-10-01,0,10,0,10,10
71102,SAN JAVIER(STC),estado nutricional en menores de 5 anos,clasificacion e,2001-10-01,6,16,6,16,22
80701,SAN JOAQUIN,estado nutricional en menores de 5 anos,clasificacion e,2001-10-01,0,4,0,4,4
70501,SAN JOSE DE CHIQUITOS,estado nutricional en menores de 5 anos,clasificacion e,2001-10-01,20,2,20,2,22
71104,SAN JULIAN,estado nutricional en menores de 5 anos,clasificacion e,2001-10-01,18,37,18,37,55
60501,SAN LORENZO(TJA),estado nutricional en menores de 5 anos,clasificacion e,2001-10-01,0,7,0,7,7
10702,SAN LUCAS,estado nutricional en menores de 5 anos,clasificacion e,2001-10-01,3,227,3,227,230
71201,SAN MATIAS,estado nutricional en menores de 5 anos,clasificacion e,2001-10-01,19,13,19,13,32
70302,SAN MIGUEL DE VELASCO,estado nutricional en menores de 5 anos,clasificacion e,2001-10-01,9,16,9,16,25
51001,SAN PABLO DE LIPEZ,estado nutricional en menores de 5 anos,clasificacion e,2001-10-01,0,4,0,4,4
50501,SAN PEDRO DE BUENA VISTA,estado nutricional en menores de 5 anos,clasificacion e,2001-10-01,1,68,1,68,69
21801,SAN PEDRO DE CURAHUARA,estado nutricional en menores de 5 anos,clasificacion e,2001-10-01,1,6,1,6,7
21702,SAN PEDRO DE TIQUINA,estado nutricional en menores de 5 anos,clasificacion e,2001-10-01,0,2,0,2,2
90202,SAN PEDRO(PND),estado nutricional en menores de 5 anos,clasificacion e,2001-10-01,1,2,1,2,3
70303,SAN RAFAEL,estado nutricional en menores de 5 anos,clasificacion e,2001-10-01,8,3,8,3,11
80401,SANTA ANA,estado nutricional en menores de 5 anos,clasificacion e,2001-10-01,3,7,3,7,10
70101,SANTA CRUZ DE LA SIERRA,estado nutricional en menores de 5 anos,clasificacion e,2001-10-01,28,80,28,80,108
80303,SANTA ROSA,estado nutricional en menores de 5 anos,clasificacion e,2001-10-01,3,4,3,4,7
70602,SANTA ROSA DEL SARA,estado nutricional en menores de 5 anos,clasificacion e,2001-10-01,0,4,0,4,4
20308,SANTIAGO DE CALLAPA,estado nutricional en menores de 5 anos,clasificacion e,2001-10-01,0,3,0,3,3
41401,SANTIAGO DE HUARI,estado nutricional en menores de 5 anos,clasificacion e,2001-10-01,6,7,6,7,13
21901,SANTIAGO DE MACHACA,estado nutricional en menores de 5 anos,clasificacion e,2001-10-01,2,5,2,5,7
30702,SANTIVAÃ‘ES,estado nutricional en menores de 5 anos,clasificacion e,2001-10-01,6,9,6,9,15
40202,SANTUARIO DE QUILLACAS,estado nutricional en menores de 5 anos,clasificacion e,2001-10-01,3,3,3,3,6
20902,SAPAHAQUI,estado nutricional en menores de 5 anos,clasificacion e,2001-10-01,1,16,1,16,17
90303,SENA,estado nutricional en menores de 5 anos,clasificacion e,2001-10-01,0,1,0,1,1
21301,SICA SICA (VILLA AROMA),estado nutricional en menores de 5 anos,clasificacion e,2001-10-01,2,5,2,5,7
30703,SICAYA,estado nutricional en menores de 5 anos,clasificacion e,2001-10-01,0,5,0,5,5
30902,SIPE SIPE,estado nutricional en menores de 5 anos,clasificacion e,2001-10-01,30,24,30,24,54
10403,SOPACHUY,estado nutricional en menores de 5 anos,clasificacion e,2001-10-01,0,55,0,55,55
20601,SORATA,estado nutricional en menores de 5 anos,clasificacion e,2001-10-01,0,6,0,6,6
10101,SUCRE,estado nutricional en menores de 5 anos,clasificacion e,2001-10-01,15,260,15,260,275
31404,TACACHI,estado nutricional en menores de 5 anos,clasificacion e,2001-10-01,0,4,0,4,4
20603,TACACOMA,estado nutricional en menores de 5 anos,clasificacion e,2001-10-01,0,13,0,13,13
50303,TACOBAMBA,estado nutricional en menores de 5 anos,clasificacion e,2001-10-01,0,58,0,58,58
30602,TACOPAYA,estado nutricional en menores de 5 anos,clasificacion e,2001-10-01,3,31,3,31,34
51402,TAHUA,estado nutricional en menores de 5 anos,clasificacion e,2001-10-01,0,2,0,2,2
31101,TAPACARI,estado nutricional en menores de 5 anos,clasificacion e,2001-10-01,1,56,1,56,57
10601,TARABUCO,estado nutricional en menores de 5 anos,clasificacion e,2001-10-01,2,324,2,324,326
30401,TARATA,estado nutricional en menores de 5 anos,clasificacion e,2001-10-01,0,24,0,24,24
60101,TARIJA,estado nutricional en menores de 5 anos,clasificacion e,2001-10-01,11,50,11,50,61
10202,TARVITA,estado nutricional en menores de 5 anos,clasificacion e,2001-10-01,1,35,1,35,36
20803,TIAWANACU,estado nutricional en menores de 5 anos,clasificacion e,2001-10-01,7,2,7,2,9
50102,TINGUIPAYA,estado nutricional en menores de 5 anos,clasificacion e,2001-10-01,13,80,13,80,93
20606,TIPUANI,estado nutricional en menores de 5 anos,clasificacion e,2001-10-01,3,1,3,1,4
30903,TIQUIPAYA,estado nutricional en menores de 5 anos,clasificacion e,2001-10-01,0,14,0,14,14
31601,TIRAQUE (CBBA),estado nutricional en menores de 5 anos,clasificacion e,2001-10-01,14,20,14,20,34
21703,TITO YUPANQUI (PARQUIPUJIO),estado nutricional en menores de 5 anos,clasificacion e,2001-10-01,2,2,2,2,4
30802,TOCO,estado nutricional en menores de 5 anos,clasificacion e,2001-10-01,0,4,0,4,4
41001,TOLEDO,estado nutricional en menores de 5 anos,clasificacion e,2001-10-01,0,1,0,1,1
51202,TOMAVE,estado nutricional en menores de 5 anos,clasificacion e,2001-10-01,3,42,3,42,45
10402,TOMINA,estado nutricional en menores de 5 anos,clasificacion e,2001-10-01,0,110,0,110,110
50502,TORO TORO,estado nutricional en menores de 5 anos,clasificacion e,2001-10-01,1,10,1,10,11
31201,TOTORA(CBBA),estado nutricional en menores de 5 anos,clasificacion e,2001-10-01,25,28,25,28,53
41301,TOTORA(ORR),estado nutricional en menores de 5 anos,clasificacion e,2001-10-01,0,3,0,3,3
70802,TRIGAL,estado nutricional en menores de 5 anos,clasificacion e,2001-10-01,0,1,0,1,1
80101,TRINIDAD,estado nutricional en menores de 5 anos,clasificacion e,2001-10-01,7,57,7,57,64
50801,TUPIZA,estado nutricional en menores de 5 anos,clasificacion e,2001-10-01,0,60,0,60,60
40402,TURCO,estado nutricional en menores de 5 anos,clasificacion e,2001-10-01,0,5,0,5,5
21302,UMALA,estado nutricional en menores de 5 anos,clasificacion e,2001-10-01,1,19,1,19,20
50201,UNCIA,estado nutricional en menores de 5 anos,clasificacion e,2001-10-01,0,9,0,9,9
60401,URIONDO (A. CONCEPCION),estado nutricional en menores de 5 anos,clasificacion e,2001-10-01,0,6,0,6,6
71502,URUBICHA,estado nutricional en menores de 5 anos,clasificacion e,2001-10-01,23,25,23,25,48
51201,UYUNI,estado nutricional en menores de 5 anos,clasificacion e,2001-10-01,0,25,0,25,25
30502,VACAS,estado nutricional en menores de 5 anos,clasificacion e,2001-10-01,2,9,2,9,11
70801,VALLEGRANDE,estado nutricional en menores de 5 anos,clasificacion e,2001-10-01,9,9,9,9,18
20801,VIACHA,estado nutricional en menores de 5 anos,clasificacion e,2001-10-01,1,32,1,32,33
31302,VILA VILA,estado nutricional en menores de 5 anos,clasificacion e,2001-10-01,1,20,1,20,21
60303,VILLA MONTES,estado nutricional en menores de 5 anos,clasificacion e,2001-10-01,9,11,9,11,20
31402,VILLA RIVERO,estado nutricional en menores de 5 anos,clasificacion e,2001-10-01,0,16,0,16,16
10801,VILLA SERRANO,estado nutricional en menores de 5 anos,clasificacion e,2001-10-01,0,87,0,87,87
31003,VILLA TUNARI,estado nutricional en menores de 5 anos,clasificacion e,2001-10-01,27,29,27,29,56
11001,VILLA VACA GUZMAN (MUYUPAMPA),estado nutricional en menores de 5 anos,clasificacion e,2001-10-01,3,48,3,48,51
51501,VILLAZON,estado nutricional en menores de 5 anos,clasificacion e,2001-10-01,2,36,2,36,38
30904,VINTO,estado nutricional en menores de 5 anos,clasificacion e,2001-10-01,17,4,17,4,21
50602,VITICHI,estado nutricional en menores de 5 anos,clasificacion e,2001-10-01,3,39,3,39,42
70201,WARNES,estado nutricional en menores de 5 anos,clasificacion e,2001-10-01,15,23,15,23,38
20903,YACO,estado nutricional en menores de 5 anos,clasificacion e,2001-10-01,0,15,0,15,15
60301,YACUIBA,estado nutricional en menores de 5 anos,clasificacion e,2001-10-01,5,4,5,4,9
10602,YAMPARAEZ,estado nutricional en menores de 5 anos,clasificacion e,2001-10-01,0,101,0,101,101
70403,YAPACANI,estado nutricional en menores de 5 anos,clasificacion e,2001-10-01,16,32,16,32,48
50103,YOCALLA,estado nutricional en menores de 5 anos,clasificacion e,2001-10-01,0,40,0,40,40
10102,YOTALA,estado nutricional en menores de 5 anos,clasificacion e,2001-10-01,0,75,0,75,75
60402,YUNCHARA,estado nutricional en menores de 5 anos,clasificacion e,2001-10-01,3,2,3,2,5
10301,ZUDAÃ‘EZ,estado nutricional en menores de 5 anos,clasificacion e,2001-10-01,0,70,0,70,70
51302,ACACIO,estado nutricional en menores de 5 anos,clasificacion e,2001-11-01,3,53,3,53,56
20201,ACHACACHI,estado nutricional en menores de 5 anos,clasificacion e,2001-11-01,2,51,2,51,53
20104,ACHOCALLA,estado nutricional en menores de 5 anos,clasificacion e,2001-11-01,6,3,6,3,9
31303,ALALAY,estado nutricional en menores de 5 anos,clasificacion e,2001-11-01,2,3,2,3,5
10404,ALCALA,estado nutricional en menores de 5 anos,clasificacion e,2001-11-01,0,23,0,23,23
20202,ANCORAIMES,estado nutricional en menores de 5 anos,clasificacion e,2001-11-01,0,29,0,29,29
41201,ANDAMARCA,estado nutricional en menores de 5 anos,clasificacion e,2001-11-01,0,1,0,1,1
30402,ANZALDO,estado nutricional en menores de 5 anos,clasificacion e,2001-11-01,2,31,2,31,33
20701,APOLO,estado nutricional en menores de 5 anos,clasificacion e,2001-11-01,8,3,8,3,11
51301,ARAMPAMPA,estado nutricional en menores de 5 anos,clasificacion e,2001-11-01,0,47,0,47,47
30501,ARANI,estado nutricional en menores de 5 anos,clasificacion e,2001-11-01,8,30,8,30,38
30403,ARBIETO,estado nutricional en menores de 5 anos,clasificacion e,2001-11-01,0,10,0,10,10
30601,ARQUE,estado nutricional en menores de 5 anos,clasificacion e,2001-11-01,41,22,41,22,63
71501,ASCENCION DE GUARAYOS,estado nutricional en menores de 5 anos,clasificacion e,2001-11-01,0,5,0,5,5
50802,ATOCHA,estado nutricional en menores de 5 anos,clasificacion e,2001-11-01,0,27,0,27,27
20503,AUCAPATA,estado nutricional en menores de 5 anos,clasificacion e,2001-11-01,5,2,5,2,7
20502,AYATA,estado nutricional en menores de 5 anos,clasificacion e,2001-11-01,2,2,2,2,4
21303,AYO AYO,estado nutricional en menores de 5 anos,clasificacion e,2001-11-01,4,1,4,1,5
30301,AYOPAYA (V. DE INDEPENDENCIA),estado nutricional en menores de 5 anos,clasificacion e,2001-11-01,43,30,43,30,73
10201,AZURDUY,estado nutricional en menores de 5 anos,clasificacion e,2001-11-01,0,70,0,70,70
21203,BATALLAS,estado nutricional en menores de 5 anos,clasificacion e,2001-11-01,0,14,0,14,14
80802,BAURES,estado nutricional en menores de 5 anos,clasificacion e,2001-11-01,8,3,8,3,11
41202,BELEN DE ANDAMARCA,estado nutricional en menores de 5 anos,clasificacion e,2001-11-01,0,1,0,1,1
50104,BELEN DE URMIRI,estado nutricional en menores de 5 anos,clasificacion e,2001-11-01,1,1,1,1,2
90104,BELLA FLOR,estado nutricional en menores de 5 anos,clasificacion e,2001-11-01,1,0,1,0,1
60202,BERMEJO,estado nutricional en menores de 5 anos,clasificacion e,2001-11-01,0,6,0,6,6
50301,BETANZOS,estado nutricional en menores de 5 anos,clasificacion e,2001-11-01,2,240,2,240,242
31501,BOLIVAR,estado nutricional en menores de 5 anos,clasificacion e,2001-11-01,35,24,35,24,59
70707,BOYUIBE,estado nutricional en menores de 5 anos,clasificacion e,2001-11-01,0,14,0,14,14
70401,BUENA VISTA,estado nutricional en menores de 5 anos,clasificacion e,2001-11-01,18,17,18,17,35
70703,CABEZAS,estado nutricional en menores de 5 anos,clasificacion e,2001-11-01,0,25,0,25,25
20905,CAIROMA,estado nutricional en menores de 5 anos,clasificacion e,2001-11-01,0,4,0,4,4
51102,"CAIZA ""D""",estado nutricional en menores de 5 anos,clasificacion e,2001-11-01,5,16,5,16,21
21003,CAJUATA,estado nutricional en menores de 5 anos,clasificacion e,2001-11-01,9,5,9,5,14
21304,CALAMARCA,estado nutricional en menores de 5 anos,clasificacion e,2001-11-01,0,12,0,12,12
10701,CAMARGO,estado nutricional en menores de 5 anos,clasificacion e,2001-11-01,1,37,1,37,38
10901,CAMATAQUI (C. VILLA ABECIA),estado nutricional en menores de 5 anos,clasificacion e,2001-11-01,1,12,1,12,13
70706,CAMIRI,estado nutricional en menores de 5 anos,clasificacion e,2001-11-01,27,23,27,23,50
30701,CAPINOTA,estado nutricional en menores de 5 anos,clasificacion e,2001-11-01,15,9,15,9,24
20302,CAQUIAVIRI,estado nutricional en menores de 5 anos,clasificacion e,2001-11-01,3,4,3,4,7
40102,CARACOLLO,estado nutricional en menores de 5 anos,clasificacion e,2001-11-01,4,8,4,8,12
22001,CARANAVI,estado nutricional en menores de 5 anos,clasificacion e,2001-11-01,12,32,12,32,44
60302,CARAPARI,estado nutricional en menores de 5 anos,clasificacion e,2001-11-01,1,11,1,11,12
50702,CARIPUYO,estado nutricional en menores de 5 anos,clasificacion e,2001-11-01,2,137,2,137,139
21902,CATACORA,estado nutricional en menores de 5 anos,clasificacion e,2001-11-01,0,2,0,2,2
40201,CHALLAPATA,estado nutricional en menores de 5 anos,clasificacion e,2001-11-01,23,9,23,9,32
50302,CHAQUI,estado nutricional en menores de 5 anos,clasificacion e,2001-11-01,0,30,0,30,30
70702,CHARAGUA,estado nutricional en menores de 5 anos,clasificacion e,2001-11-01,2,64,2,64,66
20305,CHARAÃ‘A,estado nutricional en menores de 5 anos,clasificacion e,2001-11-01,0,8,0,8,8
50202,CHAYANTA,estado nutricional en menores de 5 anos,clasificacion e,2001-11-01,0,66,0,66,66
31204,CHIMORE,estado nutricional en menores de 5 anos,clasificacion e,2001-11-01,8,20,8,20,28
40302,CHOQUE COTA,estado nutricional en menores de 5 anos,clasificacion e,2001-11-01,0,3,0,3,3
21101,CHULUMANI (V. DE LA LIBERTAD),estado nutricional en menores de 5 anos,clasificacion e,2001-11-01,0,2,0,2,2
20501,CHUMA,estado nutricional en menores de 5 anos,clasificacion e,2001-11-01,9,8,9,8,17
30801,CLIZA,estado nutricional en menores de 5 anos,clasificacion e,2001-11-01,1,8,1,8,9
90101,COBIJA,estado nutricional en menores de 5 anos,clasificacion e,2001-11-01,27,13,27,13,40
30101,COCHABAMBA,estado nutricional en menores de 5 anos,clasificacion e,2001-11-01,85,97,85,97,182
30905,COLCAPIRHUA,estado nutricional en menores de 5 anos,clasificacion e,2001-11-01,25,10,25,10,35
50901,"COLCHA ""K""",estado nutricional en menores de 5 anos,clasificacion e,2001-11-01,0,26,0,26,26
31002,COLOMI,estado nutricional en menores de 5 anos,clasificacion e,2001-11-01,28,17,28,17,45
70603,COLPA BELGICA,estado nutricional en menores de 5 anos,clasificacion e,2001-11-01,3,0,3,0,3
50401,COLQUECHACA,estado nutricional en menores de 5 anos,clasificacion e,2001-11-01,2,32,2,32,34
21306,COLQUENCHA,estado nutricional en menores de 5 anos,clasificacion e,2001-11-01,11,6,11,6,17
21004,COLQUIRI,estado nutricional en menores de 5 anos,clasificacion e,2001-11-01,12,21,12,21,33
20304,COMANCHE,estado nutricional en menores de 5 anos,clasificacion e,2001-11-01,6,4,6,4,10
71301,COMARAPA,estado nutricional en menores de 5 anos,clasificacion e,2001-11-01,11,9,11,9,20
20605,COMBAYA,estado nutricional en menores de 5 anos,clasificacion e,2001-11-01,0,4,0,4,4
71101,CONCEPCION,estado nutricional en menores de 5 anos,clasificacion e,2001-11-01,0,6,0,6,6
21701,COPACABANA,estado nutricional en menores de 5 anos,clasificacion e,2001-11-01,2,1,2,1,3
21401,COROICO,estado nutricional en menores de 5 anos,clasificacion e,2001-11-01,12,4,12,4,16
40301,CORQUE,estado nutricional en menores de 5 anos,clasificacion e,2001-11-01,11,1,11,1,12
50601,COTAGAITA,estado nutricional en menores de 5 anos,clasificacion e,2001-11-01,0,55,0,55,55
70102,COTOCA,estado nutricional en menores de 5 anos,clasificacion e,2001-11-01,1,20,1,20,21
70704,CUEVO,estado nutricional en menores de 5 anos,clasificacion e,2001-11-01,4,11,4,11,15
10902,CULPINA,estado nutricional en menores de 5 anos,clasificacion e,2001-11-01,2,129,2,129,131
40401,CURAHUARA DE CARANGAS,estado nutricional en menores de 5 anos,clasificacion e,2001-11-01,1,0,1,0,1
20804,DESAGUADERO,estado nutricional en menores de 5 anos,clasificacion e,2001-11-01,0,3,0,3,3
20105,EL ALTO,estado nutricional en menores de 5 anos,clasificacion e,2001-11-01,359,420,359,420,779
71503,EL PUENTE(STC),estado nutricional en menores de 5 anos,clasificacion e,2001-11-01,3,28,3,28,31
60502,EL PUENTE(TJA),estado nutricional en menores de 5 anos,clasificacion e,2001-11-01,3,13,3,13,16
70105,EL TORNO,estado nutricional en menores de 5 anos,clasificacion e,2001-11-01,0,38,0,38,38
10405,EL VILLAR,estado nutricional en menores de 5 anos,clasificacion e,2001-11-01,0,68,0,68,68
60601,ENTRE RIOS,estado nutricional en menores de 5 anos,clasificacion e,2001-11-01,5,13,5,13,18
41101,EUCALIPTUS,estado nutricional en menores de 5 anos,clasificacion e,2001-11-01,1,12,1,12,13
80402,EXALTACION,estado nutricional en menores de 5 anos,clasificacion e,2001-11-01,1,0,1,0,1
90203,FILADELFIA,estado nutricional en menores de 5 anos,clasificacion e,2001-11-01,0,1,0,1,1
71002,GENERAL SAAVEDRA,estado nutricional en menores de 5 anos,clasificacion e,2001-11-01,1,49,1,49,50
21601,GRAL. J.J. PEREZ (CHARAZANI),estado nutricional en menores de 5 anos,clasificacion e,2001-11-01,0,1,0,1,1
20602,GUANAY,estado nutricional en menores de 5 anos,clasificacion e,2001-11-01,3,14,3,14,17
20802,GUAQUI,estado nutricional en menores de 5 anos,clasificacion e,2001-11-01,0,2,0,2,2
80202,GUAYARAMERIN,estado nutricional en menores de 5 anos,clasificacion e,2001-11-01,23,14,23,14,37
70705,GUTIERREZ,estado nutricional en menores de 5 anos,clasificacion e,2001-11-01,1,70,1,70,71
10502,HUACARETA,estado nutricional en menores de 5 anos,clasificacion e,2001-11-01,0,59,0,59,59
40701,HUANUNI,estado nutricional en menores de 5 anos,clasificacion e,2001-11-01,1,1,1,1,2
80803,HUARACAJE,estado nutricional en menores de 5 anos,clasificacion e,2001-11-01,3,1,3,1,4
41601,HUAYLLAMARCA,estado nutricional en menores de 5 anos,clasificacion e,2001-11-01,2,4,2,4,6
21005,ICHOCA,estado nutricional en menores de 5 anos,clasificacion e,2001-11-01,0,1,0,1,1
10304,ICLA,estado nutricional en menores de 5 anos,clasificacion e,2001-11-01,58,67,58,67,125
10703,INCAHUASI,estado nutricional en menores de 5 anos,clasificacion e,2001-11-01,0,77,0,77,77
21001,INQUISIVI,estado nutricional en menores de 5 anos,clasificacion e,2001-11-01,0,22,0,22,22
21102,IRUPANA (VILLA DE LANZA),estado nutricional en menores de 5 anos,clasificacion e,2001-11-01,1,7,1,7,8
21501,IXIAMAS,estado nutricional en menores de 5 anos,clasificacion e,2001-11-01,5,8,5,8,13
21105,LA ASUNTA,estado nutricional en menores de 5 anos,clasificacion e,2001-11-01,31,23,31,23,54
70104,LA GUARDIA,estado nutricional en menores de 5 anos,clasificacion e,2001-11-01,0,18,0,18,18
20101,LA PAZ,estado nutricional en menores de 5 anos,clasificacion e,2001-11-01,159,159,159,159,318
70701,LAGUNILLAS,estado nutricional en menores de 5 anos,clasificacion e,2001-11-01,20,16,20,16,36
21202,LAJA,estado nutricional en menores de 5 anos,clasificacion e,2001-11-01,0,35,0,35,35
10903,LAS CARRERAS,estado nutricional en menores de 5 anos,clasificacion e,2001-11-01,0,23,0,23,23
50203,LLALLAGUA,estado nutricional en menores de 5 anos,clasificacion e,2001-11-01,2,88,2,88,90
51401,LLICA,estado nutricional en menores de 5 anos,clasificacion e,2001-11-01,0,8,0,8,8
20901,LURIBAY,estado nutricional en menores de 5 anos,clasificacion e,2001-11-01,0,7,0,7,7
40702,MACHACAMARCA,estado nutricional en menores de 5 anos,clasificacion e,2001-11-01,1,0,1,0,1
11003,MACHARETI,estado nutricional en menores de 5 anos,clasificacion e,2001-11-01,2,42,2,42,44
80801,MAGDALENA,estado nutricional en menores de 5 anos,clasificacion e,2001-11-01,1,2,1,2,3
70903,MAIRANA,estado nutricional en menores de 5 anos,clasificacion e,2001-11-01,1,4,1,4,5
20103,MECAPACA,estado nutricional en menores de 5 anos,clasificacion e,2001-11-01,0,7,0,7,7
71003,MINEROS,estado nutricional en menores de 5 anos,clasificacion e,2001-11-01,0,35,0,35,35
31301,MIZQUE,estado nutricional en menores de 5 anos,clasificacion e,2001-11-01,2,14,2,14,16
20402,MOCOMOCO,estado nutricional en menores de 5 anos,clasificacion e,2001-11-01,10,13,10,13,23
51002,MOJINETE,estado nutricional en menores de 5 anos,clasificacion e,2001-11-01,0,6,0,6,6
10303,MOJOCOYA,estado nutricional en menores de 5 anos,clasificacion e,2001-11-01,2,21,2,21,23
10501,MONTEAGUDO,estado nutricional en menores de 5 anos,clasificacion e,2001-11-01,4,59,4,59,63
71001,MONTERO,estado nutricional en menores de 5 anos,clasificacion e,2001-11-01,9,112,9,112,121
70803,MORO MORO,estado nutricional en menores de 5 anos,clasificacion e,2001-11-01,8,3,8,3,11
30302,MOROCHATA,estado nutricional en menores de 5 anos,clasificacion e,2001-11-01,5,9,5,9,14
50404,OCURI,estado nutricional en menores de 5 anos,clasificacion e,2001-11-01,19,44,19,44,63
70202,OKINAWA,estado nutricional en menores de 5 anos,clasificacion e,2001-11-01,1,1,1,1,2
30203,OMEREQUE,estado nutricional en menores de 5 anos,clasificacion e,2001-11-01,1,1,1,1,2
40101,ORURO,estado nutricional en menores de 5 anos,clasificacion e,2001-11-01,10,222,10,222,232
60201,PADCAYA,estado nutricional en menores de 5 anos,clasificacion e,2001-11-01,4,11,4,11,15
10401,PADILLA,estado nutricional en menores de 5 anos,clasificacion e,2001-11-01,1,112,1,112,113
70502,PAILON,estado nutricional en menores de 5 anos,clasificacion e,2001-11-01,1,18,1,18,19
20102,PALCA,estado nutricional en menores de 5 anos,clasificacion e,2001-11-01,11,12,11,12,23
21104,PALOS BLANCOS,estado nutricional en menores de 5 anos,clasificacion e,2001-11-01,10,25,10,25,35
40802,PAMPA AULLAGAS,estado nutricional en menores de 5 anos,clasificacion e,2001-11-01,3,3,3,3,6
70902,PAMPA GRANDE,estado nutricional en menores de 5 anos,clasificacion e,2001-11-01,6,6,6,6,12
21802,PAPEL PAMPA,estado nutricional en menores de 5 anos,clasificacion e,2001-11-01,1,2,1,2,3
30202,PASORAPA,estado nutricional en menores de 5 anos,clasificacion e,2001-11-01,1,3,1,3,4
21305,PATACAMAYA,estado nutricional en menores de 5 anos,clasificacion e,2001-11-01,13,10,13,10,23
40602,PAZÃ‘A,estado nutricional en menores de 5 anos,clasificacion e,2001-11-01,0,5,0,5,5
20702,PELECHUCO,estado nutricional en menores de 5 anos,clasificacion e,2001-11-01,3,10,3,10,13
50403,POCOATA,estado nutricional en menores de 5 anos,clasificacion e,2001-11-01,19,67,19,67,86
31203,POCONA,estado nutricional en menores de 5 anos,clasificacion e,2001-11-01,1,18,1,18,19
31202,POJO (CBBA),estado nutricional en menores de 5 anos,clasificacion e,2001-11-01,6,44,6,44,50
40601,POOPO,estado nutricional en menores de 5 anos,clasificacion e,2001-11-01,0,6,0,6,6
51203,PORCO,estado nutricional en menores de 5 anos,clasificacion e,2001-11-01,3,6,3,6,9
10103,POROMA,estado nutricional en menores de 5 anos,clasificacion e,2001-11-01,0,148,0,148,148
70103,PORONGO,estado nutricional en menores de 5 anos,clasificacion e,2001-11-01,0,4,0,4,4
70601,PORTACHUELO,estado nutricional en menores de 5 anos,clasificacion e,2001-11-01,6,5,6,5,11
90102,PORVENIR,estado nutricional en menores de 5 anos,clasificacion e,2001-11-01,0,7,0,7,7
50101,POTOSI,estado nutricional en menores de 5 anos,clasificacion e,2001-11-01,9,148,9,148,157
70805,PUCARA,estado nutricional en menores de 5 anos,clasificacion e,2001-11-01,0,2,0,2,2
21201,PUCARANI,estado nutricional en menores de 5 anos,clasificacion e,2001-11-01,0,10,0,10,10
20401,PUERTO ACOSTA,estado nutricional en menores de 5 anos,clasificacion e,2001-11-01,30,9,30,9,39
20403,PUERTO CARABUCO,estado nutricional en menores de 5 anos,clasificacion e,2001-11-01,17,13,17,13,30
90301,PUERTO GONZALO MORENO,estado nutricional en menores de 5 anos,clasificacion e,2001-11-01,0,1,0,1,1
21204,PUERTO PEREZ,estado nutricional en menores de 5 anos,clasificacion e,2001-11-01,0,6,0,6,6
71402,PUERTO QUIJARRO,estado nutricional en menores de 5 anos,clasificacion e,2001-11-01,18,5,18,5,23
90201,PUERTO RICO,estado nutricional en menores de 5 anos,clasificacion e,2001-11-01,0,2,0,2,2
80703,PUERTO SILES,estado nutricional en menores de 5 anos,clasificacion e,2001-11-01,1,0,1,0,1
71401,PUERTO SUAREZ,estado nutricional en menores de 5 anos,clasificacion e,2001-11-01,22,5,22,5,27
31205,PUERTO VILLARROEL,estado nutricional en menores de 5 anos,clasificacion e,2001-11-01,50,25,50,25,75
51101,PUNA,estado nutricional en menores de 5 anos,clasificacion e,2001-11-01,1,49,1,49,50
31401,PUNATA,estado nutricional en menores de 5 anos,clasificacion e,2001-11-01,5,8,5,8,13
20604,QUIABAYA,estado nutricional en menores de 5 anos,clasificacion e,2001-11-01,0,8,0,8,8
30901,QUILLACOLLO,estado nutricional en menores de 5 anos,clasificacion e,2001-11-01,4,7,4,7,11
21002,QUIME,estado nutricional en menores de 5 anos,clasificacion e,2001-11-01,5,14,5,14,19
50402,RAVELO,estado nutricional en menores de 5 anos,clasificacion e,2001-11-01,3,160,3,160,163
80301,REYES,estado nutricional en menores de 5 anos,clasificacion e,2001-11-01,2,12,2,12,14
80201,RIBERALTA,estado nutricional en menores de 5 anos,clasificacion e,2001-11-01,114,77,114,77,191
70503,ROBORE,estado nutricional en menores de 5 anos,clasificacion e,2001-11-01,0,18,0,18,18
80304,RURRENABAQUE,estado nutricional en menores de 5 anos,clasificacion e,2001-11-01,10,6,10,6,16
31001,SACABA,estado nutricional en menores de 5 anos,clasificacion e,2001-11-01,9,75,9,75,84
30404,SACABAMBA,estado nutricional en menores de 5 anos,clasificacion e,2001-11-01,1,22,1,22,23
50701,SACACA,estado nutricional en menores de 5 anos,clasificacion e,2001-11-01,4,90,4,90,94
71302,SAIPINA,estado nutricional en menores de 5 anos,clasificacion e,2001-11-01,4,2,4,2,6
40801,SALINAS DE GARCI MENDOZA,estado nutricional en menores de 5 anos,clasificacion e,2001-11-01,1,0,1,0,1
70901,SAMAIPATA,estado nutricional en menores de 5 anos,clasificacion e,2001-11-01,1,4,1,4,5
80602,SAN ANDRES,estado nutricional en menores de 5 anos,clasificacion e,2001-11-01,3,3,3,3,6
51003,SAN ANTONIO DE ESMORUCO,estado nutricional en menores de 5 anos,clasificacion e,2001-11-01,0,7,0,7,7
71105,SAN ANTONIO DE LOMERIO,estado nutricional en menores de 5 anos,clasificacion e,2001-11-01,17,20,17,20,37
31403,SAN BENITO,estado nutricional en menores de 5 anos,clasificacion e,2001-11-01,0,19,0,19,19
80302,SAN BORJA,estado nutricional en menores de 5 anos,clasificacion e,2001-11-01,30,24,30,24,54
21502,SAN BUENA VENTURA,estado nutricional en menores de 5 anos,clasificacion e,2001-11-01,9,11,9,11,20
70402,SAN CARLOS,estado nutricional en menores de 5 anos,clasificacion e,2001-11-01,0,6,0,6,6
80501,SAN IGNACIO,estado nutricional en menores de 5 anos,clasificacion e,2001-11-01,7,43,7,43,50
70301,SAN IGNACIO DE VELASCO,estado nutricional en menores de 5 anos,clasificacion e,2001-11-01,73,40,73,40,113
80102,SAN JAVIER(BNI),estado nutricional en menores de 5 anos,clasificacion e,2001-11-01,0,3,0,3,3
71102,SAN JAVIER(STC),estado nutricional en menores de 5 anos,clasificacion e,2001-11-01,0,3,0,3,3
80701,SAN JOAQUIN,estado nutricional en menores de 5 anos,clasificacion e,2001-11-01,0,6,0,6,6
70501,SAN JOSE DE CHIQUITOS,estado nutricional en menores de 5 anos,clasificacion e,2001-11-01,22,2,22,2,24
71104,SAN JULIAN,estado nutricional en menores de 5 anos,clasificacion e,2001-11-01,21,37,21,37,58
60501,SAN LORENZO(TJA),estado nutricional en menores de 5 anos,clasificacion e,2001-11-01,7,8,7,8,15
10702,SAN LUCAS,estado nutricional en menores de 5 anos,clasificacion e,2001-11-01,5,282,5,282,287
71201,SAN MATIAS,estado nutricional en menores de 5 anos,clasificacion e,2001-11-01,20,9,20,9,29
70302,SAN MIGUEL DE VELASCO,estado nutricional en menores de 5 anos,clasificacion e,2001-11-01,19,13,19,13,32
51001,SAN PABLO DE LIPEZ,estado nutricional en menores de 5 anos,clasificacion e,2001-11-01,1,8,1,8,9
50501,SAN PEDRO DE BUENA VISTA,estado nutricional en menores de 5 anos,clasificacion e,2001-11-01,3,200,3,200,203
21801,SAN PEDRO DE CURAHUARA,estado nutricional en menores de 5 anos,clasificacion e,2001-11-01,0,2,0,2,2
21702,SAN PEDRO DE TIQUINA,estado nutricional en menores de 5 anos,clasificacion e,2001-11-01,0,2,0,2,2
70303,SAN RAFAEL,estado nutricional en menores de 5 anos,clasificacion e,2001-11-01,9,11,9,11,20
80702,SAN RAMON,estado nutricional en menores de 5 anos,clasificacion e,2001-11-01,3,2,3,2,5
80702,SAN RAMON,estado nutricional en menores de 5 anos,clasificacion e,2001-11-01,0,2,0,2,2
80401,SANTA ANA,estado nutricional en menores de 5 anos,clasificacion e,2001-11-01,3,4,3,4,7
70101,SANTA CRUZ DE LA SIERRA,estado nutricional en menores de 5 anos,clasificacion e,2001-11-01,58,106,58,106,164
80303,SANTA ROSA,estado nutricional en menores de 5 anos,clasificacion e,2001-11-01,2,0,2,0,2
70602,SANTA ROSA DEL SARA,estado nutricional en menores de 5 anos,clasificacion e,2001-11-01,0,18,0,18,18
20308,SANTIAGO DE CALLAPA,estado nutricional en menores de 5 anos,clasificacion e,2001-11-01,0,1,0,1,1
41401,SANTIAGO DE HUARI,estado nutricional en menores de 5 anos,clasificacion e,2001-11-01,10,4,10,4,14
21901,SANTIAGO DE MACHACA,estado nutricional en menores de 5 anos,clasificacion e,2001-11-01,2,2,2,2,4
30702,SANTIVAÃ‘ES,estado nutricional en menores de 5 anos,clasificacion e,2001-11-01,7,3,7,3,10
40202,SANTUARIO DE QUILLACAS,estado nutricional en menores de 5 anos,clasificacion e,2001-11-01,1,8,1,8,9
20902,SAPAHAQUI,estado nutricional en menores de 5 anos,clasificacion e,2001-11-01,1,11,1,11,12
90303,SENA,estado nutricional en menores de 5 anos,clasificacion e,2001-11-01,1,1,1,1,2
21301,SICA SICA (VILLA AROMA),estado nutricional en menores de 5 anos,clasificacion e,2001-11-01,4,5,4,5,9
30703,SICAYA,estado nutricional en menores de 5 anos,clasificacion e,2001-11-01,0,8,0,8,8
30902,SIPE SIPE,estado nutricional en menores de 5 anos,clasificacion e,2001-11-01,33,12,33,12,45
10403,SOPACHUY,estado nutricional en menores de 5 anos,clasificacion e,2001-11-01,1,53,1,53,54
20601,SORATA,estado nutricional en menores de 5 anos,clasificacion e,2001-11-01,1,10,1,10,11
10101,SUCRE,estado nutricional en menores de 5 anos,clasificacion e,2001-11-01,4,273,4,273,277
31404,TACACHI,estado nutricional en menores de 5 anos,clasificacion e,2001-11-01,0,1,0,1,1
20603,TACACOMA,estado nutricional en menores de 5 anos,clasificacion e,2001-11-01,2,3,2,3,5
50303,TACOBAMBA,estado nutricional en menores de 5 anos,clasificacion e,2001-11-01,3,90,3,90,93
30602,TACOPAYA,estado nutricional en menores de 5 anos,clasificacion e,2001-11-01,1,22,1,22,23
51402,TAHUA,estado nutricional en menores de 5 anos,clasificacion e,2001-11-01,0,4,0,4,4
31101,TAPACARI,estado nutricional en menores de 5 anos,clasificacion e,2001-11-01,1,41,1,41,42
10601,TARABUCO,estado nutricional en menores de 5 anos,clasificacion e,2001-11-01,2,312,2,312,314
30401,TARATA,estado nutricional en menores de 5 anos,clasificacion e,2001-11-01,0,20,0,20,20
60101,TARIJA,estado nutricional en menores de 5 anos,clasificacion e,2001-11-01,33,87,33,87,120
10202,TARVITA,estado nutricional en menores de 5 anos,clasificacion e,2001-11-01,0,37,0,37,37
20803,TIAWANACU,estado nutricional en menores de 5 anos,clasificacion e,2001-11-01,4,5,4,5,9
50102,TINGUIPAYA,estado nutricional en menores de 5 anos,clasificacion e,2001-11-01,4,90,4,90,94
20606,TIPUANI,estado nutricional en menores de 5 anos,clasificacion e,2001-11-01,4,3,4,3,7
30903,TIQUIPAYA,estado nutricional en menores de 5 anos,clasificacion e,2001-11-01,1,23,1,23,24
31601,TIRAQUE (CBBA),estado nutricional en menores de 5 anos,clasificacion e,2001-11-01,6,36,6,36,42
21703,TITO YUPANQUI (PARQUIPUJIO),estado nutricional en menores de 5 anos,clasificacion e,2001-11-01,0,6,0,6,6
30802,TOCO,estado nutricional en menores de 5 anos,clasificacion e,2001-11-01,0,3,0,3,3
30803,TOLATA,estado nutricional en menores de 5 anos,clasificacion e,2001-11-01,0,1,0,1,1
41001,TOLEDO,estado nutricional en menores de 5 anos,clasificacion e,2001-11-01,3,3,3,3,6
51202,TOMAVE,estado nutricional en menores de 5 anos,clasificacion e,2001-11-01,3,45,3,45,48
10402,TOMINA,estado nutricional en menores de 5 anos,clasificacion e,2001-11-01,0,120,0,120,120
50502,TORO TORO,estado nutricional en menores de 5 anos,clasificacion e,2001-11-01,0,29,0,29,29
31201,TOTORA(CBBA),estado nutricional en menores de 5 anos,clasificacion e,2001-11-01,15,19,15,19,34
41301,TOTORA(ORR),estado nutricional en menores de 5 anos,clasificacion e,2001-11-01,0,5,0,5,5
70802,TRIGAL,estado nutricional en menores de 5 anos,clasificacion e,2001-11-01,1,1,1,1,2
80101,TRINIDAD,estado nutricional en menores de 5 anos,clasificacion e,2001-11-01,6,99,6,99,105
50801,TUPIZA,estado nutricional en menores de 5 anos,clasificacion e,2001-11-01,0,87,0,87,87
40402,TURCO,estado nutricional en menores de 5 anos,clasificacion e,2001-11-01,0,2,0,2,2
21302,UMALA,estado nutricional en menores de 5 anos,clasificacion e,2001-11-01,6,6,6,6,12
50201,UNCIA,estado nutricional en menores de 5 anos,clasificacion e,2001-11-01,5,26,5,26,31
60401,URIONDO (A. CONCEPCION),estado nutricional en menores de 5 anos,clasificacion e,2001-11-01,0,7,0,7,7
71502,URUBICHA,estado nutricional en menores de 5 anos,clasificacion e,2001-11-01,0,12,0,12,12
51201,UYUNI,estado nutricional en menores de 5 anos,clasificacion e,2001-11-01,0,36,0,36,36
30502,VACAS,estado nutricional en menores de 5 anos,clasificacion e,2001-11-01,0,24,0,24,24
70801,VALLEGRANDE,estado nutricional en menores de 5 anos,clasificacion e,2001-11-01,9,10,9,10,19
20801,VIACHA,estado nutricional en menores de 5 anos,clasificacion e,2001-11-01,1,36,1,36,37
31302,VILA VILA,estado nutricional en menores de 5 anos,clasificacion e,2001-11-01,0,19,0,19,19
60303,VILLA MONTES,estado nutricional en menores de 5 anos,clasificacion e,2001-11-01,9,9,9,9,18
31402,VILLA RIVERO,estado nutricional en menores de 5 anos,clasificacion e,2001-11-01,0,7,0,7,7
10801,VILLA SERRANO,estado nutricional en menores de 5 anos,clasificacion e,2001-11-01,0,86,0,86,86
31003,VILLA TUNARI,estado nutricional en menores de 5 anos,clasificacion e,2001-11-01,21,34,21,34,55
11001,VILLA VACA GUZMAN (MUYUPAMPA),estado nutricional en menores de 5 anos,clasificacion e,2001-11-01,5,51,5,51,56
51501,VILLAZON,estado nutricional en menores de 5 anos,clasificacion e,2001-11-01,2,67,2,67,69
30904,VINTO,estado nutricional en menores de 5 anos,clasificacion e,2001-11-01,24,6,24,6,30
50602,VITICHI,estado nutricional en menores de 5 anos,clasificacion e,2001-11-01,0,18,0,18,18
70201,WARNES,estado nutricional en menores de 5 anos,clasificacion e,2001-11-01,11,23,11,23,34
20903,YACO,estado nutricional en menores de 5 anos,clasificacion e,2001-11-01,1,16,1,16,17
60301,YACUIBA,estado nutricional en menores de 5 anos,clasificacion e,2001-11-01,9,16,9,16,25
10602,YAMPARAEZ,estado nutricional en menores de 5 anos,clasificacion e,2001-11-01,0,115,0,115,115
70403,YAPACANI,estado nutricional en menores de 5 anos,clasificacion e,2001-11-01,17,20,17,20,37
50103,YOCALLA,estado nutricional en menores de 5 anos,clasificacion e,2001-11-01,0,15,0,15,15
10102,YOTALA,estado nutricional en menores de 5 anos,clasificacion e,2001-11-01,0,80,0,80,80
60402,YUNCHARA,estado nutricional en menores de 5 anos,clasificacion e,2001-11-01,3,2,3,2,5
10301,ZUDAÃ‘EZ,estado nutricional en menores de 5 anos,clasificacion e,2001-11-01,0,91,0,91,91
51302,ACACIO,estado nutricional en menores de 5 anos,clasificacion e,2001-12-01,0,31,0,31,31
20201,ACHACACHI,estado nutricional en menores de 5 anos,clasificacion e,2001-12-01,1,12,1,12,13
20104,ACHOCALLA,estado nutricional en menores de 5 anos,clasificacion e,2001-12-01,5,5,5,5,10
30201,AIQUILE,estado nutricional en menores de 5 anos,clasificacion e,2001-12-01,2,3,2,3,5
31303,ALALAY,estado nutricional en menores de 5 anos,clasificacion e,2001-12-01,0,2,0,2,2
10404,ALCALA,estado nutricional en menores de 5 anos,clasificacion e,2001-12-01,0,40,0,40,40
20202,ANCORAIMES,estado nutricional en menores de 5 anos,clasificacion e,2001-12-01,0,17,0,17,17
41201,ANDAMARCA,estado nutricional en menores de 5 anos,clasificacion e,2001-12-01,2,1,2,1,3
30402,ANZALDO,estado nutricional en menores de 5 anos,clasificacion e,2001-12-01,4,13,4,13,17
20701,APOLO,estado nutricional en menores de 5 anos,clasificacion e,2001-12-01,4,1,4,1,5
51301,ARAMPAMPA,estado nutricional en menores de 5 anos,clasificacion e,2001-12-01,0,23,0,23,23
30501,ARANI,estado nutricional en menores de 5 anos,clasificacion e,2001-12-01,0,5,0,5,5
30403,ARBIETO,estado nutricional en menores de 5 anos,clasificacion e,2001-12-01,0,6,0,6,6
30601,ARQUE,estado nutricional en menores de 5 anos,clasificacion e,2001-12-01,13,9,13,9,22
71501,ASCENCION DE GUARAYOS,estado nutricional en menores de 5 anos,clasificacion e,2001-12-01,54,57,54,57,111
50802,ATOCHA,estado nutricional en menores de 5 anos,clasificacion e,2001-12-01,1,20,1,20,21
20503,AUCAPATA,estado nutricional en menores de 5 anos,clasificacion e,2001-12-01,3,3,3,3,6
20502,AYATA,estado nutricional en menores de 5 anos,clasificacion e,2001-12-01,0,3,0,3,3
21303,AYO AYO,estado nutricional en menores de 5 anos,clasificacion e,2001-12-01,3,3,3,3,6
30301,AYOPAYA (V. DE INDEPENDENCIA),estado nutricional en menores de 5 anos,clasificacion e,2001-12-01,28,23,28,23,51
10201,AZURDUY,estado nutricional en menores de 5 anos,clasificacion e,2001-12-01,0,40,0,40,40
21203,BATALLAS,estado nutricional en menores de 5 anos,clasificacion e,2001-12-01,0,7,0,7,7
80802,BAURES,estado nutricional en menores de 5 anos,clasificacion e,2001-12-01,2,3,2,3,5
50104,BELEN DE URMIRI,estado nutricional en menores de 5 anos,clasificacion e,2001-12-01,1,1,1,1,2
60202,BERMEJO,estado nutricional en menores de 5 anos,clasificacion e,2001-12-01,0,3,0,3,3
50301,BETANZOS,estado nutricional en menores de 5 anos,clasificacion e,2001-12-01,3,123,3,123,126
31501,BOLIVAR,estado nutricional en menores de 5 anos,clasificacion e,2001-12-01,25,14,25,14,39
90103,BOLPEBRA,estado nutricional en menores de 5 anos,clasificacion e,2001-12-01,0,1,0,1,1
70707,BOYUIBE,estado nutricional en menores de 5 anos,clasificacion e,2001-12-01,2,6,2,6,8
70401,BUENA VISTA,estado nutricional en menores de 5 anos,clasificacion e,2001-12-01,18,5,18,5,23
70703,CABEZAS,estado nutricional en menores de 5 anos,clasificacion e,2001-12-01,0,15,0,15,15
20905,CAIROMA,estado nutricional en menores de 5 anos,clasificacion e,2001-12-01,0,24,0,24,24
51102,"CAIZA ""D""",estado nutricional en menores de 5 anos,clasificacion e,2001-12-01,6,29,6,29,35
20303,CALACOTO,estado nutricional en menores de 5 anos,clasificacion e,2001-12-01,0,2,0,2,2
21304,CALAMARCA,estado nutricional en menores de 5 anos,clasificacion e,2001-12-01,0,10,0,10,10
10701,CAMARGO,estado nutricional en menores de 5 anos,clasificacion e,2001-12-01,0,11,0,11,11
10901,CAMATAQUI (C. VILLA ABECIA),estado nutricional en menores de 5 anos,clasificacion e,2001-12-01,0,5,0,5,5
70706,CAMIRI,estado nutricional en menores de 5 anos,clasificacion e,2001-12-01,33,27,33,27,60
30701,CAPINOTA,estado nutricional en menores de 5 anos,clasificacion e,2001-12-01,18,12,18,12,30
20302,CAQUIAVIRI,estado nutricional en menores de 5 anos,clasificacion e,2001-12-01,4,11,4,11,15
40102,CARACOLLO,estado nutricional en menores de 5 anos,clasificacion e,2001-12-01,0,1,0,1,1
22001,CARANAVI,estado nutricional en menores de 5 anos,clasificacion e,2001-12-01,13,25,13,25,38
60302,CARAPARI,estado nutricional en menores de 5 anos,clasificacion e,2001-12-01,1,6,1,6,7
50702,CARIPUYO,estado nutricional en menores de 5 anos,clasificacion e,2001-12-01,0,36,0,36,36
40201,CHALLAPATA,estado nutricional en menores de 5 anos,clasificacion e,2001-12-01,10,6,10,6,16
50302,CHAQUI,estado nutricional en menores de 5 anos,clasificacion e,2001-12-01,0,22,0,22,22
70702,CHARAGUA,estado nutricional en menores de 5 anos,clasificacion e,2001-12-01,4,48,4,48,52
20305,CHARAÃ‘A,estado nutricional en menores de 5 anos,clasificacion e,2001-12-01,0,4,0,4,4
50202,CHAYANTA,estado nutricional en menores de 5 anos,clasificacion e,2001-12-01,0,13,0,13,13
31204,CHIMORE,estado nutricional en menores de 5 anos,clasificacion e,2001-12-01,7,15,7,15,22
21101,CHULUMANI (V. DE LA LIBERTAD),estado nutricional en menores de 5 anos,clasificacion e,2001-12-01,0,5,0,5,5
20501,CHUMA,estado nutricional en menores de 5 anos,clasificacion e,2001-12-01,4,2,4,2,6
30801,CLIZA,estado nutricional en menores de 5 anos,clasificacion e,2001-12-01,0,15,0,15,15
90101,COBIJA,estado nutricional en menores de 5 anos,clasificacion e,2001-12-01,18,4,18,4,22
30101,COCHABAMBA,estado nutricional en menores de 5 anos,clasificacion e,2001-12-01,38,78,38,78,116
30905,COLCAPIRHUA,estado nutricional en menores de 5 anos,clasificacion e,2001-12-01,19,12,19,12,31
50901,"COLCHA ""K""",estado nutricional en menores de 5 anos,clasificacion e,2001-12-01,0,8,0,8,8
31002,COLOMI,estado nutricional en menores de 5 anos,clasificacion e,2001-12-01,5,22,5,22,27
70603,COLPA BELGICA,estado nutricional en menores de 5 anos,clasificacion e,2001-12-01,1,1,1,1,2
50401,COLQUECHACA,estado nutricional en menores de 5 anos,clasificacion e,2001-12-01,3,21,3,21,24
21306,COLQUENCHA,estado nutricional en menores de 5 anos,clasificacion e,2001-12-01,0,5,0,5,5
21004,COLQUIRI,estado nutricional en menores de 5 anos,clasificacion e,2001-12-01,6,15,6,15,21
20304,COMANCHE,estado nutricional en menores de 5 anos,clasificacion e,2001-12-01,2,2,2,2,4
71301,COMARAPA,estado nutricional en menores de 5 anos,clasificacion e,2001-12-01,4,9,4,9,13
20605,COMBAYA,estado nutricional en menores de 5 anos,clasificacion e,2001-12-01,0,6,0,6,6
71101,CONCEPCION,estado nutricional en menores de 5 anos,clasificacion e,2001-12-01,1,0,1,0,1
21701,COPACABANA,estado nutricional en menores de 5 anos,clasificacion e,2001-12-01,0,4,0,4,4
21402,CORIPATA,estado nutricional en menores de 5 anos,clasificacion e,2001-12-01,1,0,1,0,1
20301,CORO CORO,estado nutricional en menores de 5 anos,clasificacion e,2001-12-01,3,4,3,4,7
21401,COROICO,estado nutricional en menores de 5 anos,clasificacion e,2001-12-01,6,5,6,5,11
40301,CORQUE,estado nutricional en menores de 5 anos,clasificacion e,2001-12-01,7,8,7,8,15
50601,COTAGAITA,estado nutricional en menores de 5 anos,clasificacion e,2001-12-01,0,48,0,48,48
70102,COTOCA,estado nutricional en menores de 5 anos,clasificacion e,2001-12-01,0,11,0,11,11
70704,CUEVO,estado nutricional en menores de 5 anos,clasificacion e,2001-12-01,3,8,3,8,11
10902,CULPINA,estado nutricional en menores de 5 anos,clasificacion e,2001-12-01,7,73,7,73,80
40401,CURAHUARA DE CARANGAS,estado nutricional en menores de 5 anos,clasificacion e,2001-12-01,2,0,2,0,2
21602,CURVA,estado nutricional en menores de 5 anos,clasificacion e,2001-12-01,3,1,3,1,4
20804,DESAGUADERO,estado nutricional en menores de 5 anos,clasificacion e,2001-12-01,0,1,0,1,1
20105,EL ALTO,estado nutricional en menores de 5 anos,clasificacion e,2001-12-01,289,316,289,316,605
71503,EL PUENTE(STC),estado nutricional en menores de 5 anos,clasificacion e,2001-12-01,2,32,2,32,34
60502,EL PUENTE(TJA),estado nutricional en menores de 5 anos,clasificacion e,2001-12-01,1,5,1,5,6
70105,EL TORNO,estado nutricional en menores de 5 anos,clasificacion e,2001-12-01,0,43,0,43,43
10405,EL VILLAR,estado nutricional en menores de 5 anos,clasificacion e,2001-12-01,2,65,2,65,67
60601,ENTRE RIOS,estado nutricional en menores de 5 anos,clasificacion e,2001-12-01,6,12,6,12,18
41101,EUCALIPTUS,estado nutricional en menores de 5 anos,clasificacion e,2001-12-01,1,10,1,10,11
80402,EXALTACION,estado nutricional en menores de 5 anos,clasificacion e,2001-12-01,3,3,3,3,6
90203,FILADELFIA,estado nutricional en menores de 5 anos,clasificacion e,2001-12-01,0,5,0,5,5
71002,GENERAL SAAVEDRA,estado nutricional en menores de 5 anos,clasificacion e,2001-12-01,4,24,4,24,28
21601,GRAL. J.J. PEREZ (CHARAZANI),estado nutricional en menores de 5 anos,clasificacion e,2001-12-01,2,0,2,0,2
20602,GUANAY,estado nutricional en menores de 5 anos,clasificacion e,2001-12-01,6,25,6,25,31
20802,GUAQUI,estado nutricional en menores de 5 anos,clasificacion e,2001-12-01,0,4,0,4,4
80202,GUAYARAMERIN,estado nutricional en menores de 5 anos,clasificacion e,2001-12-01,17,9,17,9,26
70705,GUTIERREZ,estado nutricional en menores de 5 anos,clasificacion e,2001-12-01,6,87,6,87,93
10502,HUACARETA,estado nutricional en menores de 5 anos,clasificacion e,2001-12-01,1,38,1,38,39
40701,HUANUNI,estado nutricional en menores de 5 anos,clasificacion e,2001-12-01,0,2,0,2,2
80803,HUARACAJE,estado nutricional en menores de 5 anos,clasificacion e,2001-12-01,1,2,1,2,3
41601,HUAYLLAMARCA,estado nutricional en menores de 5 anos,clasificacion e,2001-12-01,1,1,1,1,2
21005,ICHOCA,estado nutricional en menores de 5 anos,clasificacion e,2001-12-01,0,2,0,2,2
10304,ICLA,estado nutricional en menores de 5 anos,clasificacion e,2001-12-01,42,100,42,100,142
10703,INCAHUASI,estado nutricional en menores de 5 anos,clasificacion e,2001-12-01,0,58,0,58,58
21001,INQUISIVI,estado nutricional en menores de 5 anos,clasificacion e,2001-12-01,0,17,0,17,17
21102,IRUPANA (VILLA DE LANZA),estado nutricional en menores de 5 anos,clasificacion e,2001-12-01,0,3,0,3,3
21501,IXIAMAS,estado nutricional en menores de 5 anos,clasificacion e,2001-12-01,4,3,4,3,7
21105,LA ASUNTA,estado nutricional en menores de 5 anos,clasificacion e,2001-12-01,8,8,8,8,16
70104,LA GUARDIA,estado nutricional en menores de 5 anos,clasificacion e,2001-12-01,1,26,1,26,27
20101,LA PAZ,estado nutricional en menores de 5 anos,clasificacion e,2001-12-01,137,143,137,143,280
70701,LAGUNILLAS,estado nutricional en menores de 5 anos,clasificacion e,2001-12-01,11,11,11,11,22
21202,LAJA,estado nutricional en menores de 5 anos,clasificacion e,2001-12-01,0,21,0,21,21
10903,LAS CARRERAS,estado nutricional en menores de 5 anos,clasificacion e,2001-12-01,0,24,0,24,24
50203,LLALLAGUA,estado nutricional en menores de 5 anos,clasificacion e,2001-12-01,1,54,1,54,55
51401,LLICA,estado nutricional en menores de 5 anos,clasificacion e,2001-12-01,0,1,0,1,1
80601,LORETO,estado nutricional en menores de 5 anos,clasificacion e,2001-12-01,0,1,0,1,1
20901,LURIBAY,estado nutricional en menores de 5 anos,clasificacion e,2001-12-01,0,10,0,10,10
40702,MACHACAMARCA,estado nutricional en menores de 5 anos,clasificacion e,2001-12-01,3,0,3,0,3
11003,MACHARETI,estado nutricional en menores de 5 anos,clasificacion e,2001-12-01,0,20,0,20,20
70903,MAIRANA,estado nutricional en menores de 5 anos,clasificacion e,2001-12-01,5,5,5,5,10
71003,MINEROS,estado nutricional en menores de 5 anos,clasificacion e,2001-12-01,1,38,1,38,39
31301,MIZQUE,estado nutricional en menores de 5 anos,clasificacion e,2001-12-01,0,8,0,8,8
20402,MOCOMOCO,estado nutricional en menores de 5 anos,clasificacion e,2001-12-01,0,1,0,1,1
10303,MOJOCOYA,estado nutricional en menores de 5 anos,clasificacion e,2001-12-01,0,31,0,31,31
10501,MONTEAGUDO,estado nutricional en menores de 5 anos,clasificacion e,2001-12-01,0,57,0,57,57
71001,MONTERO,estado nutricional en menores de 5 anos,clasificacion e,2001-12-01,3,99,3,99,102
70803,MORO MORO,estado nutricional en menores de 5 anos,clasificacion e,2001-12-01,2,0,2,0,2
30302,MOROCHATA,estado nutricional en menores de 5 anos,clasificacion e,2001-12-01,1,38,1,38,39
90401,NACEBE (SANTA ROSA DEL ABUNA),estado nutricional en menores de 5 anos,clasificacion e,2001-12-01,1,0,1,0,1
50404,OCURI,estado nutricional en menores de 5 anos,clasificacion e,2001-12-01,21,41,21,41,62
30203,OMEREQUE,estado nutricional en menores de 5 anos,clasificacion e,2001-12-01,0,6,0,6,6
40101,ORURO,estado nutricional en menores de 5 anos,clasificacion e,2001-12-01,15,199,15,199,214
60201,PADCAYA,estado nutricional en menores de 5 anos,clasificacion e,2001-12-01,2,1,2,1,3
10401,PADILLA,estado nutricional en menores de 5 anos,clasificacion e,2001-12-01,2,112,2,112,114
20102,PALCA,estado nutricional en menores de 5 anos,clasificacion e,2001-12-01,13,19,13,19,32
21104,PALOS BLANCOS,estado nutricional en menores de 5 anos,clasificacion e,2001-12-01,3,18,3,18,21
40802,PAMPA AULLAGAS,estado nutricional en menores de 5 anos,clasificacion e,2001-12-01,4,1,4,1,5
70902,PAMPA GRANDE,estado nutricional en menores de 5 anos,clasificacion e,2001-12-01,8,5,8,5,13
21802,PAPEL PAMPA,estado nutricional en menores de 5 anos,clasificacion e,2001-12-01,1,2,1,2,3
30202,PASORAPA,estado nutricional en menores de 5 anos,clasificacion e,2001-12-01,0,14,0,14,14
21305,PATACAMAYA,estado nutricional en menores de 5 anos,clasificacion e,2001-12-01,6,6,6,6,12
40602,PAZÃ‘A,estado nutricional en menores de 5 anos,clasificacion e,2001-12-01,0,10,0,10,10
20702,PELECHUCO,estado nutricional en menores de 5 anos,clasificacion e,2001-12-01,3,2,3,2,5
50403,POCOATA,estado nutricional en menores de 5 anos,clasificacion e,2001-12-01,35,74,35,74,109
31203,POCONA,estado nutricional en menores de 5 anos,clasificacion e,2001-12-01,0,16,0,16,16
31202,POJO (CBBA),estado nutricional en menores de 5 anos,clasificacion e,2001-12-01,9,28,9,28,37
40601,POOPO,estado nutricional en menores de 5 anos,clasificacion e,2001-12-01,0,5,0,5,5
51203,PORCO,estado nutricional en menores de 5 anos,clasificacion e,2001-12-01,4,3,4,3,7
10103,POROMA,estado nutricional en menores de 5 anos,clasificacion e,2001-12-01,0,119,0,119,119
70103,PORONGO,estado nutricional en menores de 5 anos,clasificacion e,2001-12-01,1,5,1,5,6
70601,PORTACHUELO,estado nutricional en menores de 5 anos,clasificacion e,2001-12-01,7,2,7,2,9
90102,PORVENIR,estado nutricional en menores de 5 anos,clasificacion e,2001-12-01,0,2,0,2,2
70804,POSTRER VALLE,estado nutricional en menores de 5 anos,clasificacion e,2001-12-01,0,2,0,2,2
50101,POTOSI,estado nutricional en menores de 5 anos,clasificacion e,2001-12-01,10,146,10,146,156
10302,PRESTO,estado nutricional en menores de 5 anos,clasificacion e,2001-12-01,0,71,0,71,71
21201,PUCARANI,estado nutricional en menores de 5 anos,clasificacion e,2001-12-01,0,7,0,7,7
20401,PUERTO ACOSTA,estado nutricional en menores de 5 anos,clasificacion e,2001-12-01,16,8,16,8,24
20403,PUERTO CARABUCO,estado nutricional en menores de 5 anos,clasificacion e,2001-12-01,16,13,16,13,29
90301,PUERTO GONZALO MORENO,estado nutricional en menores de 5 anos,clasificacion e,2001-12-01,0,2,0,2,2
21204,PUERTO PEREZ,estado nutricional en menores de 5 anos,clasificacion e,2001-12-01,1,1,1,1,2
71402,PUERTO QUIJARRO,estado nutricional en menores de 5 anos,clasificacion e,2001-12-01,7,3,7,3,10
90201,PUERTO RICO,estado nutricional en menores de 5 anos,clasificacion e,2001-12-01,0,1,0,1,1
80703,PUERTO SILES,estado nutricional en menores de 5 anos,clasificacion e,2001-12-01,1,31,1,31,32
71401,PUERTO SUAREZ,estado nutricional en menores de 5 anos,clasificacion e,2001-12-01,12,1,12,1,13
31205,PUERTO VILLARROEL,estado nutricional en menores de 5 anos,clasificacion e,2001-12-01,34,19,34,19,53
51101,PUNA,estado nutricional en menores de 5 anos,clasificacion e,2001-12-01,0,101,0,101,101
31401,PUNATA,estado nutricional en menores de 5 anos,clasificacion e,2001-12-01,2,7,2,7,9
20604,QUIABAYA,estado nutricional en menores de 5 anos,clasificacion e,2001-12-01,0,7,0,7,7
30901,QUILLACOLLO,estado nutricional en menores de 5 anos,clasificacion e,2001-12-01,9,1,9,1,10
21002,QUIME,estado nutricional en menores de 5 anos,clasificacion e,2001-12-01,1,9,1,9,10
50402,RAVELO,estado nutricional en menores de 5 anos,clasificacion e,2001-12-01,0,156,0,156,156
80201,RIBERALTA,estado nutricional en menores de 5 anos,clasificacion e,2001-12-01,123,82,123,82,205
70503,ROBORE,estado nutricional en menores de 5 anos,clasificacion e,2001-12-01,0,16,0,16,16
80304,RURRENABAQUE,estado nutricional en menores de 5 anos,clasificacion e,2001-12-01,2,2,2,2,4
31001,SACABA,estado nutricional en menores de 5 anos,clasificacion e,2001-12-01,14,35,14,35,49
30404,SACABAMBA,estado nutricional en menores de 5 anos,clasificacion e,2001-12-01,0,24,0,24,24
50701,SACACA,estado nutricional en menores de 5 anos,clasificacion e,2001-12-01,0,57,0,57,57
71302,SAIPINA,estado nutricional en menores de 5 anos,clasificacion e,2001-12-01,4,5,4,5,9
40801,SALINAS DE GARCI MENDOZA,estado nutricional en menores de 5 anos,clasificacion e,2001-12-01,4,0,4,0,4
70901,SAMAIPATA,estado nutricional en menores de 5 anos,clasificacion e,2001-12-01,2,3,2,3,5
80602,SAN ANDRES,estado nutricional en menores de 5 anos,clasificacion e,2001-12-01,0,2,0,2,2
51003,SAN ANTONIO DE ESMORUCO,estado nutricional en menores de 5 anos,clasificacion e,2001-12-01,0,2,0,2,2
71105,SAN ANTONIO DE LOMERIO,estado nutricional en menores de 5 anos,clasificacion e,2001-12-01,34,46,34,46,80
31403,SAN BENITO,estado nutricional en menores de 5 anos,clasificacion e,2001-12-01,0,5,0,5,5
80302,SAN BORJA,estado nutricional en menores de 5 anos,clasificacion e,2001-12-01,9,11,9,11,20
21502,SAN BUENA VENTURA,estado nutricional en menores de 5 anos,clasificacion e,2001-12-01,4,11,4,11,15
70402,SAN CARLOS,estado nutricional en menores de 5 anos,clasificacion e,2001-12-01,0,3,0,3,3
80501,SAN IGNACIO,estado nutricional en menores de 5 anos,clasificacion e,2001-12-01,8,21,8,21,29
70301,SAN IGNACIO DE VELASCO,estado nutricional en menores de 5 anos,clasificacion e,2001-12-01,51,46,51,46,97
80102,SAN JAVIER(BNI),estado nutricional en menores de 5 anos,clasificacion e,2001-12-01,0,9,0,9,9
71102,SAN JAVIER(STC),estado nutricional en menores de 5 anos,clasificacion e,2001-12-01,8,15,8,15,23
80701,SAN JOAQUIN,estado nutricional en menores de 5 anos,clasificacion e,2001-12-01,0,6,0,6,6
70501,SAN JOSE DE CHIQUITOS,estado nutricional en menores de 5 anos,clasificacion e,2001-12-01,20,3,20,3,23
71104,SAN JULIAN,estado nutricional en menores de 5 anos,clasificacion e,2001-12-01,20,41,20,41,61
90302,SAN LORENZO(PND),estado nutricional en menores de 5 anos,clasificacion e,2001-12-01,1,0,1,0,1
60501,SAN LORENZO(TJA),estado nutricional en menores de 5 anos,clasificacion e,2001-12-01,0,4,0,4,4
10702,SAN LUCAS,estado nutricional en menores de 5 anos,clasificacion e,2001-12-01,3,211,3,211,214
71201,SAN MATIAS,estado nutricional en menores de 5 anos,clasificacion e,2001-12-01,23,17,23,17,40
70302,SAN MIGUEL DE VELASCO,estado nutricional en menores de 5 anos,clasificacion e,2001-12-01,14,6,14,6,20
51001,SAN PABLO DE LIPEZ,estado nutricional en menores de 5 anos,clasificacion e,2001-12-01,0,9,0,9,9
50501,SAN PEDRO DE BUENA VISTA,estado nutricional en menores de 5 anos,clasificacion e,2001-12-01,2,79,2,79,81
21801,SAN PEDRO DE CURAHUARA,estado nutricional en menores de 5 anos,clasificacion e,2001-12-01,0,2,0,2,2
70303,SAN RAFAEL,estado nutricional en menores de 5 anos,clasificacion e,2001-12-01,6,14,6,14,20
80702,SAN RAMON,estado nutricional en menores de 5 anos,clasificacion e,2001-12-01,2,1,2,1,3
80702,SAN RAMON,estado nutricional en menores de 5 anos,clasificacion e,2001-12-01,0,1,0,1,1
80401,SANTA ANA,estado nutricional en menores de 5 anos,clasificacion e,2001-12-01,3,1,3,1,4
70101,SANTA CRUZ DE LA SIERRA,estado nutricional en menores de 5 anos,clasificacion e,2001-12-01,31,85,31,85,116
80303,SANTA ROSA,estado nutricional en menores de 5 anos,clasificacion e,2001-12-01,13,6,13,6,19
70602,SANTA ROSA DEL SARA,estado nutricional en menores de 5 anos,clasificacion e,2001-12-01,0,2,0,2,2
41401,SANTIAGO DE HUARI,estado nutricional en menores de 5 anos,clasificacion e,2001-12-01,5,3,5,3,8
30702,SANTIVAÃ‘ES,estado nutricional en menores de 5 anos,clasificacion e,2001-12-01,0,1,0,1,1
40202,SANTUARIO DE QUILLACAS,estado nutricional en menores de 5 anos,clasificacion e,2001-12-01,0,2,0,2,2
20902,SAPAHAQUI,estado nutricional en menores de 5 anos,clasificacion e,2001-12-01,0,15,0,15,15
21301,SICA SICA (VILLA AROMA),estado nutricional en menores de 5 anos,clasificacion e,2001-12-01,4,6,4,6,10
30703,SICAYA,estado nutricional en menores de 5 anos,clasificacion e,2001-12-01,0,10,0,10,10
30902,SIPE SIPE,estado nutricional en menores de 5 anos,clasificacion e,2001-12-01,26,16,26,16,42
10403,SOPACHUY,estado nutricional en menores de 5 anos,clasificacion e,2001-12-01,1,42,1,42,43
20601,SORATA,estado nutricional en menores de 5 anos,clasificacion e,2001-12-01,0,8,0,8,8
10101,SUCRE,estado nutricional en menores de 5 anos,clasificacion e,2001-12-01,2,191,2,191,193
31404,TACACHI,estado nutricional en menores de 5 anos,clasificacion e,2001-12-01,0,4,0,4,4
20603,TACACOMA,estado nutricional en menores de 5 anos,clasificacion e,2001-12-01,0,1,0,1,1
50303,TACOBAMBA,estado nutricional en menores de 5 anos,clasificacion e,2001-12-01,1,82,1,82,83
51402,TAHUA,estado nutricional en menores de 5 anos,clasificacion e,2001-12-01,0,2,0,2,2
31101,TAPACARI,estado nutricional en menores de 5 anos,clasificacion e,2001-12-01,3,19,3,19,22
10601,TARABUCO,estado nutricional en menores de 5 anos,clasificacion e,2001-12-01,2,303,2,303,305
30401,TARATA,estado nutricional en menores de 5 anos,clasificacion e,2001-12-01,1,14,1,14,15
60101,TARIJA,estado nutricional en menores de 5 anos,clasificacion e,2001-12-01,8,43,8,43,51
10202,TARVITA,estado nutricional en menores de 5 anos,clasificacion e,2001-12-01,1,58,1,58,59
20803,TIAWANACU,estado nutricional en menores de 5 anos,clasificacion e,2001-12-01,6,3,6,3,9
50102,TINGUIPAYA,estado nutricional en menores de 5 anos,clasificacion e,2001-12-01,4,54,4,54,58
20606,TIPUANI,estado nutricional en menores de 5 anos,clasificacion e,2001-12-01,2,0,2,0,2
30903,TIQUIPAYA,estado nutricional en menores de 5 anos,clasificacion e,2001-12-01,0,8,0,8,8
31601,TIRAQUE (CBBA),estado nutricional en menores de 5 anos,clasificacion e,2001-12-01,14,31,14,31,45
21703,TITO YUPANQUI (PARQUIPUJIO),estado nutricional en menores de 5 anos,clasificacion e,2001-12-01,0,1,0,1,1
30802,TOCO,estado nutricional en menores de 5 anos,clasificacion e,2001-12-01,0,6,0,6,6
41001,TOLEDO,estado nutricional en menores de 5 anos,clasificacion e,2001-12-01,1,2,1,2,3
51202,TOMAVE,estado nutricional en menores de 5 anos,clasificacion e,2001-12-01,0,29,0,29,29
10402,TOMINA,estado nutricional en menores de 5 anos,clasificacion e,2001-12-01,0,102,0,102,102
50502,TORO TORO,estado nutricional en menores de 5 anos,clasificacion e,2001-12-01,2,16,2,16,18
31201,TOTORA(CBBA),estado nutricional en menores de 5 anos,clasificacion e,2001-12-01,12,22,12,22,34
41301,TOTORA(ORR),estado nutricional en menores de 5 anos,clasificacion e,2001-12-01,0,13,0,13,13
70802,TRIGAL,estado nutricional en menores de 5 anos,clasificacion e,2001-12-01,0,1,0,1,1
80101,TRINIDAD,estado nutricional en menores de 5 anos,clasificacion e,2001-12-01,0,49,0,49,49
50801,TUPIZA,estado nutricional en menores de 5 anos,clasificacion e,2001-12-01,0,66,0,66,66
40402,TURCO,estado nutricional en menores de 5 anos,clasificacion e,2001-12-01,1,0,1,0,1
21302,UMALA,estado nutricional en menores de 5 anos,clasificacion e,2001-12-01,0,3,0,3,3
50201,UNCIA,estado nutricional en menores de 5 anos,clasificacion e,2001-12-01,0,31,0,31,31
60401,URIONDO (A. CONCEPCION),estado nutricional en menores de 5 anos,clasificacion e,2001-12-01,0,3,0,3,3
71502,URUBICHA,estado nutricional en menores de 5 anos,clasificacion e,2001-12-01,12,46,12,46,58
51201,UYUNI,estado nutricional en menores de 5 anos,clasificacion e,2001-12-01,0,19,0,19,19
30502,VACAS,estado nutricional en menores de 5 anos,clasificacion e,2001-12-01,0,6,0,6,6
70801,VALLEGRANDE,estado nutricional en menores de 5 anos,clasificacion e,2001-12-01,3,8,3,8,11
20801,VIACHA,estado nutricional en menores de 5 anos,clasificacion e,2001-12-01,4,22,4,22,26
31302,VILA VILA,estado nutricional en menores de 5 anos,clasificacion e,2001-12-01,0,22,0,22,22
60303,VILLA MONTES,estado nutricional en menores de 5 anos,clasificacion e,2001-12-01,10,17,10,17,27
31402,VILLA RIVERO,estado nutricional en menores de 5 anos,clasificacion e,2001-12-01,0,12,0,12,12
10801,VILLA SERRANO,estado nutricional en menores de 5 anos,clasificacion e,2001-12-01,0,72,0,72,72
31003,VILLA TUNARI,estado nutricional en menores de 5 anos,clasificacion e,2001-12-01,25,25,25,25,50
11001,VILLA VACA GUZMAN (MUYUPAMPA),estado nutricional en menores de 5 anos,clasificacion e,2001-12-01,0,30,0,30,30
51501,VILLAZON,estado nutricional en menores de 5 anos,clasificacion e,2001-12-01,2,66,2,66,68
30904,VINTO,estado nutricional en menores de 5 anos,clasificacion e,2001-12-01,11,7,11,7,18
50602,VITICHI,estado nutricional en menores de 5 anos,clasificacion e,2001-12-01,0,32,0,32,32
70201,WARNES,estado nutricional en menores de 5 anos,clasificacion e,2001-12-01,16,22,16,22,38
20903,YACO,estado nutricional en menores de 5 anos,clasificacion e,2001-12-01,0,8,0,8,8
60301,YACUIBA,estado nutricional en menores de 5 anos,clasificacion e,2001-12-01,8,14,8,14,22
10602,YAMPARAEZ,estado nutricional en menores de 5 anos,clasificacion e,2001-12-01,1,112,1,112,113
21103,YANACACHI,estado nutricional en menores de 5 anos,clasificacion e,2001-12-01,0,3,0,3,3
70403,YAPACANI,estado nutricional en menores de 5 anos,clasificacion e,2001-12-01,16,18,16,18,34
50103,YOCALLA,estado nutricional en menores de 5 anos,clasificacion e,2001-12-01,0,11,0,11,11
10102,YOTALA,estado nutricional en menores de 5 anos,clasificacion e,2001-12-01,0,78,0,78,78
60402,YUNCHARA,estado nutricional en menores de 5 anos,clasificacion e,2001-12-01,3,5,3,5,8
10301,ZUDAÃ‘EZ,estado nutricional en menores de 5 anos,clasificacion e,2001-12-01,0,80,0,80,80
51302,ACACIO,estado nutricional en menores de 5 anos,clasificacion e,2002-01-01,0,51,0,51,51
20201,ACHACACHI,estado nutricional en menores de 5 anos,clasificacion e,2002-01-01,3,22,3,22,25
20104,ACHOCALLA,estado nutricional en menores de 5 anos,clasificacion e,2002-01-01,3,1,3,1,4
30201,AIQUILE,estado nutricional en menores de 5 anos,clasificacion e,2002-01-01,1,4,1,4,5
31303,ALALAY,estado nutricional en menores de 5 anos,clasificacion e,2002-01-01,1,1,1,1,2
10404,ALCALA,estado nutricional en menores de 5 anos,clasificacion e,2002-01-01,0,22,0,22,22
20202,ANCORAIMES,estado nutricional en menores de 5 anos,clasificacion e,2002-01-01,0,36,0,36,36
41201,ANDAMARCA,estado nutricional en menores de 5 anos,clasificacion e,2002-01-01,1,0,1,0,1
40603,ANTEQUERA,estado nutricional en menores de 5 anos,clasificacion e,2002-01-01,1,0,1,0,1
30402,ANZALDO,estado nutricional en menores de 5 anos,clasificacion e,2002-01-01,0,5,0,5,5
20701,APOLO,estado nutricional en menores de 5 anos,clasificacion e,2002-01-01,3,2,3,2,5
51301,ARAMPAMPA,estado nutricional en menores de 5 anos,clasificacion e,2002-01-01,0,48,0,48,48
30501,ARANI,estado nutricional en menores de 5 anos,clasificacion e,2002-01-01,0,8,0,8,8
30403,ARBIETO,estado nutricional en menores de 5 anos,clasificacion e,2002-01-01,0,4,0,4,4
30601,ARQUE,estado nutricional en menores de 5 anos,clasificacion e,2002-01-01,4,2,4,2,6
50802,ATOCHA,estado nutricional en menores de 5 anos,clasificacion e,2002-01-01,1,7,1,7,8
20503,AUCAPATA,estado nutricional en menores de 5 anos,clasificacion e,2002-01-01,0,10,0,10,10
20502,AYATA,estado nutricional en menores de 5 anos,clasificacion e,2002-01-01,5,0,5,0,5
21303,AYO AYO,estado nutricional en menores de 5 anos,clasificacion e,2002-01-01,7,4,7,4,11
30301,AYOPAYA (V. DE INDEPENDENCIA),estado nutricional en menores de 5 anos,clasificacion e,2002-01-01,23,30,23,30,53
10201,AZURDUY,estado nutricional en menores de 5 anos,clasificacion e,2002-01-01,1,33,1,33,34
21203,BATALLAS,estado nutricional en menores de 5 anos,clasificacion e,2002-01-01,0,13,0,13,13
80802,BAURES,estado nutricional en menores de 5 anos,clasificacion e,2002-01-01,5,9,5,9,14
50104,BELEN DE URMIRI,estado nutricional en menores de 5 anos,clasificacion e,2002-01-01,0,2,0,2,2
60202,BERMEJO,estado nutricional en menores de 5 anos,clasificacion e,2002-01-01,0,5,0,5,5
50301,BETANZOS,estado nutricional en menores de 5 anos,clasificacion e,2002-01-01,9,160,9,160,169
31501,BOLIVAR,estado nutricional en menores de 5 anos,clasificacion e,2002-01-01,40,37,40,37,77
90103,BOLPEBRA,estado nutricional en menores de 5 anos,clasificacion e,2002-01-01,0,2,0,2,2
70707,BOYUIBE,estado nutricional en menores de 5 anos,clasificacion e,2002-01-01,0,16,0,16,16
70401,BUENA VISTA,estado nutricional en menores de 5 anos,clasificacion e,2002-01-01,10,13,10,13,23
70703,CABEZAS,estado nutricional en menores de 5 anos,clasificacion e,2002-01-01,0,11,0,11,11
20905,CAIROMA,estado nutricional en menores de 5 anos,clasificacion e,2002-01-01,0,14,0,14,14
51102,"CAIZA ""D""",estado nutricional en menores de 5 anos,clasificacion e,2002-01-01,2,29,2,29,31
21003,CAJUATA,estado nutricional en menores de 5 anos,clasificacion e,2002-01-01,3,3,3,3,6
21304,CALAMARCA,estado nutricional en menores de 5 anos,clasificacion e,2002-01-01,1,4,1,4,5
10701,CAMARGO,estado nutricional en menores de 5 anos,clasificacion e,2002-01-01,0,41,0,41,41
10901,CAMATAQUI (C. VILLA ABECIA),estado nutricional en menores de 5 anos,clasificacion e,2002-01-01,0,10,0,10,10
70706,CAMIRI,estado nutricional en menores de 5 anos,clasificacion e,2002-01-01,42,46,42,46,88
30701,CAPINOTA,estado nutricional en menores de 5 anos,clasificacion e,2002-01-01,20,10,20,10,30
20302,CAQUIAVIRI,estado nutricional en menores de 5 anos,clasificacion e,2002-01-01,2,15,2,15,17
40102,CARACOLLO,estado nutricional en menores de 5 anos,clasificacion e,2002-01-01,1,4,1,4,5
22001,CARANAVI,estado nutricional en menores de 5 anos,clasificacion e,2002-01-01,17,27,17,27,44
60302,CARAPARI,estado nutricional en menores de 5 anos,clasificacion e,2002-01-01,6,4,6,4,10
50702,CARIPUYO,estado nutricional en menores de 5 anos,clasificacion e,2002-01-01,0,44,0,44,44
21902,CATACORA,estado nutricional en menores de 5 anos,clasificacion e,2002-01-01,0,3,0,3,3
40201,CHALLAPATA,estado nutricional en menores de 5 anos,clasificacion e,2002-01-01,16,17,16,17,33
50302,CHAQUI,estado nutricional en menores de 5 anos,clasificacion e,2002-01-01,0,32,0,32,32
70702,CHARAGUA,estado nutricional en menores de 5 anos,clasificacion e,2002-01-01,0,81,0,81,81
31204,CHIMORE,estado nutricional en menores de 5 anos,clasificacion e,2002-01-01,7,9,7,9,16
21101,CHULUMANI (V. DE LA LIBERTAD),estado nutricional en menores de 5 anos,clasificacion e,2002-01-01,2,4,2,4,6
30801,CLIZA,estado nutricional en menores de 5 anos,clasificacion e,2002-01-01,1,8,1,8,9
90101,COBIJA,estado nutricional en menores de 5 anos,clasificacion e,2002-01-01,25,12,25,12,37
30101,COCHABAMBA,estado nutricional en menores de 5 anos,clasificacion e,2002-01-01,70,62,70,62,132
30905,COLCAPIRHUA,estado nutricional en menores de 5 anos,clasificacion e,2002-01-01,20,20,20,20,40
50901,"COLCHA ""K""",estado nutricional en menores de 5 anos,clasificacion e,2002-01-01,0,17,0,17,17
31002,COLOMI,estado nutricional en menores de 5 anos,clasificacion e,2002-01-01,5,6,5,6,11
50401,COLQUECHACA,estado nutricional en menores de 5 anos,clasificacion e,2002-01-01,10,22,10,22,32
21306,COLQUENCHA,estado nutricional en menores de 5 anos,clasificacion e,2002-01-01,3,1,3,1,4
21004,COLQUIRI,estado nutricional en menores de 5 anos,clasificacion e,2002-01-01,16,11,16,11,27
20304,COMANCHE,estado nutricional en menores de 5 anos,clasificacion e,2002-01-01,2,3,2,3,5
71301,COMARAPA,estado nutricional en menores de 5 anos,clasificacion e,2002-01-01,4,10,4,10,14
20605,COMBAYA,estado nutricional en menores de 5 anos,clasificacion e,2002-01-01,0,13,0,13,13
71101,CONCEPCION,estado nutricional en menores de 5 anos,clasificacion e,2002-01-01,0,12,0,12,12
21701,COPACABANA,estado nutricional en menores de 5 anos,clasificacion e,2002-01-01,0,1,0,1,1
21402,CORIPATA,estado nutricional en menores de 5 anos,clasificacion e,2002-01-01,0,2,0,2,2
20301,CORO CORO,estado nutricional en menores de 5 anos,clasificacion e,2002-01-01,6,10,6,10,16
21401,COROICO,estado nutricional en menores de 5 anos,clasificacion e,2002-01-01,6,2,6,2,8
40301,CORQUE,estado nutricional en menores de 5 anos,clasificacion e,2002-01-01,5,6,5,6,11
50601,COTAGAITA,estado nutricional en menores de 5 anos,clasificacion e,2002-01-01,3,43,3,43,46
70102,COTOCA,estado nutricional en menores de 5 anos,clasificacion e,2002-01-01,8,10,8,10,18
31405,CUCHUMUELA (V. G. VILLARROEL),estado nutricional en menores de 5 anos,clasificacion e,2002-01-01,0,3,0,3,3
70704,CUEVO,estado nutricional en menores de 5 anos,clasificacion e,2002-01-01,9,4,9,4,13
10902,CULPINA,estado nutricional en menores de 5 anos,clasificacion e,2002-01-01,2,61,2,61,63
40401,CURAHUARA DE CARANGAS,estado nutricional en menores de 5 anos,clasificacion e,2002-01-01,3,1,3,1,4
21602,CURVA,estado nutricional en menores de 5 anos,clasificacion e,2002-01-01,2,1,2,1,3
20804,DESAGUADERO,estado nutricional en menores de 5 anos,clasificacion e,2002-01-01,0,5,0,5,5
20105,EL ALTO,estado nutricional en menores de 5 anos,clasificacion e,2002-01-01,359,325,359,325,684
40103,EL CHORO,estado nutricional en menores de 5 anos,clasificacion e,2002-01-01,1,0,1,0,1
71503,EL PUENTE(STC),estado nutricional en menores de 5 anos,clasificacion e,2002-01-01,1,25,1,25,26
60502,EL PUENTE(TJA),estado nutricional en menores de 5 anos,clasificacion e,2002-01-01,0,2,0,2,2
70105,EL TORNO,estado nutricional en menores de 5 anos,clasificacion e,2002-01-01,14,21,14,21,35
10405,EL VILLAR,estado nutricional en menores de 5 anos,clasificacion e,2002-01-01,0,48,0,48,48
60601,ENTRE RIOS,estado nutricional en menores de 5 anos,clasificacion e,2002-01-01,9,10,9,10,19
41101,EUCALIPTUS,estado nutricional en menores de 5 anos,clasificacion e,2002-01-01,0,2,0,2,2
80402,EXALTACION,estado nutricional en menores de 5 anos,clasificacion e,2002-01-01,3,10,3,10,13
90203,FILADELFIA,estado nutricional en menores de 5 anos,clasificacion e,2002-01-01,0,2,0,2,2
71002,GENERAL SAAVEDRA,estado nutricional en menores de 5 anos,clasificacion e,2002-01-01,19,56,19,56,75
21601,GRAL. J.J. PEREZ (CHARAZANI),estado nutricional en menores de 5 anos,clasificacion e,2002-01-01,1,2,1,2,3
20602,GUANAY,estado nutricional en menores de 5 anos,clasificacion e,2002-01-01,0,35,0,35,35
20802,GUAQUI,estado nutricional en menores de 5 anos,clasificacion e,2002-01-01,0,2,0,2,2
80202,GUAYARAMERIN,estado nutricional en menores de 5 anos,clasificacion e,2002-01-01,18,10,18,10,28
70705,GUTIERREZ,estado nutricional en menores de 5 anos,clasificacion e,2002-01-01,9,90,9,90,99
10502,HUACARETA,estado nutricional en menores de 5 anos,clasificacion e,2002-01-01,2,56,2,56,58
11002,HUACAYA (VILLA DE HUACAYA),estado nutricional en menores de 5 anos,clasificacion e,2002-01-01,0,6,0,6,6
40501,HUACHACALLA,estado nutricional en menores de 5 anos,clasificacion e,2002-01-01,0,1,0,1,1
40701,HUANUNI,estado nutricional en menores de 5 anos,clasificacion e,2002-01-01,2,3,2,3,5
21005,ICHOCA,estado nutricional en menores de 5 anos,clasificacion e,2002-01-01,1,3,1,3,4
10304,ICLA,estado nutricional en menores de 5 anos,clasificacion e,2002-01-01,97,114,97,114,211
10703,INCAHUASI,estado nutricional en menores de 5 anos,clasificacion e,2002-01-01,1,32,1,32,33
21001,INQUISIVI,estado nutricional en menores de 5 anos,clasificacion e,2002-01-01,1,23,1,23,24
21102,IRUPANA (VILLA DE LANZA),estado nutricional en menores de 5 anos,clasificacion e,2002-01-01,0,8,0,8,8
21501,IXIAMAS,estado nutricional en menores de 5 anos,clasificacion e,2002-01-01,3,5,3,5,8
21105,LA ASUNTA,estado nutricional en menores de 5 anos,clasificacion e,2002-01-01,10,12,10,12,22
70104,LA GUARDIA,estado nutricional en menores de 5 anos,clasificacion e,2002-01-01,9,21,9,21,30
20101,LA PAZ,estado nutricional en menores de 5 anos,clasificacion e,2002-01-01,172,161,172,161,333
70701,LAGUNILLAS,estado nutricional en menores de 5 anos,clasificacion e,2002-01-01,17,17,17,17,34
21202,LAJA,estado nutricional en menores de 5 anos,clasificacion e,2002-01-01,0,5,0,5,5
10903,LAS CARRERAS,estado nutricional en menores de 5 anos,clasificacion e,2002-01-01,0,8,0,8,8
51401,LLICA,estado nutricional en menores de 5 anos,clasificacion e,2002-01-01,1,7,1,7,8
80601,LORETO,estado nutricional en menores de 5 anos,clasificacion e,2002-01-01,0,1,0,1,1
20901,LURIBAY,estado nutricional en menores de 5 anos,clasificacion e,2002-01-01,0,6,0,6,6
40702,MACHACAMARCA,estado nutricional en menores de 5 anos,clasificacion e,2002-01-01,10,1,10,1,11
11003,MACHARETI,estado nutricional en menores de 5 anos,clasificacion e,2002-01-01,3,40,3,40,43
80801,MAGDALENA,estado nutricional en menores de 5 anos,clasificacion e,2002-01-01,3,6,3,6,9
70903,MAIRANA,estado nutricional en menores de 5 anos,clasificacion e,2002-01-01,6,8,6,8,14
20103,MECAPACA,estado nutricional en menores de 5 anos,clasificacion e,2002-01-01,0,6,0,6,6
71003,MINEROS,estado nutricional en menores de 5 anos,clasificacion e,2002-01-01,7,72,7,72,79
31301,MIZQUE,estado nutricional en menores de 5 anos,clasificacion e,2002-01-01,2,11,2,11,13
20402,MOCOMOCO,estado nutricional en menores de 5 anos,clasificacion e,2002-01-01,0,3,0,3,3
51002,MOJINETE,estado nutricional en menores de 5 anos,clasificacion e,2002-01-01,0,1,0,1,1
10303,MOJOCOYA,estado nutricional en menores de 5 anos,clasificacion e,2002-01-01,25,14,25,14,39
10501,MONTEAGUDO,estado nutricional en menores de 5 anos,clasificacion e,2002-01-01,7,47,7,47,54
71001,MONTERO,estado nutricional en menores de 5 anos,clasificacion e,2002-01-01,3,142,3,142,145
70803,MORO MORO,estado nutricional en menores de 5 anos,clasificacion e,2002-01-01,6,1,6,1,7
30302,MOROCHATA,estado nutricional en menores de 5 anos,clasificacion e,2002-01-01,4,9,4,9,13
50404,OCURI,estado nutricional en menores de 5 anos,clasificacion e,2002-01-01,15,23,15,23,38
70202,OKINAWA,estado nutricional en menores de 5 anos,clasificacion e,2002-01-01,0,2,0,2,2
40101,ORURO,estado nutricional en menores de 5 anos,clasificacion e,2002-01-01,10,198,10,198,208
60201,PADCAYA,estado nutricional en menores de 5 anos,clasificacion e,2002-01-01,3,5,3,5,8
10401,PADILLA,estado nutricional en menores de 5 anos,clasificacion e,2002-01-01,1,104,1,104,105
70502,PAILON,estado nutricional en menores de 5 anos,clasificacion e,2002-01-01,2,19,2,19,21
20102,PALCA,estado nutricional en menores de 5 anos,clasificacion e,2002-01-01,10,8,10,8,18
21104,PALOS BLANCOS,estado nutricional en menores de 5 anos,clasificacion e,2002-01-01,15,22,15,22,37
40802,PAMPA AULLAGAS,estado nutricional en menores de 5 anos,clasificacion e,2002-01-01,4,5,4,5,9
70902,PAMPA GRANDE,estado nutricional en menores de 5 anos,clasificacion e,2002-01-01,2,5,2,5,7
21802,PAPEL PAMPA,estado nutricional en menores de 5 anos,clasificacion e,2002-01-01,3,1,3,1,4
30202,PASORAPA,estado nutricional en menores de 5 anos,clasificacion e,2002-01-01,1,0,1,0,1
21305,PATACAMAYA,estado nutricional en menores de 5 anos,clasificacion e,2002-01-01,10,3,10,3,13
40602,PAZÃ‘A,estado nutricional en menores de 5 anos,clasificacion e,2002-01-01,0,11,0,11,11
20702,PELECHUCO,estado nutricional en menores de 5 anos,clasificacion e,2002-01-01,6,4,6,4,10
50403,POCOATA,estado nutricional en menores de 5 anos,clasificacion e,2002-01-01,19,47,19,47,66
31203,POCONA,estado nutricional en menores de 5 anos,clasificacion e,2002-01-01,1,16,1,16,17
31202,POJO (CBBA),estado nutricional en menores de 5 anos,clasificacion e,2002-01-01,7,28,7,28,35
40601,POOPO,estado nutricional en menores de 5 anos,clasificacion e,2002-01-01,0,12,0,12,12
51203,PORCO,estado nutricional en menores de 5 anos,clasificacion e,2002-01-01,5,1,5,1,6
10103,POROMA,estado nutricional en menores de 5 anos,clasificacion e,2002-01-01,11,52,11,52,63
70103,PORONGO,estado nutricional en menores de 5 anos,clasificacion e,2002-01-01,0,2,0,2,2
70601,PORTACHUELO,estado nutricional en menores de 5 anos,clasificacion e,2002-01-01,12,4,12,4,16
90102,PORVENIR,estado nutricional en menores de 5 anos,clasificacion e,2002-01-01,0,2,0,2,2
70804,POSTRER VALLE,estado nutricional en menores de 5 anos,clasificacion e,2002-01-01,0,1,0,1,1
50101,POTOSI,estado nutricional en menores de 5 anos,clasificacion e,2002-01-01,28,160,28,160,188
10302,PRESTO,estado nutricional en menores de 5 anos,clasificacion e,2002-01-01,26,17,26,17,43
21201,PUCARANI,estado nutricional en menores de 5 anos,clasificacion e,2002-01-01,1,0,1,0,1
20401,PUERTO ACOSTA,estado nutricional en menores de 5 anos,clasificacion e,2002-01-01,16,8,16,8,24
20403,PUERTO CARABUCO,estado nutricional en menores de 5 anos,clasificacion e,2002-01-01,8,10,8,10,18
90301,PUERTO GONZALO MORENO,estado nutricional en menores de 5 anos,clasificacion e,2002-01-01,0,3,0,3,3
21204,PUERTO PEREZ,estado nutricional en menores de 5 anos,clasificacion e,2002-01-01,0,3,0,3,3
71402,PUERTO QUIJARRO,estado nutricional en menores de 5 anos,clasificacion e,2002-01-01,18,3,18,3,21
90201,PUERTO RICO,estado nutricional en menores de 5 anos,clasificacion e,2002-01-01,0,3,0,3,3
71401,PUERTO SUAREZ,estado nutricional en menores de 5 anos,clasificacion e,2002-01-01,33,5,33,5,38
31205,PUERTO VILLARROEL,estado nutricional en menores de 5 anos,clasificacion e,2002-01-01,35,41,35,41,76
51101,PUNA,estado nutricional en menores de 5 anos,clasificacion e,2002-01-01,0,64,0,64,64
31401,PUNATA,estado nutricional en menores de 5 anos,clasificacion e,2002-01-01,0,4,0,4,4
20604,QUIABAYA,estado nutricional en menores de 5 anos,clasificacion e,2002-01-01,0,4,0,4,4
30901,QUILLACOLLO,estado nutricional en menores de 5 anos,clasificacion e,2002-01-01,8,5,8,5,13
21002,QUIME,estado nutricional en menores de 5 anos,clasificacion e,2002-01-01,7,8,7,8,15
50402,RAVELO,estado nutricional en menores de 5 anos,clasificacion e,2002-01-01,3,88,3,88,91
80301,REYES,estado nutricional en menores de 5 anos,clasificacion e,2002-01-01,5,9,5,9,14
80201,RIBERALTA,estado nutricional en menores de 5 anos,clasificacion e,2002-01-01,111,85,111,85,196
70503,ROBORE,estado nutricional en menores de 5 anos,clasificacion e,2002-01-01,0,15,0,15,15
80304,RURRENABAQUE,estado nutricional en menores de 5 anos,clasificacion e,2002-01-01,10,8,10,8,18
31001,SACABA,estado nutricional en menores de 5 anos,clasificacion e,2002-01-01,8,22,8,22,30
30404,SACABAMBA,estado nutricional en menores de 5 anos,clasificacion e,2002-01-01,0,8,0,8,8
50701,SACACA,estado nutricional en menores de 5 anos,clasificacion e,2002-01-01,27,73,27,73,100
71302,SAIPINA,estado nutricional en menores de 5 anos,clasificacion e,2002-01-01,5,1,5,1,6
40801,SALINAS DE GARCI MENDOZA,estado nutricional en menores de 5 anos,clasificacion e,2002-01-01,4,2,4,2,6
70901,SAMAIPATA,estado nutricional en menores de 5 anos,clasificacion e,2002-01-01,2,3,2,3,5
51601,SAN AGUSTIN,estado nutricional en menores de 5 anos,clasificacion e,2002-01-01,0,2,0,2,2
51003,SAN ANTONIO DE ESMORUCO,estado nutricional en menores de 5 anos,clasificacion e,2002-01-01,0,1,0,1,1
71105,SAN ANTONIO DE LOMERIO,estado nutricional en menores de 5 anos,clasificacion e,2002-01-01,57,70,57,70,127
31403,SAN BENITO,estado nutricional en menores de 5 anos,clasificacion e,2002-01-01,0,5,0,5,5
80302,SAN BORJA,estado nutricional en menores de 5 anos,clasificacion e,2002-01-01,19,13,19,13,32
21502,SAN BUENA VENTURA,estado nutricional en menores de 5 anos,clasificacion e,2002-01-01,11,6,11,6,17
70402,SAN CARLOS,estado nutricional en menores de 5 anos,clasificacion e,2002-01-01,1,1,1,1,2
80501,SAN IGNACIO,estado nutricional en menores de 5 anos,clasificacion e,2002-01-01,1,42,1,42,43
70301,SAN IGNACIO DE VELASCO,estado nutricional en menores de 5 anos,clasificacion e,2002-01-01,68,41,68,41,109
80102,SAN JAVIER(BNI),estado nutricional en menores de 5 anos,clasificacion e,2002-01-01,0,2,0,2,2
71102,SAN JAVIER(STC),estado nutricional en menores de 5 anos,clasificacion e,2002-01-01,5,3,5,3,8
80701,SAN JOAQUIN,estado nutricional en menores de 5 anos,clasificacion e,2002-01-01,0,2,0,2,2
70501,SAN JOSE DE CHIQUITOS,estado nutricional en menores de 5 anos,clasificacion e,2002-01-01,23,6,23,6,29
71104,SAN JULIAN,estado nutricional en menores de 5 anos,clasificacion e,2002-01-01,31,48,31,48,79
60501,SAN LORENZO(TJA),estado nutricional en menores de 5 anos,clasificacion e,2002-01-01,0,5,0,5,5
10702,SAN LUCAS,estado nutricional en menores de 5 anos,clasificacion e,2002-01-01,1,177,1,177,178
71201,SAN MATIAS,estado nutricional en menores de 5 anos,clasificacion e,2002-01-01,35,17,35,17,52
70302,SAN MIGUEL DE VELASCO,estado nutricional en menores de 5 anos,clasificacion e,2002-01-01,17,29,17,29,46
51001,SAN PABLO DE LIPEZ,estado nutricional en menores de 5 anos,clasificacion e,2002-01-01,0,5,0,5,5
50501,SAN PEDRO DE BUENA VISTA,estado nutricional en menores de 5 anos,clasificacion e,2002-01-01,1,20,1,20,21
21801,SAN PEDRO DE CURAHUARA,estado nutricional en menores de 5 anos,clasificacion e,2002-01-01,0,2,0,2,2
21702,SAN PEDRO DE TIQUINA,estado nutricional en menores de 5 anos,clasificacion e,2002-01-01,0,4,0,4,4
90202,SAN PEDRO(PND),estado nutricional en menores de 5 anos,clasificacion e,2002-01-01,1,0,1,0,1
70303,SAN RAFAEL,estado nutricional en menores de 5 anos,clasificacion e,2002-01-01,6,9,6,9,15
80702,SAN RAMON,estado nutricional en menores de 5 anos,clasificacion e,2002-01-01,3,1,3,1,4
80401,SANTA ANA,estado nutricional en menores de 5 anos,clasificacion e,2002-01-01,2,9,2,9,11
70101,SANTA CRUZ DE LA SIERRA,estado nutricional en menores de 5 anos,clasificacion e,2002-01-01,61,88,61,88,149
80303,SANTA ROSA,estado nutricional en menores de 5 anos,clasificacion e,2002-01-01,3,2,3,2,5
70602,SANTA ROSA DEL SARA,estado nutricional en menores de 5 anos,clasificacion e,2002-01-01,2,6,2,6,8
41401,SANTIAGO DE HUARI,estado nutricional en menores de 5 anos,clasificacion e,2002-01-01,9,3,9,3,12
30702,SANTIVAÃ‘ES,estado nutricional en menores de 5 anos,clasificacion e,2002-01-01,4,7,4,7,11
40202,SANTUARIO DE QUILLACAS,estado nutricional en menores de 5 anos,clasificacion e,2002-01-01,1,1,1,1,2
20902,SAPAHAQUI,estado nutricional en menores de 5 anos,clasificacion e,2002-01-01,1,6,1,6,7
90303,SENA,estado nutricional en menores de 5 anos,clasificacion e,2002-01-01,0,4,0,4,4
21301,SICA SICA (VILLA AROMA),estado nutricional en menores de 5 anos,clasificacion e,2002-01-01,7,3,7,3,10
30703,SICAYA,estado nutricional en menores de 5 anos,clasificacion e,2002-01-01,0,7,0,7,7
30902,SIPE SIPE,estado nutricional en menores de 5 anos,clasificacion e,2002-01-01,36,31,36,31,67
10403,SOPACHUY,estado nutricional en menores de 5 anos,clasificacion e,2002-01-01,1,42,1,42,43
20601,SORATA,estado nutricional en menores de 5 anos,clasificacion e,2002-01-01,0,2,0,2,2
10101,SUCRE,estado nutricional en menores de 5 anos,clasificacion e,2002-01-01,12,219,12,219,231
31404,TACACHI,estado nutricional en menores de 5 anos,clasificacion e,2002-01-01,0,3,0,3,3
50303,TACOBAMBA,estado nutricional en menores de 5 anos,clasificacion e,2002-01-01,4,25,4,25,29
30602,TACOPAYA,estado nutricional en menores de 5 anos,clasificacion e,2002-01-01,16,21,16,21,37
51402,TAHUA,estado nutricional en menores de 5 anos,clasificacion e,2002-01-01,0,2,0,2,2
31101,TAPACARI,estado nutricional en menores de 5 anos,clasificacion e,2002-01-01,0,20,0,20,20
10601,TARABUCO,estado nutricional en menores de 5 anos,clasificacion e,2002-01-01,3,285,3,285,288
30401,TARATA,estado nutricional en menores de 5 anos,clasificacion e,2002-01-01,0,15,0,15,15
60101,TARIJA,estado nutricional en menores de 5 anos,clasificacion e,2002-01-01,10,43,10,43,53
10202,TARVITA,estado nutricional en menores de 5 anos,clasificacion e,2002-01-01,15,28,15,28,43
20803,TIAWANACU,estado nutricional en menores de 5 anos,clasificacion e,2002-01-01,1,0,1,0,1
50102,TINGUIPAYA,estado nutricional en menores de 5 anos,clasificacion e,2002-01-01,4,22,4,22,26
20606,TIPUANI,estado nutricional en menores de 5 anos,clasificacion e,2002-01-01,1,2,1,2,3
30903,TIQUIPAYA,estado nutricional en menores de 5 anos,clasificacion e,2002-01-01,0,12,0,12,12
31601,TIRAQUE (CBBA),estado nutricional en menores de 5 anos,clasificacion e,2002-01-01,33,63,33,63,96
21703,TITO YUPANQUI (PARQUIPUJIO),estado nutricional en menores de 5 anos,clasificacion e,2002-01-01,0,13,0,13,13
30802,TOCO,estado nutricional en menores de 5 anos,clasificacion e,2002-01-01,0,2,0,2,2
41001,TOLEDO,estado nutricional en menores de 5 anos,clasificacion e,2002-01-01,4,0,4,0,4
51202,TOMAVE,estado nutricional en menores de 5 anos,clasificacion e,2002-01-01,0,36,0,36,36
10402,TOMINA,estado nutricional en menores de 5 anos,clasificacion e,2002-01-01,7,76,7,76,83
50502,TORO TORO,estado nutricional en menores de 5 anos,clasificacion e,2002-01-01,0,4,0,4,4
31201,TOTORA(CBBA),estado nutricional en menores de 5 anos,clasificacion e,2002-01-01,9,9,9,9,18
70802,TRIGAL,estado nutricional en menores de 5 anos,clasificacion e,2002-01-01,1,1,1,1,2
80101,TRINIDAD,estado nutricional en menores de 5 anos,clasificacion e,2002-01-01,10,64,10,64,74
50801,TUPIZA,estado nutricional en menores de 5 anos,clasificacion e,2002-01-01,2,104,2,104,106
40402,TURCO,estado nutricional en menores de 5 anos,clasificacion e,2002-01-01,1,3,1,3,4
21302,UMALA,estado nutricional en menores de 5 anos,clasificacion e,2002-01-01,0,1,0,1,1
50201,UNCIA,estado nutricional en menores de 5 anos,clasificacion e,2002-01-01,0,4,0,4,4
60401,URIONDO (A. CONCEPCION),estado nutricional en menores de 5 anos,clasificacion e,2002-01-01,3,3,3,3,6
71502,URUBICHA,estado nutricional en menores de 5 anos,clasificacion e,2002-01-01,0,5,0,5,5
51201,UYUNI,estado nutricional en menores de 5 anos,clasificacion e,2002-01-01,0,9,0,9,9
30502,VACAS,estado nutricional en menores de 5 anos,clasificacion e,2002-01-01,0,12,0,12,12
70801,VALLEGRANDE,estado nutricional en menores de 5 anos,clasificacion e,2002-01-01,2,22,2,22,24
20801,VIACHA,estado nutricional en menores de 5 anos,clasificacion e,2002-01-01,2,30,2,30,32
31302,VILA VILA,estado nutricional en menores de 5 anos,clasificacion e,2002-01-01,3,5,3,5,8
60303,VILLA MONTES,estado nutricional en menores de 5 anos,clasificacion e,2002-01-01,17,18,17,18,35
10801,VILLA SERRANO,estado nutricional en menores de 5 anos,clasificacion e,2002-01-01,0,72,0,72,72
31003,VILLA TUNARI,estado nutricional en menores de 5 anos,clasificacion e,2002-01-01,39,27,39,27,66
11001,VILLA VACA GUZMAN (MUYUPAMPA),estado nutricional en menores de 5 anos,clasificacion e,2002-01-01,0,38,0,38,38
51501,VILLAZON,estado nutricional en menores de 5 anos,clasificacion e,2002-01-01,1,43,1,43,44
30904,VINTO,estado nutricional en menores de 5 anos,clasificacion e,2002-01-01,10,17,10,17,27
50602,VITICHI,estado nutricional en menores de 5 anos,clasificacion e,2002-01-01,8,18,8,18,26
20306,WALDO BALLIVIAN,estado nutricional en menores de 5 anos,clasificacion e,2002-01-01,0,3,0,3,3
70201,WARNES,estado nutricional en menores de 5 anos,clasificacion e,2002-01-01,20,31,20,31,51
20903,YACO,estado nutricional en menores de 5 anos,clasificacion e,2002-01-01,0,9,0,9,9
60301,YACUIBA,estado nutricional en menores de 5 anos,clasificacion e,2002-01-01,14,8,14,8,22
10602,YAMPARAEZ,estado nutricional en menores de 5 anos,clasificacion e,2002-01-01,63,52,63,52,115
21103,YANACACHI,estado nutricional en menores de 5 anos,clasificacion e,2002-01-01,3,0,3,0,3
70403,YAPACANI,estado nutricional en menores de 5 anos,clasificacion e,2002-01-01,33,22,33,22,55
50103,YOCALLA,estado nutricional en menores de 5 anos,clasificacion e,2002-01-01,0,5,0,5,5
10102,YOTALA,estado nutricional en menores de 5 anos,clasificacion e,2002-01-01,15,34,15,34,49
60402,YUNCHARA,estado nutricional en menores de 5 anos,clasificacion e,2002-01-01,4,11,4,11,15
10301,ZUDAÃ‘EZ,estado nutricional en menores de 5 anos,clasificacion e,2002-01-01,50,39,50,39,89
51302,ACACIO,estado nutricional en menores de 5 anos,clasificacion e,2002-02-01,3,36,3,36,39
20201,ACHACACHI,estado nutricional en menores de 5 anos,clasificacion e,2002-02-01,9,10,9,10,19
30201,AIQUILE,estado nutricional en menores de 5 anos,clasificacion e,2002-02-01,2,3,2,3,5
31303,ALALAY,estado nutricional en menores de 5 anos,clasificacion e,2002-02-01,0,2,0,2,2
10404,ALCALA,estado nutricional en menores de 5 anos,clasificacion e,2002-02-01,10,10,10,10,20
20202,ANCORAIMES,estado nutricional en menores de 5 anos,clasificacion e,2002-02-01,5,12,5,12,17
41201,ANDAMARCA,estado nutricional en menores de 5 anos,clasificacion e,2002-02-01,2,0,2,0,2
30402,ANZALDO,estado nutricional en menores de 5 anos,clasificacion e,2002-02-01,1,9,1,9,10
20701,APOLO,estado nutricional en menores de 5 anos,clasificacion e,2002-02-01,13,3,13,3,16
51301,ARAMPAMPA,estado nutricional en menores de 5 anos,clasificacion e,2002-02-01,6,38,6,38,44
30403,ARBIETO,estado nutricional en menores de 5 anos,clasificacion e,2002-02-01,0,1,0,1,1
30601,ARQUE,estado nutricional en menores de 5 anos,clasificacion e,2002-02-01,1,7,1,7,8
71501,ASCENCION DE GUARAYOS,estado nutricional en menores de 5 anos,clasificacion e,2002-02-01,38,38,38,38,76
50802,ATOCHA,estado nutricional en menores de 5 anos,clasificacion e,2002-02-01,2,14,2,14,16
20503,AUCAPATA,estado nutricional en menores de 5 anos,clasificacion e,2002-02-01,0,9,0,9,9
20502,AYATA,estado nutricional en menores de 5 anos,clasificacion e,2002-02-01,1,0,1,0,1
21303,AYO AYO,estado nutricional en menores de 5 anos,clasificacion e,2002-02-01,6,1,6,1,7
30301,AYOPAYA (V. DE INDEPENDENCIA),estado nutricional en menores de 5 anos,clasificacion e,2002-02-01,22,23,22,23,45
10201,AZURDUY,estado nutricional en menores de 5 anos,clasificacion e,2002-02-01,10,27,10,27,37
21203,BATALLAS,estado nutricional en menores de 5 anos,clasificacion e,2002-02-01,1,6,1,6,7
80802,BAURES,estado nutricional en menores de 5 anos,clasificacion e,2002-02-01,3,3,3,3,6
50104,BELEN DE URMIRI,estado nutricional en menores de 5 anos,clasificacion e,2002-02-01,0,3,0,3,3
90104,BELLA FLOR,estado nutricional en menores de 5 anos,clasificacion e,2002-02-01,0,3,0,3,3
60202,BERMEJO,estado nutricional en menores de 5 anos,clasificacion e,2002-02-01,1,4,1,4,5
50301,BETANZOS,estado nutricional en menores de 5 anos,clasificacion e,2002-02-01,6,72,6,72,78
31501,BOLIVAR,estado nutricional en menores de 5 anos,clasificacion e,2002-02-01,9,12,9,12,21
70707,BOYUIBE,estado nutricional en menores de 5 anos,clasificacion e,2002-02-01,0,1,0,1,1
70401,BUENA VISTA,estado nutricional en menores de 5 anos,clasificacion e,2002-02-01,7,7,7,7,14
70703,CABEZAS,estado nutricional en menores de 5 anos,clasificacion e,2002-02-01,0,16,0,16,16
20905,CAIROMA,estado nutricional en menores de 5 anos,clasificacion e,2002-02-01,0,2,0,2,2
51102,"CAIZA ""D""",estado nutricional en menores de 5 anos,clasificacion e,2002-02-01,5,40,5,40,45
21003,CAJUATA,estado nutricional en menores de 5 anos,clasificacion e,2002-02-01,9,2,9,2,11
20303,CALACOTO,estado nutricional en menores de 5 anos,clasificacion e,2002-02-01,0,2,0,2,2
21304,CALAMARCA,estado nutricional en menores de 5 anos,clasificacion e,2002-02-01,5,3,5,3,8
10701,CAMARGO,estado nutricional en menores de 5 anos,clasificacion e,2002-02-01,1,34,1,34,35
10901,CAMATAQUI (C. VILLA ABECIA),estado nutricional en menores de 5 anos,clasificacion e,2002-02-01,1,4,1,4,5
70706,CAMIRI,estado nutricional en menores de 5 anos,clasificacion e,2002-02-01,19,32,19,32,51
30701,CAPINOTA,estado nutricional en menores de 5 anos,clasificacion e,2002-02-01,15,3,15,3,18
20302,CAQUIAVIRI,estado nutricional en menores de 5 anos,clasificacion e,2002-02-01,2,7,2,7,9
40102,CARACOLLO,estado nutricional en menores de 5 anos,clasificacion e,2002-02-01,6,18,6,18,24
22001,CARANAVI,estado nutricional en menores de 5 anos,clasificacion e,2002-02-01,15,17,15,17,32
60302,CARAPARI,estado nutricional en menores de 5 anos,clasificacion e,2002-02-01,5,3,5,3,8
50702,CARIPUYO,estado nutricional en menores de 5 anos,clasificacion e,2002-02-01,0,20,0,20,20
21902,CATACORA,estado nutricional en menores de 5 anos,clasificacion e,2002-02-01,2,2,2,2,4
40201,CHALLAPATA,estado nutricional en menores de 5 anos,clasificacion e,2002-02-01,8,3,8,3,11
50302,CHAQUI,estado nutricional en menores de 5 anos,clasificacion e,2002-02-01,10,23,10,23,33
70702,CHARAGUA,estado nutricional en menores de 5 anos,clasificacion e,2002-02-01,2,69,2,69,71
31204,CHIMORE,estado nutricional en menores de 5 anos,clasificacion e,2002-02-01,5,3,5,3,8
40903,CHIPAYA,estado nutricional en menores de 5 anos,clasificacion e,2002-02-01,0,1,0,1,1
40302,CHOQUE COTA,estado nutricional en menores de 5 anos,clasificacion e,2002-02-01,0,1,0,1,1
20501,CHUMA,estado nutricional en menores de 5 anos,clasificacion e,2002-02-01,2,0,2,0,2
30801,CLIZA,estado nutricional en menores de 5 anos,clasificacion e,2002-02-01,0,12,0,12,12
90101,COBIJA,estado nutricional en menores de 5 anos,clasificacion e,2002-02-01,6,5,6,5,11
30101,COCHABAMBA,estado nutricional en menores de 5 anos,clasificacion e,2002-02-01,36,67,36,67,103
40902,COIPASA,estado nutricional en menores de 5 anos,clasificacion e,2002-02-01,0,1,0,1,1
30905,COLCAPIRHUA,estado nutricional en menores de 5 anos,clasificacion e,2002-02-01,7,6,7,6,13
50901,"COLCHA ""K""",estado nutricional en menores de 5 anos,clasificacion e,2002-02-01,0,3,0,3,3
31002,COLOMI,estado nutricional en menores de 5 anos,clasificacion e,2002-02-01,16,9,16,9,25
50401,COLQUECHACA,estado nutricional en menores de 5 anos,clasificacion e,2002-02-01,10,24,10,24,34
21306,COLQUENCHA,estado nutricional en menores de 5 anos,clasificacion e,2002-02-01,4,1,4,1,5
21004,COLQUIRI,estado nutricional en menores de 5 anos,clasificacion e,2002-02-01,17,7,17,7,24
20304,COMANCHE,estado nutricional en menores de 5 anos,clasificacion e,2002-02-01,2,4,2,4,6
71301,COMARAPA,estado nutricional en menores de 5 anos,clasificacion e,2002-02-01,1,6,1,6,7
20605,COMBAYA,estado nutricional en menores de 5 anos,clasificacion e,2002-02-01,0,3,0,3,3
71101,CONCEPCION,estado nutricional en menores de 5 anos,clasificacion e,2002-02-01,0,8,0,8,8
21701,COPACABANA,estado nutricional en menores de 5 anos,clasificacion e,2002-02-01,0,5,0,5,5
20301,CORO CORO,estado nutricional en menores de 5 anos,clasificacion e,2002-02-01,3,2,3,2,5
21401,COROICO,estado nutricional en menores de 5 anos,clasificacion e,2002-02-01,7,4,7,4,11
40301,CORQUE,estado nutricional en menores de 5 anos,clasificacion e,2002-02-01,4,7,4,7,11
50601,COTAGAITA,estado nutricional en menores de 5 anos,clasificacion e,2002-02-01,2,24,2,24,26
70102,COTOCA,estado nutricional en menores de 5 anos,clasificacion e,2002-02-01,7,17,7,17,24
31405,CUCHUMUELA (V. G. VILLARROEL),estado nutricional en menores de 5 anos,clasificacion e,2002-02-01,0,1,0,1,1
70704,CUEVO,estado nutricional en menores de 5 anos,clasificacion e,2002-02-01,9,7,9,7,16
10902,CULPINA,estado nutricional en menores de 5 anos,clasificacion e,2002-02-01,2,50,2,50,52
40401,CURAHUARA DE CARANGAS,estado nutricional en menores de 5 anos,clasificacion e,2002-02-01,2,3,2,3,5
21602,CURVA,estado nutricional en menores de 5 anos,clasificacion e,2002-02-01,2,3,2,3,5
20804,DESAGUADERO,estado nutricional en menores de 5 anos,clasificacion e,2002-02-01,0,2,0,2,2
20105,EL ALTO,estado nutricional en menores de 5 anos,clasificacion e,2002-02-01,257,217,257,217,474
71503,EL PUENTE(STC),estado nutricional en menores de 5 anos,clasificacion e,2002-02-01,4,42,4,42,46
60502,EL PUENTE(TJA),estado nutricional en menores de 5 anos,clasificacion e,2002-02-01,3,8,3,8,11
70105,EL TORNO,estado nutricional en menores de 5 anos,clasificacion e,2002-02-01,21,7,21,7,28
10405,EL VILLAR,estado nutricional en menores de 5 anos,clasificacion e,2002-02-01,16,29,16,29,45
60601,ENTRE RIOS,estado nutricional en menores de 5 anos,clasificacion e,2002-02-01,2,8,2,8,10
41101,EUCALIPTUS,estado nutricional en menores de 5 anos,clasificacion e,2002-02-01,0,8,0,8,8
80402,EXALTACION,estado nutricional en menores de 5 anos,clasificacion e,2002-02-01,2,12,2,12,14
90203,FILADELFIA,estado nutricional en menores de 5 anos,clasificacion e,2002-02-01,0,1,0,1,1
71002,GENERAL SAAVEDRA,estado nutricional en menores de 5 anos,clasificacion e,2002-02-01,13,36,13,36,49
20602,GUANAY,estado nutricional en menores de 5 anos,clasificacion e,2002-02-01,11,22,11,22,33
20802,GUAQUI,estado nutricional en menores de 5 anos,clasificacion e,2002-02-01,0,2,0,2,2
80202,GUAYARAMERIN,estado nutricional en menores de 5 anos,clasificacion e,2002-02-01,8,12,8,12,20
70705,GUTIERREZ,estado nutricional en menores de 5 anos,clasificacion e,2002-02-01,5,42,5,42,47
10502,HUACARETA,estado nutricional en menores de 5 anos,clasificacion e,2002-02-01,27,26,27,26,53
11002,HUACAYA (VILLA DE HUACAYA),estado nutricional en menores de 5 anos,clasificacion e,2002-02-01,3,1,3,1,4
80803,HUARACAJE,estado nutricional en menores de 5 anos,clasificacion e,2002-02-01,3,0,3,0,3
21005,ICHOCA,estado nutricional en menores de 5 anos,clasificacion e,2002-02-01,4,8,4,8,12
10304,ICLA,estado nutricional en menores de 5 anos,clasificacion e,2002-02-01,18,29,18,29,47
10703,INCAHUASI,estado nutricional en menores de 5 anos,clasificacion e,2002-02-01,0,44,0,44,44
21001,INQUISIVI,estado nutricional en menores de 5 anos,clasificacion e,2002-02-01,5,18,5,18,23
21102,IRUPANA (VILLA DE LANZA),estado nutricional en menores de 5 anos,clasificacion e,2002-02-01,0,3,0,3,3
21501,IXIAMAS,estado nutricional en menores de 5 anos,clasificacion e,2002-02-01,3,6,3,6,9
21105,LA ASUNTA,estado nutricional en menores de 5 anos,clasificacion e,2002-02-01,7,13,7,13,20
70104,LA GUARDIA,estado nutricional en menores de 5 anos,clasificacion e,2002-02-01,16,6,16,6,22
20101,LA PAZ,estado nutricional en menores de 5 anos,clasificacion e,2002-02-01,148,128,148,128,276
70701,LAGUNILLAS,estado nutricional en menores de 5 anos,clasificacion e,2002-02-01,1,3,1,3,4
21202,LAJA,estado nutricional en menores de 5 anos,clasificacion e,2002-02-01,0,7,0,7,7
10903,LAS CARRERAS,estado nutricional en menores de 5 anos,clasificacion e,2002-02-01,0,7,0,7,7
51401,LLICA,estado nutricional en menores de 5 anos,clasificacion e,2002-02-01,0,5,0,5,5
20901,LURIBAY,estado nutricional en menores de 5 anos,clasificacion e,2002-02-01,0,8,0,8,8
40702,MACHACAMARCA,estado nutricional en menores de 5 anos,clasificacion e,2002-02-01,4,1,4,1,5
11003,MACHARETI,estado nutricional en menores de 5 anos,clasificacion e,2002-02-01,16,19,16,19,35
80801,MAGDALENA,estado nutricional en menores de 5 anos,clasificacion e,2002-02-01,5,0,5,0,5
70903,MAIRANA,estado nutricional en menores de 5 anos,clasificacion e,2002-02-01,1,1,1,1,2
20103,MECAPACA,estado nutricional en menores de 5 anos,clasificacion e,2002-02-01,1,1,1,1,2
71003,MINEROS,estado nutricional en menores de 5 anos,clasificacion e,2002-02-01,10,32,10,32,42
31301,MIZQUE,estado nutricional en menores de 5 anos,clasificacion e,2002-02-01,19,26,19,26,45
20402,MOCOMOCO,estado nutricional en menores de 5 anos,clasificacion e,2002-02-01,3,9,3,9,12
51002,MOJINETE,estado nutricional en menores de 5 anos,clasificacion e,2002-02-01,0,2,0,2,2
10303,MOJOCOYA,estado nutricional en menores de 5 anos,clasificacion e,2002-02-01,32,19,32,19,51
10501,MONTEAGUDO,estado nutricional en menores de 5 anos,clasificacion e,2002-02-01,39,46,39,46,85
71001,MONTERO,estado nutricional en menores de 5 anos,clasificacion e,2002-02-01,0,81,0,81,81
70803,MORO MORO,estado nutricional en menores de 5 anos,clasificacion e,2002-02-01,3,7,3,7,10
30302,MOROCHATA,estado nutricional en menores de 5 anos,clasificacion e,2002-02-01,5,7,5,7,12
90401,NACEBE (SANTA ROSA DEL ABUNA),estado nutricional en menores de 5 anos,clasificacion e,2002-02-01,0,3,0,3,3
20307,NAZACARA DE PACAJES,estado nutricional en menores de 5 anos,clasificacion e,2002-02-01,1,0,1,0,1
50404,OCURI,estado nutricional en menores de 5 anos,clasificacion e,2002-02-01,19,17,19,17,36
70202,OKINAWA,estado nutricional en menores de 5 anos,clasificacion e,2002-02-01,1,5,1,5,6
30203,OMEREQUE,estado nutricional en menores de 5 anos,clasificacion e,2002-02-01,1,1,1,1,2
40101,ORURO,estado nutricional en menores de 5 anos,clasificacion e,2002-02-01,11,102,11,102,113
60201,PADCAYA,estado nutricional en menores de 5 anos,clasificacion e,2002-02-01,0,5,0,5,5
10401,PADILLA,estado nutricional en menores de 5 anos,clasificacion e,2002-02-01,41,71,41,71,112
70502,PAILON,estado nutricional en menores de 5 anos,clasificacion e,2002-02-01,1,12,1,12,13
20102,PALCA,estado nutricional en menores de 5 anos,clasificacion e,2002-02-01,13,19,13,19,32
21104,PALOS BLANCOS,estado nutricional en menores de 5 anos,clasificacion e,2002-02-01,6,7,6,7,13
40802,PAMPA AULLAGAS,estado nutricional en menores de 5 anos,clasificacion e,2002-02-01,6,2,6,2,8
70902,PAMPA GRANDE,estado nutricional en menores de 5 anos,clasificacion e,2002-02-01,1,4,1,4,5
30202,PASORAPA,estado nutricional en menores de 5 anos,clasificacion e,2002-02-01,3,14,3,14,17
21305,PATACAMAYA,estado nutricional en menores de 5 anos,clasificacion e,2002-02-01,6,1,6,1,7
40602,PAZÃ‘A,estado nutricional en menores de 5 anos,clasificacion e,2002-02-01,1,14,1,14,15
20702,PELECHUCO,estado nutricional en menores de 5 anos,clasificacion e,2002-02-01,6,1,6,1,7
50403,POCOATA,estado nutricional en menores de 5 anos,clasificacion e,2002-02-01,32,50,32,50,82
31203,POCONA,estado nutricional en menores de 5 anos,clasificacion e,2002-02-01,1,13,1,13,14
31202,POJO (CBBA),estado nutricional en menores de 5 anos,clasificacion e,2002-02-01,10,24,10,24,34
40601,POOPO,estado nutricional en menores de 5 anos,clasificacion e,2002-02-01,0,3,0,3,3
51203,PORCO,estado nutricional en menores de 5 anos,clasificacion e,2002-02-01,14,9,14,9,23
10103,POROMA,estado nutricional en menores de 5 anos,clasificacion e,2002-02-01,30,63,30,63,93
70103,PORONGO,estado nutricional en menores de 5 anos,clasificacion e,2002-02-01,3,0,3,0,3
70601,PORTACHUELO,estado nutricional en menores de 5 anos,clasificacion e,2002-02-01,5,2,5,2,7
50101,POTOSI,estado nutricional en menores de 5 anos,clasificacion e,2002-02-01,36,68,36,68,104
10302,PRESTO,estado nutricional en menores de 5 anos,clasificacion e,2002-02-01,25,12,25,12,37
70805,PUCARA,estado nutricional en menores de 5 anos,clasificacion e,2002-02-01,0,1,0,1,1
21201,PUCARANI,estado nutricional en menores de 5 anos,clasificacion e,2002-02-01,2,12,2,12,14
20401,PUERTO ACOSTA,estado nutricional en menores de 5 anos,clasificacion e,2002-02-01,7,5,7,5,12
20403,PUERTO CARABUCO,estado nutricional en menores de 5 anos,clasificacion e,2002-02-01,14,13,14,13,27
90301,PUERTO GONZALO MORENO,estado nutricional en menores de 5 anos,clasificacion e,2002-02-01,0,2,0,2,2
21204,PUERTO PEREZ,estado nutricional en menores de 5 anos,clasificacion e,2002-02-01,2,0,2,0,2
71402,PUERTO QUIJARRO,estado nutricional en menores de 5 anos,clasificacion e,2002-02-01,9,3,9,3,12
90201,PUERTO RICO,estado nutricional en menores de 5 anos,clasificacion e,2002-02-01,0,3,0,3,3
80703,PUERTO SILES,estado nutricional en menores de 5 anos,clasificacion e,2002-02-01,0,3,0,3,3
71401,PUERTO SUAREZ,estado nutricional en menores de 5 anos,clasificacion e,2002-02-01,8,6,8,6,14
31205,PUERTO VILLARROEL,estado nutricional en menores de 5 anos,clasificacion e,2002-02-01,22,10,22,10,32
51101,PUNA,estado nutricional en menores de 5 anos,clasificacion e,2002-02-01,0,57,0,57,57
31401,PUNATA,estado nutricional en menores de 5 anos,clasificacion e,2002-02-01,0,2,0,2,2
20604,QUIABAYA,estado nutricional en menores de 5 anos,clasificacion e,2002-02-01,0,15,0,15,15
21002,QUIME,estado nutricional en menores de 5 anos,clasificacion e,2002-02-01,2,12,2,12,14
50402,RAVELO,estado nutricional en menores de 5 anos,clasificacion e,2002-02-01,22,58,22,58,80
80301,REYES,estado nutricional en menores de 5 anos,clasificacion e,2002-02-01,8,0,8,0,8
80201,RIBERALTA,estado nutricional en menores de 5 anos,clasificacion e,2002-02-01,51,36,51,36,87
70503,ROBORE,estado nutricional en menores de 5 anos,clasificacion e,2002-02-01,0,17,0,17,17
80304,RURRENABAQUE,estado nutricional en menores de 5 anos,clasificacion e,2002-02-01,3,0,3,0,3
31001,SACABA,estado nutricional en menores de 5 anos,clasificacion e,2002-02-01,3,15,3,15,18
30404,SACABAMBA,estado nutricional en menores de 5 anos,clasificacion e,2002-02-01,0,22,0,22,22
50701,SACACA,estado nutricional en menores de 5 anos,clasificacion e,2002-02-01,34,71,34,71,105
71302,SAIPINA,estado nutricional en menores de 5 anos,clasificacion e,2002-02-01,4,4,4,4,8
40801,SALINAS DE GARCI MENDOZA,estado nutricional en menores de 5 anos,clasificacion e,2002-02-01,2,3,2,3,5
70901,SAMAIPATA,estado nutricional en menores de 5 anos,clasificacion e,2002-02-01,1,3,1,3,4
51003,SAN ANTONIO DE ESMORUCO,estado nutricional en menores de 5 anos,clasificacion e,2002-02-01,0,3,0,3,3
71105,SAN ANTONIO DE LOMERIO,estado nutricional en menores de 5 anos,clasificacion e,2002-02-01,24,60,24,60,84
31403,SAN BENITO,estado nutricional en menores de 5 anos,clasificacion e,2002-02-01,0,13,0,13,13
80302,SAN BORJA,estado nutricional en menores de 5 anos,clasificacion e,2002-02-01,17,7,17,7,24
21502,SAN BUENA VENTURA,estado nutricional en menores de 5 anos,clasificacion e,2002-02-01,11,14,11,14,25
70402,SAN CARLOS,estado nutricional en menores de 5 anos,clasificacion e,2002-02-01,0,4,0,4,4
80501,SAN IGNACIO,estado nutricional en menores de 5 anos,clasificacion e,2002-02-01,7,33,7,33,40
70301,SAN IGNACIO DE VELASCO,estado nutricional en menores de 5 anos,clasificacion e,2002-02-01,68,75,68,75,143
80102,SAN JAVIER(BNI),estado nutricional en menores de 5 anos,clasificacion e,2002-02-01,3,1,3,1,4
71102,SAN JAVIER(STC),estado nutricional en menores de 5 anos,clasificacion e,2002-02-01,0,23,0,23,23
80701,SAN JOAQUIN,estado nutricional en menores de 5 anos,clasificacion e,2002-02-01,1,3,1,3,4
70501,SAN JOSE DE CHIQUITOS,estado nutricional en menores de 5 anos,clasificacion e,2002-02-01,9,10,9,10,19
71104,SAN JULIAN,estado nutricional en menores de 5 anos,clasificacion e,2002-02-01,24,42,24,42,66
90302,SAN LORENZO(PND),estado nutricional en menores de 5 anos,clasificacion e,2002-02-01,0,2,0,2,2
60501,SAN LORENZO(TJA),estado nutricional en menores de 5 anos,clasificacion e,2002-02-01,0,5,0,5,5
10702,SAN LUCAS,estado nutricional en menores de 5 anos,clasificacion e,2002-02-01,0,120,0,120,120
71201,SAN MATIAS,estado nutricional en menores de 5 anos,clasificacion e,2002-02-01,26,23,26,23,49
70302,SAN MIGUEL DE VELASCO,estado nutricional en menores de 5 anos,clasificacion e,2002-02-01,11,33,11,33,44
51001,SAN PABLO DE LIPEZ,estado nutricional en menores de 5 anos,clasificacion e,2002-02-01,0,5,0,5,5
50501,SAN PEDRO DE BUENA VISTA,estado nutricional en menores de 5 anos,clasificacion e,2002-02-01,5,56,5,56,61
21801,SAN PEDRO DE CURAHUARA,estado nutricional en menores de 5 anos,clasificacion e,2002-02-01,1,0,1,0,1
21702,SAN PEDRO DE TIQUINA,estado nutricional en menores de 5 anos,clasificacion e,2002-02-01,0,1,0,1,1
90202,SAN PEDRO(PND),estado nutricional en menores de 5 anos,clasificacion e,2002-02-01,0,1,0,1,1
70303,SAN RAFAEL,estado nutricional en menores de 5 anos,clasificacion e,2002-02-01,13,9,13,9,22
80702,SAN RAMON,estado nutricional en menores de 5 anos,clasificacion e,2002-02-01,1,2,1,2,3
80401,SANTA ANA,estado nutricional en menores de 5 anos,clasificacion e,2002-02-01,4,2,4,2,6
70101,SANTA CRUZ DE LA SIERRA,estado nutricional en menores de 5 anos,clasificacion e,2002-02-01,44,64,44,64,108
80303,SANTA ROSA,estado nutricional en menores de 5 anos,clasificacion e,2002-02-01,1,2,1,2,3
70602,SANTA ROSA DEL SARA,estado nutricional en menores de 5 anos,clasificacion e,2002-02-01,1,0,1,0,1
41401,SANTIAGO DE HUARI,estado nutricional en menores de 5 anos,clasificacion e,2002-02-01,0,2,0,2,2
30702,SANTIVAÃ‘ES,estado nutricional en menores de 5 anos,clasificacion e,2002-02-01,4,28,4,28,32
40202,SANTUARIO DE QUILLACAS,estado nutricional en menores de 5 anos,clasificacion e,2002-02-01,1,1,1,1,2
20902,SAPAHAQUI,estado nutricional en menores de 5 anos,clasificacion e,2002-02-01,0,5,0,5,5
21301,SICA SICA (VILLA AROMA),estado nutricional en menores de 5 anos,clasificacion e,2002-02-01,9,0,9,0,9
30703,SICAYA,estado nutricional en menores de 5 anos,clasificacion e,2002-02-01,0,1,0,1,1
30902,SIPE SIPE,estado nutricional en menores de 5 anos,clasificacion e,2002-02-01,22,18,22,18,40
10403,SOPACHUY,estado nutricional en menores de 5 anos,clasificacion e,2002-02-01,22,10,22,10,32
20601,SORATA,estado nutricional en menores de 5 anos,clasificacion e,2002-02-01,1,6,1,6,7
10101,SUCRE,estado nutricional en menores de 5 anos,clasificacion e,2002-02-01,7,162,7,162,169
31404,TACACHI,estado nutricional en menores de 5 anos,clasificacion e,2002-02-01,0,3,0,3,3
20603,TACACOMA,estado nutricional en menores de 5 anos,clasificacion e,2002-02-01,4,3,4,3,7
50303,TACOBAMBA,estado nutricional en menores de 5 anos,clasificacion e,2002-02-01,8,20,8,20,28
30602,TACOPAYA,estado nutricional en menores de 5 anos,clasificacion e,2002-02-01,2,2,2,2,4
31101,TAPACARI,estado nutricional en menores de 5 anos,clasificacion e,2002-02-01,0,21,0,21,21
10601,TARABUCO,estado nutricional en menores de 5 anos,clasificacion e,2002-02-01,0,226,0,226,226
30401,TARATA,estado nutricional en menores de 5 anos,clasificacion e,2002-02-01,1,7,1,7,8
60101,TARIJA,estado nutricional en menores de 5 anos,clasificacion e,2002-02-01,6,18,6,18,24
10202,TARVITA,estado nutricional en menores de 5 anos,clasificacion e,2002-02-01,21,20,21,20,41
20803,TIAWANACU,estado nutricional en menores de 5 anos,clasificacion e,2002-02-01,6,2,6,2,8
50102,TINGUIPAYA,estado nutricional en menores de 5 anos,clasificacion e,2002-02-01,0,27,0,27,27
20606,TIPUANI,estado nutricional en menores de 5 anos,clasificacion e,2002-02-01,1,0,1,0,1
30903,TIQUIPAYA,estado nutricional en menores de 5 anos,clasificacion e,2002-02-01,0,3,0,3,3
31601,TIRAQUE (CBBA),estado nutricional en menores de 5 anos,clasificacion e,2002-02-01,13,21,13,21,34
21703,TITO YUPANQUI (PARQUIPUJIO),estado nutricional en menores de 5 anos,clasificacion e,2002-02-01,0,5,0,5,5
30802,TOCO,estado nutricional en menores de 5 anos,clasificacion e,2002-02-01,0,4,0,4,4
41001,TOLEDO,estado nutricional en menores de 5 anos,clasificacion e,2002-02-01,1,1,1,1,2
51202,TOMAVE,estado nutricional en menores de 5 anos,clasificacion e,2002-02-01,0,35,0,35,35
10402,TOMINA,estado nutricional en menores de 5 anos,clasificacion e,2002-02-01,34,30,34,30,64
50502,TORO TORO,estado nutricional en menores de 5 anos,clasificacion e,2002-02-01,2,4,2,4,6
31201,TOTORA(CBBA),estado nutricional en menores de 5 anos,clasificacion e,2002-02-01,14,10,14,10,24
41301,TOTORA(ORR),estado nutricional en menores de 5 anos,clasificacion e,2002-02-01,1,2,1,2,3
80101,TRINIDAD,estado nutricional en menores de 5 anos,clasificacion e,2002-02-01,1,0,1,0,1
50801,TUPIZA,estado nutricional en menores de 5 anos,clasificacion e,2002-02-01,10,33,10,33,43
40402,TURCO,estado nutricional en menores de 5 anos,clasificacion e,2002-02-01,0,2,0,2,2
21302,UMALA,estado nutricional en menores de 5 anos,clasificacion e,2002-02-01,4,0,4,0,4
60401,URIONDO (A. CONCEPCION),estado nutricional en menores de 5 anos,clasificacion e,2002-02-01,1,9,1,9,10
71502,URUBICHA,estado nutricional en menores de 5 anos,clasificacion e,2002-02-01,9,78,9,78,87
51201,UYUNI,estado nutricional en menores de 5 anos,clasificacion e,2002-02-01,0,13,0,13,13
30502,VACAS,estado nutricional en menores de 5 anos,clasificacion e,2002-02-01,0,14,0,14,14
70801,VALLEGRANDE,estado nutricional en menores de 5 anos,clasificacion e,2002-02-01,4,9,4,9,13
20801,VIACHA,estado nutricional en menores de 5 anos,clasificacion e,2002-02-01,4,22,4,22,26
31302,VILA VILA,estado nutricional en menores de 5 anos,clasificacion e,2002-02-01,2,8,2,8,10
60303,VILLA MONTES,estado nutricional en menores de 5 anos,clasificacion e,2002-02-01,7,15,7,15,22
31402,VILLA RIVERO,estado nutricional en menores de 5 anos,clasificacion e,2002-02-01,0,2,0,2,2
10801,VILLA SERRANO,estado nutricional en menores de 5 anos,clasificacion e,2002-02-01,31,49,31,49,80
31003,VILLA TUNARI,estado nutricional en menores de 5 anos,clasificacion e,2002-02-01,25,21,25,21,46
11001,VILLA VACA GUZMAN (MUYUPAMPA),estado nutricional en menores de 5 anos,clasificacion e,2002-02-01,15,33,15,33,48
51501,VILLAZON,estado nutricional en menores de 5 anos,clasificacion e,2002-02-01,0,22,0,22,22
30904,VINTO,estado nutricional en menores de 5 anos,clasificacion e,2002-02-01,12,11,12,11,23
50602,VITICHI,estado nutricional en menores de 5 anos,clasificacion e,2002-02-01,10,25,10,25,35
20306,WALDO BALLIVIAN,estado nutricional en menores de 5 anos,clasificacion e,2002-02-01,1,1,1,1,2
70201,WARNES,estado nutricional en menores de 5 anos,clasificacion e,2002-02-01,20,11,20,11,31
20903,YACO,estado nutricional en menores de 5 anos,clasificacion e,2002-02-01,0,6,0,6,6
60301,YACUIBA,estado nutricional en menores de 5 anos,clasificacion e,2002-02-01,12,7,12,7,19
10602,YAMPARAEZ,estado nutricional en menores de 5 anos,clasificacion e,2002-02-01,54,48,54,48,102
70403,YAPACANI,estado nutricional en menores de 5 anos,clasificacion e,2002-02-01,13,27,13,27,40
50103,YOCALLA,estado nutricional en menores de 5 anos,clasificacion e,2002-02-01,0,22,0,22,22
10102,YOTALA,estado nutricional en menores de 5 anos,clasificacion e,2002-02-01,19,25,19,25,44
60402,YUNCHARA,estado nutricional en menores de 5 anos,clasificacion e,2002-02-01,2,4,2,4,6
10301,ZUDAÃ‘EZ,estado nutricional en menores de 5 anos,clasificacion e,2002-02-01,33,34,33,34,67
51302,ACACIO,estado nutricional en menores de 5 anos,clasificacion e,2002-03-01,19,17,19,17,36
20201,ACHACACHI,estado nutricional en menores de 5 anos,clasificacion e,2002-03-01,11,29,11,29,40
20104,ACHOCALLA,estado nutricional en menores de 5 anos,clasificacion e,2002-03-01,3,0,3,0,3
30201,AIQUILE,estado nutricional en menores de 5 anos,clasificacion e,2002-03-01,6,13,6,13,19
31303,ALALAY,estado nutricional en menores de 5 anos,clasificacion e,2002-03-01,1,1,1,1,2
10404,ALCALA,estado nutricional en menores de 5 anos,clasificacion e,2002-03-01,11,12,11,12,23
20202,ANCORAIMES,estado nutricional en menores de 5 anos,clasificacion e,2002-03-01,26,17,26,17,43
41201,ANDAMARCA,estado nutricional en menores de 5 anos,clasificacion e,2002-03-01,6,3,6,3,9
40603,ANTEQUERA,estado nutricional en menores de 5 anos,clasificacion e,2002-03-01,0,1,0,1,1
30402,ANZALDO,estado nutricional en menores de 5 anos,clasificacion e,2002-03-01,0,21,0,21,21
20701,APOLO,estado nutricional en menores de 5 anos,clasificacion e,2002-03-01,8,6,8,6,14
51301,ARAMPAMPA,estado nutricional en menores de 5 anos,clasificacion e,2002-03-01,4,11,4,11,15
30501,ARANI,estado nutricional en menores de 5 anos,clasificacion e,2002-03-01,3,23,3,23,26
30403,ARBIETO,estado nutricional en menores de 5 anos,clasificacion e,2002-03-01,0,5,0,5,5
30601,ARQUE,estado nutricional en menores de 5 anos,clasificacion e,2002-03-01,40,40,40,40,80
71501,ASCENCION DE GUARAYOS,estado nutricional en menores de 5 anos,clasificacion e,2002-03-01,0,1,0,1,1
50802,ATOCHA,estado nutricional en menores de 5 anos,clasificacion e,2002-03-01,0,11,0,11,11
20502,AYATA,estado nutricional en menores de 5 anos,clasificacion e,2002-03-01,0,2,0,2,2
21303,AYO AYO,estado nutricional en menores de 5 anos,clasificacion e,2002-03-01,1,2,1,2,3
30301,AYOPAYA (V. DE INDEPENDENCIA),estado nutricional en menores de 5 anos,clasificacion e,2002-03-01,25,27,25,27,52
10201,AZURDUY,estado nutricional en menores de 5 anos,clasificacion e,2002-03-01,48,49,48,49,97
21203,BATALLAS,estado nutricional en menores de 5 anos,clasificacion e,2002-03-01,0,3,0,3,3
80802,BAURES,estado nutricional en menores de 5 anos,clasificacion e,2002-03-01,3,2,3,2,5
41202,BELEN DE ANDAMARCA,estado nutricional en menores de 5 anos,clasificacion e,2002-03-01,0,3,0,3,3
50104,BELEN DE URMIRI,estado nutricional en menores de 5 anos,clasificacion e,2002-03-01,0,4,0,4,4
60202,BERMEJO,estado nutricional en menores de 5 anos,clasificacion e,2002-03-01,1,8,1,8,9
50301,BETANZOS,estado nutricional en menores de 5 anos,clasificacion e,2002-03-01,49,181,49,181,230
31501,BOLIVAR,estado nutricional en menores de 5 anos,clasificacion e,2002-03-01,30,27,30,27,57
90103,BOLPEBRA,estado nutricional en menores de 5 anos,clasificacion e,2002-03-01,0,6,0,6,6
70707,BOYUIBE,estado nutricional en menores de 5 anos,clasificacion e,2002-03-01,1,3,1,3,4
70401,BUENA VISTA,estado nutricional en menores de 5 anos,clasificacion e,2002-03-01,12,10,12,10,22
70703,CABEZAS,estado nutricional en menores de 5 anos,clasificacion e,2002-03-01,0,10,0,10,10
20905,CAIROMA,estado nutricional en menores de 5 anos,clasificacion e,2002-03-01,0,19,0,19,19
51102,"CAIZA ""D""",estado nutricional en menores de 5 anos,clasificacion e,2002-03-01,17,42,17,42,59
21003,CAJUATA,estado nutricional en menores de 5 anos,clasificacion e,2002-03-01,4,1,4,1,5
20303,CALACOTO,estado nutricional en menores de 5 anos,clasificacion e,2002-03-01,1,2,1,2,3
21304,CALAMARCA,estado nutricional en menores de 5 anos,clasificacion e,2002-03-01,3,0,3,0,3
10701,CAMARGO,estado nutricional en menores de 5 anos,clasificacion e,2002-03-01,0,32,0,32,32
10901,CAMATAQUI (C. VILLA ABECIA),estado nutricional en menores de 5 anos,clasificacion e,2002-03-01,0,14,0,14,14
70706,CAMIRI,estado nutricional en menores de 5 anos,clasificacion e,2002-03-01,16,24,16,24,40
30701,CAPINOTA,estado nutricional en menores de 5 anos,clasificacion e,2002-03-01,25,49,25,49,74
20302,CAQUIAVIRI,estado nutricional en menores de 5 anos,clasificacion e,2002-03-01,10,7,10,7,17
40102,CARACOLLO,estado nutricional en menores de 5 anos,clasificacion e,2002-03-01,3,6,3,6,9
22001,CARANAVI,estado nutricional en menores de 5 anos,clasificacion e,2002-03-01,29,41,29,41,70
60302,CARAPARI,estado nutricional en menores de 5 anos,clasificacion e,2002-03-01,10,13,10,13,23
50702,CARIPUYO,estado nutricional en menores de 5 anos,clasificacion e,2002-03-01,5,38,5,38,43
21902,CATACORA,estado nutricional en menores de 5 anos,clasificacion e,2002-03-01,2,0,2,0,2
40201,CHALLAPATA,estado nutricional en menores de 5 anos,clasificacion e,2002-03-01,16,11,16,11,27
50302,CHAQUI,estado nutricional en menores de 5 anos,clasificacion e,2002-03-01,1,29,1,29,30
70702,CHARAGUA,estado nutricional en menores de 5 anos,clasificacion e,2002-03-01,1,62,1,62,63
20305,CHARAÃ‘A,estado nutricional en menores de 5 anos,clasificacion e,2002-03-01,0,3,0,3,3
31204,CHIMORE,estado nutricional en menores de 5 anos,clasificacion e,2002-03-01,2,2,2,2,4
40903,CHIPAYA,estado nutricional en menores de 5 anos,clasificacion e,2002-03-01,0,1,0,1,1
20501,CHUMA,estado nutricional en menores de 5 anos,clasificacion e,2002-03-01,6,2,6,2,8
30801,CLIZA,estado nutricional en menores de 5 anos,clasificacion e,2002-03-01,4,9,4,9,13
90101,COBIJA,estado nutricional en menores de 5 anos,clasificacion e,2002-03-01,14,11,14,11,25
30101,COCHABAMBA,estado nutricional en menores de 5 anos,clasificacion e,2002-03-01,43,94,43,94,137
40902,COIPASA,estado nutricional en menores de 5 anos,clasificacion e,2002-03-01,0,1,0,1,1
30905,COLCAPIRHUA,estado nutricional en menores de 5 anos,clasificacion e,2002-03-01,8,3,8,3,11
50901,"COLCHA ""K""",estado nutricional en menores de 5 anos,clasificacion e,2002-03-01,1,15,1,15,16
31002,COLOMI,estado nutricional en menores de 5 anos,clasificacion e,2002-03-01,21,10,21,10,31
50401,COLQUECHACA,estado nutricional en menores de 5 anos,clasificacion e,2002-03-01,32,27,32,27,59
21306,COLQUENCHA,estado nutricional en menores de 5 anos,clasificacion e,2002-03-01,9,0,9,0,9
21004,COLQUIRI,estado nutricional en menores de 5 anos,clasificacion e,2002-03-01,18,11,18,11,29
20304,COMANCHE,estado nutricional en menores de 5 anos,clasificacion e,2002-03-01,1,1,1,1,2
71301,COMARAPA,estado nutricional en menores de 5 anos,clasificacion e,2002-03-01,5,12,5,12,17
20605,COMBAYA,estado nutricional en menores de 5 anos,clasificacion e,2002-03-01,3,11,3,11,14
21701,COPACABANA,estado nutricional en menores de 5 anos,clasificacion e,2002-03-01,2,3,2,3,5
21402,CORIPATA,estado nutricional en menores de 5 anos,clasificacion e,2002-03-01,2,1,2,1,3
20301,CORO CORO,estado nutricional en menores de 5 anos,clasificacion e,2002-03-01,4,8,4,8,12
21401,COROICO,estado nutricional en menores de 5 anos,clasificacion e,2002-03-01,7,3,7,3,10
40301,CORQUE,estado nutricional en menores de 5 anos,clasificacion e,2002-03-01,4,11,4,11,15
50601,COTAGAITA,estado nutricional en menores de 5 anos,clasificacion e,2002-03-01,18,52,18,52,70
70102,COTOCA,estado nutricional en menores de 5 anos,clasificacion e,2002-03-01,15,9,15,9,24
31405,CUCHUMUELA (V. G. VILLARROEL),estado nutricional en menores de 5 anos,clasificacion e,2002-03-01,0,2,0,2,2
70704,CUEVO,estado nutricional en menores de 5 anos,clasificacion e,2002-03-01,9,2,9,2,11
10902,CULPINA,estado nutricional en menores de 5 anos,clasificacion e,2002-03-01,17,73,17,73,90
40401,CURAHUARA DE CARANGAS,estado nutricional en menores de 5 anos,clasificacion e,2002-03-01,3,0,3,0,3
20804,DESAGUADERO,estado nutricional en menores de 5 anos,clasificacion e,2002-03-01,0,9,0,9,9
20105,EL ALTO,estado nutricional en menores de 5 anos,clasificacion e,2002-03-01,355,241,355,241,596
40103,EL CHORO,estado nutricional en menores de 5 anos,clasificacion e,2002-03-01,0,1,0,1,1
71503,EL PUENTE(STC),estado nutricional en menores de 5 anos,clasificacion e,2002-03-01,1,24,1,24,25
60502,EL PUENTE(TJA),estado nutricional en menores de 5 anos,clasificacion e,2002-03-01,0,7,0,7,7
70105,EL TORNO,estado nutricional en menores de 5 anos,clasificacion e,2002-03-01,25,13,25,13,38
10405,EL VILLAR,estado nutricional en menores de 5 anos,clasificacion e,2002-03-01,19,28,19,28,47
60601,ENTRE RIOS,estado nutricional en menores de 5 anos,clasificacion e,2002-03-01,8,7,8,7,15
41101,EUCALIPTUS,estado nutricional en menores de 5 anos,clasificacion e,2002-03-01,0,3,0,3,3
80402,EXALTACION,estado nutricional en menores de 5 anos,clasificacion e,2002-03-01,0,14,0,14,14
90203,FILADELFIA,estado nutricional en menores de 5 anos,clasificacion e,2002-03-01,0,8,0,8,8
71002,GENERAL SAAVEDRA,estado nutricional en menores de 5 anos,clasificacion e,2002-03-01,17,27,17,27,44
21601,GRAL. J.J. PEREZ (CHARAZANI),estado nutricional en menores de 5 anos,clasificacion e,2002-03-01,5,0,5,0,5
20602,GUANAY,estado nutricional en menores de 5 anos,clasificacion e,2002-03-01,1,22,1,22,23
20802,GUAQUI,estado nutricional en menores de 5 anos,clasificacion e,2002-03-01,0,1,0,1,1
80202,GUAYARAMERIN,estado nutricional en menores de 5 anos,clasificacion e,2002-03-01,24,11,24,11,35
70705,GUTIERREZ,estado nutricional en menores de 5 anos,clasificacion e,2002-03-01,17,72,17,72,89
10502,HUACARETA,estado nutricional en menores de 5 anos,clasificacion e,2002-03-01,32,21,32,21,53
11002,HUACAYA (VILLA DE HUACAYA),estado nutricional en menores de 5 anos,clasificacion e,2002-03-01,4,9,4,9,13
40501,HUACHACALLA,estado nutricional en menores de 5 anos,clasificacion e,2002-03-01,0,1,0,1,1
80803,HUARACAJE,estado nutricional en menores de 5 anos,clasificacion e,2002-03-01,4,0,4,0,4
41601,HUAYLLAMARCA,estado nutricional en menores de 5 anos,clasificacion e,2002-03-01,0,1,0,1,1
21005,ICHOCA,estado nutricional en menores de 5 anos,clasificacion e,2002-03-01,3,2,3,2,5
10304,ICLA,estado nutricional en menores de 5 anos,clasificacion e,2002-03-01,43,76,43,76,119
10703,INCAHUASI,estado nutricional en menores de 5 anos,clasificacion e,2002-03-01,2,90,2,90,92
21001,INQUISIVI,estado nutricional en menores de 5 anos,clasificacion e,2002-03-01,1,24,1,24,25
21102,IRUPANA (VILLA DE LANZA),estado nutricional en menores de 5 anos,clasificacion e,2002-03-01,0,4,0,4,4
21501,IXIAMAS,estado nutricional en menores de 5 anos,clasificacion e,2002-03-01,13,6,13,6,19
21105,LA ASUNTA,estado nutricional en menores de 5 anos,clasificacion e,2002-03-01,11,12,11,12,23
70104,LA GUARDIA,estado nutricional en menores de 5 anos,clasificacion e,2002-03-01,27,10,27,10,37
20101,LA PAZ,estado nutricional en menores de 5 anos,clasificacion e,2002-03-01,199,172,199,172,371
70701,LAGUNILLAS,estado nutricional en menores de 5 anos,clasificacion e,2002-03-01,1,28,1,28,29
21202,LAJA,estado nutricional en menores de 5 anos,clasificacion e,2002-03-01,0,8,0,8,8
10903,LAS CARRERAS,estado nutricional en menores de 5 anos,clasificacion e,2002-03-01,5,10,5,10,15
21006,LICOMA PAMPA,estado nutricional en menores de 5 anos,clasificacion e,2002-03-01,0,2,0,2,2
51401,LLICA,estado nutricional en menores de 5 anos,clasificacion e,2002-03-01,0,6,0,6,6
80601,LORETO,estado nutricional en menores de 5 anos,clasificacion e,2002-03-01,0,2,0,2,2
20901,LURIBAY,estado nutricional en menores de 5 anos,clasificacion e,2002-03-01,0,9,0,9,9
40702,MACHACAMARCA,estado nutricional en menores de 5 anos,clasificacion e,2002-03-01,4,2,4,2,6
11003,MACHARETI,estado nutricional en menores de 5 anos,clasificacion e,2002-03-01,20,21,20,21,41
80801,MAGDALENA,estado nutricional en menores de 5 anos,clasificacion e,2002-03-01,1,2,1,2,3
70903,MAIRANA,estado nutricional en menores de 5 anos,clasificacion e,2002-03-01,1,3,1,3,4
20103,MECAPACA,estado nutricional en menores de 5 anos,clasificacion e,2002-03-01,3,3,3,3,6
71003,MINEROS,estado nutricional en menores de 5 anos,clasificacion e,2002-03-01,22,34,22,34,56
31301,MIZQUE,estado nutricional en menores de 5 anos,clasificacion e,2002-03-01,0,15,0,15,15
20402,MOCOMOCO,estado nutricional en menores de 5 anos,clasificacion e,2002-03-01,7,10,7,10,17
51002,MOJINETE,estado nutricional en menores de 5 anos,clasificacion e,2002-03-01,0,3,0,3,3
10303,MOJOCOYA,estado nutricional en menores de 5 anos,clasificacion e,2002-03-01,28,16,28,16,44
10501,MONTEAGUDO,estado nutricional en menores de 5 anos,clasificacion e,2002-03-01,44,49,44,49,93
71001,MONTERO,estado nutricional en menores de 5 anos,clasificacion e,2002-03-01,6,124,6,124,130
70803,MORO MORO,estado nutricional en menores de 5 anos,clasificacion e,2002-03-01,4,2,4,2,6
30302,MOROCHATA,estado nutricional en menores de 5 anos,clasificacion e,2002-03-01,18,32,18,32,50
90401,NACEBE (SANTA ROSA DEL ABUNA),estado nutricional en menores de 5 anos,clasificacion e,2002-03-01,0,7,0,7,7
50404,OCURI,estado nutricional en menores de 5 anos,clasificacion e,2002-03-01,28,23,28,23,51
70202,OKINAWA,estado nutricional en menores de 5 anos,clasificacion e,2002-03-01,1,4,1,4,5
30203,OMEREQUE,estado nutricional en menores de 5 anos,clasificacion e,2002-03-01,0,1,0,1,1
40101,ORURO,estado nutricional en menores de 5 anos,clasificacion e,2002-03-01,60,74,60,74,134
60201,PADCAYA,estado nutricional en menores de 5 anos,clasificacion e,2002-03-01,11,13,11,13,24
10401,PADILLA,estado nutricional en menores de 5 anos,clasificacion e,2002-03-01,43,63,43,63,106
70502,PAILON,estado nutricional en menores de 5 anos,clasificacion e,2002-03-01,1,14,1,14,15
20102,PALCA,estado nutricional en menores de 5 anos,clasificacion e,2002-03-01,11,16,11,16,27
21104,PALOS BLANCOS,estado nutricional en menores de 5 anos,clasificacion e,2002-03-01,18,21,18,21,39
40802,PAMPA AULLAGAS,estado nutricional en menores de 5 anos,clasificacion e,2002-03-01,3,3,3,3,6
70902,PAMPA GRANDE,estado nutricional en menores de 5 anos,clasificacion e,2002-03-01,6,3,6,3,9
21802,PAPEL PAMPA,estado nutricional en menores de 5 anos,clasificacion e,2002-03-01,1,5,1,5,6
30202,PASORAPA,estado nutricional en menores de 5 anos,clasificacion e,2002-03-01,6,14,6,14,20
21305,PATACAMAYA,estado nutricional en menores de 5 anos,clasificacion e,2002-03-01,7,3,7,3,10
40602,PAZÃ‘A,estado nutricional en menores de 5 anos,clasificacion e,2002-03-01,1,5,1,5,6
20702,PELECHUCO,estado nutricional en menores de 5 anos,clasificacion e,2002-03-01,4,0,4,0,4
50403,POCOATA,estado nutricional en menores de 5 anos,clasificacion e,2002-03-01,35,45,35,45,80
31203,POCONA,estado nutricional en menores de 5 anos,clasificacion e,2002-03-01,12,24,12,24,36
31202,POJO (CBBA),estado nutricional en menores de 5 anos,clasificacion e,2002-03-01,3,24,3,24,27
40601,POOPO,estado nutricional en menores de 5 anos,clasificacion e,2002-03-01,0,37,0,37,37
51203,PORCO,estado nutricional en menores de 5 anos,clasificacion e,2002-03-01,13,6,13,6,19
10103,POROMA,estado nutricional en menores de 5 anos,clasificacion e,2002-03-01,42,34,42,34,76
70103,PORONGO,estado nutricional en menores de 5 anos,clasificacion e,2002-03-01,3,1,3,1,4
70601,PORTACHUELO,estado nutricional en menores de 5 anos,clasificacion e,2002-03-01,14,6,14,6,20
90102,PORVENIR,estado nutricional en menores de 5 anos,clasificacion e,2002-03-01,0,1,0,1,1
70804,POSTRER VALLE,estado nutricional en menores de 5 anos,clasificacion e,2002-03-01,1,2,1,2,3
50101,POTOSI,estado nutricional en menores de 5 anos,clasificacion e,2002-03-01,55,89,55,89,144
10302,PRESTO,estado nutricional en menores de 5 anos,clasificacion e,2002-03-01,25,25,25,25,50
70805,PUCARA,estado nutricional en menores de 5 anos,clasificacion e,2002-03-01,0,1,0,1,1
21201,PUCARANI,estado nutricional en menores de 5 anos,clasificacion e,2002-03-01,0,15,0,15,15
20401,PUERTO ACOSTA,estado nutricional en menores de 5 anos,clasificacion e,2002-03-01,5,7,5,7,12
20403,PUERTO CARABUCO,estado nutricional en menores de 5 anos,clasificacion e,2002-03-01,7,15,7,15,22
90301,PUERTO GONZALO MORENO,estado nutricional en menores de 5 anos,clasificacion e,2002-03-01,7,1,7,1,8
21204,PUERTO PEREZ,estado nutricional en menores de 5 anos,clasificacion e,2002-03-01,0,3,0,3,3
71402,PUERTO QUIJARRO,estado nutricional en menores de 5 anos,clasificacion e,2002-03-01,16,1,16,1,17
90201,PUERTO RICO,estado nutricional en menores de 5 anos,clasificacion e,2002-03-01,1,3,1,3,4
80703,PUERTO SILES,estado nutricional en menores de 5 anos,clasificacion e,2002-03-01,0,1,0,1,1
71401,PUERTO SUAREZ,estado nutricional en menores de 5 anos,clasificacion e,2002-03-01,19,10,19,10,29
31205,PUERTO VILLARROEL,estado nutricional en menores de 5 anos,clasificacion e,2002-03-01,40,19,40,19,59
51101,PUNA,estado nutricional en menores de 5 anos,clasificacion e,2002-03-01,6,113,6,113,119
31401,PUNATA,estado nutricional en menores de 5 anos,clasificacion e,2002-03-01,8,13,8,13,21
20604,QUIABAYA,estado nutricional en menores de 5 anos,clasificacion e,2002-03-01,0,11,0,11,11
30901,QUILLACOLLO,estado nutricional en menores de 5 anos,clasificacion e,2002-03-01,15,3,15,3,18
21002,QUIME,estado nutricional en menores de 5 anos,clasificacion e,2002-03-01,2,13,2,13,15
50402,RAVELO,estado nutricional en menores de 5 anos,clasificacion e,2002-03-01,57,87,57,87,144
80301,REYES,estado nutricional en menores de 5 anos,clasificacion e,2002-03-01,5,10,5,10,15
80201,RIBERALTA,estado nutricional en menores de 5 anos,clasificacion e,2002-03-01,113,75,113,75,188
70503,ROBORE,estado nutricional en menores de 5 anos,clasificacion e,2002-03-01,0,22,0,22,22
80304,RURRENABAQUE,estado nutricional en menores de 5 anos,clasificacion e,2002-03-01,6,4,6,4,10
31001,SACABA,estado nutricional en menores de 5 anos,clasificacion e,2002-03-01,24,59,24,59,83
30404,SACABAMBA,estado nutricional en menores de 5 anos,clasificacion e,2002-03-01,0,12,0,12,12
50701,SACACA,estado nutricional en menores de 5 anos,clasificacion e,2002-03-01,59,114,59,114,173
71302,SAIPINA,estado nutricional en menores de 5 anos,clasificacion e,2002-03-01,8,6,8,6,14
40801,SALINAS DE GARCI MENDOZA,estado nutricional en menores de 5 anos,clasificacion e,2002-03-01,4,2,4,2,6
70901,SAMAIPATA,estado nutricional en menores de 5 anos,clasificacion e,2002-03-01,0,3,0,3,3
51601,SAN AGUSTIN,estado nutricional en menores de 5 anos,clasificacion e,2002-03-01,0,2,0,2,2
80602,SAN ANDRES,estado nutricional en menores de 5 anos,clasificacion e,2002-03-01,4,3,4,3,7
51003,SAN ANTONIO DE ESMORUCO,estado nutricional en menores de 5 anos,clasificacion e,2002-03-01,0,4,0,4,4
71105,SAN ANTONIO DE LOMERIO,estado nutricional en menores de 5 anos,clasificacion e,2002-03-01,50,58,50,58,108
31403,SAN BENITO,estado nutricional en menores de 5 anos,clasificacion e,2002-03-01,0,7,0,7,7
80302,SAN BORJA,estado nutricional en menores de 5 anos,clasificacion e,2002-03-01,19,20,19,20,39
21502,SAN BUENA VENTURA,estado nutricional en menores de 5 anos,clasificacion e,2002-03-01,20,4,20,4,24
70402,SAN CARLOS,estado nutricional en menores de 5 anos,clasificacion e,2002-03-01,0,11,0,11,11
80501,SAN IGNACIO,estado nutricional en menores de 5 anos,clasificacion e,2002-03-01,14,27,14,27,41
70301,SAN IGNACIO DE VELASCO,estado nutricional en menores de 5 anos,clasificacion e,2002-03-01,51,46,51,46,97
80102,SAN JAVIER(BNI),estado nutricional en menores de 5 anos,clasificacion e,2002-03-01,6,1,6,1,7
71102,SAN JAVIER(STC),estado nutricional en menores de 5 anos,clasificacion e,2002-03-01,0,11,0,11,11
80701,SAN JOAQUIN,estado nutricional en menores de 5 anos,clasificacion e,2002-03-01,0,3,0,3,3
70501,SAN JOSE DE CHIQUITOS,estado nutricional en menores de 5 anos,clasificacion e,2002-03-01,24,5,24,5,29
71104,SAN JULIAN,estado nutricional en menores de 5 anos,clasificacion e,2002-03-01,29,44,29,44,73
60501,SAN LORENZO(TJA),estado nutricional en menores de 5 anos,clasificacion e,2002-03-01,8,6,8,6,14
10702,SAN LUCAS,estado nutricional en menores de 5 anos,clasificacion e,2002-03-01,11,218,11,218,229
71201,SAN MATIAS,estado nutricional en menores de 5 anos,clasificacion e,2002-03-01,29,22,29,22,51
70302,SAN MIGUEL DE VELASCO,estado nutricional en menores de 5 anos,clasificacion e,2002-03-01,26,27,26,27,53
51001,SAN PABLO DE LIPEZ,estado nutricional en menores de 5 anos,clasificacion e,2002-03-01,1,10,1,10,11
50501,SAN PEDRO DE BUENA VISTA,estado nutricional en menores de 5 anos,clasificacion e,2002-03-01,1,85,1,85,86
21801,SAN PEDRO DE CURAHUARA,estado nutricional en menores de 5 anos,clasificacion e,2002-03-01,0,5,0,5,5
70303,SAN RAFAEL,estado nutricional en menores de 5 anos,clasificacion e,2002-03-01,9,8,9,8,17
80702,SAN RAMON,estado nutricional en menores de 5 anos,clasificacion e,2002-03-01,0,7,0,7,7
80702,SAN RAMON,estado nutricional en menores de 5 anos,clasificacion e,2002-03-01,2,0,2,0,2
80401,SANTA ANA,estado nutricional en menores de 5 anos,clasificacion e,2002-03-01,1,7,1,7,8
70101,SANTA CRUZ DE LA SIERRA,estado nutricional en menores de 5 anos,clasificacion e,2002-03-01,55,95,55,95,150
80303,SANTA ROSA,estado nutricional en menores de 5 anos,clasificacion e,2002-03-01,4,1,4,1,5
70602,SANTA ROSA DEL SARA,estado nutricional en menores de 5 anos,clasificacion e,2002-03-01,3,2,3,2,5
20308,SANTIAGO DE CALLAPA,estado nutricional en menores de 5 anos,clasificacion e,2002-03-01,0,2,0,2,2
41401,SANTIAGO DE HUARI,estado nutricional en menores de 5 anos,clasificacion e,2002-03-01,4,10,4,10,14
21901,SANTIAGO DE MACHACA,estado nutricional en menores de 5 anos,clasificacion e,2002-03-01,0,1,0,1,1
30702,SANTIVAÃ‘ES,estado nutricional en menores de 5 anos,clasificacion e,2002-03-01,9,12,9,12,21
40202,SANTUARIO DE QUILLACAS,estado nutricional en menores de 5 anos,clasificacion e,2002-03-01,2,5,2,5,7
20902,SAPAHAQUI,estado nutricional en menores de 5 anos,clasificacion e,2002-03-01,0,7,0,7,7
21301,SICA SICA (VILLA AROMA),estado nutricional en menores de 5 anos,clasificacion e,2002-03-01,9,5,9,5,14
30703,SICAYA,estado nutricional en menores de 5 anos,clasificacion e,2002-03-01,0,8,0,8,8
30902,SIPE SIPE,estado nutricional en menores de 5 anos,clasificacion e,2002-03-01,27,27,27,27,54
10403,SOPACHUY,estado nutricional en menores de 5 anos,clasificacion e,2002-03-01,28,26,28,26,54
20601,SORATA,estado nutricional en menores de 5 anos,clasificacion e,2002-03-01,2,4,2,4,6
10101,SUCRE,estado nutricional en menores de 5 anos,clasificacion e,2002-03-01,57,248,57,248,305
31404,TACACHI,estado nutricional en menores de 5 anos,clasificacion e,2002-03-01,1,5,1,5,6
20603,TACACOMA,estado nutricional en menores de 5 anos,clasificacion e,2002-03-01,3,7,3,7,10
50303,TACOBAMBA,estado nutricional en menores de 5 anos,clasificacion e,2002-03-01,14,16,14,16,30
30602,TACOPAYA,estado nutricional en menores de 5 anos,clasificacion e,2002-03-01,0,23,0,23,23
51402,TAHUA,estado nutricional en menores de 5 anos,clasificacion e,2002-03-01,0,2,0,2,2
31101,TAPACARI,estado nutricional en menores de 5 anos,clasificacion e,2002-03-01,1,43,1,43,44
10601,TARABUCO,estado nutricional en menores de 5 anos,clasificacion e,2002-03-01,33,233,33,233,266
30401,TARATA,estado nutricional en menores de 5 anos,clasificacion e,2002-03-01,1,11,1,11,12
60101,TARIJA,estado nutricional en menores de 5 anos,clasificacion e,2002-03-01,15,45,15,45,60
10202,TARVITA,estado nutricional en menores de 5 anos,clasificacion e,2002-03-01,24,13,24,13,37
20803,TIAWANACU,estado nutricional en menores de 5 anos,clasificacion e,2002-03-01,1,2,1,2,3
50102,TINGUIPAYA,estado nutricional en menores de 5 anos,clasificacion e,2002-03-01,2,35,2,35,37
20606,TIPUANI,estado nutricional en menores de 5 anos,clasificacion e,2002-03-01,4,1,4,1,5
30903,TIQUIPAYA,estado nutricional en menores de 5 anos,clasificacion e,2002-03-01,0,13,0,13,13
31601,TIRAQUE (CBBA),estado nutricional en menores de 5 anos,clasificacion e,2002-03-01,12,46,12,46,58
21703,TITO YUPANQUI (PARQUIPUJIO),estado nutricional en menores de 5 anos,clasificacion e,2002-03-01,0,7,0,7,7
30802,TOCO,estado nutricional en menores de 5 anos,clasificacion e,2002-03-01,0,7,0,7,7
41001,TOLEDO,estado nutricional en menores de 5 anos,clasificacion e,2002-03-01,0,2,0,2,2
51202,TOMAVE,estado nutricional en menores de 5 anos,clasificacion e,2002-03-01,0,46,0,46,46
10402,TOMINA,estado nutricional en menores de 5 anos,clasificacion e,2002-03-01,46,46,46,46,92
50502,TORO TORO,estado nutricional en menores de 5 anos,clasificacion e,2002-03-01,3,12,3,12,15
31201,TOTORA(CBBA),estado nutricional en menores de 5 anos,clasificacion e,2002-03-01,29,16,29,16,45
41301,TOTORA(ORR),estado nutricional en menores de 5 anos,clasificacion e,2002-03-01,0,7,0,7,7
70802,TRIGAL,estado nutricional en menores de 5 anos,clasificacion e,2002-03-01,0,2,0,2,2
80101,TRINIDAD,estado nutricional en menores de 5 anos,clasificacion e,2002-03-01,13,56,13,56,69
50801,TUPIZA,estado nutricional en menores de 5 anos,clasificacion e,2002-03-01,7,94,7,94,101
40402,TURCO,estado nutricional en menores de 5 anos,clasificacion e,2002-03-01,2,0,2,0,2
21302,UMALA,estado nutricional en menores de 5 anos,clasificacion e,2002-03-01,0,3,0,3,3
60401,URIONDO (A. CONCEPCION),estado nutricional en menores de 5 anos,clasificacion e,2002-03-01,1,5,1,5,6
71502,URUBICHA,estado nutricional en menores de 5 anos,clasificacion e,2002-03-01,0,8,0,8,8
51201,UYUNI,estado nutricional en menores de 5 anos,clasificacion e,2002-03-01,1,34,1,34,35
30502,VACAS,estado nutricional en menores de 5 anos,clasificacion e,2002-03-01,0,4,0,4,4
70801,VALLEGRANDE,estado nutricional en menores de 5 anos,clasificacion e,2002-03-01,12,3,12,3,15
20801,VIACHA,estado nutricional en menores de 5 anos,clasificacion e,2002-03-01,2,27,2,27,29
31302,VILA VILA,estado nutricional en menores de 5 anos,clasificacion e,2002-03-01,2,9,2,9,11
60303,VILLA MONTES,estado nutricional en menores de 5 anos,clasificacion e,2002-03-01,10,18,10,18,28
31402,VILLA RIVERO,estado nutricional en menores de 5 anos,clasificacion e,2002-03-01,0,4,0,4,4
10801,VILLA SERRANO,estado nutricional en menores de 5 anos,clasificacion e,2002-03-01,31,42,31,42,73
31003,VILLA TUNARI,estado nutricional en menores de 5 anos,clasificacion e,2002-03-01,28,31,28,31,59
11001,VILLA VACA GUZMAN (MUYUPAMPA),estado nutricional en menores de 5 anos,clasificacion e,2002-03-01,21,4,21,4,25
51501,VILLAZON,estado nutricional en menores de 5 anos,clasificacion e,2002-03-01,2,49,2,49,51
30904,VINTO,estado nutricional en menores de 5 anos,clasificacion e,2002-03-01,11,5,11,5,16
50602,VITICHI,estado nutricional en menores de 5 anos,clasificacion e,2002-03-01,8,25,8,25,33
70201,WARNES,estado nutricional en menores de 5 anos,clasificacion e,2002-03-01,22,26,22,26,48
20903,YACO,estado nutricional en menores de 5 anos,clasificacion e,2002-03-01,0,14,0,14,14
60301,YACUIBA,estado nutricional en menores de 5 anos,clasificacion e,2002-03-01,10,18,10,18,28
10602,YAMPARAEZ,estado nutricional en menores de 5 anos,clasificacion e,2002-03-01,42,49,42,49,91
70403,YAPACANI,estado nutricional en menores de 5 anos,clasificacion e,2002-03-01,20,21,20,21,41
50103,YOCALLA,estado nutricional en menores de 5 anos,clasificacion e,2002-03-01,0,12,0,12,12
10102,YOTALA,estado nutricional en menores de 5 anos,clasificacion e,2002-03-01,34,38,34,38,72
60402,YUNCHARA,estado nutricional en menores de 5 anos,clasificacion e,2002-03-01,2,11,2,11,13
10301,ZUDAÃ‘EZ,estado nutricional en menores de 5 anos,clasificacion e,2002-03-01,54,52,54,52,106
51302,ACACIO,estado nutricional en menores de 5 anos,clasificacion e,2002-04-01,9,35,9,35,44
20201,ACHACACHI,estado nutricional en menores de 5 anos,clasificacion e,2002-04-01,26,27,26,27,53
20104,ACHOCALLA,estado nutricional en menores de 5 anos,clasificacion e,2002-04-01,6,1,6,1,7
30201,AIQUILE,estado nutricional en menores de 5 anos,clasificacion e,2002-04-01,6,8,6,8,14
31303,ALALAY,estado nutricional en menores de 5 anos,clasificacion e,2002-04-01,1,1,1,1,2
10404,ALCALA,estado nutricional en menores de 5 anos,clasificacion e,2002-04-01,14,15,14,15,29
20202,ANCORAIMES,estado nutricional en menores de 5 anos,clasificacion e,2002-04-01,19,17,19,17,36
41201,ANDAMARCA,estado nutricional en menores de 5 anos,clasificacion e,2002-04-01,1,0,1,0,1
30402,ANZALDO,estado nutricional en menores de 5 anos,clasificacion e,2002-04-01,1,41,1,41,42
20701,APOLO,estado nutricional en menores de 5 anos,clasificacion e,2002-04-01,9,5,9,5,14
51301,ARAMPAMPA,estado nutricional en menores de 5 anos,clasificacion e,2002-04-01,12,32,12,32,44
30501,ARANI,estado nutricional en menores de 5 anos,clasificacion e,2002-04-01,6,10,6,10,16
30403,ARBIETO,estado nutricional en menores de 5 anos,clasificacion e,2002-04-01,1,16,1,16,17
30601,ARQUE,estado nutricional en menores de 5 anos,clasificacion e,2002-04-01,4,9,4,9,13
71501,ASCENCION DE GUARAYOS,estado nutricional en menores de 5 anos,clasificacion e,2002-04-01,44,48,44,48,92
50802,ATOCHA,estado nutricional en menores de 5 anos,clasificacion e,2002-04-01,0,14,0,14,14
20503,AUCAPATA,estado nutricional en menores de 5 anos,clasificacion e,2002-04-01,6,0,6,0,6
20502,AYATA,estado nutricional en menores de 5 anos,clasificacion e,2002-04-01,11,12,11,12,23
21303,AYO AYO,estado nutricional en menores de 5 anos,clasificacion e,2002-04-01,4,0,4,0,4
30301,AYOPAYA (V. DE INDEPENDENCIA),estado nutricional en menores de 5 anos,clasificacion e,2002-04-01,35,13,35,13,48
10201,AZURDUY,estado nutricional en menores de 5 anos,clasificacion e,2002-04-01,46,36,46,36,82
21203,BATALLAS,estado nutricional en menores de 5 anos,clasificacion e,2002-04-01,1,4,1,4,5
80802,BAURES,estado nutricional en menores de 5 anos,clasificacion e,2002-04-01,4,5,4,5,9
41202,BELEN DE ANDAMARCA,estado nutricional en menores de 5 anos,clasificacion e,2002-04-01,0,2,0,2,2
50104,BELEN DE URMIRI,estado nutricional en menores de 5 anos,clasificacion e,2002-04-01,0,2,0,2,2
60202,BERMEJO,estado nutricional en menores de 5 anos,clasificacion e,2002-04-01,5,2,5,2,7
50301,BETANZOS,estado nutricional en menores de 5 anos,clasificacion e,2002-04-01,46,98,46,98,144
31501,BOLIVAR,estado nutricional en menores de 5 anos,clasificacion e,2002-04-01,16,25,16,25,41
90103,BOLPEBRA,estado nutricional en menores de 5 anos,clasificacion e,2002-04-01,1,0,1,0,1
70707,BOYUIBE,estado nutricional en menores de 5 anos,clasificacion e,2002-04-01,0,1,0,1,1
70401,BUENA VISTA,estado nutricional en menores de 5 anos,clasificacion e,2002-04-01,9,8,9,8,17
70703,CABEZAS,estado nutricional en menores de 5 anos,clasificacion e,2002-04-01,0,6,0,6,6
20905,CAIROMA,estado nutricional en menores de 5 anos,clasificacion e,2002-04-01,0,6,0,6,6
51102,"CAIZA ""D""",estado nutricional en menores de 5 anos,clasificacion e,2002-04-01,15,22,15,22,37
21003,CAJUATA,estado nutricional en menores de 5 anos,clasificacion e,2002-04-01,6,3,6,3,9
20303,CALACOTO,estado nutricional en menores de 5 anos,clasificacion e,2002-04-01,0,1,0,1,1
21304,CALAMARCA,estado nutricional en menores de 5 anos,clasificacion e,2002-04-01,3,3,3,3,6
10701,CAMARGO,estado nutricional en menores de 5 anos,clasificacion e,2002-04-01,0,23,0,23,23
10901,CAMATAQUI (C. VILLA ABECIA),estado nutricional en menores de 5 anos,clasificacion e,2002-04-01,0,16,0,16,16
70706,CAMIRI,estado nutricional en menores de 5 anos,clasificacion e,2002-04-01,39,42,39,42,81
30701,CAPINOTA,estado nutricional en menores de 5 anos,clasificacion e,2002-04-01,11,10,11,10,21
20302,CAQUIAVIRI,estado nutricional en menores de 5 anos,clasificacion e,2002-04-01,4,16,4,16,20
40102,CARACOLLO,estado nutricional en menores de 5 anos,clasificacion e,2002-04-01,3,12,3,12,15
22001,CARANAVI,estado nutricional en menores de 5 anos,clasificacion e,2002-04-01,28,52,28,52,80
60302,CARAPARI,estado nutricional en menores de 5 anos,clasificacion e,2002-04-01,13,9,13,9,22
50702,CARIPUYO,estado nutricional en menores de 5 anos,clasificacion e,2002-04-01,0,41,0,41,41
21902,CATACORA,estado nutricional en menores de 5 anos,clasificacion e,2002-04-01,3,2,3,2,5
40201,CHALLAPATA,estado nutricional en menores de 5 anos,clasificacion e,2002-04-01,17,23,17,23,40
50302,CHAQUI,estado nutricional en menores de 5 anos,clasificacion e,2002-04-01,0,28,0,28,28
70702,CHARAGUA,estado nutricional en menores de 5 anos,clasificacion e,2002-04-01,4,67,4,67,71
20305,CHARAÃ‘A,estado nutricional en menores de 5 anos,clasificacion e,2002-04-01,0,10,0,10,10
31204,CHIMORE,estado nutricional en menores de 5 anos,clasificacion e,2002-04-01,8,8,8,8,16
40302,CHOQUE COTA,estado nutricional en menores de 5 anos,clasificacion e,2002-04-01,0,2,0,2,2
21101,CHULUMANI (V. DE LA LIBERTAD),estado nutricional en menores de 5 anos,clasificacion e,2002-04-01,3,2,3,2,5
20501,CHUMA,estado nutricional en menores de 5 anos,clasificacion e,2002-04-01,2,4,2,4,6
30801,CLIZA,estado nutricional en menores de 5 anos,clasificacion e,2002-04-01,5,8,5,8,13
90101,COBIJA,estado nutricional en menores de 5 anos,clasificacion e,2002-04-01,34,24,34,24,58
30101,COCHABAMBA,estado nutricional en menores de 5 anos,clasificacion e,2002-04-01,67,89,67,89,156
30905,COLCAPIRHUA,estado nutricional en menores de 5 anos,clasificacion e,2002-04-01,12,7,12,7,19
50901,"COLCHA ""K""",estado nutricional en menores de 5 anos,clasificacion e,2002-04-01,0,8,0,8,8
31002,COLOMI,estado nutricional en menores de 5 anos,clasificacion e,2002-04-01,14,25,14,25,39
50401,COLQUECHACA,estado nutricional en menores de 5 anos,clasificacion e,2002-04-01,34,36,34,36,70
21306,COLQUENCHA,estado nutricional en menores de 5 anos,clasificacion e,2002-04-01,0,1,0,1,1
21004,COLQUIRI,estado nutricional en menores de 5 anos,clasificacion e,2002-04-01,23,8,23,8,31
20304,COMANCHE,estado nutricional en menores de 5 anos,clasificacion e,2002-04-01,5,3,5,3,8
71301,COMARAPA,estado nutricional en menores de 5 anos,clasificacion e,2002-04-01,2,10,2,10,12
20605,COMBAYA,estado nutricional en menores de 5 anos,clasificacion e,2002-04-01,2,6,2,6,8
71101,CONCEPCION,estado nutricional en menores de 5 anos,clasificacion e,2002-04-01,2,0,2,0,2
21701,COPACABANA,estado nutricional en menores de 5 anos,clasificacion e,2002-04-01,1,3,1,3,4
21402,CORIPATA,estado nutricional en menores de 5 anos,clasificacion e,2002-04-01,1,5,1,5,6
20301,CORO CORO,estado nutricional en menores de 5 anos,clasificacion e,2002-04-01,8,16,8,16,24
21401,COROICO,estado nutricional en menores de 5 anos,clasificacion e,2002-04-01,2,3,2,3,5
40301,CORQUE,estado nutricional en menores de 5 anos,clasificacion e,2002-04-01,1,2,1,2,3
50601,COTAGAITA,estado nutricional en menores de 5 anos,clasificacion e,2002-04-01,6,41,6,41,47
70102,COTOCA,estado nutricional en menores de 5 anos,clasificacion e,2002-04-01,12,5,12,5,17
31405,CUCHUMUELA (V. G. VILLARROEL),estado nutricional en menores de 5 anos,clasificacion e,2002-04-01,0,5,0,5,5
70704,CUEVO,estado nutricional en menores de 5 anos,clasificacion e,2002-04-01,6,2,6,2,8
10902,CULPINA,estado nutricional en menores de 5 anos,clasificacion e,2002-04-01,29,31,29,31,60
40401,CURAHUARA DE CARANGAS,estado nutricional en menores de 5 anos,clasificacion e,2002-04-01,5,3,5,3,8
20804,DESAGUADERO,estado nutricional en menores de 5 anos,clasificacion e,2002-04-01,0,4,0,4,4
20105,EL ALTO,estado nutricional en menores de 5 anos,clasificacion e,2002-04-01,344,330,344,330,674
40103,EL CHORO,estado nutricional en menores de 5 anos,clasificacion e,2002-04-01,1,0,1,0,1
71503,EL PUENTE(STC),estado nutricional en menores de 5 anos,clasificacion e,2002-04-01,6,34,6,34,40
60502,EL PUENTE(TJA),estado nutricional en menores de 5 anos,clasificacion e,2002-04-01,3,3,3,3,6
70105,EL TORNO,estado nutricional en menores de 5 anos,clasificacion e,2002-04-01,13,7,13,7,20
10405,EL VILLAR,estado nutricional en menores de 5 anos,clasificacion e,2002-04-01,20,37,20,37,57
60601,ENTRE RIOS,estado nutricional en menores de 5 anos,clasificacion e,2002-04-01,3,10,3,10,13
41101,EUCALIPTUS,estado nutricional en menores de 5 anos,clasificacion e,2002-04-01,0,5,0,5,5
80402,EXALTACION,estado nutricional en menores de 5 anos,clasificacion e,2002-04-01,3,6,3,6,9
90203,FILADELFIA,estado nutricional en menores de 5 anos,clasificacion e,2002-04-01,0,12,0,12,12
21601,GRAL. J.J. PEREZ (CHARAZANI),estado nutricional en menores de 5 anos,clasificacion e,2002-04-01,1,3,1,3,4
20602,GUANAY,estado nutricional en menores de 5 anos,clasificacion e,2002-04-01,5,29,5,29,34
20802,GUAQUI,estado nutricional en menores de 5 anos,clasificacion e,2002-04-01,0,3,0,3,3
80202,GUAYARAMERIN,estado nutricional en menores de 5 anos,clasificacion e,2002-04-01,24,18,24,18,42
70705,GUTIERREZ,estado nutricional en menores de 5 anos,clasificacion e,2002-04-01,9,58,9,58,67
10502,HUACARETA,estado nutricional en menores de 5 anos,clasificacion e,2002-04-01,22,18,22,18,40
11002,HUACAYA (VILLA DE HUACAYA),estado nutricional en menores de 5 anos,clasificacion e,2002-04-01,3,3,3,3,6
40501,HUACHACALLA,estado nutricional en menores de 5 anos,clasificacion e,2002-04-01,0,1,0,1,1
40701,HUANUNI,estado nutricional en menores de 5 anos,clasificacion e,2002-04-01,0,1,0,1,1
80803,HUARACAJE,estado nutricional en menores de 5 anos,clasificacion e,2002-04-01,3,0,3,0,3
41601,HUAYLLAMARCA,estado nutricional en menores de 5 anos,clasificacion e,2002-04-01,1,0,1,0,1
21005,ICHOCA,estado nutricional en menores de 5 anos,clasificacion e,2002-04-01,5,4,5,4,9
10304,ICLA,estado nutricional en menores de 5 anos,clasificacion e,2002-04-01,62,61,62,61,123
10703,INCAHUASI,estado nutricional en menores de 5 anos,clasificacion e,2002-04-01,5,75,5,75,80
21001,INQUISIVI,estado nutricional en menores de 5 anos,clasificacion e,2002-04-01,3,14,3,14,17
21102,IRUPANA (VILLA DE LANZA),estado nutricional en menores de 5 anos,clasificacion e,2002-04-01,0,7,0,7,7
21501,IXIAMAS,estado nutricional en menores de 5 anos,clasificacion e,2002-04-01,6,8,6,8,14
21105,LA ASUNTA,estado nutricional en menores de 5 anos,clasificacion e,2002-04-01,14,16,14,16,30
70104,LA GUARDIA,estado nutricional en menores de 5 anos,clasificacion e,2002-04-01,16,9,16,9,25
20101,LA PAZ,estado nutricional en menores de 5 anos,clasificacion e,2002-04-01,211,195,211,195,406
70701,LAGUNILLAS,estado nutricional en menores de 5 anos,clasificacion e,2002-04-01,11,13,11,13,24
21202,LAJA,estado nutricional en menores de 5 anos,clasificacion e,2002-04-01,0,8,0,8,8
10903,LAS CARRERAS,estado nutricional en menores de 5 anos,clasificacion e,2002-04-01,3,3,3,3,6
51401,LLICA,estado nutricional en menores de 5 anos,clasificacion e,2002-04-01,0,2,0,2,2
20901,LURIBAY,estado nutricional en menores de 5 anos,clasificacion e,2002-04-01,7,5,7,5,12
40702,MACHACAMARCA,estado nutricional en menores de 5 anos,clasificacion e,2002-04-01,2,2,2,2,4
11003,MACHARETI,estado nutricional en menores de 5 anos,clasificacion e,2002-04-01,11,26,11,26,37
80801,MAGDALENA,estado nutricional en menores de 5 anos,clasificacion e,2002-04-01,6,2,6,2,8
70903,MAIRANA,estado nutricional en menores de 5 anos,clasificacion e,2002-04-01,3,3,3,3,6
20904,MALLA,estado nutricional en menores de 5 anos,clasificacion e,2002-04-01,0,2,0,2,2
20103,MECAPACA,estado nutricional en menores de 5 anos,clasificacion e,2002-04-01,0,2,0,2,2
71003,MINEROS,estado nutricional en menores de 5 anos,clasificacion e,2002-04-01,13,0,13,0,13
31301,MIZQUE,estado nutricional en menores de 5 anos,clasificacion e,2002-04-01,5,7,5,7,12
20402,MOCOMOCO,estado nutricional en menores de 5 anos,clasificacion e,2002-04-01,6,4,6,4,10
51002,MOJINETE,estado nutricional en menores de 5 anos,clasificacion e,2002-04-01,0,1,0,1,1
10303,MOJOCOYA,estado nutricional en menores de 5 anos,clasificacion e,2002-04-01,30,20,30,20,50
10501,MONTEAGUDO,estado nutricional en menores de 5 anos,clasificacion e,2002-04-01,19,42,19,42,61
71001,MONTERO,estado nutricional en menores de 5 anos,clasificacion e,2002-04-01,0,5,0,5,5
70803,MORO MORO,estado nutricional en menores de 5 anos,clasificacion e,2002-04-01,3,6,3,6,9
30302,MOROCHATA,estado nutricional en menores de 5 anos,clasificacion e,2002-04-01,12,14,12,14,26
90401,NACEBE (SANTA ROSA DEL ABUNA),estado nutricional en menores de 5 anos,clasificacion e,2002-04-01,0,3,0,3,3
50404,OCURI,estado nutricional en menores de 5 anos,clasificacion e,2002-04-01,20,20,20,20,40
70202,OKINAWA,estado nutricional en menores de 5 anos,clasificacion e,2002-04-01,2,7,2,7,9
30203,OMEREQUE,estado nutricional en menores de 5 anos,clasificacion e,2002-04-01,0,6,0,6,6
40101,ORURO,estado nutricional en menores de 5 anos,clasificacion e,2002-04-01,87,68,87,68,155
60201,PADCAYA,estado nutricional en menores de 5 anos,clasificacion e,2002-04-01,3,15,3,15,18
10401,PADILLA,estado nutricional en menores de 5 anos,clasificacion e,2002-04-01,43,63,43,63,106
70502,PAILON,estado nutricional en menores de 5 anos,clasificacion e,2002-04-01,0,26,0,26,26
20102,PALCA,estado nutricional en menores de 5 anos,clasificacion e,2002-04-01,13,19,13,19,32
21104,PALOS BLANCOS,estado nutricional en menores de 5 anos,clasificacion e,2002-04-01,20,34,20,34,54
40802,PAMPA AULLAGAS,estado nutricional en menores de 5 anos,clasificacion e,2002-04-01,0,11,0,11,11
70902,PAMPA GRANDE,estado nutricional en menores de 5 anos,clasificacion e,2002-04-01,3,6,3,6,9
21802,PAPEL PAMPA,estado nutricional en menores de 5 anos,clasificacion e,2002-04-01,0,1,0,1,1
30202,PASORAPA,estado nutricional en menores de 5 anos,clasificacion e,2002-04-01,3,7,3,7,10
21305,PATACAMAYA,estado nutricional en menores de 5 anos,clasificacion e,2002-04-01,4,3,4,3,7
40602,PAZÃ‘A,estado nutricional en menores de 5 anos,clasificacion e,2002-04-01,0,1,0,1,1
20702,PELECHUCO,estado nutricional en menores de 5 anos,clasificacion e,2002-04-01,5,5,5,5,10
50403,POCOATA,estado nutricional en menores de 5 anos,clasificacion e,2002-04-01,29,40,29,40,69
31203,POCONA,estado nutricional en menores de 5 anos,clasificacion e,2002-04-01,14,18,14,18,32
31202,POJO (CBBA),estado nutricional en menores de 5 anos,clasificacion e,2002-04-01,27,18,27,18,45
40601,POOPO,estado nutricional en menores de 5 anos,clasificacion e,2002-04-01,0,10,0,10,10
51203,PORCO,estado nutricional en menores de 5 anos,clasificacion e,2002-04-01,5,4,5,4,9
10103,POROMA,estado nutricional en menores de 5 anos,clasificacion e,2002-04-01,23,25,23,25,48
70103,PORONGO,estado nutricional en menores de 5 anos,clasificacion e,2002-04-01,2,2,2,2,4
70601,PORTACHUELO,estado nutricional en menores de 5 anos,clasificacion e,2002-04-01,14,14,14,14,28
90102,PORVENIR,estado nutricional en menores de 5 anos,clasificacion e,2002-04-01,1,0,1,0,1
50101,POTOSI,estado nutricional en menores de 5 anos,clasificacion e,2002-04-01,110,94,110,94,204
10302,PRESTO,estado nutricional en menores de 5 anos,clasificacion e,2002-04-01,40,24,40,24,64
70805,PUCARA,estado nutricional en menores de 5 anos,clasificacion e,2002-04-01,0,6,0,6,6
21201,PUCARANI,estado nutricional en menores de 5 anos,clasificacion e,2002-04-01,0,13,0,13,13
20401,PUERTO ACOSTA,estado nutricional en menores de 5 anos,clasificacion e,2002-04-01,21,9,21,9,30
20403,PUERTO CARABUCO,estado nutricional en menores de 5 anos,clasificacion e,2002-04-01,12,11,12,11,23
90301,PUERTO GONZALO MORENO,estado nutricional en menores de 5 anos,clasificacion e,2002-04-01,3,0,3,0,3
21204,PUERTO PEREZ,estado nutricional en menores de 5 anos,clasificacion e,2002-04-01,0,2,0,2,2
71402,PUERTO QUIJARRO,estado nutricional en menores de 5 anos,clasificacion e,2002-04-01,14,10,14,10,24
90201,PUERTO RICO,estado nutricional en menores de 5 anos,clasificacion e,2002-04-01,0,2,0,2,2
80703,PUERTO SILES,estado nutricional en menores de 5 anos,clasificacion e,2002-04-01,0,2,0,2,2
71401,PUERTO SUAREZ,estado nutricional en menores de 5 anos,clasificacion e,2002-04-01,7,3,7,3,10
31205,PUERTO VILLARROEL,estado nutricional en menores de 5 anos,clasificacion e,2002-04-01,44,25,44,25,69
51101,PUNA,estado nutricional en menores de 5 anos,clasificacion e,2002-04-01,16,69,16,69,85
31401,PUNATA,estado nutricional en menores de 5 anos,clasificacion e,2002-04-01,16,73,16,73,89
20604,QUIABAYA,estado nutricional en menores de 5 anos,clasificacion e,2002-04-01,7,5,7,5,12
30901,QUILLACOLLO,estado nutricional en menores de 5 anos,clasificacion e,2002-04-01,13,9,13,9,22
21002,QUIME,estado nutricional en menores de 5 anos,clasificacion e,2002-04-01,4,15,4,15,19
50402,RAVELO,estado nutricional en menores de 5 anos,clasificacion e,2002-04-01,21,60,21,60,81
80301,REYES,estado nutricional en menores de 5 anos,clasificacion e,2002-04-01,4,8,4,8,12
80201,RIBERALTA,estado nutricional en menores de 5 anos,clasificacion e,2002-04-01,149,102,149,102,251
70503,ROBORE,estado nutricional en menores de 5 anos,clasificacion e,2002-04-01,0,20,0,20,20
80304,RURRENABAQUE,estado nutricional en menores de 5 anos,clasificacion e,2002-04-01,7,7,7,7,14
40901,SABAYA,estado nutricional en menores de 5 anos,clasificacion e,2002-04-01,0,1,0,1,1
31001,SACABA,estado nutricional en menores de 5 anos,clasificacion e,2002-04-01,8,31,8,31,39
30404,SACABAMBA,estado nutricional en menores de 5 anos,clasificacion e,2002-04-01,0,9,0,9,9
50701,SACACA,estado nutricional en menores de 5 anos,clasificacion e,2002-04-01,46,63,46,63,109
71302,SAIPINA,estado nutricional en menores de 5 anos,clasificacion e,2002-04-01,5,4,5,4,9
40801,SALINAS DE GARCI MENDOZA,estado nutricional en menores de 5 anos,clasificacion e,2002-04-01,5,4,5,4,9
70901,SAMAIPATA,estado nutricional en menores de 5 anos,clasificacion e,2002-04-01,1,1,1,1,2
51601,SAN AGUSTIN,estado nutricional en menores de 5 anos,clasificacion e,2002-04-01,0,3,0,3,3
80602,SAN ANDRES,estado nutricional en menores de 5 anos,clasificacion e,2002-04-01,3,5,3,5,8
51003,SAN ANTONIO DE ESMORUCO,estado nutricional en menores de 5 anos,clasificacion e,2002-04-01,0,1,0,1,1
71105,SAN ANTONIO DE LOMERIO,estado nutricional en menores de 5 anos,clasificacion e,2002-04-01,45,37,45,37,82
31403,SAN BENITO,estado nutricional en menores de 5 anos,clasificacion e,2002-04-01,0,6,0,6,6
80302,SAN BORJA,estado nutricional en menores de 5 anos,clasificacion e,2002-04-01,30,31,30,31,61
21502,SAN BUENA VENTURA,estado nutricional en menores de 5 anos,clasificacion e,2002-04-01,13,24,13,24,37
70402,SAN CARLOS,estado nutricional en menores de 5 anos,clasificacion e,2002-04-01,0,6,0,6,6
80501,SAN IGNACIO,estado nutricional en menores de 5 anos,clasificacion e,2002-04-01,12,35,12,35,47
70301,SAN IGNACIO DE VELASCO,estado nutricional en menores de 5 anos,clasificacion e,2002-04-01,74,45,74,45,119
80102,SAN JAVIER(BNI),estado nutricional en menores de 5 anos,clasificacion e,2002-04-01,4,5,4,5,9
71102,SAN JAVIER(STC),estado nutricional en menores de 5 anos,clasificacion e,2002-04-01,13,3,13,3,16
80701,SAN JOAQUIN,estado nutricional en menores de 5 anos,clasificacion e,2002-04-01,0,9,0,9,9
70501,SAN JOSE DE CHIQUITOS,estado nutricional en menores de 5 anos,clasificacion e,2002-04-01,21,9,21,9,30
71104,SAN JULIAN,estado nutricional en menores de 5 anos,clasificacion e,2002-04-01,30,84,30,84,114
60501,SAN LORENZO(TJA),estado nutricional en menores de 5 anos,clasificacion e,2002-04-01,4,5,4,5,9
10702,SAN LUCAS,estado nutricional en menores de 5 anos,clasificacion e,2002-04-01,111,111,111,111,222
71201,SAN MATIAS,estado nutricional en menores de 5 anos,clasificacion e,2002-04-01,26,17,26,17,43
70302,SAN MIGUEL DE VELASCO,estado nutricional en menores de 5 anos,clasificacion e,2002-04-01,38,26,38,26,64
51001,SAN PABLO DE LIPEZ,estado nutricional en menores de 5 anos,clasificacion e,2002-04-01,0,3,0,3,3
50501,SAN PEDRO DE BUENA VISTA,estado nutricional en menores de 5 anos,clasificacion e,2002-04-01,0,68,0,68,68
50902,SAN PEDRO DE QUEMES,estado nutricional en menores de 5 anos,clasificacion e,2002-04-01,0,4,0,4,4
90202,SAN PEDRO(PND),estado nutricional en menores de 5 anos,clasificacion e,2002-04-01,0,1,0,1,1
70303,SAN RAFAEL,estado nutricional en menores de 5 anos,clasificacion e,2002-04-01,8,3,8,3,11
80702,SAN RAMON,estado nutricional en menores de 5 anos,clasificacion e,2002-04-01,2,0,2,0,2
80702,SAN RAMON,estado nutricional en menores de 5 anos,clasificacion e,2002-04-01,3,1,3,1,4
80401,SANTA ANA,estado nutricional en menores de 5 anos,clasificacion e,2002-04-01,2,2,2,2,4
70101,SANTA CRUZ DE LA SIERRA,estado nutricional en menores de 5 anos,clasificacion e,2002-04-01,65,77,65,77,142
80303,SANTA ROSA,estado nutricional en menores de 5 anos,clasificacion e,2002-04-01,3,0,3,0,3
70602,SANTA ROSA DEL SARA,estado nutricional en menores de 5 anos,clasificacion e,2002-04-01,2,4,2,4,6
20308,SANTIAGO DE CALLAPA,estado nutricional en menores de 5 anos,clasificacion e,2002-04-01,1,4,1,4,5
41401,SANTIAGO DE HUARI,estado nutricional en menores de 5 anos,clasificacion e,2002-04-01,4,6,4,6,10
21901,SANTIAGO DE MACHACA,estado nutricional en menores de 5 anos,clasificacion e,2002-04-01,0,2,0,2,2
30702,SANTIVAÃ‘ES,estado nutricional en menores de 5 anos,clasificacion e,2002-04-01,14,8,14,8,22
40202,SANTUARIO DE QUILLACAS,estado nutricional en menores de 5 anos,clasificacion e,2002-04-01,0,1,0,1,1
20902,SAPAHAQUI,estado nutricional en menores de 5 anos,clasificacion e,2002-04-01,0,3,0,3,3
21301,SICA SICA (VILLA AROMA),estado nutricional en menores de 5 anos,clasificacion e,2002-04-01,4,1,4,1,5
30703,SICAYA,estado nutricional en menores de 5 anos,clasificacion e,2002-04-01,0,5,0,5,5
30902,SIPE SIPE,estado nutricional en menores de 5 anos,clasificacion e,2002-04-01,44,41,44,41,85
10403,SOPACHUY,estado nutricional en menores de 5 anos,clasificacion e,2002-04-01,39,27,39,27,66
20601,SORATA,estado nutricional en menores de 5 anos,clasificacion e,2002-04-01,0,3,0,3,3
10101,SUCRE,estado nutricional en menores de 5 anos,clasificacion e,2002-04-01,108,158,108,158,266
31404,TACACHI,estado nutricional en menores de 5 anos,clasificacion e,2002-04-01,0,1,0,1,1
20603,TACACOMA,estado nutricional en menores de 5 anos,clasificacion e,2002-04-01,1,1,1,1,2
50303,TACOBAMBA,estado nutricional en menores de 5 anos,clasificacion e,2002-04-01,32,11,32,11,43
30602,TACOPAYA,estado nutricional en menores de 5 anos,clasificacion e,2002-04-01,12,19,12,19,31
51402,TAHUA,estado nutricional en menores de 5 anos,clasificacion e,2002-04-01,0,1,0,1,1
31101,TAPACARI,estado nutricional en menores de 5 anos,clasificacion e,2002-04-01,1,34,1,34,35
10601,TARABUCO,estado nutricional en menores de 5 anos,clasificacion e,2002-04-01,71,204,71,204,275
30401,TARATA,estado nutricional en menores de 5 anos,clasificacion e,2002-04-01,1,14,1,14,15
60101,TARIJA,estado nutricional en menores de 5 anos,clasificacion e,2002-04-01,31,47,31,47,78
10202,TARVITA,estado nutricional en menores de 5 anos,clasificacion e,2002-04-01,33,21,33,21,54
20803,TIAWANACU,estado nutricional en menores de 5 anos,clasificacion e,2002-04-01,3,4,3,4,7
50102,TINGUIPAYA,estado nutricional en menores de 5 anos,clasificacion e,2002-04-01,0,46,0,46,46
20606,TIPUANI,estado nutricional en menores de 5 anos,clasificacion e,2002-04-01,3,3,3,3,6
30903,TIQUIPAYA,estado nutricional en menores de 5 anos,clasificacion e,2002-04-01,0,13,0,13,13
31601,TIRAQUE (CBBA),estado nutricional en menores de 5 anos,clasificacion e,2002-04-01,25,100,25,100,125
21703,TITO YUPANQUI (PARQUIPUJIO),estado nutricional en menores de 5 anos,clasificacion e,2002-04-01,0,3,0,3,3
41001,TOLEDO,estado nutricional en menores de 5 anos,clasificacion e,2002-04-01,0,1,0,1,1
51202,TOMAVE,estado nutricional en menores de 5 anos,clasificacion e,2002-04-01,0,38,0,38,38
10402,TOMINA,estado nutricional en menores de 5 anos,clasificacion e,2002-04-01,63,53,63,53,116
50502,TORO TORO,estado nutricional en menores de 5 anos,clasificacion e,2002-04-01,0,11,0,11,11
31201,TOTORA(CBBA),estado nutricional en menores de 5 anos,clasificacion e,2002-04-01,7,38,7,38,45
41301,TOTORA(ORR),estado nutricional en menores de 5 anos,clasificacion e,2002-04-01,0,5,0,5,5
70802,TRIGAL,estado nutricional en menores de 5 anos,clasificacion e,2002-04-01,0,2,0,2,2
80101,TRINIDAD,estado nutricional en menores de 5 anos,clasificacion e,2002-04-01,38,57,38,57,95
50801,TUPIZA,estado nutricional en menores de 5 anos,clasificacion e,2002-04-01,1,73,1,73,74
40402,TURCO,estado nutricional en menores de 5 anos,clasificacion e,2002-04-01,1,1,1,1,2
21302,UMALA,estado nutricional en menores de 5 anos,clasificacion e,2002-04-01,1,1,1,1,2
60401,URIONDO (A. CONCEPCION),estado nutricional en menores de 5 anos,clasificacion e,2002-04-01,6,10,6,10,16
71502,URUBICHA,estado nutricional en menores de 5 anos,clasificacion e,2002-04-01,23,64,23,64,87
51201,UYUNI,estado nutricional en menores de 5 anos,clasificacion e,2002-04-01,0,40,0,40,40
30502,VACAS,estado nutricional en menores de 5 anos,clasificacion e,2002-04-01,5,11,5,11,16
70801,VALLEGRANDE,estado nutricional en menores de 5 anos,clasificacion e,2002-04-01,10,10,10,10,20
20801,VIACHA,estado nutricional en menores de 5 anos,clasificacion e,2002-04-01,4,22,4,22,26
31302,VILA VILA,estado nutricional en menores de 5 anos,clasificacion e,2002-04-01,4,12,4,12,16
60303,VILLA MONTES,estado nutricional en menores de 5 anos,clasificacion e,2002-04-01,11,17,11,17,28
90502,VILLA NUEVA (LOMA ALTA),estado nutricional en menores de 5 anos,clasificacion e,2002-04-01,0,1,0,1,1
31402,VILLA RIVERO,estado nutricional en menores de 5 anos,clasificacion e,2002-04-01,0,24,0,24,24
10801,VILLA SERRANO,estado nutricional en menores de 5 anos,clasificacion e,2002-04-01,44,78,44,78,122
31003,VILLA TUNARI,estado nutricional en menores de 5 anos,clasificacion e,2002-04-01,51,29,51,29,80
11001,VILLA VACA GUZMAN (MUYUPAMPA),estado nutricional en menores de 5 anos,clasificacion e,2002-04-01,12,15,12,15,27
51501,VILLAZON,estado nutricional en menores de 5 anos,clasificacion e,2002-04-01,1,51,1,51,52
30904,VINTO,estado nutricional en menores de 5 anos,clasificacion e,2002-04-01,13,16,13,16,29
50602,VITICHI,estado nutricional en menores de 5 anos,clasificacion e,2002-04-01,14,30,14,30,44
20306,WALDO BALLIVIAN,estado nutricional en menores de 5 anos,clasificacion e,2002-04-01,3,0,3,0,3
70201,WARNES,estado nutricional en menores de 5 anos,clasificacion e,2002-04-01,24,22,24,22,46
20903,YACO,estado nutricional en menores de 5 anos,clasificacion e,2002-04-01,0,10,0,10,10
60301,YACUIBA,estado nutricional en menores de 5 anos,clasificacion e,2002-04-01,18,21,18,21,39
10602,YAMPARAEZ,estado nutricional en menores de 5 anos,clasificacion e,2002-04-01,72,46,72,46,118
21103,YANACACHI,estado nutricional en menores de 5 anos,clasificacion e,2002-04-01,1,3,1,3,4
70403,YAPACANI,estado nutricional en menores de 5 anos,clasificacion e,2002-04-01,25,44,25,44,69
50103,YOCALLA,estado nutricional en menores de 5 anos,clasificacion e,2002-04-01,0,14,0,14,14
10102,YOTALA,estado nutricional en menores de 5 anos,clasificacion e,2002-04-01,25,33,25,33,58
60402,YUNCHARA,estado nutricional en menores de 5 anos,clasificacion e,2002-04-01,0,14,0,14,14
10301,ZUDAÃ‘EZ,estado nutricional en menores de 5 anos,clasificacion e,2002-04-01,43,29,43,29,72
51302,ACACIO,estado nutricional en menores de 5 anos,clasificacion e,2002-05-01,13,34,13,34,47
20201,ACHACACHI,estado nutricional en menores de 5 anos,clasificacion e,2002-05-01,16,16,16,16,32
20104,ACHOCALLA,estado nutricional en menores de 5 anos,clasificacion e,2002-05-01,3,0,3,0,3
30201,AIQUILE,estado nutricional en menores de 5 anos,clasificacion e,2002-05-01,8,2,8,2,10
31303,ALALAY,estado nutricional en menores de 5 anos,clasificacion e,2002-05-01,3,1,3,1,4
10404,ALCALA,estado nutricional en menores de 5 anos,clasificacion e,2002-05-01,18,8,18,8,26
20202,ANCORAIMES,estado nutricional en menores de 5 anos,clasificacion e,2002-05-01,21,21,21,21,42
30402,ANZALDO,estado nutricional en menores de 5 anos,clasificacion e,2002-05-01,0,18,0,18,18
20701,APOLO,estado nutricional en menores de 5 anos,clasificacion e,2002-05-01,19,7,19,7,26
51301,ARAMPAMPA,estado nutricional en menores de 5 anos,clasificacion e,2002-05-01,24,19,24,19,43
30501,ARANI,estado nutricional en menores de 5 anos,clasificacion e,2002-05-01,4,4,4,4,8
30403,ARBIETO,estado nutricional en menores de 5 anos,clasificacion e,2002-05-01,0,15,0,15,15
30601,ARQUE,estado nutricional en menores de 5 anos,clasificacion e,2002-05-01,21,13,21,13,34
71501,ASCENCION DE GUARAYOS,estado nutricional en menores de 5 anos,clasificacion e,2002-05-01,0,1,0,1,1
50802,ATOCHA,estado nutricional en menores de 5 anos,clasificacion e,2002-05-01,3,27,3,27,30
20502,AYATA,estado nutricional en menores de 5 anos,clasificacion e,2002-05-01,12,14,12,14,26
21303,AYO AYO,estado nutricional en menores de 5 anos,clasificacion e,2002-05-01,8,3,8,3,11
30301,AYOPAYA (V. DE INDEPENDENCIA),estado nutricional en menores de 5 anos,clasificacion e,2002-05-01,33,16,33,16,49
10201,AZURDUY,estado nutricional en menores de 5 anos,clasificacion e,2002-05-01,43,40,43,40,83
21203,BATALLAS,estado nutricional en menores de 5 anos,clasificacion e,2002-05-01,1,5,1,5,6
80802,BAURES,estado nutricional en menores de 5 anos,clasificacion e,2002-05-01,2,0,2,0,2
50104,BELEN DE URMIRI,estado nutricional en menores de 5 anos,clasificacion e,2002-05-01,0,7,0,7,7
90104,BELLA FLOR,estado nutricional en menores de 5 anos,clasificacion e,2002-05-01,0,1,0,1,1
60202,BERMEJO,estado nutricional en menores de 5 anos,clasificacion e,2002-05-01,2,6,2,6,8
50301,BETANZOS,estado nutricional en menores de 5 anos,clasificacion e,2002-05-01,81,143,81,143,224
31501,BOLIVAR,estado nutricional en menores de 5 anos,clasificacion e,2002-05-01,5,13,5,13,18
70707,BOYUIBE,estado nutricional en menores de 5 anos,clasificacion e,2002-05-01,1,7,1,7,8
70401,BUENA VISTA,estado nutricional en menores de 5 anos,clasificacion e,2002-05-01,8,6,8,6,14
70703,CABEZAS,estado nutricional en menores de 5 anos,clasificacion e,2002-05-01,0,4,0,4,4
20905,CAIROMA,estado nutricional en menores de 5 anos,clasificacion e,2002-05-01,0,10,0,10,10
51102,"CAIZA ""D""",estado nutricional en menores de 5 anos,clasificacion e,2002-05-01,12,34,12,34,46
21003,CAJUATA,estado nutricional en menores de 5 anos,clasificacion e,2002-05-01,2,4,2,4,6
20303,CALACOTO,estado nutricional en menores de 5 anos,clasificacion e,2002-05-01,3,0,3,0,3
21304,CALAMARCA,estado nutricional en menores de 5 anos,clasificacion e,2002-05-01,5,4,5,4,9
10701,CAMARGO,estado nutricional en menores de 5 anos,clasificacion e,2002-05-01,8,23,8,23,31
10901,CAMATAQUI (C. VILLA ABECIA),estado nutricional en menores de 5 anos,clasificacion e,2002-05-01,7,5,7,5,12
70706,CAMIRI,estado nutricional en menores de 5 anos,clasificacion e,2002-05-01,4,16,4,16,20
30701,CAPINOTA,estado nutricional en menores de 5 anos,clasificacion e,2002-05-01,2,5,2,5,7
20302,CAQUIAVIRI,estado nutricional en menores de 5 anos,clasificacion e,2002-05-01,2,3,2,3,5
40102,CARACOLLO,estado nutricional en menores de 5 anos,clasificacion e,2002-05-01,3,12,3,12,15
22001,CARANAVI,estado nutricional en menores de 5 anos,clasificacion e,2002-05-01,26,15,26,15,41
60302,CARAPARI,estado nutricional en menores de 5 anos,clasificacion e,2002-05-01,7,8,7,8,15
50702,CARIPUYO,estado nutricional en menores de 5 anos,clasificacion e,2002-05-01,11,60,11,60,71
21803,CHACARILLA,estado nutricional en menores de 5 anos,clasificacion e,2002-05-01,2,2,2,2,4
40201,CHALLAPATA,estado nutricional en menores de 5 anos,clasificacion e,2002-05-01,30,29,30,29,59
50302,CHAQUI,estado nutricional en menores de 5 anos,clasificacion e,2002-05-01,22,27,22,27,49
70702,CHARAGUA,estado nutricional en menores de 5 anos,clasificacion e,2002-05-01,7,61,7,61,68
20305,CHARAÃ‘A,estado nutricional en menores de 5 anos,clasificacion e,2002-05-01,0,4,0,4,4
31204,CHIMORE,estado nutricional en menores de 5 anos,clasificacion e,2002-05-01,4,3,4,3,7
40302,CHOQUE COTA,estado nutricional en menores de 5 anos,clasificacion e,2002-05-01,0,1,0,1,1
21101,CHULUMANI (V. DE LA LIBERTAD),estado nutricional en menores de 5 anos,clasificacion e,2002-05-01,0,3,0,3,3
20501,CHUMA,estado nutricional en menores de 5 anos,clasificacion e,2002-05-01,1,3,1,3,4
30801,CLIZA,estado nutricional en menores de 5 anos,clasificacion e,2002-05-01,2,7,2,7,9
90101,COBIJA,estado nutricional en menores de 5 anos,clasificacion e,2002-05-01,21,18,21,18,39
30101,COCHABAMBA,estado nutricional en menores de 5 anos,clasificacion e,2002-05-01,103,95,103,95,198
30905,COLCAPIRHUA,estado nutricional en menores de 5 anos,clasificacion e,2002-05-01,33,12,33,12,45
50901,"COLCHA ""K""",estado nutricional en menores de 5 anos,clasificacion e,2002-05-01,0,19,0,19,19
31002,COLOMI,estado nutricional en menores de 5 anos,clasificacion e,2002-05-01,15,15,15,15,30
50401,COLQUECHACA,estado nutricional en menores de 5 anos,clasificacion e,2002-05-01,41,31,41,31,72
21306,COLQUENCHA,estado nutricional en menores de 5 anos,clasificacion e,2002-05-01,14,5,14,5,19
21004,COLQUIRI,estado nutricional en menores de 5 anos,clasificacion e,2002-05-01,8,8,8,8,16
20304,COMANCHE,estado nutricional en menores de 5 anos,clasificacion e,2002-05-01,1,2,1,2,3
71301,COMARAPA,estado nutricional en menores de 5 anos,clasificacion e,2002-05-01,9,13,9,13,22
20605,COMBAYA,estado nutricional en menores de 5 anos,clasificacion e,2002-05-01,1,3,1,3,4
71101,CONCEPCION,estado nutricional en menores de 5 anos,clasificacion e,2002-05-01,1,0,1,0,1
21701,COPACABANA,estado nutricional en menores de 5 anos,clasificacion e,2002-05-01,4,2,4,2,6
20301,CORO CORO,estado nutricional en menores de 5 anos,clasificacion e,2002-05-01,17,1,17,1,18
21401,COROICO,estado nutricional en menores de 5 anos,clasificacion e,2002-05-01,17,10,17,10,27
40301,CORQUE,estado nutricional en menores de 5 anos,clasificacion e,2002-05-01,2,3,2,3,5
50601,COTAGAITA,estado nutricional en menores de 5 anos,clasificacion e,2002-05-01,9,40,9,40,49
70102,COTOCA,estado nutricional en menores de 5 anos,clasificacion e,2002-05-01,6,6,6,6,12
31405,CUCHUMUELA (V. G. VILLARROEL),estado nutricional en menores de 5 anos,clasificacion e,2002-05-01,0,11,0,11,11
70704,CUEVO,estado nutricional en menores de 5 anos,clasificacion e,2002-05-01,8,6,8,6,14
10902,CULPINA,estado nutricional en menores de 5 anos,clasificacion e,2002-05-01,52,41,52,41,93
40401,CURAHUARA DE CARANGAS,estado nutricional en menores de 5 anos,clasificacion e,2002-05-01,6,3,6,3,9
21602,CURVA,estado nutricional en menores de 5 anos,clasificacion e,2002-05-01,3,0,3,0,3
20804,DESAGUADERO,estado nutricional en menores de 5 anos,clasificacion e,2002-05-01,0,7,0,7,7
20105,EL ALTO,estado nutricional en menores de 5 anos,clasificacion e,2002-05-01,441,378,441,378,819
40103,EL CHORO,estado nutricional en menores de 5 anos,clasificacion e,2002-05-01,0,1,0,1,1
71503,EL PUENTE(STC),estado nutricional en menores de 5 anos,clasificacion e,2002-05-01,1,27,1,27,28
60502,EL PUENTE(TJA),estado nutricional en menores de 5 anos,clasificacion e,2002-05-01,2,17,2,17,19
70105,EL TORNO,estado nutricional en menores de 5 anos,clasificacion e,2002-05-01,21,15,21,15,36
10405,EL VILLAR,estado nutricional en menores de 5 anos,clasificacion e,2002-05-01,37,37,37,37,74
60601,ENTRE RIOS,estado nutricional en menores de 5 anos,clasificacion e,2002-05-01,6,12,6,12,18
41101,EUCALIPTUS,estado nutricional en menores de 5 anos,clasificacion e,2002-05-01,0,5,0,5,5
80402,EXALTACION,estado nutricional en menores de 5 anos,clasificacion e,2002-05-01,7,16,7,16,23
90203,FILADELFIA,estado nutricional en menores de 5 anos,clasificacion e,2002-05-01,0,4,0,4,4
71002,GENERAL SAAVEDRA,estado nutricional en menores de 5 anos,clasificacion e,2002-05-01,13,18,13,18,31
21601,GRAL. J.J. PEREZ (CHARAZANI),estado nutricional en menores de 5 anos,clasificacion e,2002-05-01,1,0,1,0,1
20602,GUANAY,estado nutricional en menores de 5 anos,clasificacion e,2002-05-01,16,29,16,29,45
20802,GUAQUI,estado nutricional en menores de 5 anos,clasificacion e,2002-05-01,0,7,0,7,7
80202,GUAYARAMERIN,estado nutricional en menores de 5 anos,clasificacion e,2002-05-01,27,19,27,19,46
70705,GUTIERREZ,estado nutricional en menores de 5 anos,clasificacion e,2002-05-01,1,55,1,55,56
10502,HUACARETA,estado nutricional en menores de 5 anos,clasificacion e,2002-05-01,27,21,27,21,48
11002,HUACAYA (VILLA DE HUACAYA),estado nutricional en menores de 5 anos,clasificacion e,2002-05-01,0,5,0,5,5
40501,HUACHACALLA,estado nutricional en menores de 5 anos,clasificacion e,2002-05-01,0,2,0,2,2
80803,HUARACAJE,estado nutricional en menores de 5 anos,clasificacion e,2002-05-01,6,0,6,0,6
41601,HUAYLLAMARCA,estado nutricional en menores de 5 anos,clasificacion e,2002-05-01,3,0,3,0,3
21005,ICHOCA,estado nutricional en menores de 5 anos,clasificacion e,2002-05-01,1,1,1,1,2
10304,ICLA,estado nutricional en menores de 5 anos,clasificacion e,2002-05-01,65,65,65,65,130
10703,INCAHUASI,estado nutricional en menores de 5 anos,clasificacion e,2002-05-01,35,45,35,45,80
21001,INQUISIVI,estado nutricional en menores de 5 anos,clasificacion e,2002-05-01,10,28,10,28,38
21102,IRUPANA (VILLA DE LANZA),estado nutricional en menores de 5 anos,clasificacion e,2002-05-01,0,4,0,4,4
21501,IXIAMAS,estado nutricional en menores de 5 anos,clasificacion e,2002-05-01,4,15,4,15,19
21105,LA ASUNTA,estado nutricional en menores de 5 anos,clasificacion e,2002-05-01,9,10,9,10,19
70104,LA GUARDIA,estado nutricional en menores de 5 anos,clasificacion e,2002-05-01,14,7,14,7,21
20101,LA PAZ,estado nutricional en menores de 5 anos,clasificacion e,2002-05-01,298,141,298,141,439
70701,LAGUNILLAS,estado nutricional en menores de 5 anos,clasificacion e,2002-05-01,5,9,5,9,14
21202,LAJA,estado nutricional en menores de 5 anos,clasificacion e,2002-05-01,0,13,0,13,13
10903,LAS CARRERAS,estado nutricional en menores de 5 anos,clasificacion e,2002-05-01,9,10,9,10,19
51401,LLICA,estado nutricional en menores de 5 anos,clasificacion e,2002-05-01,0,2,0,2,2
80601,LORETO,estado nutricional en menores de 5 anos,clasificacion e,2002-05-01,2,2,2,2,4
20901,LURIBAY,estado nutricional en menores de 5 anos,clasificacion e,2002-05-01,6,3,6,3,9
40702,MACHACAMARCA,estado nutricional en menores de 5 anos,clasificacion e,2002-05-01,3,0,3,0,3
11003,MACHARETI,estado nutricional en menores de 5 anos,clasificacion e,2002-05-01,9,21,9,21,30
80801,MAGDALENA,estado nutricional en menores de 5 anos,clasificacion e,2002-05-01,7,5,7,5,12
70903,MAIRANA,estado nutricional en menores de 5 anos,clasificacion e,2002-05-01,5,1,5,1,6
20904,MALLA,estado nutricional en menores de 5 anos,clasificacion e,2002-05-01,1,0,1,0,1
20103,MECAPACA,estado nutricional en menores de 5 anos,clasificacion e,2002-05-01,1,4,1,4,5
71003,MINEROS,estado nutricional en menores de 5 anos,clasificacion e,2002-05-01,39,23,39,23,62
31301,MIZQUE,estado nutricional en menores de 5 anos,clasificacion e,2002-05-01,13,17,13,17,30
20402,MOCOMOCO,estado nutricional en menores de 5 anos,clasificacion e,2002-05-01,4,6,4,6,10
51002,MOJINETE,estado nutricional en menores de 5 anos,clasificacion e,2002-05-01,0,1,0,1,1
10303,MOJOCOYA,estado nutricional en menores de 5 anos,clasificacion e,2002-05-01,33,21,33,21,54
10501,MONTEAGUDO,estado nutricional en menores de 5 anos,clasificacion e,2002-05-01,50,48,50,48,98
71001,MONTERO,estado nutricional en menores de 5 anos,clasificacion e,2002-05-01,18,122,18,122,140
70803,MORO MORO,estado nutricional en menores de 5 anos,clasificacion e,2002-05-01,4,3,4,3,7
30302,MOROCHATA,estado nutricional en menores de 5 anos,clasificacion e,2002-05-01,7,15,7,15,22
90501,NUEVO MANOA (NUEVA ESPERANZA),estado nutricional en menores de 5 anos,clasificacion e,2002-05-01,1,1,1,1,2
50404,OCURI,estado nutricional en menores de 5 anos,clasificacion e,2002-05-01,28,19,28,19,47
70202,OKINAWA,estado nutricional en menores de 5 anos,clasificacion e,2002-05-01,2,3,2,3,5
40101,ORURO,estado nutricional en menores de 5 anos,clasificacion e,2002-05-01,99,70,99,70,169
60201,PADCAYA,estado nutricional en menores de 5 anos,clasificacion e,2002-05-01,11,19,11,19,30
10401,PADILLA,estado nutricional en menores de 5 anos,clasificacion e,2002-05-01,61,53,61,53,114
70502,PAILON,estado nutricional en menores de 5 anos,clasificacion e,2002-05-01,0,10,0,10,10
20102,PALCA,estado nutricional en menores de 5 anos,clasificacion e,2002-05-01,9,13,9,13,22
21104,PALOS BLANCOS,estado nutricional en menores de 5 anos,clasificacion e,2002-05-01,18,20,18,20,38
40802,PAMPA AULLAGAS,estado nutricional en menores de 5 anos,clasificacion e,2002-05-01,7,4,7,4,11
70902,PAMPA GRANDE,estado nutricional en menores de 5 anos,clasificacion e,2002-05-01,5,2,5,2,7
21802,PAPEL PAMPA,estado nutricional en menores de 5 anos,clasificacion e,2002-05-01,1,0,1,0,1
30202,PASORAPA,estado nutricional en menores de 5 anos,clasificacion e,2002-05-01,15,11,15,11,26
21305,PATACAMAYA,estado nutricional en menores de 5 anos,clasificacion e,2002-05-01,9,8,9,8,17
40602,PAZÃ‘A,estado nutricional en menores de 5 anos,clasificacion e,2002-05-01,0,7,0,7,7
20702,PELECHUCO,estado nutricional en menores de 5 anos,clasificacion e,2002-05-01,4,12,4,12,16
50403,POCOATA,estado nutricional en menores de 5 anos,clasificacion e,2002-05-01,37,61,37,61,98
31203,POCONA,estado nutricional en menores de 5 anos,clasificacion e,2002-05-01,35,31,35,31,66
31202,POJO (CBBA),estado nutricional en menores de 5 anos,clasificacion e,2002-05-01,24,21,24,21,45
40601,POOPO,estado nutricional en menores de 5 anos,clasificacion e,2002-05-01,2,12,2,12,14
51203,PORCO,estado nutricional en menores de 5 anos,clasificacion e,2002-05-01,3,4,3,4,7
10103,POROMA,estado nutricional en menores de 5 anos,clasificacion e,2002-05-01,34,80,34,80,114
70103,PORONGO,estado nutricional en menores de 5 anos,clasificacion e,2002-05-01,7,2,7,2,9
70601,PORTACHUELO,estado nutricional en menores de 5 anos,clasificacion e,2002-05-01,10,4,10,4,14
50101,POTOSI,estado nutricional en menores de 5 anos,clasificacion e,2002-05-01,129,115,129,115,244
10302,PRESTO,estado nutricional en menores de 5 anos,clasificacion e,2002-05-01,35,34,35,34,69
70805,PUCARA,estado nutricional en menores de 5 anos,clasificacion e,2002-05-01,0,6,0,6,6
21201,PUCARANI,estado nutricional en menores de 5 anos,clasificacion e,2002-05-01,0,20,0,20,20
20401,PUERTO ACOSTA,estado nutricional en menores de 5 anos,clasificacion e,2002-05-01,17,10,17,10,27
20403,PUERTO CARABUCO,estado nutricional en menores de 5 anos,clasificacion e,2002-05-01,9,16,9,16,25
90301,PUERTO GONZALO MORENO,estado nutricional en menores de 5 anos,clasificacion e,2002-05-01,6,3,6,3,9
71402,PUERTO QUIJARRO,estado nutricional en menores de 5 anos,clasificacion e,2002-05-01,11,0,11,0,11
90201,PUERTO RICO,estado nutricional en menores de 5 anos,clasificacion e,2002-05-01,0,7,0,7,7
71401,PUERTO SUAREZ,estado nutricional en menores de 5 anos,clasificacion e,2002-05-01,22,3,22,3,25
31205,PUERTO VILLARROEL,estado nutricional en menores de 5 anos,clasificacion e,2002-05-01,61,43,61,43,104
51101,PUNA,estado nutricional en menores de 5 anos,clasificacion e,2002-05-01,48,81,48,81,129
31401,PUNATA,estado nutricional en menores de 5 anos,clasificacion e,2002-05-01,0,5,0,5,5
20604,QUIABAYA,estado nutricional en menores de 5 anos,clasificacion e,2002-05-01,11,4,11,4,15
30901,QUILLACOLLO,estado nutricional en menores de 5 anos,clasificacion e,2002-05-01,20,10,20,10,30
21002,QUIME,estado nutricional en menores de 5 anos,clasificacion e,2002-05-01,5,1,5,1,6
50402,RAVELO,estado nutricional en menores de 5 anos,clasificacion e,2002-05-01,60,90,60,90,150
80301,REYES,estado nutricional en menores de 5 anos,clasificacion e,2002-05-01,3,4,3,4,7
80201,RIBERALTA,estado nutricional en menores de 5 anos,clasificacion e,2002-05-01,160,117,160,117,277
70503,ROBORE,estado nutricional en menores de 5 anos,clasificacion e,2002-05-01,2,7,2,7,9
80304,RURRENABAQUE,estado nutricional en menores de 5 anos,clasificacion e,2002-05-01,5,5,5,5,10
31001,SACABA,estado nutricional en menores de 5 anos,clasificacion e,2002-05-01,7,119,7,119,126
30404,SACABAMBA,estado nutricional en menores de 5 anos,clasificacion e,2002-05-01,0,29,0,29,29
50701,SACACA,estado nutricional en menores de 5 anos,clasificacion e,2002-05-01,69,90,69,90,159
71302,SAIPINA,estado nutricional en menores de 5 anos,clasificacion e,2002-05-01,1,1,1,1,2
40801,SALINAS DE GARCI MENDOZA,estado nutricional en menores de 5 anos,clasificacion e,2002-05-01,2,3,2,3,5
70901,SAMAIPATA,estado nutricional en menores de 5 anos,clasificacion e,2002-05-01,8,0,8,0,8
51601,SAN AGUSTIN,estado nutricional en menores de 5 anos,clasificacion e,2002-05-01,0,1,0,1,1
80602,SAN ANDRES,estado nutricional en menores de 5 anos,clasificacion e,2002-05-01,0,2,0,2,2
51003,SAN ANTONIO DE ESMORUCO,estado nutricional en menores de 5 anos,clasificacion e,2002-05-01,0,5,0,5,5
71105,SAN ANTONIO DE LOMERIO,estado nutricional en menores de 5 anos,clasificacion e,2002-05-01,39,32,39,32,71
31403,SAN BENITO,estado nutricional en menores de 5 anos,clasificacion e,2002-05-01,1,1,1,1,2
80302,SAN BORJA,estado nutricional en menores de 5 anos,clasificacion e,2002-05-01,11,12,11,12,23
21502,SAN BUENA VENTURA,estado nutricional en menores de 5 anos,clasificacion e,2002-05-01,3,5,3,5,8
70402,SAN CARLOS,estado nutricional en menores de 5 anos,clasificacion e,2002-05-01,0,1,0,1,1
80501,SAN IGNACIO,estado nutricional en menores de 5 anos,clasificacion e,2002-05-01,26,39,26,39,65
70301,SAN IGNACIO DE VELASCO,estado nutricional en menores de 5 anos,clasificacion e,2002-05-01,46,26,46,26,72
80102,SAN JAVIER(BNI),estado nutricional en menores de 5 anos,clasificacion e,2002-05-01,5,1,5,1,6
71102,SAN JAVIER(STC),estado nutricional en menores de 5 anos,clasificacion e,2002-05-01,18,0,18,0,18
80701,SAN JOAQUIN,estado nutricional en menores de 5 anos,clasificacion e,2002-05-01,0,8,0,8,8
70501,SAN JOSE DE CHIQUITOS,estado nutricional en menores de 5 anos,clasificacion e,2002-05-01,14,6,14,6,20
71104,SAN JULIAN,estado nutricional en menores de 5 anos,clasificacion e,2002-05-01,35,85,35,85,120
90302,SAN LORENZO(PND),estado nutricional en menores de 5 anos,clasificacion e,2002-05-01,0,1,0,1,1
60501,SAN LORENZO(TJA),estado nutricional en menores de 5 anos,clasificacion e,2002-05-01,4,5,4,5,9
10702,SAN LUCAS,estado nutricional en menores de 5 anos,clasificacion e,2002-05-01,152,112,152,112,264
71201,SAN MATIAS,estado nutricional en menores de 5 anos,clasificacion e,2002-05-01,13,13,13,13,26
70302,SAN MIGUEL DE VELASCO,estado nutricional en menores de 5 anos,clasificacion e,2002-05-01,19,18,19,18,37
51001,SAN PABLO DE LIPEZ,estado nutricional en menores de 5 anos,clasificacion e,2002-05-01,0,18,0,18,18
50501,SAN PEDRO DE BUENA VISTA,estado nutricional en menores de 5 anos,clasificacion e,2002-05-01,1,109,1,109,110
21801,SAN PEDRO DE CURAHUARA,estado nutricional en menores de 5 anos,clasificacion e,2002-05-01,1,6,1,6,7
90202,SAN PEDRO(PND),estado nutricional en menores de 5 anos,clasificacion e,2002-05-01,1,1,1,1,2
70303,SAN RAFAEL,estado nutricional en menores de 5 anos,clasificacion e,2002-05-01,8,5,8,5,13
80401,SANTA ANA,estado nutricional en menores de 5 anos,clasificacion e,2002-05-01,7,0,7,0,7
70101,SANTA CRUZ DE LA SIERRA,estado nutricional en menores de 5 anos,clasificacion e,2002-05-01,83,39,83,39,122
80303,SANTA ROSA,estado nutricional en menores de 5 anos,clasificacion e,2002-05-01,19,5,19,5,24
70602,SANTA ROSA DEL SARA,estado nutricional en menores de 5 anos,clasificacion e,2002-05-01,2,5,2,5,7
20308,SANTIAGO DE CALLAPA,estado nutricional en menores de 5 anos,clasificacion e,2002-05-01,0,4,0,4,4
41401,SANTIAGO DE HUARI,estado nutricional en menores de 5 anos,clasificacion e,2002-05-01,4,7,4,7,11
21901,SANTIAGO DE MACHACA,estado nutricional en menores de 5 anos,clasificacion e,2002-05-01,1,1,1,1,2
30702,SANTIVAÃ‘ES,estado nutricional en menores de 5 anos,clasificacion e,2002-05-01,4,2,4,2,6
40202,SANTUARIO DE QUILLACAS,estado nutricional en menores de 5 anos,clasificacion e,2002-05-01,0,2,0,2,2
20902,SAPAHAQUI,estado nutricional en menores de 5 anos,clasificacion e,2002-05-01,0,3,0,3,3
21301,SICA SICA (VILLA AROMA),estado nutricional en menores de 5 anos,clasificacion e,2002-05-01,6,5,6,5,11
30703,SICAYA,estado nutricional en menores de 5 anos,clasificacion e,2002-05-01,0,12,0,12,12
30902,SIPE SIPE,estado nutricional en menores de 5 anos,clasificacion e,2002-05-01,61,47,61,47,108
10403,SOPACHUY,estado nutricional en menores de 5 anos,clasificacion e,2002-05-01,41,28,41,28,69
20601,SORATA,estado nutricional en menores de 5 anos,clasificacion e,2002-05-01,11,12,11,12,23
10101,SUCRE,estado nutricional en menores de 5 anos,clasificacion e,2002-05-01,195,140,195,140,335
31404,TACACHI,estado nutricional en menores de 5 anos,clasificacion e,2002-05-01,0,1,0,1,1
20603,TACACOMA,estado nutricional en menores de 5 anos,clasificacion e,2002-05-01,2,3,2,3,5
50303,TACOBAMBA,estado nutricional en menores de 5 anos,clasificacion e,2002-05-01,16,12,16,12,28
30602,TACOPAYA,estado nutricional en menores de 5 anos,clasificacion e,2002-05-01,17,14,17,14,31
51402,TAHUA,estado nutricional en menores de 5 anos,clasificacion e,2002-05-01,0,2,0,2,2
31101,TAPACARI,estado nutricional en menores de 5 anos,clasificacion e,2002-05-01,3,75,3,75,78
10601,TARABUCO,estado nutricional en menores de 5 anos,clasificacion e,2002-05-01,76,222,76,222,298
30401,TARATA,estado nutricional en menores de 5 anos,clasificacion e,2002-05-01,13,15,13,15,28
60101,TARIJA,estado nutricional en menores de 5 anos,clasificacion e,2002-05-01,45,32,45,32,77
10202,TARVITA,estado nutricional en menores de 5 anos,clasificacion e,2002-05-01,37,20,37,20,57
20803,TIAWANACU,estado nutricional en menores de 5 anos,clasificacion e,2002-05-01,5,3,5,3,8
50102,TINGUIPAYA,estado nutricional en menores de 5 anos,clasificacion e,2002-05-01,7,56,7,56,63
20606,TIPUANI,estado nutricional en menores de 5 anos,clasificacion e,2002-05-01,0,2,0,2,2
30903,TIQUIPAYA,estado nutricional en menores de 5 anos,clasificacion e,2002-05-01,0,23,0,23,23
31601,TIRAQUE (CBBA),estado nutricional en menores de 5 anos,clasificacion e,2002-05-01,19,41,19,41,60
21703,TITO YUPANQUI (PARQUIPUJIO),estado nutricional en menores de 5 anos,clasificacion e,2002-05-01,0,24,0,24,24
30802,TOCO,estado nutricional en menores de 5 anos,clasificacion e,2002-05-01,6,2,6,2,8
41001,TOLEDO,estado nutricional en menores de 5 anos,clasificacion e,2002-05-01,1,2,1,2,3
51202,TOMAVE,estado nutricional en menores de 5 anos,clasificacion e,2002-05-01,1,44,1,44,45
10402,TOMINA,estado nutricional en menores de 5 anos,clasificacion e,2002-05-01,44,41,44,41,85
50502,TORO TORO,estado nutricional en menores de 5 anos,clasificacion e,2002-05-01,0,23,0,23,23
31201,TOTORA(CBBA),estado nutricional en menores de 5 anos,clasificacion e,2002-05-01,30,28,30,28,58
41301,TOTORA(ORR),estado nutricional en menores de 5 anos,clasificacion e,2002-05-01,4,1,4,1,5
80101,TRINIDAD,estado nutricional en menores de 5 anos,clasificacion e,2002-05-01,52,50,52,50,102
50801,TUPIZA,estado nutricional en menores de 5 anos,clasificacion e,2002-05-01,1,88,1,88,89
21302,UMALA,estado nutricional en menores de 5 anos,clasificacion e,2002-05-01,0,2,0,2,2
60401,URIONDO (A. CONCEPCION),estado nutricional en menores de 5 anos,clasificacion e,2002-05-01,8,17,8,17,25
71502,URUBICHA,estado nutricional en menores de 5 anos,clasificacion e,2002-05-01,0,8,0,8,8
51201,UYUNI,estado nutricional en menores de 5 anos,clasificacion e,2002-05-01,0,53,0,53,53
30502,VACAS,estado nutricional en menores de 5 anos,clasificacion e,2002-05-01,3,16,3,16,19
70801,VALLEGRANDE,estado nutricional en menores de 5 anos,clasificacion e,2002-05-01,12,12,12,12,24
20801,VIACHA,estado nutricional en menores de 5 anos,clasificacion e,2002-05-01,3,39,3,39,42
31302,VILA VILA,estado nutricional en menores de 5 anos,clasificacion e,2002-05-01,8,12,8,12,20
60303,VILLA MONTES,estado nutricional en menores de 5 anos,clasificacion e,2002-05-01,5,15,5,15,20
31402,VILLA RIVERO,estado nutricional en menores de 5 anos,clasificacion e,2002-05-01,0,6,0,6,6
10801,VILLA SERRANO,estado nutricional en menores de 5 anos,clasificacion e,2002-05-01,34,52,34,52,86
31003,VILLA TUNARI,estado nutricional en menores de 5 anos,clasificacion e,2002-05-01,52,35,52,35,87
11001,VILLA VACA GUZMAN (MUYUPAMPA),estado nutricional en menores de 5 anos,clasificacion e,2002-05-01,29,18,29,18,47
51501,VILLAZON,estado nutricional en menores de 5 anos,clasificacion e,2002-05-01,7,58,7,58,65
30904,VINTO,estado nutricional en menores de 5 anos,clasificacion e,2002-05-01,84,33,84,33,117
50602,VITICHI,estado nutricional en menores de 5 anos,clasificacion e,2002-05-01,3,40,3,40,43
20306,WALDO BALLIVIAN,estado nutricional en menores de 5 anos,clasificacion e,2002-05-01,0,1,0,1,1
70201,WARNES,estado nutricional en menores de 5 anos,clasificacion e,2002-05-01,25,14,25,14,39
20903,YACO,estado nutricional en menores de 5 anos,clasificacion e,2002-05-01,0,6,0,6,6
60301,YACUIBA,estado nutricional en menores de 5 anos,clasificacion e,2002-05-01,22,10,22,10,32
10602,YAMPARAEZ,estado nutricional en menores de 5 anos,clasificacion e,2002-05-01,64,44,64,44,108
21103,YANACACHI,estado nutricional en menores de 5 anos,clasificacion e,2002-05-01,1,5,1,5,6
70403,YAPACANI,estado nutricional en menores de 5 anos,clasificacion e,2002-05-01,1,33,1,33,34
50103,YOCALLA,estado nutricional en menores de 5 anos,clasificacion e,2002-05-01,0,21,0,21,21
10102,YOTALA,estado nutricional en menores de 5 anos,clasificacion e,2002-05-01,26,32,26,32,58
60402,YUNCHARA,estado nutricional en menores de 5 anos,clasificacion e,2002-05-01,4,11,4,11,15
10301,ZUDAÃ‘EZ,estado nutricional en menores de 5 anos,clasificacion e,2002-05-01,35,50,35,50,85
51302,ACACIO,estado nutricional en menores de 5 anos,clasificacion e,2002-06-01,11,46,11,46,57
20201,ACHACACHI,estado nutricional en menores de 5 anos,clasificacion e,2002-06-01,26,15,26,15,41
20104,ACHOCALLA,estado nutricional en menores de 5 anos,clasificacion e,2002-06-01,4,0,4,0,4
30201,AIQUILE,estado nutricional en menores de 5 anos,clasificacion e,2002-06-01,5,5,5,5,10
31303,ALALAY,estado nutricional en menores de 5 anos,clasificacion e,2002-06-01,1,4,1,4,5
10404,ALCALA,estado nutricional en menores de 5 anos,clasificacion e,2002-06-01,14,9,14,9,23
20202,ANCORAIMES,estado nutricional en menores de 5 anos,clasificacion e,2002-06-01,11,23,11,23,34
41201,ANDAMARCA,estado nutricional en menores de 5 anos,clasificacion e,2002-06-01,6,1,6,1,7
40603,ANTEQUERA,estado nutricional en menores de 5 anos,clasificacion e,2002-06-01,0,1,0,1,1
30402,ANZALDO,estado nutricional en menores de 5 anos,clasificacion e,2002-06-01,2,33,2,33,35
20701,APOLO,estado nutricional en menores de 5 anos,clasificacion e,2002-06-01,18,7,18,7,25
51301,ARAMPAMPA,estado nutricional en menores de 5 anos,clasificacion e,2002-06-01,13,6,13,6,19
30501,ARANI,estado nutricional en menores de 5 anos,clasificacion e,2002-06-01,1,9,1,9,10
30403,ARBIETO,estado nutricional en menores de 5 anos,clasificacion e,2002-06-01,0,1,0,1,1
30601,ARQUE,estado nutricional en menores de 5 anos,clasificacion e,2002-06-01,23,6,23,6,29
71501,ASCENCION DE GUARAYOS,estado nutricional en menores de 5 anos,clasificacion e,2002-06-01,56,62,56,62,118
50802,ATOCHA,estado nutricional en menores de 5 anos,clasificacion e,2002-06-01,1,13,1,13,14
20503,AUCAPATA,estado nutricional en menores de 5 anos,clasificacion e,2002-06-01,5,1,5,1,6
20502,AYATA,estado nutricional en menores de 5 anos,clasificacion e,2002-06-01,4,5,4,5,9
21303,AYO AYO,estado nutricional en menores de 5 anos,clasificacion e,2002-06-01,9,1,9,1,10
30301,AYOPAYA (V. DE INDEPENDENCIA),estado nutricional en menores de 5 anos,clasificacion e,2002-06-01,33,26,33,26,59
10201,AZURDUY,estado nutricional en menores de 5 anos,clasificacion e,2002-06-01,73,49,73,49,122
21203,BATALLAS,estado nutricional en menores de 5 anos,clasificacion e,2002-06-01,0,15,0,15,15
80802,BAURES,estado nutricional en menores de 5 anos,clasificacion e,2002-06-01,7,6,7,6,13
50104,BELEN DE URMIRI,estado nutricional en menores de 5 anos,clasificacion e,2002-06-01,1,5,1,5,6
90104,BELLA FLOR,estado nutricional en menores de 5 anos,clasificacion e,2002-06-01,0,1,0,1,1
60202,BERMEJO,estado nutricional en menores de 5 anos,clasificacion e,2002-06-01,1,4,1,4,5
50301,BETANZOS,estado nutricional en menores de 5 anos,clasificacion e,2002-06-01,54,70,54,70,124
31501,BOLIVAR,estado nutricional en menores de 5 anos,clasificacion e,2002-06-01,14,16,14,16,30
70703,CABEZAS,estado nutricional en menores de 5 anos,clasificacion e,2002-06-01,0,20,0,20,20
20905,CAIROMA,estado nutricional en menores de 5 anos,clasificacion e,2002-06-01,9,18,9,18,27
51102,"CAIZA ""D""",estado nutricional en menores de 5 anos,clasificacion e,2002-06-01,13,15,13,15,28
21003,CAJUATA,estado nutricional en menores de 5 anos,clasificacion e,2002-06-01,8,5,8,5,13
20303,CALACOTO,estado nutricional en menores de 5 anos,clasificacion e,2002-06-01,1,3,1,3,4
21304,CALAMARCA,estado nutricional en menores de 5 anos,clasificacion e,2002-06-01,10,3,10,3,13
10701,CAMARGO,estado nutricional en menores de 5 anos,clasificacion e,2002-06-01,4,25,4,25,29
10901,CAMATAQUI (C. VILLA ABECIA),estado nutricional en menores de 5 anos,clasificacion e,2002-06-01,9,9,9,9,18
70706,CAMIRI,estado nutricional en menores de 5 anos,clasificacion e,2002-06-01,5,18,5,18,23
30701,CAPINOTA,estado nutricional en menores de 5 anos,clasificacion e,2002-06-01,9,26,9,26,35
20302,CAQUIAVIRI,estado nutricional en menores de 5 anos,clasificacion e,2002-06-01,6,4,6,4,10
40102,CARACOLLO,estado nutricional en menores de 5 anos,clasificacion e,2002-06-01,4,10,4,10,14
22001,CARANAVI,estado nutricional en menores de 5 anos,clasificacion e,2002-06-01,33,28,33,28,61
60302,CARAPARI,estado nutricional en menores de 5 anos,clasificacion e,2002-06-01,4,9,4,9,13
50702,CARIPUYO,estado nutricional en menores de 5 anos,clasificacion e,2002-06-01,1,55,1,55,56
21902,CATACORA,estado nutricional en menores de 5 anos,clasificacion e,2002-06-01,3,1,3,1,4
40201,CHALLAPATA,estado nutricional en menores de 5 anos,clasificacion e,2002-06-01,12,20,12,20,32
50302,CHAQUI,estado nutricional en menores de 5 anos,clasificacion e,2002-06-01,23,14,23,14,37
70702,CHARAGUA,estado nutricional en menores de 5 anos,clasificacion e,2002-06-01,1,48,1,48,49
20305,CHARAÃ‘A,estado nutricional en menores de 5 anos,clasificacion e,2002-06-01,1,0,1,0,1
50202,CHAYANTA,estado nutricional en menores de 5 anos,clasificacion e,2002-06-01,9,43,9,43,52
31204,CHIMORE,estado nutricional en menores de 5 anos,clasificacion e,2002-06-01,8,1,8,1,9
40903,CHIPAYA,estado nutricional en menores de 5 anos,clasificacion e,2002-06-01,0,3,0,3,3
40302,CHOQUE COTA,estado nutricional en menores de 5 anos,clasificacion e,2002-06-01,1,0,1,0,1
21101,CHULUMANI (V. DE LA LIBERTAD),estado nutricional en menores de 5 anos,clasificacion e,2002-06-01,0,6,0,6,6
20501,CHUMA,estado nutricional en menores de 5 anos,clasificacion e,2002-06-01,2,8,2,8,10
30801,CLIZA,estado nutricional en menores de 5 anos,clasificacion e,2002-06-01,2,10,2,10,12
90101,COBIJA,estado nutricional en menores de 5 anos,clasificacion e,2002-06-01,11,6,11,6,17
30101,COCHABAMBA,estado nutricional en menores de 5 anos,clasificacion e,2002-06-01,43,45,43,45,88
30905,COLCAPIRHUA,estado nutricional en menores de 5 anos,clasificacion e,2002-06-01,19,13,19,13,32
50901,"COLCHA ""K""",estado nutricional en menores de 5 anos,clasificacion e,2002-06-01,1,23,1,23,24
21307,COLLANA,estado nutricional en menores de 5 anos,clasificacion e,2002-06-01,1,0,1,0,1
31002,COLOMI,estado nutricional en menores de 5 anos,clasificacion e,2002-06-01,9,7,9,7,16
50401,COLQUECHACA,estado nutricional en menores de 5 anos,clasificacion e,2002-06-01,60,6,60,6,66
21306,COLQUENCHA,estado nutricional en menores de 5 anos,clasificacion e,2002-06-01,8,3,8,3,11
21004,COLQUIRI,estado nutricional en menores de 5 anos,clasificacion e,2002-06-01,14,10,14,10,24
20304,COMANCHE,estado nutricional en menores de 5 anos,clasificacion e,2002-06-01,3,2,3,2,5
71301,COMARAPA,estado nutricional en menores de 5 anos,clasificacion e,2002-06-01,7,13,7,13,20
20605,COMBAYA,estado nutricional en menores de 5 anos,clasificacion e,2002-06-01,1,3,1,3,4
71101,CONCEPCION,estado nutricional en menores de 5 anos,clasificacion e,2002-06-01,0,1,0,1,1
21701,COPACABANA,estado nutricional en menores de 5 anos,clasificacion e,2002-06-01,0,4,0,4,4
20301,CORO CORO,estado nutricional en menores de 5 anos,clasificacion e,2002-06-01,5,2,5,2,7
21401,COROICO,estado nutricional en menores de 5 anos,clasificacion e,2002-06-01,2,4,2,4,6
40301,CORQUE,estado nutricional en menores de 5 anos,clasificacion e,2002-06-01,4,10,4,10,14
50601,COTAGAITA,estado nutricional en menores de 5 anos,clasificacion e,2002-06-01,28,79,28,79,107
70102,COTOCA,estado nutricional en menores de 5 anos,clasificacion e,2002-06-01,12,11,12,11,23
31405,CUCHUMUELA (V. G. VILLARROEL),estado nutricional en menores de 5 anos,clasificacion e,2002-06-01,1,9,1,9,10
70704,CUEVO,estado nutricional en menores de 5 anos,clasificacion e,2002-06-01,2,1,2,1,3
10902,CULPINA,estado nutricional en menores de 5 anos,clasificacion e,2002-06-01,61,38,61,38,99
40401,CURAHUARA DE CARANGAS,estado nutricional en menores de 5 anos,clasificacion e,2002-06-01,2,1,2,1,3
21602,CURVA,estado nutricional en menores de 5 anos,clasificacion e,2002-06-01,1,4,1,4,5
20804,DESAGUADERO,estado nutricional en menores de 5 anos,clasificacion e,2002-06-01,0,8,0,8,8
20105,EL ALTO,estado nutricional en menores de 5 anos,clasificacion e,2002-06-01,426,278,426,278,704
40103,EL CHORO,estado nutricional en menores de 5 anos,clasificacion e,2002-06-01,1,0,1,0,1
71503,EL PUENTE(STC),estado nutricional en menores de 5 anos,clasificacion e,2002-06-01,1,25,1,25,26
60502,EL PUENTE(TJA),estado nutricional en menores de 5 anos,clasificacion e,2002-06-01,12,18,12,18,30
70105,EL TORNO,estado nutricional en menores de 5 anos,clasificacion e,2002-06-01,11,11,11,11,22
10405,EL VILLAR,estado nutricional en menores de 5 anos,clasificacion e,2002-06-01,28,31,28,31,59
60601,ENTRE RIOS,estado nutricional en menores de 5 anos,clasificacion e,2002-06-01,5,5,5,5,10
41101,EUCALIPTUS,estado nutricional en menores de 5 anos,clasificacion e,2002-06-01,1,4,1,4,5
80402,EXALTACION,estado nutricional en menores de 5 anos,clasificacion e,2002-06-01,4,4,4,4,8
90203,FILADELFIA,estado nutricional en menores de 5 anos,clasificacion e,2002-06-01,0,6,0,6,6
71002,GENERAL SAAVEDRA,estado nutricional en menores de 5 anos,clasificacion e,2002-06-01,8,12,8,12,20
20602,GUANAY,estado nutricional en menores de 5 anos,clasificacion e,2002-06-01,46,42,46,42,88
20802,GUAQUI,estado nutricional en menores de 5 anos,clasificacion e,2002-06-01,4,4,4,4,8
80202,GUAYARAMERIN,estado nutricional en menores de 5 anos,clasificacion e,2002-06-01,17,11,17,11,28
70705,GUTIERREZ,estado nutricional en menores de 5 anos,clasificacion e,2002-06-01,10,60,10,60,70
10502,HUACARETA,estado nutricional en menores de 5 anos,clasificacion e,2002-06-01,25,21,25,21,46
11002,HUACAYA (VILLA DE HUACAYA),estado nutricional en menores de 5 anos,clasificacion e,2002-06-01,3,5,3,5,8
40501,HUACHACALLA,estado nutricional en menores de 5 anos,clasificacion e,2002-06-01,1,0,1,0,1
80803,HUARACAJE,estado nutricional en menores de 5 anos,clasificacion e,2002-06-01,2,3,2,3,5
41601,HUAYLLAMARCA,estado nutricional en menores de 5 anos,clasificacion e,2002-06-01,1,1,1,1,2
21005,ICHOCA,estado nutricional en menores de 5 anos,clasificacion e,2002-06-01,4,2,4,2,6
10304,ICLA,estado nutricional en menores de 5 anos,clasificacion e,2002-06-01,65,71,65,71,136
10703,INCAHUASI,estado nutricional en menores de 5 anos,clasificacion e,2002-06-01,52,61,52,61,113
21001,INQUISIVI,estado nutricional en menores de 5 anos,clasificacion e,2002-06-01,12,42,12,42,54
21102,IRUPANA (VILLA DE LANZA),estado nutricional en menores de 5 anos,clasificacion e,2002-06-01,0,1,0,1,1
21501,IXIAMAS,estado nutricional en menores de 5 anos,clasificacion e,2002-06-01,5,4,5,4,9
21105,LA ASUNTA,estado nutricional en menores de 5 anos,clasificacion e,2002-06-01,10,15,10,15,25
70104,LA GUARDIA,estado nutricional en menores de 5 anos,clasificacion e,2002-06-01,10,8,10,8,18
20101,LA PAZ,estado nutricional en menores de 5 anos,clasificacion e,2002-06-01,300,167,300,167,467
70701,LAGUNILLAS,estado nutricional en menores de 5 anos,clasificacion e,2002-06-01,4,2,4,2,6
21202,LAJA,estado nutricional en menores de 5 anos,clasificacion e,2002-06-01,0,3,0,3,3
10903,LAS CARRERAS,estado nutricional en menores de 5 anos,clasificacion e,2002-06-01,9,3,9,3,12
50203,LLALLAGUA,estado nutricional en menores de 5 anos,clasificacion e,2002-06-01,0,18,0,18,18
51401,LLICA,estado nutricional en menores de 5 anos,clasificacion e,2002-06-01,1,0,1,0,1
80601,LORETO,estado nutricional en menores de 5 anos,clasificacion e,2002-06-01,1,1,1,1,2
20901,LURIBAY,estado nutricional en menores de 5 anos,clasificacion e,2002-06-01,3,5,3,5,8
11003,MACHARETI,estado nutricional en menores de 5 anos,clasificacion e,2002-06-01,12,27,12,27,39
80801,MAGDALENA,estado nutricional en menores de 5 anos,clasificacion e,2002-06-01,5,7,5,7,12
70903,MAIRANA,estado nutricional en menores de 5 anos,clasificacion e,2002-06-01,4,3,4,3,7
20103,MECAPACA,estado nutricional en menores de 5 anos,clasificacion e,2002-06-01,1,9,1,9,10
71003,MINEROS,estado nutricional en menores de 5 anos,clasificacion e,2002-06-01,17,7,17,7,24
31301,MIZQUE,estado nutricional en menores de 5 anos,clasificacion e,2002-06-01,1,12,1,12,13
20402,MOCOMOCO,estado nutricional en menores de 5 anos,clasificacion e,2002-06-01,15,3,15,3,18
51002,MOJINETE,estado nutricional en menores de 5 anos,clasificacion e,2002-06-01,0,1,0,1,1
10303,MOJOCOYA,estado nutricional en menores de 5 anos,clasificacion e,2002-06-01,23,29,23,29,52
10501,MONTEAGUDO,estado nutricional en menores de 5 anos,clasificacion e,2002-06-01,36,39,36,39,75
71001,MONTERO,estado nutricional en menores de 5 anos,clasificacion e,2002-06-01,24,65,24,65,89
70803,MORO MORO,estado nutricional en menores de 5 anos,clasificacion e,2002-06-01,4,9,4,9,13
30302,MOROCHATA,estado nutricional en menores de 5 anos,clasificacion e,2002-06-01,9,27,9,27,36
90401,NACEBE (SANTA ROSA DEL ABUNA),estado nutricional en menores de 5 anos,clasificacion e,2002-06-01,0,1,0,1,1
90501,NUEVO MANOA (NUEVA ESPERANZA),estado nutricional en menores de 5 anos,clasificacion e,2002-06-01,0,3,0,3,3
50404,OCURI,estado nutricional en menores de 5 anos,clasificacion e,2002-06-01,32,55,32,55,87
70202,OKINAWA,estado nutricional en menores de 5 anos,clasificacion e,2002-06-01,3,3,3,3,6
40101,ORURO,estado nutricional en menores de 5 anos,clasificacion e,2002-06-01,101,55,101,55,156
60201,PADCAYA,estado nutricional en menores de 5 anos,clasificacion e,2002-06-01,8,13,8,13,21
10401,PADILLA,estado nutricional en menores de 5 anos,clasificacion e,2002-06-01,47,47,47,47,94
70502,PAILON,estado nutricional en menores de 5 anos,clasificacion e,2002-06-01,5,3,5,3,8
20102,PALCA,estado nutricional en menores de 5 anos,clasificacion e,2002-06-01,2,5,2,5,7
21104,PALOS BLANCOS,estado nutricional en menores de 5 anos,clasificacion e,2002-06-01,17,14,17,14,31
40802,PAMPA AULLAGAS,estado nutricional en menores de 5 anos,clasificacion e,2002-06-01,5,1,5,1,6
70902,PAMPA GRANDE,estado nutricional en menores de 5 anos,clasificacion e,2002-06-01,1,2,1,2,3
21802,PAPEL PAMPA,estado nutricional en menores de 5 anos,clasificacion e,2002-06-01,0,1,0,1,1
30202,PASORAPA,estado nutricional en menores de 5 anos,clasificacion e,2002-06-01,5,5,5,5,10
21305,PATACAMAYA,estado nutricional en menores de 5 anos,clasificacion e,2002-06-01,7,8,7,8,15
40602,PAZÃ‘A,estado nutricional en menores de 5 anos,clasificacion e,2002-06-01,3,6,3,6,9
20702,PELECHUCO,estado nutricional en menores de 5 anos,clasificacion e,2002-06-01,7,13,7,13,20
50403,POCOATA,estado nutricional en menores de 5 anos,clasificacion e,2002-06-01,55,60,55,60,115
31203,POCONA,estado nutricional en menores de 5 anos,clasificacion e,2002-06-01,17,12,17,12,29
31202,POJO (CBBA),estado nutricional en menores de 5 anos,clasificacion e,2002-06-01,23,14,23,14,37
40601,POOPO,estado nutricional en menores de 5 anos,clasificacion e,2002-06-01,0,6,0,6,6
51203,PORCO,estado nutricional en menores de 5 anos,clasificacion e,2002-06-01,6,12,6,12,18
10103,POROMA,estado nutricional en menores de 5 anos,clasificacion e,2002-06-01,49,75,49,75,124
70103,PORONGO,estado nutricional en menores de 5 anos,clasificacion e,2002-06-01,1,0,1,0,1
70601,PORTACHUELO,estado nutricional en menores de 5 anos,clasificacion e,2002-06-01,8,7,8,7,15
70804,POSTRER VALLE,estado nutricional en menores de 5 anos,clasificacion e,2002-06-01,1,3,1,3,4
50101,POTOSI,estado nutricional en menores de 5 anos,clasificacion e,2002-06-01,150,107,150,107,257
10302,PRESTO,estado nutricional en menores de 5 anos,clasificacion e,2002-06-01,30,31,30,31,61
21201,PUCARANI,estado nutricional en menores de 5 anos,clasificacion e,2002-06-01,2,18,2,18,20
20401,PUERTO ACOSTA,estado nutricional en menores de 5 anos,clasificacion e,2002-06-01,14,6,14,6,20
20403,PUERTO CARABUCO,estado nutricional en menores de 5 anos,clasificacion e,2002-06-01,10,21,10,21,31
90301,PUERTO GONZALO MORENO,estado nutricional en menores de 5 anos,clasificacion e,2002-06-01,2,0,2,0,2
21204,PUERTO PEREZ,estado nutricional en menores de 5 anos,clasificacion e,2002-06-01,0,1,0,1,1
71402,PUERTO QUIJARRO,estado nutricional en menores de 5 anos,clasificacion e,2002-06-01,15,1,15,1,16
90201,PUERTO RICO,estado nutricional en menores de 5 anos,clasificacion e,2002-06-01,4,2,4,2,6
71401,PUERTO SUAREZ,estado nutricional en menores de 5 anos,clasificacion e,2002-06-01,4,4,4,4,8
31205,PUERTO VILLARROEL,estado nutricional en menores de 5 anos,clasificacion e,2002-06-01,42,29,42,29,71
51101,PUNA,estado nutricional en menores de 5 anos,clasificacion e,2002-06-01,7,62,7,62,69
31401,PUNATA,estado nutricional en menores de 5 anos,clasificacion e,2002-06-01,7,14,7,14,21
20604,QUIABAYA,estado nutricional en menores de 5 anos,clasificacion e,2002-06-01,8,4,8,4,12
30901,QUILLACOLLO,estado nutricional en menores de 5 anos,clasificacion e,2002-06-01,13,13,13,13,26
21002,QUIME,estado nutricional en menores de 5 anos,clasificacion e,2002-06-01,12,14,12,14,26
50402,RAVELO,estado nutricional en menores de 5 anos,clasificacion e,2002-06-01,80,151,80,151,231
80301,REYES,estado nutricional en menores de 5 anos,clasificacion e,2002-06-01,4,4,4,4,8
80201,RIBERALTA,estado nutricional en menores de 5 anos,clasificacion e,2002-06-01,109,56,109,56,165
70503,ROBORE,estado nutricional en menores de 5 anos,clasificacion e,2002-06-01,2,6,2,6,8
80304,RURRENABAQUE,estado nutricional en menores de 5 anos,clasificacion e,2002-06-01,4,3,4,3,7
31001,SACABA,estado nutricional en menores de 5 anos,clasificacion e,2002-06-01,14,33,14,33,47
30404,SACABAMBA,estado nutricional en menores de 5 anos,clasificacion e,2002-06-01,0,21,0,21,21
50701,SACACA,estado nutricional en menores de 5 anos,clasificacion e,2002-06-01,100,117,100,117,217
71302,SAIPINA,estado nutricional en menores de 5 anos,clasificacion e,2002-06-01,1,1,1,1,2
40801,SALINAS DE GARCI MENDOZA,estado nutricional en menores de 5 anos,clasificacion e,2002-06-01,3,1,3,1,4
51601,SAN AGUSTIN,estado nutricional en menores de 5 anos,clasificacion e,2002-06-01,0,1,0,1,1
80602,SAN ANDRES,estado nutricional en menores de 5 anos,clasificacion e,2002-06-01,4,8,4,8,12
51003,SAN ANTONIO DE ESMORUCO,estado nutricional en menores de 5 anos,clasificacion e,2002-06-01,0,1,0,1,1
71105,SAN ANTONIO DE LOMERIO,estado nutricional en menores de 5 anos,clasificacion e,2002-06-01,33,25,33,25,58
31403,SAN BENITO,estado nutricional en menores de 5 anos,clasificacion e,2002-06-01,2,5,2,5,7
80302,SAN BORJA,estado nutricional en menores de 5 anos,clasificacion e,2002-06-01,36,21,36,21,57
21502,SAN BUENA VENTURA,estado nutricional en menores de 5 anos,clasificacion e,2002-06-01,6,5,6,5,11
80501,SAN IGNACIO,estado nutricional en menores de 5 anos,clasificacion e,2002-06-01,6,28,6,28,34
70301,SAN IGNACIO DE VELASCO,estado nutricional en menores de 5 anos,clasificacion e,2002-06-01,70,46,70,46,116
80102,SAN JAVIER(BNI),estado nutricional en menores de 5 anos,clasificacion e,2002-06-01,9,6,9,6,15
71102,SAN JAVIER(STC),estado nutricional en menores de 5 anos,clasificacion e,2002-06-01,15,5,15,5,20
70501,SAN JOSE DE CHIQUITOS,estado nutricional en menores de 5 anos,clasificacion e,2002-06-01,16,1,16,1,17
71104,SAN JULIAN,estado nutricional en menores de 5 anos,clasificacion e,2002-06-01,20,20,20,20,40
90302,SAN LORENZO(PND),estado nutricional en menores de 5 anos,clasificacion e,2002-06-01,0,1,0,1,1
60501,SAN LORENZO(TJA),estado nutricional en menores de 5 anos,clasificacion e,2002-06-01,11,8,11,8,19
10702,SAN LUCAS,estado nutricional en menores de 5 anos,clasificacion e,2002-06-01,156,119,156,119,275
70302,SAN MIGUEL DE VELASCO,estado nutricional en menores de 5 anos,clasificacion e,2002-06-01,13,11,13,11,24
51001,SAN PABLO DE LIPEZ,estado nutricional en menores de 5 anos,clasificacion e,2002-06-01,0,6,0,6,6
50501,SAN PEDRO DE BUENA VISTA,estado nutricional en menores de 5 anos,clasificacion e,2002-06-01,1,95,1,95,96
21801,SAN PEDRO DE CURAHUARA,estado nutricional en menores de 5 anos,clasificacion e,2002-06-01,2,4,2,4,6
90202,SAN PEDRO(PND),estado nutricional en menores de 5 anos,clasificacion e,2002-06-01,5,4,5,4,9
70303,SAN RAFAEL,estado nutricional en menores de 5 anos,clasificacion e,2002-06-01,13,8,13,8,21
80702,SAN RAMON,estado nutricional en menores de 5 anos,clasificacion e,2002-06-01,5,4,5,4,9
80401,SANTA ANA,estado nutricional en menores de 5 anos,clasificacion e,2002-06-01,0,1,0,1,1
70101,SANTA CRUZ DE LA SIERRA,estado nutricional en menores de 5 anos,clasificacion e,2002-06-01,51,39,51,39,90
80303,SANTA ROSA,estado nutricional en menores de 5 anos,clasificacion e,2002-06-01,5,1,5,1,6
70602,SANTA ROSA DEL SARA,estado nutricional en menores de 5 anos,clasificacion e,2002-06-01,5,6,5,6,11
20308,SANTIAGO DE CALLAPA,estado nutricional en menores de 5 anos,clasificacion e,2002-06-01,1,0,1,0,1
41401,SANTIAGO DE HUARI,estado nutricional en menores de 5 anos,clasificacion e,2002-06-01,3,4,3,4,7
21901,SANTIAGO DE MACHACA,estado nutricional en menores de 5 anos,clasificacion e,2002-06-01,1,0,1,0,1
30702,SANTIVAÃ‘ES,estado nutricional en menores de 5 anos,clasificacion e,2002-06-01,7,5,7,5,12
40202,SANTUARIO DE QUILLACAS,estado nutricional en menores de 5 anos,clasificacion e,2002-06-01,0,1,0,1,1
20902,SAPAHAQUI,estado nutricional en menores de 5 anos,clasificacion e,2002-06-01,0,1,0,1,1
90303,SENA,estado nutricional en menores de 5 anos,clasificacion e,2002-06-01,9,4,9,4,13
21301,SICA SICA (VILLA AROMA),estado nutricional en menores de 5 anos,clasificacion e,2002-06-01,11,10,11,10,21
30703,SICAYA,estado nutricional en menores de 5 anos,clasificacion e,2002-06-01,1,12,1,12,13
30902,SIPE SIPE,estado nutricional en menores de 5 anos,clasificacion e,2002-06-01,42,26,42,26,68
10403,SOPACHUY,estado nutricional en menores de 5 anos,clasificacion e,2002-06-01,26,36,26,36,62
20601,SORATA,estado nutricional en menores de 5 anos,clasificacion e,2002-06-01,6,7,6,7,13
10101,SUCRE,estado nutricional en menores de 5 anos,clasificacion e,2002-06-01,157,107,157,107,264
31404,TACACHI,estado nutricional en menores de 5 anos,clasificacion e,2002-06-01,0,1,0,1,1
20603,TACACOMA,estado nutricional en menores de 5 anos,clasificacion e,2002-06-01,6,14,6,14,20
50303,TACOBAMBA,estado nutricional en menores de 5 anos,clasificacion e,2002-06-01,18,9,18,9,27
30602,TACOPAYA,estado nutricional en menores de 5 anos,clasificacion e,2002-06-01,10,20,10,20,30
31101,TAPACARI,estado nutricional en menores de 5 anos,clasificacion e,2002-06-01,3,58,3,58,61
10601,TARABUCO,estado nutricional en menores de 5 anos,clasificacion e,2002-06-01,140,156,140,156,296
30401,TARATA,estado nutricional en menores de 5 anos,clasificacion e,2002-06-01,13,9,13,9,22
60101,TARIJA,estado nutricional en menores de 5 anos,clasificacion e,2002-06-01,41,21,41,21,62
10202,TARVITA,estado nutricional en menores de 5 anos,clasificacion e,2002-06-01,39,38,39,38,77
20803,TIAWANACU,estado nutricional en menores de 5 anos,clasificacion e,2002-06-01,11,12,11,12,23
50102,TINGUIPAYA,estado nutricional en menores de 5 anos,clasificacion e,2002-06-01,7,50,7,50,57
30903,TIQUIPAYA,estado nutricional en menores de 5 anos,clasificacion e,2002-06-01,16,22,16,22,38
31601,TIRAQUE (CBBA),estado nutricional en menores de 5 anos,clasificacion e,2002-06-01,23,30,23,30,53
21703,TITO YUPANQUI (PARQUIPUJIO),estado nutricional en menores de 5 anos,clasificacion e,2002-06-01,3,1,3,1,4
30802,TOCO,estado nutricional en menores de 5 anos,clasificacion e,2002-06-01,1,5,1,5,6
30803,TOLATA,estado nutricional en menores de 5 anos,clasificacion e,2002-06-01,1,0,1,0,1
41001,TOLEDO,estado nutricional en menores de 5 anos,clasificacion e,2002-06-01,1,0,1,0,1
51202,TOMAVE,estado nutricional en menores de 5 anos,clasificacion e,2002-06-01,1,58,1,58,59
10402,TOMINA,estado nutricional en menores de 5 anos,clasificacion e,2002-06-01,37,40,37,40,77
50502,TORO TORO,estado nutricional en menores de 5 anos,clasificacion e,2002-06-01,0,5,0,5,5
31201,TOTORA(CBBA),estado nutricional en menores de 5 anos,clasificacion e,2002-06-01,12,11,12,11,23
41301,TOTORA(ORR),estado nutricional en menores de 5 anos,clasificacion e,2002-06-01,6,2,6,2,8
70802,TRIGAL,estado nutricional en menores de 5 anos,clasificacion e,2002-06-01,1,0,1,0,1
80101,TRINIDAD,estado nutricional en menores de 5 anos,clasificacion e,2002-06-01,23,50,23,50,73
50801,TUPIZA,estado nutricional en menores de 5 anos,clasificacion e,2002-06-01,0,43,0,43,43
40402,TURCO,estado nutricional en menores de 5 anos,clasificacion e,2002-06-01,1,1,1,1,2
21302,UMALA,estado nutricional en menores de 5 anos,clasificacion e,2002-06-01,0,2,0,2,2
50201,UNCIA,estado nutricional en menores de 5 anos,clasificacion e,2002-06-01,10,39,10,39,49
60401,URIONDO (A. CONCEPCION),estado nutricional en menores de 5 anos,clasificacion e,2002-06-01,2,5,2,5,7
71502,URUBICHA,estado nutricional en menores de 5 anos,clasificacion e,2002-06-01,18,52,18,52,70
51201,UYUNI,estado nutricional en menores de 5 anos,clasificacion e,2002-06-01,13,32,13,32,45
30502,VACAS,estado nutricional en menores de 5 anos,clasificacion e,2002-06-01,1,9,1,9,10
70801,VALLEGRANDE,estado nutricional en menores de 5 anos,clasificacion e,2002-06-01,4,14,4,14,18
20801,VIACHA,estado nutricional en menores de 5 anos,clasificacion e,2002-06-01,1,24,1,24,25
31302,VILA VILA,estado nutricional en menores de 5 anos,clasificacion e,2002-06-01,6,1,6,1,7
60303,VILLA MONTES,estado nutricional en menores de 5 anos,clasificacion e,2002-06-01,6,2,6,2,8
31402,VILLA RIVERO,estado nutricional en menores de 5 anos,clasificacion e,2002-06-01,0,8,0,8,8
10801,VILLA SERRANO,estado nutricional en menores de 5 anos,clasificacion e,2002-06-01,49,64,49,64,113
31003,VILLA TUNARI,estado nutricional en menores de 5 anos,clasificacion e,2002-06-01,40,35,40,35,75
11001,VILLA VACA GUZMAN (MUYUPAMPA),estado nutricional en menores de 5 anos,clasificacion e,2002-06-01,41,9,41,9,50
51501,VILLAZON,estado nutricional en menores de 5 anos,clasificacion e,2002-06-01,8,38,8,38,46
30904,VINTO,estado nutricional en menores de 5 anos,clasificacion e,2002-06-01,24,8,24,8,32
50602,VITICHI,estado nutricional en menores de 5 anos,clasificacion e,2002-06-01,11,15,11,15,26
20306,WALDO BALLIVIAN,estado nutricional en menores de 5 anos,clasificacion e,2002-06-01,1,0,1,0,1
70201,WARNES,estado nutricional en menores de 5 anos,clasificacion e,2002-06-01,20,6,20,6,26
20903,YACO,estado nutricional en menores de 5 anos,clasificacion e,2002-06-01,0,11,0,11,11
60301,YACUIBA,estado nutricional en menores de 5 anos,clasificacion e,2002-06-01,17,10,17,10,27
10602,YAMPARAEZ,estado nutricional en menores de 5 anos,clasificacion e,2002-06-01,64,42,64,42,106
50103,YOCALLA,estado nutricional en menores de 5 anos,clasificacion e,2002-06-01,0,13,0,13,13
10102,YOTALA,estado nutricional en menores de 5 anos,clasificacion e,2002-06-01,25,37,25,37,62
60402,YUNCHARA,estado nutricional en menores de 5 anos,clasificacion e,2002-06-01,2,7,2,7,9
10301,ZUDAÃ‘EZ,estado nutricional en menores de 5 anos,clasificacion e,2002-06-01,43,25,43,25,68
51302,ACACIO,estado nutricional en menores de 5 anos,clasificacion e,2002-07-01,14,21,14,21,35
20201,ACHACACHI,estado nutricional en menores de 5 anos,clasificacion e,2002-07-01,17,14,17,14,31
20104,ACHOCALLA,estado nutricional en menores de 5 anos,clasificacion e,2002-07-01,3,0,3,0,3
30201,AIQUILE,estado nutricional en menores de 5 anos,clasificacion e,2002-07-01,8,16,8,16,24
31303,ALALAY,estado nutricional en menores de 5 anos,clasificacion e,2002-07-01,2,1,2,1,3
10404,ALCALA,estado nutricional en menores de 5 anos,clasificacion e,2002-07-01,15,18,15,18,33
20202,ANCORAIMES,estado nutricional en menores de 5 anos,clasificacion e,2002-07-01,13,18,13,18,31
40603,ANTEQUERA,estado nutricional en menores de 5 anos,clasificacion e,2002-07-01,0,1,0,1,1
30402,ANZALDO,estado nutricional en menores de 5 anos,clasificacion e,2002-07-01,0,24,0,24,24
20701,APOLO,estado nutricional en menores de 5 anos,clasificacion e,2002-07-01,13,10,13,10,23
51301,ARAMPAMPA,estado nutricional en menores de 5 anos,clasificacion e,2002-07-01,12,27,12,27,39
30501,ARANI,estado nutricional en menores de 5 anos,clasificacion e,2002-07-01,14,9,14,9,23
30403,ARBIETO,estado nutricional en menores de 5 anos,clasificacion e,2002-07-01,1,3,1,3,4
30601,ARQUE,estado nutricional en menores de 5 anos,clasificacion e,2002-07-01,25,17,25,17,42
50802,ATOCHA,estado nutricional en menores de 5 anos,clasificacion e,2002-07-01,0,17,0,17,17
20503,AUCAPATA,estado nutricional en menores de 5 anos,clasificacion e,2002-07-01,2,1,2,1,3
20502,AYATA,estado nutricional en menores de 5 anos,clasificacion e,2002-07-01,9,7,9,7,16
21303,AYO AYO,estado nutricional en menores de 5 anos,clasificacion e,2002-07-01,1,3,1,3,4
30301,AYOPAYA (V. DE INDEPENDENCIA),estado nutricional en menores de 5 anos,clasificacion e,2002-07-01,25,23,25,23,48
10201,AZURDUY,estado nutricional en menores de 5 anos,clasificacion e,2002-07-01,32,31,32,31,63
21203,BATALLAS,estado nutricional en menores de 5 anos,clasificacion e,2002-07-01,1,1,1,1,2
80802,BAURES,estado nutricional en menores de 5 anos,clasificacion e,2002-07-01,5,4,5,4,9
50104,BELEN DE URMIRI,estado nutricional en menores de 5 anos,clasificacion e,2002-07-01,1,4,1,4,5
60202,BERMEJO,estado nutricional en menores de 5 anos,clasificacion e,2002-07-01,1,9,1,9,10
50301,BETANZOS,estado nutricional en menores de 5 anos,clasificacion e,2002-07-01,93,95,93,95,188
31501,BOLIVAR,estado nutricional en menores de 5 anos,clasificacion e,2002-07-01,26,22,26,22,48
70707,BOYUIBE,estado nutricional en menores de 5 anos,clasificacion e,2002-07-01,0,7,0,7,7
70703,CABEZAS,estado nutricional en menores de 5 anos,clasificacion e,2002-07-01,4,4,4,4,8
20905,CAIROMA,estado nutricional en menores de 5 anos,clasificacion e,2002-07-01,10,11,10,11,21
51102,"CAIZA ""D""",estado nutricional en menores de 5 anos,clasificacion e,2002-07-01,24,13,24,13,37
21003,CAJUATA,estado nutricional en menores de 5 anos,clasificacion e,2002-07-01,6,1,6,1,7
20303,CALACOTO,estado nutricional en menores de 5 anos,clasificacion e,2002-07-01,3,1,3,1,4
21304,CALAMARCA,estado nutricional en menores de 5 anos,clasificacion e,2002-07-01,7,5,7,5,12
10701,CAMARGO,estado nutricional en menores de 5 anos,clasificacion e,2002-07-01,9,8,9,8,17
10901,CAMATAQUI (C. VILLA ABECIA),estado nutricional en menores de 5 anos,clasificacion e,2002-07-01,5,3,5,3,8
70706,CAMIRI,estado nutricional en menores de 5 anos,clasificacion e,2002-07-01,5,18,5,18,23
30701,CAPINOTA,estado nutricional en menores de 5 anos,clasificacion e,2002-07-01,11,24,11,24,35
20302,CAQUIAVIRI,estado nutricional en menores de 5 anos,clasificacion e,2002-07-01,2,2,2,2,4
40102,CARACOLLO,estado nutricional en menores de 5 anos,clasificacion e,2002-07-01,4,4,4,4,8
22001,CARANAVI,estado nutricional en menores de 5 anos,clasificacion e,2002-07-01,47,38,47,38,85
60302,CARAPARI,estado nutricional en menores de 5 anos,clasificacion e,2002-07-01,6,10,6,10,16
50702,CARIPUYO,estado nutricional en menores de 5 anos,clasificacion e,2002-07-01,27,19,27,19,46
21902,CATACORA,estado nutricional en menores de 5 anos,clasificacion e,2002-07-01,1,0,1,0,1
21803,CHACARILLA,estado nutricional en menores de 5 anos,clasificacion e,2002-07-01,0,2,0,2,2
40201,CHALLAPATA,estado nutricional en menores de 5 anos,clasificacion e,2002-07-01,15,16,15,16,31
50302,CHAQUI,estado nutricional en menores de 5 anos,clasificacion e,2002-07-01,18,8,18,8,26
70702,CHARAGUA,estado nutricional en menores de 5 anos,clasificacion e,2002-07-01,14,34,14,34,48
20305,CHARAÃ‘A,estado nutricional en menores de 5 anos,clasificacion e,2002-07-01,5,2,5,2,7
50202,CHAYANTA,estado nutricional en menores de 5 anos,clasificacion e,2002-07-01,31,17,31,17,48
31204,CHIMORE,estado nutricional en menores de 5 anos,clasificacion e,2002-07-01,5,1,5,1,6
21101,CHULUMANI (V. DE LA LIBERTAD),estado nutricional en menores de 5 anos,clasificacion e,2002-07-01,2,3,2,3,5
20501,CHUMA,estado nutricional en menores de 5 anos,clasificacion e,2002-07-01,1,15,1,15,16
30801,CLIZA,estado nutricional en menores de 5 anos,clasificacion e,2002-07-01,3,9,3,9,12
90101,COBIJA,estado nutricional en menores de 5 anos,clasificacion e,2002-07-01,11,11,11,11,22
30101,COCHABAMBA,estado nutricional en menores de 5 anos,clasificacion e,2002-07-01,59,51,59,51,110
30905,COLCAPIRHUA,estado nutricional en menores de 5 anos,clasificacion e,2002-07-01,9,25,9,25,34
50901,"COLCHA ""K""",estado nutricional en menores de 5 anos,clasificacion e,2002-07-01,4,6,4,6,10
21307,COLLANA,estado nutricional en menores de 5 anos,clasificacion e,2002-07-01,1,0,1,0,1
31002,COLOMI,estado nutricional en menores de 5 anos,clasificacion e,2002-07-01,14,9,14,9,23
50401,COLQUECHACA,estado nutricional en menores de 5 anos,clasificacion e,2002-07-01,45,25,45,25,70
21306,COLQUENCHA,estado nutricional en menores de 5 anos,clasificacion e,2002-07-01,4,4,4,4,8
21004,COLQUIRI,estado nutricional en menores de 5 anos,clasificacion e,2002-07-01,12,7,12,7,19
20304,COMANCHE,estado nutricional en menores de 5 anos,clasificacion e,2002-07-01,0,1,0,1,1
71301,COMARAPA,estado nutricional en menores de 5 anos,clasificacion e,2002-07-01,20,24,20,24,44
20605,COMBAYA,estado nutricional en menores de 5 anos,clasificacion e,2002-07-01,0,1,0,1,1
71101,CONCEPCION,estado nutricional en menores de 5 anos,clasificacion e,2002-07-01,8,5,8,5,13
21701,COPACABANA,estado nutricional en menores de 5 anos,clasificacion e,2002-07-01,1,7,1,7,8
20301,CORO CORO,estado nutricional en menores de 5 anos,clasificacion e,2002-07-01,15,4,15,4,19
21401,COROICO,estado nutricional en menores de 5 anos,clasificacion e,2002-07-01,5,3,5,3,8
40301,CORQUE,estado nutricional en menores de 5 anos,clasificacion e,2002-07-01,3,2,3,2,5
50601,COTAGAITA,estado nutricional en menores de 5 anos,clasificacion e,2002-07-01,19,25,19,25,44
70102,COTOCA,estado nutricional en menores de 5 anos,clasificacion e,2002-07-01,8,2,8,2,10
31405,CUCHUMUELA (V. G. VILLARROEL),estado nutricional en menores de 5 anos,clasificacion e,2002-07-01,5,1,5,1,6
70704,CUEVO,estado nutricional en menores de 5 anos,clasificacion e,2002-07-01,4,2,4,2,6
10902,CULPINA,estado nutricional en menores de 5 anos,clasificacion e,2002-07-01,43,35,43,35,78
40401,CURAHUARA DE CARANGAS,estado nutricional en menores de 5 anos,clasificacion e,2002-07-01,4,1,4,1,5
21602,CURVA,estado nutricional en menores de 5 anos,clasificacion e,2002-07-01,1,1,1,1,2
20804,DESAGUADERO,estado nutricional en menores de 5 anos,clasificacion e,2002-07-01,8,0,8,0,8
20105,EL ALTO,estado nutricional en menores de 5 anos,clasificacion e,2002-07-01,402,259,402,259,661
71503,EL PUENTE(STC),estado nutricional en menores de 5 anos,clasificacion e,2002-07-01,0,28,0,28,28
60502,EL PUENTE(TJA),estado nutricional en menores de 5 anos,clasificacion e,2002-07-01,8,25,8,25,33
70105,EL TORNO,estado nutricional en menores de 5 anos,clasificacion e,2002-07-01,5,15,5,15,20
10405,EL VILLAR,estado nutricional en menores de 5 anos,clasificacion e,2002-07-01,23,26,23,26,49
60601,ENTRE RIOS,estado nutricional en menores de 5 anos,clasificacion e,2002-07-01,9,7,9,7,16
41101,EUCALIPTUS,estado nutricional en menores de 5 anos,clasificacion e,2002-07-01,1,2,1,2,3
80402,EXALTACION,estado nutricional en menores de 5 anos,clasificacion e,2002-07-01,0,1,0,1,1
90203,FILADELFIA,estado nutricional en menores de 5 anos,clasificacion e,2002-07-01,0,1,0,1,1
71002,GENERAL SAAVEDRA,estado nutricional en menores de 5 anos,clasificacion e,2002-07-01,22,10,22,10,32
21601,GRAL. J.J. PEREZ (CHARAZANI),estado nutricional en menores de 5 anos,clasificacion e,2002-07-01,1,1,1,1,2
20602,GUANAY,estado nutricional en menores de 5 anos,clasificacion e,2002-07-01,38,37,38,37,75
20802,GUAQUI,estado nutricional en menores de 5 anos,clasificacion e,2002-07-01,6,1,6,1,7
80202,GUAYARAMERIN,estado nutricional en menores de 5 anos,clasificacion e,2002-07-01,33,19,33,19,52
70705,GUTIERREZ,estado nutricional en menores de 5 anos,clasificacion e,2002-07-01,22,40,22,40,62
10502,HUACARETA,estado nutricional en menores de 5 anos,clasificacion e,2002-07-01,27,21,27,21,48
11002,HUACAYA (VILLA DE HUACAYA),estado nutricional en menores de 5 anos,clasificacion e,2002-07-01,2,1,2,1,3
40501,HUACHACALLA,estado nutricional en menores de 5 anos,clasificacion e,2002-07-01,0,1,0,1,1
40701,HUANUNI,estado nutricional en menores de 5 anos,clasificacion e,2002-07-01,15,6,15,6,21
80803,HUARACAJE,estado nutricional en menores de 5 anos,clasificacion e,2002-07-01,5,0,5,0,5
41601,HUAYLLAMARCA,estado nutricional en menores de 5 anos,clasificacion e,2002-07-01,7,3,7,3,10
21005,ICHOCA,estado nutricional en menores de 5 anos,clasificacion e,2002-07-01,1,0,1,0,1
10304,ICLA,estado nutricional en menores de 5 anos,clasificacion e,2002-07-01,67,69,67,69,136
10703,INCAHUASI,estado nutricional en menores de 5 anos,clasificacion e,2002-07-01,31,48,31,48,79
21001,INQUISIVI,estado nutricional en menores de 5 anos,clasificacion e,2002-07-01,16,35,16,35,51
21102,IRUPANA (VILLA DE LANZA),estado nutricional en menores de 5 anos,clasificacion e,2002-07-01,0,1,0,1,1
21501,IXIAMAS,estado nutricional en menores de 5 anos,clasificacion e,2002-07-01,5,6,5,6,11
21105,LA ASUNTA,estado nutricional en menores de 5 anos,clasificacion e,2002-07-01,7,11,7,11,18
70104,LA GUARDIA,estado nutricional en menores de 5 anos,clasificacion e,2002-07-01,11,7,11,7,18
20101,LA PAZ,estado nutricional en menores de 5 anos,clasificacion e,2002-07-01,237,140,237,140,377
70701,LAGUNILLAS,estado nutricional en menores de 5 anos,clasificacion e,2002-07-01,7,4,7,4,11
21202,LAJA,estado nutricional en menores de 5 anos,clasificacion e,2002-07-01,2,0,2,0,2
10903,LAS CARRERAS,estado nutricional en menores de 5 anos,clasificacion e,2002-07-01,7,6,7,6,13
21006,LICOMA PAMPA,estado nutricional en menores de 5 anos,clasificacion e,2002-07-01,1,0,1,0,1
50203,LLALLAGUA,estado nutricional en menores de 5 anos,clasificacion e,2002-07-01,4,75,4,75,79
80601,LORETO,estado nutricional en menores de 5 anos,clasificacion e,2002-07-01,0,2,0,2,2
20901,LURIBAY,estado nutricional en menores de 5 anos,clasificacion e,2002-07-01,2,6,2,6,8
40702,MACHACAMARCA,estado nutricional en menores de 5 anos,clasificacion e,2002-07-01,2,3,2,3,5
11003,MACHARETI,estado nutricional en menores de 5 anos,clasificacion e,2002-07-01,5,11,5,11,16
80801,MAGDALENA,estado nutricional en menores de 5 anos,clasificacion e,2002-07-01,8,4,8,4,12
70903,MAIRANA,estado nutricional en menores de 5 anos,clasificacion e,2002-07-01,5,1,5,1,6
20103,MECAPACA,estado nutricional en menores de 5 anos,clasificacion e,2002-07-01,2,3,2,3,5
71003,MINEROS,estado nutricional en menores de 5 anos,clasificacion e,2002-07-01,39,11,39,11,50
31301,MIZQUE,estado nutricional en menores de 5 anos,clasificacion e,2002-07-01,34,16,34,16,50
20402,MOCOMOCO,estado nutricional en menores de 5 anos,clasificacion e,2002-07-01,13,11,13,11,24
51002,MOJINETE,estado nutricional en menores de 5 anos,clasificacion e,2002-07-01,0,1,0,1,1
10303,MOJOCOYA,estado nutricional en menores de 5 anos,clasificacion e,2002-07-01,23,17,23,17,40
10501,MONTEAGUDO,estado nutricional en menores de 5 anos,clasificacion e,2002-07-01,39,45,39,45,84
71001,MONTERO,estado nutricional en menores de 5 anos,clasificacion e,2002-07-01,26,36,26,36,62
70803,MORO MORO,estado nutricional en menores de 5 anos,clasificacion e,2002-07-01,4,5,4,5,9
30302,MOROCHATA,estado nutricional en menores de 5 anos,clasificacion e,2002-07-01,25,19,25,19,44
90501,NUEVO MANOA (NUEVA ESPERANZA),estado nutricional en menores de 5 anos,clasificacion e,2002-07-01,1,3,1,3,4
50404,OCURI,estado nutricional en menores de 5 anos,clasificacion e,2002-07-01,42,24,42,24,66
70202,OKINAWA,estado nutricional en menores de 5 anos,clasificacion e,2002-07-01,3,7,3,7,10
30203,OMEREQUE,estado nutricional en menores de 5 anos,clasificacion e,2002-07-01,0,1,0,1,1
40101,ORURO,estado nutricional en menores de 5 anos,clasificacion e,2002-07-01,93,47,93,47,140
60201,PADCAYA,estado nutricional en menores de 5 anos,clasificacion e,2002-07-01,6,7,6,7,13
10401,PADILLA,estado nutricional en menores de 5 anos,clasificacion e,2002-07-01,28,51,28,51,79
70502,PAILON,estado nutricional en menores de 5 anos,clasificacion e,2002-07-01,10,2,10,2,12
20102,PALCA,estado nutricional en menores de 5 anos,clasificacion e,2002-07-01,6,9,6,9,15
21104,PALOS BLANCOS,estado nutricional en menores de 5 anos,clasificacion e,2002-07-01,11,20,11,20,31
40802,PAMPA AULLAGAS,estado nutricional en menores de 5 anos,clasificacion e,2002-07-01,1,2,1,2,3
70902,PAMPA GRANDE,estado nutricional en menores de 5 anos,clasificacion e,2002-07-01,2,3,2,3,5
21802,PAPEL PAMPA,estado nutricional en menores de 5 anos,clasificacion e,2002-07-01,1,0,1,0,1
30202,PASORAPA,estado nutricional en menores de 5 anos,clasificacion e,2002-07-01,9,7,9,7,16
21305,PATACAMAYA,estado nutricional en menores de 5 anos,clasificacion e,2002-07-01,15,3,15,3,18
40602,PAZÃ‘A,estado nutricional en menores de 5 anos,clasificacion e,2002-07-01,5,2,5,2,7
20702,PELECHUCO,estado nutricional en menores de 5 anos,clasificacion e,2002-07-01,5,13,5,13,18
50403,POCOATA,estado nutricional en menores de 5 anos,clasificacion e,2002-07-01,25,24,25,24,49
31203,POCONA,estado nutricional en menores de 5 anos,clasificacion e,2002-07-01,9,16,9,16,25
31202,POJO (CBBA),estado nutricional en menores de 5 anos,clasificacion e,2002-07-01,32,25,32,25,57
40601,POOPO,estado nutricional en menores de 5 anos,clasificacion e,2002-07-01,0,5,0,5,5
51203,PORCO,estado nutricional en menores de 5 anos,clasificacion e,2002-07-01,3,4,3,4,7
10103,POROMA,estado nutricional en menores de 5 anos,clasificacion e,2002-07-01,39,19,39,19,58
70601,PORTACHUELO,estado nutricional en menores de 5 anos,clasificacion e,2002-07-01,10,3,10,3,13
90102,PORVENIR,estado nutricional en menores de 5 anos,clasificacion e,2002-07-01,0,1,0,1,1
50101,POTOSI,estado nutricional en menores de 5 anos,clasificacion e,2002-07-01,148,100,148,100,248
10302,PRESTO,estado nutricional en menores de 5 anos,clasificacion e,2002-07-01,29,34,29,34,63
21201,PUCARANI,estado nutricional en menores de 5 anos,clasificacion e,2002-07-01,0,8,0,8,8
20401,PUERTO ACOSTA,estado nutricional en menores de 5 anos,clasificacion e,2002-07-01,26,12,26,12,38
20403,PUERTO CARABUCO,estado nutricional en menores de 5 anos,clasificacion e,2002-07-01,14,11,14,11,25
90301,PUERTO GONZALO MORENO,estado nutricional en menores de 5 anos,clasificacion e,2002-07-01,5,1,5,1,6
21204,PUERTO PEREZ,estado nutricional en menores de 5 anos,clasificacion e,2002-07-01,1,0,1,0,1
71402,PUERTO QUIJARRO,estado nutricional en menores de 5 anos,clasificacion e,2002-07-01,6,0,6,0,6
90201,PUERTO RICO,estado nutricional en menores de 5 anos,clasificacion e,2002-07-01,2,5,2,5,7
80703,PUERTO SILES,estado nutricional en menores de 5 anos,clasificacion e,2002-07-01,1,3,1,3,4
71401,PUERTO SUAREZ,estado nutricional en menores de 5 anos,clasificacion e,2002-07-01,9,3,9,3,12
31205,PUERTO VILLARROEL,estado nutricional en menores de 5 anos,clasificacion e,2002-07-01,70,33,70,33,103
51101,PUNA,estado nutricional en menores de 5 anos,clasificacion e,2002-07-01,37,74,37,74,111
31401,PUNATA,estado nutricional en menores de 5 anos,clasificacion e,2002-07-01,6,6,6,6,12
20604,QUIABAYA,estado nutricional en menores de 5 anos,clasificacion e,2002-07-01,5,6,5,6,11
30901,QUILLACOLLO,estado nutricional en menores de 5 anos,clasificacion e,2002-07-01,10,6,10,6,16
21002,QUIME,estado nutricional en menores de 5 anos,clasificacion e,2002-07-01,3,3,3,3,6
50402,RAVELO,estado nutricional en menores de 5 anos,clasificacion e,2002-07-01,54,30,54,30,84
80201,RIBERALTA,estado nutricional en menores de 5 anos,clasificacion e,2002-07-01,98,88,98,88,186
70503,ROBORE,estado nutricional en menores de 5 anos,clasificacion e,2002-07-01,7,3,7,3,10
80304,RURRENABAQUE,estado nutricional en menores de 5 anos,clasificacion e,2002-07-01,4,2,4,2,6
40901,SABAYA,estado nutricional en menores de 5 anos,clasificacion e,2002-07-01,0,1,0,1,1
31001,SACABA,estado nutricional en menores de 5 anos,clasificacion e,2002-07-01,13,58,13,58,71
30404,SACABAMBA,estado nutricional en menores de 5 anos,clasificacion e,2002-07-01,1,26,1,26,27
50701,SACACA,estado nutricional en menores de 5 anos,clasificacion e,2002-07-01,47,60,47,60,107
71302,SAIPINA,estado nutricional en menores de 5 anos,clasificacion e,2002-07-01,0,1,0,1,1
40801,SALINAS DE GARCI MENDOZA,estado nutricional en menores de 5 anos,clasificacion e,2002-07-01,2,1,2,1,3
70901,SAMAIPATA,estado nutricional en menores de 5 anos,clasificacion e,2002-07-01,4,3,4,3,7
80602,SAN ANDRES,estado nutricional en menores de 5 anos,clasificacion e,2002-07-01,5,7,5,7,12
51003,SAN ANTONIO DE ESMORUCO,estado nutricional en menores de 5 anos,clasificacion e,2002-07-01,0,3,0,3,3
71105,SAN ANTONIO DE LOMERIO,estado nutricional en menores de 5 anos,clasificacion e,2002-07-01,37,38,37,38,75
31403,SAN BENITO,estado nutricional en menores de 5 anos,clasificacion e,2002-07-01,10,3,10,3,13
80302,SAN BORJA,estado nutricional en menores de 5 anos,clasificacion e,2002-07-01,21,12,21,12,33
21502,SAN BUENA VENTURA,estado nutricional en menores de 5 anos,clasificacion e,2002-07-01,8,19,8,19,27
80501,SAN IGNACIO,estado nutricional en menores de 5 anos,clasificacion e,2002-07-01,13,29,13,29,42
70301,SAN IGNACIO DE VELASCO,estado nutricional en menores de 5 anos,clasificacion e,2002-07-01,47,22,47,22,69
80102,SAN JAVIER(BNI),estado nutricional en menores de 5 anos,clasificacion e,2002-07-01,8,7,8,7,15
71102,SAN JAVIER(STC),estado nutricional en menores de 5 anos,clasificacion e,2002-07-01,8,11,8,11,19
80701,SAN JOAQUIN,estado nutricional en menores de 5 anos,clasificacion e,2002-07-01,2,5,2,5,7
70501,SAN JOSE DE CHIQUITOS,estado nutricional en menores de 5 anos,clasificacion e,2002-07-01,7,1,7,1,8
71104,SAN JULIAN,estado nutricional en menores de 5 anos,clasificacion e,2002-07-01,29,38,29,38,67
90302,SAN LORENZO(PND),estado nutricional en menores de 5 anos,clasificacion e,2002-07-01,3,6,3,6,9
60501,SAN LORENZO(TJA),estado nutricional en menores de 5 anos,clasificacion e,2002-07-01,14,31,14,31,45
10702,SAN LUCAS,estado nutricional en menores de 5 anos,clasificacion e,2002-07-01,118,65,118,65,183
71201,SAN MATIAS,estado nutricional en menores de 5 anos,clasificacion e,2002-07-01,0,5,0,5,5
70302,SAN MIGUEL DE VELASCO,estado nutricional en menores de 5 anos,clasificacion e,2002-07-01,8,22,8,22,30
51001,SAN PABLO DE LIPEZ,estado nutricional en menores de 5 anos,clasificacion e,2002-07-01,1,0,1,0,1
50501,SAN PEDRO DE BUENA VISTA,estado nutricional en menores de 5 anos,clasificacion e,2002-07-01,4,71,4,71,75
21801,SAN PEDRO DE CURAHUARA,estado nutricional en menores de 5 anos,clasificacion e,2002-07-01,2,2,2,2,4
21702,SAN PEDRO DE TIQUINA,estado nutricional en menores de 5 anos,clasificacion e,2002-07-01,1,0,1,0,1
70303,SAN RAFAEL,estado nutricional en menores de 5 anos,clasificacion e,2002-07-01,10,3,10,3,13
80401,SANTA ANA,estado nutricional en menores de 5 anos,clasificacion e,2002-07-01,1,1,1,1,2
70101,SANTA CRUZ DE LA SIERRA,estado nutricional en menores de 5 anos,clasificacion e,2002-07-01,99,38,99,38,137
70602,SANTA ROSA DEL SARA,estado nutricional en menores de 5 anos,clasificacion e,2002-07-01,3,0,3,0,3
41401,SANTIAGO DE HUARI,estado nutricional en menores de 5 anos,clasificacion e,2002-07-01,0,8,0,8,8
21901,SANTIAGO DE MACHACA,estado nutricional en menores de 5 anos,clasificacion e,2002-07-01,4,1,4,1,5
30702,SANTIVAÃ‘ES,estado nutricional en menores de 5 anos,clasificacion e,2002-07-01,4,1,4,1,5
40202,SANTUARIO DE QUILLACAS,estado nutricional en menores de 5 anos,clasificacion e,2002-07-01,3,7,3,7,10
20902,SAPAHAQUI,estado nutricional en menores de 5 anos,clasificacion e,2002-07-01,0,4,0,4,4
21301,SICA SICA (VILLA AROMA),estado nutricional en menores de 5 anos,clasificacion e,2002-07-01,6,4,6,4,10
30703,SICAYA,estado nutricional en menores de 5 anos,clasificacion e,2002-07-01,10,2,10,2,12
30902,SIPE SIPE,estado nutricional en menores de 5 anos,clasificacion e,2002-07-01,35,21,35,21,56
10403,SOPACHUY,estado nutricional en menores de 5 anos,clasificacion e,2002-07-01,33,23,33,23,56
20601,SORATA,estado nutricional en menores de 5 anos,clasificacion e,2002-07-01,10,4,10,4,14
10101,SUCRE,estado nutricional en menores de 5 anos,clasificacion e,2002-07-01,160,83,160,83,243
31404,TACACHI,estado nutricional en menores de 5 anos,clasificacion e,2002-07-01,2,2,2,2,4
20603,TACACOMA,estado nutricional en menores de 5 anos,clasificacion e,2002-07-01,5,9,5,9,14
50303,TACOBAMBA,estado nutricional en menores de 5 anos,clasificacion e,2002-07-01,12,11,12,11,23
30602,TACOPAYA,estado nutricional en menores de 5 anos,clasificacion e,2002-07-01,5,3,5,3,8
31101,TAPACARI,estado nutricional en menores de 5 anos,clasificacion e,2002-07-01,2,36,2,36,38
10601,TARABUCO,estado nutricional en menores de 5 anos,clasificacion e,2002-07-01,161,137,161,137,298
30401,TARATA,estado nutricional en menores de 5 anos,clasificacion e,2002-07-01,2,2,2,2,4
60101,TARIJA,estado nutricional en menores de 5 anos,clasificacion e,2002-07-01,39,20,39,20,59
10202,TARVITA,estado nutricional en menores de 5 anos,clasificacion e,2002-07-01,28,23,28,23,51
20803,TIAWANACU,estado nutricional en menores de 5 anos,clasificacion e,2002-07-01,6,5,6,5,11
50102,TINGUIPAYA,estado nutricional en menores de 5 anos,clasificacion e,2002-07-01,1,53,1,53,54
20606,TIPUANI,estado nutricional en menores de 5 anos,clasificacion e,2002-07-01,2,1,2,1,3
30903,TIQUIPAYA,estado nutricional en menores de 5 anos,clasificacion e,2002-07-01,6,11,6,11,17
31601,TIRAQUE (CBBA),estado nutricional en menores de 5 anos,clasificacion e,2002-07-01,8,49,8,49,57
21703,TITO YUPANQUI (PARQUIPUJIO),estado nutricional en menores de 5 anos,clasificacion e,2002-07-01,0,3,0,3,3
30802,TOCO,estado nutricional en menores de 5 anos,clasificacion e,2002-07-01,1,2,1,2,3
30803,TOLATA,estado nutricional en menores de 5 anos,clasificacion e,2002-07-01,1,0,1,0,1
41001,TOLEDO,estado nutricional en menores de 5 anos,clasificacion e,2002-07-01,1,1,1,1,2
51202,TOMAVE,estado nutricional en menores de 5 anos,clasificacion e,2002-07-01,13,18,13,18,31
10402,TOMINA,estado nutricional en menores de 5 anos,clasificacion e,2002-07-01,31,45,31,45,76
50502,TORO TORO,estado nutricional en menores de 5 anos,clasificacion e,2002-07-01,4,8,4,8,12
31201,TOTORA(CBBA),estado nutricional en menores de 5 anos,clasificacion e,2002-07-01,9,8,9,8,17
41301,TOTORA(ORR),estado nutricional en menores de 5 anos,clasificacion e,2002-07-01,0,2,0,2,2
70802,TRIGAL,estado nutricional en menores de 5 anos,clasificacion e,2002-07-01,1,1,1,1,2
80101,TRINIDAD,estado nutricional en menores de 5 anos,clasificacion e,2002-07-01,52,65,52,65,117
50801,TUPIZA,estado nutricional en menores de 5 anos,clasificacion e,2002-07-01,3,69,3,69,72
21302,UMALA,estado nutricional en menores de 5 anos,clasificacion e,2002-07-01,0,7,0,7,7
50201,UNCIA,estado nutricional en menores de 5 anos,clasificacion e,2002-07-01,6,21,6,21,27
60401,URIONDO (A. CONCEPCION),estado nutricional en menores de 5 anos,clasificacion e,2002-07-01,1,2,1,2,3
51201,UYUNI,estado nutricional en menores de 5 anos,clasificacion e,2002-07-01,11,22,11,22,33
30502,VACAS,estado nutricional en menores de 5 anos,clasificacion e,2002-07-01,0,11,0,11,11
70801,VALLEGRANDE,estado nutricional en menores de 5 anos,clasificacion e,2002-07-01,5,6,5,6,11
20801,VIACHA,estado nutricional en menores de 5 anos,clasificacion e,2002-07-01,7,20,7,20,27
31302,VILA VILA,estado nutricional en menores de 5 anos,clasificacion e,2002-07-01,7,9,7,9,16
60303,VILLA MONTES,estado nutricional en menores de 5 anos,clasificacion e,2002-07-01,8,7,8,7,15
31402,VILLA RIVERO,estado nutricional en menores de 5 anos,clasificacion e,2002-07-01,7,6,7,6,13
10801,VILLA SERRANO,estado nutricional en menores de 5 anos,clasificacion e,2002-07-01,57,79,57,79,136
31003,VILLA TUNARI,estado nutricional en menores de 5 anos,clasificacion e,2002-07-01,46,63,46,63,109
11001,VILLA VACA GUZMAN (MUYUPAMPA),estado nutricional en menores de 5 anos,clasificacion e,2002-07-01,25,15,25,15,40
51501,VILLAZON,estado nutricional en menores de 5 anos,clasificacion e,2002-07-01,7,22,7,22,29
30904,VINTO,estado nutricional en menores de 5 anos,clasificacion e,2002-07-01,18,8,18,8,26
50602,VITICHI,estado nutricional en menores de 5 anos,clasificacion e,2002-07-01,3,6,3,6,9
20306,WALDO BALLIVIAN,estado nutricional en menores de 5 anos,clasificacion e,2002-07-01,4,0,4,0,4
70201,WARNES,estado nutricional en menores de 5 anos,clasificacion e,2002-07-01,35,21,35,21,56
20903,YACO,estado nutricional en menores de 5 anos,clasificacion e,2002-07-01,0,4,0,4,4
60301,YACUIBA,estado nutricional en menores de 5 anos,clasificacion e,2002-07-01,15,4,15,4,19
10602,YAMPARAEZ,estado nutricional en menores de 5 anos,clasificacion e,2002-07-01,65,42,65,42,107
50103,YOCALLA,estado nutricional en menores de 5 anos,clasificacion e,2002-07-01,0,12,0,12,12
10102,YOTALA,estado nutricional en menores de 5 anos,clasificacion e,2002-07-01,33,31,33,31,64
60402,YUNCHARA,estado nutricional en menores de 5 anos,clasificacion e,2002-07-01,2,11,2,11,13
10301,ZUDAÃ‘EZ,estado nutricional en menores de 5 anos,clasificacion e,2002-07-01,39,40,39,40,79
51302,ACACIO,estado nutricional en menores de 5 anos,clasificacion e,2002-08-01,27,40,27,40,67
20201,ACHACACHI,estado nutricional en menores de 5 anos,clasificacion e,2002-08-01,32,24,32,24,56
20104,ACHOCALLA,estado nutricional en menores de 5 anos,clasificacion e,2002-08-01,9,6,9,6,15
30201,AIQUILE,estado nutricional en menores de 5 anos,clasificacion e,2002-08-01,13,17,13,17,30
31303,ALALAY,estado nutricional en menores de 5 anos,clasificacion e,2002-08-01,2,5,2,5,7
10404,ALCALA,estado nutricional en menores de 5 anos,clasificacion e,2002-08-01,21,21,21,21,42
20202,ANCORAIMES,estado nutricional en menores de 5 anos,clasificacion e,2002-08-01,17,20,17,20,37
30402,ANZALDO,estado nutricional en menores de 5 anos,clasificacion e,2002-08-01,2,27,2,27,29
20701,APOLO,estado nutricional en menores de 5 anos,clasificacion e,2002-08-01,8,10,8,10,18
51301,ARAMPAMPA,estado nutricional en menores de 5 anos,clasificacion e,2002-08-01,13,15,13,15,28
30403,ARBIETO,estado nutricional en menores de 5 anos,clasificacion e,2002-08-01,0,7,0,7,7
30601,ARQUE,estado nutricional en menores de 5 anos,clasificacion e,2002-08-01,16,14,16,14,30
71501,ASCENCION DE GUARAYOS,estado nutricional en menores de 5 anos,clasificacion e,2002-08-01,69,71,69,71,140
50802,ATOCHA,estado nutricional en menores de 5 anos,clasificacion e,2002-08-01,1,5,1,5,6
20503,AUCAPATA,estado nutricional en menores de 5 anos,clasificacion e,2002-08-01,12,3,12,3,15
20502,AYATA,estado nutricional en menores de 5 anos,clasificacion e,2002-08-01,12,5,12,5,17
21303,AYO AYO,estado nutricional en menores de 5 anos,clasificacion e,2002-08-01,4,0,4,0,4
30301,AYOPAYA (V. DE INDEPENDENCIA),estado nutricional en menores de 5 anos,clasificacion e,2002-08-01,26,26,26,26,52
10201,AZURDUY,estado nutricional en menores de 5 anos,clasificacion e,2002-08-01,68,54,68,54,122
21203,BATALLAS,estado nutricional en menores de 5 anos,clasificacion e,2002-08-01,2,13,2,13,15
80802,BAURES,estado nutricional en menores de 5 anos,clasificacion e,2002-08-01,6,5,6,5,11
41202,BELEN DE ANDAMARCA,estado nutricional en menores de 5 anos,clasificacion e,2002-08-01,0,1,0,1,1
50104,BELEN DE URMIRI,estado nutricional en menores de 5 anos,clasificacion e,2002-08-01,0,1,0,1,1
60202,BERMEJO,estado nutricional en menores de 5 anos,clasificacion e,2002-08-01,1,3,1,3,4
50301,BETANZOS,estado nutricional en menores de 5 anos,clasificacion e,2002-08-01,62,60,62,60,122
31501,BOLIVAR,estado nutricional en menores de 5 anos,clasificacion e,2002-08-01,8,11,8,11,19
70707,BOYUIBE,estado nutricional en menores de 5 anos,clasificacion e,2002-08-01,0,2,0,2,2
70703,CABEZAS,estado nutricional en menores de 5 anos,clasificacion e,2002-08-01,2,8,2,8,10
20905,CAIROMA,estado nutricional en menores de 5 anos,clasificacion e,2002-08-01,27,9,27,9,36
51102,"CAIZA ""D""",estado nutricional en menores de 5 anos,clasificacion e,2002-08-01,27,21,27,21,48
21003,CAJUATA,estado nutricional en menores de 5 anos,clasificacion e,2002-08-01,12,8,12,8,20
20303,CALACOTO,estado nutricional en menores de 5 anos,clasificacion e,2002-08-01,9,1,9,1,10
21304,CALAMARCA,estado nutricional en menores de 5 anos,clasificacion e,2002-08-01,16,11,16,11,27
10701,CAMARGO,estado nutricional en menores de 5 anos,clasificacion e,2002-08-01,2,14,2,14,16
10901,CAMATAQUI (C. VILLA ABECIA),estado nutricional en menores de 5 anos,clasificacion e,2002-08-01,4,4,4,4,8
70706,CAMIRI,estado nutricional en menores de 5 anos,clasificacion e,2002-08-01,53,37,53,37,90
30701,CAPINOTA,estado nutricional en menores de 5 anos,clasificacion e,2002-08-01,21,35,21,35,56
20302,CAQUIAVIRI,estado nutricional en menores de 5 anos,clasificacion e,2002-08-01,5,4,5,4,9
40102,CARACOLLO,estado nutricional en menores de 5 anos,clasificacion e,2002-08-01,2,7,2,7,9
22001,CARANAVI,estado nutricional en menores de 5 anos,clasificacion e,2002-08-01,37,43,37,43,80
60302,CARAPARI,estado nutricional en menores de 5 anos,clasificacion e,2002-08-01,3,4,3,4,7
50702,CARIPUYO,estado nutricional en menores de 5 anos,clasificacion e,2002-08-01,31,26,31,26,57
21902,CATACORA,estado nutricional en menores de 5 anos,clasificacion e,2002-08-01,2,1,2,1,3
40201,CHALLAPATA,estado nutricional en menores de 5 anos,clasificacion e,2002-08-01,24,21,24,21,45
50302,CHAQUI,estado nutricional en menores de 5 anos,clasificacion e,2002-08-01,11,9,11,9,20
70702,CHARAGUA,estado nutricional en menores de 5 anos,clasificacion e,2002-08-01,11,27,11,27,38
20305,CHARAÃ‘A,estado nutricional en menores de 5 anos,clasificacion e,2002-08-01,5,7,5,7,12
31204,CHIMORE,estado nutricional en menores de 5 anos,clasificacion e,2002-08-01,2,2,2,2,4
40302,CHOQUE COTA,estado nutricional en menores de 5 anos,clasificacion e,2002-08-01,1,0,1,0,1
21101,CHULUMANI (V. DE LA LIBERTAD),estado nutricional en menores de 5 anos,clasificacion e,2002-08-01,3,2,3,2,5
20501,CHUMA,estado nutricional en menores de 5 anos,clasificacion e,2002-08-01,14,8,14,8,22
30801,CLIZA,estado nutricional en menores de 5 anos,clasificacion e,2002-08-01,5,10,5,10,15
90101,COBIJA,estado nutricional en menores de 5 anos,clasificacion e,2002-08-01,22,22,22,22,44
30101,COCHABAMBA,estado nutricional en menores de 5 anos,clasificacion e,2002-08-01,68,58,68,58,126
30905,COLCAPIRHUA,estado nutricional en menores de 5 anos,clasificacion e,2002-08-01,14,3,14,3,17
50901,"COLCHA ""K""",estado nutricional en menores de 5 anos,clasificacion e,2002-08-01,7,8,7,8,15
31002,COLOMI,estado nutricional en menores de 5 anos,clasificacion e,2002-08-01,13,24,13,24,37
50401,COLQUECHACA,estado nutricional en menores de 5 anos,clasificacion e,2002-08-01,73,36,73,36,109
21306,COLQUENCHA,estado nutricional en menores de 5 anos,clasificacion e,2002-08-01,6,13,6,13,19
21004,COLQUIRI,estado nutricional en menores de 5 anos,clasificacion e,2002-08-01,38,11,38,11,49
20304,COMANCHE,estado nutricional en menores de 5 anos,clasificacion e,2002-08-01,1,5,1,5,6
71301,COMARAPA,estado nutricional en menores de 5 anos,clasificacion e,2002-08-01,24,15,24,15,39
20605,COMBAYA,estado nutricional en menores de 5 anos,clasificacion e,2002-08-01,2,4,2,4,6
71101,CONCEPCION,estado nutricional en menores de 5 anos,clasificacion e,2002-08-01,4,0,4,0,4
21701,COPACABANA,estado nutricional en menores de 5 anos,clasificacion e,2002-08-01,4,1,4,1,5
21402,CORIPATA,estado nutricional en menores de 5 anos,clasificacion e,2002-08-01,5,2,5,2,7
20301,CORO CORO,estado nutricional en menores de 5 anos,clasificacion e,2002-08-01,8,10,8,10,18
21401,COROICO,estado nutricional en menores de 5 anos,clasificacion e,2002-08-01,2,3,2,3,5
40301,CORQUE,estado nutricional en menores de 5 anos,clasificacion e,2002-08-01,5,2,5,2,7
50601,COTAGAITA,estado nutricional en menores de 5 anos,clasificacion e,2002-08-01,24,44,24,44,68
70102,COTOCA,estado nutricional en menores de 5 anos,clasificacion e,2002-08-01,18,4,18,4,22
70704,CUEVO,estado nutricional en menores de 5 anos,clasificacion e,2002-08-01,3,1,3,1,4
10902,CULPINA,estado nutricional en menores de 5 anos,clasificacion e,2002-08-01,59,52,59,52,111
40401,CURAHUARA DE CARANGAS,estado nutricional en menores de 5 anos,clasificacion e,2002-08-01,2,1,2,1,3
20804,DESAGUADERO,estado nutricional en menores de 5 anos,clasificacion e,2002-08-01,11,2,11,2,13
20105,EL ALTO,estado nutricional en menores de 5 anos,clasificacion e,2002-08-01,344,241,344,241,585
40103,EL CHORO,estado nutricional en menores de 5 anos,clasificacion e,2002-08-01,0,1,0,1,1
71503,EL PUENTE(STC),estado nutricional en menores de 5 anos,clasificacion e,2002-08-01,2,23,2,23,25
60502,EL PUENTE(TJA),estado nutricional en menores de 5 anos,clasificacion e,2002-08-01,5,5,5,5,10
70105,EL TORNO,estado nutricional en menores de 5 anos,clasificacion e,2002-08-01,7,6,7,6,13
10405,EL VILLAR,estado nutricional en menores de 5 anos,clasificacion e,2002-08-01,22,30,22,30,52
60601,ENTRE RIOS,estado nutricional en menores de 5 anos,clasificacion e,2002-08-01,5,3,5,3,8
41101,EUCALIPTUS,estado nutricional en menores de 5 anos,clasificacion e,2002-08-01,4,16,4,16,20
80402,EXALTACION,estado nutricional en menores de 5 anos,clasificacion e,2002-08-01,1,5,1,5,6
90203,FILADELFIA,estado nutricional en menores de 5 anos,clasificacion e,2002-08-01,1,3,1,3,4
71002,GENERAL SAAVEDRA,estado nutricional en menores de 5 anos,clasificacion e,2002-08-01,12,13,12,13,25
21601,GRAL. J.J. PEREZ (CHARAZANI),estado nutricional en menores de 5 anos,clasificacion e,2002-08-01,2,22,2,22,24
20602,GUANAY,estado nutricional en menores de 5 anos,clasificacion e,2002-08-01,33,20,33,20,53
20802,GUAQUI,estado nutricional en menores de 5 anos,clasificacion e,2002-08-01,2,2,2,2,4
80202,GUAYARAMERIN,estado nutricional en menores de 5 anos,clasificacion e,2002-08-01,30,19,30,19,49
70705,GUTIERREZ,estado nutricional en menores de 5 anos,clasificacion e,2002-08-01,36,33,36,33,69
10502,HUACARETA,estado nutricional en menores de 5 anos,clasificacion e,2002-08-01,15,11,15,11,26
11002,HUACAYA (VILLA DE HUACAYA),estado nutricional en menores de 5 anos,clasificacion e,2002-08-01,2,4,2,4,6
40501,HUACHACALLA,estado nutricional en menores de 5 anos,clasificacion e,2002-08-01,1,0,1,0,1
40701,HUANUNI,estado nutricional en menores de 5 anos,clasificacion e,2002-08-01,13,7,13,7,20
41601,HUAYLLAMARCA,estado nutricional en menores de 5 anos,clasificacion e,2002-08-01,1,2,1,2,3
21005,ICHOCA,estado nutricional en menores de 5 anos,clasificacion e,2002-08-01,9,8,9,8,17
10304,ICLA,estado nutricional en menores de 5 anos,clasificacion e,2002-08-01,64,93,64,93,157
10703,INCAHUASI,estado nutricional en menores de 5 anos,clasificacion e,2002-08-01,28,43,28,43,71
21001,INQUISIVI,estado nutricional en menores de 5 anos,clasificacion e,2002-08-01,13,32,13,32,45
21102,IRUPANA (VILLA DE LANZA),estado nutricional en menores de 5 anos,clasificacion e,2002-08-01,1,1,1,1,2
21501,IXIAMAS,estado nutricional en menores de 5 anos,clasificacion e,2002-08-01,5,8,5,8,13
21105,LA ASUNTA,estado nutricional en menores de 5 anos,clasificacion e,2002-08-01,5,9,5,9,14
70104,LA GUARDIA,estado nutricional en menores de 5 anos,clasificacion e,2002-08-01,11,6,11,6,17
20101,LA PAZ,estado nutricional en menores de 5 anos,clasificacion e,2002-08-01,200,153,200,153,353
70701,LAGUNILLAS,estado nutricional en menores de 5 anos,clasificacion e,2002-08-01,7,11,7,11,18
21202,LAJA,estado nutricional en menores de 5 anos,clasificacion e,2002-08-01,5,2,5,2,7
10903,LAS CARRERAS,estado nutricional en menores de 5 anos,clasificacion e,2002-08-01,6,10,6,10,16
21006,LICOMA PAMPA,estado nutricional en menores de 5 anos,clasificacion e,2002-08-01,2,1,2,1,3
50203,LLALLAGUA,estado nutricional en menores de 5 anos,clasificacion e,2002-08-01,0,6,0,6,6
51401,LLICA,estado nutricional en menores de 5 anos,clasificacion e,2002-08-01,3,1,3,1,4
20901,LURIBAY,estado nutricional en menores de 5 anos,clasificacion e,2002-08-01,2,0,2,0,2
40702,MACHACAMARCA,estado nutricional en menores de 5 anos,clasificacion e,2002-08-01,2,1,2,1,3
11003,MACHARETI,estado nutricional en menores de 5 anos,clasificacion e,2002-08-01,8,15,8,15,23
80801,MAGDALENA,estado nutricional en menores de 5 anos,clasificacion e,2002-08-01,1,3,1,3,4
70903,MAIRANA,estado nutricional en menores de 5 anos,clasificacion e,2002-08-01,3,6,3,6,9
20103,MECAPACA,estado nutricional en menores de 5 anos,clasificacion e,2002-08-01,2,3,2,3,5
71003,MINEROS,estado nutricional en menores de 5 anos,clasificacion e,2002-08-01,26,8,26,8,34
31301,MIZQUE,estado nutricional en menores de 5 anos,clasificacion e,2002-08-01,10,9,10,9,19
20402,MOCOMOCO,estado nutricional en menores de 5 anos,clasificacion e,2002-08-01,18,18,18,18,36
10303,MOJOCOYA,estado nutricional en menores de 5 anos,clasificacion e,2002-08-01,24,19,24,19,43
10501,MONTEAGUDO,estado nutricional en menores de 5 anos,clasificacion e,2002-08-01,33,30,33,30,63
71001,MONTERO,estado nutricional en menores de 5 anos,clasificacion e,2002-08-01,24,16,24,16,40
70803,MORO MORO,estado nutricional en menores de 5 anos,clasificacion e,2002-08-01,1,1,1,1,2
30302,MOROCHATA,estado nutricional en menores de 5 anos,clasificacion e,2002-08-01,13,15,13,15,28
90401,NACEBE (SANTA ROSA DEL ABUNA),estado nutricional en menores de 5 anos,clasificacion e,2002-08-01,0,1,0,1,1
20307,NAZACARA DE PACAJES,estado nutricional en menores de 5 anos,clasificacion e,2002-08-01,1,1,1,1,2
50404,OCURI,estado nutricional en menores de 5 anos,clasificacion e,2002-08-01,43,32,43,32,75
70202,OKINAWA,estado nutricional en menores de 5 anos,clasificacion e,2002-08-01,1,2,1,2,3
30203,OMEREQUE,estado nutricional en menores de 5 anos,clasificacion e,2002-08-01,0,1,0,1,1
40101,ORURO,estado nutricional en menores de 5 anos,clasificacion e,2002-08-01,71,51,71,51,122
60201,PADCAYA,estado nutricional en menores de 5 anos,clasificacion e,2002-08-01,6,3,6,3,9
10401,PADILLA,estado nutricional en menores de 5 anos,clasificacion e,2002-08-01,33,50,33,50,83
70502,PAILON,estado nutricional en menores de 5 anos,clasificacion e,2002-08-01,5,5,5,5,10
20102,PALCA,estado nutricional en menores de 5 anos,clasificacion e,2002-08-01,10,11,10,11,21
21104,PALOS BLANCOS,estado nutricional en menores de 5 anos,clasificacion e,2002-08-01,17,17,17,17,34
40802,PAMPA AULLAGAS,estado nutricional en menores de 5 anos,clasificacion e,2002-08-01,7,1,7,1,8
70902,PAMPA GRANDE,estado nutricional en menores de 5 anos,clasificacion e,2002-08-01,3,2,3,2,5
21802,PAPEL PAMPA,estado nutricional en menores de 5 anos,clasificacion e,2002-08-01,1,3,1,3,4
30202,PASORAPA,estado nutricional en menores de 5 anos,clasificacion e,2002-08-01,2,11,2,11,13
21305,PATACAMAYA,estado nutricional en menores de 5 anos,clasificacion e,2002-08-01,2,4,2,4,6
40602,PAZÃ‘A,estado nutricional en menores de 5 anos,clasificacion e,2002-08-01,1,2,1,2,3
20702,PELECHUCO,estado nutricional en menores de 5 anos,clasificacion e,2002-08-01,11,6,11,6,17
50403,POCOATA,estado nutricional en menores de 5 anos,clasificacion e,2002-08-01,36,29,36,29,65
31203,POCONA,estado nutricional en menores de 5 anos,clasificacion e,2002-08-01,20,15,20,15,35
31202,POJO (CBBA),estado nutricional en menores de 5 anos,clasificacion e,2002-08-01,57,21,57,21,78
40601,POOPO,estado nutricional en menores de 5 anos,clasificacion e,2002-08-01,5,1,5,1,6
51203,PORCO,estado nutricional en menores de 5 anos,clasificacion e,2002-08-01,6,2,6,2,8
10103,POROMA,estado nutricional en menores de 5 anos,clasificacion e,2002-08-01,39,50,39,50,89
70103,PORONGO,estado nutricional en menores de 5 anos,clasificacion e,2002-08-01,5,4,5,4,9
70601,PORTACHUELO,estado nutricional en menores de 5 anos,clasificacion e,2002-08-01,8,2,8,2,10
70804,POSTRER VALLE,estado nutricional en menores de 5 anos,clasificacion e,2002-08-01,1,0,1,0,1
50101,POTOSI,estado nutricional en menores de 5 anos,clasificacion e,2002-08-01,128,69,128,69,197
10302,PRESTO,estado nutricional en menores de 5 anos,clasificacion e,2002-08-01,24,19,24,19,43
70805,PUCARA,estado nutricional en menores de 5 anos,clasificacion e,2002-08-01,0,2,0,2,2
21201,PUCARANI,estado nutricional en menores de 5 anos,clasificacion e,2002-08-01,3,4,3,4,7
20401,PUERTO ACOSTA,estado nutricional en menores de 5 anos,clasificacion e,2002-08-01,22,17,22,17,39
20403,PUERTO CARABUCO,estado nutricional en menores de 5 anos,clasificacion e,2002-08-01,16,15,16,15,31
90301,PUERTO GONZALO MORENO,estado nutricional en menores de 5 anos,clasificacion e,2002-08-01,9,1,9,1,10
21204,PUERTO PEREZ,estado nutricional en menores de 5 anos,clasificacion e,2002-08-01,0,1,0,1,1
71402,PUERTO QUIJARRO,estado nutricional en menores de 5 anos,clasificacion e,2002-08-01,12,4,12,4,16
90201,PUERTO RICO,estado nutricional en menores de 5 anos,clasificacion e,2002-08-01,4,4,4,4,8
80703,PUERTO SILES,estado nutricional en menores de 5 anos,clasificacion e,2002-08-01,0,1,0,1,1
71401,PUERTO SUAREZ,estado nutricional en menores de 5 anos,clasificacion e,2002-08-01,14,8,14,8,22
31205,PUERTO VILLARROEL,estado nutricional en menores de 5 anos,clasificacion e,2002-08-01,36,44,36,44,80
51101,PUNA,estado nutricional en menores de 5 anos,clasificacion e,2002-08-01,18,45,18,45,63
20604,QUIABAYA,estado nutricional en menores de 5 anos,clasificacion e,2002-08-01,7,2,7,2,9
30901,QUILLACOLLO,estado nutricional en menores de 5 anos,clasificacion e,2002-08-01,10,0,10,0,10
21002,QUIME,estado nutricional en menores de 5 anos,clasificacion e,2002-08-01,10,3,10,3,13
70904,QUIRUSILLAS,estado nutricional en menores de 5 anos,clasificacion e,2002-08-01,1,0,1,0,1
50402,RAVELO,estado nutricional en menores de 5 anos,clasificacion e,2002-08-01,71,47,71,47,118
80301,REYES,estado nutricional en menores de 5 anos,clasificacion e,2002-08-01,2,5,2,5,7
80201,RIBERALTA,estado nutricional en menores de 5 anos,clasificacion e,2002-08-01,161,74,161,74,235
70503,ROBORE,estado nutricional en menores de 5 anos,clasificacion e,2002-08-01,6,2,6,2,8
80304,RURRENABAQUE,estado nutricional en menores de 5 anos,clasificacion e,2002-08-01,3,0,3,0,3
40901,SABAYA,estado nutricional en menores de 5 anos,clasificacion e,2002-08-01,0,1,0,1,1
31001,SACABA,estado nutricional en menores de 5 anos,clasificacion e,2002-08-01,35,18,35,18,53
30404,SACABAMBA,estado nutricional en menores de 5 anos,clasificacion e,2002-08-01,0,45,0,45,45
50701,SACACA,estado nutricional en menores de 5 anos,clasificacion e,2002-08-01,70,58,70,58,128
71302,SAIPINA,estado nutricional en menores de 5 anos,clasificacion e,2002-08-01,1,2,1,2,3
40801,SALINAS DE GARCI MENDOZA,estado nutricional en menores de 5 anos,clasificacion e,2002-08-01,3,3,3,3,6
70901,SAMAIPATA,estado nutricional en menores de 5 anos,clasificacion e,2002-08-01,4,3,4,3,7
80602,SAN ANDRES,estado nutricional en menores de 5 anos,clasificacion e,2002-08-01,10,7,10,7,17
71105,SAN ANTONIO DE LOMERIO,estado nutricional en menores de 5 anos,clasificacion e,2002-08-01,31,33,31,33,64
31403,SAN BENITO,estado nutricional en menores de 5 anos,clasificacion e,2002-08-01,0,3,0,3,3
80302,SAN BORJA,estado nutricional en menores de 5 anos,clasificacion e,2002-08-01,34,22,34,22,56
21502,SAN BUENA VENTURA,estado nutricional en menores de 5 anos,clasificacion e,2002-08-01,6,9,6,9,15
80501,SAN IGNACIO,estado nutricional en menores de 5 anos,clasificacion e,2002-08-01,27,31,27,31,58
70301,SAN IGNACIO DE VELASCO,estado nutricional en menores de 5 anos,clasificacion e,2002-08-01,66,36,66,36,102
80102,SAN JAVIER(BNI),estado nutricional en menores de 5 anos,clasificacion e,2002-08-01,8,2,8,2,10
71102,SAN JAVIER(STC),estado nutricional en menores de 5 anos,clasificacion e,2002-08-01,15,7,15,7,22
80701,SAN JOAQUIN,estado nutricional en menores de 5 anos,clasificacion e,2002-08-01,0,6,0,6,6
70501,SAN JOSE DE CHIQUITOS,estado nutricional en menores de 5 anos,clasificacion e,2002-08-01,6,1,6,1,7
71104,SAN JULIAN,estado nutricional en menores de 5 anos,clasificacion e,2002-08-01,50,32,50,32,82
60501,SAN LORENZO(TJA),estado nutricional en menores de 5 anos,clasificacion e,2002-08-01,9,9,9,9,18
10702,SAN LUCAS,estado nutricional en menores de 5 anos,clasificacion e,2002-08-01,131,80,131,80,211
71201,SAN MATIAS,estado nutricional en menores de 5 anos,clasificacion e,2002-08-01,19,20,19,20,39
70302,SAN MIGUEL DE VELASCO,estado nutricional en menores de 5 anos,clasificacion e,2002-08-01,9,8,9,8,17
50501,SAN PEDRO DE BUENA VISTA,estado nutricional en menores de 5 anos,clasificacion e,2002-08-01,33,107,33,107,140
21801,SAN PEDRO DE CURAHUARA,estado nutricional en menores de 5 anos,clasificacion e,2002-08-01,0,3,0,3,3
21702,SAN PEDRO DE TIQUINA,estado nutricional en menores de 5 anos,clasificacion e,2002-08-01,0,1,0,1,1
70303,SAN RAFAEL,estado nutricional en menores de 5 anos,clasificacion e,2002-08-01,9,5,9,5,14
80702,SAN RAMON,estado nutricional en menores de 5 anos,clasificacion e,2002-08-01,0,4,0,4,4
80401,SANTA ANA,estado nutricional en menores de 5 anos,clasificacion e,2002-08-01,6,1,6,1,7
70101,SANTA CRUZ DE LA SIERRA,estado nutricional en menores de 5 anos,clasificacion e,2002-08-01,81,55,81,55,136
80303,SANTA ROSA,estado nutricional en menores de 5 anos,clasificacion e,2002-08-01,4,1,4,1,5
70602,SANTA ROSA DEL SARA,estado nutricional en menores de 5 anos,clasificacion e,2002-08-01,3,0,3,0,3
20308,SANTIAGO DE CALLAPA,estado nutricional en menores de 5 anos,clasificacion e,2002-08-01,1,0,1,0,1
41401,SANTIAGO DE HUARI,estado nutricional en menores de 5 anos,clasificacion e,2002-08-01,2,8,2,8,10
21901,SANTIAGO DE MACHACA,estado nutricional en menores de 5 anos,clasificacion e,2002-08-01,4,2,4,2,6
30702,SANTIVAÃ‘ES,estado nutricional en menores de 5 anos,clasificacion e,2002-08-01,5,0,5,0,5
40202,SANTUARIO DE QUILLACAS,estado nutricional en menores de 5 anos,clasificacion e,2002-08-01,2,0,2,0,2
20902,SAPAHAQUI,estado nutricional en menores de 5 anos,clasificacion e,2002-08-01,3,1,3,1,4
21301,SICA SICA (VILLA AROMA),estado nutricional en menores de 5 anos,clasificacion e,2002-08-01,12,5,12,5,17
30703,SICAYA,estado nutricional en menores de 5 anos,clasificacion e,2002-08-01,4,3,4,3,7
30902,SIPE SIPE,estado nutricional en menores de 5 anos,clasificacion e,2002-08-01,23,6,23,6,29
10403,SOPACHUY,estado nutricional en menores de 5 anos,clasificacion e,2002-08-01,32,17,32,17,49
20601,SORATA,estado nutricional en menores de 5 anos,clasificacion e,2002-08-01,4,9,4,9,13
10101,SUCRE,estado nutricional en menores de 5 anos,clasificacion e,2002-08-01,180,146,180,146,326
20603,TACACOMA,estado nutricional en menores de 5 anos,clasificacion e,2002-08-01,5,9,5,9,14
50303,TACOBAMBA,estado nutricional en menores de 5 anos,clasificacion e,2002-08-01,17,21,17,21,38
30602,TACOPAYA,estado nutricional en menores de 5 anos,clasificacion e,2002-08-01,5,6,5,6,11
31101,TAPACARI,estado nutricional en menores de 5 anos,clasificacion e,2002-08-01,22,44,22,44,66
10601,TARABUCO,estado nutricional en menores de 5 anos,clasificacion e,2002-08-01,173,123,173,123,296
30401,TARATA,estado nutricional en menores de 5 anos,clasificacion e,2002-08-01,7,10,7,10,17
60101,TARIJA,estado nutricional en menores de 5 anos,clasificacion e,2002-08-01,31,20,31,20,51
10202,TARVITA,estado nutricional en menores de 5 anos,clasificacion e,2002-08-01,34,58,34,58,92
20803,TIAWANACU,estado nutricional en menores de 5 anos,clasificacion e,2002-08-01,5,6,5,6,11
50102,TINGUIPAYA,estado nutricional en menores de 5 anos,clasificacion e,2002-08-01,9,54,9,54,63
20606,TIPUANI,estado nutricional en menores de 5 anos,clasificacion e,2002-08-01,2,1,2,1,3
30903,TIQUIPAYA,estado nutricional en menores de 5 anos,clasificacion e,2002-08-01,10,23,10,23,33
31601,TIRAQUE (CBBA),estado nutricional en menores de 5 anos,clasificacion e,2002-08-01,15,11,15,11,26
21703,TITO YUPANQUI (PARQUIPUJIO),estado nutricional en menores de 5 anos,clasificacion e,2002-08-01,0,3,0,3,3
30802,TOCO,estado nutricional en menores de 5 anos,clasificacion e,2002-08-01,3,4,3,4,7
41001,TOLEDO,estado nutricional en menores de 5 anos,clasificacion e,2002-08-01,2,3,2,3,5
51202,TOMAVE,estado nutricional en menores de 5 anos,clasificacion e,2002-08-01,16,18,16,18,34
10402,TOMINA,estado nutricional en menores de 5 anos,clasificacion e,2002-08-01,21,36,21,36,57
50502,TORO TORO,estado nutricional en menores de 5 anos,clasificacion e,2002-08-01,23,23,23,23,46
31201,TOTORA(CBBA),estado nutricional en menores de 5 anos,clasificacion e,2002-08-01,15,17,15,17,32
41301,TOTORA(ORR),estado nutricional en menores de 5 anos,clasificacion e,2002-08-01,6,6,6,6,12
70802,TRIGAL,estado nutricional en menores de 5 anos,clasificacion e,2002-08-01,1,1,1,1,2
80101,TRINIDAD,estado nutricional en menores de 5 anos,clasificacion e,2002-08-01,46,55,46,55,101
40402,TURCO,estado nutricional en menores de 5 anos,clasificacion e,2002-08-01,0,2,0,2,2
21302,UMALA,estado nutricional en menores de 5 anos,clasificacion e,2002-08-01,2,2,2,2,4
60401,URIONDO (A. CONCEPCION),estado nutricional en menores de 5 anos,clasificacion e,2002-08-01,0,3,0,3,3
71502,URUBICHA,estado nutricional en menores de 5 anos,clasificacion e,2002-08-01,6,30,6,30,36
51201,UYUNI,estado nutricional en menores de 5 anos,clasificacion e,2002-08-01,10,17,10,17,27
70801,VALLEGRANDE,estado nutricional en menores de 5 anos,clasificacion e,2002-08-01,18,11,18,11,29
20801,VIACHA,estado nutricional en menores de 5 anos,clasificacion e,2002-08-01,11,19,11,19,30
31302,VILA VILA,estado nutricional en menores de 5 anos,clasificacion e,2002-08-01,2,17,2,17,19
60303,VILLA MONTES,estado nutricional en menores de 5 anos,clasificacion e,2002-08-01,12,6,12,6,18
31402,VILLA RIVERO,estado nutricional en menores de 5 anos,clasificacion e,2002-08-01,1,0,1,0,1
10801,VILLA SERRANO,estado nutricional en menores de 5 anos,clasificacion e,2002-08-01,40,58,40,58,98
31003,VILLA TUNARI,estado nutricional en menores de 5 anos,clasificacion e,2002-08-01,53,43,53,43,96
11001,VILLA VACA GUZMAN (MUYUPAMPA),estado nutricional en menores de 5 anos,clasificacion e,2002-08-01,18,21,18,21,39
51501,VILLAZON,estado nutricional en menores de 5 anos,clasificacion e,2002-08-01,29,27,29,27,56
50602,VITICHI,estado nutricional en menores de 5 anos,clasificacion e,2002-08-01,14,35,14,35,49
70201,WARNES,estado nutricional en menores de 5 anos,clasificacion e,2002-08-01,28,9,28,9,37
20903,YACO,estado nutricional en menores de 5 anos,clasificacion e,2002-08-01,7,17,7,17,24
60301,YACUIBA,estado nutricional en menores de 5 anos,clasificacion e,2002-08-01,10,7,10,7,17
10602,YAMPARAEZ,estado nutricional en menores de 5 anos,clasificacion e,2002-08-01,58,46,58,46,104
21103,YANACACHI,estado nutricional en menores de 5 anos,clasificacion e,2002-08-01,0,4,0,4,4
50103,YOCALLA,estado nutricional en menores de 5 anos,clasificacion e,2002-08-01,0,9,0,9,9
10102,YOTALA,estado nutricional en menores de 5 anos,clasificacion e,2002-08-01,36,35,36,35,71
60402,YUNCHARA,estado nutricional en menores de 5 anos,clasificacion e,2002-08-01,0,6,0,6,6
10301,ZUDAÃ‘EZ,estado nutricional en menores de 5 anos,clasificacion e,2002-08-01,30,25,30,25,55
51302,ACACIO,estado nutricional en menores de 5 anos,clasificacion e,2002-09-01,8,36,8,36,44
20201,ACHACACHI,estado nutricional en menores de 5 anos,clasificacion e,2002-09-01,33,21,33,21,54
20104,ACHOCALLA,estado nutricional en menores de 5 anos,clasificacion e,2002-09-01,4,7,4,7,11
30201,AIQUILE,estado nutricional en menores de 5 anos,clasificacion e,2002-09-01,10,15,10,15,25
31303,ALALAY,estado nutricional en menores de 5 anos,clasificacion e,2002-09-01,1,2,1,2,3
10404,ALCALA,estado nutricional en menores de 5 anos,clasificacion e,2002-09-01,25,22,25,22,47
20202,ANCORAIMES,estado nutricional en menores de 5 anos,clasificacion e,2002-09-01,12,16,12,16,28
41201,ANDAMARCA,estado nutricional en menores de 5 anos,clasificacion e,2002-09-01,3,0,3,0,3
30402,ANZALDO,estado nutricional en menores de 5 anos,clasificacion e,2002-09-01,2,24,2,24,26
20701,APOLO,estado nutricional en menores de 5 anos,clasificacion e,2002-09-01,10,10,10,10,20
51301,ARAMPAMPA,estado nutricional en menores de 5 anos,clasificacion e,2002-09-01,9,12,9,12,21
30501,ARANI,estado nutricional en menores de 5 anos,clasificacion e,2002-09-01,10,13,10,13,23
30403,ARBIETO,estado nutricional en menores de 5 anos,clasificacion e,2002-09-01,0,9,0,9,9
30601,ARQUE,estado nutricional en menores de 5 anos,clasificacion e,2002-09-01,22,7,22,7,29
50802,ATOCHA,estado nutricional en menores de 5 anos,clasificacion e,2002-09-01,0,19,0,19,19
20503,AUCAPATA,estado nutricional en menores de 5 anos,clasificacion e,2002-09-01,1,1,1,1,2
20502,AYATA,estado nutricional en menores de 5 anos,clasificacion e,2002-09-01,24,19,24,19,43
21303,AYO AYO,estado nutricional en menores de 5 anos,clasificacion e,2002-09-01,1,1,1,1,2
30301,AYOPAYA (V. DE INDEPENDENCIA),estado nutricional en menores de 5 anos,clasificacion e,2002-09-01,35,25,35,25,60
10201,AZURDUY,estado nutricional en menores de 5 anos,clasificacion e,2002-09-01,58,69,58,69,127
21203,BATALLAS,estado nutricional en menores de 5 anos,clasificacion e,2002-09-01,4,9,4,9,13
80802,BAURES,estado nutricional en menores de 5 anos,clasificacion e,2002-09-01,8,6,8,6,14
41202,BELEN DE ANDAMARCA,estado nutricional en menores de 5 anos,clasificacion e,2002-09-01,1,0,1,0,1
50104,BELEN DE URMIRI,estado nutricional en menores de 5 anos,clasificacion e,2002-09-01,4,8,4,8,12
60202,BERMEJO,estado nutricional en menores de 5 anos,clasificacion e,2002-09-01,3,5,3,5,8
50301,BETANZOS,estado nutricional en menores de 5 anos,clasificacion e,2002-09-01,121,127,121,127,248
31501,BOLIVAR,estado nutricional en menores de 5 anos,clasificacion e,2002-09-01,17,11,17,11,28
70707,BOYUIBE,estado nutricional en menores de 5 anos,clasificacion e,2002-09-01,0,5,0,5,5
70401,BUENA VISTA,estado nutricional en menores de 5 anos,clasificacion e,2002-09-01,9,5,9,5,14
70703,CABEZAS,estado nutricional en menores de 5 anos,clasificacion e,2002-09-01,7,3,7,3,10
20905,CAIROMA,estado nutricional en menores de 5 anos,clasificacion e,2002-09-01,14,8,14,8,22
51102,"CAIZA ""D""",estado nutricional en menores de 5 anos,clasificacion e,2002-09-01,30,16,30,16,46
21003,CAJUATA,estado nutricional en menores de 5 anos,clasificacion e,2002-09-01,1,4,1,4,5
20303,CALACOTO,estado nutricional en menores de 5 anos,clasificacion e,2002-09-01,0,4,0,4,4
21304,CALAMARCA,estado nutricional en menores de 5 anos,clasificacion e,2002-09-01,13,11,13,11,24
10701,CAMARGO,estado nutricional en menores de 5 anos,clasificacion e,2002-09-01,17,37,17,37,54
10901,CAMATAQUI (C. VILLA ABECIA),estado nutricional en menores de 5 anos,clasificacion e,2002-09-01,6,5,6,5,11
70706,CAMIRI,estado nutricional en menores de 5 anos,clasificacion e,2002-09-01,16,24,16,24,40
30701,CAPINOTA,estado nutricional en menores de 5 anos,clasificacion e,2002-09-01,17,24,17,24,41
20302,CAQUIAVIRI,estado nutricional en menores de 5 anos,clasificacion e,2002-09-01,3,4,3,4,7
40102,CARACOLLO,estado nutricional en menores de 5 anos,clasificacion e,2002-09-01,5,8,5,8,13
22001,CARANAVI,estado nutricional en menores de 5 anos,clasificacion e,2002-09-01,30,25,30,25,55
60302,CARAPARI,estado nutricional en menores de 5 anos,clasificacion e,2002-09-01,5,2,5,2,7
50702,CARIPUYO,estado nutricional en menores de 5 anos,clasificacion e,2002-09-01,35,14,35,14,49
21902,CATACORA,estado nutricional en menores de 5 anos,clasificacion e,2002-09-01,2,0,2,0,2
40201,CHALLAPATA,estado nutricional en menores de 5 anos,clasificacion e,2002-09-01,10,22,10,22,32
50302,CHAQUI,estado nutricional en menores de 5 anos,clasificacion e,2002-09-01,24,11,24,11,35
70702,CHARAGUA,estado nutricional en menores de 5 anos,clasificacion e,2002-09-01,20,27,20,27,47
20305,CHARAÃ‘A,estado nutricional en menores de 5 anos,clasificacion e,2002-09-01,7,9,7,9,16
50202,CHAYANTA,estado nutricional en menores de 5 anos,clasificacion e,2002-09-01,23,15,23,15,38
40302,CHOQUE COTA,estado nutricional en menores de 5 anos,clasificacion e,2002-09-01,2,0,2,0,2
21101,CHULUMANI (V. DE LA LIBERTAD),estado nutricional en menores de 5 anos,clasificacion e,2002-09-01,5,2,5,2,7
20501,CHUMA,estado nutricional en menores de 5 anos,clasificacion e,2002-09-01,16,19,16,19,35
30801,CLIZA,estado nutricional en menores de 5 anos,clasificacion e,2002-09-01,2,9,2,9,11
90101,COBIJA,estado nutricional en menores de 5 anos,clasificacion e,2002-09-01,11,11,11,11,22
30101,COCHABAMBA,estado nutricional en menores de 5 anos,clasificacion e,2002-09-01,84,54,84,54,138
30905,COLCAPIRHUA,estado nutricional en menores de 5 anos,clasificacion e,2002-09-01,16,5,16,5,21
50901,"COLCHA ""K""",estado nutricional en menores de 5 anos,clasificacion e,2002-09-01,8,6,8,6,14
21307,COLLANA,estado nutricional en menores de 5 anos,clasificacion e,2002-09-01,3,1,3,1,4
31002,COLOMI,estado nutricional en menores de 5 anos,clasificacion e,2002-09-01,12,15,12,15,27
50401,COLQUECHACA,estado nutricional en menores de 5 anos,clasificacion e,2002-09-01,82,46,82,46,128
21306,COLQUENCHA,estado nutricional en menores de 5 anos,clasificacion e,2002-09-01,1,4,1,4,5
21004,COLQUIRI,estado nutricional en menores de 5 anos,clasificacion e,2002-09-01,22,9,22,9,31
20304,COMANCHE,estado nutricional en menores de 5 anos,clasificacion e,2002-09-01,3,2,3,2,5
71301,COMARAPA,estado nutricional en menores de 5 anos,clasificacion e,2002-09-01,20,18,20,18,38
20605,COMBAYA,estado nutricional en menores de 5 anos,clasificacion e,2002-09-01,1,7,1,7,8
71101,CONCEPCION,estado nutricional en menores de 5 anos,clasificacion e,2002-09-01,1,3,1,3,4
21701,COPACABANA,estado nutricional en menores de 5 anos,clasificacion e,2002-09-01,0,2,0,2,2
21402,CORIPATA,estado nutricional en menores de 5 anos,clasificacion e,2002-09-01,0,6,0,6,6
20301,CORO CORO,estado nutricional en menores de 5 anos,clasificacion e,2002-09-01,14,10,14,10,24
21401,COROICO,estado nutricional en menores de 5 anos,clasificacion e,2002-09-01,13,5,13,5,18
40301,CORQUE,estado nutricional en menores de 5 anos,clasificacion e,2002-09-01,6,7,6,7,13
50601,COTAGAITA,estado nutricional en menores de 5 anos,clasificacion e,2002-09-01,16,19,16,19,35
70102,COTOCA,estado nutricional en menores de 5 anos,clasificacion e,2002-09-01,11,10,11,10,21
31405,CUCHUMUELA (V. G. VILLARROEL),estado nutricional en menores de 5 anos,clasificacion e,2002-09-01,0,2,0,2,2
70704,CUEVO,estado nutricional en menores de 5 anos,clasificacion e,2002-09-01,3,2,3,2,5
10902,CULPINA,estado nutricional en menores de 5 anos,clasificacion e,2002-09-01,79,73,79,73,152
40401,CURAHUARA DE CARANGAS,estado nutricional en menores de 5 anos,clasificacion e,2002-09-01,4,0,4,0,4
20804,DESAGUADERO,estado nutricional en menores de 5 anos,clasificacion e,2002-09-01,3,3,3,3,6
20105,EL ALTO,estado nutricional en menores de 5 anos,clasificacion e,2002-09-01,365,226,365,226,591
40103,EL CHORO,estado nutricional en menores de 5 anos,clasificacion e,2002-09-01,1,1,1,1,2
71503,EL PUENTE(STC),estado nutricional en menores de 5 anos,clasificacion e,2002-09-01,0,25,0,25,25
60502,EL PUENTE(TJA),estado nutricional en menores de 5 anos,clasificacion e,2002-09-01,12,25,12,25,37
70105,EL TORNO,estado nutricional en menores de 5 anos,clasificacion e,2002-09-01,11,13,11,13,24
10405,EL VILLAR,estado nutricional en menores de 5 anos,clasificacion e,2002-09-01,24,24,24,24,48
60601,ENTRE RIOS,estado nutricional en menores de 5 anos,clasificacion e,2002-09-01,4,4,4,4,8
41101,EUCALIPTUS,estado nutricional en menores de 5 anos,clasificacion e,2002-09-01,2,2,2,2,4
80402,EXALTACION,estado nutricional en menores de 5 anos,clasificacion e,2002-09-01,0,1,0,1,1
90203,FILADELFIA,estado nutricional en menores de 5 anos,clasificacion e,2002-09-01,1,0,1,0,1
71002,GENERAL SAAVEDRA,estado nutricional en menores de 5 anos,clasificacion e,2002-09-01,2,0,2,0,2
21601,GRAL. J.J. PEREZ (CHARAZANI),estado nutricional en menores de 5 anos,clasificacion e,2002-09-01,25,5,25,5,30
20602,GUANAY,estado nutricional en menores de 5 anos,clasificacion e,2002-09-01,12,24,12,24,36
20802,GUAQUI,estado nutricional en menores de 5 anos,clasificacion e,2002-09-01,0,3,0,3,3
80202,GUAYARAMERIN,estado nutricional en menores de 5 anos,clasificacion e,2002-09-01,25,18,25,18,43
70705,GUTIERREZ,estado nutricional en menores de 5 anos,clasificacion e,2002-09-01,24,24,24,24,48
10502,HUACARETA,estado nutricional en menores de 5 anos,clasificacion e,2002-09-01,13,4,13,4,17
11002,HUACAYA (VILLA DE HUACAYA),estado nutricional en menores de 5 anos,clasificacion e,2002-09-01,2,2,2,2,4
40701,HUANUNI,estado nutricional en menores de 5 anos,clasificacion e,2002-09-01,16,9,16,9,25
80803,HUARACAJE,estado nutricional en menores de 5 anos,clasificacion e,2002-09-01,1,0,1,0,1
41601,HUAYLLAMARCA,estado nutricional en menores de 5 anos,clasificacion e,2002-09-01,2,1,2,1,3
21005,ICHOCA,estado nutricional en menores de 5 anos,clasificacion e,2002-09-01,1,4,1,4,5
10304,ICLA,estado nutricional en menores de 5 anos,clasificacion e,2002-09-01,50,72,50,72,122
10703,INCAHUASI,estado nutricional en menores de 5 anos,clasificacion e,2002-09-01,31,47,31,47,78
21001,INQUISIVI,estado nutricional en menores de 5 anos,clasificacion e,2002-09-01,14,30,14,30,44
21102,IRUPANA (VILLA DE LANZA),estado nutricional en menores de 5 anos,clasificacion e,2002-09-01,4,3,4,3,7
21501,IXIAMAS,estado nutricional en menores de 5 anos,clasificacion e,2002-09-01,1,6,1,6,7
21105,LA ASUNTA,estado nutricional en menores de 5 anos,clasificacion e,2002-09-01,8,6,8,6,14
70104,LA GUARDIA,estado nutricional en menores de 5 anos,clasificacion e,2002-09-01,11,6,11,6,17
20101,LA PAZ,estado nutricional en menores de 5 anos,clasificacion e,2002-09-01,215,169,215,169,384
70701,LAGUNILLAS,estado nutricional en menores de 5 anos,clasificacion e,2002-09-01,10,6,10,6,16
21202,LAJA,estado nutricional en menores de 5 anos,clasificacion e,2002-09-01,7,8,7,8,15
10903,LAS CARRERAS,estado nutricional en menores de 5 anos,clasificacion e,2002-09-01,6,8,6,8,14
21006,LICOMA PAMPA,estado nutricional en menores de 5 anos,clasificacion e,2002-09-01,2,2,2,2,4
50203,LLALLAGUA,estado nutricional en menores de 5 anos,clasificacion e,2002-09-01,0,51,0,51,51
80601,LORETO,estado nutricional en menores de 5 anos,clasificacion e,2002-09-01,0,3,0,3,3
20901,LURIBAY,estado nutricional en menores de 5 anos,clasificacion e,2002-09-01,4,1,4,1,5
40702,MACHACAMARCA,estado nutricional en menores de 5 anos,clasificacion e,2002-09-01,1,0,1,0,1
11003,MACHARETI,estado nutricional en menores de 5 anos,clasificacion e,2002-09-01,13,32,13,32,45
80801,MAGDALENA,estado nutricional en menores de 5 anos,clasificacion e,2002-09-01,1,1,1,1,2
70903,MAIRANA,estado nutricional en menores de 5 anos,clasificacion e,2002-09-01,3,1,3,1,4
20904,MALLA,estado nutricional en menores de 5 anos,clasificacion e,2002-09-01,0,2,0,2,2
20103,MECAPACA,estado nutricional en menores de 5 anos,clasificacion e,2002-09-01,2,2,2,2,4
31301,MIZQUE,estado nutricional en menores de 5 anos,clasificacion e,2002-09-01,3,15,3,15,18
20402,MOCOMOCO,estado nutricional en menores de 5 anos,clasificacion e,2002-09-01,5,2,5,2,7
51002,MOJINETE,estado nutricional en menores de 5 anos,clasificacion e,2002-09-01,0,1,0,1,1
10303,MOJOCOYA,estado nutricional en menores de 5 anos,clasificacion e,2002-09-01,21,16,21,16,37
10501,MONTEAGUDO,estado nutricional en menores de 5 anos,clasificacion e,2002-09-01,36,49,36,49,85
71001,MONTERO,estado nutricional en menores de 5 anos,clasificacion e,2002-09-01,52,29,52,29,81
70803,MORO MORO,estado nutricional en menores de 5 anos,clasificacion e,2002-09-01,6,10,6,10,16
30302,MOROCHATA,estado nutricional en menores de 5 anos,clasificacion e,2002-09-01,30,31,30,31,61
20307,NAZACARA DE PACAJES,estado nutricional en menores de 5 anos,clasificacion e,2002-09-01,1,0,1,0,1
50404,OCURI,estado nutricional en menores de 5 anos,clasificacion e,2002-09-01,29,40,29,40,69
70202,OKINAWA,estado nutricional en menores de 5 anos,clasificacion e,2002-09-01,2,1,2,1,3
30203,OMEREQUE,estado nutricional en menores de 5 anos,clasificacion e,2002-09-01,0,8,0,8,8
40101,ORURO,estado nutricional en menores de 5 anos,clasificacion e,2002-09-01,117,78,117,78,195
60201,PADCAYA,estado nutricional en menores de 5 anos,clasificacion e,2002-09-01,9,6,9,6,15
10401,PADILLA,estado nutricional en menores de 5 anos,clasificacion e,2002-09-01,33,58,33,58,91
70502,PAILON,estado nutricional en menores de 5 anos,clasificacion e,2002-09-01,2,8,2,8,10
20102,PALCA,estado nutricional en menores de 5 anos,clasificacion e,2002-09-01,11,38,11,38,49
21104,PALOS BLANCOS,estado nutricional en menores de 5 anos,clasificacion e,2002-09-01,17,12,17,12,29
40802,PAMPA AULLAGAS,estado nutricional en menores de 5 anos,clasificacion e,2002-09-01,4,0,4,0,4
70902,PAMPA GRANDE,estado nutricional en menores de 5 anos,clasificacion e,2002-09-01,5,8,5,8,13
21802,PAPEL PAMPA,estado nutricional en menores de 5 anos,clasificacion e,2002-09-01,4,1,4,1,5
30202,PASORAPA,estado nutricional en menores de 5 anos,clasificacion e,2002-09-01,9,5,9,5,14
21305,PATACAMAYA,estado nutricional en menores de 5 anos,clasificacion e,2002-09-01,19,8,19,8,27
40602,PAZÃ‘A,estado nutricional en menores de 5 anos,clasificacion e,2002-09-01,4,1,4,1,5
20702,PELECHUCO,estado nutricional en menores de 5 anos,clasificacion e,2002-09-01,12,17,12,17,29
50403,POCOATA,estado nutricional en menores de 5 anos,clasificacion e,2002-09-01,43,42,43,42,85
31203,POCONA,estado nutricional en menores de 5 anos,clasificacion e,2002-09-01,19,11,19,11,30
31202,POJO (CBBA),estado nutricional en menores de 5 anos,clasificacion e,2002-09-01,27,25,27,25,52
40601,POOPO,estado nutricional en menores de 5 anos,clasificacion e,2002-09-01,1,4,1,4,5
51203,PORCO,estado nutricional en menores de 5 anos,clasificacion e,2002-09-01,9,4,9,4,13
10103,POROMA,estado nutricional en menores de 5 anos,clasificacion e,2002-09-01,43,49,43,49,92
70103,PORONGO,estado nutricional en menores de 5 anos,clasificacion e,2002-09-01,2,2,2,2,4
70601,PORTACHUELO,estado nutricional en menores de 5 anos,clasificacion e,2002-09-01,10,7,10,7,17
90102,PORVENIR,estado nutricional en menores de 5 anos,clasificacion e,2002-09-01,3,1,3,1,4
70804,POSTRER VALLE,estado nutricional en menores de 5 anos,clasificacion e,2002-09-01,1,1,1,1,2
50101,POTOSI,estado nutricional en menores de 5 anos,clasificacion e,2002-09-01,143,85,143,85,228
10302,PRESTO,estado nutricional en menores de 5 anos,clasificacion e,2002-09-01,38,36,38,36,74
21201,PUCARANI,estado nutricional en menores de 5 anos,clasificacion e,2002-09-01,5,14,5,14,19
20401,PUERTO ACOSTA,estado nutricional en menores de 5 anos,clasificacion e,2002-09-01,23,11,23,11,34
20403,PUERTO CARABUCO,estado nutricional en menores de 5 anos,clasificacion e,2002-09-01,7,10,7,10,17
90301,PUERTO GONZALO MORENO,estado nutricional en menores de 5 anos,clasificacion e,2002-09-01,0,1,0,1,1
21204,PUERTO PEREZ,estado nutricional en menores de 5 anos,clasificacion e,2002-09-01,0,1,0,1,1
71402,PUERTO QUIJARRO,estado nutricional en menores de 5 anos,clasificacion e,2002-09-01,10,2,10,2,12
90201,PUERTO RICO,estado nutricional en menores de 5 anos,clasificacion e,2002-09-01,7,2,7,2,9
71401,PUERTO SUAREZ,estado nutricional en menores de 5 anos,clasificacion e,2002-09-01,7,4,7,4,11
31205,PUERTO VILLARROEL,estado nutricional en menores de 5 anos,clasificacion e,2002-09-01,60,30,60,30,90
51101,PUNA,estado nutricional en menores de 5 anos,clasificacion e,2002-09-01,98,106,98,106,204
31401,PUNATA,estado nutricional en menores de 5 anos,clasificacion e,2002-09-01,7,5,7,5,12
20604,QUIABAYA,estado nutricional en menores de 5 anos,clasificacion e,2002-09-01,3,6,3,6,9
30901,QUILLACOLLO,estado nutricional en menores de 5 anos,clasificacion e,2002-09-01,29,22,29,22,51
21002,QUIME,estado nutricional en menores de 5 anos,clasificacion e,2002-09-01,9,7,9,7,16
70904,QUIRUSILLAS,estado nutricional en menores de 5 anos,clasificacion e,2002-09-01,0,2,0,2,2
50402,RAVELO,estado nutricional en menores de 5 anos,clasificacion e,2002-09-01,88,78,88,78,166
80301,REYES,estado nutricional en menores de 5 anos,clasificacion e,2002-09-01,2,2,2,2,4
80201,RIBERALTA,estado nutricional en menores de 5 anos,clasificacion e,2002-09-01,144,100,144,100,244
70503,ROBORE,estado nutricional en menores de 5 anos,clasificacion e,2002-09-01,6,6,6,6,12
80304,RURRENABAQUE,estado nutricional en menores de 5 anos,clasificacion e,2002-09-01,4,0,4,0,4
31001,SACABA,estado nutricional en menores de 5 anos,clasificacion e,2002-09-01,64,43,64,43,107
30404,SACABAMBA,estado nutricional en menores de 5 anos,clasificacion e,2002-09-01,0,26,0,26,26
50701,SACACA,estado nutricional en menores de 5 anos,clasificacion e,2002-09-01,73,75,73,75,148
71302,SAIPINA,estado nutricional en menores de 5 anos,clasificacion e,2002-09-01,2,5,2,5,7
40801,SALINAS DE GARCI MENDOZA,estado nutricional en menores de 5 anos,clasificacion e,2002-09-01,6,5,6,5,11
70901,SAMAIPATA,estado nutricional en menores de 5 anos,clasificacion e,2002-09-01,5,2,5,2,7
80602,SAN ANDRES,estado nutricional en menores de 5 anos,clasificacion e,2002-09-01,2,1,2,1,3
51003,SAN ANTONIO DE ESMORUCO,estado nutricional en menores de 5 anos,clasificacion e,2002-09-01,2,3,2,3,5
71105,SAN ANTONIO DE LOMERIO,estado nutricional en menores de 5 anos,clasificacion e,2002-09-01,24,29,24,29,53
31403,SAN BENITO,estado nutricional en menores de 5 anos,clasificacion e,2002-09-01,7,1,7,1,8
80302,SAN BORJA,estado nutricional en menores de 5 anos,clasificacion e,2002-09-01,31,31,31,31,62
21502,SAN BUENA VENTURA,estado nutricional en menores de 5 anos,clasificacion e,2002-09-01,11,11,11,11,22
70402,SAN CARLOS,estado nutricional en menores de 5 anos,clasificacion e,2002-09-01,13,5,13,5,18
80501,SAN IGNACIO,estado nutricional en menores de 5 anos,clasificacion e,2002-09-01,42,42,42,42,84
70301,SAN IGNACIO DE VELASCO,estado nutricional en menores de 5 anos,clasificacion e,2002-09-01,76,44,76,44,120
80102,SAN JAVIER(BNI),estado nutricional en menores de 5 anos,clasificacion e,2002-09-01,0,2,0,2,2
71102,SAN JAVIER(STC),estado nutricional en menores de 5 anos,clasificacion e,2002-09-01,0,1,0,1,1
80701,SAN JOAQUIN,estado nutricional en menores de 5 anos,clasificacion e,2002-09-01,0,6,0,6,6
70501,SAN JOSE DE CHIQUITOS,estado nutricional en menores de 5 anos,clasificacion e,2002-09-01,9,2,9,2,11
71104,SAN JULIAN,estado nutricional en menores de 5 anos,clasificacion e,2002-09-01,16,25,16,25,41
90302,SAN LORENZO(PND),estado nutricional en menores de 5 anos,clasificacion e,2002-09-01,2,1,2,1,3
60501,SAN LORENZO(TJA),estado nutricional en menores de 5 anos,clasificacion e,2002-09-01,6,7,6,7,13
10702,SAN LUCAS,estado nutricional en menores de 5 anos,clasificacion e,2002-09-01,130,98,130,98,228
71201,SAN MATIAS,estado nutricional en menores de 5 anos,clasificacion e,2002-09-01,19,11,19,11,30
70302,SAN MIGUEL DE VELASCO,estado nutricional en menores de 5 anos,clasificacion e,2002-09-01,23,16,23,16,39
51001,SAN PABLO DE LIPEZ,estado nutricional en menores de 5 anos,clasificacion e,2002-09-01,3,2,3,2,5
50501,SAN PEDRO DE BUENA VISTA,estado nutricional en menores de 5 anos,clasificacion e,2002-09-01,37,84,37,84,121
21801,SAN PEDRO DE CURAHUARA,estado nutricional en menores de 5 anos,clasificacion e,2002-09-01,1,1,1,1,2
21702,SAN PEDRO DE TIQUINA,estado nutricional en menores de 5 anos,clasificacion e,2002-09-01,0,1,0,1,1
70303,SAN RAFAEL,estado nutricional en menores de 5 anos,clasificacion e,2002-09-01,13,8,13,8,21
80401,SANTA ANA,estado nutricional en menores de 5 anos,clasificacion e,2002-09-01,6,0,6,0,6
70101,SANTA CRUZ DE LA SIERRA,estado nutricional en menores de 5 anos,clasificacion e,2002-09-01,148,90,148,90,238
80303,SANTA ROSA,estado nutricional en menores de 5 anos,clasificacion e,2002-09-01,3,0,3,0,3
70602,SANTA ROSA DEL SARA,estado nutricional en menores de 5 anos,clasificacion e,2002-09-01,0,1,0,1,1
20308,SANTIAGO DE CALLAPA,estado nutricional en menores de 5 anos,clasificacion e,2002-09-01,6,3,6,3,9
41401,SANTIAGO DE HUARI,estado nutricional en menores de 5 anos,clasificacion e,2002-09-01,3,1,3,1,4
21901,SANTIAGO DE MACHACA,estado nutricional en menores de 5 anos,clasificacion e,2002-09-01,1,1,1,1,2
30702,SANTIVAÃ‘ES,estado nutricional en menores de 5 anos,clasificacion e,2002-09-01,6,10,6,10,16
40202,SANTUARIO DE QUILLACAS,estado nutricional en menores de 5 anos,clasificacion e,2002-09-01,1,2,1,2,3
20902,SAPAHAQUI,estado nutricional en menores de 5 anos,clasificacion e,2002-09-01,3,1,3,1,4
90303,SENA,estado nutricional en menores de 5 anos,clasificacion e,2002-09-01,6,1,6,1,7
21301,SICA SICA (VILLA AROMA),estado nutricional en menores de 5 anos,clasificacion e,2002-09-01,14,6,14,6,20
30703,SICAYA,estado nutricional en menores de 5 anos,clasificacion e,2002-09-01,6,1,6,1,7
30902,SIPE SIPE,estado nutricional en menores de 5 anos,clasificacion e,2002-09-01,56,38,56,38,94
10403,SOPACHUY,estado nutricional en menores de 5 anos,clasificacion e,2002-09-01,28,26,28,26,54
20601,SORATA,estado nutricional en menores de 5 anos,clasificacion e,2002-09-01,5,7,5,7,12
10101,SUCRE,estado nutricional en menores de 5 anos,clasificacion e,2002-09-01,180,125,180,125,305
31404,TACACHI,estado nutricional en menores de 5 anos,clasificacion e,2002-09-01,0,1,0,1,1
20603,TACACOMA,estado nutricional en menores de 5 anos,clasificacion e,2002-09-01,3,0,3,0,3
50303,TACOBAMBA,estado nutricional en menores de 5 anos,clasificacion e,2002-09-01,18,15,18,15,33
30602,TACOPAYA,estado nutricional en menores de 5 anos,clasificacion e,2002-09-01,24,23,24,23,47
51402,TAHUA,estado nutricional en menores de 5 anos,clasificacion e,2002-09-01,1,1,1,1,2
31101,TAPACARI,estado nutricional en menores de 5 anos,clasificacion e,2002-09-01,30,59,30,59,89
10601,TARABUCO,estado nutricional en menores de 5 anos,clasificacion e,2002-09-01,152,126,152,126,278
30401,TARATA,estado nutricional en menores de 5 anos,clasificacion e,2002-09-01,11,7,11,7,18
60101,TARIJA,estado nutricional en menores de 5 anos,clasificacion e,2002-09-01,36,17,36,17,53
10202,TARVITA,estado nutricional en menores de 5 anos,clasificacion e,2002-09-01,38,70,38,70,108
20803,TIAWANACU,estado nutricional en menores de 5 anos,clasificacion e,2002-09-01,7,3,7,3,10
50102,TINGUIPAYA,estado nutricional en menores de 5 anos,clasificacion e,2002-09-01,14,74,14,74,88
20606,TIPUANI,estado nutricional en menores de 5 anos,clasificacion e,2002-09-01,3,0,3,0,3
30903,TIQUIPAYA,estado nutricional en menores de 5 anos,clasificacion e,2002-09-01,12,15,12,15,27
31601,TIRAQUE (CBBA),estado nutricional en menores de 5 anos,clasificacion e,2002-09-01,40,45,40,45,85
30802,TOCO,estado nutricional en menores de 5 anos,clasificacion e,2002-09-01,0,2,0,2,2
30803,TOLATA,estado nutricional en menores de 5 anos,clasificacion e,2002-09-01,1,5,1,5,6
41001,TOLEDO,estado nutricional en menores de 5 anos,clasificacion e,2002-09-01,1,2,1,2,3
51202,TOMAVE,estado nutricional en menores de 5 anos,clasificacion e,2002-09-01,12,16,12,16,28
10402,TOMINA,estado nutricional en menores de 5 anos,clasificacion e,2002-09-01,26,50,26,50,76
50502,TORO TORO,estado nutricional en menores de 5 anos,clasificacion e,2002-09-01,19,12,19,12,31
31201,TOTORA(CBBA),estado nutricional en menores de 5 anos,clasificacion e,2002-09-01,17,13,17,13,30
41301,TOTORA(ORR),estado nutricional en menores de 5 anos,clasificacion e,2002-09-01,1,2,1,2,3
80101,TRINIDAD,estado nutricional en menores de 5 anos,clasificacion e,2002-09-01,15,87,15,87,102
50801,TUPIZA,estado nutricional en menores de 5 anos,clasificacion e,2002-09-01,8,76,8,76,84
21302,UMALA,estado nutricional en menores de 5 anos,clasificacion e,2002-09-01,1,0,1,0,1
50201,UNCIA,estado nutricional en menores de 5 anos,clasificacion e,2002-09-01,1,5,1,5,6
60401,URIONDO (A. CONCEPCION),estado nutricional en menores de 5 anos,clasificacion e,2002-09-01,1,1,1,1,2
71502,URUBICHA,estado nutricional en menores de 5 anos,clasificacion e,2002-09-01,2,5,2,5,7
51201,UYUNI,estado nutricional en menores de 5 anos,clasificacion e,2002-09-01,10,18,10,18,28
30502,VACAS,estado nutricional en menores de 5 anos,clasificacion e,2002-09-01,17,8,17,8,25
70801,VALLEGRANDE,estado nutricional en menores de 5 anos,clasificacion e,2002-09-01,18,12,18,12,30
20801,VIACHA,estado nutricional en menores de 5 anos,clasificacion e,2002-09-01,19,17,19,17,36
31302,VILA VILA,estado nutricional en menores de 5 anos,clasificacion e,2002-09-01,2,9,2,9,11
60303,VILLA MONTES,estado nutricional en menores de 5 anos,clasificacion e,2002-09-01,10,4,10,4,14
31402,VILLA RIVERO,estado nutricional en menores de 5 anos,clasificacion e,2002-09-01,5,3,5,3,8
10801,VILLA SERRANO,estado nutricional en menores de 5 anos,clasificacion e,2002-09-01,51,85,51,85,136
31003,VILLA TUNARI,estado nutricional en menores de 5 anos,clasificacion e,2002-09-01,25,49,25,49,74
11001,VILLA VACA GUZMAN (MUYUPAMPA),estado nutricional en menores de 5 anos,clasificacion e,2002-09-01,14,12,14,12,26
51501,VILLAZON,estado nutricional en menores de 5 anos,clasificacion e,2002-09-01,28,23,28,23,51
30904,VINTO,estado nutricional en menores de 5 anos,clasificacion e,2002-09-01,15,5,15,5,20
50602,VITICHI,estado nutricional en menores de 5 anos,clasificacion e,2002-09-01,9,11,9,11,20
20306,WALDO BALLIVIAN,estado nutricional en menores de 5 anos,clasificacion e,2002-09-01,3,0,3,0,3
70201,WARNES,estado nutricional en menores de 5 anos,clasificacion e,2002-09-01,32,21,32,21,53
20903,YACO,estado nutricional en menores de 5 anos,clasificacion e,2002-09-01,6,3,6,3,9
60301,YACUIBA,estado nutricional en menores de 5 anos,clasificacion e,2002-09-01,21,21,21,21,42
10602,YAMPARAEZ,estado nutricional en menores de 5 anos,clasificacion e,2002-09-01,72,43,72,43,115
21103,YANACACHI,estado nutricional en menores de 5 anos,clasificacion e,2002-09-01,1,4,1,4,5
70403,YAPACANI,estado nutricional en menores de 5 anos,clasificacion e,2002-09-01,18,18,18,18,36
50103,YOCALLA,estado nutricional en menores de 5 anos,clasificacion e,2002-09-01,6,6,6,6,12
10102,YOTALA,estado nutricional en menores de 5 anos,clasificacion e,2002-09-01,34,39,34,39,73
60402,YUNCHARA,estado nutricional en menores de 5 anos,clasificacion e,2002-09-01,2,4,2,4,6
10301,ZUDAÃ‘EZ,estado nutricional en menores de 5 anos,clasificacion e,2002-09-01,34,43,34,43,77
51302,ACACIO,estado nutricional en menores de 5 anos,clasificacion e,2002-10-01,21,32,21,32,53
20201,ACHACACHI,estado nutricional en menores de 5 anos,clasificacion e,2002-10-01,34,22,34,22,56
20104,ACHOCALLA,estado nutricional en menores de 5 anos,clasificacion e,2002-10-01,6,6,6,6,12
30201,AIQUILE,estado nutricional en menores de 5 anos,clasificacion e,2002-10-01,10,20,10,20,30
31303,ALALAY,estado nutricional en menores de 5 anos,clasificacion e,2002-10-01,1,26,1,26,27
10404,ALCALA,estado nutricional en menores de 5 anos,clasificacion e,2002-10-01,8,17,8,17,25
20202,ANCORAIMES,estado nutricional en menores de 5 anos,clasificacion e,2002-10-01,9,18,9,18,27
30402,ANZALDO,estado nutricional en menores de 5 anos,clasificacion e,2002-10-01,6,18,6,18,24
20701,APOLO,estado nutricional en menores de 5 anos,clasificacion e,2002-10-01,5,14,5,14,19
51301,ARAMPAMPA,estado nutricional en menores de 5 anos,clasificacion e,2002-10-01,11,10,11,10,21
30501,ARANI,estado nutricional en menores de 5 anos,clasificacion e,2002-10-01,8,6,8,6,14
30403,ARBIETO,estado nutricional en menores de 5 anos,clasificacion e,2002-10-01,0,13,0,13,13
30601,ARQUE,estado nutricional en menores de 5 anos,clasificacion e,2002-10-01,17,10,17,10,27
71501,ASCENCION DE GUARAYOS,estado nutricional en menores de 5 anos,clasificacion e,2002-10-01,113,62,113,62,175
50802,ATOCHA,estado nutricional en menores de 5 anos,clasificacion e,2002-10-01,0,32,0,32,32
20503,AUCAPATA,estado nutricional en menores de 5 anos,clasificacion e,2002-10-01,6,0,6,0,6
20502,AYATA,estado nutricional en menores de 5 anos,clasificacion e,2002-10-01,10,2,10,2,12
21303,AYO AYO,estado nutricional en menores de 5 anos,clasificacion e,2002-10-01,1,1,1,1,2
30301,AYOPAYA (V. DE INDEPENDENCIA),estado nutricional en menores de 5 anos,clasificacion e,2002-10-01,39,23,39,23,62
10201,AZURDUY,estado nutricional en menores de 5 anos,clasificacion e,2002-10-01,66,71,66,71,137
21203,BATALLAS,estado nutricional en menores de 5 anos,clasificacion e,2002-10-01,3,6,3,6,9
80802,BAURES,estado nutricional en menores de 5 anos,clasificacion e,2002-10-01,6,3,6,3,9
41202,BELEN DE ANDAMARCA,estado nutricional en menores de 5 anos,clasificacion e,2002-10-01,0,1,0,1,1
50104,BELEN DE URMIRI,estado nutricional en menores de 5 anos,clasificacion e,2002-10-01,0,4,0,4,4
60202,BERMEJO,estado nutricional en menores de 5 anos,clasificacion e,2002-10-01,2,1,2,1,3
50301,BETANZOS,estado nutricional en menores de 5 anos,clasificacion e,2002-10-01,75,79,75,79,154
31501,BOLIVAR,estado nutricional en menores de 5 anos,clasificacion e,2002-10-01,31,20,31,20,51
70707,BOYUIBE,estado nutricional en menores de 5 anos,clasificacion e,2002-10-01,1,13,1,13,14
70703,CABEZAS,estado nutricional en menores de 5 anos,clasificacion e,2002-10-01,5,10,5,10,15
20905,CAIROMA,estado nutricional en menores de 5 anos,clasificacion e,2002-10-01,33,44,33,44,77
51102,"CAIZA ""D""",estado nutricional en menores de 5 anos,clasificacion e,2002-10-01,29,19,29,19,48
21003,CAJUATA,estado nutricional en menores de 5 anos,clasificacion e,2002-10-01,19,12,19,12,31
20303,CALACOTO,estado nutricional en menores de 5 anos,clasificacion e,2002-10-01,2,4,2,4,6
21304,CALAMARCA,estado nutricional en menores de 5 anos,clasificacion e,2002-10-01,37,11,37,11,48
10701,CAMARGO,estado nutricional en menores de 5 anos,clasificacion e,2002-10-01,24,30,24,30,54
10901,CAMATAQUI (C. VILLA ABECIA),estado nutricional en menores de 5 anos,clasificacion e,2002-10-01,4,3,4,3,7
70706,CAMIRI,estado nutricional en menores de 5 anos,clasificacion e,2002-10-01,28,18,28,18,46
30701,CAPINOTA,estado nutricional en menores de 5 anos,clasificacion e,2002-10-01,39,29,39,29,68
20302,CAQUIAVIRI,estado nutricional en menores de 5 anos,clasificacion e,2002-10-01,4,5,4,5,9
40102,CARACOLLO,estado nutricional en menores de 5 anos,clasificacion e,2002-10-01,7,16,7,16,23
22001,CARANAVI,estado nutricional en menores de 5 anos,clasificacion e,2002-10-01,26,22,26,22,48
60302,CARAPARI,estado nutricional en menores de 5 anos,clasificacion e,2002-10-01,7,6,7,6,13
50702,CARIPUYO,estado nutricional en menores de 5 anos,clasificacion e,2002-10-01,16,15,16,15,31
40201,CHALLAPATA,estado nutricional en menores de 5 anos,clasificacion e,2002-10-01,17,21,17,21,38
50302,CHAQUI,estado nutricional en menores de 5 anos,clasificacion e,2002-10-01,17,16,17,16,33
70702,CHARAGUA,estado nutricional en menores de 5 anos,clasificacion e,2002-10-01,5,22,5,22,27
20305,CHARAÃ‘A,estado nutricional en menores de 5 anos,clasificacion e,2002-10-01,4,4,4,4,8
50202,CHAYANTA,estado nutricional en menores de 5 anos,clasificacion e,2002-10-01,20,15,20,15,35
31204,CHIMORE,estado nutricional en menores de 5 anos,clasificacion e,2002-10-01,12,3,12,3,15
40302,CHOQUE COTA,estado nutricional en menores de 5 anos,clasificacion e,2002-10-01,3,0,3,0,3
21101,CHULUMANI (V. DE LA LIBERTAD),estado nutricional en menores de 5 anos,clasificacion e,2002-10-01,1,1,1,1,2
20501,CHUMA,estado nutricional en menores de 5 anos,clasificacion e,2002-10-01,9,1,9,1,10
30801,CLIZA,estado nutricional en menores de 5 anos,clasificacion e,2002-10-01,10,5,10,5,15
90101,COBIJA,estado nutricional en menores de 5 anos,clasificacion e,2002-10-01,32,21,32,21,53
30101,COCHABAMBA,estado nutricional en menores de 5 anos,clasificacion e,2002-10-01,107,130,107,130,237
40902,COIPASA,estado nutricional en menores de 5 anos,clasificacion e,2002-10-01,1,0,1,0,1
30905,COLCAPIRHUA,estado nutricional en menores de 5 anos,clasificacion e,2002-10-01,11,11,11,11,22
50901,"COLCHA ""K""",estado nutricional en menores de 5 anos,clasificacion e,2002-10-01,6,8,6,8,14
21307,COLLANA,estado nutricional en menores de 5 anos,clasificacion e,2002-10-01,0,1,0,1,1
31002,COLOMI,estado nutricional en menores de 5 anos,clasificacion e,2002-10-01,4,16,4,16,20
50401,COLQUECHACA,estado nutricional en menores de 5 anos,clasificacion e,2002-10-01,90,43,90,43,133
21306,COLQUENCHA,estado nutricional en menores de 5 anos,clasificacion e,2002-10-01,2,7,2,7,9
21004,COLQUIRI,estado nutricional en menores de 5 anos,clasificacion e,2002-10-01,28,24,28,24,52
20304,COMANCHE,estado nutricional en menores de 5 anos,clasificacion e,2002-10-01,2,3,2,3,5
71301,COMARAPA,estado nutricional en menores de 5 anos,clasificacion e,2002-10-01,18,22,18,22,40
20605,COMBAYA,estado nutricional en menores de 5 anos,clasificacion e,2002-10-01,2,4,2,4,6
71101,CONCEPCION,estado nutricional en menores de 5 anos,clasificacion e,2002-10-01,5,2,5,2,7
21701,COPACABANA,estado nutricional en menores de 5 anos,clasificacion e,2002-10-01,8,7,8,7,15
21402,CORIPATA,estado nutricional en menores de 5 anos,clasificacion e,2002-10-01,0,4,0,4,4
20301,CORO CORO,estado nutricional en menores de 5 anos,clasificacion e,2002-10-01,5,0,5,0,5
21401,COROICO,estado nutricional en menores de 5 anos,clasificacion e,2002-10-01,6,3,6,3,9
40301,CORQUE,estado nutricional en menores de 5 anos,clasificacion e,2002-10-01,5,4,5,4,9
50601,COTAGAITA,estado nutricional en menores de 5 anos,clasificacion e,2002-10-01,50,65,50,65,115
70102,COTOCA,estado nutricional en menores de 5 anos,clasificacion e,2002-10-01,36,10,36,10,46
31405,CUCHUMUELA (V. G. VILLARROEL),estado nutricional en menores de 5 anos,clasificacion e,2002-10-01,2,4,2,4,6
70704,CUEVO,estado nutricional en menores de 5 anos,clasificacion e,2002-10-01,6,0,6,0,6
10902,CULPINA,estado nutricional en menores de 5 anos,clasificacion e,2002-10-01,53,43,53,43,96
40401,CURAHUARA DE CARANGAS,estado nutricional en menores de 5 anos,clasificacion e,2002-10-01,6,0,6,0,6
21602,CURVA,estado nutricional en menores de 5 anos,clasificacion e,2002-10-01,2,3,2,3,5
20804,DESAGUADERO,estado nutricional en menores de 5 anos,clasificacion e,2002-10-01,1,5,1,5,6
20105,EL ALTO,estado nutricional en menores de 5 anos,clasificacion e,2002-10-01,476,338,476,338,814
40103,EL CHORO,estado nutricional en menores de 5 anos,clasificacion e,2002-10-01,2,4,2,4,6
71503,EL PUENTE(STC),estado nutricional en menores de 5 anos,clasificacion e,2002-10-01,2,17,2,17,19
60502,EL PUENTE(TJA),estado nutricional en menores de 5 anos,clasificacion e,2002-10-01,18,33,18,33,51
70105,EL TORNO,estado nutricional en menores de 5 anos,clasificacion e,2002-10-01,23,12,23,12,35
10405,EL VILLAR,estado nutricional en menores de 5 anos,clasificacion e,2002-10-01,20,40,20,40,60
60601,ENTRE RIOS,estado nutricional en menores de 5 anos,clasificacion e,2002-10-01,2,11,2,11,13
41101,EUCALIPTUS,estado nutricional en menores de 5 anos,clasificacion e,2002-10-01,1,6,1,6,7
90203,FILADELFIA,estado nutricional en menores de 5 anos,clasificacion e,2002-10-01,0,5,0,5,5
71002,GENERAL SAAVEDRA,estado nutricional en menores de 5 anos,clasificacion e,2002-10-01,18,21,18,21,39
21601,GRAL. J.J. PEREZ (CHARAZANI),estado nutricional en menores de 5 anos,clasificacion e,2002-10-01,14,20,14,20,34
20602,GUANAY,estado nutricional en menores de 5 anos,clasificacion e,2002-10-01,16,28,16,28,44
20802,GUAQUI,estado nutricional en menores de 5 anos,clasificacion e,2002-10-01,3,1,3,1,4
80202,GUAYARAMERIN,estado nutricional en menores de 5 anos,clasificacion e,2002-10-01,34,24,34,24,58
70705,GUTIERREZ,estado nutricional en menores de 5 anos,clasificacion e,2002-10-01,23,44,23,44,67
10502,HUACARETA,estado nutricional en menores de 5 anos,clasificacion e,2002-10-01,19,17,19,17,36
11002,HUACAYA (VILLA DE HUACAYA),estado nutricional en menores de 5 anos,clasificacion e,2002-10-01,4,3,4,3,7
40701,HUANUNI,estado nutricional en menores de 5 anos,clasificacion e,2002-10-01,20,12,20,12,32
80803,HUARACAJE,estado nutricional en menores de 5 anos,clasificacion e,2002-10-01,5,4,5,4,9
21005,ICHOCA,estado nutricional en menores de 5 anos,clasificacion e,2002-10-01,22,11,22,11,33
10304,ICLA,estado nutricional en menores de 5 anos,clasificacion e,2002-10-01,40,68,40,68,108
10703,INCAHUASI,estado nutricional en menores de 5 anos,clasificacion e,2002-10-01,34,28,34,28,62
21001,INQUISIVI,estado nutricional en menores de 5 anos,clasificacion e,2002-10-01,33,20,33,20,53
21102,IRUPANA (VILLA DE LANZA),estado nutricional en menores de 5 anos,clasificacion e,2002-10-01,0,1,0,1,1
21501,IXIAMAS,estado nutricional en menores de 5 anos,clasificacion e,2002-10-01,4,13,4,13,17
21105,LA ASUNTA,estado nutricional en menores de 5 anos,clasificacion e,2002-10-01,7,5,7,5,12
70104,LA GUARDIA,estado nutricional en menores de 5 anos,clasificacion e,2002-10-01,16,10,16,10,26
20101,LA PAZ,estado nutricional en menores de 5 anos,clasificacion e,2002-10-01,261,168,261,168,429
70701,LAGUNILLAS,estado nutricional en menores de 5 anos,clasificacion e,2002-10-01,7,8,7,8,15
21202,LAJA,estado nutricional en menores de 5 anos,clasificacion e,2002-10-01,15,6,15,6,21
10903,LAS CARRERAS,estado nutricional en menores de 5 anos,clasificacion e,2002-10-01,6,12,6,12,18
50203,LLALLAGUA,estado nutricional en menores de 5 anos,clasificacion e,2002-10-01,7,78,7,78,85
51401,LLICA,estado nutricional en menores de 5 anos,clasificacion e,2002-10-01,1,1,1,1,2
80601,LORETO,estado nutricional en menores de 5 anos,clasificacion e,2002-10-01,6,3,6,3,9
20901,LURIBAY,estado nutricional en menores de 5 anos,clasificacion e,2002-10-01,8,7,8,7,15
40702,MACHACAMARCA,estado nutricional en menores de 5 anos,clasificacion e,2002-10-01,1,2,1,2,3
11003,MACHARETI,estado nutricional en menores de 5 anos,clasificacion e,2002-10-01,13,24,13,24,37
80801,MAGDALENA,estado nutricional en menores de 5 anos,clasificacion e,2002-10-01,4,0,4,0,4
70903,MAIRANA,estado nutricional en menores de 5 anos,clasificacion e,2002-10-01,10,4,10,4,14
20904,MALLA,estado nutricional en menores de 5 anos,clasificacion e,2002-10-01,1,4,1,4,5
20103,MECAPACA,estado nutricional en menores de 5 anos,clasificacion e,2002-10-01,2,6,2,6,8
71003,MINEROS,estado nutricional en menores de 5 anos,clasificacion e,2002-10-01,43,13,43,13,56
31301,MIZQUE,estado nutricional en menores de 5 anos,clasificacion e,2002-10-01,10,26,10,26,36
20402,MOCOMOCO,estado nutricional en menores de 5 anos,clasificacion e,2002-10-01,17,13,17,13,30
51002,MOJINETE,estado nutricional en menores de 5 anos,clasificacion e,2002-10-01,1,3,1,3,4
10303,MOJOCOYA,estado nutricional en menores de 5 anos,clasificacion e,2002-10-01,25,23,25,23,48
10501,MONTEAGUDO,estado nutricional en menores de 5 anos,clasificacion e,2002-10-01,25,50,25,50,75
71001,MONTERO,estado nutricional en menores de 5 anos,clasificacion e,2002-10-01,81,39,81,39,120
70803,MORO MORO,estado nutricional en menores de 5 anos,clasificacion e,2002-10-01,6,5,6,5,11
30302,MOROCHATA,estado nutricional en menores de 5 anos,clasificacion e,2002-10-01,20,34,20,34,54
90401,NACEBE (SANTA ROSA DEL ABUNA),estado nutricional en menores de 5 anos,clasificacion e,2002-10-01,2,5,2,5,7
20307,NAZACARA DE PACAJES,estado nutricional en menores de 5 anos,clasificacion e,2002-10-01,2,0,2,0,2
90501,NUEVO MANOA (NUEVA ESPERANZA),estado nutricional en menores de 5 anos,clasificacion e,2002-10-01,2,3,2,3,5
50404,OCURI,estado nutricional en menores de 5 anos,clasificacion e,2002-10-01,26,30,26,30,56
70202,OKINAWA,estado nutricional en menores de 5 anos,clasificacion e,2002-10-01,2,0,2,0,2
30203,OMEREQUE,estado nutricional en menores de 5 anos,clasificacion e,2002-10-01,0,1,0,1,1
40101,ORURO,estado nutricional en menores de 5 anos,clasificacion e,2002-10-01,173,97,173,97,270
60201,PADCAYA,estado nutricional en menores de 5 anos,clasificacion e,2002-10-01,7,11,7,11,18
10401,PADILLA,estado nutricional en menores de 5 anos,clasificacion e,2002-10-01,37,46,37,46,83
70502,PAILON,estado nutricional en menores de 5 anos,clasificacion e,2002-10-01,8,12,8,12,20
20102,PALCA,estado nutricional en menores de 5 anos,clasificacion e,2002-10-01,8,16,8,16,24
21104,PALOS BLANCOS,estado nutricional en menores de 5 anos,clasificacion e,2002-10-01,9,10,9,10,19
40802,PAMPA AULLAGAS,estado nutricional en menores de 5 anos,clasificacion e,2002-10-01,8,3,8,3,11
70902,PAMPA GRANDE,estado nutricional en menores de 5 anos,clasificacion e,2002-10-01,2,5,2,5,7
21802,PAPEL PAMPA,estado nutricional en menores de 5 anos,clasificacion e,2002-10-01,1,0,1,0,1
30202,PASORAPA,estado nutricional en menores de 5 anos,clasificacion e,2002-10-01,5,10,5,10,15
21305,PATACAMAYA,estado nutricional en menores de 5 anos,clasificacion e,2002-10-01,14,11,14,11,25
40602,PAZÃ‘A,estado nutricional en menores de 5 anos,clasificacion e,2002-10-01,1,1,1,1,2
20702,PELECHUCO,estado nutricional en menores de 5 anos,clasificacion e,2002-10-01,6,5,6,5,11
50403,POCOATA,estado nutricional en menores de 5 anos,clasificacion e,2002-10-01,53,57,53,57,110
31203,POCONA,estado nutricional en menores de 5 anos,clasificacion e,2002-10-01,21,12,21,12,33
31202,POJO (CBBA),estado nutricional en menores de 5 anos,clasificacion e,2002-10-01,37,22,37,22,59
40601,POOPO,estado nutricional en menores de 5 anos,clasificacion e,2002-10-01,4,4,4,4,8
51203,PORCO,estado nutricional en menores de 5 anos,clasificacion e,2002-10-01,15,9,15,9,24
10103,POROMA,estado nutricional en menores de 5 anos,clasificacion e,2002-10-01,73,87,73,87,160
70103,PORONGO,estado nutricional en menores de 5 anos,clasificacion e,2002-10-01,1,1,1,1,2
70601,PORTACHUELO,estado nutricional en menores de 5 anos,clasificacion e,2002-10-01,12,7,12,7,19
70804,POSTRER VALLE,estado nutricional en menores de 5 anos,clasificacion e,2002-10-01,1,0,1,0,1
50101,POTOSI,estado nutricional en menores de 5 anos,clasificacion e,2002-10-01,173,129,173,129,302
10302,PRESTO,estado nutricional en menores de 5 anos,clasificacion e,2002-10-01,36,27,36,27,63
70805,PUCARA,estado nutricional en menores de 5 anos,clasificacion e,2002-10-01,1,1,1,1,2
21201,PUCARANI,estado nutricional en menores de 5 anos,clasificacion e,2002-10-01,3,8,3,8,11
20401,PUERTO ACOSTA,estado nutricional en menores de 5 anos,clasificacion e,2002-10-01,28,21,28,21,49
20403,PUERTO CARABUCO,estado nutricional en menores de 5 anos,clasificacion e,2002-10-01,12,13,12,13,25
90301,PUERTO GONZALO MORENO,estado nutricional en menores de 5 anos,clasificacion e,2002-10-01,3,1,3,1,4
21204,PUERTO PEREZ,estado nutricional en menores de 5 anos,clasificacion e,2002-10-01,3,1,3,1,4
71402,PUERTO QUIJARRO,estado nutricional en menores de 5 anos,clasificacion e,2002-10-01,2,1,2,1,3
90201,PUERTO RICO,estado nutricional en menores de 5 anos,clasificacion e,2002-10-01,8,7,8,7,15
71401,PUERTO SUAREZ,estado nutricional en menores de 5 anos,clasificacion e,2002-10-01,23,5,23,5,28
31205,PUERTO VILLARROEL,estado nutricional en menores de 5 anos,clasificacion e,2002-10-01,87,34,87,34,121
51101,PUNA,estado nutricional en menores de 5 anos,clasificacion e,2002-10-01,16,27,16,27,43
31401,PUNATA,estado nutricional en menores de 5 anos,clasificacion e,2002-10-01,37,17,37,17,54
20604,QUIABAYA,estado nutricional en menores de 5 anos,clasificacion e,2002-10-01,15,12,15,12,27
30901,QUILLACOLLO,estado nutricional en menores de 5 anos,clasificacion e,2002-10-01,40,31,40,31,71
21002,QUIME,estado nutricional en menores de 5 anos,clasificacion e,2002-10-01,25,13,25,13,38
70904,QUIRUSILLAS,estado nutricional en menores de 5 anos,clasificacion e,2002-10-01,0,1,0,1,1
50402,RAVELO,estado nutricional en menores de 5 anos,clasificacion e,2002-10-01,93,66,93,66,159
80301,REYES,estado nutricional en menores de 5 anos,clasificacion e,2002-10-01,9,4,9,4,13
80201,RIBERALTA,estado nutricional en menores de 5 anos,clasificacion e,2002-10-01,178,111,178,111,289
70503,ROBORE,estado nutricional en menores de 5 anos,clasificacion e,2002-10-01,5,6,5,6,11
80304,RURRENABAQUE,estado nutricional en menores de 5 anos,clasificacion e,2002-10-01,1,2,1,2,3
40901,SABAYA,estado nutricional en menores de 5 anos,clasificacion e,2002-10-01,0,1,0,1,1
31001,SACABA,estado nutricional en menores de 5 anos,clasificacion e,2002-10-01,66,33,66,33,99
30404,SACABAMBA,estado nutricional en menores de 5 anos,clasificacion e,2002-10-01,15,26,15,26,41
50701,SACACA,estado nutricional en menores de 5 anos,clasificacion e,2002-10-01,43,81,43,81,124
71302,SAIPINA,estado nutricional en menores de 5 anos,clasificacion e,2002-10-01,5,4,5,4,9
40801,SALINAS DE GARCI MENDOZA,estado nutricional en menores de 5 anos,clasificacion e,2002-10-01,3,7,3,7,10
70901,SAMAIPATA,estado nutricional en menores de 5 anos,clasificacion e,2002-10-01,5,0,5,0,5
80602,SAN ANDRES,estado nutricional en menores de 5 anos,clasificacion e,2002-10-01,10,7,10,7,17
71105,SAN ANTONIO DE LOMERIO,estado nutricional en menores de 5 anos,clasificacion e,2002-10-01,26,38,26,38,64
31403,SAN BENITO,estado nutricional en menores de 5 anos,clasificacion e,2002-10-01,3,0,3,0,3
80302,SAN BORJA,estado nutricional en menores de 5 anos,clasificacion e,2002-10-01,44,48,44,48,92
21502,SAN BUENA VENTURA,estado nutricional en menores de 5 anos,clasificacion e,2002-10-01,8,1,8,1,9
80501,SAN IGNACIO,estado nutricional en menores de 5 anos,clasificacion e,2002-10-01,31,28,31,28,59
70301,SAN IGNACIO DE VELASCO,estado nutricional en menores de 5 anos,clasificacion e,2002-10-01,50,48,50,48,98
80102,SAN JAVIER(BNI),estado nutricional en menores de 5 anos,clasificacion e,2002-10-01,4,5,4,5,9
71102,SAN JAVIER(STC),estado nutricional en menores de 5 anos,clasificacion e,2002-10-01,22,11,22,11,33
80701,SAN JOAQUIN,estado nutricional en menores de 5 anos,clasificacion e,2002-10-01,0,3,0,3,3
70501,SAN JOSE DE CHIQUITOS,estado nutricional en menores de 5 anos,clasificacion e,2002-10-01,27,2,27,2,29
71104,SAN JULIAN,estado nutricional en menores de 5 anos,clasificacion e,2002-10-01,56,36,56,36,92
90302,SAN LORENZO(PND),estado nutricional en menores de 5 anos,clasificacion e,2002-10-01,3,14,3,14,17
60501,SAN LORENZO(TJA),estado nutricional en menores de 5 anos,clasificacion e,2002-10-01,4,7,4,7,11
10702,SAN LUCAS,estado nutricional en menores de 5 anos,clasificacion e,2002-10-01,177,163,177,163,340
71201,SAN MATIAS,estado nutricional en menores de 5 anos,clasificacion e,2002-10-01,23,4,23,4,27
70302,SAN MIGUEL DE VELASCO,estado nutricional en menores de 5 anos,clasificacion e,2002-10-01,22,35,22,35,57
51001,SAN PABLO DE LIPEZ,estado nutricional en menores de 5 anos,clasificacion e,2002-10-01,1,6,1,6,7
50501,SAN PEDRO DE BUENA VISTA,estado nutricional en menores de 5 anos,clasificacion e,2002-10-01,43,111,43,111,154
21801,SAN PEDRO DE CURAHUARA,estado nutricional en menores de 5 anos,clasificacion e,2002-10-01,4,5,4,5,9
90202,SAN PEDRO(PND),estado nutricional en menores de 5 anos,clasificacion e,2002-10-01,1,2,1,2,3
70303,SAN RAFAEL,estado nutricional en menores de 5 anos,clasificacion e,2002-10-01,14,14,14,14,28
80702,SAN RAMON,estado nutricional en menores de 5 anos,clasificacion e,2002-10-01,1,0,1,0,1
80702,SAN RAMON,estado nutricional en menores de 5 anos,clasificacion e,2002-10-01,2,0,2,0,2
70101,SANTA CRUZ DE LA SIERRA,estado nutricional en menores de 5 anos,clasificacion e,2002-10-01,181,87,181,87,268
80303,SANTA ROSA,estado nutricional en menores de 5 anos,clasificacion e,2002-10-01,0,4,0,4,4
70602,SANTA ROSA DEL SARA,estado nutricional en menores de 5 anos,clasificacion e,2002-10-01,2,3,2,3,5
20308,SANTIAGO DE CALLAPA,estado nutricional en menores de 5 anos,clasificacion e,2002-10-01,5,6,5,6,11
41401,SANTIAGO DE HUARI,estado nutricional en menores de 5 anos,clasificacion e,2002-10-01,4,5,4,5,9
21901,SANTIAGO DE MACHACA,estado nutricional en menores de 5 anos,clasificacion e,2002-10-01,1,2,1,2,3
30702,SANTIVAÃ‘ES,estado nutricional en menores de 5 anos,clasificacion e,2002-10-01,7,4,7,4,11
40202,SANTUARIO DE QUILLACAS,estado nutricional en menores de 5 anos,clasificacion e,2002-10-01,3,2,3,2,5
20902,SAPAHAQUI,estado nutricional en menores de 5 anos,clasificacion e,2002-10-01,5,11,5,11,16
90303,SENA,estado nutricional en menores de 5 anos,clasificacion e,2002-10-01,0,9,0,9,9
21301,SICA SICA (VILLA AROMA),estado nutricional en menores de 5 anos,clasificacion e,2002-10-01,23,13,23,13,36
30703,SICAYA,estado nutricional en menores de 5 anos,clasificacion e,2002-10-01,3,5,3,5,8
30902,SIPE SIPE,estado nutricional en menores de 5 anos,clasificacion e,2002-10-01,64,27,64,27,91
10403,SOPACHUY,estado nutricional en menores de 5 anos,clasificacion e,2002-10-01,33,34,33,34,67
20601,SORATA,estado nutricional en menores de 5 anos,clasificacion e,2002-10-01,11,13,11,13,24
10101,SUCRE,estado nutricional en menores de 5 anos,clasificacion e,2002-10-01,197,156,197,156,353
31404,TACACHI,estado nutricional en menores de 5 anos,clasificacion e,2002-10-01,0,2,0,2,2
20603,TACACOMA,estado nutricional en menores de 5 anos,clasificacion e,2002-10-01,4,7,4,7,11
50303,TACOBAMBA,estado nutricional en menores de 5 anos,clasificacion e,2002-10-01,31,24,31,24,55
30602,TACOPAYA,estado nutricional en menores de 5 anos,clasificacion e,2002-10-01,17,43,17,43,60
51402,TAHUA,estado nutricional en menores de 5 anos,clasificacion e,2002-10-01,1,0,1,0,1
31101,TAPACARI,estado nutricional en menores de 5 anos,clasificacion e,2002-10-01,41,25,41,25,66
10601,TARABUCO,estado nutricional en menores de 5 anos,clasificacion e,2002-10-01,136,114,136,114,250
30401,TARATA,estado nutricional en menores de 5 anos,clasificacion e,2002-10-01,8,7,8,7,15
60101,TARIJA,estado nutricional en menores de 5 anos,clasificacion e,2002-10-01,50,39,50,39,89
10202,TARVITA,estado nutricional en menores de 5 anos,clasificacion e,2002-10-01,35,51,35,51,86
20803,TIAWANACU,estado nutricional en menores de 5 anos,clasificacion e,2002-10-01,3,5,3,5,8
50102,TINGUIPAYA,estado nutricional en menores de 5 anos,clasificacion e,2002-10-01,74,61,74,61,135
20606,TIPUANI,estado nutricional en menores de 5 anos,clasificacion e,2002-10-01,1,3,1,3,4
30903,TIQUIPAYA,estado nutricional en menores de 5 anos,clasificacion e,2002-10-01,28,20,28,20,48
31601,TIRAQUE (CBBA),estado nutricional en menores de 5 anos,clasificacion e,2002-10-01,34,49,34,49,83
21703,TITO YUPANQUI (PARQUIPUJIO),estado nutricional en menores de 5 anos,clasificacion e,2002-10-01,0,2,0,2,2
30802,TOCO,estado nutricional en menores de 5 anos,clasificacion e,2002-10-01,0,8,0,8,8
30803,TOLATA,estado nutricional en menores de 5 anos,clasificacion e,2002-10-01,1,0,1,0,1
41001,TOLEDO,estado nutricional en menores de 5 anos,clasificacion e,2002-10-01,2,2,2,2,4
51202,TOMAVE,estado nutricional en menores de 5 anos,clasificacion e,2002-10-01,19,8,19,8,27
10402,TOMINA,estado nutricional en menores de 5 anos,clasificacion e,2002-10-01,28,39,28,39,67
50502,TORO TORO,estado nutricional en menores de 5 anos,clasificacion e,2002-10-01,23,17,23,17,40
31201,TOTORA(CBBA),estado nutricional en menores de 5 anos,clasificacion e,2002-10-01,9,5,9,5,14
41301,TOTORA(ORR),estado nutricional en menores de 5 anos,clasificacion e,2002-10-01,0,1,0,1,1
80101,TRINIDAD,estado nutricional en menores de 5 anos,clasificacion e,2002-10-01,37,51,37,51,88
50801,TUPIZA,estado nutricional en menores de 5 anos,clasificacion e,2002-10-01,17,87,17,87,104
40402,TURCO,estado nutricional en menores de 5 anos,clasificacion e,2002-10-01,0,2,0,2,2
50201,UNCIA,estado nutricional en menores de 5 anos,clasificacion e,2002-10-01,2,0,2,0,2
60401,URIONDO (A. CONCEPCION),estado nutricional en menores de 5 anos,clasificacion e,2002-10-01,2,5,2,5,7
71502,URUBICHA,estado nutricional en menores de 5 anos,clasificacion e,2002-10-01,29,49,29,49,78
51201,UYUNI,estado nutricional en menores de 5 anos,clasificacion e,2002-10-01,10,8,10,8,18
30502,VACAS,estado nutricional en menores de 5 anos,clasificacion e,2002-10-01,7,21,7,21,28
70801,VALLEGRANDE,estado nutricional en menores de 5 anos,clasificacion e,2002-10-01,15,17,15,17,32
20801,VIACHA,estado nutricional en menores de 5 anos,clasificacion e,2002-10-01,22,21,22,21,43
31302,VILA VILA,estado nutricional en menores de 5 anos,clasificacion e,2002-10-01,13,32,13,32,45
60303,VILLA MONTES,estado nutricional en menores de 5 anos,clasificacion e,2002-10-01,20,10,20,10,30
31402,VILLA RIVERO,estado nutricional en menores de 5 anos,clasificacion e,2002-10-01,2,11,2,11,13
10801,VILLA SERRANO,estado nutricional en menores de 5 anos,clasificacion e,2002-10-01,42,61,42,61,103
31003,VILLA TUNARI,estado nutricional en menores de 5 anos,clasificacion e,2002-10-01,39,46,39,46,85
11001,VILLA VACA GUZMAN (MUYUPAMPA),estado nutricional en menores de 5 anos,clasificacion e,2002-10-01,16,10,16,10,26
51501,VILLAZON,estado nutricional en menores de 5 anos,clasificacion e,2002-10-01,30,32,30,32,62
30904,VINTO,estado nutricional en menores de 5 anos,clasificacion e,2002-10-01,25,11,25,11,36
50602,VITICHI,estado nutricional en menores de 5 anos,clasificacion e,2002-10-01,11,17,11,17,28
20306,WALDO BALLIVIAN,estado nutricional en menores de 5 anos,clasificacion e,2002-10-01,2,0,2,0,2
70201,WARNES,estado nutricional en menores de 5 anos,clasificacion e,2002-10-01,20,22,20,22,42
20903,YACO,estado nutricional en menores de 5 anos,clasificacion e,2002-10-01,12,29,12,29,41
60301,YACUIBA,estado nutricional en menores de 5 anos,clasificacion e,2002-10-01,24,12,24,12,36
10602,YAMPARAEZ,estado nutricional en menores de 5 anos,clasificacion e,2002-10-01,56,32,56,32,88
21103,YANACACHI,estado nutricional en menores de 5 anos,clasificacion e,2002-10-01,1,3,1,3,4
50103,YOCALLA,estado nutricional en menores de 5 anos,clasificacion e,2002-10-01,13,19,13,19,32
10102,YOTALA,estado nutricional en menores de 5 anos,clasificacion e,2002-10-01,33,43,33,43,76
60402,YUNCHARA,estado nutricional en menores de 5 anos,clasificacion e,2002-10-01,3,8,3,8,11
10301,ZUDAÃ‘EZ,estado nutricional en menores de 5 anos,clasificacion e,2002-10-01,35,41,35,41,76
51302,ACACIO,estado nutricional en menores de 5 anos,clasificacion e,2002-11-01,15,32,15,32,47
20201,ACHACACHI,estado nutricional en menores de 5 anos,clasificacion e,2002-11-01,51,17,51,17,68
20104,ACHOCALLA,estado nutricional en menores de 5 anos,clasificacion e,2002-11-01,7,1,7,1,8
30201,AIQUILE,estado nutricional en menores de 5 anos,clasificacion e,2002-11-01,30,35,30,35,65
31303,ALALAY,estado nutricional en menores de 5 anos,clasificacion e,2002-11-01,1,12,1,12,13
10404,ALCALA,estado nutricional en menores de 5 anos,clasificacion e,2002-11-01,12,22,12,22,34
20202,ANCORAIMES,estado nutricional en menores de 5 anos,clasificacion e,2002-11-01,21,22,21,22,43
41201,ANDAMARCA,estado nutricional en menores de 5 anos,clasificacion e,2002-11-01,1,0,1,0,1
30402,ANZALDO,estado nutricional en menores de 5 anos,clasificacion e,2002-11-01,5,23,5,23,28
20701,APOLO,estado nutricional en menores de 5 anos,clasificacion e,2002-11-01,17,19,17,19,36
51301,ARAMPAMPA,estado nutricional en menores de 5 anos,clasificacion e,2002-11-01,8,21,8,21,29
30501,ARANI,estado nutricional en menores de 5 anos,clasificacion e,2002-11-01,12,11,12,11,23
30601,ARQUE,estado nutricional en menores de 5 anos,clasificacion e,2002-11-01,19,12,19,12,31
50802,ATOCHA,estado nutricional en menores de 5 anos,clasificacion e,2002-11-01,1,36,1,36,37
20503,AUCAPATA,estado nutricional en menores de 5 anos,clasificacion e,2002-11-01,5,2,5,2,7
20502,AYATA,estado nutricional en menores de 5 anos,clasificacion e,2002-11-01,27,8,27,8,35
21303,AYO AYO,estado nutricional en menores de 5 anos,clasificacion e,2002-11-01,1,1,1,1,2
30301,AYOPAYA (V. DE INDEPENDENCIA),estado nutricional en menores de 5 anos,clasificacion e,2002-11-01,19,18,19,18,37
10201,AZURDUY,estado nutricional en menores de 5 anos,clasificacion e,2002-11-01,53,52,53,52,105
21203,BATALLAS,estado nutricional en menores de 5 anos,clasificacion e,2002-11-01,10,7,10,7,17
80802,BAURES,estado nutricional en menores de 5 anos,clasificacion e,2002-11-01,4,1,4,1,5
41202,BELEN DE ANDAMARCA,estado nutricional en menores de 5 anos,clasificacion e,2002-11-01,1,0,1,0,1
50104,BELEN DE URMIRI,estado nutricional en menores de 5 anos,clasificacion e,2002-11-01,2,4,2,4,6
60202,BERMEJO,estado nutricional en menores de 5 anos,clasificacion e,2002-11-01,2,0,2,0,2
50301,BETANZOS,estado nutricional en menores de 5 anos,clasificacion e,2002-11-01,112,123,112,123,235
31501,BOLIVAR,estado nutricional en menores de 5 anos,clasificacion e,2002-11-01,32,20,32,20,52
90103,BOLPEBRA,estado nutricional en menores de 5 anos,clasificacion e,2002-11-01,1,0,1,0,1
70707,BOYUIBE,estado nutricional en menores de 5 anos,clasificacion e,2002-11-01,0,4,0,4,4
70401,BUENA VISTA,estado nutricional en menores de 5 anos,clasificacion e,2002-11-01,2,8,2,8,10
70703,CABEZAS,estado nutricional en menores de 5 anos,clasificacion e,2002-11-01,11,6,11,6,17
20905,CAIROMA,estado nutricional en menores de 5 anos,clasificacion e,2002-11-01,12,10,12,10,22
51102,"CAIZA ""D""",estado nutricional en menores de 5 anos,clasificacion e,2002-11-01,39,16,39,16,55
21003,CAJUATA,estado nutricional en menores de 5 anos,clasificacion e,2002-11-01,12,18,12,18,30
20303,CALACOTO,estado nutricional en menores de 5 anos,clasificacion e,2002-11-01,9,2,9,2,11
21304,CALAMARCA,estado nutricional en menores de 5 anos,clasificacion e,2002-11-01,18,10,18,10,28
10701,CAMARGO,estado nutricional en menores de 5 anos,clasificacion e,2002-11-01,15,30,15,30,45
10901,CAMATAQUI (C. VILLA ABECIA),estado nutricional en menores de 5 anos,clasificacion e,2002-11-01,2,4,2,4,6
70706,CAMIRI,estado nutricional en menores de 5 anos,clasificacion e,2002-11-01,27,21,27,21,48
30701,CAPINOTA,estado nutricional en menores de 5 anos,clasificacion e,2002-11-01,29,23,29,23,52
20302,CAQUIAVIRI,estado nutricional en menores de 5 anos,clasificacion e,2002-11-01,6,11,6,11,17
40102,CARACOLLO,estado nutricional en menores de 5 anos,clasificacion e,2002-11-01,2,26,2,26,28
22001,CARANAVI,estado nutricional en menores de 5 anos,clasificacion e,2002-11-01,38,28,38,28,66
60302,CARAPARI,estado nutricional en menores de 5 anos,clasificacion e,2002-11-01,3,3,3,3,6
50702,CARIPUYO,estado nutricional en menores de 5 anos,clasificacion e,2002-11-01,49,27,49,27,76
21902,CATACORA,estado nutricional en menores de 5 anos,clasificacion e,2002-11-01,3,0,3,0,3
40201,CHALLAPATA,estado nutricional en menores de 5 anos,clasificacion e,2002-11-01,18,12,18,12,30
50302,CHAQUI,estado nutricional en menores de 5 anos,clasificacion e,2002-11-01,33,17,33,17,50
70702,CHARAGUA,estado nutricional en menores de 5 anos,clasificacion e,2002-11-01,8,28,8,28,36
20305,CHARAÃ‘A,estado nutricional en menores de 5 anos,clasificacion e,2002-11-01,5,2,5,2,7
50202,CHAYANTA,estado nutricional en menores de 5 anos,clasificacion e,2002-11-01,34,38,34,38,72
31204,CHIMORE,estado nutricional en menores de 5 anos,clasificacion e,2002-11-01,7,3,7,3,10
40903,CHIPAYA,estado nutricional en menores de 5 anos,clasificacion e,2002-11-01,0,2,0,2,2
21101,CHULUMANI (V. DE LA LIBERTAD),estado nutricional en menores de 5 anos,clasificacion e,2002-11-01,0,2,0,2,2
20501,CHUMA,estado nutricional en menores de 5 anos,clasificacion e,2002-11-01,10,18,10,18,28
30801,CLIZA,estado nutricional en menores de 5 anos,clasificacion e,2002-11-01,3,0,3,0,3
90101,COBIJA,estado nutricional en menores de 5 anos,clasificacion e,2002-11-01,15,4,15,4,19
30101,COCHABAMBA,estado nutricional en menores de 5 anos,clasificacion e,2002-11-01,84,84,84,84,168
30905,COLCAPIRHUA,estado nutricional en menores de 5 anos,clasificacion e,2002-11-01,4,3,4,3,7
50901,"COLCHA ""K""",estado nutricional en menores de 5 anos,clasificacion e,2002-11-01,10,6,10,6,16
31002,COLOMI,estado nutricional en menores de 5 anos,clasificacion e,2002-11-01,7,9,7,9,16
50401,COLQUECHACA,estado nutricional en menores de 5 anos,clasificacion e,2002-11-01,62,45,62,45,107
21306,COLQUENCHA,estado nutricional en menores de 5 anos,clasificacion e,2002-11-01,3,4,3,4,7
21004,COLQUIRI,estado nutricional en menores de 5 anos,clasificacion e,2002-11-01,34,19,34,19,53
20304,COMANCHE,estado nutricional en menores de 5 anos,clasificacion e,2002-11-01,4,2,4,2,6
71301,COMARAPA,estado nutricional en menores de 5 anos,clasificacion e,2002-11-01,15,15,15,15,30
20605,COMBAYA,estado nutricional en menores de 5 anos,clasificacion e,2002-11-01,2,0,2,0,2
71101,CONCEPCION,estado nutricional en menores de 5 anos,clasificacion e,2002-11-01,5,5,5,5,10
21701,COPACABANA,estado nutricional en menores de 5 anos,clasificacion e,2002-11-01,11,8,11,8,19
21402,CORIPATA,estado nutricional en menores de 5 anos,clasificacion e,2002-11-01,0,1,0,1,1
20301,CORO CORO,estado nutricional en menores de 5 anos,clasificacion e,2002-11-01,5,7,5,7,12
21401,COROICO,estado nutricional en menores de 5 anos,clasificacion e,2002-11-01,5,3,5,3,8
40301,CORQUE,estado nutricional en menores de 5 anos,clasificacion e,2002-11-01,2,0,2,0,2
50601,COTAGAITA,estado nutricional en menores de 5 anos,clasificacion e,2002-11-01,33,23,33,23,56
70102,COTOCA,estado nutricional en menores de 5 anos,clasificacion e,2002-11-01,4,1,4,1,5
31405,CUCHUMUELA (V. G. VILLARROEL),estado nutricional en menores de 5 anos,clasificacion e,2002-11-01,0,1,0,1,1
70704,CUEVO,estado nutricional en menores de 5 anos,clasificacion e,2002-11-01,7,8,7,8,15
10902,CULPINA,estado nutricional en menores de 5 anos,clasificacion e,2002-11-01,61,45,61,45,106
40401,CURAHUARA DE CARANGAS,estado nutricional en menores de 5 anos,clasificacion e,2002-11-01,2,0,2,0,2
21602,CURVA,estado nutricional en menores de 5 anos,clasificacion e,2002-11-01,5,3,5,3,8
20804,DESAGUADERO,estado nutricional en menores de 5 anos,clasificacion e,2002-11-01,0,2,0,2,2
20105,EL ALTO,estado nutricional en menores de 5 anos,clasificacion e,2002-11-01,508,241,508,241,749
40103,EL CHORO,estado nutricional en menores de 5 anos,clasificacion e,2002-11-01,1,0,1,0,1
71503,EL PUENTE(STC),estado nutricional en menores de 5 anos,clasificacion e,2002-11-01,4,24,4,24,28
60502,EL PUENTE(TJA),estado nutricional en menores de 5 anos,clasificacion e,2002-11-01,8,36,8,36,44
70105,EL TORNO,estado nutricional en menores de 5 anos,clasificacion e,2002-11-01,22,11,22,11,33
10405,EL VILLAR,estado nutricional en menores de 5 anos,clasificacion e,2002-11-01,13,27,13,27,40
60601,ENTRE RIOS,estado nutricional en menores de 5 anos,clasificacion e,2002-11-01,8,16,8,16,24
41101,EUCALIPTUS,estado nutricional en menores de 5 anos,clasificacion e,2002-11-01,4,6,4,6,10
80402,EXALTACION,estado nutricional en menores de 5 anos,clasificacion e,2002-11-01,1,8,1,8,9
90203,FILADELFIA,estado nutricional en menores de 5 anos,clasificacion e,2002-11-01,1,0,1,0,1
71002,GENERAL SAAVEDRA,estado nutricional en menores de 5 anos,clasificacion e,2002-11-01,35,16,35,16,51
21601,GRAL. J.J. PEREZ (CHARAZANI),estado nutricional en menores de 5 anos,clasificacion e,2002-11-01,9,21,9,21,30
20602,GUANAY,estado nutricional en menores de 5 anos,clasificacion e,2002-11-01,8,9,8,9,17
20802,GUAQUI,estado nutricional en menores de 5 anos,clasificacion e,2002-11-01,3,2,3,2,5
80202,GUAYARAMERIN,estado nutricional en menores de 5 anos,clasificacion e,2002-11-01,24,20,24,20,44
70705,GUTIERREZ,estado nutricional en menores de 5 anos,clasificacion e,2002-11-01,39,30,39,30,69
10502,HUACARETA,estado nutricional en menores de 5 anos,clasificacion e,2002-11-01,20,16,20,16,36
11002,HUACAYA (VILLA DE HUACAYA),estado nutricional en menores de 5 anos,clasificacion e,2002-11-01,0,4,0,4,4
40701,HUANUNI,estado nutricional en menores de 5 anos,clasificacion e,2002-11-01,8,12,8,12,20
80803,HUARACAJE,estado nutricional en menores de 5 anos,clasificacion e,2002-11-01,1,0,1,0,1
41601,HUAYLLAMARCA,estado nutricional en menores de 5 anos,clasificacion e,2002-11-01,1,0,1,0,1
21005,ICHOCA,estado nutricional en menores de 5 anos,clasificacion e,2002-11-01,7,5,7,5,12
10304,ICLA,estado nutricional en menores de 5 anos,clasificacion e,2002-11-01,63,75,63,75,138
10703,INCAHUASI,estado nutricional en menores de 5 anos,clasificacion e,2002-11-01,156,53,156,53,209
21001,INQUISIVI,estado nutricional en menores de 5 anos,clasificacion e,2002-11-01,30,41,30,41,71
21102,IRUPANA (VILLA DE LANZA),estado nutricional en menores de 5 anos,clasificacion e,2002-11-01,4,7,4,7,11
21501,IXIAMAS,estado nutricional en menores de 5 anos,clasificacion e,2002-11-01,3,5,3,5,8
21105,LA ASUNTA,estado nutricional en menores de 5 anos,clasificacion e,2002-11-01,4,7,4,7,11
70104,LA GUARDIA,estado nutricional en menores de 5 anos,clasificacion e,2002-11-01,9,2,9,2,11
20101,LA PAZ,estado nutricional en menores de 5 anos,clasificacion e,2002-11-01,262,170,262,170,432
70701,LAGUNILLAS,estado nutricional en menores de 5 anos,clasificacion e,2002-11-01,6,16,6,16,22
21202,LAJA,estado nutricional en menores de 5 anos,clasificacion e,2002-11-01,4,2,4,2,6
10903,LAS CARRERAS,estado nutricional en menores de 5 anos,clasificacion e,2002-11-01,9,11,9,11,20
50203,LLALLAGUA,estado nutricional en menores de 5 anos,clasificacion e,2002-11-01,8,53,8,53,61
51401,LLICA,estado nutricional en menores de 5 anos,clasificacion e,2002-11-01,5,1,5,1,6
80601,LORETO,estado nutricional en menores de 5 anos,clasificacion e,2002-11-01,2,3,2,3,5
20901,LURIBAY,estado nutricional en menores de 5 anos,clasificacion e,2002-11-01,12,2,12,2,14
40702,MACHACAMARCA,estado nutricional en menores de 5 anos,clasificacion e,2002-11-01,4,1,4,1,5
11003,MACHARETI,estado nutricional en menores de 5 anos,clasificacion e,2002-11-01,15,24,15,24,39
80801,MAGDALENA,estado nutricional en menores de 5 anos,clasificacion e,2002-11-01,2,3,2,3,5
70903,MAIRANA,estado nutricional en menores de 5 anos,clasificacion e,2002-11-01,8,2,8,2,10
20904,MALLA,estado nutricional en menores de 5 anos,clasificacion e,2002-11-01,4,3,4,3,7
20103,MECAPACA,estado nutricional en menores de 5 anos,clasificacion e,2002-11-01,3,5,3,5,8
71003,MINEROS,estado nutricional en menores de 5 anos,clasificacion e,2002-11-01,34,19,34,19,53
31301,MIZQUE,estado nutricional en menores de 5 anos,clasificacion e,2002-11-01,8,14,8,14,22
20402,MOCOMOCO,estado nutricional en menores de 5 anos,clasificacion e,2002-11-01,5,3,5,3,8
51002,MOJINETE,estado nutricional en menores de 5 anos,clasificacion e,2002-11-01,0,5,0,5,5
10303,MOJOCOYA,estado nutricional en menores de 5 anos,clasificacion e,2002-11-01,22,12,22,12,34
10501,MONTEAGUDO,estado nutricional en menores de 5 anos,clasificacion e,2002-11-01,36,35,36,35,71
71001,MONTERO,estado nutricional en menores de 5 anos,clasificacion e,2002-11-01,78,32,78,32,110
70803,MORO MORO,estado nutricional en menores de 5 anos,clasificacion e,2002-11-01,5,7,5,7,12
30302,MOROCHATA,estado nutricional en menores de 5 anos,clasificacion e,2002-11-01,22,40,22,40,62
90401,NACEBE (SANTA ROSA DEL ABUNA),estado nutricional en menores de 5 anos,clasificacion e,2002-11-01,1,0,1,0,1
50404,OCURI,estado nutricional en menores de 5 anos,clasificacion e,2002-11-01,23,38,23,38,61
70202,OKINAWA,estado nutricional en menores de 5 anos,clasificacion e,2002-11-01,3,0,3,0,3
30203,OMEREQUE,estado nutricional en menores de 5 anos,clasificacion e,2002-11-01,1,1,1,1,2
40101,ORURO,estado nutricional en menores de 5 anos,clasificacion e,2002-11-01,118,70,118,70,188
60201,PADCAYA,estado nutricional en menores de 5 anos,clasificacion e,2002-11-01,8,6,8,6,14
10401,PADILLA,estado nutricional en menores de 5 anos,clasificacion e,2002-11-01,29,48,29,48,77
70502,PAILON,estado nutricional en menores de 5 anos,clasificacion e,2002-11-01,4,3,4,3,7
20102,PALCA,estado nutricional en menores de 5 anos,clasificacion e,2002-11-01,17,31,17,31,48
21104,PALOS BLANCOS,estado nutricional en menores de 5 anos,clasificacion e,2002-11-01,17,14,17,14,31
40802,PAMPA AULLAGAS,estado nutricional en menores de 5 anos,clasificacion e,2002-11-01,8,2,8,2,10
70902,PAMPA GRANDE,estado nutricional en menores de 5 anos,clasificacion e,2002-11-01,2,2,2,2,4
21802,PAPEL PAMPA,estado nutricional en menores de 5 anos,clasificacion e,2002-11-01,1,0,1,0,1
30202,PASORAPA,estado nutricional en menores de 5 anos,clasificacion e,2002-11-01,9,6,9,6,15
21305,PATACAMAYA,estado nutricional en menores de 5 anos,clasificacion e,2002-11-01,17,10,17,10,27
40602,PAZÃ‘A,estado nutricional en menores de 5 anos,clasificacion e,2002-11-01,6,4,6,4,10
20702,PELECHUCO,estado nutricional en menores de 5 anos,clasificacion e,2002-11-01,8,9,8,9,17
50403,POCOATA,estado nutricional en menores de 5 anos,clasificacion e,2002-11-01,33,47,33,47,80
31203,POCONA,estado nutricional en menores de 5 anos,clasificacion e,2002-11-01,16,15,16,15,31
31202,POJO (CBBA),estado nutricional en menores de 5 anos,clasificacion e,2002-11-01,28,15,28,15,43
40601,POOPO,estado nutricional en menores de 5 anos,clasificacion e,2002-11-01,3,3,3,3,6
10103,POROMA,estado nutricional en menores de 5 anos,clasificacion e,2002-11-01,27,48,27,48,75
70103,PORONGO,estado nutricional en menores de 5 anos,clasificacion e,2002-11-01,2,3,2,3,5
70601,PORTACHUELO,estado nutricional en menores de 5 anos,clasificacion e,2002-11-01,7,4,7,4,11
90102,PORVENIR,estado nutricional en menores de 5 anos,clasificacion e,2002-11-01,2,3,2,3,5
70804,POSTRER VALLE,estado nutricional en menores de 5 anos,clasificacion e,2002-11-01,0,2,0,2,2
50101,POTOSI,estado nutricional en menores de 5 anos,clasificacion e,2002-11-01,121,72,121,72,193
10302,PRESTO,estado nutricional en menores de 5 anos,clasificacion e,2002-11-01,22,31,22,31,53
21201,PUCARANI,estado nutricional en menores de 5 anos,clasificacion e,2002-11-01,0,4,0,4,4
20401,PUERTO ACOSTA,estado nutricional en menores de 5 anos,clasificacion e,2002-11-01,12,13,12,13,25
20403,PUERTO CARABUCO,estado nutricional en menores de 5 anos,clasificacion e,2002-11-01,8,15,8,15,23
90301,PUERTO GONZALO MORENO,estado nutricional en menores de 5 anos,clasificacion e,2002-11-01,11,0,11,0,11
71402,PUERTO QUIJARRO,estado nutricional en menores de 5 anos,clasificacion e,2002-11-01,11,1,11,1,12
90201,PUERTO RICO,estado nutricional en menores de 5 anos,clasificacion e,2002-11-01,2,8,2,8,10
80703,PUERTO SILES,estado nutricional en menores de 5 anos,clasificacion e,2002-11-01,1,1,1,1,2
71401,PUERTO SUAREZ,estado nutricional en menores de 5 anos,clasificacion e,2002-11-01,23,11,23,11,34
31205,PUERTO VILLARROEL,estado nutricional en menores de 5 anos,clasificacion e,2002-11-01,59,44,59,44,103
51101,PUNA,estado nutricional en menores de 5 anos,clasificacion e,2002-11-01,90,56,90,56,146
31401,PUNATA,estado nutricional en menores de 5 anos,clasificacion e,2002-11-01,5,10,5,10,15
20604,QUIABAYA,estado nutricional en menores de 5 anos,clasificacion e,2002-11-01,13,3,13,3,16
30901,QUILLACOLLO,estado nutricional en menores de 5 anos,clasificacion e,2002-11-01,19,22,19,22,41
21002,QUIME,estado nutricional en menores de 5 anos,clasificacion e,2002-11-01,21,10,21,10,31
50402,RAVELO,estado nutricional en menores de 5 anos,clasificacion e,2002-11-01,80,50,80,50,130
80301,REYES,estado nutricional en menores de 5 anos,clasificacion e,2002-11-01,23,12,23,12,35
80201,RIBERALTA,estado nutricional en menores de 5 anos,clasificacion e,2002-11-01,121,70,121,70,191
70503,ROBORE,estado nutricional en menores de 5 anos,clasificacion e,2002-11-01,8,5,8,5,13
40901,SABAYA,estado nutricional en menores de 5 anos,clasificacion e,2002-11-01,0,3,0,3,3
31001,SACABA,estado nutricional en menores de 5 anos,clasificacion e,2002-11-01,45,21,45,21,66
30404,SACABAMBA,estado nutricional en menores de 5 anos,clasificacion e,2002-11-01,4,21,4,21,25
50701,SACACA,estado nutricional en menores de 5 anos,clasificacion e,2002-11-01,61,82,61,82,143
71302,SAIPINA,estado nutricional en menores de 5 anos,clasificacion e,2002-11-01,5,7,5,7,12
40801,SALINAS DE GARCI MENDOZA,estado nutricional en menores de 5 anos,clasificacion e,2002-11-01,7,1,7,1,8
70901,SAMAIPATA,estado nutricional en menores de 5 anos,clasificacion e,2002-11-01,6,5,6,5,11
51601,SAN AGUSTIN,estado nutricional en menores de 5 anos,clasificacion e,2002-11-01,1,1,1,1,2
80602,SAN ANDRES,estado nutricional en menores de 5 anos,clasificacion e,2002-11-01,5,8,5,8,13
51003,SAN ANTONIO DE ESMORUCO,estado nutricional en menores de 5 anos,clasificacion e,2002-11-01,0,5,0,5,5
71105,SAN ANTONIO DE LOMERIO,estado nutricional en menores de 5 anos,clasificacion e,2002-11-01,26,33,26,33,59
31403,SAN BENITO,estado nutricional en menores de 5 anos,clasificacion e,2002-11-01,8,9,8,9,17
80302,SAN BORJA,estado nutricional en menores de 5 anos,clasificacion e,2002-11-01,38,35,38,35,73
21502,SAN BUENA VENTURA,estado nutricional en menores de 5 anos,clasificacion e,2002-11-01,17,5,17,5,22
70402,SAN CARLOS,estado nutricional en menores de 5 anos,clasificacion e,2002-11-01,16,9,16,9,25
80501,SAN IGNACIO,estado nutricional en menores de 5 anos,clasificacion e,2002-11-01,19,35,19,35,54
70301,SAN IGNACIO DE VELASCO,estado nutricional en menores de 5 anos,clasificacion e,2002-11-01,53,64,53,64,117
80102,SAN JAVIER(BNI),estado nutricional en menores de 5 anos,clasificacion e,2002-11-01,1,3,1,3,4
71102,SAN JAVIER(STC),estado nutricional en menores de 5 anos,clasificacion e,2002-11-01,7,2,7,2,9
80701,SAN JOAQUIN,estado nutricional en menores de 5 anos,clasificacion e,2002-11-01,0,2,0,2,2
70501,SAN JOSE DE CHIQUITOS,estado nutricional en menores de 5 anos,clasificacion e,2002-11-01,19,10,19,10,29
71104,SAN JULIAN,estado nutricional en menores de 5 anos,clasificacion e,2002-11-01,42,34,42,34,76
90302,SAN LORENZO(PND),estado nutricional en menores de 5 anos,clasificacion e,2002-11-01,4,2,4,2,6
60501,SAN LORENZO(TJA),estado nutricional en menores de 5 anos,clasificacion e,2002-11-01,7,8,7,8,15
10702,SAN LUCAS,estado nutricional en menores de 5 anos,clasificacion e,2002-11-01,122,89,122,89,211
70302,SAN MIGUEL DE VELASCO,estado nutricional en menores de 5 anos,clasificacion e,2002-11-01,3,8,3,8,11
51001,SAN PABLO DE LIPEZ,estado nutricional en menores de 5 anos,clasificacion e,2002-11-01,2,5,2,5,7
50501,SAN PEDRO DE BUENA VISTA,estado nutricional en menores de 5 anos,clasificacion e,2002-11-01,43,86,43,86,129
21801,SAN PEDRO DE CURAHUARA,estado nutricional en menores de 5 anos,clasificacion e,2002-11-01,3,7,3,7,10
21702,SAN PEDRO DE TIQUINA,estado nutricional en menores de 5 anos,clasificacion e,2002-11-01,1,0,1,0,1
90202,SAN PEDRO(PND),estado nutricional en menores de 5 anos,clasificacion e,2002-11-01,2,4,2,4,6
70303,SAN RAFAEL,estado nutricional en menores de 5 anos,clasificacion e,2002-11-01,10,6,10,6,16
80401,SANTA ANA,estado nutricional en menores de 5 anos,clasificacion e,2002-11-01,6,5,6,5,11
70101,SANTA CRUZ DE LA SIERRA,estado nutricional en menores de 5 anos,clasificacion e,2002-11-01,130,46,130,46,176
80303,SANTA ROSA,estado nutricional en menores de 5 anos,clasificacion e,2002-11-01,2,0,2,0,2
20308,SANTIAGO DE CALLAPA,estado nutricional en menores de 5 anos,clasificacion e,2002-11-01,6,9,6,9,15
41401,SANTIAGO DE HUARI,estado nutricional en menores de 5 anos,clasificacion e,2002-11-01,5,2,5,2,7
21901,SANTIAGO DE MACHACA,estado nutricional en menores de 5 anos,clasificacion e,2002-11-01,1,3,1,3,4
30702,SANTIVAÃ‘ES,estado nutricional en menores de 5 anos,clasificacion e,2002-11-01,1,3,1,3,4
40202,SANTUARIO DE QUILLACAS,estado nutricional en menores de 5 anos,clasificacion e,2002-11-01,1,2,1,2,3
20902,SAPAHAQUI,estado nutricional en menores de 5 anos,clasificacion e,2002-11-01,14,10,14,10,24
90303,SENA,estado nutricional en menores de 5 anos,clasificacion e,2002-11-01,2,0,2,0,2
21301,SICA SICA (VILLA AROMA),estado nutricional en menores de 5 anos,clasificacion e,2002-11-01,15,8,15,8,23
30703,SICAYA,estado nutricional en menores de 5 anos,clasificacion e,2002-11-01,0,1,0,1,1
30902,SIPE SIPE,estado nutricional en menores de 5 anos,clasificacion e,2002-11-01,75,33,75,33,108
10403,SOPACHUY,estado nutricional en menores de 5 anos,clasificacion e,2002-11-01,25,19,25,19,44
20601,SORATA,estado nutricional en menores de 5 anos,clasificacion e,2002-11-01,2,22,2,22,24
10101,SUCRE,estado nutricional en menores de 5 anos,clasificacion e,2002-11-01,160,98,160,98,258
31404,TACACHI,estado nutricional en menores de 5 anos,clasificacion e,2002-11-01,5,0,5,0,5
20603,TACACOMA,estado nutricional en menores de 5 anos,clasificacion e,2002-11-01,2,1,2,1,3
50303,TACOBAMBA,estado nutricional en menores de 5 anos,clasificacion e,2002-11-01,30,26,30,26,56
30602,TACOPAYA,estado nutricional en menores de 5 anos,clasificacion e,2002-11-01,25,26,25,26,51
51402,TAHUA,estado nutricional en menores de 5 anos,clasificacion e,2002-11-01,0,1,0,1,1
31101,TAPACARI,estado nutricional en menores de 5 anos,clasificacion e,2002-11-01,25,16,25,16,41
10601,TARABUCO,estado nutricional en menores de 5 anos,clasificacion e,2002-11-01,147,109,147,109,256
30401,TARATA,estado nutricional en menores de 5 anos,clasificacion e,2002-11-01,9,1,9,1,10
60101,TARIJA,estado nutricional en menores de 5 anos,clasificacion e,2002-11-01,36,35,36,35,71
10202,TARVITA,estado nutricional en menores de 5 anos,clasificacion e,2002-11-01,19,32,19,32,51
20803,TIAWANACU,estado nutricional en menores de 5 anos,clasificacion e,2002-11-01,4,4,4,4,8
50102,TINGUIPAYA,estado nutricional en menores de 5 anos,clasificacion e,2002-11-01,9,43,9,43,52
20606,TIPUANI,estado nutricional en menores de 5 anos,clasificacion e,2002-11-01,3,6,3,6,9
30903,TIQUIPAYA,estado nutricional en menores de 5 anos,clasificacion e,2002-11-01,33,19,33,19,52
31601,TIRAQUE (CBBA),estado nutricional en menores de 5 anos,clasificacion e,2002-11-01,27,19,27,19,46
21703,TITO YUPANQUI (PARQUIPUJIO),estado nutricional en menores de 5 anos,clasificacion e,2002-11-01,2,2,2,2,4
30802,TOCO,estado nutricional en menores de 5 anos,clasificacion e,2002-11-01,0,3,0,3,3
41001,TOLEDO,estado nutricional en menores de 5 anos,clasificacion e,2002-11-01,3,0,3,0,3
51202,TOMAVE,estado nutricional en menores de 5 anos,clasificacion e,2002-11-01,23,20,23,20,43
10402,TOMINA,estado nutricional en menores de 5 anos,clasificacion e,2002-11-01,23,46,23,46,69
50502,TORO TORO,estado nutricional en menores de 5 anos,clasificacion e,2002-11-01,4,11,4,11,15
31201,TOTORA(CBBA),estado nutricional en menores de 5 anos,clasificacion e,2002-11-01,7,6,7,6,13
41301,TOTORA(ORR),estado nutricional en menores de 5 anos,clasificacion e,2002-11-01,3,2,3,2,5
70802,TRIGAL,estado nutricional en menores de 5 anos,clasificacion e,2002-11-01,2,0,2,0,2
80101,TRINIDAD,estado nutricional en menores de 5 anos,clasificacion e,2002-11-01,27,37,27,37,64
50801,TUPIZA,estado nutricional en menores de 5 anos,clasificacion e,2002-11-01,12,73,12,73,85
40402,TURCO,estado nutricional en menores de 5 anos,clasificacion e,2002-11-01,1,0,1,0,1
21302,UMALA,estado nutricional en menores de 5 anos,clasificacion e,2002-11-01,1,0,1,0,1
50201,UNCIA,estado nutricional en menores de 5 anos,clasificacion e,2002-11-01,6,8,6,8,14
60401,URIONDO (A. CONCEPCION),estado nutricional en menores de 5 anos,clasificacion e,2002-11-01,0,1,0,1,1
71502,URUBICHA,estado nutricional en menores de 5 anos,clasificacion e,2002-11-01,18,16,18,16,34
51201,UYUNI,estado nutricional en menores de 5 anos,clasificacion e,2002-11-01,12,13,12,13,25
30502,VACAS,estado nutricional en menores de 5 anos,clasificacion e,2002-11-01,13,26,13,26,39
70801,VALLEGRANDE,estado nutricional en menores de 5 anos,clasificacion e,2002-11-01,11,15,11,15,26
20801,VIACHA,estado nutricional en menores de 5 anos,clasificacion e,2002-11-01,22,29,22,29,51
31302,VILA VILA,estado nutricional en menores de 5 anos,clasificacion e,2002-11-01,0,9,0,9,9
60303,VILLA MONTES,estado nutricional en menores de 5 anos,clasificacion e,2002-11-01,14,5,14,5,19
31402,VILLA RIVERO,estado nutricional en menores de 5 anos,clasificacion e,2002-11-01,9,1,9,1,10
10801,VILLA SERRANO,estado nutricional en menores de 5 anos,clasificacion e,2002-11-01,51,63,51,63,114
31003,VILLA TUNARI,estado nutricional en menores de 5 anos,clasificacion e,2002-11-01,18,30,18,30,48
11001,VILLA VACA GUZMAN (MUYUPAMPA),estado nutricional en menores de 5 anos,clasificacion e,2002-11-01,10,14,10,14,24
51501,VILLAZON,estado nutricional en menores de 5 anos,clasificacion e,2002-11-01,32,34,32,34,66
30904,VINTO,estado nutricional en menores de 5 anos,clasificacion e,2002-11-01,6,4,6,4,10
50602,VITICHI,estado nutricional en menores de 5 anos,clasificacion e,2002-11-01,10,21,10,21,31
20306,WALDO BALLIVIAN,estado nutricional en menores de 5 anos,clasificacion e,2002-11-01,1,1,1,1,2
70201,WARNES,estado nutricional en menores de 5 anos,clasificacion e,2002-11-01,42,18,42,18,60
20903,YACO,estado nutricional en menores de 5 anos,clasificacion e,2002-11-01,11,10,11,10,21
60301,YACUIBA,estado nutricional en menores de 5 anos,clasificacion e,2002-11-01,21,15,21,15,36
10602,YAMPARAEZ,estado nutricional en menores de 5 anos,clasificacion e,2002-11-01,72,44,72,44,116
21103,YANACACHI,estado nutricional en menores de 5 anos,clasificacion e,2002-11-01,3,2,3,2,5
70403,YAPACANI,estado nutricional en menores de 5 anos,clasificacion e,2002-11-01,14,17,14,17,31
50103,YOCALLA,estado nutricional en menores de 5 anos,clasificacion e,2002-11-01,10,14,10,14,24
10102,YOTALA,estado nutricional en menores de 5 anos,clasificacion e,2002-11-01,26,36,26,36,62
60402,YUNCHARA,estado nutricional en menores de 5 anos,clasificacion e,2002-11-01,8,12,8,12,20
10301,ZUDAÃ‘EZ,estado nutricional en menores de 5 anos,clasificacion e,2002-11-01,33,46,33,46,79
51302,ACACIO,estado nutricional en menores de 5 anos,clasificacion e,2002-12-01,9,39,9,39,48
20201,ACHACACHI,estado nutricional en menores de 5 anos,clasificacion e,2002-12-01,28,24,28,24,52
20104,ACHOCALLA,estado nutricional en menores de 5 anos,clasificacion e,2002-12-01,4,1,4,1,5
30201,AIQUILE,estado nutricional en menores de 5 anos,clasificacion e,2002-12-01,11,6,11,6,17
31303,ALALAY,estado nutricional en menores de 5 anos,clasificacion e,2002-12-01,0,4,0,4,4
10404,ALCALA,estado nutricional en menores de 5 anos,clasificacion e,2002-12-01,17,16,17,16,33
20202,ANCORAIMES,estado nutricional en menores de 5 anos,clasificacion e,2002-12-01,10,14,10,14,24
41201,ANDAMARCA,estado nutricional en menores de 5 anos,clasificacion e,2002-12-01,1,0,1,0,1
30402,ANZALDO,estado nutricional en menores de 5 anos,clasificacion e,2002-12-01,6,10,6,10,16
20701,APOLO,estado nutricional en menores de 5 anos,clasificacion e,2002-12-01,10,11,10,11,21
51301,ARAMPAMPA,estado nutricional en menores de 5 anos,clasificacion e,2002-12-01,21,31,21,31,52
30501,ARANI,estado nutricional en menores de 5 anos,clasificacion e,2002-12-01,5,2,5,2,7
30403,ARBIETO,estado nutricional en menores de 5 anos,clasificacion e,2002-12-01,2,1,2,1,3
30601,ARQUE,estado nutricional en menores de 5 anos,clasificacion e,2002-12-01,2,2,2,2,4
71501,ASCENCION DE GUARAYOS,estado nutricional en menores de 5 anos,clasificacion e,2002-12-01,1,3,1,3,4
50802,ATOCHA,estado nutricional en menores de 5 anos,clasificacion e,2002-12-01,1,25,1,25,26
20502,AYATA,estado nutricional en menores de 5 anos,clasificacion e,2002-12-01,14,14,14,14,28
21303,AYO AYO,estado nutricional en menores de 5 anos,clasificacion e,2002-12-01,16,0,16,0,16
30301,AYOPAYA (V. DE INDEPENDENCIA),estado nutricional en menores de 5 anos,clasificacion e,2002-12-01,19,16,19,16,35
10201,AZURDUY,estado nutricional en menores de 5 anos,clasificacion e,2002-12-01,42,39,42,39,81
21203,BATALLAS,estado nutricional en menores de 5 anos,clasificacion e,2002-12-01,0,1,0,1,1
80802,BAURES,estado nutricional en menores de 5 anos,clasificacion e,2002-12-01,3,2,3,2,5
41202,BELEN DE ANDAMARCA,estado nutricional en menores de 5 anos,clasificacion e,2002-12-01,1,0,1,0,1
50104,BELEN DE URMIRI,estado nutricional en menores de 5 anos,clasificacion e,2002-12-01,2,3,2,3,5
60202,BERMEJO,estado nutricional en menores de 5 anos,clasificacion e,2002-12-01,7,3,7,3,10
50301,BETANZOS,estado nutricional en menores de 5 anos,clasificacion e,2002-12-01,108,80,108,80,188
31501,BOLIVAR,estado nutricional en menores de 5 anos,clasificacion e,2002-12-01,17,14,17,14,31
90103,BOLPEBRA,estado nutricional en menores de 5 anos,clasificacion e,2002-12-01,1,1,1,1,2
70707,BOYUIBE,estado nutricional en menores de 5 anos,clasificacion e,2002-12-01,1,0,1,0,1
70703,CABEZAS,estado nutricional en menores de 5 anos,clasificacion e,2002-12-01,4,12,4,12,16
20905,CAIROMA,estado nutricional en menores de 5 anos,clasificacion e,2002-12-01,20,14,20,14,34
51102,"CAIZA ""D""",estado nutricional en menores de 5 anos,clasificacion e,2002-12-01,19,7,19,7,26
21003,CAJUATA,estado nutricional en menores de 5 anos,clasificacion e,2002-12-01,3,9,3,9,12
20303,CALACOTO,estado nutricional en menores de 5 anos,clasificacion e,2002-12-01,6,0,6,0,6
21304,CALAMARCA,estado nutricional en menores de 5 anos,clasificacion e,2002-12-01,41,20,41,20,61
10701,CAMARGO,estado nutricional en menores de 5 anos,clasificacion e,2002-12-01,21,20,21,20,41
10901,CAMATAQUI (C. VILLA ABECIA),estado nutricional en menores de 5 anos,clasificacion e,2002-12-01,3,3,3,3,6
70706,CAMIRI,estado nutricional en menores de 5 anos,clasificacion e,2002-12-01,29,15,29,15,44
30701,CAPINOTA,estado nutricional en menores de 5 anos,clasificacion e,2002-12-01,26,18,26,18,44
20302,CAQUIAVIRI,estado nutricional en menores de 5 anos,clasificacion e,2002-12-01,6,1,6,1,7
40102,CARACOLLO,estado nutricional en menores de 5 anos,clasificacion e,2002-12-01,0,16,0,16,16
22001,CARANAVI,estado nutricional en menores de 5 anos,clasificacion e,2002-12-01,36,15,36,15,51
60302,CARAPARI,estado nutricional en menores de 5 anos,clasificacion e,2002-12-01,7,5,7,5,12
50702,CARIPUYO,estado nutricional en menores de 5 anos,clasificacion e,2002-12-01,19,17,19,17,36
21902,CATACORA,estado nutricional en menores de 5 anos,clasificacion e,2002-12-01,2,1,2,1,3
40201,CHALLAPATA,estado nutricional en menores de 5 anos,clasificacion e,2002-12-01,9,20,9,20,29
50302,CHAQUI,estado nutricional en menores de 5 anos,clasificacion e,2002-12-01,29,12,29,12,41
70702,CHARAGUA,estado nutricional en menores de 5 anos,clasificacion e,2002-12-01,15,29,15,29,44
50202,CHAYANTA,estado nutricional en menores de 5 anos,clasificacion e,2002-12-01,38,36,38,36,74
31204,CHIMORE,estado nutricional en menores de 5 anos,clasificacion e,2002-12-01,8,0,8,0,8
20501,CHUMA,estado nutricional en menores de 5 anos,clasificacion e,2002-12-01,13,5,13,5,18
30801,CLIZA,estado nutricional en menores de 5 anos,clasificacion e,2002-12-01,2,1,2,1,3
90101,COBIJA,estado nutricional en menores de 5 anos,clasificacion e,2002-12-01,34,18,34,18,52
30101,COCHABAMBA,estado nutricional en menores de 5 anos,clasificacion e,2002-12-01,67,46,67,46,113
40902,COIPASA,estado nutricional en menores de 5 anos,clasificacion e,2002-12-01,0,1,0,1,1
30905,COLCAPIRHUA,estado nutricional en menores de 5 anos,clasificacion e,2002-12-01,9,5,9,5,14
50901,"COLCHA ""K""",estado nutricional en menores de 5 anos,clasificacion e,2002-12-01,9,5,9,5,14
31002,COLOMI,estado nutricional en menores de 5 anos,clasificacion e,2002-12-01,7,3,7,3,10
50401,COLQUECHACA,estado nutricional en menores de 5 anos,clasificacion e,2002-12-01,50,25,50,25,75
21306,COLQUENCHA,estado nutricional en menores de 5 anos,clasificacion e,2002-12-01,5,2,5,2,7
21004,COLQUIRI,estado nutricional en menores de 5 anos,clasificacion e,2002-12-01,7,5,7,5,12
20304,COMANCHE,estado nutricional en menores de 5 anos,clasificacion e,2002-12-01,1,1,1,1,2
71301,COMARAPA,estado nutricional en menores de 5 anos,clasificacion e,2002-12-01,26,19,26,19,45
20605,COMBAYA,estado nutricional en menores de 5 anos,clasificacion e,2002-12-01,3,2,3,2,5
71101,CONCEPCION,estado nutricional en menores de 5 anos,clasificacion e,2002-12-01,5,0,5,0,5
21701,COPACABANA,estado nutricional en menores de 5 anos,clasificacion e,2002-12-01,5,2,5,2,7
21402,CORIPATA,estado nutricional en menores de 5 anos,clasificacion e,2002-12-01,1,3,1,3,4
20301,CORO CORO,estado nutricional en menores de 5 anos,clasificacion e,2002-12-01,6,11,6,11,17
21401,COROICO,estado nutricional en menores de 5 anos,clasificacion e,2002-12-01,7,2,7,2,9
40301,CORQUE,estado nutricional en menores de 5 anos,clasificacion e,2002-12-01,10,7,10,7,17
50601,COTAGAITA,estado nutricional en menores de 5 anos,clasificacion e,2002-12-01,28,27,28,27,55
70102,COTOCA,estado nutricional en menores de 5 anos,clasificacion e,2002-12-01,8,1,8,1,9
70704,CUEVO,estado nutricional en menores de 5 anos,clasificacion e,2002-12-01,3,3,3,3,6
10902,CULPINA,estado nutricional en menores de 5 anos,clasificacion e,2002-12-01,57,56,57,56,113
40401,CURAHUARA DE CARANGAS,estado nutricional en menores de 5 anos,clasificacion e,2002-12-01,2,0,2,0,2
21602,CURVA,estado nutricional en menores de 5 anos,clasificacion e,2002-12-01,2,0,2,0,2
20804,DESAGUADERO,estado nutricional en menores de 5 anos,clasificacion e,2002-12-01,1,0,1,0,1
20105,EL ALTO,estado nutricional en menores de 5 anos,clasificacion e,2002-12-01,404,199,404,199,603
71503,EL PUENTE(STC),estado nutricional en menores de 5 anos,clasificacion e,2002-12-01,3,23,3,23,26
60502,EL PUENTE(TJA),estado nutricional en menores de 5 anos,clasificacion e,2002-12-01,15,22,15,22,37
70105,EL TORNO,estado nutricional en menores de 5 anos,clasificacion e,2002-12-01,13,13,13,13,26
10405,EL VILLAR,estado nutricional en menores de 5 anos,clasificacion e,2002-12-01,12,25,12,25,37
60601,ENTRE RIOS,estado nutricional en menores de 5 anos,clasificacion e,2002-12-01,4,5,4,5,9
41101,EUCALIPTUS,estado nutricional en menores de 5 anos,clasificacion e,2002-12-01,5,1,5,1,6
80402,EXALTACION,estado nutricional en menores de 5 anos,clasificacion e,2002-12-01,0,2,0,2,2
71002,GENERAL SAAVEDRA,estado nutricional en menores de 5 anos,clasificacion e,2002-12-01,16,15,16,15,31
21601,GRAL. J.J. PEREZ (CHARAZANI),estado nutricional en menores de 5 anos,clasificacion e,2002-12-01,1,4,1,4,5
20602,GUANAY,estado nutricional en menores de 5 anos,clasificacion e,2002-12-01,15,9,15,9,24
20802,GUAQUI,estado nutricional en menores de 5 anos,clasificacion e,2002-12-01,4,1,4,1,5
80202,GUAYARAMERIN,estado nutricional en menores de 5 anos,clasificacion e,2002-12-01,30,20,30,20,50
70705,GUTIERREZ,estado nutricional en menores de 5 anos,clasificacion e,2002-12-01,31,21,31,21,52
10502,HUACARETA,estado nutricional en menores de 5 anos,clasificacion e,2002-12-01,17,16,17,16,33
11002,HUACAYA (VILLA DE HUACAYA),estado nutricional en menores de 5 anos,clasificacion e,2002-12-01,2,0,2,0,2
40701,HUANUNI,estado nutricional en menores de 5 anos,clasificacion e,2002-12-01,16,8,16,8,24
80803,HUARACAJE,estado nutricional en menores de 5 anos,clasificacion e,2002-12-01,0,1,0,1,1
21005,ICHOCA,estado nutricional en menores de 5 anos,clasificacion e,2002-12-01,8,0,8,0,8
10304,ICLA,estado nutricional en menores de 5 anos,clasificacion e,2002-12-01,50,69,50,69,119
10703,INCAHUASI,estado nutricional en menores de 5 anos,clasificacion e,2002-12-01,38,26,38,26,64
21001,INQUISIVI,estado nutricional en menores de 5 anos,clasificacion e,2002-12-01,28,19,28,19,47
21501,IXIAMAS,estado nutricional en menores de 5 anos,clasificacion e,2002-12-01,7,22,7,22,29
21105,LA ASUNTA,estado nutricional en menores de 5 anos,clasificacion e,2002-12-01,11,10,11,10,21
70104,LA GUARDIA,estado nutricional en menores de 5 anos,clasificacion e,2002-12-01,8,4,8,4,12
20101,LA PAZ,estado nutricional en menores de 5 anos,clasificacion e,2002-12-01,182,112,182,112,294
70701,LAGUNILLAS,estado nutricional en menores de 5 anos,clasificacion e,2002-12-01,6,8,6,8,14
21202,LAJA,estado nutricional en menores de 5 anos,clasificacion e,2002-12-01,8,3,8,3,11
10903,LAS CARRERAS,estado nutricional en menores de 5 anos,clasificacion e,2002-12-01,1,12,1,12,13
50203,LLALLAGUA,estado nutricional en menores de 5 anos,clasificacion e,2002-12-01,16,64,16,64,80
51401,LLICA,estado nutricional en menores de 5 anos,clasificacion e,2002-12-01,0,1,0,1,1
20901,LURIBAY,estado nutricional en menores de 5 anos,clasificacion e,2002-12-01,4,0,4,0,4
40702,MACHACAMARCA,estado nutricional en menores de 5 anos,clasificacion e,2002-12-01,0,2,0,2,2
11003,MACHARETI,estado nutricional en menores de 5 anos,clasificacion e,2002-12-01,19,30,19,30,49
80801,MAGDALENA,estado nutricional en menores de 5 anos,clasificacion e,2002-12-01,1,1,1,1,2
70903,MAIRANA,estado nutricional en menores de 5 anos,clasificacion e,2002-12-01,3,2,3,2,5
20103,MECAPACA,estado nutricional en menores de 5 anos,clasificacion e,2002-12-01,2,2,2,2,4
71003,MINEROS,estado nutricional en menores de 5 anos,clasificacion e,2002-12-01,26,14,26,14,40
31301,MIZQUE,estado nutricional en menores de 5 anos,clasificacion e,2002-12-01,11,9,11,9,20
20402,MOCOMOCO,estado nutricional en menores de 5 anos,clasificacion e,2002-12-01,9,2,9,2,11
10303,MOJOCOYA,estado nutricional en menores de 5 anos,clasificacion e,2002-12-01,9,9,9,9,18
10501,MONTEAGUDO,estado nutricional en menores de 5 anos,clasificacion e,2002-12-01,26,27,26,27,53
71001,MONTERO,estado nutricional en menores de 5 anos,clasificacion e,2002-12-01,54,23,54,23,77
30302,MOROCHATA,estado nutricional en menores de 5 anos,clasificacion e,2002-12-01,16,23,16,23,39
90401,NACEBE (SANTA ROSA DEL ABUNA),estado nutricional en menores de 5 anos,clasificacion e,2002-12-01,0,3,0,3,3
20307,NAZACARA DE PACAJES,estado nutricional en menores de 5 anos,clasificacion e,2002-12-01,2,0,2,0,2
50404,OCURI,estado nutricional en menores de 5 anos,clasificacion e,2002-12-01,23,43,23,43,66
70202,OKINAWA,estado nutricional en menores de 5 anos,clasificacion e,2002-12-01,3,0,3,0,3
30203,OMEREQUE,estado nutricional en menores de 5 anos,clasificacion e,2002-12-01,0,1,0,1,1
40101,ORURO,estado nutricional en menores de 5 anos,clasificacion e,2002-12-01,97,60,97,60,157
60201,PADCAYA,estado nutricional en menores de 5 anos,clasificacion e,2002-12-01,6,4,6,4,10
10401,PADILLA,estado nutricional en menores de 5 anos,clasificacion e,2002-12-01,33,50,33,50,83
70502,PAILON,estado nutricional en menores de 5 anos,clasificacion e,2002-12-01,4,3,4,3,7
20102,PALCA,estado nutricional en menores de 5 anos,clasificacion e,2002-12-01,10,10,10,10,20
21104,PALOS BLANCOS,estado nutricional en menores de 5 anos,clasificacion e,2002-12-01,11,5,11,5,16
40802,PAMPA AULLAGAS,estado nutricional en menores de 5 anos,clasificacion e,2002-12-01,3,1,3,1,4
70902,PAMPA GRANDE,estado nutricional en menores de 5 anos,clasificacion e,2002-12-01,3,1,3,1,4
21802,PAPEL PAMPA,estado nutricional en menores de 5 anos,clasificacion e,2002-12-01,1,1,1,1,2
30202,PASORAPA,estado nutricional en menores de 5 anos,clasificacion e,2002-12-01,3,3,3,3,6
21305,PATACAMAYA,estado nutricional en menores de 5 anos,clasificacion e,2002-12-01,10,9,10,9,19
40602,PAZÃ‘A,estado nutricional en menores de 5 anos,clasificacion e,2002-12-01,1,4,1,4,5
20702,PELECHUCO,estado nutricional en menores de 5 anos,clasificacion e,2002-12-01,5,0,5,0,5
50403,POCOATA,estado nutricional en menores de 5 anos,clasificacion e,2002-12-01,38,62,38,62,100
31203,POCONA,estado nutricional en menores de 5 anos,clasificacion e,2002-12-01,22,11,22,11,33
31202,POJO (CBBA),estado nutricional en menores de 5 anos,clasificacion e,2002-12-01,23,7,23,7,30
40601,POOPO,estado nutricional en menores de 5 anos,clasificacion e,2002-12-01,3,3,3,3,6
51203,PORCO,estado nutricional en menores de 5 anos,clasificacion e,2002-12-01,1,6,1,6,7
10103,POROMA,estado nutricional en menores de 5 anos,clasificacion e,2002-12-01,29,35,29,35,64
70601,PORTACHUELO,estado nutricional en menores de 5 anos,clasificacion e,2002-12-01,14,15,14,15,29
90102,PORVENIR,estado nutricional en menores de 5 anos,clasificacion e,2002-12-01,5,0,5,0,5
70804,POSTRER VALLE,estado nutricional en menores de 5 anos,clasificacion e,2002-12-01,2,2,2,2,4
50101,POTOSI,estado nutricional en menores de 5 anos,clasificacion e,2002-12-01,129,65,129,65,194
10302,PRESTO,estado nutricional en menores de 5 anos,clasificacion e,2002-12-01,24,22,24,22,46
20401,PUERTO ACOSTA,estado nutricional en menores de 5 anos,clasificacion e,2002-12-01,13,15,13,15,28
20403,PUERTO CARABUCO,estado nutricional en menores de 5 anos,clasificacion e,2002-12-01,11,6,11,6,17
90301,PUERTO GONZALO MORENO,estado nutricional en menores de 5 anos,clasificacion e,2002-12-01,1,0,1,0,1
21204,PUERTO PEREZ,estado nutricional en menores de 5 anos,clasificacion e,2002-12-01,1,1,1,1,2
71402,PUERTO QUIJARRO,estado nutricional en menores de 5 anos,clasificacion e,2002-12-01,11,1,11,1,12
90201,PUERTO RICO,estado nutricional en menores de 5 anos,clasificacion e,2002-12-01,2,3,2,3,5
71401,PUERTO SUAREZ,estado nutricional en menores de 5 anos,clasificacion e,2002-12-01,13,7,13,7,20
31205,PUERTO VILLARROEL,estado nutricional en menores de 5 anos,clasificacion e,2002-12-01,50,28,50,28,78
51101,PUNA,estado nutricional en menores de 5 anos,clasificacion e,2002-12-01,27,15,27,15,42
31401,PUNATA,estado nutricional en menores de 5 anos,clasificacion e,2002-12-01,39,16,39,16,55
30901,QUILLACOLLO,estado nutricional en menores de 5 anos,clasificacion e,2002-12-01,16,25,16,25,41
21002,QUIME,estado nutricional en menores de 5 anos,clasificacion e,2002-12-01,7,8,7,8,15
50402,RAVELO,estado nutricional en menores de 5 anos,clasificacion e,2002-12-01,114,101,114,101,215
80301,REYES,estado nutricional en menores de 5 anos,clasificacion e,2002-12-01,1,2,1,2,3
80201,RIBERALTA,estado nutricional en menores de 5 anos,clasificacion e,2002-12-01,85,92,85,92,177
70503,ROBORE,estado nutricional en menores de 5 anos,clasificacion e,2002-12-01,10,9,10,9,19
80304,RURRENABAQUE,estado nutricional en menores de 5 anos,clasificacion e,2002-12-01,2,1,2,1,3
31001,SACABA,estado nutricional en menores de 5 anos,clasificacion e,2002-12-01,39,14,39,14,53
30404,SACABAMBA,estado nutricional en menores de 5 anos,clasificacion e,2002-12-01,3,7,3,7,10
50701,SACACA,estado nutricional en menores de 5 anos,clasificacion e,2002-12-01,49,75,49,75,124
71302,SAIPINA,estado nutricional en menores de 5 anos,clasificacion e,2002-12-01,7,6,7,6,13
40801,SALINAS DE GARCI MENDOZA,estado nutricional en menores de 5 anos,clasificacion e,2002-12-01,3,6,3,6,9
70901,SAMAIPATA,estado nutricional en menores de 5 anos,clasificacion e,2002-12-01,2,2,2,2,4
80602,SAN ANDRES,estado nutricional en menores de 5 anos,clasificacion e,2002-12-01,6,2,6,2,8
51003,SAN ANTONIO DE ESMORUCO,estado nutricional en menores de 5 anos,clasificacion e,2002-12-01,0,4,0,4,4
71105,SAN ANTONIO DE LOMERIO,estado nutricional en menores de 5 anos,clasificacion e,2002-12-01,32,36,32,36,68
31403,SAN BENITO,estado nutricional en menores de 5 anos,clasificacion e,2002-12-01,5,2,5,2,7
80302,SAN BORJA,estado nutricional en menores de 5 anos,clasificacion e,2002-12-01,42,33,42,33,75
21502,SAN BUENA VENTURA,estado nutricional en menores de 5 anos,clasificacion e,2002-12-01,8,9,8,9,17
70402,SAN CARLOS,estado nutricional en menores de 5 anos,clasificacion e,2002-12-01,5,5,5,5,10
80501,SAN IGNACIO,estado nutricional en menores de 5 anos,clasificacion e,2002-12-01,22,17,22,17,39
70301,SAN IGNACIO DE VELASCO,estado nutricional en menores de 5 anos,clasificacion e,2002-12-01,54,73,54,73,127
71102,SAN JAVIER(STC),estado nutricional en menores de 5 anos,clasificacion e,2002-12-01,15,8,15,8,23
80701,SAN JOAQUIN,estado nutricional en menores de 5 anos,clasificacion e,2002-12-01,2,0,2,0,2
70501,SAN JOSE DE CHIQUITOS,estado nutricional en menores de 5 anos,clasificacion e,2002-12-01,8,3,8,3,11
71104,SAN JULIAN,estado nutricional en menores de 5 anos,clasificacion e,2002-12-01,58,26,58,26,84
90302,SAN LORENZO(PND),estado nutricional en menores de 5 anos,clasificacion e,2002-12-01,0,2,0,2,2
60501,SAN LORENZO(TJA),estado nutricional en menores de 5 anos,clasificacion e,2002-12-01,11,18,11,18,29
10702,SAN LUCAS,estado nutricional en menores de 5 anos,clasificacion e,2002-12-01,114,86,114,86,200
70302,SAN MIGUEL DE VELASCO,estado nutricional en menores de 5 anos,clasificacion e,2002-12-01,8,11,8,11,19
51001,SAN PABLO DE LIPEZ,estado nutricional en menores de 5 anos,clasificacion e,2002-12-01,1,0,1,0,1
50501,SAN PEDRO DE BUENA VISTA,estado nutricional en menores de 5 anos,clasificacion e,2002-12-01,37,46,37,46,83
21801,SAN PEDRO DE CURAHUARA,estado nutricional en menores de 5 anos,clasificacion e,2002-12-01,6,3,6,3,9
70303,SAN RAFAEL,estado nutricional en menores de 5 anos,clasificacion e,2002-12-01,10,4,10,4,14
80702,SAN RAMON,estado nutricional en menores de 5 anos,clasificacion e,2002-12-01,1,1,1,1,2
80401,SANTA ANA,estado nutricional en menores de 5 anos,clasificacion e,2002-12-01,11,13,11,13,24
70101,SANTA CRUZ DE LA SIERRA,estado nutricional en menores de 5 anos,clasificacion e,2002-12-01,108,47,108,47,155
80303,SANTA ROSA,estado nutricional en menores de 5 anos,clasificacion e,2002-12-01,6,2,6,2,8
70602,SANTA ROSA DEL SARA,estado nutricional en menores de 5 anos,clasificacion e,2002-12-01,5,5,5,5,10
20308,SANTIAGO DE CALLAPA,estado nutricional en menores de 5 anos,clasificacion e,2002-12-01,7,4,7,4,11
41401,SANTIAGO DE HUARI,estado nutricional en menores de 5 anos,clasificacion e,2002-12-01,7,6,7,6,13
21901,SANTIAGO DE MACHACA,estado nutricional en menores de 5 anos,clasificacion e,2002-12-01,2,0,2,0,2
30702,SANTIVAÃ‘ES,estado nutricional en menores de 5 anos,clasificacion e,2002-12-01,2,1,2,1,3
40202,SANTUARIO DE QUILLACAS,estado nutricional en menores de 5 anos,clasificacion e,2002-12-01,2,1,2,1,3
20902,SAPAHAQUI,estado nutricional en menores de 5 anos,clasificacion e,2002-12-01,16,3,16,3,19
90303,SENA,estado nutricional en menores de 5 anos,clasificacion e,2002-12-01,2,0,2,0,2
21301,SICA SICA (VILLA AROMA),estado nutricional en menores de 5 anos,clasificacion e,2002-12-01,14,11,14,11,25
30703,SICAYA,estado nutricional en menores de 5 anos,clasificacion e,2002-12-01,1,4,1,4,5
30902,SIPE SIPE,estado nutricional en menores de 5 anos,clasificacion e,2002-12-01,39,13,39,13,52
10403,SOPACHUY,estado nutricional en menores de 5 anos,clasificacion e,2002-12-01,38,29,38,29,67
20601,SORATA,estado nutricional en menores de 5 anos,clasificacion e,2002-12-01,7,6,7,6,13
10101,SUCRE,estado nutricional en menores de 5 anos,clasificacion e,2002-12-01,101,77,101,77,178
31404,TACACHI,estado nutricional en menores de 5 anos,clasificacion e,2002-12-01,1,0,1,0,1
20603,TACACOMA,estado nutricional en menores de 5 anos,clasificacion e,2002-12-01,6,8,6,8,14
50303,TACOBAMBA,estado nutricional en menores de 5 anos,clasificacion e,2002-12-01,21,28,21,28,49
30602,TACOPAYA,estado nutricional en menores de 5 anos,clasificacion e,2002-12-01,4,3,4,3,7
31101,TAPACARI,estado nutricional en menores de 5 anos,clasificacion e,2002-12-01,18,21,18,21,39
10601,TARABUCO,estado nutricional en menores de 5 anos,clasificacion e,2002-12-01,127,125,127,125,252
30401,TARATA,estado nutricional en menores de 5 anos,clasificacion e,2002-12-01,6,9,6,9,15
60101,TARIJA,estado nutricional en menores de 5 anos,clasificacion e,2002-12-01,45,31,45,31,76
10202,TARVITA,estado nutricional en menores de 5 anos,clasificacion e,2002-12-01,28,37,28,37,65
20803,TIAWANACU,estado nutricional en menores de 5 anos,clasificacion e,2002-12-01,3,6,3,6,9
50102,TINGUIPAYA,estado nutricional en menores de 5 anos,clasificacion e,2002-12-01,12,13,12,13,25
20606,TIPUANI,estado nutricional en menores de 5 anos,clasificacion e,2002-12-01,2,3,2,3,5
30903,TIQUIPAYA,estado nutricional en menores de 5 anos,clasificacion e,2002-12-01,5,18,5,18,23
31601,TIRAQUE (CBBA),estado nutricional en menores de 5 anos,clasificacion e,2002-12-01,32,45,32,45,77
30802,TOCO,estado nutricional en menores de 5 anos,clasificacion e,2002-12-01,0,4,0,4,4
30803,TOLATA,estado nutricional en menores de 5 anos,clasificacion e,2002-12-01,0,1,0,1,1
41001,TOLEDO,estado nutricional en menores de 5 anos,clasificacion e,2002-12-01,2,2,2,2,4
51202,TOMAVE,estado nutricional en menores de 5 anos,clasificacion e,2002-12-01,15,14,15,14,29
10402,TOMINA,estado nutricional en menores de 5 anos,clasificacion e,2002-12-01,26,42,26,42,68
50502,TORO TORO,estado nutricional en menores de 5 anos,clasificacion e,2002-12-01,12,12,12,12,24
31201,TOTORA(CBBA),estado nutricional en menores de 5 anos,clasificacion e,2002-12-01,13,7,13,7,20
41301,TOTORA(ORR),estado nutricional en menores de 5 anos,clasificacion e,2002-12-01,4,3,4,3,7
70802,TRIGAL,estado nutricional en menores de 5 anos,clasificacion e,2002-12-01,2,0,2,0,2
80101,TRINIDAD,estado nutricional en menores de 5 anos,clasificacion e,2002-12-01,39,57,39,57,96
50801,TUPIZA,estado nutricional en menores de 5 anos,clasificacion e,2002-12-01,13,91,13,91,104
40402,TURCO,estado nutricional en menores de 5 anos,clasificacion e,2002-12-01,1,1,1,1,2
21302,UMALA,estado nutricional en menores de 5 anos,clasificacion e,2002-12-01,1,1,1,1,2
50201,UNCIA,estado nutricional en menores de 5 anos,clasificacion e,2002-12-01,2,5,2,5,7
60401,URIONDO (A. CONCEPCION),estado nutricional en menores de 5 anos,clasificacion e,2002-12-01,4,3,4,3,7
71502,URUBICHA,estado nutricional en menores de 5 anos,clasificacion e,2002-12-01,8,6,8,6,14
51201,UYUNI,estado nutricional en menores de 5 anos,clasificacion e,2002-12-01,9,13,9,13,22
30502,VACAS,estado nutricional en menores de 5 anos,clasificacion e,2002-12-01,4,23,4,23,27
70801,VALLEGRANDE,estado nutricional en menores de 5 anos,clasificacion e,2002-12-01,10,8,10,8,18
20801,VIACHA,estado nutricional en menores de 5 anos,clasificacion e,2002-12-01,13,22,13,22,35
31302,VILA VILA,estado nutricional en menores de 5 anos,clasificacion e,2002-12-01,2,21,2,21,23
60303,VILLA MONTES,estado nutricional en menores de 5 anos,clasificacion e,2002-12-01,21,2,21,2,23
31402,VILLA RIVERO,estado nutricional en menores de 5 anos,clasificacion e,2002-12-01,1,1,1,1,2
10801,VILLA SERRANO,estado nutricional en menores de 5 anos,clasificacion e,2002-12-01,37,46,37,46,83
31003,VILLA TUNARI,estado nutricional en menores de 5 anos,clasificacion e,2002-12-01,11,29,11,29,40
11001,VILLA VACA GUZMAN (MUYUPAMPA),estado nutricional en menores de 5 anos,clasificacion e,2002-12-01,14,21,14,21,35
51501,VILLAZON,estado nutricional en menores de 5 anos,clasificacion e,2002-12-01,27,26,27,26,53
30904,VINTO,estado nutricional en menores de 5 anos,clasificacion e,2002-12-01,13,5,13,5,18
50602,VITICHI,estado nutricional en menores de 5 anos,clasificacion e,2002-12-01,18,26,18,26,44
20306,WALDO BALLIVIAN,estado nutricional en menores de 5 anos,clasificacion e,2002-12-01,1,0,1,0,1
70201,WARNES,estado nutricional en menores de 5 anos,clasificacion e,2002-12-01,22,15,22,15,37
20903,YACO,estado nutricional en menores de 5 anos,clasificacion e,2002-12-01,5,13,5,13,18
60301,YACUIBA,estado nutricional en menores de 5 anos,clasificacion e,2002-12-01,23,11,23,11,34
10602,YAMPARAEZ,estado nutricional en menores de 5 anos,clasificacion e,2002-12-01,76,46,76,46,122
50103,YOCALLA,estado nutricional en menores de 5 anos,clasificacion e,2002-12-01,4,4,4,4,8
10102,YOTALA,estado nutricional en menores de 5 anos,clasificacion e,2002-12-01,28,36,28,36,64
60402,YUNCHARA,estado nutricional en menores de 5 anos,clasificacion e,2002-12-01,4,4,4,4,8
10301,ZUDAÃ‘EZ,estado nutricional en menores de 5 anos,clasificacion e,2002-12-01,25,38,25,38,63
51302,ACACIO,estado nutricional en menores de 5 anos,clasificacion e,2003-01-01,28,40,28,40,68
20201,ACHACACHI,estado nutricional en menores de 5 anos,clasificacion e,2003-01-01,34,29,34,29,63
20104,ACHOCALLA,estado nutricional en menores de 5 anos,clasificacion e,2003-01-01,9,2,9,2,11
30201,AIQUILE,estado nutricional en menores de 5 anos,clasificacion e,2003-01-01,11,9,11,9,20
31303,ALALAY,estado nutricional en menores de 5 anos,clasificacion e,2003-01-01,4,3,4,3,7
10404,ALCALA,estado nutricional en menores de 5 anos,clasificacion e,2003-01-01,9,15,9,15,24
20202,ANCORAIMES,estado nutricional en menores de 5 anos,clasificacion e,2003-01-01,29,12,29,12,41
40603,ANTEQUERA,estado nutricional en menores de 5 anos,clasificacion e,2003-01-01,1,2,1,2,3
30402,ANZALDO,estado nutricional en menores de 5 anos,clasificacion e,2003-01-01,1,4,1,4,5
20701,APOLO,estado nutricional en menores de 5 anos,clasificacion e,2003-01-01,11,15,11,15,26
51301,ARAMPAMPA,estado nutricional en menores de 5 anos,clasificacion e,2003-01-01,10,23,10,23,33
30501,ARANI,estado nutricional en menores de 5 anos,clasificacion e,2003-01-01,1,4,1,4,5
30403,ARBIETO,estado nutricional en menores de 5 anos,clasificacion e,2003-01-01,0,2,0,2,2
30601,ARQUE,estado nutricional en menores de 5 anos,clasificacion e,2003-01-01,10,12,10,12,22
50802,ATOCHA,estado nutricional en menores de 5 anos,clasificacion e,2003-01-01,3,18,3,18,21
20503,AUCAPATA,estado nutricional en menores de 5 anos,clasificacion e,2003-01-01,2,0,2,0,2
20502,AYATA,estado nutricional en menores de 5 anos,clasificacion e,2003-01-01,11,3,11,3,14
21303,AYO AYO,estado nutricional en menores de 5 anos,clasificacion e,2003-01-01,6,0,6,0,6
30301,AYOPAYA (V. DE INDEPENDENCIA),estado nutricional en menores de 5 anos,clasificacion e,2003-01-01,10,7,10,7,17
10201,AZURDUY,estado nutricional en menores de 5 anos,clasificacion e,2003-01-01,37,51,37,51,88
21203,BATALLAS,estado nutricional en menores de 5 anos,clasificacion e,2003-01-01,2,4,2,4,6
80802,BAURES,estado nutricional en menores de 5 anos,clasificacion e,2003-01-01,2,2,2,2,4
50104,BELEN DE URMIRI,estado nutricional en menores de 5 anos,clasificacion e,2003-01-01,1,0,1,0,1
90104,BELLA FLOR,estado nutricional en menores de 5 anos,clasificacion e,2003-01-01,1,1,1,1,2
60202,BERMEJO,estado nutricional en menores de 5 anos,clasificacion e,2003-01-01,1,2,1,2,3
50301,BETANZOS,estado nutricional en menores de 5 anos,clasificacion e,2003-01-01,123,88,123,88,211
31501,BOLIVAR,estado nutricional en menores de 5 anos,clasificacion e,2003-01-01,14,23,14,23,37
90103,BOLPEBRA,estado nutricional en menores de 5 anos,clasificacion e,2003-01-01,2,0,2,0,2
70707,BOYUIBE,estado nutricional en menores de 5 anos,clasificacion e,2003-01-01,0,1,0,1,1
70401,BUENA VISTA,estado nutricional en menores de 5 anos,clasificacion e,2003-01-01,7,7,7,7,14
70703,CABEZAS,estado nutricional en menores de 5 anos,clasificacion e,2003-01-01,9,14,9,14,23
20905,CAIROMA,estado nutricional en menores de 5 anos,clasificacion e,2003-01-01,15,5,15,5,20
51102,"CAIZA ""D""",estado nutricional en menores de 5 anos,clasificacion e,2003-01-01,42,22,42,22,64
21003,CAJUATA,estado nutricional en menores de 5 anos,clasificacion e,2003-01-01,16,8,16,8,24
20303,CALACOTO,estado nutricional en menores de 5 anos,clasificacion e,2003-01-01,1,0,1,0,1
21304,CALAMARCA,estado nutricional en menores de 5 anos,clasificacion e,2003-01-01,18,8,18,8,26
10701,CAMARGO,estado nutricional en menores de 5 anos,clasificacion e,2003-01-01,31,22,31,22,53
10901,CAMATAQUI (C. VILLA ABECIA),estado nutricional en menores de 5 anos,clasificacion e,2003-01-01,4,2,4,2,6
70706,CAMIRI,estado nutricional en menores de 5 anos,clasificacion e,2003-01-01,92,27,92,27,119
30701,CAPINOTA,estado nutricional en menores de 5 anos,clasificacion e,2003-01-01,15,23,15,23,38
20302,CAQUIAVIRI,estado nutricional en menores de 5 anos,clasificacion e,2003-01-01,7,10,7,10,17
40102,CARACOLLO,estado nutricional en menores de 5 anos,clasificacion e,2003-01-01,8,9,8,9,17
22001,CARANAVI,estado nutricional en menores de 5 anos,clasificacion e,2003-01-01,34,20,34,20,54
41503,CARANGAS,estado nutricional en menores de 5 anos,clasificacion e,2003-01-01,1,0,1,0,1
60302,CARAPARI,estado nutricional en menores de 5 anos,clasificacion e,2003-01-01,10,8,10,8,18
50702,CARIPUYO,estado nutricional en menores de 5 anos,clasificacion e,2003-01-01,25,41,25,41,66
21902,CATACORA,estado nutricional en menores de 5 anos,clasificacion e,2003-01-01,0,1,0,1,1
40201,CHALLAPATA,estado nutricional en menores de 5 anos,clasificacion e,2003-01-01,21,21,21,21,42
50302,CHAQUI,estado nutricional en menores de 5 anos,clasificacion e,2003-01-01,23,13,23,13,36
70702,CHARAGUA,estado nutricional en menores de 5 anos,clasificacion e,2003-01-01,16,25,16,25,41
20305,CHARAÃ‘A,estado nutricional en menores de 5 anos,clasificacion e,2003-01-01,4,3,4,3,7
50202,CHAYANTA,estado nutricional en menores de 5 anos,clasificacion e,2003-01-01,20,12,20,12,32
31204,CHIMORE,estado nutricional en menores de 5 anos,clasificacion e,2003-01-01,11,3,11,3,14
40903,CHIPAYA,estado nutricional en menores de 5 anos,clasificacion e,2003-01-01,1,0,1,0,1
40302,CHOQUE COTA,estado nutricional en menores de 5 anos,clasificacion e,2003-01-01,1,1,1,1,2
21101,CHULUMANI (V. DE LA LIBERTAD),estado nutricional en menores de 5 anos,clasificacion e,2003-01-01,0,1,0,1,1
20501,CHUMA,estado nutricional en menores de 5 anos,clasificacion e,2003-01-01,8,8,8,8,16
30801,CLIZA,estado nutricional en menores de 5 anos,clasificacion e,2003-01-01,3,0,3,0,3
90101,COBIJA,estado nutricional en menores de 5 anos,clasificacion e,2003-01-01,16,13,16,13,29
30101,COCHABAMBA,estado nutricional en menores de 5 anos,clasificacion e,2003-01-01,122,80,122,80,202
30905,COLCAPIRHUA,estado nutricional en menores de 5 anos,clasificacion e,2003-01-01,4,8,4,8,12
50901,"COLCHA ""K""",estado nutricional en menores de 5 anos,clasificacion e,2003-01-01,6,5,6,5,11
21307,COLLANA,estado nutricional en menores de 5 anos,clasificacion e,2003-01-01,0,4,0,4,4
31002,COLOMI,estado nutricional en menores de 5 anos,clasificacion e,2003-01-01,16,8,16,8,24
50401,COLQUECHACA,estado nutricional en menores de 5 anos,clasificacion e,2003-01-01,44,12,44,12,56
21306,COLQUENCHA,estado nutricional en menores de 5 anos,clasificacion e,2003-01-01,4,2,4,2,6
21004,COLQUIRI,estado nutricional en menores de 5 anos,clasificacion e,2003-01-01,9,5,9,5,14
20304,COMANCHE,estado nutricional en menores de 5 anos,clasificacion e,2003-01-01,2,0,2,0,2
71301,COMARAPA,estado nutricional en menores de 5 anos,clasificacion e,2003-01-01,25,16,25,16,41
20605,COMBAYA,estado nutricional en menores de 5 anos,clasificacion e,2003-01-01,3,3,3,3,6
71101,CONCEPCION,estado nutricional en menores de 5 anos,clasificacion e,2003-01-01,2,1,2,1,3
21701,COPACABANA,estado nutricional en menores de 5 anos,clasificacion e,2003-01-01,2,0,2,0,2
21402,CORIPATA,estado nutricional en menores de 5 anos,clasificacion e,2003-01-01,0,4,0,4,4
20301,CORO CORO,estado nutricional en menores de 5 anos,clasificacion e,2003-01-01,10,13,10,13,23
21401,COROICO,estado nutricional en menores de 5 anos,clasificacion e,2003-01-01,6,6,6,6,12
40301,CORQUE,estado nutricional en menores de 5 anos,clasificacion e,2003-01-01,1,0,1,0,1
50601,COTAGAITA,estado nutricional en menores de 5 anos,clasificacion e,2003-01-01,38,29,38,29,67
70102,COTOCA,estado nutricional en menores de 5 anos,clasificacion e,2003-01-01,8,0,8,0,8
70704,CUEVO,estado nutricional en menores de 5 anos,clasificacion e,2003-01-01,2,2,2,2,4
10902,CULPINA,estado nutricional en menores de 5 anos,clasificacion e,2003-01-01,31,39,31,39,70
40401,CURAHUARA DE CARANGAS,estado nutricional en menores de 5 anos,clasificacion e,2003-01-01,0,2,0,2,2
21602,CURVA,estado nutricional en menores de 5 anos,clasificacion e,2003-01-01,5,2,5,2,7
20804,DESAGUADERO,estado nutricional en menores de 5 anos,clasificacion e,2003-01-01,2,1,2,1,3
20105,EL ALTO,estado nutricional en menores de 5 anos,clasificacion e,2003-01-01,416,206,416,206,622
40103,EL CHORO,estado nutricional en menores de 5 anos,clasificacion e,2003-01-01,2,1,2,1,3
71503,EL PUENTE(STC),estado nutricional en menores de 5 anos,clasificacion e,2003-01-01,4,34,4,34,38
60502,EL PUENTE(TJA),estado nutricional en menores de 5 anos,clasificacion e,2003-01-01,8,11,8,11,19
70105,EL TORNO,estado nutricional en menores de 5 anos,clasificacion e,2003-01-01,14,17,14,17,31
10405,EL VILLAR,estado nutricional en menores de 5 anos,clasificacion e,2003-01-01,12,26,12,26,38
60601,ENTRE RIOS,estado nutricional en menores de 5 anos,clasificacion e,2003-01-01,12,10,12,10,22
41101,EUCALIPTUS,estado nutricional en menores de 5 anos,clasificacion e,2003-01-01,1,1,1,1,2
80402,EXALTACION,estado nutricional en menores de 5 anos,clasificacion e,2003-01-01,3,3,3,3,6
90203,FILADELFIA,estado nutricional en menores de 5 anos,clasificacion e,2003-01-01,1,3,1,3,4
71002,GENERAL SAAVEDRA,estado nutricional en menores de 5 anos,clasificacion e,2003-01-01,41,29,41,29,70
21601,GRAL. J.J. PEREZ (CHARAZANI),estado nutricional en menores de 5 anos,clasificacion e,2003-01-01,2,0,2,0,2
20602,GUANAY,estado nutricional en menores de 5 anos,clasificacion e,2003-01-01,28,12,28,12,40
20802,GUAQUI,estado nutricional en menores de 5 anos,clasificacion e,2003-01-01,0,2,0,2,2
80202,GUAYARAMERIN,estado nutricional en menores de 5 anos,clasificacion e,2003-01-01,47,33,47,33,80
70705,GUTIERREZ,estado nutricional en menores de 5 anos,clasificacion e,2003-01-01,66,54,66,54,120
10502,HUACARETA,estado nutricional en menores de 5 anos,clasificacion e,2003-01-01,12,20,12,20,32
11002,HUACAYA (VILLA DE HUACAYA),estado nutricional en menores de 5 anos,clasificacion e,2003-01-01,1,3,1,3,4
40501,HUACHACALLA,estado nutricional en menores de 5 anos,clasificacion e,2003-01-01,1,0,1,0,1
40701,HUANUNI,estado nutricional en menores de 5 anos,clasificacion e,2003-01-01,29,6,29,6,35
80803,HUARACAJE,estado nutricional en menores de 5 anos,clasificacion e,2003-01-01,1,0,1,0,1
41601,HUAYLLAMARCA,estado nutricional en menores de 5 anos,clasificacion e,2003-01-01,2,3,2,3,5
21005,ICHOCA,estado nutricional en menores de 5 anos,clasificacion e,2003-01-01,4,13,4,13,17
10304,ICLA,estado nutricional en menores de 5 anos,clasificacion e,2003-01-01,20,31,20,31,51
10703,INCAHUASI,estado nutricional en menores de 5 anos,clasificacion e,2003-01-01,58,36,58,36,94
21001,INQUISIVI,estado nutricional en menores de 5 anos,clasificacion e,2003-01-01,29,27,29,27,56
21102,IRUPANA (VILLA DE LANZA),estado nutricional en menores de 5 anos,clasificacion e,2003-01-01,1,5,1,5,6
21501,IXIAMAS,estado nutricional en menores de 5 anos,clasificacion e,2003-01-01,7,13,7,13,20
21105,LA ASUNTA,estado nutricional en menores de 5 anos,clasificacion e,2003-01-01,9,7,9,7,16
70104,LA GUARDIA,estado nutricional en menores de 5 anos,clasificacion e,2003-01-01,17,14,17,14,31
20101,LA PAZ,estado nutricional en menores de 5 anos,clasificacion e,2003-01-01,264,139,264,139,403
70701,LAGUNILLAS,estado nutricional en menores de 5 anos,clasificacion e,2003-01-01,15,15,15,15,30
21202,LAJA,estado nutricional en menores de 5 anos,clasificacion e,2003-01-01,1,7,1,7,8
10903,LAS CARRERAS,estado nutricional en menores de 5 anos,clasificacion e,2003-01-01,8,12,8,12,20
21006,LICOMA PAMPA,estado nutricional en menores de 5 anos,clasificacion e,2003-01-01,1,1,1,1,2
50203,LLALLAGUA,estado nutricional en menores de 5 anos,clasificacion e,2003-01-01,4,111,4,111,115
51401,LLICA,estado nutricional en menores de 5 anos,clasificacion e,2003-01-01,1,0,1,0,1
20901,LURIBAY,estado nutricional en menores de 5 anos,clasificacion e,2003-01-01,6,6,6,6,12
40702,MACHACAMARCA,estado nutricional en menores de 5 anos,clasificacion e,2003-01-01,4,1,4,1,5
11003,MACHARETI,estado nutricional en menores de 5 anos,clasificacion e,2003-01-01,12,13,12,13,25
80801,MAGDALENA,estado nutricional en menores de 5 anos,clasificacion e,2003-01-01,4,5,4,5,9
70903,MAIRANA,estado nutricional en menores de 5 anos,clasificacion e,2003-01-01,15,1,15,1,16
20904,MALLA,estado nutricional en menores de 5 anos,clasificacion e,2003-01-01,0,1,0,1,1
20103,MECAPACA,estado nutricional en menores de 5 anos,clasificacion e,2003-01-01,0,4,0,4,4
71003,MINEROS,estado nutricional en menores de 5 anos,clasificacion e,2003-01-01,68,28,68,28,96
31301,MIZQUE,estado nutricional en menores de 5 anos,clasificacion e,2003-01-01,8,2,8,2,10
20402,MOCOMOCO,estado nutricional en menores de 5 anos,clasificacion e,2003-01-01,7,5,7,5,12
51002,MOJINETE,estado nutricional en menores de 5 anos,clasificacion e,2003-01-01,0,2,0,2,2
10303,MOJOCOYA,estado nutricional en menores de 5 anos,clasificacion e,2003-01-01,12,17,12,17,29
10501,MONTEAGUDO,estado nutricional en menores de 5 anos,clasificacion e,2003-01-01,38,42,38,42,80
71001,MONTERO,estado nutricional en menores de 5 anos,clasificacion e,2003-01-01,153,53,153,53,206
70803,MORO MORO,estado nutricional en menores de 5 anos,clasificacion e,2003-01-01,0,1,0,1,1
30302,MOROCHATA,estado nutricional en menores de 5 anos,clasificacion e,2003-01-01,48,31,48,31,79
90401,NACEBE (SANTA ROSA DEL ABUNA),estado nutricional en menores de 5 anos,clasificacion e,2003-01-01,0,1,0,1,1
90501,NUEVO MANOA (NUEVA ESPERANZA),estado nutricional en menores de 5 anos,clasificacion e,2003-01-01,0,5,0,5,5
50404,OCURI,estado nutricional en menores de 5 anos,clasificacion e,2003-01-01,19,59,19,59,78
70202,OKINAWA,estado nutricional en menores de 5 anos,clasificacion e,2003-01-01,6,2,6,2,8
30203,OMEREQUE,estado nutricional en menores de 5 anos,clasificacion e,2003-01-01,0,2,0,2,2
40101,ORURO,estado nutricional en menores de 5 anos,clasificacion e,2003-01-01,157,95,157,95,252
60201,PADCAYA,estado nutricional en menores de 5 anos,clasificacion e,2003-01-01,4,6,4,6,10
10401,PADILLA,estado nutricional en menores de 5 anos,clasificacion e,2003-01-01,27,46,27,46,73
70502,PAILON,estado nutricional en menores de 5 anos,clasificacion e,2003-01-01,19,7,19,7,26
20102,PALCA,estado nutricional en menores de 5 anos,clasificacion e,2003-01-01,11,12,11,12,23
21104,PALOS BLANCOS,estado nutricional en menores de 5 anos,clasificacion e,2003-01-01,7,14,7,14,21
40802,PAMPA AULLAGAS,estado nutricional en menores de 5 anos,clasificacion e,2003-01-01,1,2,1,2,3
70902,PAMPA GRANDE,estado nutricional en menores de 5 anos,clasificacion e,2003-01-01,2,2,2,2,4
21802,PAPEL PAMPA,estado nutricional en menores de 5 anos,clasificacion e,2003-01-01,1,0,1,0,1
30202,PASORAPA,estado nutricional en menores de 5 anos,clasificacion e,2003-01-01,5,3,5,3,8
21305,PATACAMAYA,estado nutricional en menores de 5 anos,clasificacion e,2003-01-01,25,14,25,14,39
40602,PAZÃ‘A,estado nutricional en menores de 5 anos,clasificacion e,2003-01-01,1,0,1,0,1
20702,PELECHUCO,estado nutricional en menores de 5 anos,clasificacion e,2003-01-01,3,11,3,11,14
50403,POCOATA,estado nutricional en menores de 5 anos,clasificacion e,2003-01-01,29,53,29,53,82
31203,POCONA,estado nutricional en menores de 5 anos,clasificacion e,2003-01-01,11,6,11,6,17
31202,POJO (CBBA),estado nutricional en menores de 5 anos,clasificacion e,2003-01-01,9,3,9,3,12
40601,POOPO,estado nutricional en menores de 5 anos,clasificacion e,2003-01-01,0,7,0,7,7
51203,PORCO,estado nutricional en menores de 5 anos,clasificacion e,2003-01-01,5,3,5,3,8
10103,POROMA,estado nutricional en menores de 5 anos,clasificacion e,2003-01-01,42,34,42,34,76
70103,PORONGO,estado nutricional en menores de 5 anos,clasificacion e,2003-01-01,1,1,1,1,2
70601,PORTACHUELO,estado nutricional en menores de 5 anos,clasificacion e,2003-01-01,11,11,11,11,22
90102,PORVENIR,estado nutricional en menores de 5 anos,clasificacion e,2003-01-01,5,0,5,0,5
70804,POSTRER VALLE,estado nutricional en menores de 5 anos,clasificacion e,2003-01-01,1,3,1,3,4
50101,POTOSI,estado nutricional en menores de 5 anos,clasificacion e,2003-01-01,166,79,166,79,245
10302,PRESTO,estado nutricional en menores de 5 anos,clasificacion e,2003-01-01,21,28,21,28,49
21201,PUCARANI,estado nutricional en menores de 5 anos,clasificacion e,2003-01-01,1,2,1,2,3
20401,PUERTO ACOSTA,estado nutricional en menores de 5 anos,clasificacion e,2003-01-01,21,33,21,33,54
20403,PUERTO CARABUCO,estado nutricional en menores de 5 anos,clasificacion e,2003-01-01,8,25,8,25,33
21204,PUERTO PEREZ,estado nutricional en menores de 5 anos,clasificacion e,2003-01-01,0,2,0,2,2
71402,PUERTO QUIJARRO,estado nutricional en menores de 5 anos,clasificacion e,2003-01-01,14,3,14,3,17
90201,PUERTO RICO,estado nutricional en menores de 5 anos,clasificacion e,2003-01-01,0,8,0,8,8
71401,PUERTO SUAREZ,estado nutricional en menores de 5 anos,clasificacion e,2003-01-01,15,9,15,9,24
31205,PUERTO VILLARROEL,estado nutricional en menores de 5 anos,clasificacion e,2003-01-01,56,38,56,38,94
51101,PUNA,estado nutricional en menores de 5 anos,clasificacion e,2003-01-01,123,91,123,91,214
31401,PUNATA,estado nutricional en menores de 5 anos,clasificacion e,2003-01-01,33,7,33,7,40
20604,QUIABAYA,estado nutricional en menores de 5 anos,clasificacion e,2003-01-01,12,6,12,6,18
30901,QUILLACOLLO,estado nutricional en menores de 5 anos,clasificacion e,2003-01-01,16,26,16,26,42
21002,QUIME,estado nutricional en menores de 5 anos,clasificacion e,2003-01-01,9,8,9,8,17
50402,RAVELO,estado nutricional en menores de 5 anos,clasificacion e,2003-01-01,85,78,85,78,163
80301,REYES,estado nutricional en menores de 5 anos,clasificacion e,2003-01-01,8,6,8,6,14
80201,RIBERALTA,estado nutricional en menores de 5 anos,clasificacion e,2003-01-01,98,66,98,66,164
70503,ROBORE,estado nutricional en menores de 5 anos,clasificacion e,2003-01-01,16,13,16,13,29
40901,SABAYA,estado nutricional en menores de 5 anos,clasificacion e,2003-01-01,0,5,0,5,5
31001,SACABA,estado nutricional en menores de 5 anos,clasificacion e,2003-01-01,54,36,54,36,90
50701,SACACA,estado nutricional en menores de 5 anos,clasificacion e,2003-01-01,47,66,47,66,113
71302,SAIPINA,estado nutricional en menores de 5 anos,clasificacion e,2003-01-01,2,6,2,6,8
40801,SALINAS DE GARCI MENDOZA,estado nutricional en menores de 5 anos,clasificacion e,2003-01-01,5,7,5,7,12
70901,SAMAIPATA,estado nutricional en menores de 5 anos,clasificacion e,2003-01-01,3,0,3,0,3
80602,SAN ANDRES,estado nutricional en menores de 5 anos,clasificacion e,2003-01-01,1,4,1,4,5
51003,SAN ANTONIO DE ESMORUCO,estado nutricional en menores de 5 anos,clasificacion e,2003-01-01,2,3,2,3,5
71105,SAN ANTONIO DE LOMERIO,estado nutricional en menores de 5 anos,clasificacion e,2003-01-01,55,59,55,59,114
31403,SAN BENITO,estado nutricional en menores de 5 anos,clasificacion e,2003-01-01,7,8,7,8,15
80302,SAN BORJA,estado nutricional en menores de 5 anos,clasificacion e,2003-01-01,40,28,40,28,68
21502,SAN BUENA VENTURA,estado nutricional en menores de 5 anos,clasificacion e,2003-01-01,11,6,11,6,17
70402,SAN CARLOS,estado nutricional en menores de 5 anos,clasificacion e,2003-01-01,26,9,26,9,35
80501,SAN IGNACIO,estado nutricional en menores de 5 anos,clasificacion e,2003-01-01,32,6,32,6,38
70301,SAN IGNACIO DE VELASCO,estado nutricional en menores de 5 anos,clasificacion e,2003-01-01,73,38,73,38,111
71102,SAN JAVIER(STC),estado nutricional en menores de 5 anos,clasificacion e,2003-01-01,16,5,16,5,21
80701,SAN JOAQUIN,estado nutricional en menores de 5 anos,clasificacion e,2003-01-01,1,0,1,0,1
70501,SAN JOSE DE CHIQUITOS,estado nutricional en menores de 5 anos,clasificacion e,2003-01-01,18,6,18,6,24
71104,SAN JULIAN,estado nutricional en menores de 5 anos,clasificacion e,2003-01-01,44,25,44,25,69
90302,SAN LORENZO(PND),estado nutricional en menores de 5 anos,clasificacion e,2003-01-01,2,3,2,3,5
60501,SAN LORENZO(TJA),estado nutricional en menores de 5 anos,clasificacion e,2003-01-01,15,11,15,11,26
10702,SAN LUCAS,estado nutricional en menores de 5 anos,clasificacion e,2003-01-01,97,99,97,99,196
71201,SAN MATIAS,estado nutricional en menores de 5 anos,clasificacion e,2003-01-01,14,12,14,12,26
70302,SAN MIGUEL DE VELASCO,estado nutricional en menores de 5 anos,clasificacion e,2003-01-01,21,11,21,11,32
51001,SAN PABLO DE LIPEZ,estado nutricional en menores de 5 anos,clasificacion e,2003-01-01,0,3,0,3,3
50501,SAN PEDRO DE BUENA VISTA,estado nutricional en menores de 5 anos,clasificacion e,2003-01-01,34,28,34,28,62
21801,SAN PEDRO DE CURAHUARA,estado nutricional en menores de 5 anos,clasificacion e,2003-01-01,7,6,7,6,13
50902,SAN PEDRO DE QUEMES,estado nutricional en menores de 5 anos,clasificacion e,2003-01-01,2,0,2,0,2
21702,SAN PEDRO DE TIQUINA,estado nutricional en menores de 5 anos,clasificacion e,2003-01-01,0,2,0,2,2
90202,SAN PEDRO(PND),estado nutricional en menores de 5 anos,clasificacion e,2003-01-01,0,2,0,2,2
70303,SAN RAFAEL,estado nutricional en menores de 5 anos,clasificacion e,2003-01-01,13,8,13,8,21
80702,SAN RAMON,estado nutricional en menores de 5 anos,clasificacion e,2003-01-01,1,0,1,0,1
80401,SANTA ANA,estado nutricional en menores de 5 anos,clasificacion e,2003-01-01,1,0,1,0,1
70101,SANTA CRUZ DE LA SIERRA,estado nutricional en menores de 5 anos,clasificacion e,2003-01-01,264,120,264,120,384
80303,SANTA ROSA,estado nutricional en menores de 5 anos,clasificacion e,2003-01-01,1,1,1,1,2
70602,SANTA ROSA DEL SARA,estado nutricional en menores de 5 anos,clasificacion e,2003-01-01,0,1,0,1,1
20308,SANTIAGO DE CALLAPA,estado nutricional en menores de 5 anos,clasificacion e,2003-01-01,3,4,3,4,7
41401,SANTIAGO DE HUARI,estado nutricional en menores de 5 anos,clasificacion e,2003-01-01,2,11,2,11,13
21901,SANTIAGO DE MACHACA,estado nutricional en menores de 5 anos,clasificacion e,2003-01-01,5,1,5,1,6
30702,SANTIVAÃ‘ES,estado nutricional en menores de 5 anos,clasificacion e,2003-01-01,6,1,6,1,7
40202,SANTUARIO DE QUILLACAS,estado nutricional en menores de 5 anos,clasificacion e,2003-01-01,3,0,3,0,3
20902,SAPAHAQUI,estado nutricional en menores de 5 anos,clasificacion e,2003-01-01,8,0,8,0,8
90303,SENA,estado nutricional en menores de 5 anos,clasificacion e,2003-01-01,0,16,0,16,16
21301,SICA SICA (VILLA AROMA),estado nutricional en menores de 5 anos,clasificacion e,2003-01-01,21,16,21,16,37
30703,SICAYA,estado nutricional en menores de 5 anos,clasificacion e,2003-01-01,4,0,4,0,4
30902,SIPE SIPE,estado nutricional en menores de 5 anos,clasificacion e,2003-01-01,42,23,42,23,65
10403,SOPACHUY,estado nutricional en menores de 5 anos,clasificacion e,2003-01-01,32,24,32,24,56
20601,SORATA,estado nutricional en menores de 5 anos,clasificacion e,2003-01-01,7,9,7,9,16
10101,SUCRE,estado nutricional en menores de 5 anos,clasificacion e,2003-01-01,103,67,103,67,170
31404,TACACHI,estado nutricional en menores de 5 anos,clasificacion e,2003-01-01,1,3,1,3,4
20603,TACACOMA,estado nutricional en menores de 5 anos,clasificacion e,2003-01-01,4,0,4,0,4
50303,TACOBAMBA,estado nutricional en menores de 5 anos,clasificacion e,2003-01-01,17,10,17,10,27
30602,TACOPAYA,estado nutricional en menores de 5 anos,clasificacion e,2003-01-01,35,42,35,42,77
31101,TAPACARI,estado nutricional en menores de 5 anos,clasificacion e,2003-01-01,21,25,21,25,46
10601,TARABUCO,estado nutricional en menores de 5 anos,clasificacion e,2003-01-01,120,116,120,116,236
30401,TARATA,estado nutricional en menores de 5 anos,clasificacion e,2003-01-01,7,6,7,6,13
60101,TARIJA,estado nutricional en menores de 5 anos,clasificacion e,2003-01-01,60,30,60,30,90
10202,TARVITA,estado nutricional en menores de 5 anos,clasificacion e,2003-01-01,25,37,25,37,62
20803,TIAWANACU,estado nutricional en menores de 5 anos,clasificacion e,2003-01-01,0,3,0,3,3
50102,TINGUIPAYA,estado nutricional en menores de 5 anos,clasificacion e,2003-01-01,19,38,19,38,57
20606,TIPUANI,estado nutricional en menores de 5 anos,clasificacion e,2003-01-01,9,3,9,3,12
30903,TIQUIPAYA,estado nutricional en menores de 5 anos,clasificacion e,2003-01-01,6,5,6,5,11
31601,TIRAQUE (CBBA),estado nutricional en menores de 5 anos,clasificacion e,2003-01-01,44,43,44,43,87
30803,TOLATA,estado nutricional en menores de 5 anos,clasificacion e,2003-01-01,4,4,4,4,8
41001,TOLEDO,estado nutricional en menores de 5 anos,clasificacion e,2003-01-01,3,1,3,1,4
51202,TOMAVE,estado nutricional en menores de 5 anos,clasificacion e,2003-01-01,20,17,20,17,37
10402,TOMINA,estado nutricional en menores de 5 anos,clasificacion e,2003-01-01,29,32,29,32,61
50502,TORO TORO,estado nutricional en menores de 5 anos,clasificacion e,2003-01-01,11,16,11,16,27
31201,TOTORA(CBBA),estado nutricional en menores de 5 anos,clasificacion e,2003-01-01,5,6,5,6,11
41301,TOTORA(ORR),estado nutricional en menores de 5 anos,clasificacion e,2003-01-01,0,1,0,1,1
70802,TRIGAL,estado nutricional en menores de 5 anos,clasificacion e,2003-01-01,2,1,2,1,3
80101,TRINIDAD,estado nutricional en menores de 5 anos,clasificacion e,2003-01-01,64,89,64,89,153
50801,TUPIZA,estado nutricional en menores de 5 anos,clasificacion e,2003-01-01,18,86,18,86,104
40402,TURCO,estado nutricional en menores de 5 anos,clasificacion e,2003-01-01,2,0,2,0,2
21302,UMALA,estado nutricional en menores de 5 anos,clasificacion e,2003-01-01,12,0,12,0,12
50201,UNCIA,estado nutricional en menores de 5 anos,clasificacion e,2003-01-01,5,6,5,6,11
60401,URIONDO (A. CONCEPCION),estado nutricional en menores de 5 anos,clasificacion e,2003-01-01,4,0,4,0,4
71502,URUBICHA,estado nutricional en menores de 5 anos,clasificacion e,2003-01-01,4,9,4,9,13
51201,UYUNI,estado nutricional en menores de 5 anos,clasificacion e,2003-01-01,11,6,11,6,17
30502,VACAS,estado nutricional en menores de 5 anos,clasificacion e,2003-01-01,9,7,9,7,16
70801,VALLEGRANDE,estado nutricional en menores de 5 anos,clasificacion e,2003-01-01,13,12,13,12,25
20801,VIACHA,estado nutricional en menores de 5 anos,clasificacion e,2003-01-01,15,20,15,20,35
31302,VILA VILA,estado nutricional en menores de 5 anos,clasificacion e,2003-01-01,8,2,8,2,10
60303,VILLA MONTES,estado nutricional en menores de 5 anos,clasificacion e,2003-01-01,41,17,41,17,58
31402,VILLA RIVERO,estado nutricional en menores de 5 anos,clasificacion e,2003-01-01,11,5,11,5,16
10801,VILLA SERRANO,estado nutricional en menores de 5 anos,clasificacion e,2003-01-01,32,33,32,33,65
31003,VILLA TUNARI,estado nutricional en menores de 5 anos,clasificacion e,2003-01-01,40,42,40,42,82
11001,VILLA VACA GUZMAN (MUYUPAMPA),estado nutricional en menores de 5 anos,clasificacion e,2003-01-01,10,15,10,15,25
51501,VILLAZON,estado nutricional en menores de 5 anos,clasificacion e,2003-01-01,25,22,25,22,47
50602,VITICHI,estado nutricional en menores de 5 anos,clasificacion e,2003-01-01,14,20,14,20,34
70201,WARNES,estado nutricional en menores de 5 anos,clasificacion e,2003-01-01,30,17,30,17,47
20903,YACO,estado nutricional en menores de 5 anos,clasificacion e,2003-01-01,6,9,6,9,15
60301,YACUIBA,estado nutricional en menores de 5 anos,clasificacion e,2003-01-01,40,21,40,21,61
10602,YAMPARAEZ,estado nutricional en menores de 5 anos,clasificacion e,2003-01-01,64,44,64,44,108
21103,YANACACHI,estado nutricional en menores de 5 anos,clasificacion e,2003-01-01,2,2,2,2,4
70403,YAPACANI,estado nutricional en menores de 5 anos,clasificacion e,2003-01-01,39,25,39,25,64
50103,YOCALLA,estado nutricional en menores de 5 anos,clasificacion e,2003-01-01,9,10,9,10,19
10102,YOTALA,estado nutricional en menores de 5 anos,clasificacion e,2003-01-01,16,22,16,22,38
60402,YUNCHARA,estado nutricional en menores de 5 anos,clasificacion e,2003-01-01,1,1,1,1,2
10301,ZUDAÃ‘EZ,estado nutricional en menores de 5 anos,clasificacion e,2003-01-01,30,23,30,23,53
51302,ACACIO,estado nutricional en menores de 5 anos,clasificacion e,2003-02-01,26,25,26,25,51
20201,ACHACACHI,estado nutricional en menores de 5 anos,clasificacion e,2003-02-01,27,18,27,18,45
20104,ACHOCALLA,estado nutricional en menores de 5 anos,clasificacion e,2003-02-01,2,0,2,0,2
30201,AIQUILE,estado nutricional en menores de 5 anos,clasificacion e,2003-02-01,20,14,20,14,34
31303,ALALAY,estado nutricional en menores de 5 anos,clasificacion e,2003-02-01,7,1,7,1,8
10404,ALCALA,estado nutricional en menores de 5 anos,clasificacion e,2003-02-01,12,21,12,21,33
20202,ANCORAIMES,estado nutricional en menores de 5 anos,clasificacion e,2003-02-01,10,15,10,15,25
41201,ANDAMARCA,estado nutricional en menores de 5 anos,clasificacion e,2003-02-01,2,5,2,5,7
40603,ANTEQUERA,estado nutricional en menores de 5 anos,clasificacion e,2003-02-01,0,1,0,1,1
30402,ANZALDO,estado nutricional en menores de 5 anos,clasificacion e,2003-02-01,3,17,3,17,20
20701,APOLO,estado nutricional en menores de 5 anos,clasificacion e,2003-02-01,14,16,14,16,30
51301,ARAMPAMPA,estado nutricional en menores de 5 anos,clasificacion e,2003-02-01,11,22,11,22,33
30501,ARANI,estado nutricional en menores de 5 anos,clasificacion e,2003-02-01,0,2,0,2,2
30403,ARBIETO,estado nutricional en menores de 5 anos,clasificacion e,2003-02-01,1,0,1,0,1
30601,ARQUE,estado nutricional en menores de 5 anos,clasificacion e,2003-02-01,11,6,11,6,17
71501,ASCENCION DE GUARAYOS,estado nutricional en menores de 5 anos,clasificacion e,2003-02-01,85,58,85,58,143
50802,ATOCHA,estado nutricional en menores de 5 anos,clasificacion e,2003-02-01,2,32,2,32,34
20503,AUCAPATA,estado nutricional en menores de 5 anos,clasificacion e,2003-02-01,1,2,1,2,3
20502,AYATA,estado nutricional en menores de 5 anos,clasificacion e,2003-02-01,10,11,10,11,21
30301,AYOPAYA (V. DE INDEPENDENCIA),estado nutricional en menores de 5 anos,clasificacion e,2003-02-01,13,18,13,18,31
10201,AZURDUY,estado nutricional en menores de 5 anos,clasificacion e,2003-02-01,61,56,61,56,117
21203,BATALLAS,estado nutricional en menores de 5 anos,clasificacion e,2003-02-01,4,3,4,3,7
80802,BAURES,estado nutricional en menores de 5 anos,clasificacion e,2003-02-01,6,2,6,2,8
41202,BELEN DE ANDAMARCA,estado nutricional en menores de 5 anos,clasificacion e,2003-02-01,1,0,1,0,1
50104,BELEN DE URMIRI,estado nutricional en menores de 5 anos,clasificacion e,2003-02-01,1,2,1,2,3
60202,BERMEJO,estado nutricional en menores de 5 anos,clasificacion e,2003-02-01,8,1,8,1,9
50301,BETANZOS,estado nutricional en menores de 5 anos,clasificacion e,2003-02-01,69,53,69,53,122
31501,BOLIVAR,estado nutricional en menores de 5 anos,clasificacion e,2003-02-01,14,17,14,17,31
90103,BOLPEBRA,estado nutricional en menores de 5 anos,clasificacion e,2003-02-01,1,1,1,1,2
70707,BOYUIBE,estado nutricional en menores de 5 anos,clasificacion e,2003-02-01,3,0,3,0,3
70401,BUENA VISTA,estado nutricional en menores de 5 anos,clasificacion e,2003-02-01,6,5,6,5,11
70703,CABEZAS,estado nutricional en menores de 5 anos,clasificacion e,2003-02-01,6,7,6,7,13
20905,CAIROMA,estado nutricional en menores de 5 anos,clasificacion e,2003-02-01,20,20,20,20,40
51102,"CAIZA ""D""",estado nutricional en menores de 5 anos,clasificacion e,2003-02-01,23,16,23,16,39
21003,CAJUATA,estado nutricional en menores de 5 anos,clasificacion e,2003-02-01,12,3,12,3,15
20303,CALACOTO,estado nutricional en menores de 5 anos,clasificacion e,2003-02-01,1,1,1,1,2
21304,CALAMARCA,estado nutricional en menores de 5 anos,clasificacion e,2003-02-01,37,22,37,22,59
10701,CAMARGO,estado nutricional en menores de 5 anos,clasificacion e,2003-02-01,14,15,14,15,29
10901,CAMATAQUI (C. VILLA ABECIA),estado nutricional en menores de 5 anos,clasificacion e,2003-02-01,4,2,4,2,6
70706,CAMIRI,estado nutricional en menores de 5 anos,clasificacion e,2003-02-01,50,29,50,29,79
30701,CAPINOTA,estado nutricional en menores de 5 anos,clasificacion e,2003-02-01,14,9,14,9,23
20302,CAQUIAVIRI,estado nutricional en menores de 5 anos,clasificacion e,2003-02-01,5,5,5,5,10
40102,CARACOLLO,estado nutricional en menores de 5 anos,clasificacion e,2003-02-01,6,8,6,8,14
22001,CARANAVI,estado nutricional en menores de 5 anos,clasificacion e,2003-02-01,28,17,28,17,45
41503,CARANGAS,estado nutricional en menores de 5 anos,clasificacion e,2003-02-01,1,0,1,0,1
60302,CARAPARI,estado nutricional en menores de 5 anos,clasificacion e,2003-02-01,11,5,11,5,16
50702,CARIPUYO,estado nutricional en menores de 5 anos,clasificacion e,2003-02-01,27,32,27,32,59
21902,CATACORA,estado nutricional en menores de 5 anos,clasificacion e,2003-02-01,1,0,1,0,1
40201,CHALLAPATA,estado nutricional en menores de 5 anos,clasificacion e,2003-02-01,12,26,12,26,38
50302,CHAQUI,estado nutricional en menores de 5 anos,clasificacion e,2003-02-01,20,7,20,7,27
70702,CHARAGUA,estado nutricional en menores de 5 anos,clasificacion e,2003-02-01,44,37,44,37,81
20305,CHARAÃ‘A,estado nutricional en menores de 5 anos,clasificacion e,2003-02-01,1,0,1,0,1
50202,CHAYANTA,estado nutricional en menores de 5 anos,clasificacion e,2003-02-01,31,17,31,17,48
31204,CHIMORE,estado nutricional en menores de 5 anos,clasificacion e,2003-02-01,4,8,4,8,12
40302,CHOQUE COTA,estado nutricional en menores de 5 anos,clasificacion e,2003-02-01,1,0,1,0,1
21101,CHULUMANI (V. DE LA LIBERTAD),estado nutricional en menores de 5 anos,clasificacion e,2003-02-01,0,2,0,2,2
20501,CHUMA,estado nutricional en menores de 5 anos,clasificacion e,2003-02-01,8,8,8,8,16
30801,CLIZA,estado nutricional en menores de 5 anos,clasificacion e,2003-02-01,11,8,11,8,19
90101,COBIJA,estado nutricional en menores de 5 anos,clasificacion e,2003-02-01,13,5,13,5,18
30101,COCHABAMBA,estado nutricional en menores de 5 anos,clasificacion e,2003-02-01,120,58,120,58,178
30905,COLCAPIRHUA,estado nutricional en menores de 5 anos,clasificacion e,2003-02-01,6,0,6,0,6
50901,"COLCHA ""K""",estado nutricional en menores de 5 anos,clasificacion e,2003-02-01,8,7,8,7,15
21307,COLLANA,estado nutricional en menores de 5 anos,clasificacion e,2003-02-01,0,1,0,1,1
31002,COLOMI,estado nutricional en menores de 5 anos,clasificacion e,2003-02-01,15,5,15,5,20
50401,COLQUECHACA,estado nutricional en menores de 5 anos,clasificacion e,2003-02-01,41,15,41,15,56
21306,COLQUENCHA,estado nutricional en menores de 5 anos,clasificacion e,2003-02-01,3,5,3,5,8
21004,COLQUIRI,estado nutricional en menores de 5 anos,clasificacion e,2003-02-01,8,8,8,8,16
20304,COMANCHE,estado nutricional en menores de 5 anos,clasificacion e,2003-02-01,2,0,2,0,2
71301,COMARAPA,estado nutricional en menores de 5 anos,clasificacion e,2003-02-01,26,18,26,18,44
71101,CONCEPCION,estado nutricional en menores de 5 anos,clasificacion e,2003-02-01,6,4,6,4,10
21701,COPACABANA,estado nutricional en menores de 5 anos,clasificacion e,2003-02-01,5,8,5,8,13
21402,CORIPATA,estado nutricional en menores de 5 anos,clasificacion e,2003-02-01,2,0,2,0,2
20301,CORO CORO,estado nutricional en menores de 5 anos,clasificacion e,2003-02-01,8,5,8,5,13
21401,COROICO,estado nutricional en menores de 5 anos,clasificacion e,2003-02-01,8,3,8,3,11
40301,CORQUE,estado nutricional en menores de 5 anos,clasificacion e,2003-02-01,2,7,2,7,9
50601,COTAGAITA,estado nutricional en menores de 5 anos,clasificacion e,2003-02-01,36,31,36,31,67
70102,COTOCA,estado nutricional en menores de 5 anos,clasificacion e,2003-02-01,9,7,9,7,16
31405,CUCHUMUELA (V. G. VILLARROEL),estado nutricional en menores de 5 anos,clasificacion e,2003-02-01,0,1,0,1,1
70704,CUEVO,estado nutricional en menores de 5 anos,clasificacion e,2003-02-01,5,7,5,7,12
10902,CULPINA,estado nutricional en menores de 5 anos,clasificacion e,2003-02-01,52,47,52,47,99
40401,CURAHUARA DE CARANGAS,estado nutricional en menores de 5 anos,clasificacion e,2003-02-01,1,3,1,3,4
21602,CURVA,estado nutricional en menores de 5 anos,clasificacion e,2003-02-01,8,1,8,1,9
20804,DESAGUADERO,estado nutricional en menores de 5 anos,clasificacion e,2003-02-01,6,4,6,4,10
20105,EL ALTO,estado nutricional en menores de 5 anos,clasificacion e,2003-02-01,326,164,326,164,490
40103,EL CHORO,estado nutricional en menores de 5 anos,clasificacion e,2003-02-01,2,2,2,2,4
71503,EL PUENTE(STC),estado nutricional en menores de 5 anos,clasificacion e,2003-02-01,1,14,1,14,15
60502,EL PUENTE(TJA),estado nutricional en menores de 5 anos,clasificacion e,2003-02-01,16,32,16,32,48
70105,EL TORNO,estado nutricional en menores de 5 anos,clasificacion e,2003-02-01,10,11,10,11,21
10405,EL VILLAR,estado nutricional en menores de 5 anos,clasificacion e,2003-02-01,17,37,17,37,54
60601,ENTRE RIOS,estado nutricional en menores de 5 anos,clasificacion e,2003-02-01,8,5,8,5,13
41101,EUCALIPTUS,estado nutricional en menores de 5 anos,clasificacion e,2003-02-01,9,4,9,4,13
80402,EXALTACION,estado nutricional en menores de 5 anos,clasificacion e,2003-02-01,2,0,2,0,2
71002,GENERAL SAAVEDRA,estado nutricional en menores de 5 anos,clasificacion e,2003-02-01,27,22,27,22,49
21601,GRAL. J.J. PEREZ (CHARAZANI),estado nutricional en menores de 5 anos,clasificacion e,2003-02-01,4,3,4,3,7
20602,GUANAY,estado nutricional en menores de 5 anos,clasificacion e,2003-02-01,13,21,13,21,34
20802,GUAQUI,estado nutricional en menores de 5 anos,clasificacion e,2003-02-01,3,0,3,0,3
80202,GUAYARAMERIN,estado nutricional en menores de 5 anos,clasificacion e,2003-02-01,46,26,46,26,72
70705,GUTIERREZ,estado nutricional en menores de 5 anos,clasificacion e,2003-02-01,55,45,55,45,100
10502,HUACARETA,estado nutricional en menores de 5 anos,clasificacion e,2003-02-01,15,15,15,15,30
11002,HUACAYA (VILLA DE HUACAYA),estado nutricional en menores de 5 anos,clasificacion e,2003-02-01,1,1,1,1,2
40501,HUACHACALLA,estado nutricional en menores de 5 anos,clasificacion e,2003-02-01,1,0,1,0,1
40701,HUANUNI,estado nutricional en menores de 5 anos,clasificacion e,2003-02-01,12,12,12,12,24
80803,HUARACAJE,estado nutricional en menores de 5 anos,clasificacion e,2003-02-01,4,0,4,0,4
41601,HUAYLLAMARCA,estado nutricional en menores de 5 anos,clasificacion e,2003-02-01,0,1,0,1,1
21005,ICHOCA,estado nutricional en menores de 5 anos,clasificacion e,2003-02-01,5,3,5,3,8
10304,ICLA,estado nutricional en menores de 5 anos,clasificacion e,2003-02-01,20,38,20,38,58
10703,INCAHUASI,estado nutricional en menores de 5 anos,clasificacion e,2003-02-01,50,25,50,25,75
21001,INQUISIVI,estado nutricional en menores de 5 anos,clasificacion e,2003-02-01,19,16,19,16,35
21102,IRUPANA (VILLA DE LANZA),estado nutricional en menores de 5 anos,clasificacion e,2003-02-01,0,1,0,1,1
21501,IXIAMAS,estado nutricional en menores de 5 anos,clasificacion e,2003-02-01,5,4,5,4,9
21105,LA ASUNTA,estado nutricional en menores de 5 anos,clasificacion e,2003-02-01,11,11,11,11,22
70104,LA GUARDIA,estado nutricional en menores de 5 anos,clasificacion e,2003-02-01,12,5,12,5,17
20101,LA PAZ,estado nutricional en menores de 5 anos,clasificacion e,2003-02-01,192,120,192,120,312
70701,LAGUNILLAS,estado nutricional en menores de 5 anos,clasificacion e,2003-02-01,8,12,8,12,20
21202,LAJA,estado nutricional en menores de 5 anos,clasificacion e,2003-02-01,2,1,2,1,3
10903,LAS CARRERAS,estado nutricional en menores de 5 anos,clasificacion e,2003-02-01,11,12,11,12,23
21006,LICOMA PAMPA,estado nutricional en menores de 5 anos,clasificacion e,2003-02-01,1,1,1,1,2
50203,LLALLAGUA,estado nutricional en menores de 5 anos,clasificacion e,2003-02-01,5,104,5,104,109
51401,LLICA,estado nutricional en menores de 5 anos,clasificacion e,2003-02-01,3,2,3,2,5
20901,LURIBAY,estado nutricional en menores de 5 anos,clasificacion e,2003-02-01,5,2,5,2,7
40702,MACHACAMARCA,estado nutricional en menores de 5 anos,clasificacion e,2003-02-01,3,0,3,0,3
11003,MACHARETI,estado nutricional en menores de 5 anos,clasificacion e,2003-02-01,19,17,19,17,36
80801,MAGDALENA,estado nutricional en menores de 5 anos,clasificacion e,2003-02-01,5,6,5,6,11
70903,MAIRANA,estado nutricional en menores de 5 anos,clasificacion e,2003-02-01,8,2,8,2,10
20103,MECAPACA,estado nutricional en menores de 5 anos,clasificacion e,2003-02-01,3,0,3,0,3
71003,MINEROS,estado nutricional en menores de 5 anos,clasificacion e,2003-02-01,44,14,44,14,58
31301,MIZQUE,estado nutricional en menores de 5 anos,clasificacion e,2003-02-01,18,19,18,19,37
20402,MOCOMOCO,estado nutricional en menores de 5 anos,clasificacion e,2003-02-01,9,9,9,9,18
10303,MOJOCOYA,estado nutricional en menores de 5 anos,clasificacion e,2003-02-01,14,16,14,16,30
10501,MONTEAGUDO,estado nutricional en menores de 5 anos,clasificacion e,2003-02-01,41,31,41,31,72
71001,MONTERO,estado nutricional en menores de 5 anos,clasificacion e,2003-02-01,85,44,85,44,129
70803,MORO MORO,estado nutricional en menores de 5 anos,clasificacion e,2003-02-01,3,2,3,2,5
30302,MOROCHATA,estado nutricional en menores de 5 anos,clasificacion e,2003-02-01,14,29,14,29,43
90401,NACEBE (SANTA ROSA DEL ABUNA),estado nutricional en menores de 5 anos,clasificacion e,2003-02-01,5,1,5,1,6
50404,OCURI,estado nutricional en menores de 5 anos,clasificacion e,2003-02-01,19,30,19,30,49
70202,OKINAWA,estado nutricional en menores de 5 anos,clasificacion e,2003-02-01,3,2,3,2,5
30203,OMEREQUE,estado nutricional en menores de 5 anos,clasificacion e,2003-02-01,0,1,0,1,1
40101,ORURO,estado nutricional en menores de 5 anos,clasificacion e,2003-02-01,118,86,118,86,204
60201,PADCAYA,estado nutricional en menores de 5 anos,clasificacion e,2003-02-01,9,5,9,5,14
10401,PADILLA,estado nutricional en menores de 5 anos,clasificacion e,2003-02-01,37,65,37,65,102
70502,PAILON,estado nutricional en menores de 5 anos,clasificacion e,2003-02-01,9,4,9,4,13
20102,PALCA,estado nutricional en menores de 5 anos,clasificacion e,2003-02-01,13,9,13,9,22
21104,PALOS BLANCOS,estado nutricional en menores de 5 anos,clasificacion e,2003-02-01,14,14,14,14,28
40802,PAMPA AULLAGAS,estado nutricional en menores de 5 anos,clasificacion e,2003-02-01,5,3,5,3,8
70902,PAMPA GRANDE,estado nutricional en menores de 5 anos,clasificacion e,2003-02-01,2,5,2,5,7
30202,PASORAPA,estado nutricional en menores de 5 anos,clasificacion e,2003-02-01,9,9,9,9,18
21305,PATACAMAYA,estado nutricional en menores de 5 anos,clasificacion e,2003-02-01,37,18,37,18,55
40602,PAZÃ‘A,estado nutricional en menores de 5 anos,clasificacion e,2003-02-01,1,0,1,0,1
20702,PELECHUCO,estado nutricional en menores de 5 anos,clasificacion e,2003-02-01,7,4,7,4,11
50403,POCOATA,estado nutricional en menores de 5 anos,clasificacion e,2003-02-01,35,44,35,44,79
31203,POCONA,estado nutricional en menores de 5 anos,clasificacion e,2003-02-01,16,7,16,7,23
31202,POJO (CBBA),estado nutricional en menores de 5 anos,clasificacion e,2003-02-01,28,14,28,14,42
40601,POOPO,estado nutricional en menores de 5 anos,clasificacion e,2003-02-01,1,2,1,2,3
51203,PORCO,estado nutricional en menores de 5 anos,clasificacion e,2003-02-01,4,4,4,4,8
10103,POROMA,estado nutricional en menores de 5 anos,clasificacion e,2003-02-01,54,58,54,58,112
70601,PORTACHUELO,estado nutricional en menores de 5 anos,clasificacion e,2003-02-01,7,6,7,6,13
90102,PORVENIR,estado nutricional en menores de 5 anos,clasificacion e,2003-02-01,2,2,2,2,4
70804,POSTRER VALLE,estado nutricional en menores de 5 anos,clasificacion e,2003-02-01,7,3,7,3,10
50101,POTOSI,estado nutricional en menores de 5 anos,clasificacion e,2003-02-01,125,87,125,87,212
10302,PRESTO,estado nutricional en menores de 5 anos,clasificacion e,2003-02-01,24,23,24,23,47
21201,PUCARANI,estado nutricional en menores de 5 anos,clasificacion e,2003-02-01,4,1,4,1,5
20401,PUERTO ACOSTA,estado nutricional en menores de 5 anos,clasificacion e,2003-02-01,22,19,22,19,41
20403,PUERTO CARABUCO,estado nutricional en menores de 5 anos,clasificacion e,2003-02-01,19,19,19,19,38
90301,PUERTO GONZALO MORENO,estado nutricional en menores de 5 anos,clasificacion e,2003-02-01,4,0,4,0,4
21204,PUERTO PEREZ,estado nutricional en menores de 5 anos,clasificacion e,2003-02-01,1,1,1,1,2
71402,PUERTO QUIJARRO,estado nutricional en menores de 5 anos,clasificacion e,2003-02-01,15,1,15,1,16
90201,PUERTO RICO,estado nutricional en menores de 5 anos,clasificacion e,2003-02-01,1,1,1,1,2
71401,PUERTO SUAREZ,estado nutricional en menores de 5 anos,clasificacion e,2003-02-01,17,9,17,9,26
31205,PUERTO VILLARROEL,estado nutricional en menores de 5 anos,clasificacion e,2003-02-01,68,29,68,29,97
51101,PUNA,estado nutricional en menores de 5 anos,clasificacion e,2003-02-01,22,18,22,18,40
31401,PUNATA,estado nutricional en menores de 5 anos,clasificacion e,2003-02-01,21,6,21,6,27
30901,QUILLACOLLO,estado nutricional en menores de 5 anos,clasificacion e,2003-02-01,8,16,8,16,24
21002,QUIME,estado nutricional en menores de 5 anos,clasificacion e,2003-02-01,17,15,17,15,32
50402,RAVELO,estado nutricional en menores de 5 anos,clasificacion e,2003-02-01,89,71,89,71,160
80301,REYES,estado nutricional en menores de 5 anos,clasificacion e,2003-02-01,13,14,13,14,27
80201,RIBERALTA,estado nutricional en menores de 5 anos,clasificacion e,2003-02-01,55,42,55,42,97
70503,ROBORE,estado nutricional en menores de 5 anos,clasificacion e,2003-02-01,13,14,13,14,27
40901,SABAYA,estado nutricional en menores de 5 anos,clasificacion e,2003-02-01,0,3,0,3,3
31001,SACABA,estado nutricional en menores de 5 anos,clasificacion e,2003-02-01,46,21,46,21,67
30404,SACABAMBA,estado nutricional en menores de 5 anos,clasificacion e,2003-02-01,6,17,6,17,23
50701,SACACA,estado nutricional en menores de 5 anos,clasificacion e,2003-02-01,62,91,62,91,153
71302,SAIPINA,estado nutricional en menores de 5 anos,clasificacion e,2003-02-01,3,5,3,5,8
40801,SALINAS DE GARCI MENDOZA,estado nutricional en menores de 5 anos,clasificacion e,2003-02-01,4,2,4,2,6
70901,SAMAIPATA,estado nutricional en menores de 5 anos,clasificacion e,2003-02-01,5,2,5,2,7
80602,SAN ANDRES,estado nutricional en menores de 5 anos,clasificacion e,2003-02-01,2,4,2,4,6
51003,SAN ANTONIO DE ESMORUCO,estado nutricional en menores de 5 anos,clasificacion e,2003-02-01,0,2,0,2,2
71105,SAN ANTONIO DE LOMERIO,estado nutricional en menores de 5 anos,clasificacion e,2003-02-01,43,52,43,52,95
31403,SAN BENITO,estado nutricional en menores de 5 anos,clasificacion e,2003-02-01,12,4,12,4,16
80302,SAN BORJA,estado nutricional en menores de 5 anos,clasificacion e,2003-02-01,33,10,33,10,43
21502,SAN BUENA VENTURA,estado nutricional en menores de 5 anos,clasificacion e,2003-02-01,10,7,10,7,17
70402,SAN CARLOS,estado nutricional en menores de 5 anos,clasificacion e,2003-02-01,15,12,15,12,27
80501,SAN IGNACIO,estado nutricional en menores de 5 anos,clasificacion e,2003-02-01,23,19,23,19,42
70301,SAN IGNACIO DE VELASCO,estado nutricional en menores de 5 anos,clasificacion e,2003-02-01,79,40,79,40,119
80102,SAN JAVIER(BNI),estado nutricional en menores de 5 anos,clasificacion e,2003-02-01,1,1,1,1,2
71102,SAN JAVIER(STC),estado nutricional en menores de 5 anos,clasificacion e,2003-02-01,6,4,6,4,10
80701,SAN JOAQUIN,estado nutricional en menores de 5 anos,clasificacion e,2003-02-01,4,1,4,1,5
70501,SAN JOSE DE CHIQUITOS,estado nutricional en menores de 5 anos,clasificacion e,2003-02-01,15,5,15,5,20
71104,SAN JULIAN,estado nutricional en menores de 5 anos,clasificacion e,2003-02-01,81,55,81,55,136
90302,SAN LORENZO(PND),estado nutricional en menores de 5 anos,clasificacion e,2003-02-01,3,7,3,7,10
60501,SAN LORENZO(TJA),estado nutricional en menores de 5 anos,clasificacion e,2003-02-01,11,9,11,9,20
10702,SAN LUCAS,estado nutricional en menores de 5 anos,clasificacion e,2003-02-01,126,99,126,99,225
71201,SAN MATIAS,estado nutricional en menores de 5 anos,clasificacion e,2003-02-01,9,6,9,6,15
70302,SAN MIGUEL DE VELASCO,estado nutricional en menores de 5 anos,clasificacion e,2003-02-01,21,24,21,24,45
51001,SAN PABLO DE LIPEZ,estado nutricional en menores de 5 anos,clasificacion e,2003-02-01,1,3,1,3,4
50501,SAN PEDRO DE BUENA VISTA,estado nutricional en menores de 5 anos,clasificacion e,2003-02-01,36,39,36,39,75
21801,SAN PEDRO DE CURAHUARA,estado nutricional en menores de 5 anos,clasificacion e,2003-02-01,1,1,1,1,2
50902,SAN PEDRO DE QUEMES,estado nutricional en menores de 5 anos,clasificacion e,2003-02-01,1,0,1,0,1
70303,SAN RAFAEL,estado nutricional en menores de 5 anos,clasificacion e,2003-02-01,7,10,7,10,17
80702,SAN RAMON,estado nutricional en menores de 5 anos,clasificacion e,2003-02-01,1,1,1,1,2
70101,SANTA CRUZ DE LA SIERRA,estado nutricional en menores de 5 anos,clasificacion e,2003-02-01,152,55,152,55,207
70602,SANTA ROSA DEL SARA,estado nutricional en menores de 5 anos,clasificacion e,2003-02-01,4,4,4,4,8
41401,SANTIAGO DE HUARI,estado nutricional en menores de 5 anos,clasificacion e,2003-02-01,2,4,2,4,6
21901,SANTIAGO DE MACHACA,estado nutricional en menores de 5 anos,clasificacion e,2003-02-01,1,0,1,0,1
30702,SANTIVAÃ‘ES,estado nutricional en menores de 5 anos,clasificacion e,2003-02-01,8,7,8,7,15
40202,SANTUARIO DE QUILLACAS,estado nutricional en menores de 5 anos,clasificacion e,2003-02-01,4,2,4,2,6
20902,SAPAHAQUI,estado nutricional en menores de 5 anos,clasificacion e,2003-02-01,8,3,8,3,11
90303,SENA,estado nutricional en menores de 5 anos,clasificacion e,2003-02-01,3,2,3,2,5
21301,SICA SICA (VILLA AROMA),estado nutricional en menores de 5 anos,clasificacion e,2003-02-01,8,7,8,7,15
30703,SICAYA,estado nutricional en menores de 5 anos,clasificacion e,2003-02-01,1,1,1,1,2
30902,SIPE SIPE,estado nutricional en menores de 5 anos,clasificacion e,2003-02-01,35,10,35,10,45
10403,SOPACHUY,estado nutricional en menores de 5 anos,clasificacion e,2003-02-01,23,27,23,27,50
20601,SORATA,estado nutricional en menores de 5 anos,clasificacion e,2003-02-01,9,8,9,8,17
10101,SUCRE,estado nutricional en menores de 5 anos,clasificacion e,2003-02-01,130,129,130,129,259
31404,TACACHI,estado nutricional en menores de 5 anos,clasificacion e,2003-02-01,1,0,1,0,1
50303,TACOBAMBA,estado nutricional en menores de 5 anos,clasificacion e,2003-02-01,11,12,11,12,23
30602,TACOPAYA,estado nutricional en menores de 5 anos,clasificacion e,2003-02-01,16,17,16,17,33
51402,TAHUA,estado nutricional en menores de 5 anos,clasificacion e,2003-02-01,0,1,0,1,1
31101,TAPACARI,estado nutricional en menores de 5 anos,clasificacion e,2003-02-01,15,25,15,25,40
10601,TARABUCO,estado nutricional en menores de 5 anos,clasificacion e,2003-02-01,105,123,105,123,228
30401,TARATA,estado nutricional en menores de 5 anos,clasificacion e,2003-02-01,7,1,7,1,8
60101,TARIJA,estado nutricional en menores de 5 anos,clasificacion e,2003-02-01,81,36,81,36,117
10202,TARVITA,estado nutricional en menores de 5 anos,clasificacion e,2003-02-01,35,53,35,53,88
20803,TIAWANACU,estado nutricional en menores de 5 anos,clasificacion e,2003-02-01,8,0,8,0,8
50102,TINGUIPAYA,estado nutricional en menores de 5 anos,clasificacion e,2003-02-01,4,5,4,5,9
20606,TIPUANI,estado nutricional en menores de 5 anos,clasificacion e,2003-02-01,2,0,2,0,2
30903,TIQUIPAYA,estado nutricional en menores de 5 anos,clasificacion e,2003-02-01,1,7,1,7,8
31601,TIRAQUE (CBBA),estado nutricional en menores de 5 anos,clasificacion e,2003-02-01,34,26,34,26,60
30802,TOCO,estado nutricional en menores de 5 anos,clasificacion e,2003-02-01,0,2,0,2,2
30803,TOLATA,estado nutricional en menores de 5 anos,clasificacion e,2003-02-01,2,2,2,2,4
41001,TOLEDO,estado nutricional en menores de 5 anos,clasificacion e,2003-02-01,2,0,2,0,2
51202,TOMAVE,estado nutricional en menores de 5 anos,clasificacion e,2003-02-01,15,24,15,24,39
10402,TOMINA,estado nutricional en menores de 5 anos,clasificacion e,2003-02-01,40,36,40,36,76
50502,TORO TORO,estado nutricional en menores de 5 anos,clasificacion e,2003-02-01,25,22,25,22,47
31201,TOTORA(CBBA),estado nutricional en menores de 5 anos,clasificacion e,2003-02-01,4,4,4,4,8
41301,TOTORA(ORR),estado nutricional en menores de 5 anos,clasificacion e,2003-02-01,7,8,7,8,15
70802,TRIGAL,estado nutricional en menores de 5 anos,clasificacion e,2003-02-01,3,0,3,0,3
80101,TRINIDAD,estado nutricional en menores de 5 anos,clasificacion e,2003-02-01,30,56,30,56,86
50801,TUPIZA,estado nutricional en menores de 5 anos,clasificacion e,2003-02-01,24,108,24,108,132
40402,TURCO,estado nutricional en menores de 5 anos,clasificacion e,2003-02-01,0,2,0,2,2
21302,UMALA,estado nutricional en menores de 5 anos,clasificacion e,2003-02-01,3,4,3,4,7
50201,UNCIA,estado nutricional en menores de 5 anos,clasificacion e,2003-02-01,2,3,2,3,5
60401,URIONDO (A. CONCEPCION),estado nutricional en menores de 5 anos,clasificacion e,2003-02-01,6,0,6,0,6
71502,URUBICHA,estado nutricional en menores de 5 anos,clasificacion e,2003-02-01,13,18,13,18,31
51201,UYUNI,estado nutricional en menores de 5 anos,clasificacion e,2003-02-01,13,12,13,12,25
30502,VACAS,estado nutricional en menores de 5 anos,clasificacion e,2003-02-01,5,1,5,1,6
70801,VALLEGRANDE,estado nutricional en menores de 5 anos,clasificacion e,2003-02-01,20,15,20,15,35
20801,VIACHA,estado nutricional en menores de 5 anos,clasificacion e,2003-02-01,11,26,11,26,37
31302,VILA VILA,estado nutricional en menores de 5 anos,clasificacion e,2003-02-01,5,10,5,10,15
60303,VILLA MONTES,estado nutricional en menores de 5 anos,clasificacion e,2003-02-01,45,18,45,18,63
31402,VILLA RIVERO,estado nutricional en menores de 5 anos,clasificacion e,2003-02-01,10,2,10,2,12
10801,VILLA SERRANO,estado nutricional en menores de 5 anos,clasificacion e,2003-02-01,34,37,34,37,71
31003,VILLA TUNARI,estado nutricional en menores de 5 anos,clasificacion e,2003-02-01,31,20,31,20,51
11001,VILLA VACA GUZMAN (MUYUPAMPA),estado nutricional en menores de 5 anos,clasificacion e,2003-02-01,22,20,22,20,42
51501,VILLAZON,estado nutricional en menores de 5 anos,clasificacion e,2003-02-01,26,29,26,29,55
50602,VITICHI,estado nutricional en menores de 5 anos,clasificacion e,2003-02-01,24,28,24,28,52
20306,WALDO BALLIVIAN,estado nutricional en menores de 5 anos,clasificacion e,2003-02-01,1,0,1,0,1
70201,WARNES,estado nutricional en menores de 5 anos,clasificacion e,2003-02-01,27,15,27,15,42
20903,YACO,estado nutricional en menores de 5 anos,clasificacion e,2003-02-01,19,27,19,27,46
60301,YACUIBA,estado nutricional en menores de 5 anos,clasificacion e,2003-02-01,34,24,34,24,58
10602,YAMPARAEZ,estado nutricional en menores de 5 anos,clasificacion e,2003-02-01,76,49,76,49,125
21103,YANACACHI,estado nutricional en menores de 5 anos,clasificacion e,2003-02-01,4,2,4,2,6
70403,YAPACANI,estado nutricional en menores de 5 anos,clasificacion e,2003-02-01,32,25,32,25,57
50103,YOCALLA,estado nutricional en menores de 5 anos,clasificacion e,2003-02-01,6,2,6,2,8
10102,YOTALA,estado nutricional en menores de 5 anos,clasificacion e,2003-02-01,23,38,23,38,61
60402,YUNCHARA,estado nutricional en menores de 5 anos,clasificacion e,2003-02-01,3,8,3,8,11
10301,ZUDAÃ‘EZ,estado nutricional en menores de 5 anos,clasificacion e,2003-02-01,22,27,22,27,49
51302,ACACIO,estado nutricional en menores de 5 anos,clasificacion e,2003-03-01,33,32,33,32,65
20201,ACHACACHI,estado nutricional en menores de 5 anos,clasificacion e,2003-03-01,11,13,11,13,24
20104,ACHOCALLA,estado nutricional en menores de 5 anos,clasificacion e,2003-03-01,2,2,2,2,4
30201,AIQUILE,estado nutricional en menores de 5 anos,clasificacion e,2003-03-01,13,15,13,15,28
31303,ALALAY,estado nutricional en menores de 5 anos,clasificacion e,2003-03-01,2,2,2,2,4
10404,ALCALA,estado nutricional en menores de 5 anos,clasificacion e,2003-03-01,14,19,14,19,33
20202,ANCORAIMES,estado nutricional en menores de 5 anos,clasificacion e,2003-03-01,12,13,12,13,25
41201,ANDAMARCA,estado nutricional en menores de 5 anos,clasificacion e,2003-03-01,2,10,2,10,12
40603,ANTEQUERA,estado nutricional en menores de 5 anos,clasificacion e,2003-03-01,0,1,0,1,1
30402,ANZALDO,estado nutricional en menores de 5 anos,clasificacion e,2003-03-01,2,13,2,13,15
20701,APOLO,estado nutricional en menores de 5 anos,clasificacion e,2003-03-01,6,5,6,5,11
51301,ARAMPAMPA,estado nutricional en menores de 5 anos,clasificacion e,2003-03-01,9,18,9,18,27
30501,ARANI,estado nutricional en menores de 5 anos,clasificacion e,2003-03-01,0,10,0,10,10
30403,ARBIETO,estado nutricional en menores de 5 anos,clasificacion e,2003-03-01,2,5,2,5,7
30601,ARQUE,estado nutricional en menores de 5 anos,clasificacion e,2003-03-01,25,29,25,29,54
71501,ASCENCION DE GUARAYOS,estado nutricional en menores de 5 anos,clasificacion e,2003-03-01,1,2,1,2,3
50802,ATOCHA,estado nutricional en menores de 5 anos,clasificacion e,2003-03-01,2,49,2,49,51
20503,AUCAPATA,estado nutricional en menores de 5 anos,clasificacion e,2003-03-01,7,6,7,6,13
20502,AYATA,estado nutricional en menores de 5 anos,clasificacion e,2003-03-01,13,7,13,7,20
30301,AYOPAYA (V. DE INDEPENDENCIA),estado nutricional en menores de 5 anos,clasificacion e,2003-03-01,16,20,16,20,36
10201,AZURDUY,estado nutricional en menores de 5 anos,clasificacion e,2003-03-01,51,33,51,33,84
21203,BATALLAS,estado nutricional en menores de 5 anos,clasificacion e,2003-03-01,4,1,4,1,5
80802,BAURES,estado nutricional en menores de 5 anos,clasificacion e,2003-03-01,5,8,5,8,13
41202,BELEN DE ANDAMARCA,estado nutricional en menores de 5 anos,clasificacion e,2003-03-01,0,2,0,2,2
50104,BELEN DE URMIRI,estado nutricional en menores de 5 anos,clasificacion e,2003-03-01,0,3,0,3,3
90104,BELLA FLOR,estado nutricional en menores de 5 anos,clasificacion e,2003-03-01,1,2,1,2,3
60202,BERMEJO,estado nutricional en menores de 5 anos,clasificacion e,2003-03-01,0,1,0,1,1
50301,BETANZOS,estado nutricional en menores de 5 anos,clasificacion e,2003-03-01,124,88,124,88,212
31501,BOLIVAR,estado nutricional en menores de 5 anos,clasificacion e,2003-03-01,20,11,20,11,31
90103,BOLPEBRA,estado nutricional en menores de 5 anos,clasificacion e,2003-03-01,1,0,1,0,1
70707,BOYUIBE,estado nutricional en menores de 5 anos,clasificacion e,2003-03-01,2,0,2,0,2
70401,BUENA VISTA,estado nutricional en menores de 5 anos,clasificacion e,2003-03-01,5,10,5,10,15
70703,CABEZAS,estado nutricional en menores de 5 anos,clasificacion e,2003-03-01,0,1,0,1,1
20905,CAIROMA,estado nutricional en menores de 5 anos,clasificacion e,2003-03-01,7,4,7,4,11
51102,"CAIZA ""D""",estado nutricional en menores de 5 anos,clasificacion e,2003-03-01,40,31,40,31,71
21003,CAJUATA,estado nutricional en menores de 5 anos,clasificacion e,2003-03-01,7,4,7,4,11
20303,CALACOTO,estado nutricional en menores de 5 anos,clasificacion e,2003-03-01,1,1,1,1,2
21304,CALAMARCA,estado nutricional en menores de 5 anos,clasificacion e,2003-03-01,29,24,29,24,53
10701,CAMARGO,estado nutricional en menores de 5 anos,clasificacion e,2003-03-01,18,18,18,18,36
10901,CAMATAQUI (C. VILLA ABECIA),estado nutricional en menores de 5 anos,clasificacion e,2003-03-01,1,0,1,0,1
70706,CAMIRI,estado nutricional en menores de 5 anos,clasificacion e,2003-03-01,40,21,40,21,61
30701,CAPINOTA,estado nutricional en menores de 5 anos,clasificacion e,2003-03-01,16,31,16,31,47
20302,CAQUIAVIRI,estado nutricional en menores de 5 anos,clasificacion e,2003-03-01,6,2,6,2,8
40102,CARACOLLO,estado nutricional en menores de 5 anos,clasificacion e,2003-03-01,5,3,5,3,8
22001,CARANAVI,estado nutricional en menores de 5 anos,clasificacion e,2003-03-01,33,40,33,40,73
60302,CARAPARI,estado nutricional en menores de 5 anos,clasificacion e,2003-03-01,9,8,9,8,17
50702,CARIPUYO,estado nutricional en menores de 5 anos,clasificacion e,2003-03-01,18,18,18,18,36
40201,CHALLAPATA,estado nutricional en menores de 5 anos,clasificacion e,2003-03-01,25,19,25,19,44
50302,CHAQUI,estado nutricional en menores de 5 anos,clasificacion e,2003-03-01,27,10,27,10,37
70702,CHARAGUA,estado nutricional en menores de 5 anos,clasificacion e,2003-03-01,59,29,59,29,88
20305,CHARAÃ‘A,estado nutricional en menores de 5 anos,clasificacion e,2003-03-01,0,2,0,2,2
50202,CHAYANTA,estado nutricional en menores de 5 anos,clasificacion e,2003-03-01,15,13,15,13,28
31204,CHIMORE,estado nutricional en menores de 5 anos,clasificacion e,2003-03-01,10,2,10,2,12
21101,CHULUMANI (V. DE LA LIBERTAD),estado nutricional en menores de 5 anos,clasificacion e,2003-03-01,5,13,5,13,18
20501,CHUMA,estado nutricional en menores de 5 anos,clasificacion e,2003-03-01,7,7,7,7,14
30801,CLIZA,estado nutricional en menores de 5 anos,clasificacion e,2003-03-01,2,2,2,2,4
90101,COBIJA,estado nutricional en menores de 5 anos,clasificacion e,2003-03-01,10,10,10,10,20
30101,COCHABAMBA,estado nutricional en menores de 5 anos,clasificacion e,2003-03-01,90,55,90,55,145
30905,COLCAPIRHUA,estado nutricional en menores de 5 anos,clasificacion e,2003-03-01,2,3,2,3,5
50901,"COLCHA ""K""",estado nutricional en menores de 5 anos,clasificacion e,2003-03-01,11,9,11,9,20
21307,COLLANA,estado nutricional en menores de 5 anos,clasificacion e,2003-03-01,1,2,1,2,3
31002,COLOMI,estado nutricional en menores de 5 anos,clasificacion e,2003-03-01,12,15,12,15,27
50401,COLQUECHACA,estado nutricional en menores de 5 anos,clasificacion e,2003-03-01,54,13,54,13,67
21306,COLQUENCHA,estado nutricional en menores de 5 anos,clasificacion e,2003-03-01,4,2,4,2,6
21004,COLQUIRI,estado nutricional en menores de 5 anos,clasificacion e,2003-03-01,17,17,17,17,34
20304,COMANCHE,estado nutricional en menores de 5 anos,clasificacion e,2003-03-01,1,0,1,0,1
71301,COMARAPA,estado nutricional en menores de 5 anos,clasificacion e,2003-03-01,18,16,18,16,34
71101,CONCEPCION,estado nutricional en menores de 5 anos,clasificacion e,2003-03-01,5,2,5,2,7
21701,COPACABANA,estado nutricional en menores de 5 anos,clasificacion e,2003-03-01,1,0,1,0,1
21402,CORIPATA,estado nutricional en menores de 5 anos,clasificacion e,2003-03-01,0,1,0,1,1
20301,CORO CORO,estado nutricional en menores de 5 anos,clasificacion e,2003-03-01,11,5,11,5,16
21401,COROICO,estado nutricional en menores de 5 anos,clasificacion e,2003-03-01,27,3,27,3,30
40301,CORQUE,estado nutricional en menores de 5 anos,clasificacion e,2003-03-01,8,7,8,7,15
50601,COTAGAITA,estado nutricional en menores de 5 anos,clasificacion e,2003-03-01,17,22,17,22,39
70102,COTOCA,estado nutricional en menores de 5 anos,clasificacion e,2003-03-01,3,6,3,6,9
31405,CUCHUMUELA (V. G. VILLARROEL),estado nutricional en menores de 5 anos,clasificacion e,2003-03-01,1,0,1,0,1
70704,CUEVO,estado nutricional en menores de 5 anos,clasificacion e,2003-03-01,2,1,2,1,3
10902,CULPINA,estado nutricional en menores de 5 anos,clasificacion e,2003-03-01,44,39,44,39,83
40401,CURAHUARA DE CARANGAS,estado nutricional en menores de 5 anos,clasificacion e,2003-03-01,9,4,9,4,13
21602,CURVA,estado nutricional en menores de 5 anos,clasificacion e,2003-03-01,0,2,0,2,2
20804,DESAGUADERO,estado nutricional en menores de 5 anos,clasificacion e,2003-03-01,2,0,2,0,2
20105,EL ALTO,estado nutricional en menores de 5 anos,clasificacion e,2003-03-01,334,169,334,169,503
40103,EL CHORO,estado nutricional en menores de 5 anos,clasificacion e,2003-03-01,2,5,2,5,7
71503,EL PUENTE(STC),estado nutricional en menores de 5 anos,clasificacion e,2003-03-01,3,35,3,35,38
60502,EL PUENTE(TJA),estado nutricional en menores de 5 anos,clasificacion e,2003-03-01,10,5,10,5,15
70105,EL TORNO,estado nutricional en menores de 5 anos,clasificacion e,2003-03-01,21,17,21,17,38
10405,EL VILLAR,estado nutricional en menores de 5 anos,clasificacion e,2003-03-01,15,32,15,32,47
60601,ENTRE RIOS,estado nutricional en menores de 5 anos,clasificacion e,2003-03-01,5,2,5,2,7
40502,ESCARA,estado nutricional en menores de 5 anos,clasificacion e,2003-03-01,0,1,0,1,1
41101,EUCALIPTUS,estado nutricional en menores de 5 anos,clasificacion e,2003-03-01,2,1,2,1,3
80402,EXALTACION,estado nutricional en menores de 5 anos,clasificacion e,2003-03-01,0,7,0,7,7
71002,GENERAL SAAVEDRA,estado nutricional en menores de 5 anos,clasificacion e,2003-03-01,37,19,37,19,56
21601,GRAL. J.J. PEREZ (CHARAZANI),estado nutricional en menores de 5 anos,clasificacion e,2003-03-01,1,4,1,4,5
20602,GUANAY,estado nutricional en menores de 5 anos,clasificacion e,2003-03-01,32,17,32,17,49
20802,GUAQUI,estado nutricional en menores de 5 anos,clasificacion e,2003-03-01,1,2,1,2,3
80202,GUAYARAMERIN,estado nutricional en menores de 5 anos,clasificacion e,2003-03-01,45,27,45,27,72
70705,GUTIERREZ,estado nutricional en menores de 5 anos,clasificacion e,2003-03-01,50,44,50,44,94
10502,HUACARETA,estado nutricional en menores de 5 anos,clasificacion e,2003-03-01,11,21,11,21,32
11002,HUACAYA (VILLA DE HUACAYA),estado nutricional en menores de 5 anos,clasificacion e,2003-03-01,0,1,0,1,1
40701,HUANUNI,estado nutricional en menores de 5 anos,clasificacion e,2003-03-01,36,12,36,12,48
80803,HUARACAJE,estado nutricional en menores de 5 anos,clasificacion e,2003-03-01,1,0,1,0,1
21005,ICHOCA,estado nutricional en menores de 5 anos,clasificacion e,2003-03-01,2,4,2,4,6
10304,ICLA,estado nutricional en menores de 5 anos,clasificacion e,2003-03-01,39,52,39,52,91
10703,INCAHUASI,estado nutricional en menores de 5 anos,clasificacion e,2003-03-01,31,19,31,19,50
21001,INQUISIVI,estado nutricional en menores de 5 anos,clasificacion e,2003-03-01,23,17,23,17,40
21102,IRUPANA (VILLA DE LANZA),estado nutricional en menores de 5 anos,clasificacion e,2003-03-01,1,5,1,5,6
21501,IXIAMAS,estado nutricional en menores de 5 anos,clasificacion e,2003-03-01,9,9,9,9,18
21105,LA ASUNTA,estado nutricional en menores de 5 anos,clasificacion e,2003-03-01,15,13,15,13,28
70104,LA GUARDIA,estado nutricional en menores de 5 anos,clasificacion e,2003-03-01,12,5,12,5,17
20101,LA PAZ,estado nutricional en menores de 5 anos,clasificacion e,2003-03-01,183,149,183,149,332
70701,LAGUNILLAS,estado nutricional en menores de 5 anos,clasificacion e,2003-03-01,11,11,11,11,22
21202,LAJA,estado nutricional en menores de 5 anos,clasificacion e,2003-03-01,2,0,2,0,2
10903,LAS CARRERAS,estado nutricional en menores de 5 anos,clasificacion e,2003-03-01,6,16,6,16,22
21006,LICOMA PAMPA,estado nutricional en menores de 5 anos,clasificacion e,2003-03-01,4,0,4,0,4
50203,LLALLAGUA,estado nutricional en menores de 5 anos,clasificacion e,2003-03-01,8,50,8,50,58
51401,LLICA,estado nutricional en menores de 5 anos,clasificacion e,2003-03-01,2,6,2,6,8
80601,LORETO,estado nutricional en menores de 5 anos,clasificacion e,2003-03-01,1,0,1,0,1
20901,LURIBAY,estado nutricional en menores de 5 anos,clasificacion e,2003-03-01,5,2,5,2,7
40702,MACHACAMARCA,estado nutricional en menores de 5 anos,clasificacion e,2003-03-01,11,3,11,3,14
11003,MACHARETI,estado nutricional en menores de 5 anos,clasificacion e,2003-03-01,7,15,7,15,22
80801,MAGDALENA,estado nutricional en menores de 5 anos,clasificacion e,2003-03-01,3,6,3,6,9
70903,MAIRANA,estado nutricional en menores de 5 anos,clasificacion e,2003-03-01,5,6,5,6,11
20904,MALLA,estado nutricional en menores de 5 anos,clasificacion e,2003-03-01,4,4,4,4,8
20103,MECAPACA,estado nutricional en menores de 5 anos,clasificacion e,2003-03-01,2,3,2,3,5
71003,MINEROS,estado nutricional en menores de 5 anos,clasificacion e,2003-03-01,52,16,52,16,68
31301,MIZQUE,estado nutricional en menores de 5 anos,clasificacion e,2003-03-01,29,11,29,11,40
20402,MOCOMOCO,estado nutricional en menores de 5 anos,clasificacion e,2003-03-01,17,8,17,8,25
51002,MOJINETE,estado nutricional en menores de 5 anos,clasificacion e,2003-03-01,0,2,0,2,2
10303,MOJOCOYA,estado nutricional en menores de 5 anos,clasificacion e,2003-03-01,11,10,11,10,21
10501,MONTEAGUDO,estado nutricional en menores de 5 anos,clasificacion e,2003-03-01,32,28,32,28,60
71001,MONTERO,estado nutricional en menores de 5 anos,clasificacion e,2003-03-01,76,49,76,49,125
70803,MORO MORO,estado nutricional en menores de 5 anos,clasificacion e,2003-03-01,5,7,5,7,12
30302,MOROCHATA,estado nutricional en menores de 5 anos,clasificacion e,2003-03-01,30,31,30,31,61
90401,NACEBE (SANTA ROSA DEL ABUNA),estado nutricional en menores de 5 anos,clasificacion e,2003-03-01,2,0,2,0,2
50404,OCURI,estado nutricional en menores de 5 anos,clasificacion e,2003-03-01,23,40,23,40,63
70202,OKINAWA,estado nutricional en menores de 5 anos,clasificacion e,2003-03-01,4,6,4,6,10
40101,ORURO,estado nutricional en menores de 5 anos,clasificacion e,2003-03-01,108,69,108,69,177
60201,PADCAYA,estado nutricional en menores de 5 anos,clasificacion e,2003-03-01,14,15,14,15,29
10401,PADILLA,estado nutricional en menores de 5 anos,clasificacion e,2003-03-01,37,35,37,35,72
70502,PAILON,estado nutricional en menores de 5 anos,clasificacion e,2003-03-01,9,2,9,2,11
20102,PALCA,estado nutricional en menores de 5 anos,clasificacion e,2003-03-01,7,8,7,8,15
21104,PALOS BLANCOS,estado nutricional en menores de 5 anos,clasificacion e,2003-03-01,14,16,14,16,30
40802,PAMPA AULLAGAS,estado nutricional en menores de 5 anos,clasificacion e,2003-03-01,6,7,6,7,13
70902,PAMPA GRANDE,estado nutricional en menores de 5 anos,clasificacion e,2003-03-01,5,4,5,4,9
21802,PAPEL PAMPA,estado nutricional en menores de 5 anos,clasificacion e,2003-03-01,1,0,1,0,1
30202,PASORAPA,estado nutricional en menores de 5 anos,clasificacion e,2003-03-01,8,4,8,4,12
21305,PATACAMAYA,estado nutricional en menores de 5 anos,clasificacion e,2003-03-01,22,10,22,10,32
40602,PAZÃ‘A,estado nutricional en menores de 5 anos,clasificacion e,2003-03-01,1,7,1,7,8
20702,PELECHUCO,estado nutricional en menores de 5 anos,clasificacion e,2003-03-01,3,2,3,2,5
50403,POCOATA,estado nutricional en menores de 5 anos,clasificacion e,2003-03-01,24,29,24,29,53
31203,POCONA,estado nutricional en menores de 5 anos,clasificacion e,2003-03-01,17,13,17,13,30
31202,POJO (CBBA),estado nutricional en menores de 5 anos,clasificacion e,2003-03-01,18,14,18,14,32
40601,POOPO,estado nutricional en menores de 5 anos,clasificacion e,2003-03-01,0,1,0,1,1
51203,PORCO,estado nutricional en menores de 5 anos,clasificacion e,2003-03-01,5,4,5,4,9
10103,POROMA,estado nutricional en menores de 5 anos,clasificacion e,2003-03-01,50,57,50,57,107
70601,PORTACHUELO,estado nutricional en menores de 5 anos,clasificacion e,2003-03-01,5,7,5,7,12
90102,PORVENIR,estado nutricional en menores de 5 anos,clasificacion e,2003-03-01,0,1,0,1,1
70804,POSTRER VALLE,estado nutricional en menores de 5 anos,clasificacion e,2003-03-01,3,6,3,6,9
50101,POTOSI,estado nutricional en menores de 5 anos,clasificacion e,2003-03-01,127,86,127,86,213
10302,PRESTO,estado nutricional en menores de 5 anos,clasificacion e,2003-03-01,19,22,19,22,41
70805,PUCARA,estado nutricional en menores de 5 anos,clasificacion e,2003-03-01,0,1,0,1,1
21201,PUCARANI,estado nutricional en menores de 5 anos,clasificacion e,2003-03-01,0,6,0,6,6
20401,PUERTO ACOSTA,estado nutricional en menores de 5 anos,clasificacion e,2003-03-01,22,15,22,15,37
20403,PUERTO CARABUCO,estado nutricional en menores de 5 anos,clasificacion e,2003-03-01,15,18,15,18,33
90301,PUERTO GONZALO MORENO,estado nutricional en menores de 5 anos,clasificacion e,2003-03-01,4,1,4,1,5
71402,PUERTO QUIJARRO,estado nutricional en menores de 5 anos,clasificacion e,2003-03-01,7,2,7,2,9
90201,PUERTO RICO,estado nutricional en menores de 5 anos,clasificacion e,2003-03-01,1,7,1,7,8
71401,PUERTO SUAREZ,estado nutricional en menores de 5 anos,clasificacion e,2003-03-01,14,4,14,4,18
31205,PUERTO VILLARROEL,estado nutricional en menores de 5 anos,clasificacion e,2003-03-01,67,45,67,45,112
51101,PUNA,estado nutricional en menores de 5 anos,clasificacion e,2003-03-01,80,23,80,23,103
31401,PUNATA,estado nutricional en menores de 5 anos,clasificacion e,2003-03-01,54,10,54,10,64
30901,QUILLACOLLO,estado nutricional en menores de 5 anos,clasificacion e,2003-03-01,40,62,40,62,102
21002,QUIME,estado nutricional en menores de 5 anos,clasificacion e,2003-03-01,19,16,19,16,35
50402,RAVELO,estado nutricional en menores de 5 anos,clasificacion e,2003-03-01,75,75,75,75,150
80301,REYES,estado nutricional en menores de 5 anos,clasificacion e,2003-03-01,8,3,8,3,11
80201,RIBERALTA,estado nutricional en menores de 5 anos,clasificacion e,2003-03-01,59,54,59,54,113
70503,ROBORE,estado nutricional en menores de 5 anos,clasificacion e,2003-03-01,27,15,27,15,42
80304,RURRENABAQUE,estado nutricional en menores de 5 anos,clasificacion e,2003-03-01,3,1,3,1,4
40901,SABAYA,estado nutricional en menores de 5 anos,clasificacion e,2003-03-01,1,1,1,1,2
31001,SACABA,estado nutricional en menores de 5 anos,clasificacion e,2003-03-01,56,47,56,47,103
30404,SACABAMBA,estado nutricional en menores de 5 anos,clasificacion e,2003-03-01,5,10,5,10,15
50701,SACACA,estado nutricional en menores de 5 anos,clasificacion e,2003-03-01,55,81,55,81,136
71302,SAIPINA,estado nutricional en menores de 5 anos,clasificacion e,2003-03-01,1,0,1,0,1
40801,SALINAS DE GARCI MENDOZA,estado nutricional en menores de 5 anos,clasificacion e,2003-03-01,7,3,7,3,10
70901,SAMAIPATA,estado nutricional en menores de 5 anos,clasificacion e,2003-03-01,5,2,5,2,7
51601,SAN AGUSTIN,estado nutricional en menores de 5 anos,clasificacion e,2003-03-01,0,1,0,1,1
80602,SAN ANDRES,estado nutricional en menores de 5 anos,clasificacion e,2003-03-01,7,1,7,1,8
51003,SAN ANTONIO DE ESMORUCO,estado nutricional en menores de 5 anos,clasificacion e,2003-03-01,0,3,0,3,3
71105,SAN ANTONIO DE LOMERIO,estado nutricional en menores de 5 anos,clasificacion e,2003-03-01,32,45,32,45,77
31403,SAN BENITO,estado nutricional en menores de 5 anos,clasificacion e,2003-03-01,8,4,8,4,12
80302,SAN BORJA,estado nutricional en menores de 5 anos,clasificacion e,2003-03-01,39,14,39,14,53
21502,SAN BUENA VENTURA,estado nutricional en menores de 5 anos,clasificacion e,2003-03-01,9,1,9,1,10
70402,SAN CARLOS,estado nutricional en menores de 5 anos,clasificacion e,2003-03-01,14,12,14,12,26
80501,SAN IGNACIO,estado nutricional en menores de 5 anos,clasificacion e,2003-03-01,26,23,26,23,49
70301,SAN IGNACIO DE VELASCO,estado nutricional en menores de 5 anos,clasificacion e,2003-03-01,55,40,55,40,95
80102,SAN JAVIER(BNI),estado nutricional en menores de 5 anos,clasificacion e,2003-03-01,2,0,2,0,2
71102,SAN JAVIER(STC),estado nutricional en menores de 5 anos,clasificacion e,2003-03-01,11,2,11,2,13
70501,SAN JOSE DE CHIQUITOS,estado nutricional en menores de 5 anos,clasificacion e,2003-03-01,11,2,11,2,13
71104,SAN JULIAN,estado nutricional en menores de 5 anos,clasificacion e,2003-03-01,73,88,73,88,161
90302,SAN LORENZO(PND),estado nutricional en menores de 5 anos,clasificacion e,2003-03-01,9,12,9,12,21
60501,SAN LORENZO(TJA),estado nutricional en menores de 5 anos,clasificacion e,2003-03-01,10,8,10,8,18
10702,SAN LUCAS,estado nutricional en menores de 5 anos,clasificacion e,2003-03-01,160,96,160,96,256
70302,SAN MIGUEL DE VELASCO,estado nutricional en menores de 5 anos,clasificacion e,2003-03-01,17,20,17,20,37
51001,SAN PABLO DE LIPEZ,estado nutricional en menores de 5 anos,clasificacion e,2003-03-01,2,7,2,7,9
50501,SAN PEDRO DE BUENA VISTA,estado nutricional en menores de 5 anos,clasificacion e,2003-03-01,46,68,46,68,114
21801,SAN PEDRO DE CURAHUARA,estado nutricional en menores de 5 anos,clasificacion e,2003-03-01,0,3,0,3,3
70303,SAN RAFAEL,estado nutricional en menores de 5 anos,clasificacion e,2003-03-01,14,9,14,9,23
80702,SAN RAMON,estado nutricional en menores de 5 anos,clasificacion e,2003-03-01,0,1,0,1,1
80702,SAN RAMON,estado nutricional en menores de 5 anos,clasificacion e,2003-03-01,1,1,1,1,2
80401,SANTA ANA,estado nutricional en menores de 5 anos,clasificacion e,2003-03-01,0,1,0,1,1
70101,SANTA CRUZ DE LA SIERRA,estado nutricional en menores de 5 anos,clasificacion e,2003-03-01,136,56,136,56,192
80303,SANTA ROSA,estado nutricional en menores de 5 anos,clasificacion e,2003-03-01,1,1,1,1,2
70602,SANTA ROSA DEL SARA,estado nutricional en menores de 5 anos,clasificacion e,2003-03-01,4,8,4,8,12
20308,SANTIAGO DE CALLAPA,estado nutricional en menores de 5 anos,clasificacion e,2003-03-01,5,2,5,2,7
21901,SANTIAGO DE MACHACA,estado nutricional en menores de 5 anos,clasificacion e,2003-03-01,1,1,1,1,2
30702,SANTIVAÃ‘ES,estado nutricional en menores de 5 anos,clasificacion e,2003-03-01,13,2,13,2,15
40202,SANTUARIO DE QUILLACAS,estado nutricional en menores de 5 anos,clasificacion e,2003-03-01,1,2,1,2,3
20902,SAPAHAQUI,estado nutricional en menores de 5 anos,clasificacion e,2003-03-01,13,11,13,11,24
90303,SENA,estado nutricional en menores de 5 anos,clasificacion e,2003-03-01,0,6,0,6,6
21301,SICA SICA (VILLA AROMA),estado nutricional en menores de 5 anos,clasificacion e,2003-03-01,34,11,34,11,45
30703,SICAYA,estado nutricional en menores de 5 anos,clasificacion e,2003-03-01,2,0,2,0,2
30902,SIPE SIPE,estado nutricional en menores de 5 anos,clasificacion e,2003-03-01,37,17,37,17,54
10403,SOPACHUY,estado nutricional en menores de 5 anos,clasificacion e,2003-03-01,22,11,22,11,33
20601,SORATA,estado nutricional en menores de 5 anos,clasificacion e,2003-03-01,8,8,8,8,16
10101,SUCRE,estado nutricional en menores de 5 anos,clasificacion e,2003-03-01,126,91,126,91,217
31404,TACACHI,estado nutricional en menores de 5 anos,clasificacion e,2003-03-01,1,0,1,0,1
50303,TACOBAMBA,estado nutricional en menores de 5 anos,clasificacion e,2003-03-01,26,22,26,22,48
30602,TACOPAYA,estado nutricional en menores de 5 anos,clasificacion e,2003-03-01,20,23,20,23,43
31101,TAPACARI,estado nutricional en menores de 5 anos,clasificacion e,2003-03-01,39,22,39,22,61
10601,TARABUCO,estado nutricional en menores de 5 anos,clasificacion e,2003-03-01,104,100,104,100,204
30401,TARATA,estado nutricional en menores de 5 anos,clasificacion e,2003-03-01,5,10,5,10,15
60101,TARIJA,estado nutricional en menores de 5 anos,clasificacion e,2003-03-01,34,19,34,19,53
10202,TARVITA,estado nutricional en menores de 5 anos,clasificacion e,2003-03-01,40,38,40,38,78
20803,TIAWANACU,estado nutricional en menores de 5 anos,clasificacion e,2003-03-01,3,1,3,1,4
50102,TINGUIPAYA,estado nutricional en menores de 5 anos,clasificacion e,2003-03-01,20,26,20,26,46
20606,TIPUANI,estado nutricional en menores de 5 anos,clasificacion e,2003-03-01,3,2,3,2,5
30903,TIQUIPAYA,estado nutricional en menores de 5 anos,clasificacion e,2003-03-01,3,4,3,4,7
31601,TIRAQUE (CBBA),estado nutricional en menores de 5 anos,clasificacion e,2003-03-01,37,61,37,61,98
21703,TITO YUPANQUI (PARQUIPUJIO),estado nutricional en menores de 5 anos,clasificacion e,2003-03-01,1,3,1,3,4
30802,TOCO,estado nutricional en menores de 5 anos,clasificacion e,2003-03-01,0,3,0,3,3
30803,TOLATA,estado nutricional en menores de 5 anos,clasificacion e,2003-03-01,3,1,3,1,4
41001,TOLEDO,estado nutricional en menores de 5 anos,clasificacion e,2003-03-01,1,2,1,2,3
51202,TOMAVE,estado nutricional en menores de 5 anos,clasificacion e,2003-03-01,16,8,16,8,24
10402,TOMINA,estado nutricional en menores de 5 anos,clasificacion e,2003-03-01,42,52,42,52,94
50502,TORO TORO,estado nutricional en menores de 5 anos,clasificacion e,2003-03-01,23,18,23,18,41
31201,TOTORA(CBBA),estado nutricional en menores de 5 anos,clasificacion e,2003-03-01,17,4,17,4,21
41301,TOTORA(ORR),estado nutricional en menores de 5 anos,clasificacion e,2003-03-01,4,5,4,5,9
80101,TRINIDAD,estado nutricional en menores de 5 anos,clasificacion e,2003-03-01,37,40,37,40,77
50801,TUPIZA,estado nutricional en menores de 5 anos,clasificacion e,2003-03-01,18,66,18,66,84
40402,TURCO,estado nutricional en menores de 5 anos,clasificacion e,2003-03-01,2,1,2,1,3
21302,UMALA,estado nutricional en menores de 5 anos,clasificacion e,2003-03-01,1,3,1,3,4
50201,UNCIA,estado nutricional en menores de 5 anos,clasificacion e,2003-03-01,3,15,3,15,18
60401,URIONDO (A. CONCEPCION),estado nutricional en menores de 5 anos,clasificacion e,2003-03-01,2,0,2,0,2
51201,UYUNI,estado nutricional en menores de 5 anos,clasificacion e,2003-03-01,18,13,18,13,31
30502,VACAS,estado nutricional en menores de 5 anos,clasificacion e,2003-03-01,3,1,3,1,4
70801,VALLEGRANDE,estado nutricional en menores de 5 anos,clasificacion e,2003-03-01,22,30,22,30,52
20801,VIACHA,estado nutricional en menores de 5 anos,clasificacion e,2003-03-01,15,8,15,8,23
31302,VILA VILA,estado nutricional en menores de 5 anos,clasificacion e,2003-03-01,9,1,9,1,10
60303,VILLA MONTES,estado nutricional en menores de 5 anos,clasificacion e,2003-03-01,27,10,27,10,37
31402,VILLA RIVERO,estado nutricional en menores de 5 anos,clasificacion e,2003-03-01,10,4,10,4,14
10801,VILLA SERRANO,estado nutricional en menores de 5 anos,clasificacion e,2003-03-01,28,33,28,33,61
31003,VILLA TUNARI,estado nutricional en menores de 5 anos,clasificacion e,2003-03-01,26,23,26,23,49
11001,VILLA VACA GUZMAN (MUYUPAMPA),estado nutricional en menores de 5 anos,clasificacion e,2003-03-01,9,16,9,16,25
51501,VILLAZON,estado nutricional en menores de 5 anos,clasificacion e,2003-03-01,24,28,24,28,52
50602,VITICHI,estado nutricional en menores de 5 anos,clasificacion e,2003-03-01,17,17,17,17,34
20306,WALDO BALLIVIAN,estado nutricional en menores de 5 anos,clasificacion e,2003-03-01,0,1,0,1,1
70201,WARNES,estado nutricional en menores de 5 anos,clasificacion e,2003-03-01,44,21,44,21,65
20903,YACO,estado nutricional en menores de 5 anos,clasificacion e,2003-03-01,4,4,4,4,8
60301,YACUIBA,estado nutricional en menores de 5 anos,clasificacion e,2003-03-01,36,18,36,18,54
10602,YAMPARAEZ,estado nutricional en menores de 5 anos,clasificacion e,2003-03-01,70,42,70,42,112
21103,YANACACHI,estado nutricional en menores de 5 anos,clasificacion e,2003-03-01,1,2,1,2,3
70403,YAPACANI,estado nutricional en menores de 5 anos,clasificacion e,2003-03-01,28,15,28,15,43
50103,YOCALLA,estado nutricional en menores de 5 anos,clasificacion e,2003-03-01,8,5,8,5,13
10102,YOTALA,estado nutricional en menores de 5 anos,clasificacion e,2003-03-01,19,25,19,25,44
60402,YUNCHARA,estado nutricional en menores de 5 anos,clasificacion e,2003-03-01,1,8,1,8,9
10301,ZUDAÃ‘EZ,estado nutricional en menores de 5 anos,clasificacion e,2003-03-01,32,35,32,35,67
51302,ACACIO,estado nutricional en menores de 5 anos,clasificacion e,2003-04-01,41,32,41,32,73
20201,ACHACACHI,estado nutricional en menores de 5 anos,clasificacion e,2003-04-01,11,7,11,7,18
20104,ACHOCALLA,estado nutricional en menores de 5 anos,clasificacion e,2003-04-01,3,3,3,3,6
30201,AIQUILE,estado nutricional en menores de 5 anos,clasificacion e,2003-04-01,18,28,18,28,46
31303,ALALAY,estado nutricional en menores de 5 anos,clasificacion e,2003-04-01,2,0,2,0,2
10404,ALCALA,estado nutricional en menores de 5 anos,clasificacion e,2003-04-01,11,18,11,18,29
20202,ANCORAIMES,estado nutricional en menores de 5 anos,clasificacion e,2003-04-01,6,9,6,9,15
41201,ANDAMARCA,estado nutricional en menores de 5 anos,clasificacion e,2003-04-01,1,0,1,0,1
40603,ANTEQUERA,estado nutricional en menores de 5 anos,clasificacion e,2003-04-01,1,1,1,1,2
30402,ANZALDO,estado nutricional en menores de 5 anos,clasificacion e,2003-04-01,6,19,6,19,25
20701,APOLO,estado nutricional en menores de 5 anos,clasificacion e,2003-04-01,7,10,7,10,17
51301,ARAMPAMPA,estado nutricional en menores de 5 anos,clasificacion e,2003-04-01,8,17,8,17,25
30501,ARANI,estado nutricional en menores de 5 anos,clasificacion e,2003-04-01,3,22,3,22,25
30403,ARBIETO,estado nutricional en menores de 5 anos,clasificacion e,2003-04-01,4,2,4,2,6
30601,ARQUE,estado nutricional en menores de 5 anos,clasificacion e,2003-04-01,15,10,15,10,25
71501,ASCENCION DE GUARAYOS,estado nutricional en menores de 5 anos,clasificacion e,2003-04-01,77,77,77,77,154
50802,ATOCHA,estado nutricional en menores de 5 anos,clasificacion e,2003-04-01,12,53,12,53,65
20503,AUCAPATA,estado nutricional en menores de 5 anos,clasificacion e,2003-04-01,3,11,3,11,14
20502,AYATA,estado nutricional en menores de 5 anos,clasificacion e,2003-04-01,17,7,17,7,24
21303,AYO AYO,estado nutricional en menores de 5 anos,clasificacion e,2003-04-01,1,2,1,2,3
30301,AYOPAYA (V. DE INDEPENDENCIA),estado nutricional en menores de 5 anos,clasificacion e,2003-04-01,16,17,16,17,33
10201,AZURDUY,estado nutricional en menores de 5 anos,clasificacion e,2003-04-01,45,35,45,35,80
21203,BATALLAS,estado nutricional en menores de 5 anos,clasificacion e,2003-04-01,2,7,2,7,9
80802,BAURES,estado nutricional en menores de 5 anos,clasificacion e,2003-04-01,3,3,3,3,6
41202,BELEN DE ANDAMARCA,estado nutricional en menores de 5 anos,clasificacion e,2003-04-01,2,1,2,1,3
50104,BELEN DE URMIRI,estado nutricional en menores de 5 anos,clasificacion e,2003-04-01,2,1,2,1,3
90104,BELLA FLOR,estado nutricional en menores de 5 anos,clasificacion e,2003-04-01,3,4,3,4,7
60202,BERMEJO,estado nutricional en menores de 5 anos,clasificacion e,2003-04-01,0,1,0,1,1
50301,BETANZOS,estado nutricional en menores de 5 anos,clasificacion e,2003-04-01,97,86,97,86,183
31501,BOLIVAR,estado nutricional en menores de 5 anos,clasificacion e,2003-04-01,25,37,25,37,62
90103,BOLPEBRA,estado nutricional en menores de 5 anos,clasificacion e,2003-04-01,3,2,3,2,5
70707,BOYUIBE,estado nutricional en menores de 5 anos,clasificacion e,2003-04-01,3,2,3,2,5
70401,BUENA VISTA,estado nutricional en menores de 5 anos,clasificacion e,2003-04-01,10,13,10,13,23
70703,CABEZAS,estado nutricional en menores de 5 anos,clasificacion e,2003-04-01,18,4,18,4,22
20905,CAIROMA,estado nutricional en menores de 5 anos,clasificacion e,2003-04-01,17,11,17,11,28
51102,"CAIZA ""D""",estado nutricional en menores de 5 anos,clasificacion e,2003-04-01,26,12,26,12,38
21003,CAJUATA,estado nutricional en menores de 5 anos,clasificacion e,2003-04-01,13,12,13,12,25
20303,CALACOTO,estado nutricional en menores de 5 anos,clasificacion e,2003-04-01,2,2,2,2,4
21304,CALAMARCA,estado nutricional en menores de 5 anos,clasificacion e,2003-04-01,41,32,41,32,73
10701,CAMARGO,estado nutricional en menores de 5 anos,clasificacion e,2003-04-01,9,18,9,18,27
10901,CAMATAQUI (C. VILLA ABECIA),estado nutricional en menores de 5 anos,clasificacion e,2003-04-01,7,2,7,2,9
70706,CAMIRI,estado nutricional en menores de 5 anos,clasificacion e,2003-04-01,49,22,49,22,71
30701,CAPINOTA,estado nutricional en menores de 5 anos,clasificacion e,2003-04-01,11,8,11,8,19
20302,CAQUIAVIRI,estado nutricional en menores de 5 anos,clasificacion e,2003-04-01,3,7,3,7,10
40102,CARACOLLO,estado nutricional en menores de 5 anos,clasificacion e,2003-04-01,13,15,13,15,28
22001,CARANAVI,estado nutricional en menores de 5 anos,clasificacion e,2003-04-01,40,25,40,25,65
60302,CARAPARI,estado nutricional en menores de 5 anos,clasificacion e,2003-04-01,5,2,5,2,7
50702,CARIPUYO,estado nutricional en menores de 5 anos,clasificacion e,2003-04-01,17,33,17,33,50
40201,CHALLAPATA,estado nutricional en menores de 5 anos,clasificacion e,2003-04-01,21,31,21,31,52
50302,CHAQUI,estado nutricional en menores de 5 anos,clasificacion e,2003-04-01,21,5,21,5,26
70702,CHARAGUA,estado nutricional en menores de 5 anos,clasificacion e,2003-04-01,29,25,29,25,54
20305,CHARAÃ‘A,estado nutricional en menores de 5 anos,clasificacion e,2003-04-01,2,4,2,4,6
50202,CHAYANTA,estado nutricional en menores de 5 anos,clasificacion e,2003-04-01,17,12,17,12,29
31204,CHIMORE,estado nutricional en menores de 5 anos,clasificacion e,2003-04-01,6,1,6,1,7
40903,CHIPAYA,estado nutricional en menores de 5 anos,clasificacion e,2003-04-01,0,2,0,2,2
40302,CHOQUE COTA,estado nutricional en menores de 5 anos,clasificacion e,2003-04-01,1,2,1,2,3
21101,CHULUMANI (V. DE LA LIBERTAD),estado nutricional en menores de 5 anos,clasificacion e,2003-04-01,2,1,2,1,3
20501,CHUMA,estado nutricional en menores de 5 anos,clasificacion e,2003-04-01,12,7,12,7,19
30801,CLIZA,estado nutricional en menores de 5 anos,clasificacion e,2003-04-01,5,11,5,11,16
90101,COBIJA,estado nutricional en menores de 5 anos,clasificacion e,2003-04-01,7,8,7,8,15
30101,COCHABAMBA,estado nutricional en menores de 5 anos,clasificacion e,2003-04-01,143,67,143,67,210
30905,COLCAPIRHUA,estado nutricional en menores de 5 anos,clasificacion e,2003-04-01,0,1,0,1,1
50901,"COLCHA ""K""",estado nutricional en menores de 5 anos,clasificacion e,2003-04-01,8,7,8,7,15
31002,COLOMI,estado nutricional en menores de 5 anos,clasificacion e,2003-04-01,16,7,16,7,23
50401,COLQUECHACA,estado nutricional en menores de 5 anos,clasificacion e,2003-04-01,51,23,51,23,74
21306,COLQUENCHA,estado nutricional en menores de 5 anos,clasificacion e,2003-04-01,7,9,7,9,16
21004,COLQUIRI,estado nutricional en menores de 5 anos,clasificacion e,2003-04-01,24,21,24,21,45
20304,COMANCHE,estado nutricional en menores de 5 anos,clasificacion e,2003-04-01,1,1,1,1,2
71301,COMARAPA,estado nutricional en menores de 5 anos,clasificacion e,2003-04-01,22,17,22,17,39
20605,COMBAYA,estado nutricional en menores de 5 anos,clasificacion e,2003-04-01,6,3,6,3,9
71101,CONCEPCION,estado nutricional en menores de 5 anos,clasificacion e,2003-04-01,7,7,7,7,14
21701,COPACABANA,estado nutricional en menores de 5 anos,clasificacion e,2003-04-01,2,5,2,5,7
21402,CORIPATA,estado nutricional en menores de 5 anos,clasificacion e,2003-04-01,1,2,1,2,3
20301,CORO CORO,estado nutricional en menores de 5 anos,clasificacion e,2003-04-01,9,8,9,8,17
21401,COROICO,estado nutricional en menores de 5 anos,clasificacion e,2003-04-01,3,0,3,0,3
40301,CORQUE,estado nutricional en menores de 5 anos,clasificacion e,2003-04-01,8,8,8,8,16
50601,COTAGAITA,estado nutricional en menores de 5 anos,clasificacion e,2003-04-01,35,23,35,23,58
70102,COTOCA,estado nutricional en menores de 5 anos,clasificacion e,2003-04-01,10,4,10,4,14
31405,CUCHUMUELA (V. G. VILLARROEL),estado nutricional en menores de 5 anos,clasificacion e,2003-04-01,1,1,1,1,2
70704,CUEVO,estado nutricional en menores de 5 anos,clasificacion e,2003-04-01,1,1,1,1,2
10902,CULPINA,estado nutricional en menores de 5 anos,clasificacion e,2003-04-01,70,43,70,43,113
40401,CURAHUARA DE CARANGAS,estado nutricional en menores de 5 anos,clasificacion e,2003-04-01,4,2,4,2,6
21602,CURVA,estado nutricional en menores de 5 anos,clasificacion e,2003-04-01,1,1,1,1,2
20804,DESAGUADERO,estado nutricional en menores de 5 anos,clasificacion e,2003-04-01,2,2,2,2,4
20105,EL ALTO,estado nutricional en menores de 5 anos,clasificacion e,2003-04-01,575,307,575,307,882
40103,EL CHORO,estado nutricional en menores de 5 anos,clasificacion e,2003-04-01,1,0,1,0,1
71503,EL PUENTE(STC),estado nutricional en menores de 5 anos,clasificacion e,2003-04-01,2,20,2,20,22
60502,EL PUENTE(TJA),estado nutricional en menores de 5 anos,clasificacion e,2003-04-01,12,28,12,28,40
70105,EL TORNO,estado nutricional en menores de 5 anos,clasificacion e,2003-04-01,5,5,5,5,10
10405,EL VILLAR,estado nutricional en menores de 5 anos,clasificacion e,2003-04-01,15,27,15,27,42
60601,ENTRE RIOS,estado nutricional en menores de 5 anos,clasificacion e,2003-04-01,6,9,6,9,15
41101,EUCALIPTUS,estado nutricional en menores de 5 anos,clasificacion e,2003-04-01,6,2,6,2,8
80402,EXALTACION,estado nutricional en menores de 5 anos,clasificacion e,2003-04-01,4,5,4,5,9
90203,FILADELFIA,estado nutricional en menores de 5 anos,clasificacion e,2003-04-01,0,2,0,2,2
71002,GENERAL SAAVEDRA,estado nutricional en menores de 5 anos,clasificacion e,2003-04-01,24,16,24,16,40
21601,GRAL. J.J. PEREZ (CHARAZANI),estado nutricional en menores de 5 anos,clasificacion e,2003-04-01,4,13,4,13,17
20602,GUANAY,estado nutricional en menores de 5 anos,clasificacion e,2003-04-01,10,5,10,5,15
20802,GUAQUI,estado nutricional en menores de 5 anos,clasificacion e,2003-04-01,2,1,2,1,3
80202,GUAYARAMERIN,estado nutricional en menores de 5 anos,clasificacion e,2003-04-01,49,20,49,20,69
70705,GUTIERREZ,estado nutricional en menores de 5 anos,clasificacion e,2003-04-01,39,50,39,50,89
10502,HUACARETA,estado nutricional en menores de 5 anos,clasificacion e,2003-04-01,13,22,13,22,35
11002,HUACAYA (VILLA DE HUACAYA),estado nutricional en menores de 5 anos,clasificacion e,2003-04-01,2,4,2,4,6
40501,HUACHACALLA,estado nutricional en menores de 5 anos,clasificacion e,2003-04-01,0,1,0,1,1
40701,HUANUNI,estado nutricional en menores de 5 anos,clasificacion e,2003-04-01,14,11,14,11,25
80803,HUARACAJE,estado nutricional en menores de 5 anos,clasificacion e,2003-04-01,0,2,0,2,2
41601,HUAYLLAMARCA,estado nutricional en menores de 5 anos,clasificacion e,2003-04-01,3,0,3,0,3
21005,ICHOCA,estado nutricional en menores de 5 anos,clasificacion e,2003-04-01,8,2,8,2,10
10304,ICLA,estado nutricional en menores de 5 anos,clasificacion e,2003-04-01,44,55,44,55,99
10703,INCAHUASI,estado nutricional en menores de 5 anos,clasificacion e,2003-04-01,65,40,65,40,105
21001,INQUISIVI,estado nutricional en menores de 5 anos,clasificacion e,2003-04-01,35,12,35,12,47
21102,IRUPANA (VILLA DE LANZA),estado nutricional en menores de 5 anos,clasificacion e,2003-04-01,6,20,6,20,26
21501,IXIAMAS,estado nutricional en menores de 5 anos,clasificacion e,2003-04-01,7,6,7,6,13
21105,LA ASUNTA,estado nutricional en menores de 5 anos,clasificacion e,2003-04-01,5,9,5,9,14
70104,LA GUARDIA,estado nutricional en menores de 5 anos,clasificacion e,2003-04-01,20,8,20,8,28
20101,LA PAZ,estado nutricional en menores de 5 anos,clasificacion e,2003-04-01,311,207,311,207,518
70701,LAGUNILLAS,estado nutricional en menores de 5 anos,clasificacion e,2003-04-01,6,7,6,7,13
21202,LAJA,estado nutricional en menores de 5 anos,clasificacion e,2003-04-01,4,2,4,2,6
10903,LAS CARRERAS,estado nutricional en menores de 5 anos,clasificacion e,2003-04-01,16,10,16,10,26
50203,LLALLAGUA,estado nutricional en menores de 5 anos,clasificacion e,2003-04-01,0,77,0,77,77
51401,LLICA,estado nutricional en menores de 5 anos,clasificacion e,2003-04-01,1,4,1,4,5
80601,LORETO,estado nutricional en menores de 5 anos,clasificacion e,2003-04-01,0,1,0,1,1
20901,LURIBAY,estado nutricional en menores de 5 anos,clasificacion e,2003-04-01,24,19,24,19,43
40702,MACHACAMARCA,estado nutricional en menores de 5 anos,clasificacion e,2003-04-01,14,3,14,3,17
11003,MACHARETI,estado nutricional en menores de 5 anos,clasificacion e,2003-04-01,6,24,6,24,30
80801,MAGDALENA,estado nutricional en menores de 5 anos,clasificacion e,2003-04-01,2,6,2,6,8
70903,MAIRANA,estado nutricional en menores de 5 anos,clasificacion e,2003-04-01,10,5,10,5,15
20103,MECAPACA,estado nutricional en menores de 5 anos,clasificacion e,2003-04-01,2,0,2,0,2
71003,MINEROS,estado nutricional en menores de 5 anos,clasificacion e,2003-04-01,38,12,38,12,50
31301,MIZQUE,estado nutricional en menores de 5 anos,clasificacion e,2003-04-01,27,10,27,10,37
20402,MOCOMOCO,estado nutricional en menores de 5 anos,clasificacion e,2003-04-01,13,7,13,7,20
51002,MOJINETE,estado nutricional en menores de 5 anos,clasificacion e,2003-04-01,0,2,0,2,2
10303,MOJOCOYA,estado nutricional en menores de 5 anos,clasificacion e,2003-04-01,14,14,14,14,28
10501,MONTEAGUDO,estado nutricional en menores de 5 anos,clasificacion e,2003-04-01,31,29,31,29,60
71001,MONTERO,estado nutricional en menores de 5 anos,clasificacion e,2003-04-01,78,44,78,44,122
70803,MORO MORO,estado nutricional en menores de 5 anos,clasificacion e,2003-04-01,6,9,6,9,15
30302,MOROCHATA,estado nutricional en menores de 5 anos,clasificacion e,2003-04-01,44,37,44,37,81
90401,NACEBE (SANTA ROSA DEL ABUNA),estado nutricional en menores de 5 anos,clasificacion e,2003-04-01,2,3,2,3,5
90501,NUEVO MANOA (NUEVA ESPERANZA),estado nutricional en menores de 5 anos,clasificacion e,2003-04-01,0,1,0,1,1
50404,OCURI,estado nutricional en menores de 5 anos,clasificacion e,2003-04-01,28,24,28,24,52
70202,OKINAWA,estado nutricional en menores de 5 anos,clasificacion e,2003-04-01,5,1,5,1,6
30203,OMEREQUE,estado nutricional en menores de 5 anos,clasificacion e,2003-04-01,1,2,1,2,3
40101,ORURO,estado nutricional en menores de 5 anos,clasificacion e,2003-04-01,119,102,119,102,221
60201,PADCAYA,estado nutricional en menores de 5 anos,clasificacion e,2003-04-01,13,5,13,5,18
10401,PADILLA,estado nutricional en menores de 5 anos,clasificacion e,2003-04-01,47,52,47,52,99
70502,PAILON,estado nutricional en menores de 5 anos,clasificacion e,2003-04-01,8,3,8,3,11
20102,PALCA,estado nutricional en menores de 5 anos,clasificacion e,2003-04-01,11,11,11,11,22
21104,PALOS BLANCOS,estado nutricional en menores de 5 anos,clasificacion e,2003-04-01,23,13,23,13,36
40802,PAMPA AULLAGAS,estado nutricional en menores de 5 anos,clasificacion e,2003-04-01,7,7,7,7,14
70902,PAMPA GRANDE,estado nutricional en menores de 5 anos,clasificacion e,2003-04-01,3,5,3,5,8
21802,PAPEL PAMPA,estado nutricional en menores de 5 anos,clasificacion e,2003-04-01,3,1,3,1,4
30202,PASORAPA,estado nutricional en menores de 5 anos,clasificacion e,2003-04-01,8,8,8,8,16
21305,PATACAMAYA,estado nutricional en menores de 5 anos,clasificacion e,2003-04-01,20,20,20,20,40
40602,PAZÃ‘A,estado nutricional en menores de 5 anos,clasificacion e,2003-04-01,2,2,2,2,4
20702,PELECHUCO,estado nutricional en menores de 5 anos,clasificacion e,2003-04-01,3,7,3,7,10
50403,POCOATA,estado nutricional en menores de 5 anos,clasificacion e,2003-04-01,36,42,36,42,78
31203,POCONA,estado nutricional en menores de 5 anos,clasificacion e,2003-04-01,15,6,15,6,21
31202,POJO (CBBA),estado nutricional en menores de 5 anos,clasificacion e,2003-04-01,45,31,45,31,76
40601,POOPO,estado nutricional en menores de 5 anos,clasificacion e,2003-04-01,2,2,2,2,4
51203,PORCO,estado nutricional en menores de 5 anos,clasificacion e,2003-04-01,6,1,6,1,7
10103,POROMA,estado nutricional en menores de 5 anos,clasificacion e,2003-04-01,59,64,59,64,123
70601,PORTACHUELO,estado nutricional en menores de 5 anos,clasificacion e,2003-04-01,14,1,14,1,15
90102,PORVENIR,estado nutricional en menores de 5 anos,clasificacion e,2003-04-01,2,2,2,2,4
70804,POSTRER VALLE,estado nutricional en menores de 5 anos,clasificacion e,2003-04-01,2,2,2,2,4
50101,POTOSI,estado nutricional en menores de 5 anos,clasificacion e,2003-04-01,175,104,175,104,279
10302,PRESTO,estado nutricional en menores de 5 anos,clasificacion e,2003-04-01,19,26,19,26,45
70805,PUCARA,estado nutricional en menores de 5 anos,clasificacion e,2003-04-01,0,1,0,1,1
21201,PUCARANI,estado nutricional en menores de 5 anos,clasificacion e,2003-04-01,11,4,11,4,15
20401,PUERTO ACOSTA,estado nutricional en menores de 5 anos,clasificacion e,2003-04-01,21,10,21,10,31
20403,PUERTO CARABUCO,estado nutricional en menores de 5 anos,clasificacion e,2003-04-01,3,14,3,14,17
90301,PUERTO GONZALO MORENO,estado nutricional en menores de 5 anos,clasificacion e,2003-04-01,25,27,25,27,52
21204,PUERTO PEREZ,estado nutricional en menores de 5 anos,clasificacion e,2003-04-01,1,1,1,1,2
71402,PUERTO QUIJARRO,estado nutricional en menores de 5 anos,clasificacion e,2003-04-01,6,1,6,1,7
90201,PUERTO RICO,estado nutricional en menores de 5 anos,clasificacion e,2003-04-01,0,11,0,11,11
71401,PUERTO SUAREZ,estado nutricional en menores de 5 anos,clasificacion e,2003-04-01,15,3,15,3,18
31205,PUERTO VILLARROEL,estado nutricional en menores de 5 anos,clasificacion e,2003-04-01,81,49,81,49,130
51101,PUNA,estado nutricional en menores de 5 anos,clasificacion e,2003-04-01,30,18,30,18,48
31401,PUNATA,estado nutricional en menores de 5 anos,clasificacion e,2003-04-01,58,5,58,5,63
20604,QUIABAYA,estado nutricional en menores de 5 anos,clasificacion e,2003-04-01,7,8,7,8,15
30901,QUILLACOLLO,estado nutricional en menores de 5 anos,clasificacion e,2003-04-01,24,33,24,33,57
21002,QUIME,estado nutricional en menores de 5 anos,clasificacion e,2003-04-01,26,17,26,17,43
70904,QUIRUSILLAS,estado nutricional en menores de 5 anos,clasificacion e,2003-04-01,1,2,1,2,3
50402,RAVELO,estado nutricional en menores de 5 anos,clasificacion e,2003-04-01,73,63,73,63,136
80301,REYES,estado nutricional en menores de 5 anos,clasificacion e,2003-04-01,2,3,2,3,5
80201,RIBERALTA,estado nutricional en menores de 5 anos,clasificacion e,2003-04-01,89,69,89,69,158
70503,ROBORE,estado nutricional en menores de 5 anos,clasificacion e,2003-04-01,15,8,15,8,23
80304,RURRENABAQUE,estado nutricional en menores de 5 anos,clasificacion e,2003-04-01,2,0,2,0,2
40901,SABAYA,estado nutricional en menores de 5 anos,clasificacion e,2003-04-01,0,5,0,5,5
31001,SACABA,estado nutricional en menores de 5 anos,clasificacion e,2003-04-01,59,31,59,31,90
30404,SACABAMBA,estado nutricional en menores de 5 anos,clasificacion e,2003-04-01,2,6,2,6,8
50701,SACACA,estado nutricional en menores de 5 anos,clasificacion e,2003-04-01,78,99,78,99,177
71302,SAIPINA,estado nutricional en menores de 5 anos,clasificacion e,2003-04-01,7,5,7,5,12
40801,SALINAS DE GARCI MENDOZA,estado nutricional en menores de 5 anos,clasificacion e,2003-04-01,2,4,2,4,6
70901,SAMAIPATA,estado nutricional en menores de 5 anos,clasificacion e,2003-04-01,5,2,5,2,7
51601,SAN AGUSTIN,estado nutricional en menores de 5 anos,clasificacion e,2003-04-01,0,2,0,2,2
80602,SAN ANDRES,estado nutricional en menores de 5 anos,clasificacion e,2003-04-01,6,10,6,10,16
51003,SAN ANTONIO DE ESMORUCO,estado nutricional en menores de 5 anos,clasificacion e,2003-04-01,0,3,0,3,3
71105,SAN ANTONIO DE LOMERIO,estado nutricional en menores de 5 anos,clasificacion e,2003-04-01,35,45,35,45,80
31403,SAN BENITO,estado nutricional en menores de 5 anos,clasificacion e,2003-04-01,3,12,3,12,15
80302,SAN BORJA,estado nutricional en menores de 5 anos,clasificacion e,2003-04-01,48,40,48,40,88
21502,SAN BUENA VENTURA,estado nutricional en menores de 5 anos,clasificacion e,2003-04-01,13,8,13,8,21
70402,SAN CARLOS,estado nutricional en menores de 5 anos,clasificacion e,2003-04-01,14,14,14,14,28
80501,SAN IGNACIO,estado nutricional en menores de 5 anos,clasificacion e,2003-04-01,23,25,23,25,48
70301,SAN IGNACIO DE VELASCO,estado nutricional en menores de 5 anos,clasificacion e,2003-04-01,58,28,58,28,86
80102,SAN JAVIER(BNI),estado nutricional en menores de 5 anos,clasificacion e,2003-04-01,3,2,3,2,5
71102,SAN JAVIER(STC),estado nutricional en menores de 5 anos,clasificacion e,2003-04-01,6,10,6,10,16
80701,SAN JOAQUIN,estado nutricional en menores de 5 anos,clasificacion e,2003-04-01,1,0,1,0,1
70501,SAN JOSE DE CHIQUITOS,estado nutricional en menores de 5 anos,clasificacion e,2003-04-01,9,3,9,3,12
71104,SAN JULIAN,estado nutricional en menores de 5 anos,clasificacion e,2003-04-01,45,35,45,35,80
60501,SAN LORENZO(TJA),estado nutricional en menores de 5 anos,clasificacion e,2003-04-01,21,32,21,32,53
10702,SAN LUCAS,estado nutricional en menores de 5 anos,clasificacion e,2003-04-01,129,95,129,95,224
70302,SAN MIGUEL DE VELASCO,estado nutricional en menores de 5 anos,clasificacion e,2003-04-01,14,18,14,18,32
51001,SAN PABLO DE LIPEZ,estado nutricional en menores de 5 anos,clasificacion e,2003-04-01,4,2,4,2,6
50501,SAN PEDRO DE BUENA VISTA,estado nutricional en menores de 5 anos,clasificacion e,2003-04-01,39,73,39,73,112
21801,SAN PEDRO DE CURAHUARA,estado nutricional en menores de 5 anos,clasificacion e,2003-04-01,0,3,0,3,3
70303,SAN RAFAEL,estado nutricional en menores de 5 anos,clasificacion e,2003-04-01,15,8,15,8,23
80401,SANTA ANA,estado nutricional en menores de 5 anos,clasificacion e,2003-04-01,0,3,0,3,3
70101,SANTA CRUZ DE LA SIERRA,estado nutricional en menores de 5 anos,clasificacion e,2003-04-01,220,134,220,134,354
80303,SANTA ROSA,estado nutricional en menores de 5 anos,clasificacion e,2003-04-01,3,0,3,0,3
70602,SANTA ROSA DEL SARA,estado nutricional en menores de 5 anos,clasificacion e,2003-04-01,3,3,3,3,6
20308,SANTIAGO DE CALLAPA,estado nutricional en menores de 5 anos,clasificacion e,2003-04-01,1,5,1,5,6
41401,SANTIAGO DE HUARI,estado nutricional en menores de 5 anos,clasificacion e,2003-04-01,0,4,0,4,4
21901,SANTIAGO DE MACHACA,estado nutricional en menores de 5 anos,clasificacion e,2003-04-01,1,1,1,1,2
30702,SANTIVAÃ‘ES,estado nutricional en menores de 5 anos,clasificacion e,2003-04-01,6,5,6,5,11
40202,SANTUARIO DE QUILLACAS,estado nutricional en menores de 5 anos,clasificacion e,2003-04-01,0,2,0,2,2
20902,SAPAHAQUI,estado nutricional en menores de 5 anos,clasificacion e,2003-04-01,7,14,7,14,21
90303,SENA,estado nutricional en menores de 5 anos,clasificacion e,2003-04-01,0,5,0,5,5
21301,SICA SICA (VILLA AROMA),estado nutricional en menores de 5 anos,clasificacion e,2003-04-01,24,11,24,11,35
30703,SICAYA,estado nutricional en menores de 5 anos,clasificacion e,2003-04-01,8,6,8,6,14
30902,SIPE SIPE,estado nutricional en menores de 5 anos,clasificacion e,2003-04-01,32,19,32,19,51
10403,SOPACHUY,estado nutricional en menores de 5 anos,clasificacion e,2003-04-01,18,26,18,26,44
20601,SORATA,estado nutricional en menores de 5 anos,clasificacion e,2003-04-01,9,6,9,6,15
10101,SUCRE,estado nutricional en menores de 5 anos,clasificacion e,2003-04-01,163,136,163,136,299
31404,TACACHI,estado nutricional en menores de 5 anos,clasificacion e,2003-04-01,1,0,1,0,1
20603,TACACOMA,estado nutricional en menores de 5 anos,clasificacion e,2003-04-01,5,0,5,0,5
50303,TACOBAMBA,estado nutricional en menores de 5 anos,clasificacion e,2003-04-01,23,20,23,20,43
30602,TACOPAYA,estado nutricional en menores de 5 anos,clasificacion e,2003-04-01,50,36,50,36,86
51402,TAHUA,estado nutricional en menores de 5 anos,clasificacion e,2003-04-01,0,1,0,1,1
31101,TAPACARI,estado nutricional en menores de 5 anos,clasificacion e,2003-04-01,29,40,29,40,69
10601,TARABUCO,estado nutricional en menores de 5 anos,clasificacion e,2003-04-01,124,122,124,122,246
30401,TARATA,estado nutricional en menores de 5 anos,clasificacion e,2003-04-01,6,17,6,17,23
60101,TARIJA,estado nutricional en menores de 5 anos,clasificacion e,2003-04-01,35,36,35,36,71
10202,TARVITA,estado nutricional en menores de 5 anos,clasificacion e,2003-04-01,38,52,38,52,90
20803,TIAWANACU,estado nutricional en menores de 5 anos,clasificacion e,2003-04-01,3,1,3,1,4
50102,TINGUIPAYA,estado nutricional en menores de 5 anos,clasificacion e,2003-04-01,4,6,4,6,10
20606,TIPUANI,estado nutricional en menores de 5 anos,clasificacion e,2003-04-01,3,3,3,3,6
30903,TIQUIPAYA,estado nutricional en menores de 5 anos,clasificacion e,2003-04-01,10,9,10,9,19
31601,TIRAQUE (CBBA),estado nutricional en menores de 5 anos,clasificacion e,2003-04-01,39,45,39,45,84
30802,TOCO,estado nutricional en menores de 5 anos,clasificacion e,2003-04-01,2,1,2,1,3
30803,TOLATA,estado nutricional en menores de 5 anos,clasificacion e,2003-04-01,0,1,0,1,1
41001,TOLEDO,estado nutricional en menores de 5 anos,clasificacion e,2003-04-01,2,1,2,1,3
51202,TOMAVE,estado nutricional en menores de 5 anos,clasificacion e,2003-04-01,19,22,19,22,41
10402,TOMINA,estado nutricional en menores de 5 anos,clasificacion e,2003-04-01,51,57,51,57,108
50502,TORO TORO,estado nutricional en menores de 5 anos,clasificacion e,2003-04-01,22,19,22,19,41
31201,TOTORA(CBBA),estado nutricional en menores de 5 anos,clasificacion e,2003-04-01,10,8,10,8,18
41301,TOTORA(ORR),estado nutricional en menores de 5 anos,clasificacion e,2003-04-01,2,1,2,1,3
70802,TRIGAL,estado nutricional en menores de 5 anos,clasificacion e,2003-04-01,1,0,1,0,1
80101,TRINIDAD,estado nutricional en menores de 5 anos,clasificacion e,2003-04-01,52,67,52,67,119
50801,TUPIZA,estado nutricional en menores de 5 anos,clasificacion e,2003-04-01,22,70,22,70,92
40402,TURCO,estado nutricional en menores de 5 anos,clasificacion e,2003-04-01,2,1,2,1,3
21302,UMALA,estado nutricional en menores de 5 anos,clasificacion e,2003-04-01,1,4,1,4,5
50201,UNCIA,estado nutricional en menores de 5 anos,clasificacion e,2003-04-01,6,9,6,9,15
60401,URIONDO (A. CONCEPCION),estado nutricional en menores de 5 anos,clasificacion e,2003-04-01,6,6,6,6,12
71502,URUBICHA,estado nutricional en menores de 5 anos,clasificacion e,2003-04-01,37,49,37,49,86
51201,UYUNI,estado nutricional en menores de 5 anos,clasificacion e,2003-04-01,24,23,24,23,47
30502,VACAS,estado nutricional en menores de 5 anos,clasificacion e,2003-04-01,3,4,3,4,7
70801,VALLEGRANDE,estado nutricional en menores de 5 anos,clasificacion e,2003-04-01,14,12,14,12,26
20801,VIACHA,estado nutricional en menores de 5 anos,clasificacion e,2003-04-01,24,10,24,10,34
31302,VILA VILA,estado nutricional en menores de 5 anos,clasificacion e,2003-04-01,4,11,4,11,15
60303,VILLA MONTES,estado nutricional en menores de 5 anos,clasificacion e,2003-04-01,24,17,24,17,41
31402,VILLA RIVERO,estado nutricional en menores de 5 anos,clasificacion e,2003-04-01,3,3,3,3,6
10801,VILLA SERRANO,estado nutricional en menores de 5 anos,clasificacion e,2003-04-01,29,32,29,32,61
31003,VILLA TUNARI,estado nutricional en menores de 5 anos,clasificacion e,2003-04-01,50,31,50,31,81
11001,VILLA VACA GUZMAN (MUYUPAMPA),estado nutricional en menores de 5 anos,clasificacion e,2003-04-01,15,21,15,21,36
51501,VILLAZON,estado nutricional en menores de 5 anos,clasificacion e,2003-04-01,26,33,26,33,59
30904,VINTO,estado nutricional en menores de 5 anos,clasificacion e,2003-04-01,13,10,13,10,23
50602,VITICHI,estado nutricional en menores de 5 anos,clasificacion e,2003-04-01,26,24,26,24,50
70201,WARNES,estado nutricional en menores de 5 anos,clasificacion e,2003-04-01,39,18,39,18,57
20903,YACO,estado nutricional en menores de 5 anos,clasificacion e,2003-04-01,6,13,6,13,19
60301,YACUIBA,estado nutricional en menores de 5 anos,clasificacion e,2003-04-01,27,19,27,19,46
10602,YAMPARAEZ,estado nutricional en menores de 5 anos,clasificacion e,2003-04-01,74,40,74,40,114
21103,YANACACHI,estado nutricional en menores de 5 anos,clasificacion e,2003-04-01,0,2,0,2,2
70403,YAPACANI,estado nutricional en menores de 5 anos,clasificacion e,2003-04-01,68,34,68,34,102
50103,YOCALLA,estado nutricional en menores de 5 anos,clasificacion e,2003-04-01,4,3,4,3,7
10102,YOTALA,estado nutricional en menores de 5 anos,clasificacion e,2003-04-01,17,27,17,27,44
60402,YUNCHARA,estado nutricional en menores de 5 anos,clasificacion e,2003-04-01,10,10,10,10,20
10301,ZUDAÃ‘EZ,estado nutricional en menores de 5 anos,clasificacion e,2003-04-01,25,33,25,33,58
51302,ACACIO,estado nutricional en menores de 5 anos,clasificacion e,2003-05-01,38,43,38,43,81
20201,ACHACACHI,estado nutricional en menores de 5 anos,clasificacion e,2003-05-01,32,16,32,16,48
20104,ACHOCALLA,estado nutricional en menores de 5 anos,clasificacion e,2003-05-01,1,6,1,6,7
30201,AIQUILE,estado nutricional en menores de 5 anos,clasificacion e,2003-05-01,28,38,28,38,66
31303,ALALAY,estado nutricional en menores de 5 anos,clasificacion e,2003-05-01,1,0,1,0,1
10404,ALCALA,estado nutricional en menores de 5 anos,clasificacion e,2003-05-01,10,28,10,28,38
20202,ANCORAIMES,estado nutricional en menores de 5 anos,clasificacion e,2003-05-01,11,22,11,22,33
30402,ANZALDO,estado nutricional en menores de 5 anos,clasificacion e,2003-05-01,3,4,3,4,7
20701,APOLO,estado nutricional en menores de 5 anos,clasificacion e,2003-05-01,1,5,1,5,6
51301,ARAMPAMPA,estado nutricional en menores de 5 anos,clasificacion e,2003-05-01,12,20,12,20,32
30403,ARBIETO,estado nutricional en menores de 5 anos,clasificacion e,2003-05-01,1,0,1,0,1
30601,ARQUE,estado nutricional en menores de 5 anos,clasificacion e,2003-05-01,22,23,22,23,45
50802,ATOCHA,estado nutricional en menores de 5 anos,clasificacion e,2003-05-01,9,56,9,56,65
20503,AUCAPATA,estado nutricional en menores de 5 anos,clasificacion e,2003-05-01,7,6,7,6,13
20502,AYATA,estado nutricional en menores de 5 anos,clasificacion e,2003-05-01,15,9,15,9,24
21303,AYO AYO,estado nutricional en menores de 5 anos,clasificacion e,2003-05-01,3,4,3,4,7
30301,AYOPAYA (V. DE INDEPENDENCIA),estado nutricional en menores de 5 anos,clasificacion e,2003-05-01,18,27,18,27,45
10201,AZURDUY,estado nutricional en menores de 5 anos,clasificacion e,2003-05-01,51,49,51,49,100
21203,BATALLAS,estado nutricional en menores de 5 anos,clasificacion e,2003-05-01,4,10,4,10,14
80802,BAURES,estado nutricional en menores de 5 anos,clasificacion e,2003-05-01,5,7,5,7,12
41202,BELEN DE ANDAMARCA,estado nutricional en menores de 5 anos,clasificacion e,2003-05-01,1,0,1,0,1
50104,BELEN DE URMIRI,estado nutricional en menores de 5 anos,clasificacion e,2003-05-01,2,1,2,1,3
90104,BELLA FLOR,estado nutricional en menores de 5 anos,clasificacion e,2003-05-01,1,4,1,4,5
60202,BERMEJO,estado nutricional en menores de 5 anos,clasificacion e,2003-05-01,3,3,3,3,6
50301,BETANZOS,estado nutricional en menores de 5 anos,clasificacion e,2003-05-01,114,135,114,135,249
31501,BOLIVAR,estado nutricional en menores de 5 anos,clasificacion e,2003-05-01,51,48,51,48,99
90103,BOLPEBRA,estado nutricional en menores de 5 anos,clasificacion e,2003-05-01,1,17,1,17,18
70707,BOYUIBE,estado nutricional en menores de 5 anos,clasificacion e,2003-05-01,3,1,3,1,4
70401,BUENA VISTA,estado nutricional en menores de 5 anos,clasificacion e,2003-05-01,3,8,3,8,11
70703,CABEZAS,estado nutricional en menores de 5 anos,clasificacion e,2003-05-01,9,3,9,3,12
20905,CAIROMA,estado nutricional en menores de 5 anos,clasificacion e,2003-05-01,7,14,7,14,21
51102,"CAIZA ""D""",estado nutricional en menores de 5 anos,clasificacion e,2003-05-01,37,27,37,27,64
21003,CAJUATA,estado nutricional en menores de 5 anos,clasificacion e,2003-05-01,17,15,17,15,32
20303,CALACOTO,estado nutricional en menores de 5 anos,clasificacion e,2003-05-01,2,3,2,3,5
21304,CALAMARCA,estado nutricional en menores de 5 anos,clasificacion e,2003-05-01,44,26,44,26,70
10701,CAMARGO,estado nutricional en menores de 5 anos,clasificacion e,2003-05-01,20,13,20,13,33
10901,CAMATAQUI (C. VILLA ABECIA),estado nutricional en menores de 5 anos,clasificacion e,2003-05-01,7,6,7,6,13
70706,CAMIRI,estado nutricional en menores de 5 anos,clasificacion e,2003-05-01,14,16,14,16,30
30701,CAPINOTA,estado nutricional en menores de 5 anos,clasificacion e,2003-05-01,19,11,19,11,30
20302,CAQUIAVIRI,estado nutricional en menores de 5 anos,clasificacion e,2003-05-01,16,10,16,10,26
40102,CARACOLLO,estado nutricional en menores de 5 anos,clasificacion e,2003-05-01,9,7,9,7,16
22001,CARANAVI,estado nutricional en menores de 5 anos,clasificacion e,2003-05-01,53,35,53,35,88
60302,CARAPARI,estado nutricional en menores de 5 anos,clasificacion e,2003-05-01,7,6,7,6,13
50702,CARIPUYO,estado nutricional en menores de 5 anos,clasificacion e,2003-05-01,34,35,34,35,69
21902,CATACORA,estado nutricional en menores de 5 anos,clasificacion e,2003-05-01,3,0,3,0,3
40201,CHALLAPATA,estado nutricional en menores de 5 anos,clasificacion e,2003-05-01,28,13,28,13,41
50302,CHAQUI,estado nutricional en menores de 5 anos,clasificacion e,2003-05-01,24,17,24,17,41
70702,CHARAGUA,estado nutricional en menores de 5 anos,clasificacion e,2003-05-01,24,24,24,24,48
20305,CHARAÃ‘A,estado nutricional en menores de 5 anos,clasificacion e,2003-05-01,1,0,1,0,1
50202,CHAYANTA,estado nutricional en menores de 5 anos,clasificacion e,2003-05-01,18,29,18,29,47
31204,CHIMORE,estado nutricional en menores de 5 anos,clasificacion e,2003-05-01,3,13,3,13,16
40302,CHOQUE COTA,estado nutricional en menores de 5 anos,clasificacion e,2003-05-01,1,0,1,0,1
21101,CHULUMANI (V. DE LA LIBERTAD),estado nutricional en menores de 5 anos,clasificacion e,2003-05-01,4,1,4,1,5
20501,CHUMA,estado nutricional en menores de 5 anos,clasificacion e,2003-05-01,13,5,13,5,18
30801,CLIZA,estado nutricional en menores de 5 anos,clasificacion e,2003-05-01,5,1,5,1,6
90101,COBIJA,estado nutricional en menores de 5 anos,clasificacion e,2003-05-01,9,11,9,11,20
30101,COCHABAMBA,estado nutricional en menores de 5 anos,clasificacion e,2003-05-01,134,99,134,99,233
30905,COLCAPIRHUA,estado nutricional en menores de 5 anos,clasificacion e,2003-05-01,1,0,1,0,1
50901,"COLCHA ""K""",estado nutricional en menores de 5 anos,clasificacion e,2003-05-01,15,9,15,9,24
31002,COLOMI,estado nutricional en menores de 5 anos,clasificacion e,2003-05-01,15,5,15,5,20
50401,COLQUECHACA,estado nutricional en menores de 5 anos,clasificacion e,2003-05-01,36,17,36,17,53
21306,COLQUENCHA,estado nutricional en menores de 5 anos,clasificacion e,2003-05-01,4,9,4,9,13
21004,COLQUIRI,estado nutricional en menores de 5 anos,clasificacion e,2003-05-01,26,15,26,15,41
20304,COMANCHE,estado nutricional en menores de 5 anos,clasificacion e,2003-05-01,7,1,7,1,8
71301,COMARAPA,estado nutricional en menores de 5 anos,clasificacion e,2003-05-01,15,9,15,9,24
20605,COMBAYA,estado nutricional en menores de 5 anos,clasificacion e,2003-05-01,2,1,2,1,3
71101,CONCEPCION,estado nutricional en menores de 5 anos,clasificacion e,2003-05-01,6,1,6,1,7
21701,COPACABANA,estado nutricional en menores de 5 anos,clasificacion e,2003-05-01,5,3,5,3,8
21402,CORIPATA,estado nutricional en menores de 5 anos,clasificacion e,2003-05-01,2,0,2,0,2
20301,CORO CORO,estado nutricional en menores de 5 anos,clasificacion e,2003-05-01,9,9,9,9,18
21401,COROICO,estado nutricional en menores de 5 anos,clasificacion e,2003-05-01,8,9,8,9,17
40301,CORQUE,estado nutricional en menores de 5 anos,clasificacion e,2003-05-01,6,1,6,1,7
50601,COTAGAITA,estado nutricional en menores de 5 anos,clasificacion e,2003-05-01,58,54,58,54,112
70102,COTOCA,estado nutricional en menores de 5 anos,clasificacion e,2003-05-01,2,1,2,1,3
70704,CUEVO,estado nutricional en menores de 5 anos,clasificacion e,2003-05-01,0,1,0,1,1
10902,CULPINA,estado nutricional en menores de 5 anos,clasificacion e,2003-05-01,50,42,50,42,92
40401,CURAHUARA DE CARANGAS,estado nutricional en menores de 5 anos,clasificacion e,2003-05-01,0,6,0,6,6
21602,CURVA,estado nutricional en menores de 5 anos,clasificacion e,2003-05-01,2,4,2,4,6
20105,EL ALTO,estado nutricional en menores de 5 anos,clasificacion e,2003-05-01,530,322,530,322,852
40103,EL CHORO,estado nutricional en menores de 5 anos,clasificacion e,2003-05-01,0,1,0,1,1
71503,EL PUENTE(STC),estado nutricional en menores de 5 anos,clasificacion e,2003-05-01,0,36,0,36,36
60502,EL PUENTE(TJA),estado nutricional en menores de 5 anos,clasificacion e,2003-05-01,21,36,21,36,57
70105,EL TORNO,estado nutricional en menores de 5 anos,clasificacion e,2003-05-01,6,9,6,9,15
10405,EL VILLAR,estado nutricional en menores de 5 anos,clasificacion e,2003-05-01,20,33,20,33,53
60601,ENTRE RIOS,estado nutricional en menores de 5 anos,clasificacion e,2003-05-01,3,5,3,5,8
41101,EUCALIPTUS,estado nutricional en menores de 5 anos,clasificacion e,2003-05-01,4,0,4,0,4
80402,EXALTACION,estado nutricional en menores de 5 anos,clasificacion e,2003-05-01,0,21,0,21,21
90203,FILADELFIA,estado nutricional en menores de 5 anos,clasificacion e,2003-05-01,2,5,2,5,7
71002,GENERAL SAAVEDRA,estado nutricional en menores de 5 anos,clasificacion e,2003-05-01,26,17,26,17,43
21601,GRAL. J.J. PEREZ (CHARAZANI),estado nutricional en menores de 5 anos,clasificacion e,2003-05-01,8,7,8,7,15
20602,GUANAY,estado nutricional en menores de 5 anos,clasificacion e,2003-05-01,32,54,32,54,86
20802,GUAQUI,estado nutricional en menores de 5 anos,clasificacion e,2003-05-01,2,2,2,2,4
80202,GUAYARAMERIN,estado nutricional en menores de 5 anos,clasificacion e,2003-05-01,31,21,31,21,52
70705,GUTIERREZ,estado nutricional en menores de 5 anos,clasificacion e,2003-05-01,30,31,30,31,61
10502,HUACARETA,estado nutricional en menores de 5 anos,clasificacion e,2003-05-01,25,16,25,16,41
11002,HUACAYA (VILLA DE HUACAYA),estado nutricional en menores de 5 anos,clasificacion e,2003-05-01,4,9,4,9,13
40701,HUANUNI,estado nutricional en menores de 5 anos,clasificacion e,2003-05-01,19,8,19,8,27
80803,HUARACAJE,estado nutricional en menores de 5 anos,clasificacion e,2003-05-01,0,1,0,1,1
41601,HUAYLLAMARCA,estado nutricional en menores de 5 anos,clasificacion e,2003-05-01,1,2,1,2,3
21005,ICHOCA,estado nutricional en menores de 5 anos,clasificacion e,2003-05-01,7,11,7,11,18
10304,ICLA,estado nutricional en menores de 5 anos,clasificacion e,2003-05-01,69,79,69,79,148
10703,INCAHUASI,estado nutricional en menores de 5 anos,clasificacion e,2003-05-01,47,20,47,20,67
21001,INQUISIVI,estado nutricional en menores de 5 anos,clasificacion e,2003-05-01,58,52,58,52,110
21102,IRUPANA (VILLA DE LANZA),estado nutricional en menores de 5 anos,clasificacion e,2003-05-01,11,23,11,23,34
21501,IXIAMAS,estado nutricional en menores de 5 anos,clasificacion e,2003-05-01,4,2,4,2,6
21105,LA ASUNTA,estado nutricional en menores de 5 anos,clasificacion e,2003-05-01,16,21,16,21,37
70104,LA GUARDIA,estado nutricional en menores de 5 anos,clasificacion e,2003-05-01,10,7,10,7,17
20101,LA PAZ,estado nutricional en menores de 5 anos,clasificacion e,2003-05-01,320,190,320,190,510
70701,LAGUNILLAS,estado nutricional en menores de 5 anos,clasificacion e,2003-05-01,10,9,10,9,19
21202,LAJA,estado nutricional en menores de 5 anos,clasificacion e,2003-05-01,3,30,3,30,33
10903,LAS CARRERAS,estado nutricional en menores de 5 anos,clasificacion e,2003-05-01,2,12,2,12,14
21006,LICOMA PAMPA,estado nutricional en menores de 5 anos,clasificacion e,2003-05-01,1,0,1,0,1
50203,LLALLAGUA,estado nutricional en menores de 5 anos,clasificacion e,2003-05-01,0,109,0,109,109
51401,LLICA,estado nutricional en menores de 5 anos,clasificacion e,2003-05-01,1,2,1,2,3
80601,LORETO,estado nutricional en menores de 5 anos,clasificacion e,2003-05-01,4,2,4,2,6
20901,LURIBAY,estado nutricional en menores de 5 anos,clasificacion e,2003-05-01,10,6,10,6,16
40702,MACHACAMARCA,estado nutricional en menores de 5 anos,clasificacion e,2003-05-01,7,1,7,1,8
11003,MACHARETI,estado nutricional en menores de 5 anos,clasificacion e,2003-05-01,12,26,12,26,38
80801,MAGDALENA,estado nutricional en menores de 5 anos,clasificacion e,2003-05-01,3,4,3,4,7
70903,MAIRANA,estado nutricional en menores de 5 anos,clasificacion e,2003-05-01,7,0,7,0,7
20904,MALLA,estado nutricional en menores de 5 anos,clasificacion e,2003-05-01,1,4,1,4,5
20103,MECAPACA,estado nutricional en menores de 5 anos,clasificacion e,2003-05-01,0,3,0,3,3
71003,MINEROS,estado nutricional en menores de 5 anos,clasificacion e,2003-05-01,20,14,20,14,34
31301,MIZQUE,estado nutricional en menores de 5 anos,clasificacion e,2003-05-01,15,35,15,35,50
20402,MOCOMOCO,estado nutricional en menores de 5 anos,clasificacion e,2003-05-01,17,17,17,17,34
10303,MOJOCOYA,estado nutricional en menores de 5 anos,clasificacion e,2003-05-01,23,11,23,11,34
10501,MONTEAGUDO,estado nutricional en menores de 5 anos,clasificacion e,2003-05-01,46,35,46,35,81
71001,MONTERO,estado nutricional en menores de 5 anos,clasificacion e,2003-05-01,71,35,71,35,106
70803,MORO MORO,estado nutricional en menores de 5 anos,clasificacion e,2003-05-01,4,7,4,7,11
30302,MOROCHATA,estado nutricional en menores de 5 anos,clasificacion e,2003-05-01,68,48,68,48,116
90401,NACEBE (SANTA ROSA DEL ABUNA),estado nutricional en menores de 5 anos,clasificacion e,2003-05-01,1,2,1,2,3
20307,NAZACARA DE PACAJES,estado nutricional en menores de 5 anos,clasificacion e,2003-05-01,0,1,0,1,1
50404,OCURI,estado nutricional en menores de 5 anos,clasificacion e,2003-05-01,43,29,43,29,72
30203,OMEREQUE,estado nutricional en menores de 5 anos,clasificacion e,2003-05-01,1,1,1,1,2
40101,ORURO,estado nutricional en menores de 5 anos,clasificacion e,2003-05-01,111,73,111,73,184
60201,PADCAYA,estado nutricional en menores de 5 anos,clasificacion e,2003-05-01,13,11,13,11,24
10401,PADILLA,estado nutricional en menores de 5 anos,clasificacion e,2003-05-01,41,52,41,52,93
70502,PAILON,estado nutricional en menores de 5 anos,clasificacion e,2003-05-01,12,5,12,5,17
20102,PALCA,estado nutricional en menores de 5 anos,clasificacion e,2003-05-01,20,27,20,27,47
21104,PALOS BLANCOS,estado nutricional en menores de 5 anos,clasificacion e,2003-05-01,27,20,27,20,47
40802,PAMPA AULLAGAS,estado nutricional en menores de 5 anos,clasificacion e,2003-05-01,2,3,2,3,5
70902,PAMPA GRANDE,estado nutricional en menores de 5 anos,clasificacion e,2003-05-01,4,3,4,3,7
21802,PAPEL PAMPA,estado nutricional en menores de 5 anos,clasificacion e,2003-05-01,3,4,3,4,7
30202,PASORAPA,estado nutricional en menores de 5 anos,clasificacion e,2003-05-01,8,4,8,4,12
21305,PATACAMAYA,estado nutricional en menores de 5 anos,clasificacion e,2003-05-01,26,8,26,8,34
40602,PAZÃ‘A,estado nutricional en menores de 5 anos,clasificacion e,2003-05-01,4,1,4,1,5
20702,PELECHUCO,estado nutricional en menores de 5 anos,clasificacion e,2003-05-01,8,17,8,17,25
50403,POCOATA,estado nutricional en menores de 5 anos,clasificacion e,2003-05-01,47,65,47,65,112
31203,POCONA,estado nutricional en menores de 5 anos,clasificacion e,2003-05-01,14,4,14,4,18
31202,POJO (CBBA),estado nutricional en menores de 5 anos,clasificacion e,2003-05-01,40,42,40,42,82
40601,POOPO,estado nutricional en menores de 5 anos,clasificacion e,2003-05-01,1,3,1,3,4
51203,PORCO,estado nutricional en menores de 5 anos,clasificacion e,2003-05-01,3,1,3,1,4
10103,POROMA,estado nutricional en menores de 5 anos,clasificacion e,2003-05-01,78,96,78,96,174
70103,PORONGO,estado nutricional en menores de 5 anos,clasificacion e,2003-05-01,7,7,7,7,14
70601,PORTACHUELO,estado nutricional en menores de 5 anos,clasificacion e,2003-05-01,9,9,9,9,18
90102,PORVENIR,estado nutricional en menores de 5 anos,clasificacion e,2003-05-01,1,0,1,0,1
70804,POSTRER VALLE,estado nutricional en menores de 5 anos,clasificacion e,2003-05-01,2,1,2,1,3
50101,POTOSI,estado nutricional en menores de 5 anos,clasificacion e,2003-05-01,175,111,175,111,286
10302,PRESTO,estado nutricional en menores de 5 anos,clasificacion e,2003-05-01,34,39,34,39,73
21201,PUCARANI,estado nutricional en menores de 5 anos,clasificacion e,2003-05-01,11,1,11,1,12
20401,PUERTO ACOSTA,estado nutricional en menores de 5 anos,clasificacion e,2003-05-01,34,25,34,25,59
20403,PUERTO CARABUCO,estado nutricional en menores de 5 anos,clasificacion e,2003-05-01,22,20,22,20,42
90301,PUERTO GONZALO MORENO,estado nutricional en menores de 5 anos,clasificacion e,2003-05-01,4,1,4,1,5
21204,PUERTO PEREZ,estado nutricional en menores de 5 anos,clasificacion e,2003-05-01,0,3,0,3,3
71402,PUERTO QUIJARRO,estado nutricional en menores de 5 anos,clasificacion e,2003-05-01,8,0,8,0,8
90201,PUERTO RICO,estado nutricional en menores de 5 anos,clasificacion e,2003-05-01,2,2,2,2,4
80703,PUERTO SILES,estado nutricional en menores de 5 anos,clasificacion e,2003-05-01,0,2,0,2,2
71401,PUERTO SUAREZ,estado nutricional en menores de 5 anos,clasificacion e,2003-05-01,7,3,7,3,10
31205,PUERTO VILLARROEL,estado nutricional en menores de 5 anos,clasificacion e,2003-05-01,67,39,67,39,106
51101,PUNA,estado nutricional en menores de 5 anos,clasificacion e,2003-05-01,77,103,77,103,180
20604,QUIABAYA,estado nutricional en menores de 5 anos,clasificacion e,2003-05-01,2,9,2,9,11
30901,QUILLACOLLO,estado nutricional en menores de 5 anos,clasificacion e,2003-05-01,29,26,29,26,55
21002,QUIME,estado nutricional en menores de 5 anos,clasificacion e,2003-05-01,18,27,18,27,45
70904,QUIRUSILLAS,estado nutricional en menores de 5 anos,clasificacion e,2003-05-01,0,2,0,2,2
50402,RAVELO,estado nutricional en menores de 5 anos,clasificacion e,2003-05-01,95,69,95,69,164
80301,REYES,estado nutricional en menores de 5 anos,clasificacion e,2003-05-01,18,18,18,18,36
80201,RIBERALTA,estado nutricional en menores de 5 anos,clasificacion e,2003-05-01,76,66,76,66,142
70503,ROBORE,estado nutricional en menores de 5 anos,clasificacion e,2003-05-01,7,7,7,7,14
80304,RURRENABAQUE,estado nutricional en menores de 5 anos,clasificacion e,2003-05-01,10,5,10,5,15
31001,SACABA,estado nutricional en menores de 5 anos,clasificacion e,2003-05-01,71,41,71,41,112
30404,SACABAMBA,estado nutricional en menores de 5 anos,clasificacion e,2003-05-01,4,2,4,2,6
50701,SACACA,estado nutricional en menores de 5 anos,clasificacion e,2003-05-01,92,102,92,102,194
71302,SAIPINA,estado nutricional en menores de 5 anos,clasificacion e,2003-05-01,2,1,2,1,3
40801,SALINAS DE GARCI MENDOZA,estado nutricional en menores de 5 anos,clasificacion e,2003-05-01,3,2,3,2,5
70901,SAMAIPATA,estado nutricional en menores de 5 anos,clasificacion e,2003-05-01,1,0,1,0,1
80602,SAN ANDRES,estado nutricional en menores de 5 anos,clasificacion e,2003-05-01,2,1,2,1,3
51003,SAN ANTONIO DE ESMORUCO,estado nutricional en menores de 5 anos,clasificacion e,2003-05-01,2,4,2,4,6
71105,SAN ANTONIO DE LOMERIO,estado nutricional en menores de 5 anos,clasificacion e,2003-05-01,17,28,17,28,45
80302,SAN BORJA,estado nutricional en menores de 5 anos,clasificacion e,2003-05-01,75,71,75,71,146
21502,SAN BUENA VENTURA,estado nutricional en menores de 5 anos,clasificacion e,2003-05-01,14,5,14,5,19
70402,SAN CARLOS,estado nutricional en menores de 5 anos,clasificacion e,2003-05-01,15,12,15,12,27
80501,SAN IGNACIO,estado nutricional en menores de 5 anos,clasificacion e,2003-05-01,17,16,17,16,33
70301,SAN IGNACIO DE VELASCO,estado nutricional en menores de 5 anos,clasificacion e,2003-05-01,52,57,52,57,109
80102,SAN JAVIER(BNI),estado nutricional en menores de 5 anos,clasificacion e,2003-05-01,0,1,0,1,1
71102,SAN JAVIER(STC),estado nutricional en menores de 5 anos,clasificacion e,2003-05-01,6,4,6,4,10
80701,SAN JOAQUIN,estado nutricional en menores de 5 anos,clasificacion e,2003-05-01,2,0,2,0,2
70501,SAN JOSE DE CHIQUITOS,estado nutricional en menores de 5 anos,clasificacion e,2003-05-01,9,3,9,3,12
71104,SAN JULIAN,estado nutricional en menores de 5 anos,clasificacion e,2003-05-01,66,54,66,54,120
90302,SAN LORENZO(PND),estado nutricional en menores de 5 anos,clasificacion e,2003-05-01,4,0,4,0,4
60501,SAN LORENZO(TJA),estado nutricional en menores de 5 anos,clasificacion e,2003-05-01,8,15,8,15,23
10702,SAN LUCAS,estado nutricional en menores de 5 anos,clasificacion e,2003-05-01,129,119,129,119,248
70302,SAN MIGUEL DE VELASCO,estado nutricional en menores de 5 anos,clasificacion e,2003-05-01,19,21,19,21,40
51001,SAN PABLO DE LIPEZ,estado nutricional en menores de 5 anos,clasificacion e,2003-05-01,3,7,3,7,10
50501,SAN PEDRO DE BUENA VISTA,estado nutricional en menores de 5 anos,clasificacion e,2003-05-01,45,75,45,75,120
21801,SAN PEDRO DE CURAHUARA,estado nutricional en menores de 5 anos,clasificacion e,2003-05-01,0,1,0,1,1
50902,SAN PEDRO DE QUEMES,estado nutricional en menores de 5 anos,clasificacion e,2003-05-01,1,0,1,0,1
21702,SAN PEDRO DE TIQUINA,estado nutricional en menores de 5 anos,clasificacion e,2003-05-01,1,0,1,0,1
70303,SAN RAFAEL,estado nutricional en menores de 5 anos,clasificacion e,2003-05-01,9,10,9,10,19
80702,SAN RAMON,estado nutricional en menores de 5 anos,clasificacion e,2003-05-01,1,0,1,0,1
80702,SAN RAMON,estado nutricional en menores de 5 anos,clasificacion e,2003-05-01,2,1,2,1,3
80401,SANTA ANA,estado nutricional en menores de 5 anos,clasificacion e,2003-05-01,0,4,0,4,4
70101,SANTA CRUZ DE LA SIERRA,estado nutricional en menores de 5 anos,clasificacion e,2003-05-01,69,30,69,30,99
80303,SANTA ROSA,estado nutricional en menores de 5 anos,clasificacion e,2003-05-01,0,3,0,3,3
70602,SANTA ROSA DEL SARA,estado nutricional en menores de 5 anos,clasificacion e,2003-05-01,0,1,0,1,1
20308,SANTIAGO DE CALLAPA,estado nutricional en menores de 5 anos,clasificacion e,2003-05-01,5,10,5,10,15
41401,SANTIAGO DE HUARI,estado nutricional en menores de 5 anos,clasificacion e,2003-05-01,5,2,5,2,7
21901,SANTIAGO DE MACHACA,estado nutricional en menores de 5 anos,clasificacion e,2003-05-01,1,2,1,2,3
30702,SANTIVAÃ‘ES,estado nutricional en menores de 5 anos,clasificacion e,2003-05-01,3,5,3,5,8
40202,SANTUARIO DE QUILLACAS,estado nutricional en menores de 5 anos,clasificacion e,2003-05-01,0,2,0,2,2
20902,SAPAHAQUI,estado nutricional en menores de 5 anos,clasificacion e,2003-05-01,15,9,15,9,24
90303,SENA,estado nutricional en menores de 5 anos,clasificacion e,2003-05-01,2,0,2,0,2
21301,SICA SICA (VILLA AROMA),estado nutricional en menores de 5 anos,clasificacion e,2003-05-01,28,22,28,22,50
30703,SICAYA,estado nutricional en menores de 5 anos,clasificacion e,2003-05-01,6,1,6,1,7
30902,SIPE SIPE,estado nutricional en menores de 5 anos,clasificacion e,2003-05-01,19,10,19,10,29
10403,SOPACHUY,estado nutricional en menores de 5 anos,clasificacion e,2003-05-01,26,28,26,28,54
20601,SORATA,estado nutricional en menores de 5 anos,clasificacion e,2003-05-01,11,15,11,15,26
10101,SUCRE,estado nutricional en menores de 5 anos,clasificacion e,2003-05-01,158,156,158,156,314
20603,TACACOMA,estado nutricional en menores de 5 anos,clasificacion e,2003-05-01,2,2,2,2,4
50303,TACOBAMBA,estado nutricional en menores de 5 anos,clasificacion e,2003-05-01,26,37,26,37,63
30602,TACOPAYA,estado nutricional en menores de 5 anos,clasificacion e,2003-05-01,27,34,27,34,61
51402,TAHUA,estado nutricional en menores de 5 anos,clasificacion e,2003-05-01,0,1,0,1,1
31101,TAPACARI,estado nutricional en menores de 5 anos,clasificacion e,2003-05-01,60,41,60,41,101
10601,TARABUCO,estado nutricional en menores de 5 anos,clasificacion e,2003-05-01,124,115,124,115,239
30401,TARATA,estado nutricional en menores de 5 anos,clasificacion e,2003-05-01,1,134,1,134,135
60101,TARIJA,estado nutricional en menores de 5 anos,clasificacion e,2003-05-01,54,39,54,39,93
10202,TARVITA,estado nutricional en menores de 5 anos,clasificacion e,2003-05-01,40,77,40,77,117
20803,TIAWANACU,estado nutricional en menores de 5 anos,clasificacion e,2003-05-01,14,7,14,7,21
50102,TINGUIPAYA,estado nutricional en menores de 5 anos,clasificacion e,2003-05-01,23,36,23,36,59
20606,TIPUANI,estado nutricional en menores de 5 anos,clasificacion e,2003-05-01,8,3,8,3,11
30903,TIQUIPAYA,estado nutricional en menores de 5 anos,clasificacion e,2003-05-01,20,8,20,8,28
31601,TIRAQUE (CBBA),estado nutricional en menores de 5 anos,clasificacion e,2003-05-01,29,12,29,12,41
21703,TITO YUPANQUI (PARQUIPUJIO),estado nutricional en menores de 5 anos,clasificacion e,2003-05-01,0,2,0,2,2
30802,TOCO,estado nutricional en menores de 5 anos,clasificacion e,2003-05-01,0,5,0,5,5
30803,TOLATA,estado nutricional en menores de 5 anos,clasificacion e,2003-05-01,2,6,2,6,8
41001,TOLEDO,estado nutricional en menores de 5 anos,clasificacion e,2003-05-01,1,0,1,0,1
51202,TOMAVE,estado nutricional en menores de 5 anos,clasificacion e,2003-05-01,22,26,22,26,48
10402,TOMINA,estado nutricional en menores de 5 anos,clasificacion e,2003-05-01,55,63,55,63,118
50502,TORO TORO,estado nutricional en menores de 5 anos,clasificacion e,2003-05-01,49,32,49,32,81
31201,TOTORA(CBBA),estado nutricional en menores de 5 anos,clasificacion e,2003-05-01,17,7,17,7,24
41301,TOTORA(ORR),estado nutricional en menores de 5 anos,clasificacion e,2003-05-01,3,8,3,8,11
70802,TRIGAL,estado nutricional en menores de 5 anos,clasificacion e,2003-05-01,2,0,2,0,2
80101,TRINIDAD,estado nutricional en menores de 5 anos,clasificacion e,2003-05-01,41,33,41,33,74
50801,TUPIZA,estado nutricional en menores de 5 anos,clasificacion e,2003-05-01,21,77,21,77,98
40402,TURCO,estado nutricional en menores de 5 anos,clasificacion e,2003-05-01,1,1,1,1,2
21302,UMALA,estado nutricional en menores de 5 anos,clasificacion e,2003-05-01,1,5,1,5,6
50201,UNCIA,estado nutricional en menores de 5 anos,clasificacion e,2003-05-01,7,5,7,5,12
60401,URIONDO (A. CONCEPCION),estado nutricional en menores de 5 anos,clasificacion e,2003-05-01,2,7,2,7,9
71502,URUBICHA,estado nutricional en menores de 5 anos,clasificacion e,2003-05-01,1,2,1,2,3
51201,UYUNI,estado nutricional en menores de 5 anos,clasificacion e,2003-05-01,14,22,14,22,36
70801,VALLEGRANDE,estado nutricional en menores de 5 anos,clasificacion e,2003-05-01,25,16,25,16,41
20801,VIACHA,estado nutricional en menores de 5 anos,clasificacion e,2003-05-01,30,22,30,22,52
31302,VILA VILA,estado nutricional en menores de 5 anos,clasificacion e,2003-05-01,18,17,18,17,35
60303,VILLA MONTES,estado nutricional en menores de 5 anos,clasificacion e,2003-05-01,20,14,20,14,34
10801,VILLA SERRANO,estado nutricional en menores de 5 anos,clasificacion e,2003-05-01,33,37,33,37,70
31003,VILLA TUNARI,estado nutricional en menores de 5 anos,clasificacion e,2003-05-01,42,41,42,41,83
11001,VILLA VACA GUZMAN (MUYUPAMPA),estado nutricional en menores de 5 anos,clasificacion e,2003-05-01,6,21,6,21,27
51501,VILLAZON,estado nutricional en menores de 5 anos,clasificacion e,2003-05-01,22,31,22,31,53
50602,VITICHI,estado nutricional en menores de 5 anos,clasificacion e,2003-05-01,34,37,34,37,71
20306,WALDO BALLIVIAN,estado nutricional en menores de 5 anos,clasificacion e,2003-05-01,4,1,4,1,5
70201,WARNES,estado nutricional en menores de 5 anos,clasificacion e,2003-05-01,3,0,3,0,3
20903,YACO,estado nutricional en menores de 5 anos,clasificacion e,2003-05-01,2,13,2,13,15
60301,YACUIBA,estado nutricional en menores de 5 anos,clasificacion e,2003-05-01,14,14,14,14,28
10602,YAMPARAEZ,estado nutricional en menores de 5 anos,clasificacion e,2003-05-01,77,53,77,53,130
21103,YANACACHI,estado nutricional en menores de 5 anos,clasificacion e,2003-05-01,0,4,0,4,4
70403,YAPACANI,estado nutricional en menores de 5 anos,clasificacion e,2003-05-01,42,34,42,34,76
50103,YOCALLA,estado nutricional en menores de 5 anos,clasificacion e,2003-05-01,8,8,8,8,16
10102,YOTALA,estado nutricional en menores de 5 anos,clasificacion e,2003-05-01,28,38,28,38,66
60402,YUNCHARA,estado nutricional en menores de 5 anos,clasificacion e,2003-05-01,6,6,6,6,12
10301,ZUDAÃ‘EZ,estado nutricional en menores de 5 anos,clasificacion e,2003-05-01,24,35,24,35,59
51302,ACACIO,estado nutricional en menores de 5 anos,clasificacion e,2003-06-01,42,39,42,39,81
20201,ACHACACHI,estado nutricional en menores de 5 anos,clasificacion e,2003-06-01,12,18,12,18,30
20104,ACHOCALLA,estado nutricional en menores de 5 anos,clasificacion e,2003-06-01,2,5,2,5,7
30201,AIQUILE,estado nutricional en menores de 5 anos,clasificacion e,2003-06-01,8,11,8,11,19
31303,ALALAY,estado nutricional en menores de 5 anos,clasificacion e,2003-06-01,5,1,5,1,6
10404,ALCALA,estado nutricional en menores de 5 anos,clasificacion e,2003-06-01,7,27,7,27,34
20202,ANCORAIMES,estado nutricional en menores de 5 anos,clasificacion e,2003-06-01,11,14,11,14,25
41201,ANDAMARCA,estado nutricional en menores de 5 anos,clasificacion e,2003-06-01,1,2,1,2,3
30402,ANZALDO,estado nutricional en menores de 5 anos,clasificacion e,2003-06-01,9,18,9,18,27
20701,APOLO,estado nutricional en menores de 5 anos,clasificacion e,2003-06-01,9,11,9,11,20
51301,ARAMPAMPA,estado nutricional en menores de 5 anos,clasificacion e,2003-06-01,23,33,23,33,56
30501,ARANI,estado nutricional en menores de 5 anos,clasificacion e,2003-06-01,3,6,3,6,9
30403,ARBIETO,estado nutricional en menores de 5 anos,clasificacion e,2003-06-01,2,0,2,0,2
30601,ARQUE,estado nutricional en menores de 5 anos,clasificacion e,2003-06-01,19,13,19,13,32
71501,ASCENCION DE GUARAYOS,estado nutricional en menores de 5 anos,clasificacion e,2003-06-01,67,64,67,64,131
50802,ATOCHA,estado nutricional en menores de 5 anos,clasificacion e,2003-06-01,3,38,3,38,41
20503,AUCAPATA,estado nutricional en menores de 5 anos,clasificacion e,2003-06-01,10,4,10,4,14
20502,AYATA,estado nutricional en menores de 5 anos,clasificacion e,2003-06-01,9,9,9,9,18
21303,AYO AYO,estado nutricional en menores de 5 anos,clasificacion e,2003-06-01,4,4,4,4,8
30301,AYOPAYA (V. DE INDEPENDENCIA),estado nutricional en menores de 5 anos,clasificacion e,2003-06-01,22,22,22,22,44
10201,AZURDUY,estado nutricional en menores de 5 anos,clasificacion e,2003-06-01,46,55,46,55,101
21203,BATALLAS,estado nutricional en menores de 5 anos,clasificacion e,2003-06-01,4,9,4,9,13
80802,BAURES,estado nutricional en menores de 5 anos,clasificacion e,2003-06-01,3,2,3,2,5
41202,BELEN DE ANDAMARCA,estado nutricional en menores de 5 anos,clasificacion e,2003-06-01,1,2,1,2,3
50104,BELEN DE URMIRI,estado nutricional en menores de 5 anos,clasificacion e,2003-06-01,2,2,2,2,4
90104,BELLA FLOR,estado nutricional en menores de 5 anos,clasificacion e,2003-06-01,8,8,8,8,16
60202,BERMEJO,estado nutricional en menores de 5 anos,clasificacion e,2003-06-01,4,2,4,2,6
50301,BETANZOS,estado nutricional en menores de 5 anos,clasificacion e,2003-06-01,113,93,113,93,206
31501,BOLIVAR,estado nutricional en menores de 5 anos,clasificacion e,2003-06-01,27,30,27,30,57
90103,BOLPEBRA,estado nutricional en menores de 5 anos,clasificacion e,2003-06-01,0,4,0,4,4
70707,BOYUIBE,estado nutricional en menores de 5 anos,clasificacion e,2003-06-01,1,1,1,1,2
70401,BUENA VISTA,estado nutricional en menores de 5 anos,clasificacion e,2003-06-01,8,8,8,8,16
70703,CABEZAS,estado nutricional en menores de 5 anos,clasificacion e,2003-06-01,6,9,6,9,15
20905,CAIROMA,estado nutricional en menores de 5 anos,clasificacion e,2003-06-01,25,34,25,34,59
51102,"CAIZA ""D""",estado nutricional en menores de 5 anos,clasificacion e,2003-06-01,28,15,28,15,43
21003,CAJUATA,estado nutricional en menores de 5 anos,clasificacion e,2003-06-01,5,18,5,18,23
20303,CALACOTO,estado nutricional en menores de 5 anos,clasificacion e,2003-06-01,2,2,2,2,4
21304,CALAMARCA,estado nutricional en menores de 5 anos,clasificacion e,2003-06-01,50,26,50,26,76
10701,CAMARGO,estado nutricional en menores de 5 anos,clasificacion e,2003-06-01,16,17,16,17,33
10901,CAMATAQUI (C. VILLA ABECIA),estado nutricional en menores de 5 anos,clasificacion e,2003-06-01,0,4,0,4,4
70706,CAMIRI,estado nutricional en menores de 5 anos,clasificacion e,2003-06-01,21,15,21,15,36
30701,CAPINOTA,estado nutricional en menores de 5 anos,clasificacion e,2003-06-01,15,12,15,12,27
20302,CAQUIAVIRI,estado nutricional en menores de 5 anos,clasificacion e,2003-06-01,8,7,8,7,15
40102,CARACOLLO,estado nutricional en menores de 5 anos,clasificacion e,2003-06-01,13,7,13,7,20
22001,CARANAVI,estado nutricional en menores de 5 anos,clasificacion e,2003-06-01,23,27,23,27,50
60302,CARAPARI,estado nutricional en menores de 5 anos,clasificacion e,2003-06-01,7,2,7,2,9
50702,CARIPUYO,estado nutricional en menores de 5 anos,clasificacion e,2003-06-01,30,31,30,31,61
40201,CHALLAPATA,estado nutricional en menores de 5 anos,clasificacion e,2003-06-01,36,25,36,25,61
50302,CHAQUI,estado nutricional en menores de 5 anos,clasificacion e,2003-06-01,16,3,16,3,19
70702,CHARAGUA,estado nutricional en menores de 5 anos,clasificacion e,2003-06-01,18,10,18,10,28
50202,CHAYANTA,estado nutricional en menores de 5 anos,clasificacion e,2003-06-01,18,24,18,24,42
31204,CHIMORE,estado nutricional en menores de 5 anos,clasificacion e,2003-06-01,3,1,3,1,4
40302,CHOQUE COTA,estado nutricional en menores de 5 anos,clasificacion e,2003-06-01,2,1,2,1,3
21101,CHULUMANI (V. DE LA LIBERTAD),estado nutricional en menores de 5 anos,clasificacion e,2003-06-01,0,2,0,2,2
20501,CHUMA,estado nutricional en menores de 5 anos,clasificacion e,2003-06-01,16,12,16,12,28
30801,CLIZA,estado nutricional en menores de 5 anos,clasificacion e,2003-06-01,3,3,3,3,6
90101,COBIJA,estado nutricional en menores de 5 anos,clasificacion e,2003-06-01,7,10,7,10,17
30101,COCHABAMBA,estado nutricional en menores de 5 anos,clasificacion e,2003-06-01,128,77,128,77,205
40902,COIPASA,estado nutricional en menores de 5 anos,clasificacion e,2003-06-01,1,0,1,0,1
30905,COLCAPIRHUA,estado nutricional en menores de 5 anos,clasificacion e,2003-06-01,4,1,4,1,5
50901,"COLCHA ""K""",estado nutricional en menores de 5 anos,clasificacion e,2003-06-01,6,8,6,8,14
31002,COLOMI,estado nutricional en menores de 5 anos,clasificacion e,2003-06-01,18,17,18,17,35
50401,COLQUECHACA,estado nutricional en menores de 5 anos,clasificacion e,2003-06-01,70,41,70,41,111
21306,COLQUENCHA,estado nutricional en menores de 5 anos,clasificacion e,2003-06-01,2,6,2,6,8
21004,COLQUIRI,estado nutricional en menores de 5 anos,clasificacion e,2003-06-01,14,18,14,18,32
20304,COMANCHE,estado nutricional en menores de 5 anos,clasificacion e,2003-06-01,1,0,1,0,1
71301,COMARAPA,estado nutricional en menores de 5 anos,clasificacion e,2003-06-01,10,7,10,7,17
20605,COMBAYA,estado nutricional en menores de 5 anos,clasificacion e,2003-06-01,4,2,4,2,6
21701,COPACABANA,estado nutricional en menores de 5 anos,clasificacion e,2003-06-01,10,3,10,3,13
21402,CORIPATA,estado nutricional en menores de 5 anos,clasificacion e,2003-06-01,1,1,1,1,2
20301,CORO CORO,estado nutricional en menores de 5 anos,clasificacion e,2003-06-01,6,7,6,7,13
21401,COROICO,estado nutricional en menores de 5 anos,clasificacion e,2003-06-01,5,7,5,7,12
40301,CORQUE,estado nutricional en menores de 5 anos,clasificacion e,2003-06-01,0,4,0,4,4
50601,COTAGAITA,estado nutricional en menores de 5 anos,clasificacion e,2003-06-01,68,55,68,55,123
70102,COTOCA,estado nutricional en menores de 5 anos,clasificacion e,2003-06-01,1,2,1,2,3
31405,CUCHUMUELA (V. G. VILLARROEL),estado nutricional en menores de 5 anos,clasificacion e,2003-06-01,3,1,3,1,4
70704,CUEVO,estado nutricional en menores de 5 anos,clasificacion e,2003-06-01,1,4,1,4,5
10902,CULPINA,estado nutricional en menores de 5 anos,clasificacion e,2003-06-01,59,47,59,47,106
40401,CURAHUARA DE CARANGAS,estado nutricional en menores de 5 anos,clasificacion e,2003-06-01,0,7,0,7,7
21602,CURVA,estado nutricional en menores de 5 anos,clasificacion e,2003-06-01,1,2,1,2,3
20804,DESAGUADERO,estado nutricional en menores de 5 anos,clasificacion e,2003-06-01,3,3,3,3,6
20105,EL ALTO,estado nutricional en menores de 5 anos,clasificacion e,2003-06-01,434,285,434,285,719
40103,EL CHORO,estado nutricional en menores de 5 anos,clasificacion e,2003-06-01,1,0,1,0,1
71503,EL PUENTE(STC),estado nutricional en menores de 5 anos,clasificacion e,2003-06-01,6,19,6,19,25
60502,EL PUENTE(TJA),estado nutricional en menores de 5 anos,clasificacion e,2003-06-01,9,13,9,13,22
70105,EL TORNO,estado nutricional en menores de 5 anos,clasificacion e,2003-06-01,6,6,6,6,12
10405,EL VILLAR,estado nutricional en menores de 5 anos,clasificacion e,2003-06-01,25,24,25,24,49
60601,ENTRE RIOS,estado nutricional en menores de 5 anos,clasificacion e,2003-06-01,10,13,10,13,23
41101,EUCALIPTUS,estado nutricional en menores de 5 anos,clasificacion e,2003-06-01,5,2,5,2,7
80402,EXALTACION,estado nutricional en menores de 5 anos,clasificacion e,2003-06-01,0,8,0,8,8
90203,FILADELFIA,estado nutricional en menores de 5 anos,clasificacion e,2003-06-01,3,1,3,1,4
71002,GENERAL SAAVEDRA,estado nutricional en menores de 5 anos,clasificacion e,2003-06-01,27,17,27,17,44
21601,GRAL. J.J. PEREZ (CHARAZANI),estado nutricional en menores de 5 anos,clasificacion e,2003-06-01,8,18,8,18,26
20602,GUANAY,estado nutricional en menores de 5 anos,clasificacion e,2003-06-01,38,26,38,26,64
20802,GUAQUI,estado nutricional en menores de 5 anos,clasificacion e,2003-06-01,3,0,3,0,3
80202,GUAYARAMERIN,estado nutricional en menores de 5 anos,clasificacion e,2003-06-01,44,26,44,26,70
70705,GUTIERREZ,estado nutricional en menores de 5 anos,clasificacion e,2003-06-01,22,44,22,44,66
10502,HUACARETA,estado nutricional en menores de 5 anos,clasificacion e,2003-06-01,10,8,10,8,18
11002,HUACAYA (VILLA DE HUACAYA),estado nutricional en menores de 5 anos,clasificacion e,2003-06-01,1,2,1,2,3
40501,HUACHACALLA,estado nutricional en menores de 5 anos,clasificacion e,2003-06-01,1,0,1,0,1
40701,HUANUNI,estado nutricional en menores de 5 anos,clasificacion e,2003-06-01,27,9,27,9,36
80803,HUARACAJE,estado nutricional en menores de 5 anos,clasificacion e,2003-06-01,4,1,4,1,5
41601,HUAYLLAMARCA,estado nutricional en menores de 5 anos,clasificacion e,2003-06-01,1,0,1,0,1
21005,ICHOCA,estado nutricional en menores de 5 anos,clasificacion e,2003-06-01,2,3,2,3,5
10304,ICLA,estado nutricional en menores de 5 anos,clasificacion e,2003-06-01,44,62,44,62,106
10703,INCAHUASI,estado nutricional en menores de 5 anos,clasificacion e,2003-06-01,41,24,41,24,65
21001,INQUISIVI,estado nutricional en menores de 5 anos,clasificacion e,2003-06-01,30,35,30,35,65
21102,IRUPANA (VILLA DE LANZA),estado nutricional en menores de 5 anos,clasificacion e,2003-06-01,5,11,5,11,16
21501,IXIAMAS,estado nutricional en menores de 5 anos,clasificacion e,2003-06-01,7,3,7,3,10
21105,LA ASUNTA,estado nutricional en menores de 5 anos,clasificacion e,2003-06-01,17,15,17,15,32
70104,LA GUARDIA,estado nutricional en menores de 5 anos,clasificacion e,2003-06-01,14,6,14,6,20
20101,LA PAZ,estado nutricional en menores de 5 anos,clasificacion e,2003-06-01,262,162,262,162,424
70701,LAGUNILLAS,estado nutricional en menores de 5 anos,clasificacion e,2003-06-01,7,4,7,4,11
21202,LAJA,estado nutricional en menores de 5 anos,clasificacion e,2003-06-01,4,3,4,3,7
10903,LAS CARRERAS,estado nutricional en menores de 5 anos,clasificacion e,2003-06-01,3,8,3,8,11
21006,LICOMA PAMPA,estado nutricional en menores de 5 anos,clasificacion e,2003-06-01,0,3,0,3,3
50203,LLALLAGUA,estado nutricional en menores de 5 anos,clasificacion e,2003-06-01,7,80,7,80,87
51401,LLICA,estado nutricional en menores de 5 anos,clasificacion e,2003-06-01,1,1,1,1,2
80601,LORETO,estado nutricional en menores de 5 anos,clasificacion e,2003-06-01,1,0,1,0,1
20901,LURIBAY,estado nutricional en menores de 5 anos,clasificacion e,2003-06-01,31,19,31,19,50
40702,MACHACAMARCA,estado nutricional en menores de 5 anos,clasificacion e,2003-06-01,4,2,4,2,6
11003,MACHARETI,estado nutricional en menores de 5 anos,clasificacion e,2003-06-01,6,15,6,15,21
80801,MAGDALENA,estado nutricional en menores de 5 anos,clasificacion e,2003-06-01,5,4,5,4,9
70903,MAIRANA,estado nutricional en menores de 5 anos,clasificacion e,2003-06-01,4,2,4,2,6
20904,MALLA,estado nutricional en menores de 5 anos,clasificacion e,2003-06-01,4,6,4,6,10
20103,MECAPACA,estado nutricional en menores de 5 anos,clasificacion e,2003-06-01,2,9,2,9,11
71003,MINEROS,estado nutricional en menores de 5 anos,clasificacion e,2003-06-01,40,24,40,24,64
31301,MIZQUE,estado nutricional en menores de 5 anos,clasificacion e,2003-06-01,7,5,7,5,12
20402,MOCOMOCO,estado nutricional en menores de 5 anos,clasificacion e,2003-06-01,11,6,11,6,17
10303,MOJOCOYA,estado nutricional en menores de 5 anos,clasificacion e,2003-06-01,12,9,12,9,21
10501,MONTEAGUDO,estado nutricional en menores de 5 anos,clasificacion e,2003-06-01,24,22,24,22,46
71001,MONTERO,estado nutricional en menores de 5 anos,clasificacion e,2003-06-01,65,38,65,38,103
70803,MORO MORO,estado nutricional en menores de 5 anos,clasificacion e,2003-06-01,2,4,2,4,6
30302,MOROCHATA,estado nutricional en menores de 5 anos,clasificacion e,2003-06-01,29,27,29,27,56
90401,NACEBE (SANTA ROSA DEL ABUNA),estado nutricional en menores de 5 anos,clasificacion e,2003-06-01,2,2,2,2,4
50404,OCURI,estado nutricional en menores de 5 anos,clasificacion e,2003-06-01,18,24,18,24,42
30203,OMEREQUE,estado nutricional en menores de 5 anos,clasificacion e,2003-06-01,5,5,5,5,10
40101,ORURO,estado nutricional en menores de 5 anos,clasificacion e,2003-06-01,110,108,110,108,218
60201,PADCAYA,estado nutricional en menores de 5 anos,clasificacion e,2003-06-01,18,19,18,19,37
10401,PADILLA,estado nutricional en menores de 5 anos,clasificacion e,2003-06-01,43,46,43,46,89
70502,PAILON,estado nutricional en menores de 5 anos,clasificacion e,2003-06-01,8,3,8,3,11
20102,PALCA,estado nutricional en menores de 5 anos,clasificacion e,2003-06-01,8,8,8,8,16
21104,PALOS BLANCOS,estado nutricional en menores de 5 anos,clasificacion e,2003-06-01,28,21,28,21,49
40802,PAMPA AULLAGAS,estado nutricional en menores de 5 anos,clasificacion e,2003-06-01,2,3,2,3,5
70902,PAMPA GRANDE,estado nutricional en menores de 5 anos,clasificacion e,2003-06-01,6,2,6,2,8
21802,PAPEL PAMPA,estado nutricional en menores de 5 anos,clasificacion e,2003-06-01,0,1,0,1,1
30202,PASORAPA,estado nutricional en menores de 5 anos,clasificacion e,2003-06-01,6,3,6,3,9
21305,PATACAMAYA,estado nutricional en menores de 5 anos,clasificacion e,2003-06-01,62,32,62,32,94
40602,PAZÃ‘A,estado nutricional en menores de 5 anos,clasificacion e,2003-06-01,3,5,3,5,8
20702,PELECHUCO,estado nutricional en menores de 5 anos,clasificacion e,2003-06-01,5,8,5,8,13
50403,POCOATA,estado nutricional en menores de 5 anos,clasificacion e,2003-06-01,36,34,36,34,70
31203,POCONA,estado nutricional en menores de 5 anos,clasificacion e,2003-06-01,7,7,7,7,14
31202,POJO (CBBA),estado nutricional en menores de 5 anos,clasificacion e,2003-06-01,25,19,25,19,44
40601,POOPO,estado nutricional en menores de 5 anos,clasificacion e,2003-06-01,0,3,0,3,3
51203,PORCO,estado nutricional en menores de 5 anos,clasificacion e,2003-06-01,2,7,2,7,9
10103,POROMA,estado nutricional en menores de 5 anos,clasificacion e,2003-06-01,74,98,74,98,172
70103,PORONGO,estado nutricional en menores de 5 anos,clasificacion e,2003-06-01,2,1,2,1,3
70601,PORTACHUELO,estado nutricional en menores de 5 anos,clasificacion e,2003-06-01,10,6,10,6,16
90102,PORVENIR,estado nutricional en menores de 5 anos,clasificacion e,2003-06-01,3,0,3,0,3
70804,POSTRER VALLE,estado nutricional en menores de 5 anos,clasificacion e,2003-06-01,1,1,1,1,2
50101,POTOSI,estado nutricional en menores de 5 anos,clasificacion e,2003-06-01,176,123,176,123,299
10302,PRESTO,estado nutricional en menores de 5 anos,clasificacion e,2003-06-01,30,28,30,28,58
21201,PUCARANI,estado nutricional en menores de 5 anos,clasificacion e,2003-06-01,17,15,17,15,32
20401,PUERTO ACOSTA,estado nutricional en menores de 5 anos,clasificacion e,2003-06-01,9,5,9,5,14
20403,PUERTO CARABUCO,estado nutricional en menores de 5 anos,clasificacion e,2003-06-01,8,12,8,12,20
90301,PUERTO GONZALO MORENO,estado nutricional en menores de 5 anos,clasificacion e,2003-06-01,3,3,3,3,6
21204,PUERTO PEREZ,estado nutricional en menores de 5 anos,clasificacion e,2003-06-01,0,1,0,1,1
71402,PUERTO QUIJARRO,estado nutricional en menores de 5 anos,clasificacion e,2003-06-01,9,3,9,3,12
90201,PUERTO RICO,estado nutricional en menores de 5 anos,clasificacion e,2003-06-01,1,2,1,2,3
80703,PUERTO SILES,estado nutricional en menores de 5 anos,clasificacion e,2003-06-01,8,8,8,8,16
71401,PUERTO SUAREZ,estado nutricional en menores de 5 anos,clasificacion e,2003-06-01,8,1,8,1,9
31205,PUERTO VILLARROEL,estado nutricional en menores de 5 anos,clasificacion e,2003-06-01,36,38,36,38,74
51101,PUNA,estado nutricional en menores de 5 anos,clasificacion e,2003-06-01,17,23,17,23,40
31401,PUNATA,estado nutricional en menores de 5 anos,clasificacion e,2003-06-01,9,2,9,2,11
20604,QUIABAYA,estado nutricional en menores de 5 anos,clasificacion e,2003-06-01,6,11,6,11,17
30901,QUILLACOLLO,estado nutricional en menores de 5 anos,clasificacion e,2003-06-01,38,21,38,21,59
21002,QUIME,estado nutricional en menores de 5 anos,clasificacion e,2003-06-01,40,17,40,17,57
50402,RAVELO,estado nutricional en menores de 5 anos,clasificacion e,2003-06-01,97,84,97,84,181
80301,REYES,estado nutricional en menores de 5 anos,clasificacion e,2003-06-01,0,6,0,6,6
80201,RIBERALTA,estado nutricional en menores de 5 anos,clasificacion e,2003-06-01,135,96,135,96,231
70503,ROBORE,estado nutricional en menores de 5 anos,clasificacion e,2003-06-01,9,5,9,5,14
80304,RURRENABAQUE,estado nutricional en menores de 5 anos,clasificacion e,2003-06-01,7,6,7,6,13
31001,SACABA,estado nutricional en menores de 5 anos,clasificacion e,2003-06-01,33,7,33,7,40
30404,SACABAMBA,estado nutricional en menores de 5 anos,clasificacion e,2003-06-01,3,5,3,5,8
50701,SACACA,estado nutricional en menores de 5 anos,clasificacion e,2003-06-01,109,125,109,125,234
71302,SAIPINA,estado nutricional en menores de 5 anos,clasificacion e,2003-06-01,6,5,6,5,11
40801,SALINAS DE GARCI MENDOZA,estado nutricional en menores de 5 anos,clasificacion e,2003-06-01,3,2,3,2,5
70901,SAMAIPATA,estado nutricional en menores de 5 anos,clasificacion e,2003-06-01,5,2,5,2,7
80602,SAN ANDRES,estado nutricional en menores de 5 anos,clasificacion e,2003-06-01,2,1,2,1,3
71105,SAN ANTONIO DE LOMERIO,estado nutricional en menores de 5 anos,clasificacion e,2003-06-01,28,46,28,46,74
31403,SAN BENITO,estado nutricional en menores de 5 anos,clasificacion e,2003-06-01,4,2,4,2,6
80302,SAN BORJA,estado nutricional en menores de 5 anos,clasificacion e,2003-06-01,40,40,40,40,80
21502,SAN BUENA VENTURA,estado nutricional en menores de 5 anos,clasificacion e,2003-06-01,12,5,12,5,17
70402,SAN CARLOS,estado nutricional en menores de 5 anos,clasificacion e,2003-06-01,18,17,18,17,35
80501,SAN IGNACIO,estado nutricional en menores de 5 anos,clasificacion e,2003-06-01,28,15,28,15,43
70301,SAN IGNACIO DE VELASCO,estado nutricional en menores de 5 anos,clasificacion e,2003-06-01,48,33,48,33,81
80102,SAN JAVIER(BNI),estado nutricional en menores de 5 anos,clasificacion e,2003-06-01,0,1,0,1,1
71102,SAN JAVIER(STC),estado nutricional en menores de 5 anos,clasificacion e,2003-06-01,4,5,4,5,9
80701,SAN JOAQUIN,estado nutricional en menores de 5 anos,clasificacion e,2003-06-01,2,1,2,1,3
70501,SAN JOSE DE CHIQUITOS,estado nutricional en menores de 5 anos,clasificacion e,2003-06-01,12,3,12,3,15
71104,SAN JULIAN,estado nutricional en menores de 5 anos,clasificacion e,2003-06-01,35,39,35,39,74
60501,SAN LORENZO(TJA),estado nutricional en menores de 5 anos,clasificacion e,2003-06-01,8,20,8,20,28
10702,SAN LUCAS,estado nutricional en menores de 5 anos,clasificacion e,2003-06-01,111,80,111,80,191
71201,SAN MATIAS,estado nutricional en menores de 5 anos,clasificacion e,2003-06-01,18,11,18,11,29
70302,SAN MIGUEL DE VELASCO,estado nutricional en menores de 5 anos,clasificacion e,2003-06-01,10,9,10,9,19
51001,SAN PABLO DE LIPEZ,estado nutricional en menores de 5 anos,clasificacion e,2003-06-01,0,1,0,1,1
50501,SAN PEDRO DE BUENA VISTA,estado nutricional en menores de 5 anos,clasificacion e,2003-06-01,60,81,60,81,141
21801,SAN PEDRO DE CURAHUARA,estado nutricional en menores de 5 anos,clasificacion e,2003-06-01,1,6,1,6,7
50902,SAN PEDRO DE QUEMES,estado nutricional en menores de 5 anos,clasificacion e,2003-06-01,0,1,0,1,1
70303,SAN RAFAEL,estado nutricional en menores de 5 anos,clasificacion e,2003-06-01,8,12,8,12,20
70101,SANTA CRUZ DE LA SIERRA,estado nutricional en menores de 5 anos,clasificacion e,2003-06-01,152,63,152,63,215
70602,SANTA ROSA DEL SARA,estado nutricional en menores de 5 anos,clasificacion e,2003-06-01,1,1,1,1,2
20308,SANTIAGO DE CALLAPA,estado nutricional en menores de 5 anos,clasificacion e,2003-06-01,3,6,3,6,9
41401,SANTIAGO DE HUARI,estado nutricional en menores de 5 anos,clasificacion e,2003-06-01,6,7,6,7,13
21901,SANTIAGO DE MACHACA,estado nutricional en menores de 5 anos,clasificacion e,2003-06-01,1,0,1,0,1
30702,SANTIVAÃ‘ES,estado nutricional en menores de 5 anos,clasificacion e,2003-06-01,15,10,15,10,25
40202,SANTUARIO DE QUILLACAS,estado nutricional en menores de 5 anos,clasificacion e,2003-06-01,2,2,2,2,4
20902,SAPAHAQUI,estado nutricional en menores de 5 anos,clasificacion e,2003-06-01,6,14,6,14,20
90303,SENA,estado nutricional en menores de 5 anos,clasificacion e,2003-06-01,1,0,1,0,1
21301,SICA SICA (VILLA AROMA),estado nutricional en menores de 5 anos,clasificacion e,2003-06-01,39,18,39,18,57
30703,SICAYA,estado nutricional en menores de 5 anos,clasificacion e,2003-06-01,5,0,5,0,5
30902,SIPE SIPE,estado nutricional en menores de 5 anos,clasificacion e,2003-06-01,41,24,41,24,65
10403,SOPACHUY,estado nutricional en menores de 5 anos,clasificacion e,2003-06-01,31,40,31,40,71
20601,SORATA,estado nutricional en menores de 5 anos,clasificacion e,2003-06-01,6,19,6,19,25
10101,SUCRE,estado nutricional en menores de 5 anos,clasificacion e,2003-06-01,155,116,155,116,271
20603,TACACOMA,estado nutricional en menores de 5 anos,clasificacion e,2003-06-01,5,7,5,7,12
50303,TACOBAMBA,estado nutricional en menores de 5 anos,clasificacion e,2003-06-01,26,27,26,27,53
30602,TACOPAYA,estado nutricional en menores de 5 anos,clasificacion e,2003-06-01,26,31,26,31,57
31101,TAPACARI,estado nutricional en menores de 5 anos,clasificacion e,2003-06-01,31,30,31,30,61
10601,TARABUCO,estado nutricional en menores de 5 anos,clasificacion e,2003-06-01,137,154,137,154,291
30401,TARATA,estado nutricional en menores de 5 anos,clasificacion e,2003-06-01,13,4,13,4,17
60101,TARIJA,estado nutricional en menores de 5 anos,clasificacion e,2003-06-01,50,56,50,56,106
10202,TARVITA,estado nutricional en menores de 5 anos,clasificacion e,2003-06-01,32,41,32,41,73
20803,TIAWANACU,estado nutricional en menores de 5 anos,clasificacion e,2003-06-01,6,5,6,5,11
50102,TINGUIPAYA,estado nutricional en menores de 5 anos,clasificacion e,2003-06-01,33,64,33,64,97
20606,TIPUANI,estado nutricional en menores de 5 anos,clasificacion e,2003-06-01,7,2,7,2,9
30903,TIQUIPAYA,estado nutricional en menores de 5 anos,clasificacion e,2003-06-01,19,5,19,5,24
31601,TIRAQUE (CBBA),estado nutricional en menores de 5 anos,clasificacion e,2003-06-01,52,68,52,68,120
21703,TITO YUPANQUI (PARQUIPUJIO),estado nutricional en menores de 5 anos,clasificacion e,2003-06-01,0,1,0,1,1
30802,TOCO,estado nutricional en menores de 5 anos,clasificacion e,2003-06-01,0,1,0,1,1
51202,TOMAVE,estado nutricional en menores de 5 anos,clasificacion e,2003-06-01,24,31,24,31,55
10402,TOMINA,estado nutricional en menores de 5 anos,clasificacion e,2003-06-01,52,53,52,53,105
50502,TORO TORO,estado nutricional en menores de 5 anos,clasificacion e,2003-06-01,39,21,39,21,60
31201,TOTORA(CBBA),estado nutricional en menores de 5 anos,clasificacion e,2003-06-01,14,6,14,6,20
41301,TOTORA(ORR),estado nutricional en menores de 5 anos,clasificacion e,2003-06-01,2,6,2,6,8
70802,TRIGAL,estado nutricional en menores de 5 anos,clasificacion e,2003-06-01,0,1,0,1,1
80101,TRINIDAD,estado nutricional en menores de 5 anos,clasificacion e,2003-06-01,47,39,47,39,86
50801,TUPIZA,estado nutricional en menores de 5 anos,clasificacion e,2003-06-01,20,33,20,33,53
40402,TURCO,estado nutricional en menores de 5 anos,clasificacion e,2003-06-01,2,2,2,2,4
21302,UMALA,estado nutricional en menores de 5 anos,clasificacion e,2003-06-01,1,0,1,0,1
50201,UNCIA,estado nutricional en menores de 5 anos,clasificacion e,2003-06-01,5,3,5,3,8
60401,URIONDO (A. CONCEPCION),estado nutricional en menores de 5 anos,clasificacion e,2003-06-01,6,5,6,5,11
71502,URUBICHA,estado nutricional en menores de 5 anos,clasificacion e,2003-06-01,27,26,27,26,53
51201,UYUNI,estado nutricional en menores de 5 anos,clasificacion e,2003-06-01,16,18,16,18,34
30502,VACAS,estado nutricional en menores de 5 anos,clasificacion e,2003-06-01,11,12,11,12,23
70801,VALLEGRANDE,estado nutricional en menores de 5 anos,clasificacion e,2003-06-01,11,19,11,19,30
20801,VIACHA,estado nutricional en menores de 5 anos,clasificacion e,2003-06-01,25,14,25,14,39
31302,VILA VILA,estado nutricional en menores de 5 anos,clasificacion e,2003-06-01,6,12,6,12,18
60303,VILLA MONTES,estado nutricional en menores de 5 anos,clasificacion e,2003-06-01,10,6,10,6,16
31402,VILLA RIVERO,estado nutricional en menores de 5 anos,clasificacion e,2003-06-01,8,3,8,3,11
10801,VILLA SERRANO,estado nutricional en menores de 5 anos,clasificacion e,2003-06-01,27,35,27,35,62
31003,VILLA TUNARI,estado nutricional en menores de 5 anos,clasificacion e,2003-06-01,40,27,40,27,67
11001,VILLA VACA GUZMAN (MUYUPAMPA),estado nutricional en menores de 5 anos,clasificacion e,2003-06-01,9,6,9,6,15
51501,VILLAZON,estado nutricional en menores de 5 anos,clasificacion e,2003-06-01,35,24,35,24,59
30904,VINTO,estado nutricional en menores de 5 anos,clasificacion e,2003-06-01,2,0,2,0,2
50602,VITICHI,estado nutricional en menores de 5 anos,clasificacion e,2003-06-01,28,38,28,38,66
20903,YACO,estado nutricional en menores de 5 anos,clasificacion e,2003-06-01,9,10,9,10,19
60301,YACUIBA,estado nutricional en menores de 5 anos,clasificacion e,2003-06-01,11,14,11,14,25
10602,YAMPARAEZ,estado nutricional en menores de 5 anos,clasificacion e,2003-06-01,83,51,83,51,134
21103,YANACACHI,estado nutricional en menores de 5 anos,clasificacion e,2003-06-01,1,1,1,1,2
70403,YAPACANI,estado nutricional en menores de 5 anos,clasificacion e,2003-06-01,22,42,22,42,64
50103,YOCALLA,estado nutricional en menores de 5 anos,clasificacion e,2003-06-01,3,5,3,5,8
10102,YOTALA,estado nutricional en menores de 5 anos,clasificacion e,2003-06-01,29,35,29,35,64
60402,YUNCHARA,estado nutricional en menores de 5 anos,clasificacion e,2003-06-01,4,5,4,5,9
10301,ZUDAÃ‘EZ,estado nutricional en menores de 5 anos,clasificacion e,2003-06-01,22,19,22,19,41
51302,ACACIO,estado nutricional en menores de 5 anos,clasificacion e,2003-07-01,32,38,32,38,70
20201,ACHACACHI,estado nutricional en menores de 5 anos,clasificacion e,2003-07-01,13,12,13,12,25
20104,ACHOCALLA,estado nutricional en menores de 5 anos,clasificacion e,2003-07-01,1,5,1,5,6
30201,AIQUILE,estado nutricional en menores de 5 anos,clasificacion e,2003-07-01,15,8,15,8,23
31303,ALALAY,estado nutricional en menores de 5 anos,clasificacion e,2003-07-01,1,7,1,7,8
10404,ALCALA,estado nutricional en menores de 5 anos,clasificacion e,2003-07-01,9,20,9,20,29
20202,ANCORAIMES,estado nutricional en menores de 5 anos,clasificacion e,2003-07-01,4,14,4,14,18
41201,ANDAMARCA,estado nutricional en menores de 5 anos,clasificacion e,2003-07-01,1,1,1,1,2
30402,ANZALDO,estado nutricional en menores de 5 anos,clasificacion e,2003-07-01,6,7,6,7,13
20701,APOLO,estado nutricional en menores de 5 anos,clasificacion e,2003-07-01,7,7,7,7,14
51301,ARAMPAMPA,estado nutricional en menores de 5 anos,clasificacion e,2003-07-01,8,17,8,17,25
30501,ARANI,estado nutricional en menores de 5 anos,clasificacion e,2003-07-01,6,12,6,12,18
30403,ARBIETO,estado nutricional en menores de 5 anos,clasificacion e,2003-07-01,1,2,1,2,3
30601,ARQUE,estado nutricional en menores de 5 anos,clasificacion e,2003-07-01,25,42,25,42,67
71501,ASCENCION DE GUARAYOS,estado nutricional en menores de 5 anos,clasificacion e,2003-07-01,0,2,0,2,2
50802,ATOCHA,estado nutricional en menores de 5 anos,clasificacion e,2003-07-01,3,62,3,62,65
20503,AUCAPATA,estado nutricional en menores de 5 anos,clasificacion e,2003-07-01,3,2,3,2,5
20502,AYATA,estado nutricional en menores de 5 anos,clasificacion e,2003-07-01,12,8,12,8,20
21303,AYO AYO,estado nutricional en menores de 5 anos,clasificacion e,2003-07-01,1,0,1,0,1
30301,AYOPAYA (V. DE INDEPENDENCIA),estado nutricional en menores de 5 anos,clasificacion e,2003-07-01,25,10,25,10,35
10201,AZURDUY,estado nutricional en menores de 5 anos,clasificacion e,2003-07-01,44,37,44,37,81
21203,BATALLAS,estado nutricional en menores de 5 anos,clasificacion e,2003-07-01,1,3,1,3,4
80802,BAURES,estado nutricional en menores de 5 anos,clasificacion e,2003-07-01,3,6,3,6,9
50104,BELEN DE URMIRI,estado nutricional en menores de 5 anos,clasificacion e,2003-07-01,3,0,3,0,3
90104,BELLA FLOR,estado nutricional en menores de 5 anos,clasificacion e,2003-07-01,7,7,7,7,14
60202,BERMEJO,estado nutricional en menores de 5 anos,clasificacion e,2003-07-01,7,11,7,11,18
50301,BETANZOS,estado nutricional en menores de 5 anos,clasificacion e,2003-07-01,84,72,84,72,156
31501,BOLIVAR,estado nutricional en menores de 5 anos,clasificacion e,2003-07-01,34,23,34,23,57
90103,BOLPEBRA,estado nutricional en menores de 5 anos,clasificacion e,2003-07-01,2,2,2,2,4
70707,BOYUIBE,estado nutricional en menores de 5 anos,clasificacion e,2003-07-01,1,2,1,2,3
70401,BUENA VISTA,estado nutricional en menores de 5 anos,clasificacion e,2003-07-01,3,12,3,12,15
70703,CABEZAS,estado nutricional en menores de 5 anos,clasificacion e,2003-07-01,2,1,2,1,3
20905,CAIROMA,estado nutricional en menores de 5 anos,clasificacion e,2003-07-01,16,20,16,20,36
51102,"CAIZA ""D""",estado nutricional en menores de 5 anos,clasificacion e,2003-07-01,29,13,29,13,42
21003,CAJUATA,estado nutricional en menores de 5 anos,clasificacion e,2003-07-01,4,9,4,9,13
20303,CALACOTO,estado nutricional en menores de 5 anos,clasificacion e,2003-07-01,1,3,1,3,4
21304,CALAMARCA,estado nutricional en menores de 5 anos,clasificacion e,2003-07-01,35,21,35,21,56
10701,CAMARGO,estado nutricional en menores de 5 anos,clasificacion e,2003-07-01,22,18,22,18,40
10901,CAMATAQUI (C. VILLA ABECIA),estado nutricional en menores de 5 anos,clasificacion e,2003-07-01,1,0,1,0,1
70706,CAMIRI,estado nutricional en menores de 5 anos,clasificacion e,2003-07-01,31,23,31,23,54
30701,CAPINOTA,estado nutricional en menores de 5 anos,clasificacion e,2003-07-01,20,18,20,18,38
20302,CAQUIAVIRI,estado nutricional en menores de 5 anos,clasificacion e,2003-07-01,4,1,4,1,5
40102,CARACOLLO,estado nutricional en menores de 5 anos,clasificacion e,2003-07-01,6,7,6,7,13
22001,CARANAVI,estado nutricional en menores de 5 anos,clasificacion e,2003-07-01,39,25,39,25,64
60302,CARAPARI,estado nutricional en menores de 5 anos,clasificacion e,2003-07-01,4,5,4,5,9
50702,CARIPUYO,estado nutricional en menores de 5 anos,clasificacion e,2003-07-01,34,36,34,36,70
40201,CHALLAPATA,estado nutricional en menores de 5 anos,clasificacion e,2003-07-01,27,18,27,18,45
50302,CHAQUI,estado nutricional en menores de 5 anos,clasificacion e,2003-07-01,17,13,17,13,30
70702,CHARAGUA,estado nutricional en menores de 5 anos,clasificacion e,2003-07-01,21,33,21,33,54
20305,CHARAÃ‘A,estado nutricional en menores de 5 anos,clasificacion e,2003-07-01,2,0,2,0,2
50202,CHAYANTA,estado nutricional en menores de 5 anos,clasificacion e,2003-07-01,8,3,8,3,11
31204,CHIMORE,estado nutricional en menores de 5 anos,clasificacion e,2003-07-01,5,1,5,1,6
21101,CHULUMANI (V. DE LA LIBERTAD),estado nutricional en menores de 5 anos,clasificacion e,2003-07-01,1,3,1,3,4
20501,CHUMA,estado nutricional en menores de 5 anos,clasificacion e,2003-07-01,4,4,4,4,8
30801,CLIZA,estado nutricional en menores de 5 anos,clasificacion e,2003-07-01,5,2,5,2,7
90101,COBIJA,estado nutricional en menores de 5 anos,clasificacion e,2003-07-01,23,22,23,22,45
30101,COCHABAMBA,estado nutricional en menores de 5 anos,clasificacion e,2003-07-01,112,70,112,70,182
30905,COLCAPIRHUA,estado nutricional en menores de 5 anos,clasificacion e,2003-07-01,7,2,7,2,9
50901,"COLCHA ""K""",estado nutricional en menores de 5 anos,clasificacion e,2003-07-01,5,1,5,1,6
31002,COLOMI,estado nutricional en menores de 5 anos,clasificacion e,2003-07-01,16,4,16,4,20
50401,COLQUECHACA,estado nutricional en menores de 5 anos,clasificacion e,2003-07-01,83,35,83,35,118
21306,COLQUENCHA,estado nutricional en menores de 5 anos,clasificacion e,2003-07-01,5,0,5,0,5
21004,COLQUIRI,estado nutricional en menores de 5 anos,clasificacion e,2003-07-01,28,15,28,15,43
20304,COMANCHE,estado nutricional en menores de 5 anos,clasificacion e,2003-07-01,1,0,1,0,1
71301,COMARAPA,estado nutricional en menores de 5 anos,clasificacion e,2003-07-01,17,10,17,10,27
20605,COMBAYA,estado nutricional en menores de 5 anos,clasificacion e,2003-07-01,1,1,1,1,2
71101,CONCEPCION,estado nutricional en menores de 5 anos,clasificacion e,2003-07-01,3,1,3,1,4
21701,COPACABANA,estado nutricional en menores de 5 anos,clasificacion e,2003-07-01,4,1,4,1,5
20301,CORO CORO,estado nutricional en menores de 5 anos,clasificacion e,2003-07-01,12,8,12,8,20
21401,COROICO,estado nutricional en menores de 5 anos,clasificacion e,2003-07-01,5,4,5,4,9
40301,CORQUE,estado nutricional en menores de 5 anos,clasificacion e,2003-07-01,1,0,1,0,1
50601,COTAGAITA,estado nutricional en menores de 5 anos,clasificacion e,2003-07-01,27,19,27,19,46
70102,COTOCA,estado nutricional en menores de 5 anos,clasificacion e,2003-07-01,10,3,10,3,13
70704,CUEVO,estado nutricional en menores de 5 anos,clasificacion e,2003-07-01,1,4,1,4,5
10902,CULPINA,estado nutricional en menores de 5 anos,clasificacion e,2003-07-01,35,34,35,34,69
40401,CURAHUARA DE CARANGAS,estado nutricional en menores de 5 anos,clasificacion e,2003-07-01,5,5,5,5,10
21602,CURVA,estado nutricional en menores de 5 anos,clasificacion e,2003-07-01,1,0,1,0,1
20105,EL ALTO,estado nutricional en menores de 5 anos,clasificacion e,2003-07-01,442,228,442,228,670
71503,EL PUENTE(STC),estado nutricional en menores de 5 anos,clasificacion e,2003-07-01,8,36,8,36,44
60502,EL PUENTE(TJA),estado nutricional en menores de 5 anos,clasificacion e,2003-07-01,14,13,14,13,27
70105,EL TORNO,estado nutricional en menores de 5 anos,clasificacion e,2003-07-01,16,14,16,14,30
10405,EL VILLAR,estado nutricional en menores de 5 anos,clasificacion e,2003-07-01,27,23,27,23,50
60601,ENTRE RIOS,estado nutricional en menores de 5 anos,clasificacion e,2003-07-01,6,3,6,3,9
41101,EUCALIPTUS,estado nutricional en menores de 5 anos,clasificacion e,2003-07-01,3,4,3,4,7
80402,EXALTACION,estado nutricional en menores de 5 anos,clasificacion e,2003-07-01,2,6,2,6,8
90203,FILADELFIA,estado nutricional en menores de 5 anos,clasificacion e,2003-07-01,1,2,1,2,3
71002,GENERAL SAAVEDRA,estado nutricional en menores de 5 anos,clasificacion e,2003-07-01,17,17,17,17,34
21601,GRAL. J.J. PEREZ (CHARAZANI),estado nutricional en menores de 5 anos,clasificacion e,2003-07-01,21,28,21,28,49
20602,GUANAY,estado nutricional en menores de 5 anos,clasificacion e,2003-07-01,31,41,31,41,72
20802,GUAQUI,estado nutricional en menores de 5 anos,clasificacion e,2003-07-01,3,0,3,0,3
80202,GUAYARAMERIN,estado nutricional en menores de 5 anos,clasificacion e,2003-07-01,34,17,34,17,51
70705,GUTIERREZ,estado nutricional en menores de 5 anos,clasificacion e,2003-07-01,23,35,23,35,58
10502,HUACARETA,estado nutricional en menores de 5 anos,clasificacion e,2003-07-01,21,10,21,10,31
11002,HUACAYA (VILLA DE HUACAYA),estado nutricional en menores de 5 anos,clasificacion e,2003-07-01,0,5,0,5,5
40501,HUACHACALLA,estado nutricional en menores de 5 anos,clasificacion e,2003-07-01,1,0,1,0,1
40701,HUANUNI,estado nutricional en menores de 5 anos,clasificacion e,2003-07-01,5,4,5,4,9
80803,HUARACAJE,estado nutricional en menores de 5 anos,clasificacion e,2003-07-01,4,1,4,1,5
41601,HUAYLLAMARCA,estado nutricional en menores de 5 anos,clasificacion e,2003-07-01,1,2,1,2,3
21005,ICHOCA,estado nutricional en menores de 5 anos,clasificacion e,2003-07-01,5,7,5,7,12
10304,ICLA,estado nutricional en menores de 5 anos,clasificacion e,2003-07-01,55,69,55,69,124
10703,INCAHUASI,estado nutricional en menores de 5 anos,clasificacion e,2003-07-01,49,24,49,24,73
21001,INQUISIVI,estado nutricional en menores de 5 anos,clasificacion e,2003-07-01,14,21,14,21,35
21102,IRUPANA (VILLA DE LANZA),estado nutricional en menores de 5 anos,clasificacion e,2003-07-01,0,18,0,18,18
21501,IXIAMAS,estado nutricional en menores de 5 anos,clasificacion e,2003-07-01,8,5,8,5,13
21105,LA ASUNTA,estado nutricional en menores de 5 anos,clasificacion e,2003-07-01,10,9,10,9,19
70104,LA GUARDIA,estado nutricional en menores de 5 anos,clasificacion e,2003-07-01,4,4,4,4,8
20101,LA PAZ,estado nutricional en menores de 5 anos,clasificacion e,2003-07-01,228,239,228,239,467
70701,LAGUNILLAS,estado nutricional en menores de 5 anos,clasificacion e,2003-07-01,7,8,7,8,15
21202,LAJA,estado nutricional en menores de 5 anos,clasificacion e,2003-07-01,6,4,6,4,10
10903,LAS CARRERAS,estado nutricional en menores de 5 anos,clasificacion e,2003-07-01,6,13,6,13,19
50203,LLALLAGUA,estado nutricional en menores de 5 anos,clasificacion e,2003-07-01,8,91,8,91,99
51401,LLICA,estado nutricional en menores de 5 anos,clasificacion e,2003-07-01,3,2,3,2,5
80601,LORETO,estado nutricional en menores de 5 anos,clasificacion e,2003-07-01,2,1,2,1,3
20901,LURIBAY,estado nutricional en menores de 5 anos,clasificacion e,2003-07-01,13,13,13,13,26
40702,MACHACAMARCA,estado nutricional en menores de 5 anos,clasificacion e,2003-07-01,3,0,3,0,3
11003,MACHARETI,estado nutricional en menores de 5 anos,clasificacion e,2003-07-01,3,16,3,16,19
80801,MAGDALENA,estado nutricional en menores de 5 anos,clasificacion e,2003-07-01,1,1,1,1,2
70903,MAIRANA,estado nutricional en menores de 5 anos,clasificacion e,2003-07-01,4,4,4,4,8
20904,MALLA,estado nutricional en menores de 5 anos,clasificacion e,2003-07-01,2,0,2,0,2
20103,MECAPACA,estado nutricional en menores de 5 anos,clasificacion e,2003-07-01,3,2,3,2,5
71003,MINEROS,estado nutricional en menores de 5 anos,clasificacion e,2003-07-01,49,17,49,17,66
31301,MIZQUE,estado nutricional en menores de 5 anos,clasificacion e,2003-07-01,9,6,9,6,15
20402,MOCOMOCO,estado nutricional en menores de 5 anos,clasificacion e,2003-07-01,18,8,18,8,26
51002,MOJINETE,estado nutricional en menores de 5 anos,clasificacion e,2003-07-01,0,2,0,2,2
10303,MOJOCOYA,estado nutricional en menores de 5 anos,clasificacion e,2003-07-01,20,19,20,19,39
10501,MONTEAGUDO,estado nutricional en menores de 5 anos,clasificacion e,2003-07-01,29,24,29,24,53
71001,MONTERO,estado nutricional en menores de 5 anos,clasificacion e,2003-07-01,64,24,64,24,88
70803,MORO MORO,estado nutricional en menores de 5 anos,clasificacion e,2003-07-01,4,6,4,6,10
30302,MOROCHATA,estado nutricional en menores de 5 anos,clasificacion e,2003-07-01,57,37,57,37,94
50404,OCURI,estado nutricional en menores de 5 anos,clasificacion e,2003-07-01,29,56,29,56,85
70202,OKINAWA,estado nutricional en menores de 5 anos,clasificacion e,2003-07-01,1,0,1,0,1
30203,OMEREQUE,estado nutricional en menores de 5 anos,clasificacion e,2003-07-01,2,9,2,9,11
40101,ORURO,estado nutricional en menores de 5 anos,clasificacion e,2003-07-01,127,78,127,78,205
60201,PADCAYA,estado nutricional en menores de 5 anos,clasificacion e,2003-07-01,7,6,7,6,13
10401,PADILLA,estado nutricional en menores de 5 anos,clasificacion e,2003-07-01,25,40,25,40,65
70502,PAILON,estado nutricional en menores de 5 anos,clasificacion e,2003-07-01,10,2,10,2,12
20102,PALCA,estado nutricional en menores de 5 anos,clasificacion e,2003-07-01,4,9,4,9,13
21104,PALOS BLANCOS,estado nutricional en menores de 5 anos,clasificacion e,2003-07-01,19,13,19,13,32
40802,PAMPA AULLAGAS,estado nutricional en menores de 5 anos,clasificacion e,2003-07-01,2,4,2,4,6
70902,PAMPA GRANDE,estado nutricional en menores de 5 anos,clasificacion e,2003-07-01,3,2,3,2,5
21802,PAPEL PAMPA,estado nutricional en menores de 5 anos,clasificacion e,2003-07-01,1,0,1,0,1
30202,PASORAPA,estado nutricional en menores de 5 anos,clasificacion e,2003-07-01,10,9,10,9,19
21305,PATACAMAYA,estado nutricional en menores de 5 anos,clasificacion e,2003-07-01,22,16,22,16,38
40602,PAZÃ‘A,estado nutricional en menores de 5 anos,clasificacion e,2003-07-01,2,4,2,4,6
20702,PELECHUCO,estado nutricional en menores de 5 anos,clasificacion e,2003-07-01,4,3,4,3,7
50403,POCOATA,estado nutricional en menores de 5 anos,clasificacion e,2003-07-01,31,23,31,23,54
31203,POCONA,estado nutricional en menores de 5 anos,clasificacion e,2003-07-01,19,7,19,7,26
31202,POJO (CBBA),estado nutricional en menores de 5 anos,clasificacion e,2003-07-01,34,18,34,18,52
40601,POOPO,estado nutricional en menores de 5 anos,clasificacion e,2003-07-01,0,8,0,8,8
51203,PORCO,estado nutricional en menores de 5 anos,clasificacion e,2003-07-01,3,2,3,2,5
10103,POROMA,estado nutricional en menores de 5 anos,clasificacion e,2003-07-01,62,69,62,69,131
70103,PORONGO,estado nutricional en menores de 5 anos,clasificacion e,2003-07-01,1,1,1,1,2
70601,PORTACHUELO,estado nutricional en menores de 5 anos,clasificacion e,2003-07-01,14,10,14,10,24
90102,PORVENIR,estado nutricional en menores de 5 anos,clasificacion e,2003-07-01,5,3,5,3,8
70804,POSTRER VALLE,estado nutricional en menores de 5 anos,clasificacion e,2003-07-01,1,3,1,3,4
50101,POTOSI,estado nutricional en menores de 5 anos,clasificacion e,2003-07-01,205,112,205,112,317
10302,PRESTO,estado nutricional en menores de 5 anos,clasificacion e,2003-07-01,26,24,26,24,50
70805,PUCARA,estado nutricional en menores de 5 anos,clasificacion e,2003-07-01,0,1,0,1,1
21201,PUCARANI,estado nutricional en menores de 5 anos,clasificacion e,2003-07-01,3,3,3,3,6
20401,PUERTO ACOSTA,estado nutricional en menores de 5 anos,clasificacion e,2003-07-01,9,4,9,4,13
20403,PUERTO CARABUCO,estado nutricional en menores de 5 anos,clasificacion e,2003-07-01,7,11,7,11,18
90301,PUERTO GONZALO MORENO,estado nutricional en menores de 5 anos,clasificacion e,2003-07-01,2,1,2,1,3
21204,PUERTO PEREZ,estado nutricional en menores de 5 anos,clasificacion e,2003-07-01,1,0,1,0,1
71402,PUERTO QUIJARRO,estado nutricional en menores de 5 anos,clasificacion e,2003-07-01,11,7,11,7,18
90201,PUERTO RICO,estado nutricional en menores de 5 anos,clasificacion e,2003-07-01,0,4,0,4,4
80703,PUERTO SILES,estado nutricional en menores de 5 anos,clasificacion e,2003-07-01,4,8,4,8,12
71401,PUERTO SUAREZ,estado nutricional en menores de 5 anos,clasificacion e,2003-07-01,8,4,8,4,12
31205,PUERTO VILLARROEL,estado nutricional en menores de 5 anos,clasificacion e,2003-07-01,53,37,53,37,90
51101,PUNA,estado nutricional en menores de 5 anos,clasificacion e,2003-07-01,75,88,75,88,163
31401,PUNATA,estado nutricional en menores de 5 anos,clasificacion e,2003-07-01,13,4,13,4,17
20604,QUIABAYA,estado nutricional en menores de 5 anos,clasificacion e,2003-07-01,4,4,4,4,8
30901,QUILLACOLLO,estado nutricional en menores de 5 anos,clasificacion e,2003-07-01,36,25,36,25,61
21002,QUIME,estado nutricional en menores de 5 anos,clasificacion e,2003-07-01,21,13,21,13,34
50402,RAVELO,estado nutricional en menores de 5 anos,clasificacion e,2003-07-01,49,39,49,39,88
80301,REYES,estado nutricional en menores de 5 anos,clasificacion e,2003-07-01,3,2,3,2,5
80201,RIBERALTA,estado nutricional en menores de 5 anos,clasificacion e,2003-07-01,115,81,115,81,196
70503,ROBORE,estado nutricional en menores de 5 anos,clasificacion e,2003-07-01,7,3,7,3,10
80304,RURRENABAQUE,estado nutricional en menores de 5 anos,clasificacion e,2003-07-01,8,5,8,5,13
40901,SABAYA,estado nutricional en menores de 5 anos,clasificacion e,2003-07-01,4,0,4,0,4
31001,SACABA,estado nutricional en menores de 5 anos,clasificacion e,2003-07-01,51,36,51,36,87
30404,SACABAMBA,estado nutricional en menores de 5 anos,clasificacion e,2003-07-01,2,5,2,5,7
50701,SACACA,estado nutricional en menores de 5 anos,clasificacion e,2003-07-01,105,150,105,150,255
71302,SAIPINA,estado nutricional en menores de 5 anos,clasificacion e,2003-07-01,2,0,2,0,2
40801,SALINAS DE GARCI MENDOZA,estado nutricional en menores de 5 anos,clasificacion e,2003-07-01,5,7,5,7,12
70901,SAMAIPATA,estado nutricional en menores de 5 anos,clasificacion e,2003-07-01,5,1,5,1,6
80602,SAN ANDRES,estado nutricional en menores de 5 anos,clasificacion e,2003-07-01,5,5,5,5,10
51003,SAN ANTONIO DE ESMORUCO,estado nutricional en menores de 5 anos,clasificacion e,2003-07-01,2,1,2,1,3
71105,SAN ANTONIO DE LOMERIO,estado nutricional en menores de 5 anos,clasificacion e,2003-07-01,32,37,32,37,69
31403,SAN BENITO,estado nutricional en menores de 5 anos,clasificacion e,2003-07-01,7,4,7,4,11
80302,SAN BORJA,estado nutricional en menores de 5 anos,clasificacion e,2003-07-01,33,37,33,37,70
21502,SAN BUENA VENTURA,estado nutricional en menores de 5 anos,clasificacion e,2003-07-01,10,9,10,9,19
70402,SAN CARLOS,estado nutricional en menores de 5 anos,clasificacion e,2003-07-01,8,16,8,16,24
80501,SAN IGNACIO,estado nutricional en menores de 5 anos,clasificacion e,2003-07-01,22,9,22,9,31
70301,SAN IGNACIO DE VELASCO,estado nutricional en menores de 5 anos,clasificacion e,2003-07-01,69,38,69,38,107
80102,SAN JAVIER(BNI),estado nutricional en menores de 5 anos,clasificacion e,2003-07-01,1,3,1,3,4
71102,SAN JAVIER(STC),estado nutricional en menores de 5 anos,clasificacion e,2003-07-01,14,8,14,8,22
70501,SAN JOSE DE CHIQUITOS,estado nutricional en menores de 5 anos,clasificacion e,2003-07-01,12,2,12,2,14
71104,SAN JULIAN,estado nutricional en menores de 5 anos,clasificacion e,2003-07-01,26,27,26,27,53
90302,SAN LORENZO(PND),estado nutricional en menores de 5 anos,clasificacion e,2003-07-01,0,2,0,2,2
60501,SAN LORENZO(TJA),estado nutricional en menores de 5 anos,clasificacion e,2003-07-01,13,9,13,9,22
10702,SAN LUCAS,estado nutricional en menores de 5 anos,clasificacion e,2003-07-01,118,82,118,82,200
70302,SAN MIGUEL DE VELASCO,estado nutricional en menores de 5 anos,clasificacion e,2003-07-01,8,9,8,9,17
51001,SAN PABLO DE LIPEZ,estado nutricional en menores de 5 anos,clasificacion e,2003-07-01,1,1,1,1,2
50501,SAN PEDRO DE BUENA VISTA,estado nutricional en menores de 5 anos,clasificacion e,2003-07-01,60,69,60,69,129
21801,SAN PEDRO DE CURAHUARA,estado nutricional en menores de 5 anos,clasificacion e,2003-07-01,2,0,2,0,2
50902,SAN PEDRO DE QUEMES,estado nutricional en menores de 5 anos,clasificacion e,2003-07-01,0,1,0,1,1
70303,SAN RAFAEL,estado nutricional en menores de 5 anos,clasificacion e,2003-07-01,9,11,9,11,20
80401,SANTA ANA,estado nutricional en menores de 5 anos,clasificacion e,2003-07-01,7,2,7,2,9
70101,SANTA CRUZ DE LA SIERRA,estado nutricional en menores de 5 anos,clasificacion e,2003-07-01,166,49,166,49,215
80303,SANTA ROSA,estado nutricional en menores de 5 anos,clasificacion e,2003-07-01,3,2,3,2,5
70602,SANTA ROSA DEL SARA,estado nutricional en menores de 5 anos,clasificacion e,2003-07-01,1,1,1,1,2
20308,SANTIAGO DE CALLAPA,estado nutricional en menores de 5 anos,clasificacion e,2003-07-01,7,12,7,12,19
41401,SANTIAGO DE HUARI,estado nutricional en menores de 5 anos,clasificacion e,2003-07-01,2,3,2,3,5
21901,SANTIAGO DE MACHACA,estado nutricional en menores de 5 anos,clasificacion e,2003-07-01,3,0,3,0,3
30702,SANTIVAÃ‘ES,estado nutricional en menores de 5 anos,clasificacion e,2003-07-01,7,8,7,8,15
40202,SANTUARIO DE QUILLACAS,estado nutricional en menores de 5 anos,clasificacion e,2003-07-01,2,1,2,1,3
20902,SAPAHAQUI,estado nutricional en menores de 5 anos,clasificacion e,2003-07-01,7,11,7,11,18
90303,SENA,estado nutricional en menores de 5 anos,clasificacion e,2003-07-01,1,0,1,0,1
21301,SICA SICA (VILLA AROMA),estado nutricional en menores de 5 anos,clasificacion e,2003-07-01,46,18,46,18,64
30703,SICAYA,estado nutricional en menores de 5 anos,clasificacion e,2003-07-01,11,4,11,4,15
30902,SIPE SIPE,estado nutricional en menores de 5 anos,clasificacion e,2003-07-01,37,22,37,22,59
10403,SOPACHUY,estado nutricional en menores de 5 anos,clasificacion e,2003-07-01,24,39,24,39,63
20601,SORATA,estado nutricional en menores de 5 anos,clasificacion e,2003-07-01,13,16,13,16,29
10101,SUCRE,estado nutricional en menores de 5 anos,clasificacion e,2003-07-01,155,137,155,137,292
31404,TACACHI,estado nutricional en menores de 5 anos,clasificacion e,2003-07-01,0,2,0,2,2
20603,TACACOMA,estado nutricional en menores de 5 anos,clasificacion e,2003-07-01,5,0,5,0,5
50303,TACOBAMBA,estado nutricional en menores de 5 anos,clasificacion e,2003-07-01,24,15,24,15,39
30602,TACOPAYA,estado nutricional en menores de 5 anos,clasificacion e,2003-07-01,19,18,19,18,37
51402,TAHUA,estado nutricional en menores de 5 anos,clasificacion e,2003-07-01,0,1,0,1,1
31101,TAPACARI,estado nutricional en menores de 5 anos,clasificacion e,2003-07-01,31,21,31,21,52
10601,TARABUCO,estado nutricional en menores de 5 anos,clasificacion e,2003-07-01,139,131,139,131,270
30401,TARATA,estado nutricional en menores de 5 anos,clasificacion e,2003-07-01,3,4,3,4,7
60101,TARIJA,estado nutricional en menores de 5 anos,clasificacion e,2003-07-01,56,42,56,42,98
10202,TARVITA,estado nutricional en menores de 5 anos,clasificacion e,2003-07-01,68,86,68,86,154
20803,TIAWANACU,estado nutricional en menores de 5 anos,clasificacion e,2003-07-01,8,4,8,4,12
50102,TINGUIPAYA,estado nutricional en menores de 5 anos,clasificacion e,2003-07-01,19,20,19,20,39
20606,TIPUANI,estado nutricional en menores de 5 anos,clasificacion e,2003-07-01,2,2,2,2,4
30903,TIQUIPAYA,estado nutricional en menores de 5 anos,clasificacion e,2003-07-01,5,3,5,3,8
31601,TIRAQUE (CBBA),estado nutricional en menores de 5 anos,clasificacion e,2003-07-01,43,38,43,38,81
21703,TITO YUPANQUI (PARQUIPUJIO),estado nutricional en menores de 5 anos,clasificacion e,2003-07-01,0,1,0,1,1
30802,TOCO,estado nutricional en menores de 5 anos,clasificacion e,2003-07-01,0,3,0,3,3
41001,TOLEDO,estado nutricional en menores de 5 anos,clasificacion e,2003-07-01,6,0,6,0,6
51202,TOMAVE,estado nutricional en menores de 5 anos,clasificacion e,2003-07-01,14,10,14,10,24
10402,TOMINA,estado nutricional en menores de 5 anos,clasificacion e,2003-07-01,45,59,45,59,104
50502,TORO TORO,estado nutricional en menores de 5 anos,clasificacion e,2003-07-01,36,33,36,33,69
31201,TOTORA(CBBA),estado nutricional en menores de 5 anos,clasificacion e,2003-07-01,23,7,23,7,30
41301,TOTORA(ORR),estado nutricional en menores de 5 anos,clasificacion e,2003-07-01,1,3,1,3,4
80101,TRINIDAD,estado nutricional en menores de 5 anos,clasificacion e,2003-07-01,48,40,48,40,88
50801,TUPIZA,estado nutricional en menores de 5 anos,clasificacion e,2003-07-01,21,38,21,38,59
40402,TURCO,estado nutricional en menores de 5 anos,clasificacion e,2003-07-01,1,0,1,0,1
50201,UNCIA,estado nutricional en menores de 5 anos,clasificacion e,2003-07-01,4,4,4,4,8
60401,URIONDO (A. CONCEPCION),estado nutricional en menores de 5 anos,clasificacion e,2003-07-01,10,6,10,6,16
71502,URUBICHA,estado nutricional en menores de 5 anos,clasificacion e,2003-07-01,3,3,3,3,6
51201,UYUNI,estado nutricional en menores de 5 anos,clasificacion e,2003-07-01,12,15,12,15,27
30502,VACAS,estado nutricional en menores de 5 anos,clasificacion e,2003-07-01,11,9,11,9,20
70801,VALLEGRANDE,estado nutricional en menores de 5 anos,clasificacion e,2003-07-01,14,7,14,7,21
20801,VIACHA,estado nutricional en menores de 5 anos,clasificacion e,2003-07-01,15,12,15,12,27
31302,VILA VILA,estado nutricional en menores de 5 anos,clasificacion e,2003-07-01,2,0,2,0,2
60303,VILLA MONTES,estado nutricional en menores de 5 anos,clasificacion e,2003-07-01,28,11,28,11,39
31402,VILLA RIVERO,estado nutricional en menores de 5 anos,clasificacion e,2003-07-01,10,3,10,3,13
10801,VILLA SERRANO,estado nutricional en menores de 5 anos,clasificacion e,2003-07-01,41,45,41,45,86
31003,VILLA TUNARI,estado nutricional en menores de 5 anos,clasificacion e,2003-07-01,65,50,65,50,115
11001,VILLA VACA GUZMAN (MUYUPAMPA),estado nutricional en menores de 5 anos,clasificacion e,2003-07-01,7,11,7,11,18
51501,VILLAZON,estado nutricional en menores de 5 anos,clasificacion e,2003-07-01,29,14,29,14,43
30904,VINTO,estado nutricional en menores de 5 anos,clasificacion e,2003-07-01,17,11,17,11,28
50602,VITICHI,estado nutricional en menores de 5 anos,clasificacion e,2003-07-01,14,11,14,11,25
20306,WALDO BALLIVIAN,estado nutricional en menores de 5 anos,clasificacion e,2003-07-01,2,0,2,0,2
20903,YACO,estado nutricional en menores de 5 anos,clasificacion e,2003-07-01,15,19,15,19,34
60301,YACUIBA,estado nutricional en menores de 5 anos,clasificacion e,2003-07-01,31,13,31,13,44
10602,YAMPARAEZ,estado nutricional en menores de 5 anos,clasificacion e,2003-07-01,87,55,87,55,142
21103,YANACACHI,estado nutricional en menores de 5 anos,clasificacion e,2003-07-01,1,2,1,2,3
70403,YAPACANI,estado nutricional en menores de 5 anos,clasificacion e,2003-07-01,33,29,33,29,62
50103,YOCALLA,estado nutricional en menores de 5 anos,clasificacion e,2003-07-01,9,8,9,8,17
10102,YOTALA,estado nutricional en menores de 5 anos,clasificacion e,2003-07-01,34,42,34,42,76
60402,YUNCHARA,estado nutricional en menores de 5 anos,clasificacion e,2003-07-01,9,9,9,9,18
10301,ZUDAÃ‘EZ,estado nutricional en menores de 5 anos,clasificacion e,2003-07-01,20,33,20,33,53
51302,ACACIO,estado nutricional en menores de 5 anos,clasificacion e,2003-08-01,35,31,35,31,66
20201,ACHACACHI,estado nutricional en menores de 5 anos,clasificacion e,2003-08-01,8,9,8,9,17
20104,ACHOCALLA,estado nutricional en menores de 5 anos,clasificacion e,2003-08-01,4,1,4,1,5
30201,AIQUILE,estado nutricional en menores de 5 anos,clasificacion e,2003-08-01,18,18,18,18,36
31303,ALALAY,estado nutricional en menores de 5 anos,clasificacion e,2003-08-01,0,2,0,2,2
10404,ALCALA,estado nutricional en menores de 5 anos,clasificacion e,2003-08-01,13,18,13,18,31
20202,ANCORAIMES,estado nutricional en menores de 5 anos,clasificacion e,2003-08-01,9,10,9,10,19
41201,ANDAMARCA,estado nutricional en menores de 5 anos,clasificacion e,2003-08-01,2,1,2,1,3
30402,ANZALDO,estado nutricional en menores de 5 anos,clasificacion e,2003-08-01,3,5,3,5,8
20701,APOLO,estado nutricional en menores de 5 anos,clasificacion e,2003-08-01,12,12,12,12,24
51301,ARAMPAMPA,estado nutricional en menores de 5 anos,clasificacion e,2003-08-01,19,17,19,17,36
30501,ARANI,estado nutricional en menores de 5 anos,clasificacion e,2003-08-01,12,9,12,9,21
30403,ARBIETO,estado nutricional en menores de 5 anos,clasificacion e,2003-08-01,2,2,2,2,4
30601,ARQUE,estado nutricional en menores de 5 anos,clasificacion e,2003-08-01,11,6,11,6,17
71501,ASCENCION DE GUARAYOS,estado nutricional en menores de 5 anos,clasificacion e,2003-08-01,63,61,63,61,124
50802,ATOCHA,estado nutricional en menores de 5 anos,clasificacion e,2003-08-01,17,29,17,29,46
20503,AUCAPATA,estado nutricional en menores de 5 anos,clasificacion e,2003-08-01,13,4,13,4,17
20502,AYATA,estado nutricional en menores de 5 anos,clasificacion e,2003-08-01,2,2,2,2,4
21303,AYO AYO,estado nutricional en menores de 5 anos,clasificacion e,2003-08-01,5,4,5,4,9
30301,AYOPAYA (V. DE INDEPENDENCIA),estado nutricional en menores de 5 anos,clasificacion e,2003-08-01,30,20,30,20,50
10201,AZURDUY,estado nutricional en menores de 5 anos,clasificacion e,2003-08-01,69,90,69,90,159
21203,BATALLAS,estado nutricional en menores de 5 anos,clasificacion e,2003-08-01,2,4,2,4,6
80802,BAURES,estado nutricional en menores de 5 anos,clasificacion e,2003-08-01,1,3,1,3,4
50104,BELEN DE URMIRI,estado nutricional en menores de 5 anos,clasificacion e,2003-08-01,2,2,2,2,4
90104,BELLA FLOR,estado nutricional en menores de 5 anos,clasificacion e,2003-08-01,2,4,2,4,6
60202,BERMEJO,estado nutricional en menores de 5 anos,clasificacion e,2003-08-01,0,1,0,1,1
50301,BETANZOS,estado nutricional en menores de 5 anos,clasificacion e,2003-08-01,109,96,109,96,205
31501,BOLIVAR,estado nutricional en menores de 5 anos,clasificacion e,2003-08-01,24,12,24,12,36
90103,BOLPEBRA,estado nutricional en menores de 5 anos,clasificacion e,2003-08-01,2,0,2,0,2
70707,BOYUIBE,estado nutricional en menores de 5 anos,clasificacion e,2003-08-01,1,2,1,2,3
70401,BUENA VISTA,estado nutricional en menores de 5 anos,clasificacion e,2003-08-01,2,3,2,3,5
70703,CABEZAS,estado nutricional en menores de 5 anos,clasificacion e,2003-08-01,3,2,3,2,5
20905,CAIROMA,estado nutricional en menores de 5 anos,clasificacion e,2003-08-01,22,19,22,19,41
51102,"CAIZA ""D""",estado nutricional en menores de 5 anos,clasificacion e,2003-08-01,21,13,21,13,34
21003,CAJUATA,estado nutricional en menores de 5 anos,clasificacion e,2003-08-01,14,13,14,13,27
20303,CALACOTO,estado nutricional en menores de 5 anos,clasificacion e,2003-08-01,1,2,1,2,3
21304,CALAMARCA,estado nutricional en menores de 5 anos,clasificacion e,2003-08-01,58,33,58,33,91
10701,CAMARGO,estado nutricional en menores de 5 anos,clasificacion e,2003-08-01,22,10,22,10,32
10901,CAMATAQUI (C. VILLA ABECIA),estado nutricional en menores de 5 anos,clasificacion e,2003-08-01,3,1,3,1,4
70706,CAMIRI,estado nutricional en menores de 5 anos,clasificacion e,2003-08-01,26,18,26,18,44
30701,CAPINOTA,estado nutricional en menores de 5 anos,clasificacion e,2003-08-01,15,21,15,21,36
20302,CAQUIAVIRI,estado nutricional en menores de 5 anos,clasificacion e,2003-08-01,11,4,11,4,15
40102,CARACOLLO,estado nutricional en menores de 5 anos,clasificacion e,2003-08-01,9,4,9,4,13
22001,CARANAVI,estado nutricional en menores de 5 anos,clasificacion e,2003-08-01,37,25,37,25,62
60302,CARAPARI,estado nutricional en menores de 5 anos,clasificacion e,2003-08-01,9,2,9,2,11
50702,CARIPUYO,estado nutricional en menores de 5 anos,clasificacion e,2003-08-01,44,26,44,26,70
21902,CATACORA,estado nutricional en menores de 5 anos,clasificacion e,2003-08-01,1,3,1,3,4
40201,CHALLAPATA,estado nutricional en menores de 5 anos,clasificacion e,2003-08-01,33,24,33,24,57
50302,CHAQUI,estado nutricional en menores de 5 anos,clasificacion e,2003-08-01,16,10,16,10,26
70702,CHARAGUA,estado nutricional en menores de 5 anos,clasificacion e,2003-08-01,18,33,18,33,51
20305,CHARAÃ‘A,estado nutricional en menores de 5 anos,clasificacion e,2003-08-01,2,0,2,0,2
50202,CHAYANTA,estado nutricional en menores de 5 anos,clasificacion e,2003-08-01,22,20,22,20,42
31204,CHIMORE,estado nutricional en menores de 5 anos,clasificacion e,2003-08-01,5,2,5,2,7
40302,CHOQUE COTA,estado nutricional en menores de 5 anos,clasificacion e,2003-08-01,0,1,0,1,1
20501,CHUMA,estado nutricional en menores de 5 anos,clasificacion e,2003-08-01,8,4,8,4,12
90101,COBIJA,estado nutricional en menores de 5 anos,clasificacion e,2003-08-01,24,19,24,19,43
30101,COCHABAMBA,estado nutricional en menores de 5 anos,clasificacion e,2003-08-01,94,44,94,44,138
30905,COLCAPIRHUA,estado nutricional en menores de 5 anos,clasificacion e,2003-08-01,7,2,7,2,9
50901,"COLCHA ""K""",estado nutricional en menores de 5 anos,clasificacion e,2003-08-01,8,2,8,2,10
31002,COLOMI,estado nutricional en menores de 5 anos,clasificacion e,2003-08-01,11,5,11,5,16
50401,COLQUECHACA,estado nutricional en menores de 5 anos,clasificacion e,2003-08-01,73,44,73,44,117
21306,COLQUENCHA,estado nutricional en menores de 5 anos,clasificacion e,2003-08-01,10,6,10,6,16
21004,COLQUIRI,estado nutricional en menores de 5 anos,clasificacion e,2003-08-01,21,16,21,16,37
71301,COMARAPA,estado nutricional en menores de 5 anos,clasificacion e,2003-08-01,14,11,14,11,25
20605,COMBAYA,estado nutricional en menores de 5 anos,clasificacion e,2003-08-01,2,2,2,2,4
71101,CONCEPCION,estado nutricional en menores de 5 anos,clasificacion e,2003-08-01,4,6,4,6,10
21701,COPACABANA,estado nutricional en menores de 5 anos,clasificacion e,2003-08-01,4,2,4,2,6
21402,CORIPATA,estado nutricional en menores de 5 anos,clasificacion e,2003-08-01,2,0,2,0,2
20301,CORO CORO,estado nutricional en menores de 5 anos,clasificacion e,2003-08-01,13,7,13,7,20
21401,COROICO,estado nutricional en menores de 5 anos,clasificacion e,2003-08-01,7,6,7,6,13
40301,CORQUE,estado nutricional en menores de 5 anos,clasificacion e,2003-08-01,1,0,1,0,1
50601,COTAGAITA,estado nutricional en menores de 5 anos,clasificacion e,2003-08-01,66,100,66,100,166
70704,CUEVO,estado nutricional en menores de 5 anos,clasificacion e,2003-08-01,2,5,2,5,7
10902,CULPINA,estado nutricional en menores de 5 anos,clasificacion e,2003-08-01,50,42,50,42,92
40401,CURAHUARA DE CARANGAS,estado nutricional en menores de 5 anos,clasificacion e,2003-08-01,6,5,6,5,11
21602,CURVA,estado nutricional en menores de 5 anos,clasificacion e,2003-08-01,0,1,0,1,1
20804,DESAGUADERO,estado nutricional en menores de 5 anos,clasificacion e,2003-08-01,2,0,2,0,2
20105,EL ALTO,estado nutricional en menores de 5 anos,clasificacion e,2003-08-01,385,241,385,241,626
40103,EL CHORO,estado nutricional en menores de 5 anos,clasificacion e,2003-08-01,1,1,1,1,2
71503,EL PUENTE(STC),estado nutricional en menores de 5 anos,clasificacion e,2003-08-01,2,19,2,19,21
60502,EL PUENTE(TJA),estado nutricional en menores de 5 anos,clasificacion e,2003-08-01,11,23,11,23,34
70105,EL TORNO,estado nutricional en menores de 5 anos,clasificacion e,2003-08-01,16,10,16,10,26
10405,EL VILLAR,estado nutricional en menores de 5 anos,clasificacion e,2003-08-01,17,42,17,42,59
60601,ENTRE RIOS,estado nutricional en menores de 5 anos,clasificacion e,2003-08-01,9,15,9,15,24
41101,EUCALIPTUS,estado nutricional en menores de 5 anos,clasificacion e,2003-08-01,2,3,2,3,5
80402,EXALTACION,estado nutricional en menores de 5 anos,clasificacion e,2003-08-01,6,4,6,4,10
90203,FILADELFIA,estado nutricional en menores de 5 anos,clasificacion e,2003-08-01,1,1,1,1,2
71002,GENERAL SAAVEDRA,estado nutricional en menores de 5 anos,clasificacion e,2003-08-01,26,19,26,19,45
21601,GRAL. J.J. PEREZ (CHARAZANI),estado nutricional en menores de 5 anos,clasificacion e,2003-08-01,12,14,12,14,26
20602,GUANAY,estado nutricional en menores de 5 anos,clasificacion e,2003-08-01,26,32,26,32,58
20802,GUAQUI,estado nutricional en menores de 5 anos,clasificacion e,2003-08-01,2,0,2,0,2
80202,GUAYARAMERIN,estado nutricional en menores de 5 anos,clasificacion e,2003-08-01,26,18,26,18,44
70705,GUTIERREZ,estado nutricional en menores de 5 anos,clasificacion e,2003-08-01,22,32,22,32,54
10502,HUACARETA,estado nutricional en menores de 5 anos,clasificacion e,2003-08-01,21,16,21,16,37
11002,HUACAYA (VILLA DE HUACAYA),estado nutricional en menores de 5 anos,clasificacion e,2003-08-01,1,5,1,5,6
40701,HUANUNI,estado nutricional en menores de 5 anos,clasificacion e,2003-08-01,4,9,4,9,13
80803,HUARACAJE,estado nutricional en menores de 5 anos,clasificacion e,2003-08-01,9,3,9,3,12
41601,HUAYLLAMARCA,estado nutricional en menores de 5 anos,clasificacion e,2003-08-01,3,1,3,1,4
21005,ICHOCA,estado nutricional en menores de 5 anos,clasificacion e,2003-08-01,7,11,7,11,18
10304,ICLA,estado nutricional en menores de 5 anos,clasificacion e,2003-08-01,47,67,47,67,114
10703,INCAHUASI,estado nutricional en menores de 5 anos,clasificacion e,2003-08-01,79,40,79,40,119
21001,INQUISIVI,estado nutricional en menores de 5 anos,clasificacion e,2003-08-01,26,24,26,24,50
21102,IRUPANA (VILLA DE LANZA),estado nutricional en menores de 5 anos,clasificacion e,2003-08-01,6,10,6,10,16
21501,IXIAMAS,estado nutricional en menores de 5 anos,clasificacion e,2003-08-01,6,7,6,7,13
21105,LA ASUNTA,estado nutricional en menores de 5 anos,clasificacion e,2003-08-01,3,9,3,9,12
70104,LA GUARDIA,estado nutricional en menores de 5 anos,clasificacion e,2003-08-01,10,1,10,1,11
20101,LA PAZ,estado nutricional en menores de 5 anos,clasificacion e,2003-08-01,211,142,211,142,353
70701,LAGUNILLAS,estado nutricional en menores de 5 anos,clasificacion e,2003-08-01,8,8,8,8,16
21202,LAJA,estado nutricional en menores de 5 anos,clasificacion e,2003-08-01,5,1,5,1,6
10903,LAS CARRERAS,estado nutricional en menores de 5 anos,clasificacion e,2003-08-01,6,8,6,8,14
21006,LICOMA PAMPA,estado nutricional en menores de 5 anos,clasificacion e,2003-08-01,3,2,3,2,5
50203,LLALLAGUA,estado nutricional en menores de 5 anos,clasificacion e,2003-08-01,3,92,3,92,95
51401,LLICA,estado nutricional en menores de 5 anos,clasificacion e,2003-08-01,1,1,1,1,2
20901,LURIBAY,estado nutricional en menores de 5 anos,clasificacion e,2003-08-01,15,4,15,4,19
40702,MACHACAMARCA,estado nutricional en menores de 5 anos,clasificacion e,2003-08-01,3,1,3,1,4
11003,MACHARETI,estado nutricional en menores de 5 anos,clasificacion e,2003-08-01,8,14,8,14,22
80801,MAGDALENA,estado nutricional en menores de 5 anos,clasificacion e,2003-08-01,5,0,5,0,5
70903,MAIRANA,estado nutricional en menores de 5 anos,clasificacion e,2003-08-01,2,1,2,1,3
20904,MALLA,estado nutricional en menores de 5 anos,clasificacion e,2003-08-01,1,0,1,0,1
71003,MINEROS,estado nutricional en menores de 5 anos,clasificacion e,2003-08-01,15,10,15,10,25
31301,MIZQUE,estado nutricional en menores de 5 anos,clasificacion e,2003-08-01,12,12,12,12,24
20402,MOCOMOCO,estado nutricional en menores de 5 anos,clasificacion e,2003-08-01,13,13,13,13,26
51002,MOJINETE,estado nutricional en menores de 5 anos,clasificacion e,2003-08-01,0,2,0,2,2
10303,MOJOCOYA,estado nutricional en menores de 5 anos,clasificacion e,2003-08-01,21,28,21,28,49
10501,MONTEAGUDO,estado nutricional en menores de 5 anos,clasificacion e,2003-08-01,43,29,43,29,72
71001,MONTERO,estado nutricional en menores de 5 anos,clasificacion e,2003-08-01,34,27,34,27,61
70803,MORO MORO,estado nutricional en menores de 5 anos,clasificacion e,2003-08-01,3,1,3,1,4
30302,MOROCHATA,estado nutricional en menores de 5 anos,clasificacion e,2003-08-01,39,35,39,35,74
20307,NAZACARA DE PACAJES,estado nutricional en menores de 5 anos,clasificacion e,2003-08-01,1,0,1,0,1
50404,OCURI,estado nutricional en menores de 5 anos,clasificacion e,2003-08-01,46,37,46,37,83
30203,OMEREQUE,estado nutricional en menores de 5 anos,clasificacion e,2003-08-01,1,1,1,1,2
40101,ORURO,estado nutricional en menores de 5 anos,clasificacion e,2003-08-01,132,57,132,57,189
60201,PADCAYA,estado nutricional en menores de 5 anos,clasificacion e,2003-08-01,7,5,7,5,12
10401,PADILLA,estado nutricional en menores de 5 anos,clasificacion e,2003-08-01,25,39,25,39,64
70502,PAILON,estado nutricional en menores de 5 anos,clasificacion e,2003-08-01,1,1,1,1,2
20102,PALCA,estado nutricional en menores de 5 anos,clasificacion e,2003-08-01,10,12,10,12,22
21104,PALOS BLANCOS,estado nutricional en menores de 5 anos,clasificacion e,2003-08-01,14,1,14,1,15
40802,PAMPA AULLAGAS,estado nutricional en menores de 5 anos,clasificacion e,2003-08-01,2,1,2,1,3
70902,PAMPA GRANDE,estado nutricional en menores de 5 anos,clasificacion e,2003-08-01,5,4,5,4,9
21802,PAPEL PAMPA,estado nutricional en menores de 5 anos,clasificacion e,2003-08-01,2,0,2,0,2
30202,PASORAPA,estado nutricional en menores de 5 anos,clasificacion e,2003-08-01,4,4,4,4,8
21305,PATACAMAYA,estado nutricional en menores de 5 anos,clasificacion e,2003-08-01,38,30,38,30,68
40602,PAZÃ‘A,estado nutricional en menores de 5 anos,clasificacion e,2003-08-01,1,2,1,2,3
20702,PELECHUCO,estado nutricional en menores de 5 anos,clasificacion e,2003-08-01,7,3,7,3,10
50403,POCOATA,estado nutricional en menores de 5 anos,clasificacion e,2003-08-01,29,50,29,50,79
31203,POCONA,estado nutricional en menores de 5 anos,clasificacion e,2003-08-01,23,9,23,9,32
31202,POJO (CBBA),estado nutricional en menores de 5 anos,clasificacion e,2003-08-01,27,16,27,16,43
40601,POOPO,estado nutricional en menores de 5 anos,clasificacion e,2003-08-01,0,1,0,1,1
51203,PORCO,estado nutricional en menores de 5 anos,clasificacion e,2003-08-01,10,2,10,2,12
10103,POROMA,estado nutricional en menores de 5 anos,clasificacion e,2003-08-01,68,71,68,71,139
70103,PORONGO,estado nutricional en menores de 5 anos,clasificacion e,2003-08-01,1,0,1,0,1
70601,PORTACHUELO,estado nutricional en menores de 5 anos,clasificacion e,2003-08-01,14,7,14,7,21
90102,PORVENIR,estado nutricional en menores de 5 anos,clasificacion e,2003-08-01,4,2,4,2,6
70804,POSTRER VALLE,estado nutricional en menores de 5 anos,clasificacion e,2003-08-01,2,2,2,2,4
50101,POTOSI,estado nutricional en menores de 5 anos,clasificacion e,2003-08-01,149,99,149,99,248
10302,PRESTO,estado nutricional en menores de 5 anos,clasificacion e,2003-08-01,29,32,29,32,61
70805,PUCARA,estado nutricional en menores de 5 anos,clasificacion e,2003-08-01,1,2,1,2,3
21201,PUCARANI,estado nutricional en menores de 5 anos,clasificacion e,2003-08-01,6,4,6,4,10
20401,PUERTO ACOSTA,estado nutricional en menores de 5 anos,clasificacion e,2003-08-01,8,15,8,15,23
20403,PUERTO CARABUCO,estado nutricional en menores de 5 anos,clasificacion e,2003-08-01,16,11,16,11,27
90301,PUERTO GONZALO MORENO,estado nutricional en menores de 5 anos,clasificacion e,2003-08-01,4,3,4,3,7
21204,PUERTO PEREZ,estado nutricional en menores de 5 anos,clasificacion e,2003-08-01,6,1,6,1,7
71402,PUERTO QUIJARRO,estado nutricional en menores de 5 anos,clasificacion e,2003-08-01,4,0,4,0,4
90201,PUERTO RICO,estado nutricional en menores de 5 anos,clasificacion e,2003-08-01,1,2,1,2,3
71401,PUERTO SUAREZ,estado nutricional en menores de 5 anos,clasificacion e,2003-08-01,3,5,3,5,8
31205,PUERTO VILLARROEL,estado nutricional en menores de 5 anos,clasificacion e,2003-08-01,35,34,35,34,69
51101,PUNA,estado nutricional en menores de 5 anos,clasificacion e,2003-08-01,4,1,4,1,5
31401,PUNATA,estado nutricional en menores de 5 anos,clasificacion e,2003-08-01,15,20,15,20,35
20604,QUIABAYA,estado nutricional en menores de 5 anos,clasificacion e,2003-08-01,7,8,7,8,15
30901,QUILLACOLLO,estado nutricional en menores de 5 anos,clasificacion e,2003-08-01,27,16,27,16,43
21002,QUIME,estado nutricional en menores de 5 anos,clasificacion e,2003-08-01,7,6,7,6,13
50402,RAVELO,estado nutricional en menores de 5 anos,clasificacion e,2003-08-01,61,58,61,58,119
80301,REYES,estado nutricional en menores de 5 anos,clasificacion e,2003-08-01,1,5,1,5,6
80201,RIBERALTA,estado nutricional en menores de 5 anos,clasificacion e,2003-08-01,113,51,113,51,164
70503,ROBORE,estado nutricional en menores de 5 anos,clasificacion e,2003-08-01,5,3,5,3,8
40901,SABAYA,estado nutricional en menores de 5 anos,clasificacion e,2003-08-01,1,2,1,2,3
31001,SACABA,estado nutricional en menores de 5 anos,clasificacion e,2003-08-01,35,6,35,6,41
30404,SACABAMBA,estado nutricional en menores de 5 anos,clasificacion e,2003-08-01,11,9,11,9,20
50701,SACACA,estado nutricional en menores de 5 anos,clasificacion e,2003-08-01,77,104,77,104,181
71302,SAIPINA,estado nutricional en menores de 5 anos,clasificacion e,2003-08-01,3,6,3,6,9
40801,SALINAS DE GARCI MENDOZA,estado nutricional en menores de 5 anos,clasificacion e,2003-08-01,2,3,2,3,5
70901,SAMAIPATA,estado nutricional en menores de 5 anos,clasificacion e,2003-08-01,4,3,4,3,7
51601,SAN AGUSTIN,estado nutricional en menores de 5 anos,clasificacion e,2003-08-01,0,2,0,2,2
51003,SAN ANTONIO DE ESMORUCO,estado nutricional en menores de 5 anos,clasificacion e,2003-08-01,2,0,2,0,2
71105,SAN ANTONIO DE LOMERIO,estado nutricional en menores de 5 anos,clasificacion e,2003-08-01,23,42,23,42,65
31403,SAN BENITO,estado nutricional en menores de 5 anos,clasificacion e,2003-08-01,5,0,5,0,5
80302,SAN BORJA,estado nutricional en menores de 5 anos,clasificacion e,2003-08-01,51,45,51,45,96
21502,SAN BUENA VENTURA,estado nutricional en menores de 5 anos,clasificacion e,2003-08-01,12,3,12,3,15
70402,SAN CARLOS,estado nutricional en menores de 5 anos,clasificacion e,2003-08-01,11,18,11,18,29
80501,SAN IGNACIO,estado nutricional en menores de 5 anos,clasificacion e,2003-08-01,26,13,26,13,39
70301,SAN IGNACIO DE VELASCO,estado nutricional en menores de 5 anos,clasificacion e,2003-08-01,68,78,68,78,146
71102,SAN JAVIER(STC),estado nutricional en menores de 5 anos,clasificacion e,2003-08-01,6,2,6,2,8
80701,SAN JOAQUIN,estado nutricional en menores de 5 anos,clasificacion e,2003-08-01,1,1,1,1,2
70501,SAN JOSE DE CHIQUITOS,estado nutricional en menores de 5 anos,clasificacion e,2003-08-01,3,0,3,0,3
71104,SAN JULIAN,estado nutricional en menores de 5 anos,clasificacion e,2003-08-01,36,39,36,39,75
90302,SAN LORENZO(PND),estado nutricional en menores de 5 anos,clasificacion e,2003-08-01,8,0,8,0,8
60501,SAN LORENZO(TJA),estado nutricional en menores de 5 anos,clasificacion e,2003-08-01,15,25,15,25,40
10702,SAN LUCAS,estado nutricional en menores de 5 anos,clasificacion e,2003-08-01,181,118,181,118,299
71201,SAN MATIAS,estado nutricional en menores de 5 anos,clasificacion e,2003-08-01,20,6,20,6,26
70302,SAN MIGUEL DE VELASCO,estado nutricional en menores de 5 anos,clasificacion e,2003-08-01,11,19,11,19,30
51001,SAN PABLO DE LIPEZ,estado nutricional en menores de 5 anos,clasificacion e,2003-08-01,2,4,2,4,6
50501,SAN PEDRO DE BUENA VISTA,estado nutricional en menores de 5 anos,clasificacion e,2003-08-01,42,53,42,53,95
21801,SAN PEDRO DE CURAHUARA,estado nutricional en menores de 5 anos,clasificacion e,2003-08-01,3,3,3,3,6
70303,SAN RAFAEL,estado nutricional en menores de 5 anos,clasificacion e,2003-08-01,6,5,6,5,11
80401,SANTA ANA,estado nutricional en menores de 5 anos,clasificacion e,2003-08-01,15,5,15,5,20
70101,SANTA CRUZ DE LA SIERRA,estado nutricional en menores de 5 anos,clasificacion e,2003-08-01,124,51,124,51,175
80303,SANTA ROSA,estado nutricional en menores de 5 anos,clasificacion e,2003-08-01,6,4,6,4,10
70602,SANTA ROSA DEL SARA,estado nutricional en menores de 5 anos,clasificacion e,2003-08-01,1,5,1,5,6
20308,SANTIAGO DE CALLAPA,estado nutricional en menores de 5 anos,clasificacion e,2003-08-01,5,3,5,3,8
41401,SANTIAGO DE HUARI,estado nutricional en menores de 5 anos,clasificacion e,2003-08-01,5,4,5,4,9
21901,SANTIAGO DE MACHACA,estado nutricional en menores de 5 anos,clasificacion e,2003-08-01,1,2,1,2,3
30702,SANTIVAÃ‘ES,estado nutricional en menores de 5 anos,clasificacion e,2003-08-01,7,1,7,1,8
20902,SAPAHAQUI,estado nutricional en menores de 5 anos,clasificacion e,2003-08-01,14,13,14,13,27
90303,SENA,estado nutricional en menores de 5 anos,clasificacion e,2003-08-01,13,10,13,10,23
21301,SICA SICA (VILLA AROMA),estado nutricional en menores de 5 anos,clasificacion e,2003-08-01,36,22,36,22,58
30703,SICAYA,estado nutricional en menores de 5 anos,clasificacion e,2003-08-01,12,4,12,4,16
30902,SIPE SIPE,estado nutricional en menores de 5 anos,clasificacion e,2003-08-01,26,17,26,17,43
10403,SOPACHUY,estado nutricional en menores de 5 anos,clasificacion e,2003-08-01,30,25,30,25,55
20601,SORATA,estado nutricional en menores de 5 anos,clasificacion e,2003-08-01,4,7,4,7,11
10101,SUCRE,estado nutricional en menores de 5 anos,clasificacion e,2003-08-01,137,118,137,118,255
20603,TACACOMA,estado nutricional en menores de 5 anos,clasificacion e,2003-08-01,8,6,8,6,14
50303,TACOBAMBA,estado nutricional en menores de 5 anos,clasificacion e,2003-08-01,29,23,29,23,52
30602,TACOPAYA,estado nutricional en menores de 5 anos,clasificacion e,2003-08-01,38,26,38,26,64
31101,TAPACARI,estado nutricional en menores de 5 anos,clasificacion e,2003-08-01,41,22,41,22,63
10601,TARABUCO,estado nutricional en menores de 5 anos,clasificacion e,2003-08-01,126,129,126,129,255
30401,TARATA,estado nutricional en menores de 5 anos,clasificacion e,2003-08-01,7,5,7,5,12
60101,TARIJA,estado nutricional en menores de 5 anos,clasificacion e,2003-08-01,43,31,43,31,74
10202,TARVITA,estado nutricional en menores de 5 anos,clasificacion e,2003-08-01,80,127,80,127,207
20803,TIAWANACU,estado nutricional en menores de 5 anos,clasificacion e,2003-08-01,3,2,3,2,5
50102,TINGUIPAYA,estado nutricional en menores de 5 anos,clasificacion e,2003-08-01,33,55,33,55,88
20606,TIPUANI,estado nutricional en menores de 5 anos,clasificacion e,2003-08-01,3,2,3,2,5
30903,TIQUIPAYA,estado nutricional en menores de 5 anos,clasificacion e,2003-08-01,9,4,9,4,13
31601,TIRAQUE (CBBA),estado nutricional en menores de 5 anos,clasificacion e,2003-08-01,30,24,30,24,54
21703,TITO YUPANQUI (PARQUIPUJIO),estado nutricional en menores de 5 anos,clasificacion e,2003-08-01,1,0,1,0,1
30802,TOCO,estado nutricional en menores de 5 anos,clasificacion e,2003-08-01,0,1,0,1,1
30803,TOLATA,estado nutricional en menores de 5 anos,clasificacion e,2003-08-01,3,2,3,2,5
41001,TOLEDO,estado nutricional en menores de 5 anos,clasificacion e,2003-08-01,3,0,3,0,3
51202,TOMAVE,estado nutricional en menores de 5 anos,clasificacion e,2003-08-01,17,17,17,17,34
10402,TOMINA,estado nutricional en menores de 5 anos,clasificacion e,2003-08-01,40,43,40,43,83
50502,TORO TORO,estado nutricional en menores de 5 anos,clasificacion e,2003-08-01,34,37,34,37,71
31201,TOTORA(CBBA),estado nutricional en menores de 5 anos,clasificacion e,2003-08-01,17,8,17,8,25
41301,TOTORA(ORR),estado nutricional en menores de 5 anos,clasificacion e,2003-08-01,2,1,2,1,3
80101,TRINIDAD,estado nutricional en menores de 5 anos,clasificacion e,2003-08-01,34,29,34,29,63
50801,TUPIZA,estado nutricional en menores de 5 anos,clasificacion e,2003-08-01,20,51,20,51,71
40402,TURCO,estado nutricional en menores de 5 anos,clasificacion e,2003-08-01,2,2,2,2,4
21302,UMALA,estado nutricional en menores de 5 anos,clasificacion e,2003-08-01,6,15,6,15,21
50201,UNCIA,estado nutricional en menores de 5 anos,clasificacion e,2003-08-01,6,2,6,2,8
60401,URIONDO (A. CONCEPCION),estado nutricional en menores de 5 anos,clasificacion e,2003-08-01,8,12,8,12,20
71502,URUBICHA,estado nutricional en menores de 5 anos,clasificacion e,2003-08-01,20,30,20,30,50
51201,UYUNI,estado nutricional en menores de 5 anos,clasificacion e,2003-08-01,6,7,6,7,13
30502,VACAS,estado nutricional en menores de 5 anos,clasificacion e,2003-08-01,17,4,17,4,21
70801,VALLEGRANDE,estado nutricional en menores de 5 anos,clasificacion e,2003-08-01,5,6,5,6,11
20801,VIACHA,estado nutricional en menores de 5 anos,clasificacion e,2003-08-01,24,5,24,5,29
31302,VILA VILA,estado nutricional en menores de 5 anos,clasificacion e,2003-08-01,9,11,9,11,20
60303,VILLA MONTES,estado nutricional en menores de 5 anos,clasificacion e,2003-08-01,19,11,19,11,30
31402,VILLA RIVERO,estado nutricional en menores de 5 anos,clasificacion e,2003-08-01,6,7,6,7,13
10801,VILLA SERRANO,estado nutricional en menores de 5 anos,clasificacion e,2003-08-01,38,63,38,63,101
31003,VILLA TUNARI,estado nutricional en menores de 5 anos,clasificacion e,2003-08-01,39,34,39,34,73
11001,VILLA VACA GUZMAN (MUYUPAMPA),estado nutricional en menores de 5 anos,clasificacion e,2003-08-01,8,8,8,8,16
51501,VILLAZON,estado nutricional en menores de 5 anos,clasificacion e,2003-08-01,21,21,21,21,42
30904,VINTO,estado nutricional en menores de 5 anos,clasificacion e,2003-08-01,7,6,7,6,13
50602,VITICHI,estado nutricional en menores de 5 anos,clasificacion e,2003-08-01,56,46,56,46,102
20306,WALDO BALLIVIAN,estado nutricional en menores de 5 anos,clasificacion e,2003-08-01,0,2,0,2,2
20903,YACO,estado nutricional en menores de 5 anos,clasificacion e,2003-08-01,32,15,32,15,47
60301,YACUIBA,estado nutricional en menores de 5 anos,clasificacion e,2003-08-01,20,11,20,11,31
10602,YAMPARAEZ,estado nutricional en menores de 5 anos,clasificacion e,2003-08-01,75,52,75,52,127
21103,YANACACHI,estado nutricional en menores de 5 anos,clasificacion e,2003-08-01,0,2,0,2,2
70403,YAPACANI,estado nutricional en menores de 5 anos,clasificacion e,2003-08-01,26,18,26,18,44
50103,YOCALLA,estado nutricional en menores de 5 anos,clasificacion e,2003-08-01,2,3,2,3,5
10102,YOTALA,estado nutricional en menores de 5 anos,clasificacion e,2003-08-01,31,38,31,38,69
60402,YUNCHARA,estado nutricional en menores de 5 anos,clasificacion e,2003-08-01,12,26,12,26,38
10301,ZUDAÃ‘EZ,estado nutricional en menores de 5 anos,clasificacion e,2003-08-01,24,28,24,28,52
51302,ACACIO,estado nutricional en menores de 5 anos,clasificacion e,2003-09-01,21,33,21,33,54
20201,ACHACACHI,estado nutricional en menores de 5 anos,clasificacion e,2003-09-01,14,8,14,8,22
20104,ACHOCALLA,estado nutricional en menores de 5 anos,clasificacion e,2003-09-01,6,5,6,5,11
30201,AIQUILE,estado nutricional en menores de 5 anos,clasificacion e,2003-09-01,19,9,19,9,28
10404,ALCALA,estado nutricional en menores de 5 anos,clasificacion e,2003-09-01,11,31,11,31,42
20202,ANCORAIMES,estado nutricional en menores de 5 anos,clasificacion e,2003-09-01,9,13,9,13,22
41201,ANDAMARCA,estado nutricional en menores de 5 anos,clasificacion e,2003-09-01,2,1,2,1,3
30402,ANZALDO,estado nutricional en menores de 5 anos,clasificacion e,2003-09-01,3,9,3,9,12
20701,APOLO,estado nutricional en menores de 5 anos,clasificacion e,2003-09-01,11,7,11,7,18
51301,ARAMPAMPA,estado nutricional en menores de 5 anos,clasificacion e,2003-09-01,9,20,9,20,29
30501,ARANI,estado nutricional en menores de 5 anos,clasificacion e,2003-09-01,7,17,7,17,24
30403,ARBIETO,estado nutricional en menores de 5 anos,clasificacion e,2003-09-01,1,0,1,0,1
30601,ARQUE,estado nutricional en menores de 5 anos,clasificacion e,2003-09-01,29,13,29,13,42
71501,ASCENCION DE GUARAYOS,estado nutricional en menores de 5 anos,clasificacion e,2003-09-01,2,2,2,2,4
50802,ATOCHA,estado nutricional en menores de 5 anos,clasificacion e,2003-09-01,4,39,4,39,43
20503,AUCAPATA,estado nutricional en menores de 5 anos,clasificacion e,2003-09-01,8,1,8,1,9
20502,AYATA,estado nutricional en menores de 5 anos,clasificacion e,2003-09-01,6,2,6,2,8
21303,AYO AYO,estado nutricional en menores de 5 anos,clasificacion e,2003-09-01,1,0,1,0,1
30301,AYOPAYA (V. DE INDEPENDENCIA),estado nutricional en menores de 5 anos,clasificacion e,2003-09-01,22,12,22,12,34
10201,AZURDUY,estado nutricional en menores de 5 anos,clasificacion e,2003-09-01,78,59,78,59,137
21203,BATALLAS,estado nutricional en menores de 5 anos,clasificacion e,2003-09-01,7,2,7,2,9
80802,BAURES,estado nutricional en menores de 5 anos,clasificacion e,2003-09-01,2,3,2,3,5
41202,BELEN DE ANDAMARCA,estado nutricional en menores de 5 anos,clasificacion e,2003-09-01,1,0,1,0,1
50104,BELEN DE URMIRI,estado nutricional en menores de 5 anos,clasificacion e,2003-09-01,3,6,3,6,9
90104,BELLA FLOR,estado nutricional en menores de 5 anos,clasificacion e,2003-09-01,2,3,2,3,5
60202,BERMEJO,estado nutricional en menores de 5 anos,clasificacion e,2003-09-01,4,2,4,2,6
50301,BETANZOS,estado nutricional en menores de 5 anos,clasificacion e,2003-09-01,108,76,108,76,184
31501,BOLIVAR,estado nutricional en menores de 5 anos,clasificacion e,2003-09-01,48,25,48,25,73
90103,BOLPEBRA,estado nutricional en menores de 5 anos,clasificacion e,2003-09-01,3,1,3,1,4
70707,BOYUIBE,estado nutricional en menores de 5 anos,clasificacion e,2003-09-01,1,2,1,2,3
70401,BUENA VISTA,estado nutricional en menores de 5 anos,clasificacion e,2003-09-01,4,15,4,15,19
70703,CABEZAS,estado nutricional en menores de 5 anos,clasificacion e,2003-09-01,1,0,1,0,1
20905,CAIROMA,estado nutricional en menores de 5 anos,clasificacion e,2003-09-01,17,14,17,14,31
51102,"CAIZA ""D""",estado nutricional en menores de 5 anos,clasificacion e,2003-09-01,23,22,23,22,45
21003,CAJUATA,estado nutricional en menores de 5 anos,clasificacion e,2003-09-01,17,8,17,8,25
20303,CALACOTO,estado nutricional en menores de 5 anos,clasificacion e,2003-09-01,1,0,1,0,1
21304,CALAMARCA,estado nutricional en menores de 5 anos,clasificacion e,2003-09-01,46,27,46,27,73
10701,CAMARGO,estado nutricional en menores de 5 anos,clasificacion e,2003-09-01,25,26,25,26,51
10901,CAMATAQUI (C. VILLA ABECIA),estado nutricional en menores de 5 anos,clasificacion e,2003-09-01,1,2,1,2,3
70706,CAMIRI,estado nutricional en menores de 5 anos,clasificacion e,2003-09-01,33,27,33,27,60
30701,CAPINOTA,estado nutricional en menores de 5 anos,clasificacion e,2003-09-01,11,8,11,8,19
20302,CAQUIAVIRI,estado nutricional en menores de 5 anos,clasificacion e,2003-09-01,7,5,7,5,12
40102,CARACOLLO,estado nutricional en menores de 5 anos,clasificacion e,2003-09-01,7,2,7,2,9
22001,CARANAVI,estado nutricional en menores de 5 anos,clasificacion e,2003-09-01,22,15,22,15,37
60302,CARAPARI,estado nutricional en menores de 5 anos,clasificacion e,2003-09-01,5,0,5,0,5
50702,CARIPUYO,estado nutricional en menores de 5 anos,clasificacion e,2003-09-01,19,34,19,34,53
21902,CATACORA,estado nutricional en menores de 5 anos,clasificacion e,2003-09-01,1,1,1,1,2
40201,CHALLAPATA,estado nutricional en menores de 5 anos,clasificacion e,2003-09-01,26,20,26,20,46
50302,CHAQUI,estado nutricional en menores de 5 anos,clasificacion e,2003-09-01,18,18,18,18,36
70702,CHARAGUA,estado nutricional en menores de 5 anos,clasificacion e,2003-09-01,16,16,16,16,32
20305,CHARAÃ‘A,estado nutricional en menores de 5 anos,clasificacion e,2003-09-01,3,2,3,2,5
50202,CHAYANTA,estado nutricional en menores de 5 anos,clasificacion e,2003-09-01,15,16,15,16,31
31204,CHIMORE,estado nutricional en menores de 5 anos,clasificacion e,2003-09-01,2,3,2,3,5
21101,CHULUMANI (V. DE LA LIBERTAD),estado nutricional en menores de 5 anos,clasificacion e,2003-09-01,2,3,2,3,5
20501,CHUMA,estado nutricional en menores de 5 anos,clasificacion e,2003-09-01,7,11,7,11,18
30801,CLIZA,estado nutricional en menores de 5 anos,clasificacion e,2003-09-01,1,2,1,2,3
90101,COBIJA,estado nutricional en menores de 5 anos,clasificacion e,2003-09-01,23,18,23,18,41
30101,COCHABAMBA,estado nutricional en menores de 5 anos,clasificacion e,2003-09-01,112,75,112,75,187
30905,COLCAPIRHUA,estado nutricional en menores de 5 anos,clasificacion e,2003-09-01,3,1,3,1,4
50901,"COLCHA ""K""",estado nutricional en menores de 5 anos,clasificacion e,2003-09-01,4,1,4,1,5
31002,COLOMI,estado nutricional en menores de 5 anos,clasificacion e,2003-09-01,20,20,20,20,40
50401,COLQUECHACA,estado nutricional en menores de 5 anos,clasificacion e,2003-09-01,79,56,79,56,135
21306,COLQUENCHA,estado nutricional en menores de 5 anos,clasificacion e,2003-09-01,2,0,2,0,2
21004,COLQUIRI,estado nutricional en menores de 5 anos,clasificacion e,2003-09-01,9,7,9,7,16
20304,COMANCHE,estado nutricional en menores de 5 anos,clasificacion e,2003-09-01,0,1,0,1,1
71301,COMARAPA,estado nutricional en menores de 5 anos,clasificacion e,2003-09-01,14,19,14,19,33
20605,COMBAYA,estado nutricional en menores de 5 anos,clasificacion e,2003-09-01,3,1,3,1,4
21701,COPACABANA,estado nutricional en menores de 5 anos,clasificacion e,2003-09-01,4,1,4,1,5
20301,CORO CORO,estado nutricional en menores de 5 anos,clasificacion e,2003-09-01,8,4,8,4,12
21401,COROICO,estado nutricional en menores de 5 anos,clasificacion e,2003-09-01,5,4,5,4,9
40301,CORQUE,estado nutricional en menores de 5 anos,clasificacion e,2003-09-01,5,3,5,3,8
50601,COTAGAITA,estado nutricional en menores de 5 anos,clasificacion e,2003-09-01,30,19,30,19,49
70704,CUEVO,estado nutricional en menores de 5 anos,clasificacion e,2003-09-01,1,1,1,1,2
10902,CULPINA,estado nutricional en menores de 5 anos,clasificacion e,2003-09-01,46,42,46,42,88
40401,CURAHUARA DE CARANGAS,estado nutricional en menores de 5 anos,clasificacion e,2003-09-01,8,2,8,2,10
21602,CURVA,estado nutricional en menores de 5 anos,clasificacion e,2003-09-01,3,0,3,0,3
20804,DESAGUADERO,estado nutricional en menores de 5 anos,clasificacion e,2003-09-01,1,0,1,0,1
20105,EL ALTO,estado nutricional en menores de 5 anos,clasificacion e,2003-09-01,344,229,344,229,573
71503,EL PUENTE(STC),estado nutricional en menores de 5 anos,clasificacion e,2003-09-01,2,9,2,9,11
60502,EL PUENTE(TJA),estado nutricional en menores de 5 anos,clasificacion e,2003-09-01,20,23,20,23,43
70105,EL TORNO,estado nutricional en menores de 5 anos,clasificacion e,2003-09-01,16,14,16,14,30
10405,EL VILLAR,estado nutricional en menores de 5 anos,clasificacion e,2003-09-01,17,39,17,39,56
60601,ENTRE RIOS,estado nutricional en menores de 5 anos,clasificacion e,2003-09-01,7,5,7,5,12
41101,EUCALIPTUS,estado nutricional en menores de 5 anos,clasificacion e,2003-09-01,3,1,3,1,4
90503,EUREKA (SANTOS MERCADO),estado nutricional en menores de 5 anos,clasificacion e,2003-09-01,0,2,0,2,2
80402,EXALTACION,estado nutricional en menores de 5 anos,clasificacion e,2003-09-01,2,4,2,4,6
90203,FILADELFIA,estado nutricional en menores de 5 anos,clasificacion e,2003-09-01,1,5,1,5,6
71002,GENERAL SAAVEDRA,estado nutricional en menores de 5 anos,clasificacion e,2003-09-01,23,18,23,18,41
21601,GRAL. J.J. PEREZ (CHARAZANI),estado nutricional en menores de 5 anos,clasificacion e,2003-09-01,10,16,10,16,26
20602,GUANAY,estado nutricional en menores de 5 anos,clasificacion e,2003-09-01,22,15,22,15,37
80202,GUAYARAMERIN,estado nutricional en menores de 5 anos,clasificacion e,2003-09-01,21,20,21,20,41
70705,GUTIERREZ,estado nutricional en menores de 5 anos,clasificacion e,2003-09-01,22,24,22,24,46
10502,HUACARETA,estado nutricional en menores de 5 anos,clasificacion e,2003-09-01,20,12,20,12,32
11002,HUACAYA (VILLA DE HUACAYA),estado nutricional en menores de 5 anos,clasificacion e,2003-09-01,4,3,4,3,7
40701,HUANUNI,estado nutricional en menores de 5 anos,clasificacion e,2003-09-01,11,9,11,9,20
80803,HUARACAJE,estado nutricional en menores de 5 anos,clasificacion e,2003-09-01,1,0,1,0,1
41601,HUAYLLAMARCA,estado nutricional en menores de 5 anos,clasificacion e,2003-09-01,2,2,2,2,4
21005,ICHOCA,estado nutricional en menores de 5 anos,clasificacion e,2003-09-01,11,6,11,6,17
10304,ICLA,estado nutricional en menores de 5 anos,clasificacion e,2003-09-01,36,62,36,62,98
10703,INCAHUASI,estado nutricional en menores de 5 anos,clasificacion e,2003-09-01,71,28,71,28,99
21001,INQUISIVI,estado nutricional en menores de 5 anos,clasificacion e,2003-09-01,25,23,25,23,48
21102,IRUPANA (VILLA DE LANZA),estado nutricional en menores de 5 anos,clasificacion e,2003-09-01,0,8,0,8,8
21501,IXIAMAS,estado nutricional en menores de 5 anos,clasificacion e,2003-09-01,11,8,11,8,19
21105,LA ASUNTA,estado nutricional en menores de 5 anos,clasificacion e,2003-09-01,15,13,15,13,28
70104,LA GUARDIA,estado nutricional en menores de 5 anos,clasificacion e,2003-09-01,11,3,11,3,14
20101,LA PAZ,estado nutricional en menores de 5 anos,clasificacion e,2003-09-01,192,103,192,103,295
70701,LAGUNILLAS,estado nutricional en menores de 5 anos,clasificacion e,2003-09-01,8,6,8,6,14
21202,LAJA,estado nutricional en menores de 5 anos,clasificacion e,2003-09-01,1,0,1,0,1
10903,LAS CARRERAS,estado nutricional en menores de 5 anos,clasificacion e,2003-09-01,10,7,10,7,17
50203,LLALLAGUA,estado nutricional en menores de 5 anos,clasificacion e,2003-09-01,28,51,28,51,79
51401,LLICA,estado nutricional en menores de 5 anos,clasificacion e,2003-09-01,1,3,1,3,4
80601,LORETO,estado nutricional en menores de 5 anos,clasificacion e,2003-09-01,2,0,2,0,2
20901,LURIBAY,estado nutricional en menores de 5 anos,clasificacion e,2003-09-01,11,11,11,11,22
40702,MACHACAMARCA,estado nutricional en menores de 5 anos,clasificacion e,2003-09-01,2,1,2,1,3
11003,MACHARETI,estado nutricional en menores de 5 anos,clasificacion e,2003-09-01,7,11,7,11,18
80801,MAGDALENA,estado nutricional en menores de 5 anos,clasificacion e,2003-09-01,4,1,4,1,5
70903,MAIRANA,estado nutricional en menores de 5 anos,clasificacion e,2003-09-01,6,0,6,0,6
20103,MECAPACA,estado nutricional en menores de 5 anos,clasificacion e,2003-09-01,0,7,0,7,7
71003,MINEROS,estado nutricional en menores de 5 anos,clasificacion e,2003-09-01,20,18,20,18,38
31301,MIZQUE,estado nutricional en menores de 5 anos,clasificacion e,2003-09-01,5,3,5,3,8
20402,MOCOMOCO,estado nutricional en menores de 5 anos,clasificacion e,2003-09-01,16,14,16,14,30
51002,MOJINETE,estado nutricional en menores de 5 anos,clasificacion e,2003-09-01,1,0,1,0,1
10303,MOJOCOYA,estado nutricional en menores de 5 anos,clasificacion e,2003-09-01,7,18,7,18,25
10501,MONTEAGUDO,estado nutricional en menores de 5 anos,clasificacion e,2003-09-01,39,43,39,43,82
71001,MONTERO,estado nutricional en menores de 5 anos,clasificacion e,2003-09-01,39,26,39,26,65
70803,MORO MORO,estado nutricional en menores de 5 anos,clasificacion e,2003-09-01,2,3,2,3,5
30302,MOROCHATA,estado nutricional en menores de 5 anos,clasificacion e,2003-09-01,34,28,34,28,62
90401,NACEBE (SANTA ROSA DEL ABUNA),estado nutricional en menores de 5 anos,clasificacion e,2003-09-01,0,1,0,1,1
50404,OCURI,estado nutricional en menores de 5 anos,clasificacion e,2003-09-01,42,38,42,38,80
30203,OMEREQUE,estado nutricional en menores de 5 anos,clasificacion e,2003-09-01,0,2,0,2,2
40101,ORURO,estado nutricional en menores de 5 anos,clasificacion e,2003-09-01,110,71,110,71,181
60201,PADCAYA,estado nutricional en menores de 5 anos,clasificacion e,2003-09-01,9,15,9,15,24
10401,PADILLA,estado nutricional en menores de 5 anos,clasificacion e,2003-09-01,29,44,29,44,73
70502,PAILON,estado nutricional en menores de 5 anos,clasificacion e,2003-09-01,13,5,13,5,18
20102,PALCA,estado nutricional en menores de 5 anos,clasificacion e,2003-09-01,6,7,6,7,13
21104,PALOS BLANCOS,estado nutricional en menores de 5 anos,clasificacion e,2003-09-01,19,16,19,16,35
40802,PAMPA AULLAGAS,estado nutricional en menores de 5 anos,clasificacion e,2003-09-01,5,4,5,4,9
70902,PAMPA GRANDE,estado nutricional en menores de 5 anos,clasificacion e,2003-09-01,2,5,2,5,7
21802,PAPEL PAMPA,estado nutricional en menores de 5 anos,clasificacion e,2003-09-01,1,1,1,1,2
30202,PASORAPA,estado nutricional en menores de 5 anos,clasificacion e,2003-09-01,1,4,1,4,5
21305,PATACAMAYA,estado nutricional en menores de 5 anos,clasificacion e,2003-09-01,25,13,25,13,38
40602,PAZÃ‘A,estado nutricional en menores de 5 anos,clasificacion e,2003-09-01,5,1,5,1,6
20702,PELECHUCO,estado nutricional en menores de 5 anos,clasificacion e,2003-09-01,10,17,10,17,27
50403,POCOATA,estado nutricional en menores de 5 anos,clasificacion e,2003-09-01,23,27,23,27,50
31203,POCONA,estado nutricional en menores de 5 anos,clasificacion e,2003-09-01,16,10,16,10,26
31202,POJO (CBBA),estado nutricional en menores de 5 anos,clasificacion e,2003-09-01,34,20,34,20,54
40601,POOPO,estado nutricional en menores de 5 anos,clasificacion e,2003-09-01,3,5,3,5,8
51203,PORCO,estado nutricional en menores de 5 anos,clasificacion e,2003-09-01,7,3,7,3,10
10103,POROMA,estado nutricional en menores de 5 anos,clasificacion e,2003-09-01,60,57,60,57,117
70103,PORONGO,estado nutricional en menores de 5 anos,clasificacion e,2003-09-01,2,0,2,0,2
70601,PORTACHUELO,estado nutricional en menores de 5 anos,clasificacion e,2003-09-01,9,18,9,18,27
90102,PORVENIR,estado nutricional en menores de 5 anos,clasificacion e,2003-09-01,3,0,3,0,3
70804,POSTRER VALLE,estado nutricional en menores de 5 anos,clasificacion e,2003-09-01,1,1,1,1,2
50101,POTOSI,estado nutricional en menores de 5 anos,clasificacion e,2003-09-01,154,79,154,79,233
10302,PRESTO,estado nutricional en menores de 5 anos,clasificacion e,2003-09-01,20,38,20,38,58
70805,PUCARA,estado nutricional en menores de 5 anos,clasificacion e,2003-09-01,0,2,0,2,2
21201,PUCARANI,estado nutricional en menores de 5 anos,clasificacion e,2003-09-01,2,2,2,2,4
20401,PUERTO ACOSTA,estado nutricional en menores de 5 anos,clasificacion e,2003-09-01,16,14,16,14,30
20403,PUERTO CARABUCO,estado nutricional en menores de 5 anos,clasificacion e,2003-09-01,16,18,16,18,34
90301,PUERTO GONZALO MORENO,estado nutricional en menores de 5 anos,clasificacion e,2003-09-01,9,19,9,19,28
71402,PUERTO QUIJARRO,estado nutricional en menores de 5 anos,clasificacion e,2003-09-01,7,3,7,3,10
90201,PUERTO RICO,estado nutricional en menores de 5 anos,clasificacion e,2003-09-01,2,2,2,2,4
71401,PUERTO SUAREZ,estado nutricional en menores de 5 anos,clasificacion e,2003-09-01,11,8,11,8,19
31205,PUERTO VILLARROEL,estado nutricional en menores de 5 anos,clasificacion e,2003-09-01,34,28,34,28,62
51101,PUNA,estado nutricional en menores de 5 anos,clasificacion e,2003-09-01,62,51,62,51,113
31401,PUNATA,estado nutricional en menores de 5 anos,clasificacion e,2003-09-01,2,5,2,5,7
20604,QUIABAYA,estado nutricional en menores de 5 anos,clasificacion e,2003-09-01,3,5,3,5,8
30901,QUILLACOLLO,estado nutricional en menores de 5 anos,clasificacion e,2003-09-01,29,21,29,21,50
21002,QUIME,estado nutricional en menores de 5 anos,clasificacion e,2003-09-01,22,11,22,11,33
50402,RAVELO,estado nutricional en menores de 5 anos,clasificacion e,2003-09-01,74,66,74,66,140
80301,REYES,estado nutricional en menores de 5 anos,clasificacion e,2003-09-01,2,3,2,3,5
80201,RIBERALTA,estado nutricional en menores de 5 anos,clasificacion e,2003-09-01,119,80,119,80,199
70503,ROBORE,estado nutricional en menores de 5 anos,clasificacion e,2003-09-01,10,6,10,6,16
80304,RURRENABAQUE,estado nutricional en menores de 5 anos,clasificacion e,2003-09-01,6,0,6,0,6
40901,SABAYA,estado nutricional en menores de 5 anos,clasificacion e,2003-09-01,2,3,2,3,5
31001,SACABA,estado nutricional en menores de 5 anos,clasificacion e,2003-09-01,40,14,40,14,54
30404,SACABAMBA,estado nutricional en menores de 5 anos,clasificacion e,2003-09-01,7,3,7,3,10
50701,SACACA,estado nutricional en menores de 5 anos,clasificacion e,2003-09-01,64,95,64,95,159
71302,SAIPINA,estado nutricional en menores de 5 anos,clasificacion e,2003-09-01,1,2,1,2,3
40801,SALINAS DE GARCI MENDOZA,estado nutricional en menores de 5 anos,clasificacion e,2003-09-01,6,8,6,8,14
70901,SAMAIPATA,estado nutricional en menores de 5 anos,clasificacion e,2003-09-01,0,3,0,3,3
80602,SAN ANDRES,estado nutricional en menores de 5 anos,clasificacion e,2003-09-01,2,1,2,1,3
51003,SAN ANTONIO DE ESMORUCO,estado nutricional en menores de 5 anos,clasificacion e,2003-09-01,0,1,0,1,1
71105,SAN ANTONIO DE LOMERIO,estado nutricional en menores de 5 anos,clasificacion e,2003-09-01,33,41,33,41,74
31403,SAN BENITO,estado nutricional en menores de 5 anos,clasificacion e,2003-09-01,7,0,7,0,7
80302,SAN BORJA,estado nutricional en menores de 5 anos,clasificacion e,2003-09-01,51,31,51,31,82
21502,SAN BUENA VENTURA,estado nutricional en menores de 5 anos,clasificacion e,2003-09-01,13,8,13,8,21
70402,SAN CARLOS,estado nutricional en menores de 5 anos,clasificacion e,2003-09-01,7,6,7,6,13
80501,SAN IGNACIO,estado nutricional en menores de 5 anos,clasificacion e,2003-09-01,22,21,22,21,43
70301,SAN IGNACIO DE VELASCO,estado nutricional en menores de 5 anos,clasificacion e,2003-09-01,57,44,57,44,101
80102,SAN JAVIER(BNI),estado nutricional en menores de 5 anos,clasificacion e,2003-09-01,2,0,2,0,2
71102,SAN JAVIER(STC),estado nutricional en menores de 5 anos,clasificacion e,2003-09-01,8,7,8,7,15
70501,SAN JOSE DE CHIQUITOS,estado nutricional en menores de 5 anos,clasificacion e,2003-09-01,8,2,8,2,10
71104,SAN JULIAN,estado nutricional en menores de 5 anos,clasificacion e,2003-09-01,23,32,23,32,55
90302,SAN LORENZO(PND),estado nutricional en menores de 5 anos,clasificacion e,2003-09-01,1,0,1,0,1
60501,SAN LORENZO(TJA),estado nutricional en menores de 5 anos,clasificacion e,2003-09-01,6,6,6,6,12
10702,SAN LUCAS,estado nutricional en menores de 5 anos,clasificacion e,2003-09-01,175,147,175,147,322
70302,SAN MIGUEL DE VELASCO,estado nutricional en menores de 5 anos,clasificacion e,2003-09-01,14,5,14,5,19
51001,SAN PABLO DE LIPEZ,estado nutricional en menores de 5 anos,clasificacion e,2003-09-01,1,3,1,3,4
50501,SAN PEDRO DE BUENA VISTA,estado nutricional en menores de 5 anos,clasificacion e,2003-09-01,61,72,61,72,133
21801,SAN PEDRO DE CURAHUARA,estado nutricional en menores de 5 anos,clasificacion e,2003-09-01,5,4,5,4,9
50902,SAN PEDRO DE QUEMES,estado nutricional en menores de 5 anos,clasificacion e,2003-09-01,0,1,0,1,1
70303,SAN RAFAEL,estado nutricional en menores de 5 anos,clasificacion e,2003-09-01,4,3,4,3,7
80702,SAN RAMON,estado nutricional en menores de 5 anos,clasificacion e,2003-09-01,0,1,0,1,1
70101,SANTA CRUZ DE LA SIERRA,estado nutricional en menores de 5 anos,clasificacion e,2003-09-01,174,40,174,40,214
80303,SANTA ROSA,estado nutricional en menores de 5 anos,clasificacion e,2003-09-01,3,3,3,3,6
70602,SANTA ROSA DEL SARA,estado nutricional en menores de 5 anos,clasificacion e,2003-09-01,2,1,2,1,3
20308,SANTIAGO DE CALLAPA,estado nutricional en menores de 5 anos,clasificacion e,2003-09-01,1,2,1,2,3
41401,SANTIAGO DE HUARI,estado nutricional en menores de 5 anos,clasificacion e,2003-09-01,5,4,5,4,9
21901,SANTIAGO DE MACHACA,estado nutricional en menores de 5 anos,clasificacion e,2003-09-01,4,0,4,0,4
30702,SANTIVAÃ‘ES,estado nutricional en menores de 5 anos,clasificacion e,2003-09-01,12,7,12,7,19
40202,SANTUARIO DE QUILLACAS,estado nutricional en menores de 5 anos,clasificacion e,2003-09-01,1,2,1,2,3
20902,SAPAHAQUI,estado nutricional en menores de 5 anos,clasificacion e,2003-09-01,11,12,11,12,23
90303,SENA,estado nutricional en menores de 5 anos,clasificacion e,2003-09-01,2,2,2,2,4
21301,SICA SICA (VILLA AROMA),estado nutricional en menores de 5 anos,clasificacion e,2003-09-01,48,33,48,33,81
30703,SICAYA,estado nutricional en menores de 5 anos,clasificacion e,2003-09-01,12,2,12,2,14
30902,SIPE SIPE,estado nutricional en menores de 5 anos,clasificacion e,2003-09-01,39,28,39,28,67
10403,SOPACHUY,estado nutricional en menores de 5 anos,clasificacion e,2003-09-01,41,37,41,37,78
20601,SORATA,estado nutricional en menores de 5 anos,clasificacion e,2003-09-01,7,9,7,9,16
10101,SUCRE,estado nutricional en menores de 5 anos,clasificacion e,2003-09-01,112,112,112,112,224
31404,TACACHI,estado nutricional en menores de 5 anos,clasificacion e,2003-09-01,3,2,3,2,5
50303,TACOBAMBA,estado nutricional en menores de 5 anos,clasificacion e,2003-09-01,26,17,26,17,43
30602,TACOPAYA,estado nutricional en menores de 5 anos,clasificacion e,2003-09-01,33,32,33,32,65
51402,TAHUA,estado nutricional en menores de 5 anos,clasificacion e,2003-09-01,1,1,1,1,2
31101,TAPACARI,estado nutricional en menores de 5 anos,clasificacion e,2003-09-01,82,55,82,55,137
10601,TARABUCO,estado nutricional en menores de 5 anos,clasificacion e,2003-09-01,125,116,125,116,241
30401,TARATA,estado nutricional en menores de 5 anos,clasificacion e,2003-09-01,7,8,7,8,15
60101,TARIJA,estado nutricional en menores de 5 anos,clasificacion e,2003-09-01,20,23,20,23,43
10202,TARVITA,estado nutricional en menores de 5 anos,clasificacion e,2003-09-01,65,79,65,79,144
20803,TIAWANACU,estado nutricional en menores de 5 anos,clasificacion e,2003-09-01,6,0,6,0,6
50102,TINGUIPAYA,estado nutricional en menores de 5 anos,clasificacion e,2003-09-01,29,62,29,62,91
20606,TIPUANI,estado nutricional en menores de 5 anos,clasificacion e,2003-09-01,2,0,2,0,2
30903,TIQUIPAYA,estado nutricional en menores de 5 anos,clasificacion e,2003-09-01,12,6,12,6,18
31601,TIRAQUE (CBBA),estado nutricional en menores de 5 anos,clasificacion e,2003-09-01,44,45,44,45,89
21703,TITO YUPANQUI (PARQUIPUJIO),estado nutricional en menores de 5 anos,clasificacion e,2003-09-01,1,0,1,0,1
30802,TOCO,estado nutricional en menores de 5 anos,clasificacion e,2003-09-01,1,3,1,3,4
30803,TOLATA,estado nutricional en menores de 5 anos,clasificacion e,2003-09-01,2,6,2,6,8
51202,TOMAVE,estado nutricional en menores de 5 anos,clasificacion e,2003-09-01,13,12,13,12,25
10402,TOMINA,estado nutricional en menores de 5 anos,clasificacion e,2003-09-01,51,52,51,52,103
50502,TORO TORO,estado nutricional en menores de 5 anos,clasificacion e,2003-09-01,37,44,37,44,81
31201,TOTORA(CBBA),estado nutricional en menores de 5 anos,clasificacion e,2003-09-01,15,7,15,7,22
41301,TOTORA(ORR),estado nutricional en menores de 5 anos,clasificacion e,2003-09-01,4,5,4,5,9
70802,TRIGAL,estado nutricional en menores de 5 anos,clasificacion e,2003-09-01,1,1,1,1,2
80101,TRINIDAD,estado nutricional en menores de 5 anos,clasificacion e,2003-09-01,20,29,20,29,49
50801,TUPIZA,estado nutricional en menores de 5 anos,clasificacion e,2003-09-01,29,33,29,33,62
40402,TURCO,estado nutricional en menores de 5 anos,clasificacion e,2003-09-01,5,2,5,2,7
21302,UMALA,estado nutricional en menores de 5 anos,clasificacion e,2003-09-01,7,8,7,8,15
50201,UNCIA,estado nutricional en menores de 5 anos,clasificacion e,2003-09-01,8,2,8,2,10
60401,URIONDO (A. CONCEPCION),estado nutricional en menores de 5 anos,clasificacion e,2003-09-01,8,9,8,9,17
51201,UYUNI,estado nutricional en menores de 5 anos,clasificacion e,2003-09-01,15,10,15,10,25
30502,VACAS,estado nutricional en menores de 5 anos,clasificacion e,2003-09-01,6,2,6,2,8
70801,VALLEGRANDE,estado nutricional en menores de 5 anos,clasificacion e,2003-09-01,3,6,3,6,9
20801,VIACHA,estado nutricional en menores de 5 anos,clasificacion e,2003-09-01,16,10,16,10,26
31302,VILA VILA,estado nutricional en menores de 5 anos,clasificacion e,2003-09-01,14,1,14,1,15
60303,VILLA MONTES,estado nutricional en menores de 5 anos,clasificacion e,2003-09-01,13,21,13,21,34
31402,VILLA RIVERO,estado nutricional en menores de 5 anos,clasificacion e,2003-09-01,12,5,12,5,17
10801,VILLA SERRANO,estado nutricional en menores de 5 anos,clasificacion e,2003-09-01,43,55,43,55,98
31003,VILLA TUNARI,estado nutricional en menores de 5 anos,clasificacion e,2003-09-01,44,31,44,31,75
11001,VILLA VACA GUZMAN (MUYUPAMPA),estado nutricional en menores de 5 anos,clasificacion e,2003-09-01,9,8,9,8,17
51501,VILLAZON,estado nutricional en menores de 5 anos,clasificacion e,2003-09-01,19,13,19,13,32
30904,VINTO,estado nutricional en menores de 5 anos,clasificacion e,2003-09-01,17,7,17,7,24
50602,VITICHI,estado nutricional en menores de 5 anos,clasificacion e,2003-09-01,9,7,9,7,16
20306,WALDO BALLIVIAN,estado nutricional en menores de 5 anos,clasificacion e,2003-09-01,4,1,4,1,5
20903,YACO,estado nutricional en menores de 5 anos,clasificacion e,2003-09-01,15,3,15,3,18
60301,YACUIBA,estado nutricional en menores de 5 anos,clasificacion e,2003-09-01,0,20,0,20,20
10602,YAMPARAEZ,estado nutricional en menores de 5 anos,clasificacion e,2003-09-01,71,41,71,41,112
70403,YAPACANI,estado nutricional en menores de 5 anos,clasificacion e,2003-09-01,23,21,23,21,44
50103,YOCALLA,estado nutricional en menores de 5 anos,clasificacion e,2003-09-01,9,4,9,4,13
10102,YOTALA,estado nutricional en menores de 5 anos,clasificacion e,2003-09-01,30,36,30,36,66
60402,YUNCHARA,estado nutricional en menores de 5 anos,clasificacion e,2003-09-01,11,9,11,9,20
10301,ZUDAÃ‘EZ,estado nutricional en menores de 5 anos,clasificacion e,2003-09-01,28,34,28,34,62
51302,ACACIO,estado nutricional en menores de 5 anos,clasificacion e,2003-10-01,29,28,29,28,57
20201,ACHACACHI,estado nutricional en menores de 5 anos,clasificacion e,2003-10-01,9,5,9,5,14
20104,ACHOCALLA,estado nutricional en menores de 5 anos,clasificacion e,2003-10-01,4,4,4,4,8
30201,AIQUILE,estado nutricional en menores de 5 anos,clasificacion e,2003-10-01,30,27,30,27,57
31303,ALALAY,estado nutricional en menores de 5 anos,clasificacion e,2003-10-01,1,5,1,5,6
10404,ALCALA,estado nutricional en menores de 5 anos,clasificacion e,2003-10-01,10,17,10,17,27
20202,ANCORAIMES,estado nutricional en menores de 5 anos,clasificacion e,2003-10-01,13,10,13,10,23
41201,ANDAMARCA,estado nutricional en menores de 5 anos,clasificacion e,2003-10-01,1,1,1,1,2
30402,ANZALDO,estado nutricional en menores de 5 anos,clasificacion e,2003-10-01,11,16,11,16,27
20701,APOLO,estado nutricional en menores de 5 anos,clasificacion e,2003-10-01,4,0,4,0,4
51301,ARAMPAMPA,estado nutricional en menores de 5 anos,clasificacion e,2003-10-01,18,18,18,18,36
30501,ARANI,estado nutricional en menores de 5 anos,clasificacion e,2003-10-01,12,7,12,7,19
30403,ARBIETO,estado nutricional en menores de 5 anos,clasificacion e,2003-10-01,2,0,2,0,2
30601,ARQUE,estado nutricional en menores de 5 anos,clasificacion e,2003-10-01,21,20,21,20,41
71501,ASCENCION DE GUARAYOS,estado nutricional en menores de 5 anos,clasificacion e,2003-10-01,9,5,9,5,14
50802,ATOCHA,estado nutricional en menores de 5 anos,clasificacion e,2003-10-01,11,45,11,45,56
20503,AUCAPATA,estado nutricional en menores de 5 anos,clasificacion e,2003-10-01,12,1,12,1,13
20502,AYATA,estado nutricional en menores de 5 anos,clasificacion e,2003-10-01,9,12,9,12,21
21303,AYO AYO,estado nutricional en menores de 5 anos,clasificacion e,2003-10-01,3,0,3,0,3
30301,AYOPAYA (V. DE INDEPENDENCIA),estado nutricional en menores de 5 anos,clasificacion e,2003-10-01,28,18,28,18,46
10201,AZURDUY,estado nutricional en menores de 5 anos,clasificacion e,2003-10-01,67,72,67,72,139
21203,BATALLAS,estado nutricional en menores de 5 anos,clasificacion e,2003-10-01,9,4,9,4,13
80802,BAURES,estado nutricional en menores de 5 anos,clasificacion e,2003-10-01,1,2,1,2,3
50104,BELEN DE URMIRI,estado nutricional en menores de 5 anos,clasificacion e,2003-10-01,2,3,2,3,5
90104,BELLA FLOR,estado nutricional en menores de 5 anos,clasificacion e,2003-10-01,0,1,0,1,1
50301,BETANZOS,estado nutricional en menores de 5 anos,clasificacion e,2003-10-01,101,91,101,91,192
31501,BOLIVAR,estado nutricional en menores de 5 anos,clasificacion e,2003-10-01,35,22,35,22,57
90103,BOLPEBRA,estado nutricional en menores de 5 anos,clasificacion e,2003-10-01,2,1,2,1,3
70707,BOYUIBE,estado nutricional en menores de 5 anos,clasificacion e,2003-10-01,0,1,0,1,1
70401,BUENA VISTA,estado nutricional en menores de 5 anos,clasificacion e,2003-10-01,6,14,6,14,20
70703,CABEZAS,estado nutricional en menores de 5 anos,clasificacion e,2003-10-01,13,18,13,18,31
20905,CAIROMA,estado nutricional en menores de 5 anos,clasificacion e,2003-10-01,20,24,20,24,44
51102,"CAIZA ""D""",estado nutricional en menores de 5 anos,clasificacion e,2003-10-01,17,10,17,10,27
21003,CAJUATA,estado nutricional en menores de 5 anos,clasificacion e,2003-10-01,17,7,17,7,24
20303,CALACOTO,estado nutricional en menores de 5 anos,clasificacion e,2003-10-01,2,1,2,1,3
21304,CALAMARCA,estado nutricional en menores de 5 anos,clasificacion e,2003-10-01,57,29,57,29,86
10701,CAMARGO,estado nutricional en menores de 5 anos,clasificacion e,2003-10-01,18,19,18,19,37
10901,CAMATAQUI (C. VILLA ABECIA),estado nutricional en menores de 5 anos,clasificacion e,2003-10-01,3,3,3,3,6
70706,CAMIRI,estado nutricional en menores de 5 anos,clasificacion e,2003-10-01,24,17,24,17,41
30701,CAPINOTA,estado nutricional en menores de 5 anos,clasificacion e,2003-10-01,11,7,11,7,18
20302,CAQUIAVIRI,estado nutricional en menores de 5 anos,clasificacion e,2003-10-01,7,11,7,11,18
40102,CARACOLLO,estado nutricional en menores de 5 anos,clasificacion e,2003-10-01,13,11,13,11,24
22001,CARANAVI,estado nutricional en menores de 5 anos,clasificacion e,2003-10-01,22,29,22,29,51
60302,CARAPARI,estado nutricional en menores de 5 anos,clasificacion e,2003-10-01,7,2,7,2,9
50702,CARIPUYO,estado nutricional en menores de 5 anos,clasificacion e,2003-10-01,40,26,40,26,66
21902,CATACORA,estado nutricional en menores de 5 anos,clasificacion e,2003-10-01,2,1,2,1,3
40201,CHALLAPATA,estado nutricional en menores de 5 anos,clasificacion e,2003-10-01,42,32,42,32,74
50302,CHAQUI,estado nutricional en menores de 5 anos,clasificacion e,2003-10-01,15,17,15,17,32
70702,CHARAGUA,estado nutricional en menores de 5 anos,clasificacion e,2003-10-01,19,22,19,22,41
50202,CHAYANTA,estado nutricional en menores de 5 anos,clasificacion e,2003-10-01,59,51,59,51,110
31204,CHIMORE,estado nutricional en menores de 5 anos,clasificacion e,2003-10-01,2,7,2,7,9
40903,CHIPAYA,estado nutricional en menores de 5 anos,clasificacion e,2003-10-01,0,1,0,1,1
21101,CHULUMANI (V. DE LA LIBERTAD),estado nutricional en menores de 5 anos,clasificacion e,2003-10-01,1,4,1,4,5
20501,CHUMA,estado nutricional en menores de 5 anos,clasificacion e,2003-10-01,8,13,8,13,21
30801,CLIZA,estado nutricional en menores de 5 anos,clasificacion e,2003-10-01,2,0,2,0,2
90101,COBIJA,estado nutricional en menores de 5 anos,clasificacion e,2003-10-01,5,5,5,5,10
30101,COCHABAMBA,estado nutricional en menores de 5 anos,clasificacion e,2003-10-01,145,68,145,68,213
30905,COLCAPIRHUA,estado nutricional en menores de 5 anos,clasificacion e,2003-10-01,12,3,12,3,15
50901,"COLCHA ""K""",estado nutricional en menores de 5 anos,clasificacion e,2003-10-01,7,9,7,9,16
31002,COLOMI,estado nutricional en menores de 5 anos,clasificacion e,2003-10-01,32,22,32,22,54
50401,COLQUECHACA,estado nutricional en menores de 5 anos,clasificacion e,2003-10-01,102,33,102,33,135
21306,COLQUENCHA,estado nutricional en menores de 5 anos,clasificacion e,2003-10-01,8,1,8,1,9
21004,COLQUIRI,estado nutricional en menores de 5 anos,clasificacion e,2003-10-01,16,4,16,4,20
20304,COMANCHE,estado nutricional en menores de 5 anos,clasificacion e,2003-10-01,1,0,1,0,1
71301,COMARAPA,estado nutricional en menores de 5 anos,clasificacion e,2003-10-01,13,18,13,18,31
20605,COMBAYA,estado nutricional en menores de 5 anos,clasificacion e,2003-10-01,2,1,2,1,3
71101,CONCEPCION,estado nutricional en menores de 5 anos,clasificacion e,2003-10-01,1,0,1,0,1
21701,COPACABANA,estado nutricional en menores de 5 anos,clasificacion e,2003-10-01,4,1,4,1,5
20301,CORO CORO,estado nutricional en menores de 5 anos,clasificacion e,2003-10-01,7,7,7,7,14
21401,COROICO,estado nutricional en menores de 5 anos,clasificacion e,2003-10-01,3,4,3,4,7
40301,CORQUE,estado nutricional en menores de 5 anos,clasificacion e,2003-10-01,2,1,2,1,3
50601,COTAGAITA,estado nutricional en menores de 5 anos,clasificacion e,2003-10-01,93,97,93,97,190
70704,CUEVO,estado nutricional en menores de 5 anos,clasificacion e,2003-10-01,4,4,4,4,8
10902,CULPINA,estado nutricional en menores de 5 anos,clasificacion e,2003-10-01,59,53,59,53,112
40401,CURAHUARA DE CARANGAS,estado nutricional en menores de 5 anos,clasificacion e,2003-10-01,13,8,13,8,21
21602,CURVA,estado nutricional en menores de 5 anos,clasificacion e,2003-10-01,1,0,1,0,1
20804,DESAGUADERO,estado nutricional en menores de 5 anos,clasificacion e,2003-10-01,2,0,2,0,2
20105,EL ALTO,estado nutricional en menores de 5 anos,clasificacion e,2003-10-01,357,224,357,224,581
71503,EL PUENTE(STC),estado nutricional en menores de 5 anos,clasificacion e,2003-10-01,2,6,2,6,8
60502,EL PUENTE(TJA),estado nutricional en menores de 5 anos,clasificacion e,2003-10-01,15,15,15,15,30
70105,EL TORNO,estado nutricional en menores de 5 anos,clasificacion e,2003-10-01,15,13,15,13,28
10405,EL VILLAR,estado nutricional en menores de 5 anos,clasificacion e,2003-10-01,17,32,17,32,49
60601,ENTRE RIOS,estado nutricional en menores de 5 anos,clasificacion e,2003-10-01,15,20,15,20,35
41101,EUCALIPTUS,estado nutricional en menores de 5 anos,clasificacion e,2003-10-01,4,1,4,1,5
80402,EXALTACION,estado nutricional en menores de 5 anos,clasificacion e,2003-10-01,7,6,7,6,13
90203,FILADELFIA,estado nutricional en menores de 5 anos,clasificacion e,2003-10-01,0,1,0,1,1
71002,GENERAL SAAVEDRA,estado nutricional en menores de 5 anos,clasificacion e,2003-10-01,27,13,27,13,40
21601,GRAL. J.J. PEREZ (CHARAZANI),estado nutricional en menores de 5 anos,clasificacion e,2003-10-01,16,16,16,16,32
20602,GUANAY,estado nutricional en menores de 5 anos,clasificacion e,2003-10-01,29,18,29,18,47
20802,GUAQUI,estado nutricional en menores de 5 anos,clasificacion e,2003-10-01,2,1,2,1,3
80202,GUAYARAMERIN,estado nutricional en menores de 5 anos,clasificacion e,2003-10-01,45,34,45,34,79
70705,GUTIERREZ,estado nutricional en menores de 5 anos,clasificacion e,2003-10-01,29,36,29,36,65
10502,HUACARETA,estado nutricional en menores de 5 anos,clasificacion e,2003-10-01,14,27,14,27,41
11002,HUACAYA (VILLA DE HUACAYA),estado nutricional en menores de 5 anos,clasificacion e,2003-10-01,4,1,4,1,5
40701,HUANUNI,estado nutricional en menores de 5 anos,clasificacion e,2003-10-01,19,12,19,12,31
80803,HUARACAJE,estado nutricional en menores de 5 anos,clasificacion e,2003-10-01,2,2,2,2,4
41601,HUAYLLAMARCA,estado nutricional en menores de 5 anos,clasificacion e,2003-10-01,1,1,1,1,2
21005,ICHOCA,estado nutricional en menores de 5 anos,clasificacion e,2003-10-01,7,6,7,6,13
10304,ICLA,estado nutricional en menores de 5 anos,clasificacion e,2003-10-01,37,47,37,47,84
10703,INCAHUASI,estado nutricional en menores de 5 anos,clasificacion e,2003-10-01,66,48,66,48,114
21001,INQUISIVI,estado nutricional en menores de 5 anos,clasificacion e,2003-10-01,22,9,22,9,31
21501,IXIAMAS,estado nutricional en menores de 5 anos,clasificacion e,2003-10-01,4,5,4,5,9
21105,LA ASUNTA,estado nutricional en menores de 5 anos,clasificacion e,2003-10-01,10,7,10,7,17
70104,LA GUARDIA,estado nutricional en menores de 5 anos,clasificacion e,2003-10-01,11,7,11,7,18
20101,LA PAZ,estado nutricional en menores de 5 anos,clasificacion e,2003-10-01,234,171,234,171,405
70701,LAGUNILLAS,estado nutricional en menores de 5 anos,clasificacion e,2003-10-01,11,11,11,11,22
21202,LAJA,estado nutricional en menores de 5 anos,clasificacion e,2003-10-01,11,7,11,7,18
10903,LAS CARRERAS,estado nutricional en menores de 5 anos,clasificacion e,2003-10-01,3,13,3,13,16
50203,LLALLAGUA,estado nutricional en menores de 5 anos,clasificacion e,2003-10-01,40,82,40,82,122
51401,LLICA,estado nutricional en menores de 5 anos,clasificacion e,2003-10-01,3,4,3,4,7
80601,LORETO,estado nutricional en menores de 5 anos,clasificacion e,2003-10-01,1,1,1,1,2
20901,LURIBAY,estado nutricional en menores de 5 anos,clasificacion e,2003-10-01,14,16,14,16,30
40702,MACHACAMARCA,estado nutricional en menores de 5 anos,clasificacion e,2003-10-01,0,3,0,3,3
11003,MACHARETI,estado nutricional en menores de 5 anos,clasificacion e,2003-10-01,8,33,8,33,41
80801,MAGDALENA,estado nutricional en menores de 5 anos,clasificacion e,2003-10-01,1,1,1,1,2
70903,MAIRANA,estado nutricional en menores de 5 anos,clasificacion e,2003-10-01,5,0,5,0,5
20103,MECAPACA,estado nutricional en menores de 5 anos,clasificacion e,2003-10-01,3,1,3,1,4
71003,MINEROS,estado nutricional en menores de 5 anos,clasificacion e,2003-10-01,23,15,23,15,38
31301,MIZQUE,estado nutricional en menores de 5 anos,clasificacion e,2003-10-01,47,6,47,6,53
20402,MOCOMOCO,estado nutricional en menores de 5 anos,clasificacion e,2003-10-01,5,17,5,17,22
51002,MOJINETE,estado nutricional en menores de 5 anos,clasificacion e,2003-10-01,0,1,0,1,1
10303,MOJOCOYA,estado nutricional en menores de 5 anos,clasificacion e,2003-10-01,13,16,13,16,29
10501,MONTEAGUDO,estado nutricional en menores de 5 anos,clasificacion e,2003-10-01,38,42,38,42,80
71001,MONTERO,estado nutricional en menores de 5 anos,clasificacion e,2003-10-01,57,43,57,43,100
70803,MORO MORO,estado nutricional en menores de 5 anos,clasificacion e,2003-10-01,7,4,7,4,11
30302,MOROCHATA,estado nutricional en menores de 5 anos,clasificacion e,2003-10-01,37,24,37,24,61
50404,OCURI,estado nutricional en menores de 5 anos,clasificacion e,2003-10-01,34,42,34,42,76
40101,ORURO,estado nutricional en menores de 5 anos,clasificacion e,2003-10-01,112,70,112,70,182
60201,PADCAYA,estado nutricional en menores de 5 anos,clasificacion e,2003-10-01,2,5,2,5,7
10401,PADILLA,estado nutricional en menores de 5 anos,clasificacion e,2003-10-01,37,46,37,46,83
70502,PAILON,estado nutricional en menores de 5 anos,clasificacion e,2003-10-01,9,7,9,7,16
20102,PALCA,estado nutricional en menores de 5 anos,clasificacion e,2003-10-01,11,18,11,18,29
21104,PALOS BLANCOS,estado nutricional en menores de 5 anos,clasificacion e,2003-10-01,16,13,16,13,29
40802,PAMPA AULLAGAS,estado nutricional en menores de 5 anos,clasificacion e,2003-10-01,3,1,3,1,4
70902,PAMPA GRANDE,estado nutricional en menores de 5 anos,clasificacion e,2003-10-01,1,2,1,2,3
30202,PASORAPA,estado nutricional en menores de 5 anos,clasificacion e,2003-10-01,10,2,10,2,12
21305,PATACAMAYA,estado nutricional en menores de 5 anos,clasificacion e,2003-10-01,21,17,21,17,38
40602,PAZÃ‘A,estado nutricional en menores de 5 anos,clasificacion e,2003-10-01,3,1,3,1,4
20702,PELECHUCO,estado nutricional en menores de 5 anos,clasificacion e,2003-10-01,6,6,6,6,12
50403,POCOATA,estado nutricional en menores de 5 anos,clasificacion e,2003-10-01,42,44,42,44,86
31203,POCONA,estado nutricional en menores de 5 anos,clasificacion e,2003-10-01,23,16,23,16,39
31202,POJO (CBBA),estado nutricional en menores de 5 anos,clasificacion e,2003-10-01,35,19,35,19,54
40601,POOPO,estado nutricional en menores de 5 anos,clasificacion e,2003-10-01,1,0,1,0,1
51203,PORCO,estado nutricional en menores de 5 anos,clasificacion e,2003-10-01,0,1,0,1,1
10103,POROMA,estado nutricional en menores de 5 anos,clasificacion e,2003-10-01,45,55,45,55,100
70601,PORTACHUELO,estado nutricional en menores de 5 anos,clasificacion e,2003-10-01,14,11,14,11,25
90102,PORVENIR,estado nutricional en menores de 5 anos,clasificacion e,2003-10-01,0,1,0,1,1
70804,POSTRER VALLE,estado nutricional en menores de 5 anos,clasificacion e,2003-10-01,0,1,0,1,1
50101,POTOSI,estado nutricional en menores de 5 anos,clasificacion e,2003-10-01,174,116,174,116,290
10302,PRESTO,estado nutricional en menores de 5 anos,clasificacion e,2003-10-01,25,23,25,23,48
70805,PUCARA,estado nutricional en menores de 5 anos,clasificacion e,2003-10-01,0,3,0,3,3
21201,PUCARANI,estado nutricional en menores de 5 anos,clasificacion e,2003-10-01,5,5,5,5,10
20401,PUERTO ACOSTA,estado nutricional en menores de 5 anos,clasificacion e,2003-10-01,14,13,14,13,27
20403,PUERTO CARABUCO,estado nutricional en menores de 5 anos,clasificacion e,2003-10-01,11,8,11,8,19
90301,PUERTO GONZALO MORENO,estado nutricional en menores de 5 anos,clasificacion e,2003-10-01,11,5,11,5,16
21204,PUERTO PEREZ,estado nutricional en menores de 5 anos,clasificacion e,2003-10-01,1,0,1,0,1
71402,PUERTO QUIJARRO,estado nutricional en menores de 5 anos,clasificacion e,2003-10-01,3,3,3,3,6
90201,PUERTO RICO,estado nutricional en menores de 5 anos,clasificacion e,2003-10-01,0,2,0,2,2
71401,PUERTO SUAREZ,estado nutricional en menores de 5 anos,clasificacion e,2003-10-01,11,7,11,7,18
31205,PUERTO VILLARROEL,estado nutricional en menores de 5 anos,clasificacion e,2003-10-01,52,48,52,48,100
51101,PUNA,estado nutricional en menores de 5 anos,clasificacion e,2003-10-01,66,27,66,27,93
31401,PUNATA,estado nutricional en menores de 5 anos,clasificacion e,2003-10-01,12,5,12,5,17
20604,QUIABAYA,estado nutricional en menores de 5 anos,clasificacion e,2003-10-01,7,4,7,4,11
30901,QUILLACOLLO,estado nutricional en menores de 5 anos,clasificacion e,2003-10-01,18,19,18,19,37
21002,QUIME,estado nutricional en menores de 5 anos,clasificacion e,2003-10-01,20,12,20,12,32
70904,QUIRUSILLAS,estado nutricional en menores de 5 anos,clasificacion e,2003-10-01,1,0,1,0,1
50402,RAVELO,estado nutricional en menores de 5 anos,clasificacion e,2003-10-01,78,56,78,56,134
80301,REYES,estado nutricional en menores de 5 anos,clasificacion e,2003-10-01,3,13,3,13,16
80201,RIBERALTA,estado nutricional en menores de 5 anos,clasificacion e,2003-10-01,86,71,86,71,157
70503,ROBORE,estado nutricional en menores de 5 anos,clasificacion e,2003-10-01,10,8,10,8,18
80304,RURRENABAQUE,estado nutricional en menores de 5 anos,clasificacion e,2003-10-01,2,2,2,2,4
40901,SABAYA,estado nutricional en menores de 5 anos,clasificacion e,2003-10-01,0,1,0,1,1
31001,SACABA,estado nutricional en menores de 5 anos,clasificacion e,2003-10-01,30,8,30,8,38
30404,SACABAMBA,estado nutricional en menores de 5 anos,clasificacion e,2003-10-01,8,8,8,8,16
50701,SACACA,estado nutricional en menores de 5 anos,clasificacion e,2003-10-01,89,122,89,122,211
40801,SALINAS DE GARCI MENDOZA,estado nutricional en menores de 5 anos,clasificacion e,2003-10-01,3,3,3,3,6
70901,SAMAIPATA,estado nutricional en menores de 5 anos,clasificacion e,2003-10-01,3,4,3,4,7
51601,SAN AGUSTIN,estado nutricional en menores de 5 anos,clasificacion e,2003-10-01,0,2,0,2,2
80602,SAN ANDRES,estado nutricional en menores de 5 anos,clasificacion e,2003-10-01,2,11,2,11,13
51003,SAN ANTONIO DE ESMORUCO,estado nutricional en menores de 5 anos,clasificacion e,2003-10-01,1,6,1,6,7
71105,SAN ANTONIO DE LOMERIO,estado nutricional en menores de 5 anos,clasificacion e,2003-10-01,24,39,24,39,63
31403,SAN BENITO,estado nutricional en menores de 5 anos,clasificacion e,2003-10-01,4,3,4,3,7
80302,SAN BORJA,estado nutricional en menores de 5 anos,clasificacion e,2003-10-01,48,24,48,24,72
21502,SAN BUENA VENTURA,estado nutricional en menores de 5 anos,clasificacion e,2003-10-01,15,7,15,7,22
70402,SAN CARLOS,estado nutricional en menores de 5 anos,clasificacion e,2003-10-01,4,11,4,11,15
80501,SAN IGNACIO,estado nutricional en menores de 5 anos,clasificacion e,2003-10-01,33,22,33,22,55
70301,SAN IGNACIO DE VELASCO,estado nutricional en menores de 5 anos,clasificacion e,2003-10-01,63,37,63,37,100
80102,SAN JAVIER(BNI),estado nutricional en menores de 5 anos,clasificacion e,2003-10-01,3,0,3,0,3
71102,SAN JAVIER(STC),estado nutricional en menores de 5 anos,clasificacion e,2003-10-01,8,4,8,4,12
70501,SAN JOSE DE CHIQUITOS,estado nutricional en menores de 5 anos,clasificacion e,2003-10-01,8,6,8,6,14
71104,SAN JULIAN,estado nutricional en menores de 5 anos,clasificacion e,2003-10-01,33,26,33,26,59
60501,SAN LORENZO(TJA),estado nutricional en menores de 5 anos,clasificacion e,2003-10-01,11,17,11,17,28
10702,SAN LUCAS,estado nutricional en menores de 5 anos,clasificacion e,2003-10-01,142,120,142,120,262
71201,SAN MATIAS,estado nutricional en menores de 5 anos,clasificacion e,2003-10-01,27,11,27,11,38
70302,SAN MIGUEL DE VELASCO,estado nutricional en menores de 5 anos,clasificacion e,2003-10-01,24,16,24,16,40
51001,SAN PABLO DE LIPEZ,estado nutricional en menores de 5 anos,clasificacion e,2003-10-01,4,2,4,2,6
50501,SAN PEDRO DE BUENA VISTA,estado nutricional en menores de 5 anos,clasificacion e,2003-10-01,66,84,66,84,150
21801,SAN PEDRO DE CURAHUARA,estado nutricional en menores de 5 anos,clasificacion e,2003-10-01,2,2,2,2,4
50902,SAN PEDRO DE QUEMES,estado nutricional en menores de 5 anos,clasificacion e,2003-10-01,0,1,0,1,1
90202,SAN PEDRO(PND),estado nutricional en menores de 5 anos,clasificacion e,2003-10-01,1,1,1,1,2
70303,SAN RAFAEL,estado nutricional en menores de 5 anos,clasificacion e,2003-10-01,18,21,18,21,39
80401,SANTA ANA,estado nutricional en menores de 5 anos,clasificacion e,2003-10-01,8,6,8,6,14
70101,SANTA CRUZ DE LA SIERRA,estado nutricional en menores de 5 anos,clasificacion e,2003-10-01,233,84,233,84,317
80303,SANTA ROSA,estado nutricional en menores de 5 anos,clasificacion e,2003-10-01,2,1,2,1,3
70602,SANTA ROSA DEL SARA,estado nutricional en menores de 5 anos,clasificacion e,2003-10-01,1,9,1,9,10
20308,SANTIAGO DE CALLAPA,estado nutricional en menores de 5 anos,clasificacion e,2003-10-01,5,7,5,7,12
41401,SANTIAGO DE HUARI,estado nutricional en menores de 5 anos,clasificacion e,2003-10-01,6,6,6,6,12
21901,SANTIAGO DE MACHACA,estado nutricional en menores de 5 anos,clasificacion e,2003-10-01,3,1,3,1,4
30702,SANTIVAÃ‘ES,estado nutricional en menores de 5 anos,clasificacion e,2003-10-01,5,4,5,4,9
20902,SAPAHAQUI,estado nutricional en menores de 5 anos,clasificacion e,2003-10-01,13,10,13,10,23
90303,SENA,estado nutricional en menores de 5 anos,clasificacion e,2003-10-01,1,0,1,0,1
21301,SICA SICA (VILLA AROMA),estado nutricional en menores de 5 anos,clasificacion e,2003-10-01,50,29,50,29,79
30703,SICAYA,estado nutricional en menores de 5 anos,clasificacion e,2003-10-01,10,5,10,5,15
30902,SIPE SIPE,estado nutricional en menores de 5 anos,clasificacion e,2003-10-01,32,32,32,32,64
10403,SOPACHUY,estado nutricional en menores de 5 anos,clasificacion e,2003-10-01,39,47,39,47,86
20601,SORATA,estado nutricional en menores de 5 anos,clasificacion e,2003-10-01,9,21,9,21,30
10101,SUCRE,estado nutricional en menores de 5 anos,clasificacion e,2003-10-01,103,93,103,93,196
31404,TACACHI,estado nutricional en menores de 5 anos,clasificacion e,2003-10-01,1,0,1,0,1
20603,TACACOMA,estado nutricional en menores de 5 anos,clasificacion e,2003-10-01,0,2,0,2,2
50303,TACOBAMBA,estado nutricional en menores de 5 anos,clasificacion e,2003-10-01,19,38,19,38,57
30602,TACOPAYA,estado nutricional en menores de 5 anos,clasificacion e,2003-10-01,37,36,37,36,73
31101,TAPACARI,estado nutricional en menores de 5 anos,clasificacion e,2003-10-01,47,27,47,27,74
10601,TARABUCO,estado nutricional en menores de 5 anos,clasificacion e,2003-10-01,129,124,129,124,253
30401,TARATA,estado nutricional en menores de 5 anos,clasificacion e,2003-10-01,16,5,16,5,21
60101,TARIJA,estado nutricional en menores de 5 anos,clasificacion e,2003-10-01,43,39,43,39,82
10202,TARVITA,estado nutricional en menores de 5 anos,clasificacion e,2003-10-01,45,56,45,56,101
20803,TIAWANACU,estado nutricional en menores de 5 anos,clasificacion e,2003-10-01,3,3,3,3,6
50102,TINGUIPAYA,estado nutricional en menores de 5 anos,clasificacion e,2003-10-01,68,83,68,83,151
20606,TIPUANI,estado nutricional en menores de 5 anos,clasificacion e,2003-10-01,2,3,2,3,5
30903,TIQUIPAYA,estado nutricional en menores de 5 anos,clasificacion e,2003-10-01,22,15,22,15,37
31601,TIRAQUE (CBBA),estado nutricional en menores de 5 anos,clasificacion e,2003-10-01,50,28,50,28,78
21703,TITO YUPANQUI (PARQUIPUJIO),estado nutricional en menores de 5 anos,clasificacion e,2003-10-01,3,2,3,2,5
30802,TOCO,estado nutricional en menores de 5 anos,clasificacion e,2003-10-01,0,3,0,3,3
30803,TOLATA,estado nutricional en menores de 5 anos,clasificacion e,2003-10-01,5,2,5,2,7
41001,TOLEDO,estado nutricional en menores de 5 anos,clasificacion e,2003-10-01,1,1,1,1,2
51202,TOMAVE,estado nutricional en menores de 5 anos,clasificacion e,2003-10-01,19,16,19,16,35
10402,TOMINA,estado nutricional en menores de 5 anos,clasificacion e,2003-10-01,45,64,45,64,109
50502,TORO TORO,estado nutricional en menores de 5 anos,clasificacion e,2003-10-01,36,21,36,21,57
31201,TOTORA(CBBA),estado nutricional en menores de 5 anos,clasificacion e,2003-10-01,14,10,14,10,24
41301,TOTORA(ORR),estado nutricional en menores de 5 anos,clasificacion e,2003-10-01,5,1,5,1,6
70802,TRIGAL,estado nutricional en menores de 5 anos,clasificacion e,2003-10-01,2,0,2,0,2
80101,TRINIDAD,estado nutricional en menores de 5 anos,clasificacion e,2003-10-01,40,38,40,38,78
50801,TUPIZA,estado nutricional en menores de 5 anos,clasificacion e,2003-10-01,32,53,32,53,85
40402,TURCO,estado nutricional en menores de 5 anos,clasificacion e,2003-10-01,1,1,1,1,2
21302,UMALA,estado nutricional en menores de 5 anos,clasificacion e,2003-10-01,6,10,6,10,16
50201,UNCIA,estado nutricional en menores de 5 anos,clasificacion e,2003-10-01,13,1,13,1,14
60401,URIONDO (A. CONCEPCION),estado nutricional en menores de 5 anos,clasificacion e,2003-10-01,6,15,6,15,21
71502,URUBICHA,estado nutricional en menores de 5 anos,clasificacion e,2003-10-01,31,30,31,30,61
51201,UYUNI,estado nutricional en menores de 5 anos,clasificacion e,2003-10-01,10,16,10,16,26
30502,VACAS,estado nutricional en menores de 5 anos,clasificacion e,2003-10-01,6,3,6,3,9
70801,VALLEGRANDE,estado nutricional en menores de 5 anos,clasificacion e,2003-10-01,9,18,9,18,27
20801,VIACHA,estado nutricional en menores de 5 anos,clasificacion e,2003-10-01,20,19,20,19,39
31302,VILA VILA,estado nutricional en menores de 5 anos,clasificacion e,2003-10-01,19,6,19,6,25
60303,VILLA MONTES,estado nutricional en menores de 5 anos,clasificacion e,2003-10-01,16,15,16,15,31
31402,VILLA RIVERO,estado nutricional en menores de 5 anos,clasificacion e,2003-10-01,10,8,10,8,18
10801,VILLA SERRANO,estado nutricional en menores de 5 anos,clasificacion e,2003-10-01,44,57,44,57,101
31003,VILLA TUNARI,estado nutricional en menores de 5 anos,clasificacion e,2003-10-01,73,46,73,46,119
11001,VILLA VACA GUZMAN (MUYUPAMPA),estado nutricional en menores de 5 anos,clasificacion e,2003-10-01,21,21,21,21,42
51501,VILLAZON,estado nutricional en menores de 5 anos,clasificacion e,2003-10-01,22,26,22,26,48
30904,VINTO,estado nutricional en menores de 5 anos,clasificacion e,2003-10-01,24,7,24,7,31
50602,VITICHI,estado nutricional en menores de 5 anos,clasificacion e,2003-10-01,46,69,46,69,115
20306,WALDO BALLIVIAN,estado nutricional en menores de 5 anos,clasificacion e,2003-10-01,0,3,0,3,3
20903,YACO,estado nutricional en menores de 5 anos,clasificacion e,2003-10-01,33,29,33,29,62
60301,YACUIBA,estado nutricional en menores de 5 anos,clasificacion e,2003-10-01,4,2,4,2,6
10602,YAMPARAEZ,estado nutricional en menores de 5 anos,clasificacion e,2003-10-01,62,50,62,50,112
21103,YANACACHI,estado nutricional en menores de 5 anos,clasificacion e,2003-10-01,4,1,4,1,5
70403,YAPACANI,estado nutricional en menores de 5 anos,clasificacion e,2003-10-01,20,29,20,29,49
50103,YOCALLA,estado nutricional en menores de 5 anos,clasificacion e,2003-10-01,4,6,4,6,10
10102,YOTALA,estado nutricional en menores de 5 anos,clasificacion e,2003-10-01,30,35,30,35,65
60402,YUNCHARA,estado nutricional en menores de 5 anos,clasificacion e,2003-10-01,21,25,21,25,46
10301,ZUDAÃ‘EZ,estado nutricional en menores de 5 anos,clasificacion e,2003-10-01,21,30,21,30,51
51302,ACACIO,estado nutricional en menores de 5 anos,clasificacion e,2003-11-01,29,21,29,21,50
20201,ACHACACHI,estado nutricional en menores de 5 anos,clasificacion e,2003-11-01,19,10,19,10,29
20104,ACHOCALLA,estado nutricional en menores de 5 anos,clasificacion e,2003-11-01,4,9,4,9,13
30201,AIQUILE,estado nutricional en menores de 5 anos,clasificacion e,2003-11-01,18,16,18,16,34
31303,ALALAY,estado nutricional en menores de 5 anos,clasificacion e,2003-11-01,4,1,4,1,5
10404,ALCALA,estado nutricional en menores de 5 anos,clasificacion e,2003-11-01,9,27,9,27,36
20202,ANCORAIMES,estado nutricional en menores de 5 anos,clasificacion e,2003-11-01,7,6,7,6,13
41201,ANDAMARCA,estado nutricional en menores de 5 anos,clasificacion e,2003-11-01,2,0,2,0,2
40603,ANTEQUERA,estado nutricional en menores de 5 anos,clasificacion e,2003-11-01,1,0,1,0,1
30402,ANZALDO,estado nutricional en menores de 5 anos,clasificacion e,2003-11-01,2,4,2,4,6
20701,APOLO,estado nutricional en menores de 5 anos,clasificacion e,2003-11-01,9,9,9,9,18
51301,ARAMPAMPA,estado nutricional en menores de 5 anos,clasificacion e,2003-11-01,10,20,10,20,30
30501,ARANI,estado nutricional en menores de 5 anos,clasificacion e,2003-11-01,14,10,14,10,24
30403,ARBIETO,estado nutricional en menores de 5 anos,clasificacion e,2003-11-01,5,2,5,2,7
30601,ARQUE,estado nutricional en menores de 5 anos,clasificacion e,2003-11-01,20,30,20,30,50
50802,ATOCHA,estado nutricional en menores de 5 anos,clasificacion e,2003-11-01,22,32,22,32,54
20503,AUCAPATA,estado nutricional en menores de 5 anos,clasificacion e,2003-11-01,32,6,32,6,38
20502,AYATA,estado nutricional en menores de 5 anos,clasificacion e,2003-11-01,37,21,37,21,58
21303,AYO AYO,estado nutricional en menores de 5 anos,clasificacion e,2003-11-01,4,2,4,2,6
30301,AYOPAYA (V. DE INDEPENDENCIA),estado nutricional en menores de 5 anos,clasificacion e,2003-11-01,8,10,8,10,18
10201,AZURDUY,estado nutricional en menores de 5 anos,clasificacion e,2003-11-01,54,57,54,57,111
21203,BATALLAS,estado nutricional en menores de 5 anos,clasificacion e,2003-11-01,4,2,4,2,6
80802,BAURES,estado nutricional en menores de 5 anos,clasificacion e,2003-11-01,3,2,3,2,5
50104,BELEN DE URMIRI,estado nutricional en menores de 5 anos,clasificacion e,2003-11-01,4,2,4,2,6
90104,BELLA FLOR,estado nutricional en menores de 5 anos,clasificacion e,2003-11-01,0,1,0,1,1
60202,BERMEJO,estado nutricional en menores de 5 anos,clasificacion e,2003-11-01,3,6,3,6,9
50301,BETANZOS,estado nutricional en menores de 5 anos,clasificacion e,2003-11-01,104,88,104,88,192
31501,BOLIVAR,estado nutricional en menores de 5 anos,clasificacion e,2003-11-01,22,17,22,17,39
90103,BOLPEBRA,estado nutricional en menores de 5 anos,clasificacion e,2003-11-01,2,0,2,0,2
70707,BOYUIBE,estado nutricional en menores de 5 anos,clasificacion e,2003-11-01,1,2,1,2,3
70401,BUENA VISTA,estado nutricional en menores de 5 anos,clasificacion e,2003-11-01,4,12,4,12,16
70703,CABEZAS,estado nutricional en menores de 5 anos,clasificacion e,2003-11-01,7,11,7,11,18
20905,CAIROMA,estado nutricional en menores de 5 anos,clasificacion e,2003-11-01,15,11,15,11,26
51102,"CAIZA ""D""",estado nutricional en menores de 5 anos,clasificacion e,2003-11-01,5,3,5,3,8
21003,CAJUATA,estado nutricional en menores de 5 anos,clasificacion e,2003-11-01,9,5,9,5,14
21304,CALAMARCA,estado nutricional en menores de 5 anos,clasificacion e,2003-11-01,34,26,34,26,60
10701,CAMARGO,estado nutricional en menores de 5 anos,clasificacion e,2003-11-01,15,26,15,26,41
10901,CAMATAQUI (C. VILLA ABECIA),estado nutricional en menores de 5 anos,clasificacion e,2003-11-01,2,3,2,3,5
70706,CAMIRI,estado nutricional en menores de 5 anos,clasificacion e,2003-11-01,25,13,25,13,38
30701,CAPINOTA,estado nutricional en menores de 5 anos,clasificacion e,2003-11-01,24,21,24,21,45
20302,CAQUIAVIRI,estado nutricional en menores de 5 anos,clasificacion e,2003-11-01,2,2,2,2,4
40102,CARACOLLO,estado nutricional en menores de 5 anos,clasificacion e,2003-11-01,16,5,16,5,21
22001,CARANAVI,estado nutricional en menores de 5 anos,clasificacion e,2003-11-01,44,52,44,52,96
60302,CARAPARI,estado nutricional en menores de 5 anos,clasificacion e,2003-11-01,7,7,7,7,14
50702,CARIPUYO,estado nutricional en menores de 5 anos,clasificacion e,2003-11-01,34,25,34,25,59
21803,CHACARILLA,estado nutricional en menores de 5 anos,clasificacion e,2003-11-01,0,2,0,2,2
40201,CHALLAPATA,estado nutricional en menores de 5 anos,clasificacion e,2003-11-01,35,25,35,25,60
50302,CHAQUI,estado nutricional en menores de 5 anos,clasificacion e,2003-11-01,11,12,11,12,23
70702,CHARAGUA,estado nutricional en menores de 5 anos,clasificacion e,2003-11-01,30,19,30,19,49
20305,CHARAÃ‘A,estado nutricional en menores de 5 anos,clasificacion e,2003-11-01,2,1,2,1,3
50202,CHAYANTA,estado nutricional en menores de 5 anos,clasificacion e,2003-11-01,38,38,38,38,76
31204,CHIMORE,estado nutricional en menores de 5 anos,clasificacion e,2003-11-01,4,15,4,15,19
40302,CHOQUE COTA,estado nutricional en menores de 5 anos,clasificacion e,2003-11-01,3,3,3,3,6
21101,CHULUMANI (V. DE LA LIBERTAD),estado nutricional en menores de 5 anos,clasificacion e,2003-11-01,3,18,3,18,21
20501,CHUMA,estado nutricional en menores de 5 anos,clasificacion e,2003-11-01,18,12,18,12,30
30801,CLIZA,estado nutricional en menores de 5 anos,clasificacion e,2003-11-01,3,3,3,3,6
90101,COBIJA,estado nutricional en menores de 5 anos,clasificacion e,2003-11-01,18,15,18,15,33
30101,COCHABAMBA,estado nutricional en menores de 5 anos,clasificacion e,2003-11-01,122,80,122,80,202
30905,COLCAPIRHUA,estado nutricional en menores de 5 anos,clasificacion e,2003-11-01,11,5,11,5,16
50901,"COLCHA ""K""",estado nutricional en menores de 5 anos,clasificacion e,2003-11-01,1,11,1,11,12
31002,COLOMI,estado nutricional en menores de 5 anos,clasificacion e,2003-11-01,15,18,15,18,33
50401,COLQUECHACA,estado nutricional en menores de 5 anos,clasificacion e,2003-11-01,84,57,84,57,141
21306,COLQUENCHA,estado nutricional en menores de 5 anos,clasificacion e,2003-11-01,5,5,5,5,10
21004,COLQUIRI,estado nutricional en menores de 5 anos,clasificacion e,2003-11-01,15,11,15,11,26
20304,COMANCHE,estado nutricional en menores de 5 anos,clasificacion e,2003-11-01,5,4,5,4,9
71301,COMARAPA,estado nutricional en menores de 5 anos,clasificacion e,2003-11-01,17,15,17,15,32
20605,COMBAYA,estado nutricional en menores de 5 anos,clasificacion e,2003-11-01,2,5,2,5,7
71101,CONCEPCION,estado nutricional en menores de 5 anos,clasificacion e,2003-11-01,0,1,0,1,1
21701,COPACABANA,estado nutricional en menores de 5 anos,clasificacion e,2003-11-01,5,5,5,5,10
21402,CORIPATA,estado nutricional en menores de 5 anos,clasificacion e,2003-11-01,3,0,3,0,3
20301,CORO CORO,estado nutricional en menores de 5 anos,clasificacion e,2003-11-01,5,4,5,4,9
21401,COROICO,estado nutricional en menores de 5 anos,clasificacion e,2003-11-01,2,4,2,4,6
40301,CORQUE,estado nutricional en menores de 5 anos,clasificacion e,2003-11-01,11,3,11,3,14
50601,COTAGAITA,estado nutricional en menores de 5 anos,clasificacion e,2003-11-01,65,95,65,95,160
70704,CUEVO,estado nutricional en menores de 5 anos,clasificacion e,2003-11-01,2,1,2,1,3
10902,CULPINA,estado nutricional en menores de 5 anos,clasificacion e,2003-11-01,66,53,66,53,119
40401,CURAHUARA DE CARANGAS,estado nutricional en menores de 5 anos,clasificacion e,2003-11-01,7,4,7,4,11
21602,CURVA,estado nutricional en menores de 5 anos,clasificacion e,2003-11-01,3,4,3,4,7
20804,DESAGUADERO,estado nutricional en menores de 5 anos,clasificacion e,2003-11-01,2,2,2,2,4
20105,EL ALTO,estado nutricional en menores de 5 anos,clasificacion e,2003-11-01,372,235,372,235,607
71503,EL PUENTE(STC),estado nutricional en menores de 5 anos,clasificacion e,2003-11-01,11,7,11,7,18
60502,EL PUENTE(TJA),estado nutricional en menores de 5 anos,clasificacion e,2003-11-01,9,14,9,14,23
70105,EL TORNO,estado nutricional en menores de 5 anos,clasificacion e,2003-11-01,15,16,15,16,31
10405,EL VILLAR,estado nutricional en menores de 5 anos,clasificacion e,2003-11-01,25,31,25,31,56
60601,ENTRE RIOS,estado nutricional en menores de 5 anos,clasificacion e,2003-11-01,18,10,18,10,28
41101,EUCALIPTUS,estado nutricional en menores de 5 anos,clasificacion e,2003-11-01,6,2,6,2,8
80402,EXALTACION,estado nutricional en menores de 5 anos,clasificacion e,2003-11-01,3,4,3,4,7
90203,FILADELFIA,estado nutricional en menores de 5 anos,clasificacion e,2003-11-01,0,1,0,1,1
71002,GENERAL SAAVEDRA,estado nutricional en menores de 5 anos,clasificacion e,2003-11-01,17,24,17,24,41
21601,GRAL. J.J. PEREZ (CHARAZANI),estado nutricional en menores de 5 anos,clasificacion e,2003-11-01,28,39,28,39,67
20602,GUANAY,estado nutricional en menores de 5 anos,clasificacion e,2003-11-01,33,35,33,35,68
20802,GUAQUI,estado nutricional en menores de 5 anos,clasificacion e,2003-11-01,1,5,1,5,6
80202,GUAYARAMERIN,estado nutricional en menores de 5 anos,clasificacion e,2003-11-01,24,22,24,22,46
70705,GUTIERREZ,estado nutricional en menores de 5 anos,clasificacion e,2003-11-01,28,42,28,42,70
10502,HUACARETA,estado nutricional en menores de 5 anos,clasificacion e,2003-11-01,15,21,15,21,36
11002,HUACAYA (VILLA DE HUACAYA),estado nutricional en menores de 5 anos,clasificacion e,2003-11-01,4,3,4,3,7
40501,HUACHACALLA,estado nutricional en menores de 5 anos,clasificacion e,2003-11-01,0,2,0,2,2
40701,HUANUNI,estado nutricional en menores de 5 anos,clasificacion e,2003-11-01,10,10,10,10,20
80803,HUARACAJE,estado nutricional en menores de 5 anos,clasificacion e,2003-11-01,2,0,2,0,2
41601,HUAYLLAMARCA,estado nutricional en menores de 5 anos,clasificacion e,2003-11-01,2,1,2,1,3
21005,ICHOCA,estado nutricional en menores de 5 anos,clasificacion e,2003-11-01,6,3,6,3,9
10304,ICLA,estado nutricional en menores de 5 anos,clasificacion e,2003-11-01,62,64,62,64,126
10703,INCAHUASI,estado nutricional en menores de 5 anos,clasificacion e,2003-11-01,88,45,88,45,133
21001,INQUISIVI,estado nutricional en menores de 5 anos,clasificacion e,2003-11-01,29,22,29,22,51
21102,IRUPANA (VILLA DE LANZA),estado nutricional en menores de 5 anos,clasificacion e,2003-11-01,2,4,2,4,6
21501,IXIAMAS,estado nutricional en menores de 5 anos,clasificacion e,2003-11-01,11,10,11,10,21
21105,LA ASUNTA,estado nutricional en menores de 5 anos,clasificacion e,2003-11-01,15,14,15,14,29
70104,LA GUARDIA,estado nutricional en menores de 5 anos,clasificacion e,2003-11-01,9,7,9,7,16
20101,LA PAZ,estado nutricional en menores de 5 anos,clasificacion e,2003-11-01,217,157,217,157,374
70701,LAGUNILLAS,estado nutricional en menores de 5 anos,clasificacion e,2003-11-01,8,5,8,5,13
21202,LAJA,estado nutricional en menores de 5 anos,clasificacion e,2003-11-01,5,0,5,0,5
10903,LAS CARRERAS,estado nutricional en menores de 5 anos,clasificacion e,2003-11-01,2,7,2,7,9
21006,LICOMA PAMPA,estado nutricional en menores de 5 anos,clasificacion e,2003-11-01,0,2,0,2,2
50203,LLALLAGUA,estado nutricional en menores de 5 anos,clasificacion e,2003-11-01,82,73,82,73,155
51401,LLICA,estado nutricional en menores de 5 anos,clasificacion e,2003-11-01,3,2,3,2,5
80601,LORETO,estado nutricional en menores de 5 anos,clasificacion e,2003-11-01,1,0,1,0,1
20901,LURIBAY,estado nutricional en menores de 5 anos,clasificacion e,2003-11-01,6,3,6,3,9
40702,MACHACAMARCA,estado nutricional en menores de 5 anos,clasificacion e,2003-11-01,0,1,0,1,1
11003,MACHARETI,estado nutricional en menores de 5 anos,clasificacion e,2003-11-01,10,20,10,20,30
80801,MAGDALENA,estado nutricional en menores de 5 anos,clasificacion e,2003-11-01,2,2,2,2,4
70903,MAIRANA,estado nutricional en menores de 5 anos,clasificacion e,2003-11-01,4,1,4,1,5
20103,MECAPACA,estado nutricional en menores de 5 anos,clasificacion e,2003-11-01,2,5,2,5,7
31301,MIZQUE,estado nutricional en menores de 5 anos,clasificacion e,2003-11-01,11,5,11,5,16
20402,MOCOMOCO,estado nutricional en menores de 5 anos,clasificacion e,2003-11-01,20,22,20,22,42
51002,MOJINETE,estado nutricional en menores de 5 anos,clasificacion e,2003-11-01,2,1,2,1,3
10303,MOJOCOYA,estado nutricional en menores de 5 anos,clasificacion e,2003-11-01,17,14,17,14,31
10501,MONTEAGUDO,estado nutricional en menores de 5 anos,clasificacion e,2003-11-01,40,40,40,40,80
70803,MORO MORO,estado nutricional en menores de 5 anos,clasificacion e,2003-11-01,1,5,1,5,6
30302,MOROCHATA,estado nutricional en menores de 5 anos,clasificacion e,2003-11-01,29,21,29,21,50
50404,OCURI,estado nutricional en menores de 5 anos,clasificacion e,2003-11-01,46,40,46,40,86
30203,OMEREQUE,estado nutricional en menores de 5 anos,clasificacion e,2003-11-01,5,5,5,5,10
40101,ORURO,estado nutricional en menores de 5 anos,clasificacion e,2003-11-01,127,68,127,68,195
60201,PADCAYA,estado nutricional en menores de 5 anos,clasificacion e,2003-11-01,9,2,9,2,11
10401,PADILLA,estado nutricional en menores de 5 anos,clasificacion e,2003-11-01,34,42,34,42,76
70502,PAILON,estado nutricional en menores de 5 anos,clasificacion e,2003-11-01,5,7,5,7,12
20102,PALCA,estado nutricional en menores de 5 anos,clasificacion e,2003-11-01,16,23,16,23,39
21104,PALOS BLANCOS,estado nutricional en menores de 5 anos,clasificacion e,2003-11-01,16,21,16,21,37
40802,PAMPA AULLAGAS,estado nutricional en menores de 5 anos,clasificacion e,2003-11-01,4,4,4,4,8
70902,PAMPA GRANDE,estado nutricional en menores de 5 anos,clasificacion e,2003-11-01,2,2,2,2,4
30202,PASORAPA,estado nutricional en menores de 5 anos,clasificacion e,2003-11-01,5,2,5,2,7
21305,PATACAMAYA,estado nutricional en menores de 5 anos,clasificacion e,2003-11-01,20,17,20,17,37
40602,PAZÃ‘A,estado nutricional en menores de 5 anos,clasificacion e,2003-11-01,1,2,1,2,3
20702,PELECHUCO,estado nutricional en menores de 5 anos,clasificacion e,2003-11-01,7,14,7,14,21
50403,POCOATA,estado nutricional en menores de 5 anos,clasificacion e,2003-11-01,45,44,45,44,89
31203,POCONA,estado nutricional en menores de 5 anos,clasificacion e,2003-11-01,10,7,10,7,17
31202,POJO (CBBA),estado nutricional en menores de 5 anos,clasificacion e,2003-11-01,56,28,56,28,84
40601,POOPO,estado nutricional en menores de 5 anos,clasificacion e,2003-11-01,2,3,2,3,5
51203,PORCO,estado nutricional en menores de 5 anos,clasificacion e,2003-11-01,5,11,5,11,16
10103,POROMA,estado nutricional en menores de 5 anos,clasificacion e,2003-11-01,39,50,39,50,89
70103,PORONGO,estado nutricional en menores de 5 anos,clasificacion e,2003-11-01,1,0,1,0,1
70601,PORTACHUELO,estado nutricional en menores de 5 anos,clasificacion e,2003-11-01,10,7,10,7,17
90102,PORVENIR,estado nutricional en menores de 5 anos,clasificacion e,2003-11-01,3,3,3,3,6
70804,POSTRER VALLE,estado nutricional en menores de 5 anos,clasificacion e,2003-11-01,1,0,1,0,1
50101,POTOSI,estado nutricional en menores de 5 anos,clasificacion e,2003-11-01,135,104,135,104,239
10302,PRESTO,estado nutricional en menores de 5 anos,clasificacion e,2003-11-01,26,31,26,31,57
21201,PUCARANI,estado nutricional en menores de 5 anos,clasificacion e,2003-11-01,11,6,11,6,17
20401,PUERTO ACOSTA,estado nutricional en menores de 5 anos,clasificacion e,2003-11-01,19,15,19,15,34
20403,PUERTO CARABUCO,estado nutricional en menores de 5 anos,clasificacion e,2003-11-01,12,14,12,14,26
90301,PUERTO GONZALO MORENO,estado nutricional en menores de 5 anos,clasificacion e,2003-11-01,21,19,21,19,40
21204,PUERTO PEREZ,estado nutricional en menores de 5 anos,clasificacion e,2003-11-01,2,0,2,0,2
71402,PUERTO QUIJARRO,estado nutricional en menores de 5 anos,clasificacion e,2003-11-01,4,2,4,2,6
90201,PUERTO RICO,estado nutricional en menores de 5 anos,clasificacion e,2003-11-01,0,1,0,1,1
71401,PUERTO SUAREZ,estado nutricional en menores de 5 anos,clasificacion e,2003-11-01,5,1,5,1,6
31205,PUERTO VILLARROEL,estado nutricional en menores de 5 anos,clasificacion e,2003-11-01,51,69,51,69,120
51101,PUNA,estado nutricional en menores de 5 anos,clasificacion e,2003-11-01,61,44,61,44,105
31401,PUNATA,estado nutricional en menores de 5 anos,clasificacion e,2003-11-01,8,6,8,6,14
20604,QUIABAYA,estado nutricional en menores de 5 anos,clasificacion e,2003-11-01,2,6,2,6,8
30901,QUILLACOLLO,estado nutricional en menores de 5 anos,clasificacion e,2003-11-01,29,24,29,24,53
21002,QUIME,estado nutricional en menores de 5 anos,clasificacion e,2003-11-01,10,10,10,10,20
70904,QUIRUSILLAS,estado nutricional en menores de 5 anos,clasificacion e,2003-11-01,0,2,0,2,2
50402,RAVELO,estado nutricional en menores de 5 anos,clasificacion e,2003-11-01,71,79,71,79,150
80301,REYES,estado nutricional en menores de 5 anos,clasificacion e,2003-11-01,11,14,11,14,25
80201,RIBERALTA,estado nutricional en menores de 5 anos,clasificacion e,2003-11-01,93,51,93,51,144
70503,ROBORE,estado nutricional en menores de 5 anos,clasificacion e,2003-11-01,6,1,6,1,7
80304,RURRENABAQUE,estado nutricional en menores de 5 anos,clasificacion e,2003-11-01,5,2,5,2,7
31001,SACABA,estado nutricional en menores de 5 anos,clasificacion e,2003-11-01,36,43,36,43,79
30404,SACABAMBA,estado nutricional en menores de 5 anos,clasificacion e,2003-11-01,5,7,5,7,12
50701,SACACA,estado nutricional en menores de 5 anos,clasificacion e,2003-11-01,77,106,77,106,183
71302,SAIPINA,estado nutricional en menores de 5 anos,clasificacion e,2003-11-01,1,4,1,4,5
40801,SALINAS DE GARCI MENDOZA,estado nutricional en menores de 5 anos,clasificacion e,2003-11-01,3,3,3,3,6
70901,SAMAIPATA,estado nutricional en menores de 5 anos,clasificacion e,2003-11-01,9,0,9,0,9
80602,SAN ANDRES,estado nutricional en menores de 5 anos,clasificacion e,2003-11-01,8,7,8,7,15
51003,SAN ANTONIO DE ESMORUCO,estado nutricional en menores de 5 anos,clasificacion e,2003-11-01,1,0,1,0,1
71105,SAN ANTONIO DE LOMERIO,estado nutricional en menores de 5 anos,clasificacion e,2003-11-01,26,44,26,44,70
80302,SAN BORJA,estado nutricional en menores de 5 anos,clasificacion e,2003-11-01,44,36,44,36,80
21502,SAN BUENA VENTURA,estado nutricional en menores de 5 anos,clasificacion e,2003-11-01,10,17,10,17,27
70402,SAN CARLOS,estado nutricional en menores de 5 anos,clasificacion e,2003-11-01,6,7,6,7,13
80501,SAN IGNACIO,estado nutricional en menores de 5 anos,clasificacion e,2003-11-01,49,24,49,24,73
70301,SAN IGNACIO DE VELASCO,estado nutricional en menores de 5 anos,clasificacion e,2003-11-01,72,61,72,61,133
80102,SAN JAVIER(BNI),estado nutricional en menores de 5 anos,clasificacion e,2003-11-01,0,1,0,1,1
71102,SAN JAVIER(STC),estado nutricional en menores de 5 anos,clasificacion e,2003-11-01,19,18,19,18,37
70501,SAN JOSE DE CHIQUITOS,estado nutricional en menores de 5 anos,clasificacion e,2003-11-01,6,2,6,2,8
71104,SAN JULIAN,estado nutricional en menores de 5 anos,clasificacion e,2003-11-01,47,32,47,32,79
90302,SAN LORENZO(PND),estado nutricional en menores de 5 anos,clasificacion e,2003-11-01,1,0,1,0,1
60501,SAN LORENZO(TJA),estado nutricional en menores de 5 anos,clasificacion e,2003-11-01,9,26,9,26,35
10702,SAN LUCAS,estado nutricional en menores de 5 anos,clasificacion e,2003-11-01,163,117,163,117,280
70302,SAN MIGUEL DE VELASCO,estado nutricional en menores de 5 anos,clasificacion e,2003-11-01,6,4,6,4,10
51001,SAN PABLO DE LIPEZ,estado nutricional en menores de 5 anos,clasificacion e,2003-11-01,2,10,2,10,12
50501,SAN PEDRO DE BUENA VISTA,estado nutricional en menores de 5 anos,clasificacion e,2003-11-01,50,73,50,73,123
21801,SAN PEDRO DE CURAHUARA,estado nutricional en menores de 5 anos,clasificacion e,2003-11-01,4,8,4,8,12
21702,SAN PEDRO DE TIQUINA,estado nutricional en menores de 5 anos,clasificacion e,2003-11-01,1,3,1,3,4
70303,SAN RAFAEL,estado nutricional en menores de 5 anos,clasificacion e,2003-11-01,11,7,11,7,18
80401,SANTA ANA,estado nutricional en menores de 5 anos,clasificacion e,2003-11-01,7,2,7,2,9
70101,SANTA CRUZ DE LA SIERRA,estado nutricional en menores de 5 anos,clasificacion e,2003-11-01,74,32,74,32,106
80303,SANTA ROSA,estado nutricional en menores de 5 anos,clasificacion e,2003-11-01,2,0,2,0,2
70602,SANTA ROSA DEL SARA,estado nutricional en menores de 5 anos,clasificacion e,2003-11-01,2,0,2,0,2
20308,SANTIAGO DE CALLAPA,estado nutricional en menores de 5 anos,clasificacion e,2003-11-01,6,7,6,7,13
41401,SANTIAGO DE HUARI,estado nutricional en menores de 5 anos,clasificacion e,2003-11-01,4,9,4,9,13
21901,SANTIAGO DE MACHACA,estado nutricional en menores de 5 anos,clasificacion e,2003-11-01,4,0,4,0,4
30702,SANTIVAÃ‘ES,estado nutricional en menores de 5 anos,clasificacion e,2003-11-01,9,6,9,6,15
40202,SANTUARIO DE QUILLACAS,estado nutricional en menores de 5 anos,clasificacion e,2003-11-01,0,1,0,1,1
20902,SAPAHAQUI,estado nutricional en menores de 5 anos,clasificacion e,2003-11-01,24,13,24,13,37
90303,SENA,estado nutricional en menores de 5 anos,clasificacion e,2003-11-01,4,3,4,3,7
21301,SICA SICA (VILLA AROMA),estado nutricional en menores de 5 anos,clasificacion e,2003-11-01,32,21,32,21,53
30703,SICAYA,estado nutricional en menores de 5 anos,clasificacion e,2003-11-01,9,1,9,1,10
30902,SIPE SIPE,estado nutricional en menores de 5 anos,clasificacion e,2003-11-01,54,29,54,29,83
10403,SOPACHUY,estado nutricional en menores de 5 anos,clasificacion e,2003-11-01,46,61,46,61,107
20601,SORATA,estado nutricional en menores de 5 anos,clasificacion e,2003-11-01,8,13,8,13,21
10101,SUCRE,estado nutricional en menores de 5 anos,clasificacion e,2003-11-01,156,161,156,161,317
31404,TACACHI,estado nutricional en menores de 5 anos,clasificacion e,2003-11-01,1,0,1,0,1
50303,TACOBAMBA,estado nutricional en menores de 5 anos,clasificacion e,2003-11-01,25,25,25,25,50
30602,TACOPAYA,estado nutricional en menores de 5 anos,clasificacion e,2003-11-01,31,18,31,18,49
51402,TAHUA,estado nutricional en menores de 5 anos,clasificacion e,2003-11-01,0,1,0,1,1
31101,TAPACARI,estado nutricional en menores de 5 anos,clasificacion e,2003-11-01,50,49,50,49,99
10601,TARABUCO,estado nutricional en menores de 5 anos,clasificacion e,2003-11-01,118,133,118,133,251
30401,TARATA,estado nutricional en menores de 5 anos,clasificacion e,2003-11-01,12,5,12,5,17
60101,TARIJA,estado nutricional en menores de 5 anos,clasificacion e,2003-11-01,29,28,29,28,57
10202,TARVITA,estado nutricional en menores de 5 anos,clasificacion e,2003-11-01,59,101,59,101,160
20803,TIAWANACU,estado nutricional en menores de 5 anos,clasificacion e,2003-11-01,3,1,3,1,4
50102,TINGUIPAYA,estado nutricional en menores de 5 anos,clasificacion e,2003-11-01,49,93,49,93,142
20606,TIPUANI,estado nutricional en menores de 5 anos,clasificacion e,2003-11-01,2,1,2,1,3
30903,TIQUIPAYA,estado nutricional en menores de 5 anos,clasificacion e,2003-11-01,5,1,5,1,6
31601,TIRAQUE (CBBA),estado nutricional en menores de 5 anos,clasificacion e,2003-11-01,43,23,43,23,66
21703,TITO YUPANQUI (PARQUIPUJIO),estado nutricional en menores de 5 anos,clasificacion e,2003-11-01,3,1,3,1,4
30802,TOCO,estado nutricional en menores de 5 anos,clasificacion e,2003-11-01,2,4,2,4,6
30803,TOLATA,estado nutricional en menores de 5 anos,clasificacion e,2003-11-01,1,1,1,1,2
41001,TOLEDO,estado nutricional en menores de 5 anos,clasificacion e,2003-11-01,1,0,1,0,1
51202,TOMAVE,estado nutricional en menores de 5 anos,clasificacion e,2003-11-01,22,19,22,19,41
10402,TOMINA,estado nutricional en menores de 5 anos,clasificacion e,2003-11-01,47,69,47,69,116
50502,TORO TORO,estado nutricional en menores de 5 anos,clasificacion e,2003-11-01,90,35,90,35,125
31201,TOTORA(CBBA),estado nutricional en menores de 5 anos,clasificacion e,2003-11-01,22,11,22,11,33
41301,TOTORA(ORR),estado nutricional en menores de 5 anos,clasificacion e,2003-11-01,4,5,4,5,9
70802,TRIGAL,estado nutricional en menores de 5 anos,clasificacion e,2003-11-01,1,0,1,0,1
80101,TRINIDAD,estado nutricional en menores de 5 anos,clasificacion e,2003-11-01,26,40,26,40,66
50801,TUPIZA,estado nutricional en menores de 5 anos,clasificacion e,2003-11-01,37,35,37,35,72
40402,TURCO,estado nutricional en menores de 5 anos,clasificacion e,2003-11-01,0,1,0,1,1
21302,UMALA,estado nutricional en menores de 5 anos,clasificacion e,2003-11-01,11,8,11,8,19
50201,UNCIA,estado nutricional en menores de 5 anos,clasificacion e,2003-11-01,8,3,8,3,11
60401,URIONDO (A. CONCEPCION),estado nutricional en menores de 5 anos,clasificacion e,2003-11-01,10,12,10,12,22
71502,URUBICHA,estado nutricional en menores de 5 anos,clasificacion e,2003-11-01,6,1,6,1,7
51201,UYUNI,estado nutricional en menores de 5 anos,clasificacion e,2003-11-01,7,21,7,21,28
30502,VACAS,estado nutricional en menores de 5 anos,clasificacion e,2003-11-01,24,16,24,16,40
70801,VALLEGRANDE,estado nutricional en menores de 5 anos,clasificacion e,2003-11-01,4,4,4,4,8
20801,VIACHA,estado nutricional en menores de 5 anos,clasificacion e,2003-11-01,22,23,22,23,45
31302,VILA VILA,estado nutricional en menores de 5 anos,clasificacion e,2003-11-01,8,2,8,2,10
60303,VILLA MONTES,estado nutricional en menores de 5 anos,clasificacion e,2003-11-01,13,7,13,7,20
31402,VILLA RIVERO,estado nutricional en menores de 5 anos,clasificacion e,2003-11-01,8,3,8,3,11
10801,VILLA SERRANO,estado nutricional en menores de 5 anos,clasificacion e,2003-11-01,44,55,44,55,99
31003,VILLA TUNARI,estado nutricional en menores de 5 anos,clasificacion e,2003-11-01,53,47,53,47,100
11001,VILLA VACA GUZMAN (MUYUPAMPA),estado nutricional en menores de 5 anos,clasificacion e,2003-11-01,13,14,13,14,27
51501,VILLAZON,estado nutricional en menores de 5 anos,clasificacion e,2003-11-01,23,29,23,29,52
50602,VITICHI,estado nutricional en menores de 5 anos,clasificacion e,2003-11-01,55,64,55,64,119
20306,WALDO BALLIVIAN,estado nutricional en menores de 5 anos,clasificacion e,2003-11-01,3,2,3,2,5
20903,YACO,estado nutricional en menores de 5 anos,clasificacion e,2003-11-01,11,11,11,11,22
60301,YACUIBA,estado nutricional en menores de 5 anos,clasificacion e,2003-11-01,8,7,8,7,15
10602,YAMPARAEZ,estado nutricional en menores de 5 anos,clasificacion e,2003-11-01,65,58,65,58,123
21103,YANACACHI,estado nutricional en menores de 5 anos,clasificacion e,2003-11-01,2,0,2,0,2
70403,YAPACANI,estado nutricional en menores de 5 anos,clasificacion e,2003-11-01,19,21,19,21,40
50103,YOCALLA,estado nutricional en menores de 5 anos,clasificacion e,2003-11-01,13,10,13,10,23
10102,YOTALA,estado nutricional en menores de 5 anos,clasificacion e,2003-11-01,21,30,21,30,51
60402,YUNCHARA,estado nutricional en menores de 5 anos,clasificacion e,2003-11-01,15,18,15,18,33
10301,ZUDAÃ‘EZ,estado nutricional en menores de 5 anos,clasificacion e,2003-11-01,22,28,22,28,50
51302,ACACIO,estado nutricional en menores de 5 anos,clasificacion e,2003-12-01,32,23,32,23,55
20201,ACHACACHI,estado nutricional en menores de 5 anos,clasificacion e,2003-12-01,10,5,10,5,15
20104,ACHOCALLA,estado nutricional en menores de 5 anos,clasificacion e,2003-12-01,1,1,1,1,2
30201,AIQUILE,estado nutricional en menores de 5 anos,clasificacion e,2003-12-01,9,3,9,3,12
31303,ALALAY,estado nutricional en menores de 5 anos,clasificacion e,2003-12-01,7,2,7,2,9
10404,ALCALA,estado nutricional en menores de 5 anos,clasificacion e,2003-12-01,7,12,7,12,19
20202,ANCORAIMES,estado nutricional en menores de 5 anos,clasificacion e,2003-12-01,7,4,7,4,11
41201,ANDAMARCA,estado nutricional en menores de 5 anos,clasificacion e,2003-12-01,1,1,1,1,2
40603,ANTEQUERA,estado nutricional en menores de 5 anos,clasificacion e,2003-12-01,2,0,2,0,2
30402,ANZALDO,estado nutricional en menores de 5 anos,clasificacion e,2003-12-01,0,2,0,2,2
20701,APOLO,estado nutricional en menores de 5 anos,clasificacion e,2003-12-01,8,5,8,5,13
51301,ARAMPAMPA,estado nutricional en menores de 5 anos,clasificacion e,2003-12-01,5,12,5,12,17
30501,ARANI,estado nutricional en menores de 5 anos,clasificacion e,2003-12-01,6,3,6,3,9
30403,ARBIETO,estado nutricional en menores de 5 anos,clasificacion e,2003-12-01,0,1,0,1,1
30601,ARQUE,estado nutricional en menores de 5 anos,clasificacion e,2003-12-01,1,3,1,3,4
71501,ASCENCION DE GUARAYOS,estado nutricional en menores de 5 anos,clasificacion e,2003-12-01,46,91,46,91,137
50802,ATOCHA,estado nutricional en menores de 5 anos,clasificacion e,2003-12-01,13,22,13,22,35
20503,AUCAPATA,estado nutricional en menores de 5 anos,clasificacion e,2003-12-01,8,3,8,3,11
20502,AYATA,estado nutricional en menores de 5 anos,clasificacion e,2003-12-01,12,8,12,8,20
30301,AYOPAYA (V. DE INDEPENDENCIA),estado nutricional en menores de 5 anos,clasificacion e,2003-12-01,22,11,22,11,33
10201,AZURDUY,estado nutricional en menores de 5 anos,clasificacion e,2003-12-01,42,56,42,56,98
21203,BATALLAS,estado nutricional en menores de 5 anos,clasificacion e,2003-12-01,4,2,4,2,6
80802,BAURES,estado nutricional en menores de 5 anos,clasificacion e,2003-12-01,2,0,2,0,2
50104,BELEN DE URMIRI,estado nutricional en menores de 5 anos,clasificacion e,2003-12-01,3,4,3,4,7
90104,BELLA FLOR,estado nutricional en menores de 5 anos,clasificacion e,2003-12-01,1,3,1,3,4
60202,BERMEJO,estado nutricional en menores de 5 anos,clasificacion e,2003-12-01,1,5,1,5,6
50301,BETANZOS,estado nutricional en menores de 5 anos,clasificacion e,2003-12-01,100,90,100,90,190
70707,BOYUIBE,estado nutricional en menores de 5 anos,clasificacion e,2003-12-01,3,4,3,4,7
70401,BUENA VISTA,estado nutricional en menores de 5 anos,clasificacion e,2003-12-01,5,6,5,6,11
20905,CAIROMA,estado nutricional en menores de 5 anos,clasificacion e,2003-12-01,19,6,19,6,25
51102,"CAIZA ""D""",estado nutricional en menores de 5 anos,clasificacion e,2003-12-01,15,12,15,12,27
21003,CAJUATA,estado nutricional en menores de 5 anos,clasificacion e,2003-12-01,10,6,10,6,16
20303,CALACOTO,estado nutricional en menores de 5 anos,clasificacion e,2003-12-01,1,0,1,0,1
21304,CALAMARCA,estado nutricional en menores de 5 anos,clasificacion e,2003-12-01,53,30,53,30,83
10701,CAMARGO,estado nutricional en menores de 5 anos,clasificacion e,2003-12-01,17,24,17,24,41
10901,CAMATAQUI (C. VILLA ABECIA),estado nutricional en menores de 5 anos,clasificacion e,2003-12-01,2,2,2,2,4
70706,CAMIRI,estado nutricional en menores de 5 anos,clasificacion e,2003-12-01,35,21,35,21,56
30701,CAPINOTA,estado nutricional en menores de 5 anos,clasificacion e,2003-12-01,23,39,23,39,62
20302,CAQUIAVIRI,estado nutricional en menores de 5 anos,clasificacion e,2003-12-01,6,5,6,5,11
40102,CARACOLLO,estado nutricional en menores de 5 anos,clasificacion e,2003-12-01,13,4,13,4,17
22001,CARANAVI,estado nutricional en menores de 5 anos,clasificacion e,2003-12-01,46,32,46,32,78
60302,CARAPARI,estado nutricional en menores de 5 anos,clasificacion e,2003-12-01,2,3,2,3,5
50702,CARIPUYO,estado nutricional en menores de 5 anos,clasificacion e,2003-12-01,21,30,21,30,51
40201,CHALLAPATA,estado nutricional en menores de 5 anos,clasificacion e,2003-12-01,23,33,23,33,56
50302,CHAQUI,estado nutricional en menores de 5 anos,clasificacion e,2003-12-01,9,10,9,10,19
70702,CHARAGUA,estado nutricional en menores de 5 anos,clasificacion e,2003-12-01,21,19,21,19,40
20305,CHARAÃ‘A,estado nutricional en menores de 5 anos,clasificacion e,2003-12-01,4,4,4,4,8
50202,CHAYANTA,estado nutricional en menores de 5 anos,clasificacion e,2003-12-01,34,45,34,45,79
31204,CHIMORE,estado nutricional en menores de 5 anos,clasificacion e,2003-12-01,5,6,5,6,11
40302,CHOQUE COTA,estado nutricional en menores de 5 anos,clasificacion e,2003-12-01,1,0,1,0,1
21101,CHULUMANI (V. DE LA LIBERTAD),estado nutricional en menores de 5 anos,clasificacion e,2003-12-01,0,1,0,1,1
20501,CHUMA,estado nutricional en menores de 5 anos,clasificacion e,2003-12-01,3,1,3,1,4
30801,CLIZA,estado nutricional en menores de 5 anos,clasificacion e,2003-12-01,5,5,5,5,10
90101,COBIJA,estado nutricional en menores de 5 anos,clasificacion e,2003-12-01,16,9,16,9,25
30101,COCHABAMBA,estado nutricional en menores de 5 anos,clasificacion e,2003-12-01,153,72,153,72,225
30905,COLCAPIRHUA,estado nutricional en menores de 5 anos,clasificacion e,2003-12-01,17,5,17,5,22
50901,"COLCHA ""K""",estado nutricional en menores de 5 anos,clasificacion e,2003-12-01,4,6,4,6,10
21307,COLLANA,estado nutricional en menores de 5 anos,clasificacion e,2003-12-01,2,1,2,1,3
31002,COLOMI,estado nutricional en menores de 5 anos,clasificacion e,2003-12-01,55,33,55,33,88
50401,COLQUECHACA,estado nutricional en menores de 5 anos,clasificacion e,2003-12-01,61,36,61,36,97
21306,COLQUENCHA,estado nutricional en menores de 5 anos,clasificacion e,2003-12-01,4,2,4,2,6
21004,COLQUIRI,estado nutricional en menores de 5 anos,clasificacion e,2003-12-01,23,8,23,8,31
20304,COMANCHE,estado nutricional en menores de 5 anos,clasificacion e,2003-12-01,0,2,0,2,2
71301,COMARAPA,estado nutricional en menores de 5 anos,clasificacion e,2003-12-01,19,7,19,7,26
20605,COMBAYA,estado nutricional en menores de 5 anos,clasificacion e,2003-12-01,3,5,3,5,8
71101,CONCEPCION,estado nutricional en menores de 5 anos,clasificacion e,2003-12-01,2,0,2,0,2
21701,COPACABANA,estado nutricional en menores de 5 anos,clasificacion e,2003-12-01,5,4,5,4,9
20301,CORO CORO,estado nutricional en menores de 5 anos,clasificacion e,2003-12-01,1,1,1,1,2
21401,COROICO,estado nutricional en menores de 5 anos,clasificacion e,2003-12-01,15,2,15,2,17
40301,CORQUE,estado nutricional en menores de 5 anos,clasificacion e,2003-12-01,0,2,0,2,2
50601,COTAGAITA,estado nutricional en menores de 5 anos,clasificacion e,2003-12-01,20,34,20,34,54
31405,CUCHUMUELA (V. G. VILLARROEL),estado nutricional en menores de 5 anos,clasificacion e,2003-12-01,1,2,1,2,3
70704,CUEVO,estado nutricional en menores de 5 anos,clasificacion e,2003-12-01,1,2,1,2,3
10902,CULPINA,estado nutricional en menores de 5 anos,clasificacion e,2003-12-01,47,48,47,48,95
40401,CURAHUARA DE CARANGAS,estado nutricional en menores de 5 anos,clasificacion e,2003-12-01,9,7,9,7,16
21602,CURVA,estado nutricional en menores de 5 anos,clasificacion e,2003-12-01,0,1,0,1,1
20105,EL ALTO,estado nutricional en menores de 5 anos,clasificacion e,2003-12-01,401,179,401,179,580
71503,EL PUENTE(STC),estado nutricional en menores de 5 anos,clasificacion e,2003-12-01,15,7,15,7,22
60502,EL PUENTE(TJA),estado nutricional en menores de 5 anos,clasificacion e,2003-12-01,10,6,10,6,16
70105,EL TORNO,estado nutricional en menores de 5 anos,clasificacion e,2003-12-01,12,6,12,6,18
10405,EL VILLAR,estado nutricional en menores de 5 anos,clasificacion e,2003-12-01,17,27,17,27,44
60601,ENTRE RIOS,estado nutricional en menores de 5 anos,clasificacion e,2003-12-01,9,9,9,9,18
41101,EUCALIPTUS,estado nutricional en menores de 5 anos,clasificacion e,2003-12-01,4,2,4,2,6
80402,EXALTACION,estado nutricional en menores de 5 anos,clasificacion e,2003-12-01,8,4,8,4,12
90203,FILADELFIA,estado nutricional en menores de 5 anos,clasificacion e,2003-12-01,0,1,0,1,1
71002,GENERAL SAAVEDRA,estado nutricional en menores de 5 anos,clasificacion e,2003-12-01,30,24,30,24,54
21601,GRAL. J.J. PEREZ (CHARAZANI),estado nutricional en menores de 5 anos,clasificacion e,2003-12-01,7,14,7,14,21
20602,GUANAY,estado nutricional en menores de 5 anos,clasificacion e,2003-12-01,20,11,20,11,31
20802,GUAQUI,estado nutricional en menores de 5 anos,clasificacion e,2003-12-01,0,3,0,3,3
80202,GUAYARAMERIN,estado nutricional en menores de 5 anos,clasificacion e,2003-12-01,32,28,32,28,60
70705,GUTIERREZ,estado nutricional en menores de 5 anos,clasificacion e,2003-12-01,34,45,34,45,79
10502,HUACARETA,estado nutricional en menores de 5 anos,clasificacion e,2003-12-01,19,16,19,16,35
11002,HUACAYA (VILLA DE HUACAYA),estado nutricional en menores de 5 anos,clasificacion e,2003-12-01,4,2,4,2,6
40501,HUACHACALLA,estado nutricional en menores de 5 anos,clasificacion e,2003-12-01,1,2,1,2,3
40701,HUANUNI,estado nutricional en menores de 5 anos,clasificacion e,2003-12-01,16,6,16,6,22
80803,HUARACAJE,estado nutricional en menores de 5 anos,clasificacion e,2003-12-01,1,0,1,0,1
41601,HUAYLLAMARCA,estado nutricional en menores de 5 anos,clasificacion e,2003-12-01,3,2,3,2,5
21005,ICHOCA,estado nutricional en menores de 5 anos,clasificacion e,2003-12-01,9,8,9,8,17
10304,ICLA,estado nutricional en menores de 5 anos,clasificacion e,2003-12-01,73,76,73,76,149
10703,INCAHUASI,estado nutricional en menores de 5 anos,clasificacion e,2003-12-01,27,17,27,17,44
21001,INQUISIVI,estado nutricional en menores de 5 anos,clasificacion e,2003-12-01,19,9,19,9,28
21102,IRUPANA (VILLA DE LANZA),estado nutricional en menores de 5 anos,clasificacion e,2003-12-01,1,3,1,3,4
21501,IXIAMAS,estado nutricional en menores de 5 anos,clasificacion e,2003-12-01,3,4,3,4,7
21105,LA ASUNTA,estado nutricional en menores de 5 anos,clasificacion e,2003-12-01,1,6,1,6,7
70104,LA GUARDIA,estado nutricional en menores de 5 anos,clasificacion e,2003-12-01,11,10,11,10,21
20101,LA PAZ,estado nutricional en menores de 5 anos,clasificacion e,2003-12-01,231,147,231,147,378
70701,LAGUNILLAS,estado nutricional en menores de 5 anos,clasificacion e,2003-12-01,1,2,1,2,3
21202,LAJA,estado nutricional en menores de 5 anos,clasificacion e,2003-12-01,1,3,1,3,4
10903,LAS CARRERAS,estado nutricional en menores de 5 anos,clasificacion e,2003-12-01,3,7,3,7,10
50203,LLALLAGUA,estado nutricional en menores de 5 anos,clasificacion e,2003-12-01,37,64,37,64,101
51401,LLICA,estado nutricional en menores de 5 anos,clasificacion e,2003-12-01,1,1,1,1,2
80601,LORETO,estado nutricional en menores de 5 anos,clasificacion e,2003-12-01,1,0,1,0,1
20901,LURIBAY,estado nutricional en menores de 5 anos,clasificacion e,2003-12-01,10,5,10,5,15
11003,MACHARETI,estado nutricional en menores de 5 anos,clasificacion e,2003-12-01,11,10,11,10,21
80801,MAGDALENA,estado nutricional en menores de 5 anos,clasificacion e,2003-12-01,4,3,4,3,7
70903,MAIRANA,estado nutricional en menores de 5 anos,clasificacion e,2003-12-01,5,1,5,1,6
20904,MALLA,estado nutricional en menores de 5 anos,clasificacion e,2003-12-01,1,0,1,0,1
20103,MECAPACA,estado nutricional en menores de 5 anos,clasificacion e,2003-12-01,2,1,2,1,3
71003,MINEROS,estado nutricional en menores de 5 anos,clasificacion e,2003-12-01,20,14,20,14,34
31301,MIZQUE,estado nutricional en menores de 5 anos,clasificacion e,2003-12-01,1,1,1,1,2
20402,MOCOMOCO,estado nutricional en menores de 5 anos,clasificacion e,2003-12-01,14,20,14,20,34
51002,MOJINETE,estado nutricional en menores de 5 anos,clasificacion e,2003-12-01,2,1,2,1,3
10303,MOJOCOYA,estado nutricional en menores de 5 anos,clasificacion e,2003-12-01,9,13,9,13,22
10501,MONTEAGUDO,estado nutricional en menores de 5 anos,clasificacion e,2003-12-01,36,33,36,33,69
71001,MONTERO,estado nutricional en menores de 5 anos,clasificacion e,2003-12-01,27,31,27,31,58
70803,MORO MORO,estado nutricional en menores de 5 anos,clasificacion e,2003-12-01,1,0,1,0,1
30302,MOROCHATA,estado nutricional en menores de 5 anos,clasificacion e,2003-12-01,19,15,19,15,34
50404,OCURI,estado nutricional en menores de 5 anos,clasificacion e,2003-12-01,36,23,36,23,59
40101,ORURO,estado nutricional en menores de 5 anos,clasificacion e,2003-12-01,157,85,157,85,242
60201,PADCAYA,estado nutricional en menores de 5 anos,clasificacion e,2003-12-01,6,4,6,4,10
10401,PADILLA,estado nutricional en menores de 5 anos,clasificacion e,2003-12-01,33,29,33,29,62
20102,PALCA,estado nutricional en menores de 5 anos,clasificacion e,2003-12-01,1,11,1,11,12
21104,PALOS BLANCOS,estado nutricional en menores de 5 anos,clasificacion e,2003-12-01,9,8,9,8,17
40802,PAMPA AULLAGAS,estado nutricional en menores de 5 anos,clasificacion e,2003-12-01,1,5,1,5,6
70902,PAMPA GRANDE,estado nutricional en menores de 5 anos,clasificacion e,2003-12-01,1,2,1,2,3
21802,PAPEL PAMPA,estado nutricional en menores de 5 anos,clasificacion e,2003-12-01,1,2,1,2,3
30202,PASORAPA,estado nutricional en menores de 5 anos,clasificacion e,2003-12-01,7,9,7,9,16
21305,PATACAMAYA,estado nutricional en menores de 5 anos,clasificacion e,2003-12-01,33,32,33,32,65
40602,PAZÃ‘A,estado nutricional en menores de 5 anos,clasificacion e,2003-12-01,2,0,2,0,2
20702,PELECHUCO,estado nutricional en menores de 5 anos,clasificacion e,2003-12-01,10,3,10,3,13
50403,POCOATA,estado nutricional en menores de 5 anos,clasificacion e,2003-12-01,31,52,31,52,83
31203,POCONA,estado nutricional en menores de 5 anos,clasificacion e,2003-12-01,12,10,12,10,22
31202,POJO (CBBA),estado nutricional en menores de 5 anos,clasificacion e,2003-12-01,26,19,26,19,45
40601,POOPO,estado nutricional en menores de 5 anos,clasificacion e,2003-12-01,0,2,0,2,2
51203,PORCO,estado nutricional en menores de 5 anos,clasificacion e,2003-12-01,12,9,12,9,21
10103,POROMA,estado nutricional en menores de 5 anos,clasificacion e,2003-12-01,24,44,24,44,68
70103,PORONGO,estado nutricional en menores de 5 anos,clasificacion e,2003-12-01,2,0,2,0,2
70601,PORTACHUELO,estado nutricional en menores de 5 anos,clasificacion e,2003-12-01,4,9,4,9,13
90102,PORVENIR,estado nutricional en menores de 5 anos,clasificacion e,2003-12-01,1,2,1,2,3
50101,POTOSI,estado nutricional en menores de 5 anos,clasificacion e,2003-12-01,130,93,130,93,223
10302,PRESTO,estado nutricional en menores de 5 anos,clasificacion e,2003-12-01,16,20,16,20,36
70805,PUCARA,estado nutricional en menores de 5 anos,clasificacion e,2003-12-01,0,1,0,1,1
21201,PUCARANI,estado nutricional en menores de 5 anos,clasificacion e,2003-12-01,6,0,6,0,6
20401,PUERTO ACOSTA,estado nutricional en menores de 5 anos,clasificacion e,2003-12-01,14,9,14,9,23
20403,PUERTO CARABUCO,estado nutricional en menores de 5 anos,clasificacion e,2003-12-01,7,7,7,7,14
90301,PUERTO GONZALO MORENO,estado nutricional en menores de 5 anos,clasificacion e,2003-12-01,11,3,11,3,14
21204,PUERTO PEREZ,estado nutricional en menores de 5 anos,clasificacion e,2003-12-01,2,0,2,0,2
90201,PUERTO RICO,estado nutricional en menores de 5 anos,clasificacion e,2003-12-01,0,5,0,5,5
80703,PUERTO SILES,estado nutricional en menores de 5 anos,clasificacion e,2003-12-01,1,2,1,2,3
31205,PUERTO VILLARROEL,estado nutricional en menores de 5 anos,clasificacion e,2003-12-01,80,61,80,61,141
51101,PUNA,estado nutricional en menores de 5 anos,clasificacion e,2003-12-01,42,31,42,31,73
31401,PUNATA,estado nutricional en menores de 5 anos,clasificacion e,2003-12-01,36,6,36,6,42
20604,QUIABAYA,estado nutricional en menores de 5 anos,clasificacion e,2003-12-01,5,1,5,1,6
30901,QUILLACOLLO,estado nutricional en menores de 5 anos,clasificacion e,2003-12-01,37,26,37,26,63
21002,QUIME,estado nutricional en menores de 5 anos,clasificacion e,2003-12-01,11,11,11,11,22
70904,QUIRUSILLAS,estado nutricional en menores de 5 anos,clasificacion e,2003-12-01,0,1,0,1,1
50402,RAVELO,estado nutricional en menores de 5 anos,clasificacion e,2003-12-01,33,29,33,29,62
80301,REYES,estado nutricional en menores de 5 anos,clasificacion e,2003-12-01,6,8,6,8,14
80201,RIBERALTA,estado nutricional en menores de 5 anos,clasificacion e,2003-12-01,109,67,109,67,176
80304,RURRENABAQUE,estado nutricional en menores de 5 anos,clasificacion e,2003-12-01,3,1,3,1,4
40901,SABAYA,estado nutricional en menores de 5 anos,clasificacion e,2003-12-01,2,5,2,5,7
31001,SACABA,estado nutricional en menores de 5 anos,clasificacion e,2003-12-01,9,7,9,7,16
30404,SACABAMBA,estado nutricional en menores de 5 anos,clasificacion e,2003-12-01,2,6,2,6,8
50701,SACACA,estado nutricional en menores de 5 anos,clasificacion e,2003-12-01,94,104,94,104,198
71302,SAIPINA,estado nutricional en menores de 5 anos,clasificacion e,2003-12-01,1,3,1,3,4
40801,SALINAS DE GARCI MENDOZA,estado nutricional en menores de 5 anos,clasificacion e,2003-12-01,2,4,2,4,6
70901,SAMAIPATA,estado nutricional en menores de 5 anos,clasificacion e,2003-12-01,3,2,3,2,5
51601,SAN AGUSTIN,estado nutricional en menores de 5 anos,clasificacion e,2003-12-01,2,3,2,3,5
80602,SAN ANDRES,estado nutricional en menores de 5 anos,clasificacion e,2003-12-01,4,9,4,9,13
31403,SAN BENITO,estado nutricional en menores de 5 anos,clasificacion e,2003-12-01,7,3,7,3,10
80302,SAN BORJA,estado nutricional en menores de 5 anos,clasificacion e,2003-12-01,41,53,41,53,94
21502,SAN BUENA VENTURA,estado nutricional en menores de 5 anos,clasificacion e,2003-12-01,15,7,15,7,22
70402,SAN CARLOS,estado nutricional en menores de 5 anos,clasificacion e,2003-12-01,18,6,18,6,24
80501,SAN IGNACIO,estado nutricional en menores de 5 anos,clasificacion e,2003-12-01,13,9,13,9,22
70301,SAN IGNACIO DE VELASCO,estado nutricional en menores de 5 anos,clasificacion e,2003-12-01,35,20,35,20,55
80102,SAN JAVIER(BNI),estado nutricional en menores de 5 anos,clasificacion e,2003-12-01,4,0,4,0,4
71102,SAN JAVIER(STC),estado nutricional en menores de 5 anos,clasificacion e,2003-12-01,10,5,10,5,15
80701,SAN JOAQUIN,estado nutricional en menores de 5 anos,clasificacion e,2003-12-01,1,2,1,2,3
71104,SAN JULIAN,estado nutricional en menores de 5 anos,clasificacion e,2003-12-01,17,18,17,18,35
60501,SAN LORENZO(TJA),estado nutricional en menores de 5 anos,clasificacion e,2003-12-01,16,20,16,20,36
10702,SAN LUCAS,estado nutricional en menores de 5 anos,clasificacion e,2003-12-01,115,100,115,100,215
71201,SAN MATIAS,estado nutricional en menores de 5 anos,clasificacion e,2003-12-01,10,2,10,2,12
70302,SAN MIGUEL DE VELASCO,estado nutricional en menores de 5 anos,clasificacion e,2003-12-01,2,9,2,9,11
51001,SAN PABLO DE LIPEZ,estado nutricional en menores de 5 anos,clasificacion e,2003-12-01,2,5,2,5,7
50501,SAN PEDRO DE BUENA VISTA,estado nutricional en menores de 5 anos,clasificacion e,2003-12-01,74,91,74,91,165
21801,SAN PEDRO DE CURAHUARA,estado nutricional en menores de 5 anos,clasificacion e,2003-12-01,9,8,9,8,17
50902,SAN PEDRO DE QUEMES,estado nutricional en menores de 5 anos,clasificacion e,2003-12-01,0,1,0,1,1
21702,SAN PEDRO DE TIQUINA,estado nutricional en menores de 5 anos,clasificacion e,2003-12-01,0,1,0,1,1
70303,SAN RAFAEL,estado nutricional en menores de 5 anos,clasificacion e,2003-12-01,13,6,13,6,19
80702,SAN RAMON,estado nutricional en menores de 5 anos,clasificacion e,2003-12-01,1,0,1,0,1
80401,SANTA ANA,estado nutricional en menores de 5 anos,clasificacion e,2003-12-01,15,8,15,8,23
70101,SANTA CRUZ DE LA SIERRA,estado nutricional en menores de 5 anos,clasificacion e,2003-12-01,100,43,100,43,143
80303,SANTA ROSA,estado nutricional en menores de 5 anos,clasificacion e,2003-12-01,6,4,6,4,10
70602,SANTA ROSA DEL SARA,estado nutricional en menores de 5 anos,clasificacion e,2003-12-01,0,3,0,3,3
20308,SANTIAGO DE CALLAPA,estado nutricional en menores de 5 anos,clasificacion e,2003-12-01,9,9,9,9,18
41401,SANTIAGO DE HUARI,estado nutricional en menores de 5 anos,clasificacion e,2003-12-01,0,3,0,3,3
21901,SANTIAGO DE MACHACA,estado nutricional en menores de 5 anos,clasificacion e,2003-12-01,2,2,2,2,4
30702,SANTIVAÃ‘ES,estado nutricional en menores de 5 anos,clasificacion e,2003-12-01,2,6,2,6,8
40202,SANTUARIO DE QUILLACAS,estado nutricional en menores de 5 anos,clasificacion e,2003-12-01,1,1,1,1,2
20902,SAPAHAQUI,estado nutricional en menores de 5 anos,clasificacion e,2003-12-01,10,10,10,10,20
90303,SENA,estado nutricional en menores de 5 anos,clasificacion e,2003-12-01,4,1,4,1,5
21301,SICA SICA (VILLA AROMA),estado nutricional en menores de 5 anos,clasificacion e,2003-12-01,41,19,41,19,60
30703,SICAYA,estado nutricional en menores de 5 anos,clasificacion e,2003-12-01,3,5,3,5,8
30902,SIPE SIPE,estado nutricional en menores de 5 anos,clasificacion e,2003-12-01,29,12,29,12,41
10403,SOPACHUY,estado nutricional en menores de 5 anos,clasificacion e,2003-12-01,26,28,26,28,54
20601,SORATA,estado nutricional en menores de 5 anos,clasificacion e,2003-12-01,3,5,3,5,8
10101,SUCRE,estado nutricional en menores de 5 anos,clasificacion e,2003-12-01,93,80,93,80,173
31404,TACACHI,estado nutricional en menores de 5 anos,clasificacion e,2003-12-01,1,0,1,0,1
20603,TACACOMA,estado nutricional en menores de 5 anos,clasificacion e,2003-12-01,5,3,5,3,8
50303,TACOBAMBA,estado nutricional en menores de 5 anos,clasificacion e,2003-12-01,30,22,30,22,52
30602,TACOPAYA,estado nutricional en menores de 5 anos,clasificacion e,2003-12-01,11,9,11,9,20
31101,TAPACARI,estado nutricional en menores de 5 anos,clasificacion e,2003-12-01,51,44,51,44,95
10601,TARABUCO,estado nutricional en menores de 5 anos,clasificacion e,2003-12-01,127,142,127,142,269
30401,TARATA,estado nutricional en menores de 5 anos,clasificacion e,2003-12-01,14,3,14,3,17
60101,TARIJA,estado nutricional en menores de 5 anos,clasificacion e,2003-12-01,88,62,88,62,150
10202,TARVITA,estado nutricional en menores de 5 anos,clasificacion e,2003-12-01,17,27,17,27,44
20803,TIAWANACU,estado nutricional en menores de 5 anos,clasificacion e,2003-12-01,1,1,1,1,2
50102,TINGUIPAYA,estado nutricional en menores de 5 anos,clasificacion e,2003-12-01,97,78,97,78,175
20606,TIPUANI,estado nutricional en menores de 5 anos,clasificacion e,2003-12-01,1,0,1,0,1
30903,TIQUIPAYA,estado nutricional en menores de 5 anos,clasificacion e,2003-12-01,7,3,7,3,10
31601,TIRAQUE (CBBA),estado nutricional en menores de 5 anos,clasificacion e,2003-12-01,44,27,44,27,71
30802,TOCO,estado nutricional en menores de 5 anos,clasificacion e,2003-12-01,0,2,0,2,2
30803,TOLATA,estado nutricional en menores de 5 anos,clasificacion e,2003-12-01,1,1,1,1,2
51202,TOMAVE,estado nutricional en menores de 5 anos,clasificacion e,2003-12-01,14,14,14,14,28
10402,TOMINA,estado nutricional en menores de 5 anos,clasificacion e,2003-12-01,37,63,37,63,100
50502,TORO TORO,estado nutricional en menores de 5 anos,clasificacion e,2003-12-01,25,24,25,24,49
31201,TOTORA(CBBA),estado nutricional en menores de 5 anos,clasificacion e,2003-12-01,20,6,20,6,26
41301,TOTORA(ORR),estado nutricional en menores de 5 anos,clasificacion e,2003-12-01,3,1,3,1,4
80101,TRINIDAD,estado nutricional en menores de 5 anos,clasificacion e,2003-12-01,41,36,41,36,77
50801,TUPIZA,estado nutricional en menores de 5 anos,clasificacion e,2003-12-01,19,51,19,51,70
40402,TURCO,estado nutricional en menores de 5 anos,clasificacion e,2003-12-01,3,1,3,1,4
21302,UMALA,estado nutricional en menores de 5 anos,clasificacion e,2003-12-01,10,6,10,6,16
50201,UNCIA,estado nutricional en menores de 5 anos,clasificacion e,2003-12-01,6,3,6,3,9
60401,URIONDO (A. CONCEPCION),estado nutricional en menores de 5 anos,clasificacion e,2003-12-01,7,6,7,6,13
71502,URUBICHA,estado nutricional en menores de 5 anos,clasificacion e,2003-12-01,4,10,4,10,14
51201,UYUNI,estado nutricional en menores de 5 anos,clasificacion e,2003-12-01,13,13,13,13,26
30502,VACAS,estado nutricional en menores de 5 anos,clasificacion e,2003-12-01,10,2,10,2,12
70801,VALLEGRANDE,estado nutricional en menores de 5 anos,clasificacion e,2003-12-01,7,12,7,12,19
20801,VIACHA,estado nutricional en menores de 5 anos,clasificacion e,2003-12-01,29,8,29,8,37
31302,VILA VILA,estado nutricional en menores de 5 anos,clasificacion e,2003-12-01,7,5,7,5,12
60303,VILLA MONTES,estado nutricional en menores de 5 anos,clasificacion e,2003-12-01,15,13,15,13,28
31402,VILLA RIVERO,estado nutricional en menores de 5 anos,clasificacion e,2003-12-01,12,3,12,3,15
10801,VILLA SERRANO,estado nutricional en menores de 5 anos,clasificacion e,2003-12-01,33,58,33,58,91
31003,VILLA TUNARI,estado nutricional en menores de 5 anos,clasificacion e,2003-12-01,31,38,31,38,69
11001,VILLA VACA GUZMAN (MUYUPAMPA),estado nutricional en menores de 5 anos,clasificacion e,2003-12-01,16,15,16,15,31
51501,VILLAZON,estado nutricional en menores de 5 anos,clasificacion e,2003-12-01,32,29,32,29,61
30904,VINTO,estado nutricional en menores de 5 anos,clasificacion e,2003-12-01,7,6,7,6,13
50602,VITICHI,estado nutricional en menores de 5 anos,clasificacion e,2003-12-01,23,27,23,27,50
20306,WALDO BALLIVIAN,estado nutricional en menores de 5 anos,clasificacion e,2003-12-01,2,2,2,2,4
20903,YACO,estado nutricional en menores de 5 anos,clasificacion e,2003-12-01,28,25,28,25,53
60301,YACUIBA,estado nutricional en menores de 5 anos,clasificacion e,2003-12-01,16,8,16,8,24
10602,YAMPARAEZ,estado nutricional en menores de 5 anos,clasificacion e,2003-12-01,66,49,66,49,115
21103,YANACACHI,estado nutricional en menores de 5 anos,clasificacion e,2003-12-01,4,4,4,4,8
70403,YAPACANI,estado nutricional en menores de 5 anos,clasificacion e,2003-12-01,24,31,24,31,55
50103,YOCALLA,estado nutricional en menores de 5 anos,clasificacion e,2003-12-01,6,4,6,4,10
10102,YOTALA,estado nutricional en menores de 5 anos,clasificacion e,2003-12-01,11,18,11,18,29
60402,YUNCHARA,estado nutricional en menores de 5 anos,clasificacion e,2003-12-01,14,26,14,26,40
10301,ZUDAÃ‘EZ,estado nutricional en menores de 5 anos,clasificacion e,2003-12-01,19,28,19,28,47
